ibge;anomes;cadunico_tot_fam;cadunico_tot_pes;cadunico_tot_fam_rpc_ate_meio_sm;cadunico_tot_pes_rpc_ate_meio_sm;cadunico_tot_fam_pob;cadunico_tot_pes_pob;cadunico_tot_fam_ext_pob;cadunico_tot_pes_ext_pob;cadunico_tot_fam_pob_e_ext_pob;cadunico_tot_pes_pob_e_ext_pob
110001;201512;3853;12118;3165;11019;731;2680;1571;5492;2302;8172
110002;201512;13348;39427;10493;34258;3122;11072;3510;11093;6632;22165
110003;201512;799;2531;705;2359;203;718;179;548;382;1266
110004;201512;10264;32086;8251;27886;2616;9522;1774;5897;4390;15419
110005;201512;1868;5891;1616;5410;530;1823;659;2192;1189;4015
110006;201512;2041;6128;1363;4779;402;1549;219;622;621;2171
110007;201512;1390;4221;1282;4036;362;1239;527;1842;889;3081
110008;201512;2427;8131;2259;7893;397;1307;1599;5847;1996;7154
110009;201512;4688;14022;3709;12425;1063;3910;1275;4141;2338;8051
110010;201512;7680;22540;6670;21220;1799;5566;3404;11888;5203;17454
110011;201512;8116;24667;6793;22099;2267;7811;2318;7357;4585;15168
110012;201512;14596;43464;11968;38606;3634;12269;3508;11325;7142;23594
110013;201512;5553;17238;4563;15515;1726;6083;1279;4476;3005;10559
110014;201512;4239;12301;3604;11281;891;2905;1905;5972;2796;8877
110015;201512;5102;15117;3669;12378;1077;3979;852;2755;1929;6734
110018;201512;4338;12051;3221;10427;849;3115;1222;3700;2071;6815
110020;201512;61235;169507;45642;147614;10446;35745;21074;69625;31520;105370
110025;201512;4409;12624;3569;11059;628;2058;2164;6646;2792;8704
110026;201512;654;2007;601;1928;142;456;346;1128;488;1584
110028;201512;7578;21637;5336;17538;1424;5119;810;2492;2234;7611
110029;201512;1361;4004;1135;3613;335;1106;458;1473;793;2579
110030;201512;10747;28869;8052;25080;2127;7275;3328;10427;5455;17702
110032;201512;4074;12746;3509;11597;1113;3815;1111;3583;2224;7398
110033;201512;5344;16922;4790;15956;1543;5165;1846;6426;3389;11591
110034;201512;3419;9137;2889;8445;740;2199;1748;5085;2488;7284
110037;201512;2050;6811;1709;6125;448;1708;750;2641;1198;4349
110040;201512;3546;11054;3019;10068;885;3183;1191;3798;2076;6981
110045;201512;5197;16778;4474;15823;1426;5493;2146;7525;3572;13018
110050;201512;1713;5449;1444;4965;442;1593;667;2286;1109;3879
110060;201512;834;2714;673;2381;232;927;154;485;386;1412
110070;201512;2027;6707;1884;6399;551;2062;863;2788;1414;4850
110080;201512;4158;11568;3655;10989;568;1632;2677;8380;3245;10012
110090;201512;780;2294;614;1989;146;542;267;805;413;1347
110092;201512;1340;4419;1233;4270;202;754;800;2826;1002;3580
110094;201512;3609;10785;3143;10124;1059;3638;1305;4154;2364;7792
110100;201512;2252;7060;2010;6612;656;2278;890;2882;1546;5160
110110;201512;1669;5264;1499;5031;609;2096;431;1476;1040;3572
110120;201512;1839;5826;1408;4864;435;1576;301;1005;736;2581
110130;201512;2555;7289;1856;6040;589;2046;395;1220;984;3266
110140;201512;2464;8063;2078;7294;590;2263;703;2333;1293;4596
110143;201512;1297;4044;997;3525;298;1089;431;1539;729;2628
110145;201512;1033;2946;822;2595;206;719;418;1276;624;1995
110146;201512;428;1315;369;1224;73;245;206;709;279;954
110147;201512;792;2270;621;1969;161;536;233;672;394;1208
110148;201512;1271;3784;888;2931;207;723;141;409;348;1132
110149;201512;3361;10064;2700;8947;880;2933;1140;3906;2020;6839
110150;201512;2495;7235;2087;6606;566;1908;798;2539;1364;4447
110155;201512;862;2640;754;2370;193;649;344;1023;537;1672
110160;201512;2007;6295;1639;5577;577;2022;562;1886;1139;3908
110170;201512;3002;8332;2147;6744;480;1567;1078;3328;1558;4895
110175;201512;1742;5134;1315;4572;230;846;716;2594;946;3440
110180;201512;1404;4080;1159;3700;276;872;659;2143;935;3015
120001;201512;2809;9651;2597;9294;540;2052;1570;5731;2110;7783
120005;201512;1544;6428;1448;6236;162;775;1078;4783;1240;5558
120010;201512;4578;15663;4326;15268;615;2172;3213;11620;3828;13792
120013;201512;1799;7124;1710;6991;406;1635;1010;4369;1416;6004
120017;201512;2041;7299;1885;7015;527;2021;856;3471;1383;5492
120020;201512;14087;62560;13565;61495;2134;9858;9550;44760;11684;54618
120025;201512;2506;8675;2401;8510;465;1758;1535;5485;2000;7243
120030;201512;6144;24116;5996;23947;261;1174;5408;21735;5669;22909
120032;201512;1448;7004;1386;6853;178;1064;994;4923;1172;5987
120033;201512;3533;14081;3450;13928;320;1295;2967;12177;3287;13472
120034;201512;2040;8430;1957;8276;150;835;1617;6746;1767;7581
120035;201512;3002;13808;2936;13673;225;1190;2483;11673;2708;12863
120038;201512;2716;9788;2573;9504;674;2543;1343;5087;2017;7630
120039;201512;1654;8340;1603;8224;174;1006;1222;6365;1396;7371
120040;201512;45278;160905;40860;152173;10047;40386;19905;75016;29952;115402
120042;201512;2896;12399;2737;12026;371;1794;1943;8656;2314;10450
120043;201512;898;4262;865;4203;71;335;696;3516;767;3851
120045;201512;4276;14545;4169;14412;578;2097;3347;11642;3925;13739
120050;201512;7988;32967;7600;32114;1200;5319;5089;22235;6289;27554
120060;201512;7401;33424;7233;33090;711;3793;5756;26505;6467;30298
120070;201512;2678;10008;2590;9809;438;1643;1696;6630;2134;8273
120080;201512;3574;13481;3368;13124;676;2746;2269;9025;2945;11771
130002;201512;3060;12629;2868;12311;196;1006;2414;10374;2610;11380
130006;201512;1975;8341;1732;7887;253;1298;1206;5524;1459;6822
130008;201512;2123;8437;1989;8193;220;944;1533;6405;1753;7349
130010;201512;2991;9829;2597;9369;216;843;2216;8034;2432;8877
130014;201512;3224;10492;2836;9867;492;1854;1799;6284;2291;8138
130020;201512;2708;9894;2617;9728;67;340;2285;8383;2352;8723
130030;201512;7342;27743;7040;27391;514;1771;6101;24432;6615;26203
130040;201512;3847;11780;3429;11222;301;1064;2759;9156;3060;10220
130050;201512;6176;24847;5675;24093;477;2010;4541;20061;5018;22071
130060;201512;5607;26307;5341;25838;538;3118;4156;20038;4694;23156
130063;201512;3623;16060;3532;15944;329;1609;2979;13594;3308;15203
130068;201512;3114;13102;2799;12426;378;1779;1807;8137;2185;9916
130070;201512;6811;21821;6002;20827;669;2328;4581;16281;5250;18609
130080;201512;5111;22872;4864;22467;795;3965;3346;15744;4141;19709
130083;201512;2142;8525;2015;8330;314;1451;1363;5643;1677;7094
130090;201512;2592;9361;2494;9210;120;571;2189;8039;2309;8610
130100;201512;5677;21015;5510;20799;179;760;5142;19453;5321;20213
130110;201512;6647;21465;6227;20942;762;2364;4915;17091;5677;19455
130115;201512;4404;15557;4123;15120;200;780;3586;13211;3786;13991
130120;201512;14394;54699;13538;53594;1496;5993;10876;44093;12372;50086
130130;201512;3783;15559;3713;15421;255;1265;3162;13136;3417;14401
130140;201512;6296;24375;6190;24255;232;961;5800;22777;6032;23738
130150;201512;3376;13270;3298;13171;185;1003;2910;11445;3095;12448
130160;201512;4172;17343;4027;17135;496;2479;3253;13703;3749;16182
130165;201512;2847;11756;2712;11517;296;1392;2109;9026;2405;10418
130170;201512;9048;32546;7917;31107;1133;4745;5782;23171;6915;27916
130180;201512;3492;11391;3396;11260;168;360;3108;10540;3276;10900
130185;201512;11270;36004;10091;34645;936;2984;8236;29456;9172;32440
130190;201512;17255;58871;15053;55971;2820;10581;9720;37604;12540;48185
130195;201512;1946;8122;1870;8012;120;539;1629;7080;1749;7619
130200;201512;2004;7135;1824;6842;460;1721;1090;4208;1550;5929
130210;201512;1238;4857;1167;4760;125;626;954;3850;1079;4476
130220;201512;1992;8143;1807;7784;314;1538;999;4276;1313;5814
130230;201512;3650;16548;3385;16089;395;1964;2506;12372;2901;14336
130240;201512;8476;32171;7758;31115;437;2301;6664;26707;7101;29008
130250;201512;19774;68777;18586;67226;2816;10125;13533;50865;16349;60990
130255;201512;4142;14542;3875;14097;182;737;3410;12505;3592;13242
130260;201512;247719;809636;220351;761185;64795;236790;95256;331155;160051;567945
130270;201512;6954;29300;6377;28362;945;4471;4494;20635;5439;25106
130280;201512;3246;13333;3131;13183;159;706;2818;12040;2977;12746
130290;201512;11323;39768;10824;39180;141;257;10412;38423;10553;38680
130300;201512;4290;16813;4085;16477;268;1266;3514;14196;3782;15462
130310;201512;5033;19087;4638;18576;364;1531;3845;15685;4209;17216
130320;201512;2928;10441;2662;10056;388;1571;1848;7122;2236;8693
130330;201512;3571;13015;3266;12625;232;1092;2697;10385;2929;11477
130340;201512;17585;67487;16323;65879;2767;11090;12088;50352;14855;61442
130350;201512;3265;13633;3180;13508;296;1619;2602;10925;2898;12544
130353;201512;6086;18563;5269;17491;1210;3934;3155;11213;4365;15147
130356;201512;4554;16341;4272;15922;429;1545;3327;12853;3756;14398
130360;201512;3292;9259;2892;8824;156;415;2609;8132;2765;8547
130370;201512;5269;20651;4472;19540;269;1538;3547;15509;3816;17047
130380;201512;7706;31899;7380;31430;519;2522;6284;26944;6803;29466
130390;201512;4870;21660;4512;21008;492;2571;3328;15714;3820;18285
130395;201512;2095;7502;1837;6959;307;1264;1150;4296;1457;5560
130400;201512;2089;7969;1995;7841;157;749;1738;6789;1895;7538
130406;201512;10714;40515;9598;38853;2189;9150;5892;24533;8081;33683
130410;201512;3900;14946;3508;14214;1063;4577;1547;6489;2610;11066
130420;201512;10522;44323;10011;43521;2583;10863;6361;29160;8944;40023
130423;201512;3247;12596;3032;12290;278;1374;2514;10111;2792;11485
130426;201512;2176;9461;2098;9325;272;1283;1602;7251;1874;8534
130430;201512;3339;11892;3204;11690;379;1467;2489;9153;2868;10620
130440;201512;3511;12797;3328;12581;272;1072;2823;10771;3095;11843
140002;201512;1672;5436;1542;5251;152;543;1105;3806;1257;4349
140005;201512;3111;9081;2952;8904;98;247;2794;8497;2892;8744
140010;201512;54806;160183;44851;144754;11238;38559;19517;65093;30755;103652
140015;201512;2928;9352;2732;9103;306;883;2198;7612;2504;8495
140017;201512;3260;10184;2937;9776;293;913;2244;7753;2537;8666
140020;201512;4473;15168;4066;14579;654;2544;2787;9992;3441;12536
140023;201512;2151;7253;1872;6817;242;974;1300;4776;1542;5750
140028;201512;2125;5859;1976;5648;286;893;1400;3827;1686;4720
140030;201512;3732;11758;3505;11441;513;1404;2546;8675;3059;10079
140040;201512;1739;8107;1680;7972;122;725;1401;6619;1523;7344
140045;201512;2514;9235;2268;8876;457;1677;1467;6178;1924;7855
140047;201512;5535;15901;4874;14948;1351;4188;2279;7454;3630;11642
140050;201512;1472;4589;1318;4388;330;1116;734;2491;1064;3607
140060;201512;1514;4616;1344;4352;275;951;843;2749;1118;3700
140070;201512;1465;7873;1409;7692;110;743;1131;6146;1241;6889
150010;201512;34333;105521;32252;102698;2149;7335;26194;83726;28343;91061
150013;201512;1683;4924;1533;4749;169;513;1198;3791;1367;4304
150020;201512;12469;41681;12005;41029;1292;4182;9768;34144;11060;38326
150030;201512;7017;30057;6775;29679;828;3281;5370;24480;6198;27761
150034;201512;4292;11776;4028;11443;228;653;3533;10080;3761;10733
150040;201512;12824;41209;10883;38869;2053;6676;7490;28788;9543;35464
150050;201512;5745;22327;5500;21900;335;1608;4675;18628;5010;20236
150060;201512;17421;54548;15795;51942;3005;9787;10038;34006;13043;43793
150070;201512;5963;24280;5326;23598;337;1651;4696;21004;5033;22655
150080;201512;70247;182606;59289;167783;11886;32729;33707;99515;45593;132244
150085;201512;5361;18218;5071;17835;518;1557;4166;15221;4684;16778
150090;201512;10049;38557;9499;37747;965;3881;7365;29946;8330;33827
150095;201512;5271;17324;4792;16607;420;1364;3799;13604;4219;14968
150100;201512;3308;12278;3103;11916;184;893;2478;9346;2662;10239
150110;201512;3283;16337;3271;16308;276;1346;2792;14167;3068;15513
150120;201512;6258;23594;6091;23311;620;2293;4913;19199;5533;21492
150125;201512;753;2177;658;2061;116;407;431;1321;547;1728
150130;201512;21867;66256;20151;63805;2470;7544;14870;48329;17340;55873
150140;201512;157568;443960;147689;430727;17259;49426;113418;335636;130677;385062
150145;201512;4547;14421;4114;13861;618;2188;3063;10505;3681;12693
150150;201512;11873;36196;10801;34534;1922;6442;6932;22414;8854;28856
150157;201512;3129;9355;2704;8749;387;1417;1856;6064;2243;7481
150160;201512;3081;9902;2872;9598;951;3218;1419;4902;2370;8120
150170;201512;21819;80101;20484;77888;3307;12738;14166;54888;17473;67626
150172;201512;3075;10492;2690;9835;446;1647;1803;6769;2249;8416
150175;201512;1968;5916;1830;5757;164;527;1485;4828;1649;5355
150178;201512;10168;31496;8955;30063;1210;4309;6321;21844;7531;26153
150180;201512;18087;72577;17360;71611;1503;6813;14371;59836;15874;66649
150190;201512;7009;23506;6684;23046;320;1149;5920;20661;6240;21810
150195;201512;5126;17025;4753;16418;289;1099;4047;14078;4336;15177
150200;201512;5255;16723;5018;16450;133;433;4667;15458;4800;15891
150210;201512;24632;92868;23754;91607;2347;8860;19139;76007;21486;84867
150215;201512;6878;21637;5956;20123;1737;6110;2501;8579;4238;14689
150220;201512;12227;37875;10822;35610;2458;8282;5544;18618;8002;26900
150230;201512;11486;36843;10046;34791;1414;5294;6754;23645;8168;28939
150240;201512;35800;105670;30897;97057;10317;33473;9433;30649;19750;64122
150250;201512;4109;16829;3953;16595;649;2762;2811;12221;3460;14983
150260;201512;2052;8169;1934;7939;407;1672;1157;4895;1564;6567
150270;201512;8708;26528;6879;24186;1808;6629;3735;13449;5543;20078
150275;201512;5893;21371;5575;20834;732;2691;4013;15360;4745;18051
150276;201512;2128;6386;1884;6040;452;1556;1216;3859;1668;5415
150277;201512;4875;15037;4199;14186;796;2817;2793;9684;3589;12501
150280;201512;5811;25911;5610;25461;1127;5189;3669;17144;4796;22333
150285;201512;2775;10947;2598;10607;488;2055;1625;6869;2113;8924
150290;201512;9658;28286;9189;27750;726;1826;7820;24412;8546;26238
150293;201512;9917;26884;7421;23359;2243;7499;2586;8758;4829;16257
150295;201512;7210;21536;5910;19986;1456;5041;3313;11943;4769;16984
150300;201512;1861;6409;1759;6273;137;565;1375;4928;1512;5493
150304;201512;4136;13009;3573;12119;612;2068;2286;8020;2898;10088
150307;201512;6503;21811;6013;21120;429;1490;4961;17582;5390;19072
150309;201512;6241;21401;5663;20569;1245;4487;3496;13374;4741;17861
150310;201512;6039;26110;5798;25723;663;3157;4528;20338;5191;23495
150320;201512;9377;22629;8651;21862;597;1265;7382;19036;7979;20301
150330;201512;13642;46837;12702;45440;1828;6485;9238;34094;11066;40579
150340;201512;2414;7800;2224;7505;283;969;1590;5435;1873;6404
150345;201512;6572;21851;6132;21254;611;2094;4861;17219;5472;19313
150350;201512;7649;24133;7099;23406;1227;3438;5057;17590;6284;21028
150360;201512;21229;65817;18487;62220;3191;10743;12195;42694;15386;53437
150370;201512;9839;35923;9211;35079;1333;4890;6923;27422;8256;32312
150375;201512;2865;12493;2780;12379;254;1111;2346;10650;2600;11761
150380;201512;9936;28731;8750;27081;620;1979;7200;22544;7820;24523
150390;201512;7867;33734;7329;32714;1346;5899;4697;21833;6043;27732
150400;201512;5793;22955;5532;22418;517;2108;4318;17890;4835;19998
150405;201512;8232;24749;7310;23614;1372;3678;4871;17355;6243;21033
150410;201512;1549;5942;1445;5720;204;921;890;3518;1094;4439
150420;201512;36882;123376;30827;113104;9493;37910;10253;38892;19746;76802
150430;201512;7140;24214;6786;23641;964;3271;4905;17565;5869;20836
150440;201512;5380;18711;5148;18387;933;3190;3631;13420;4564;16610
150442;201512;21068;61197;18629;57436;3568;11000;11210;35631;14778;46631
150445;201512;5148;17801;4769;17148;661;2364;3448;12685;4109;15049
150450;201512;4342;20877;4182;20632;370;1879;3432;17255;3802;19134
150460;201512;6542;25120;6017;24481;377;1934;5066;20942;5443;22876
150470;201512;17261;52884;16572;52067;508;1312;15486;49309;15994;50621
150475;201512;2916;10134;2685;9829;265;983;2151;8034;2416;9017
150480;201512;13701;46694;12679;45145;1334;4956;9995;36074;11329;41030
150490;201512;6829;26373;6670;26129;307;1330;5865;23188;6172;24518
150495;201512;4862;18179;4737;18009;240;982;4290;16378;4530;17360
150497;201512;2797;10165;2513;9591;806;3268;1136;4339;1942;7607
150500;201512;3141;8693;2913;8372;289;825;2251;6447;2540;7272
150503;201512;3828;11758;3274;11060;1108;3853;1645;5804;2753;9657
150506;201512;11572;39888;10432;38233;2515;8846;6315;24713;8830;33559
150510;201512;9595;37619;8789;36032;1429;5974;5758;24540;7187;30514
150520;201512;6640;26125;6520;25959;270;1052;6022;24201;6292;25253
150530;201512;12204;41668;10936;39714;1185;4077;8310;30853;9495;34930
150540;201512;4631;14138;4135;13427;302;990;3361;10932;3663;11922
150543;201512;5646;17445;4982;16458;1058;3595;3008;10223;4066;13818
150548;201512;9202;29216;8596;28442;572;1773;7602;25523;8174;27296
150549;201512;2080;6624;1906;6422;90;331;1706;5802;1796;6133
150550;201512;20075;63062;17390;58432;5212;18056;6761;23384;11973;41440
150553;201512;23252;79602;19078;70724;6997;27744;4601;17107;11598;44851
150555;201512;1685;5120;1439;4708;103;390;1103;3603;1206;3993
150560;201512;1957;6336;1825;6061;284;932;1162;3856;1446;4788
150563;201512;2882;9312;2654;8914;655;2406;1443;4804;2098;7210
150565;201512;3785;12988;3441;12454;217;991;2792;10149;3009;11140
150570;201512;5622;20878;5475;20610;414;1818;4390;16590;4804;18408
150580;201512;9479;39788;9233;39493;655;2731;8049;35200;8704;37931
150590;201512;5681;22709;5476;22442;167;767;5054;20791;5221;21558
150600;201512;7834;30324;7516;29850;426;1793;6591;26441;7017;28234
150610;201512;2373;8071;2165;7636;251;973;1482;5169;1733;6142
150611;201512;2709;9385;2528;9033;209;784;2010;7227;2219;8011
150613;201512;12209;36795;10155;33626;3327;11604;4059;13728;7386;25332
150616;201512;3076;9323;2362;8136;587;2227;818;2669;1405;4896
150618;201512;6419;21937;5833;20864;1639;6009;2885;10532;4524;16541
150619;201512;5219;17746;4824;17114;610;2346;3433;12226;4043;14572
150620;201512;6353;22733;5791;21988;774;2983;4419;17195;5193;20178
150630;201512;5738;17303;5422;16924;611;1968;4343;13831;4954;15799
150635;201512;4064;13191;3630;12318;869;3069;1711;5904;2580;8973
150640;201512;1772;5372;1707;5290;238;683;1347;4410;1585;5093
150650;201512;12474;37443;10974;34788;2976;9527;4810;15822;7786;25349
150655;201512;4925;16502;4640;15971;688;2411;3297;11509;3985;13920
150658;201512;4415;13420;3861;12647;936;3337;2224;7421;3160;10758
150660;201512;5536;17377;5008;16601;1189;3917;2726;9349;3915;13266
150670;201512;7029;18970;5870;17501;838;2606;4381;13383;5219;15989
150680;201512;55870;197918;48941;185772;14869;58818;19757;79852;34626;138670
150690;201512;2041;6278;1833;5947;320;959;1181;3966;1501;4925
150700;201512;6210;19215;5651;18472;1040;3453;3672;12356;4712;15809
150710;201512;4256;14317;3800;13562;459;1699;2727;9926;3186;11625
150715;201512;4997;15628;4327;14603;536;2015;3150;10654;3686;12669
150720;201512;6459;26251;6062;25518;818;3589;4336;18816;5154;22405
150730;201512;9811;33289;9142;32172;1069;3817;7140;25680;8209;29497
150740;201512;3709;11824;3306;11085;668;2339;1789;6026;2457;8365
150745;201512;5346;16731;4813;15974;1168;4071;2913;9645;4081;13716
150746;201512;1402;4520;1322;4373;138;461;938;3116;1076;3577
150747;201512;5370;16720;4703;15880;399;1140;3624;13082;4023;14222
150750;201512;3207;10556;2977;10264;215;857;2435;8398;2650;9255
150760;201512;11058;35867;10281;34803;2292;7899;6332;21932;8624;29831
150770;201512;5770;21961;5416;21291;464;1710;4497;18647;4961;20357
150775;201512;1144;3469;992;3190;199;781;532;1634;731;2415
150780;201512;3246;10553;3150;10435;106;374;2898;9631;3004;10005
150790;201512;4962;16146;4590;15700;374;1332;3696;13287;4070;14619
150795;201512;15344;48054;13667;45539;3068;10123;8032;27889;11100;38012
150796;201512;2993;8880;2713;8549;399;1277;2011;6481;2410;7758
150797;201512;3653;12457;3363;11955;121;517;2853;10126;2974;10643
150800;201512;13774;45416;12619;43986;2751;9053;8303;30592;11054;39645
150803;201512;6509;23600;6096;22924;703;2783;4463;16985;5166;19768
150805;201512;2620;9316;2438;9007;346;1274;1734;6523;2080;7797
150808;201512;5776;19143;4727;17110;1883;7403;743;2687;2626;10090
150810;201512;19162;59025;16057;55193;2383;7820;10746;39085;13129;46905
150812;201512;5265;16513;4816;15724;522;1996;3378;10639;3900;12635
150815;201512;8475;27640;7575;26490;825;2890;5982;21401;6807;24291
150820;201512;11369;32384;10066;30928;746;1725;8330;26425;9076;28150
150830;201512;12990;48435;11954;46899;749;3647;9815;39422;10564;43069
150835;201512;2116;7410;1945;7076;482;1766;914;3440;1396;5206
150840;201512;6916;21011;5669;18922;1343;4910;2716;8971;4059;13881
160005;201512;740;2589;696;2504;66;279;549;1940;615;2219
160010;201512;1364;4534;1360;4529;68;144;1265;4323;1333;4467
160015;201512;1687;6232;1649;6177;91;329;1485;5663;1576;5992
160020;201512;2029;7179;1880;6973;242;917;1392;5295;1634;6212
160021;201512;949;4105;914;4042;152;777;627;2785;779;3562
160023;201512;1029;4099;1015;4074;104;421;841;3407;945;3828
160025;201512;1283;3940;1268;3924;29;108;1223;3769;1252;3877
160027;201512;8175;24407;7527;23683;2635;7831;3862;13231;6497;21062
160030;201512;45537;160803;40356;151342;9862;37230;21711;85726;31573;122956
160040;201512;4298;16755;4194;16603;201;1081;3794;14819;3995;15900
160050;201512;3201;12129;2855;11603;1440;5786;884;3936;2324;9722
160053;201512;2783;10692;2712;10585;540;2217;1840;7265;2380;9482
160055;201512;632;2465;622;2453;77;323;481;1905;558;2228
160060;201512;15612;52646;14621;51518;3012;10049;9845;36138;12857;46187
160070;201512;2516;9883;2374;9631;198;946;1986;8000;2184;8946
160080;201512;2604;9769;2567;9724;110;535;2381;8934;2491;9469
170025;201512;526;1730;479;1658;136;478;232;844;368;1322
170030;201512;1173;3797;1019;3512;303;1085;368;1289;671;2374
170035;201512;1529;4388;1207;3797;305;1061;462;1419;767;2480
170040;201512;1892;5989;1670;5697;221;862;1050;3755;1271;4617
170070;201512;1820;4764;1422;4232;311;1013;759;2214;1070;3227
170100;201512;2459;7176;2131;6655;250;811;1629;5103;1879;5914
170105;201512;765;2378;596;2029;123;487;291;936;414;1423
170110;201512;1050;3278;884;2996;202;744;387;1304;589;2048
170130;201512;1368;4284;1141;3853;323;1137;499;1713;822;2850
170190;201512;1597;4633;1184;3944;448;1447;242;903;690;2350
170200;201512;1651;4599;1051;3433;275;984;259;790;534;1774
170210;201512;32031;90611;25325;79573;7434;25176;6936;22597;14370;47773
170215;201512;1189;3704;1002;3410;87;365;715;2395;802;2760
170220;201512;5718;19598;5245;18654;1276;4749;2672;9559;3948;14308
170230;201512;1443;4569;1186;4066;244;963;530;1727;774;2690
170240;201512;2689;8142;2235;7433;294;1153;1489;4890;1783;6043
170255;201512;3398;10818;2820;9811;859;3025;1167;4234;2026;7259
170270;201512;1034;2566;707;2118;72;227;475;1412;547;1639
170290;201512;2840;8537;2567;8221;208;478;2169;7319;2377;7797
170300;201512;1956;5962;1616;5396;214;807;1025;3421;1239;4228
170305;201512;779;2305;614;1997;117;424;304;985;421;1409
170307;201512;1087;3794;900;3435;188;823;430;1678;618;2501
170310;201512;1636;4493;1219;3774;325;1069;528;1655;853;2724
170320;201512;1144;3278;813;2696;208;736;263;881;471;1617
170330;201512;768;2496;698;2381;84;318;516;1730;600;2048
170360;201512;466;1480;383;1334;89;328;171;578;260;906
170370;201512;1394;3941;1089;3446;214;771;556;1722;770;2493
170380;201512;1806;5744;1443;5141;245;1005;754;2644;999;3649
170382;201512;557;1823;471;1679;97;391;271;951;368;1342
170384;201512;1567;6315;1434;6053;331;1501;771;3265;1102;4766
170386;201512;923;2747;789;2542;193;694;338;1068;531;1762
170388;201512;646;1909;517;1691;109;419;195;603;304;1022
170389;201512;922;3079;830;2924;86;345;603;2101;689;2446
170390;201512;1287;3715;1107;3488;111;372;843;2705;954;3077
170410;201512;549;1723;461;1565;44;174;293;987;337;1161
170460;201512;502;1354;338;1076;77;277;111;336;188;613
170510;201512;794;2624;637;2325;82;349;326;1164;408;1513
170550;201512;6849;19430;5008;16160;1597;5655;750;2347;2347;8002
170555;201512;1358;3893;1059;3428;217;751;511;1693;728;2444
170560;201512;1030;3387;803;3082;172;712;446;1796;618;2508
170600;201512;1347;3895;1194;3685;270;827;753;2404;1023;3231
170610;201512;1596;4883;1264;4340;143;556;780;2681;923;3237
170625;201512;435;1327;328;1118;61;205;93;326;154;531
170650;201512;1251;4017;1059;3658;265;1000;416;1494;681;2494
170700;201512;4119;12882;3319;11525;707;2669;1421;5086;2128;7755
170710;201512;1834;5376;1461;4691;236;798;853;2765;1089;3563
170720;201512;1862;5012;1562;4527;288;739;1044;3197;1332;3936
170730;201512;1017;2922;823;2622;219;728;349;1127;568;1855
170740;201512;2219;7753;1912;7188;298;1173;1219;4632;1517;5805
170755;201512;807;2479;649;2134;133;505;247;779;380;1284
170765;201512;1364;3659;1042;3121;294;940;410;1247;704;2187
170770;201512;1747;5865;1582;5572;261;979;962;3407;1223;4386
170820;201512;3670;11641;3264;10965;744;2642;1553;5293;2297;7935
170825;201512;733;2171;583;1875;106;357;251;784;357;1141
170830;201512;1405;4097;1212;3799;130;328;994;3238;1124;3566
170900;201512;2574;9072;2430;8827;230;854;1928;7124;2158;7978
170930;201512;3762;11401;3228;10484;927;3187;1257;4172;2184;7359
170950;201512;14025;40298;10164;33367;3097;11569;1818;5737;4915;17306
170980;201512;507;1509;381;1295;84;321;156;498;240;819
171050;201512;1481;5011;1324;4710;100;450;1042;3654;1142;4104
171070;201512;1528;4767;1388;4553;363;1188;720;2447;1083;3635
171090;201512;1044;2845;863;2585;66;187;629;1891;695;2078
171110;201512;609;1782;454;1495;123;437;192;595;315;1032
171150;201512;855;2445;613;2016;104;381;358;1176;462;1557
171180;201512;701;2109;483;1656;116;420;187;684;303;1104
171190;201512;1671;6122;1463;5676;305;1248;693;2796;998;4044
171195;201512;820;2902;707;2677;102;429;407;1563;509;1992
171200;201512;686;2166;548;1897;164;624;179;565;343;1189
171215;201512;461;1372;354;1155;58;207;155;514;213;721
171240;201512;726;2588;667;2470;90;391;430;1634;520;2025
171245;201512;640;2100;514;1798;110;437;167;549;277;986
171250;201512;1091;3141;865;2755;151;539;493;1498;644;2037
171270;201512;417;1705;389;1642;132;528;143;687;275;1215
171280;201512;883;2672;729;2410;184;596;321;1158;505;1754
171320;201512;3890;11681;3294;10635;926;2993;1419;4693;2345;7686
171330;201512;2923;8470;2365;7583;668;2281;999;3161;1667;5442
171360;201512;1451;4690;1274;4412;185;640;839;2968;1024;3608
171370;201512;671;1922;575;1785;133;456;300;910;433;1366
171380;201512;1340;4275;1118;3863;425;1483;343;1229;768;2712
171395;201512;904;2717;698;2315;144;566;329;1038;473;1604
171420;201512;2277;6827;1708;5768;424;1522;624;2085;1048;3607
171430;201512;1057;3232;872;2923;201;677;435;1461;636;2138
171488;201512;2498;7570;2155;7068;492;1612;1165;3968;1657;5580
171500;201512;802;2436;694;2252;109;345;452;1513;561;1858
171510;201512;906;3154;808;2984;75;321;581;2167;656;2488
171515;201512;500;1426;392;1238;63;197;212;661;275;858
171525;201512;636;2039;532;1857;97;386;286;953;383;1339
171550;201512;315;1060;242;917;83;351;46;177;129;528
171570;201512;1250;3910;1088;3589;211;692;703;2343;914;3035
171575;201512;1916;5383;1445;4527;288;927;645;2053;933;2980
171610;201512;5418;17195;4490;15523;1202;4639;1496;5088;2698;9727
171620;201512;2571;7550;2239;7092;112;439;1872;5945;1984;6384
171630;201512;920;2868;754;2593;238;891;307;1043;545;1934
171650;201512;2219;6793;1711;5764;463;1689;580;1909;1043;3598
171660;201512;2477;6828;1896;5784;243;828;1120;3403;1363;4231
171665;201512;1503;4368;1205;3905;187;670;693;2321;880;2991
171670;201512;1979;5551;1632;4975;452;1516;688;2005;1140;3521
171700;201512;1105;3568;947;3269;140;547;605;2049;745;2596
171720;201512;717;2102;592;1888;211;666;222;746;433;1412
171750;201512;1214;3726;943;3177;269;928;294;995;563;1923
171780;201512;1156;3168;878;2764;104;353;515;1659;619;2012
171790;201512;1490;4988;1284;4658;270;947;783;3012;1053;3959
171800;201512;666;2073;589;1968;82;311;398;1355;480;1666
171820;201512;10196;29938;8519;27456;1712;6010;4548;14703;6260;20713
171830;201512;1416;5230;1267;4895;315;1207;576;2265;891;3472
171840;201512;793;2166;675;1998;48;145;544;1627;592;1772
171845;201512;745;2041;571;1746;95;320;293;896;388;1216
171850;201512;958;3394;843;3159;106;468;524;1934;630;2402
171855;201512;1140;3573;1029;3362;92;362;763;2428;855;2790
171865;201512;468;1499;398;1379;85;314;192;653;277;967
171870;201512;739;2204;585;1924;144;520;212;730;356;1250
171875;201512;1323;4156;1099;3794;118;497;744;2512;862;3009
171880;201512;819;3047;797;3011;87;341;631;2438;718;2779
171884;201512;966;2676;689;2263;164;598;192;734;356;1332
171886;201512;1447;4683;1144;4032;344;1337;283;935;627;2272
171888;201512;704;2095;541;1774;59;190;302;1025;361;1215
171889;201512;502;1597;451;1512;99;352;238;811;337;1163
171890;201512;1209;3739;1004;3427;151;567;580;1965;731;2532
171900;201512;490;1821;430;1703;116;468;202;804;318;1272
172000;201512;563;1863;484;1709;74;286;274;961;348;1247
172010;201512;1198;4130;1106;3975;130;561;800;2861;930;3422
172015;201512;334;1306;277;1194;57;234;153;696;210;930
172020;201512;2275;7544;2101;7260;281;1009;1448;5087;1729;6096
172025;201512;717;2074;529;1744;90;325;265;898;355;1223
172030;201512;1153;3739;1017;3505;75;326;754;2567;829;2893
172049;201512;1335;3509;990;2924;163;476;721;2183;884;2659
172065;201512;1314;3524;1100;3281;67;191;988;3006;1055;3197
172080;201512;2512;7728;2109;7013;228;877;1342;4410;1570;5287
172085;201512;529;1434;373;1131;57;161;109;328;166;489
172090;201512;3435;9913;2800;8943;246;867;2127;6866;2373;7733
172093;201512;602;1823;468;1597;129;515;220;738;349;1253
172097;201512;667;1968;530;1746;124;406;212;730;336;1136
172100;201512;32982;98655;25017;83982;7092;26470;6550;21619;13642;48089
172110;201512;1678;6231;1488;5916;185;814;1051;4275;1236;5089
172120;201512;5225;15988;4284;14665;650;2247;2799;9849;3449;12096
172125;201512;269;838;224;756;40;159;102;340;142;499
172130;201512;558;1541;443;1352;41;153;294;908;335;1061
172208;201512;2148;6368;1919;6028;340;1095;1095;3502;1435;4597
172210;201512;2529;7746;2215;7269;561;1987;1122;3615;1683;5602
210005;201512;21816;67530;18261;61965;5774;21012;6766;23069;12540;44081
210010;201512;1571;5684;1403;5381;131;551;1057;4116;1188;4667
210015;201512;3318;10529;2961;9989;212;588;2494;8660;2706;9248
210020;201512;7011;17026;6573;16496;217;576;5975;14926;6192;15502
210030;201512;5525;18383;5157;17874;351;1568;4236;14568;4587;16136
210040;201512;1883;5224;1731;5047;111;325;1486;4356;1597;4681
210043;201512;6577;18624;5669;17465;588;1710;4132;13339;4720;15049
210047;201512;6534;24678;5953;23698;647;2959;4383;17428;5030;20387
210050;201512;2344;8534;1916;7703;685;2817;649;2785;1334;5602
210055;201512;1725;5875;1570;5649;182;678;1172;4279;1354;4957
210060;201512;7259;27859;6698;26820;1000;4157;4363;17897;5363;22054
210070;201512;7002;20690;6457;20010;167;649;5798;18011;5965;18660
210080;201512;3659;12630;3559;12499;52;252;3354;11762;3406;12014
210083;201512;4319;15083;3973;14713;136;584;3718;13832;3854;14416
210087;201512;2885;8532;2620;8184;294;949;2061;6538;2355;7487
210090;201512;9896;32393;9367;31540;549;1987;7982;26992;8531;28979
210095;201512;5954;21609;5714;21270;406;1597;4729;17839;5135;19436
210100;201512;7189;21658;6601;20934;865;2917;4980;15724;5845;18641
210110;201512;2861;9947;2759;9806;113;520;2472;8739;2585;9259
210120;201512;26015;70820;22283;66413;2834;7151;16344;51751;19178;58902
210125;201512;3532;11203;3383;11045;229;603;2955;9929;3184;10532
210130;201512;4105;12159;3806;11728;298;944;3110;9596;3408;10540
210135;201512;1678;4934;1465;4635;112;374;1173;3730;1285;4104
210140;201512;17083;54209;14720;50941;2772;10021;9107;32572;11879;42593
210150;201512;4565;11229;4085;10636;75;185;3820;9960;3895;10145
210160;201512;17541;55121;16442;53496;1505;4407;13214;44274;14719;48681
210170;201512;13799;49004;13411;48502;758;2760;11871;43455;12629;46215
210173;201512;1929;7974;1841;7812;121;716;1584;6567;1705;7283
210177;201512;3045;9421;2877;9225;168;568;2553;8243;2721;8811
210180;201512;1480;4531;1380;4382;63;229;1164;3656;1227;3885
210190;201512;4835;15374;4419;14599;235;1013;3433;11087;3668;12100
210193;201512;1391;4368;1250;4135;75;263;1028;3449;1103;3712
210197;201512;2091;6911;1926;6723;243;821;1471;5312;1714;6133
210200;201512;8537;28425;7890;27486;1133;3697;5789;21058;6922;24755
210203;201512;6518;20887;6179;20438;439;1252;5288;17820;5727;19072
210207;201512;2963;9677;2758;9295;354;1150;1954;6754;2308;7904
210210;201512;8488;28453;8022;27831;103;444;7403;26043;7506;26487
210215;201512;1251;5064;1195;4976;103;494;962;4030;1065;4524
210220;201512;6046;23044;5731;22524;412;1796;4705;18664;5117;20460
210230;201512;5092;16734;4779;16233;287;1001;4062;13933;4349;14934
210232;201512;12826;41205;10660;38447;1566;5905;6989;26836;8555;32741
210235;201512;3585;11239;3200;10744;203;801;2691;9059;2894;9860
210237;201512;2362;9023;2294;8921;55;295;2154;8354;2209;8649
210240;201512;3035;9522;2832;9238;171;520;2347;7738;2518;8258
210250;201512;5103;16425;4801;16030;134;642;4344;14382;4478;15024
210255;201512;2541;8155;2309;7733;335;1192;1634;5492;1969;6684
210260;201512;5220;16814;4725;16080;638;2113;3427;12009;4065;14122
210270;201512;5430;15244;4749;14292;132;601;4179;12443;4311;13044
210275;201512;3624;8748;3419;8527;55;81;3316;8364;3371;8445
210280;201512;5590;16801;4843;15795;308;1268;3716;11913;4024;13181
210290;201512;5630;18657;5181;18106;369;1269;4349;15430;4718;16699
210300;201512;37697;105252;30849;96766;2222;7353;23554;76540;25776;83893
210310;201512;2890;8149;2653;7835;85;198;2342;6980;2427;7178
210312;201512;2195;6952;2082;6795;65;305;1845;5979;1910;6284
210315;201512;2568;8549;2377;8285;164;647;2021;7089;2185;7736
210317;201512;4217;12735;4004;12471;198;694;3592;11204;3790;11898
210320;201512;19086;60293;17486;58346;977;3459;14868;50166;15845;53625
210325;201512;3574;11179;3170;10565;284;1063;2411;8104;2695;9167
210330;201512;36586;88200;28144;79163;4195;9909;18647;59136;22842;69045
210340;201512;11736;35339;10643;33926;1242;3413;7783;26593;9025;30006
210350;201512;10004;30758;9007;29353;695;2226;7159;23670;7854;25896
210355;201512;3889;14229;3568;13750;235;986;3021;11868;3256;12854
210360;201512;16204;48879;14710;46759;1140;3945;11579;36875;12719;40820
210370;201512;9350;22382;7800;20717;288;567;6933;19015;7221;19582
210375;201512;3116;9475;2629;8823;789;2725;1232;4278;2021;7003
210380;201512;6084;16878;5349;15851;445;1197;4344;13142;4789;14339
210390;201512;2832;10159;2573;9740;140;751;2169;8153;2309;8904
210400;201512;4881;15270;4658;15011;156;453;4342;14155;4498;14608
210405;201512;8376;22890;6654;20419;2204;6822;2324;7895;4528;14717
210407;201512;2053;7264;1772;6790;206;783;1272;5009;1478;5792
210408;201512;2394;9235;2231;9025;152;691;1880;7842;2032;8533
210409;201512;3721;13594;3498;13253;224;1067;2860;10847;3084;11914
210410;201512;3509;11626;3392;11484;354;1055;2741;9712;3095;10767
210420;201512;4032;13273;3678;12656;282;932;2945;10324;3227;11256
210430;201512;2176;6714;2097;6621;120;375;1828;5803;1948;6178
210440;201512;3991;12524;3866;12355;208;613;3489;11288;3697;11901
210450;201512;2841;8891;2525;8423;164;575;2017;6694;2181;7269
210455;201512;4126;11881;3625;11116;581;1758;2504;8000;3085;9758
210460;201512;3669;11996;3411;11585;190;756;2820;9572;3010;10328
210462;201512;1494;5396;1388;5192;95;442;1103;4115;1198;4557
210465;201512;2555;8444;2370;8177;220;635;1965;6989;2185;7624
210467;201512;6172;20455;5720;19914;444;1585;4758;16768;5202;18353
210470;201512;2066;5572;1569;4849;91;258;1169;3669;1260;3927
210480;201512;14285;46103;12397;43648;2665;9114;7770;29276;10435;38390
210490;201512;3566;10045;3123;9417;155;510;2613;7855;2768;8365
210500;201512;6383;26047;6127;25581;787;3237;4552;19586;5339;22823
210510;201512;6493;22126;6169;21732;374;1174;5240;18992;5614;20166
210515;201512;3641;11680;3478;11494;102;312;3251;10880;3353;11192
210520;201512;2612;7953;2355;7578;160;489;1994;6510;2154;6999
210530;201512;36697;112837;29475;101770;7563;29326;12473;43943;20036;73269
210535;201512;3213;11053;3074;10853;109;368;2766;9895;2875;10263
210540;201512;13475;44212;11692;41586;2640;9104;6489;24935;9129;34039
210542;201512;5832;16761;5335;16222;343;800;4601;14430;4944;15230
210545;201512;2284;7458;2166;7264;64;320;1887;6262;1951;6582
210547;201512;3799;13383;3534;12936;292;983;2774;10418;3066;11401
210550;201512;6145;18200;5635;17672;278;657;5138;16573;5416;17230
210560;201512;4146;12914;3686;12132;217;792;3083;10108;3300;10900
210565;201512;1489;5267;1277;4928;111;559;934;3614;1045;4173
210570;201512;12446;35080;11218;33680;862;1931;9527;29683;10389;31614
210580;201512;3151;9415;2815;8985;330;795;2135;7422;2465;8217
210590;201512;4092;12805;3791;12437;321;1114;3172;10447;3493;11561
210592;201512;2436;7667;2338;7506;47;209;2072;6637;2119;6846
210594;201512;2703;7568;2201;6830;114;323;1739;5523;1853;5846
210596;201512;2701;10008;2546;9710;287;1174;1881;7266;2168;8440
210598;201512;1919;5886;1761;5689;102;378;1511;4830;1613;5208
210600;201512;3225;9331;2817;8773;203;655;2229;6915;2432;7570
210610;201512;2514;8274;2335;8043;134;581;2017;6851;2151;7432
210620;201512;1923;6174;1788;5997;56;164;1628;5544;1684;5708
210630;201512;3723;13014;3257;12221;374;1602;2191;8307;2565;9909
210632;201512;4531;15787;4228;15324;450;1760;3253;11822;3703;13582
210635;201512;1913;6622;1815;6474;131;439;1562;5676;1693;6115
210637;201512;2713;9104;2491;8795;161;628;2023;7201;2184;7829
210640;201512;4203;15162;4121;15070;12;49;4019;14819;4031;14868
210650;201512;6874;20899;6666;20640;270;851;6227;19345;6497;20196
210660;201512;7959;23771;7312;22819;262;937;6677;20756;6939;21693
210663;201512;2703;8012;2527;7795;193;686;2092;6451;2285;7137
210667;201512;1812;6345;1712;6191;91;399;1467;5333;1558;5732
210670;201512;4431;16459;4209;16090;243;1082;3477;13388;3720;14470
210675;201512;5005;13953;4599;13453;361;928;3829;11489;4190;12417
210680;201512;4110;11317;3645;10752;202;531;3129;9338;3331;9869
210690;201512;7220;24250;6923;23924;294;954;6142;21838;6436;22792
210700;201512;2611;7797;2420;7588;406;968;1686;6062;2092;7030
210710;201512;4783;15721;4506;15281;228;960;3791;12779;4019;13739
210720;201512;2556;9307;2406;9090;146;672;2110;7913;2256;8585
210725;201512;1095;4113;961;3865;130;565;599;2445;729;3010
210730;201512;1115;3538;995;3362;108;311;755;2621;863;2932
210735;201512;4134;14380;3762;13744;670;2473;2523;9545;3193;12018
210740;201512;4958;14669;4679;14379;223;955;4207;12632;4430;13587
210745;201512;3871;11486;3613;11142;258;683;3029;9451;3287;10134
210750;201512;20756;55618;18063;52549;2076;5986;13852;41204;15928;47190
210760;201512;5909;16674;5488;16217;43;147;5341;15808;5384;15955
210770;201512;5910;16178;5128;15277;137;539;4656;13821;4793;14360
210780;201512;8431;27790;7667;26444;864;3066;5485;19307;6349;22373
210790;201512;4648;14615;4202;14085;287;740;3443;12165;3730;12905
210800;201512;4742;13507;4281;12944;164;487;3788;11575;3952;12062
210805;201512;3678;15416;3542;15171;174;900;3041;13123;3215;14023
210810;201512;5374;16413;4973;15911;404;841;4215;14155;4619;14996
210820;201512;7870;22626;7155;21595;1204;3509;4788;14827;5992;18336
210825;201512;5665;19483;5385;19091;656;2229;4149;15129;4805;17358
210830;201512;8348;24652;7919;24131;850;2251;6343;20068;7193;22319
210840;201512;3665;10050;3267;9447;177;448;2695;7827;2872;8275
210845;201512;5759;17588;5554;17363;104;231;5304;16840;5408;17071
210850;201512;6054;21570;5487;20590;770;3266;3708;13889;4478;17155
210860;201512;17627;52436;15809;49930;1406;4455;12329;39474;13735;43929
210870;201512;5900;19641;5368;18971;603;2082;4098;14738;4701;16820
210880;201512;4299;13907;4092;13631;340;1250;3346;11160;3686;12410
210890;201512;5302;15478;4794;14884;565;1574;3823;12387;4388;13961
210900;201512;4967;14853;4021;13256;1429;4947;1085;3772;2514;8719
210905;201512;1835;5768;1658;5517;159;409;1286;4473;1445;4882
210910;201512;8722;27491;7855;26071;1201;4277;5279;17586;6480;21863
210920;201512;2974;10533;2829;10291;182;791;2330;8451;2512;9242
210923;201512;1517;5187;1394;5001;161;638;938;3458;1099;4096
210927;201512;4819;15335;4572;15066;66;264;4384;14483;4450;14747
210930;201512;2475;9029;2335;8827;145;805;1964;7250;2109;8055
210940;201512;2830;10941;2763;10819;194;843;2332;9126;2526;9969
210945;201512;5849;17617;5643;17397;273;372;5264;16709;5537;17081
210950;201512;5337;16362;4617;15214;448;1489;3449;11581;3897;13070
210955;201512;1899;6116;1663;5762;201;688;1145;4134;1346;4822
210960;201512;8700;28405;8299;27850;2203;7217;4749;16854;6952;24071
210970;201512;1366;4857;1204;4591;164;725;831;3152;995;3877
210975;201512;1767;5915;1682;5767;134;487;1336;4597;1470;5084
210980;201512;9906;23563;9573;23218;888;1762;8215;20605;9103;22367
210990;201512;16775;50664;13490;46139;3114;11157;6902;24412;10016;35569
211000;201512;15485;49768;13698;47598;833;3490;11393;39943;12226;43433
211003;201512;4826;17091;4359;16415;336;1541;3310;12716;3646;14257
211010;201512;6490;23469;6230;23162;101;448;5904;22081;6005;22529
211020;201512;7396;23921;7140;23515;633;2211;5817;19126;6450;21337
211023;201512;2253;7599;2172;7464;185;690;1763;6082;1948;6772
211027;201512;2921;11246;2829;11097;315;1276;2230;8874;2545;10150
211030;201512;3898;11949;3628;11663;585;1391;2746;9571;3331;10962
211040;201512;4319;16326;4141;16039;153;815;3612;14048;3765;14863
211050;201512;10162;26392;9813;26005;364;853;9071;24140;9435;24993
211060;201512;6055;21485;5867;21211;481;1815;5003;18276;5484;20091
211065;201512;1874;6221;1709;6009;81;269;1551;5543;1632;5812
211070;201512;8109;27750;7438;26638;445;1712;6162;22309;6607;24021
211080;201512;1386;4176;1153;3836;88;406;877;2809;965;3215
211085;201512;1891;6483;1709;6164;318;1185;1076;3934;1394;5119
211090;201512;3520;10357;3278;10024;134;543;2810;8457;2944;9000
211100;201512;6630;17027;6463;16847;41;134;6307;16446;6348;16580
211102;201512;3052;11384;2876;11136;251;982;2394;9441;2645;10423
211105;201512;2677;8584;2283;7980;222;874;1695;5867;1917;6741
211107;201512;4459;14173;4007;13564;231;796;3297;11467;3528;12263
211110;201512;6369;18906;5097;16957;1028;3336;3000;10474;4028;13810
211120;201512;35597;97648;31457;92672;5695;16056;21167;64899;26862;80955
211125;201512;2091;6639;1856;6267;124;470;1535;5194;1659;5664
211130;201512;134388;373954;121096;356953;23067;67969;76020;228920;99087;296889
211140;201512;5349;17030;4952;16412;202;766;4220;13941;4422;14707
211150;201512;9739;28251;8829;27113;478;1710;7385;22647;7863;24357
211153;201512;2838;8691;2598;8370;405;1236;1928;6416;2333;7652
211157;201512;1214;3882;1041;3620;91;406;698;2489;789;2895
211160;201512;4117;13585;3489;12529;274;1320;2413;8426;2687;9746
211163;201512;1674;5523;1577;5385;45;140;1428;4971;1473;5111
211167;201512;1495;4999;1426;4900;40;186;1329;4562;1369;4748
211170;201512;6382;16832;6086;16481;109;324;5629;15177;5738;15501
211172;201512;2432;7161;2188;6801;146;608;1824;5549;1970;6157
211174;201512;2805;8158;2530;7812;80;384;2260;6868;2340;7252
211176;201512;4353;13491;3756;12706;442;1600;2634;9016;3076;10616
211178;201512;3788;10124;3571;9881;75;196;3397;9398;3472;9594
211180;201512;4279;14939;4013;14524;311;1279;3283;11979;3594;13258
211190;201512;2785;9381;2578;9079;84;398;2236;7881;2320;8279
211195;201512;1472;4476;1216;4155;75;223;1011;3581;1086;3804
211200;201512;2155;7168;1883;6783;380;1297;1129;4352;1509;5649
211210;201512;6867;20955;6494;20436;495;1483;5398;17173;5893;18656
211220;201512;33919;98196;29206;92151;5818;18804;18152;58586;23970;77390
211223;201512;5066;14971;4609;14241;665;2072;3188;9979;3853;12051
211227;201512;1581;5667;1443;5445;146;617;1106;4200;1252;4817
211230;201512;8442;27390;7625;26038;867;3056;5671;19649;6538;22705
211240;201512;8092;27717;7657;27164;295;1258;6851;24143;7146;25401
211245;201512;5402;16083;5362;16041;156;256;5141;15653;5297;15909
211250;201512;13008;43121;12131;42082;1716;4803;9164;34142;10880;38945
211260;201512;8565;26558;8183;26037;570;1959;7154;22719;7724;24678
211270;201512;10266;35216;9102;33710;557;2478;7204;27072;7761;29550
211280;201512;12683;37622;11835;36581;1173;3057;9598;30810;10771;33867
211285;201512;1742;6326;1526;5855;281;1169;776;3067;1057;4236
211290;201512;7203;23687;6925;23326;597;1752;5769;19937;6366;21689
211300;201512;8274;24877;7722;24131;177;510;7170;22611;7347;23121
211400;201512;11642;36477;10302;34596;2851;9784;4803;17666;7654;27450
220005;201512;1823;5264;1656;5007;73;287;1358;3987;1431;4274
220010;201512;1390;4043;1220;3779;71;269;952;2897;1023;3166
220020;201512;3293;10390;3100;10056;624;2040;1895;6160;2519;8200
220025;201512;2203;5458;1985;5127;24;79;1696;4308;1720;4387
220027;201512;1383;3715;1238;3524;74;211;1009;2892;1083;3103
220030;201512;3232;8978;3161;8869;175;585;2761;7651;2936;8236
220040;201512;7652;23798;7085;22767;1497;4828;4321;13875;5818;18703
220045;201512;1419;4613;1286;4355;63;269;979;3246;1042;3515
220050;201512;4457;13361;3885;12393;227;888;3097;9752;3324;10640
220060;201512;1962;5012;1848;4878;53;105;1685;4464;1738;4569
220070;201512;2441;7196;2223;6852;156;490;1788;5507;1944;5997
220080;201512;727;2195;676;2118;59;250;552;1667;611;1917
220090;201512;1816;4597;1535;4230;68;221;1315;3558;1383;3779
220095;201512;733;1983;680;1907;19;76;622;1711;641;1787
220100;201512;1370;4130;1143;3748;97;359;839;2737;936;3096
220105;201512;2231;7102;1979;6622;169;549;1449;4887;1618;5436
220110;201512;3386;9892;3171;9543;137;549;2725;8049;2862;8598
220115;201512;2434;8402;2328;8234;159;645;2022;7112;2181;7757
220117;201512;1316;3498;1077;3135;76;225;870;2534;946;2759
220120;201512;12308;35444;11384;34295;166;730;10703;32110;10869;32840
220130;201512;898;3040;777;2863;65;265;633;2326;698;2591
220140;201512;1641;4415;1451;4181;230;530;1117;3363;1347;3893
220150;201512;7019;21537;6593;20919;194;806;5775;18113;5969;18919
220155;201512;1118;3439;901;3023;53;216;590;1935;643;2151
220157;201512;1052;2676;931;2490;23;72;816;2154;839;2226
220160;201512;2673;7935;2349;7364;103;443;1877;5773;1980;6216
220170;201512;1365;4189;1171;3869;58;268;937;3050;995;3318
220173;201512;2069;6223;1655;5400;48;225;1352;4282;1400;4507
220177;201512;1776;5238;1740;5182;61;216;1622;4814;1683;5030
220180;201512;1144;3128;942;2754;27;98;660;1849;687;1947
220190;201512;4478;14940;4156;14459;639;2261;3029;10598;3668;12859
220191;201512;1409;4682;1327;4542;171;604;946;3205;1117;3809
220192;201512;1818;5108;1428;4411;112;378;1009;3104;1121;3482
220194;201512;1649;4999;1474;4691;118;419;1107;3436;1225;3855
220196;201512;1977;5858;1810;5575;177;596;1381;4242;1558;4838
220198;201512;1339;3801;1038;3406;15;50;969;3224;984;3274
220200;201512;4400;14750;4123;14356;648;2297;2895;10192;3543;12489
220202;201512;2101;6456;1863;6030;45;215;1616;5120;1661;5335
220205;201512;2798;7295;2500;6874;48;192;2226;6039;2274;6231
220207;201512;913;2774;778;2527;76;306;559;1779;635;2085
220208;201512;1822;5854;1562;5385;237;930;952;3246;1189;4176
220209;201512;1529;4654;1383;4425;55;239;1116;3529;1171;3768
220210;201512;1723;4643;1509;4311;41;174;1256;3493;1297;3667
220211;201512;1611;4650;1530;4546;77;311;1319;3838;1396;4149
220213;201512;1737;4956;1591;4679;39;146;1305;3735;1344;3881
220217;201512;1947;6292;1872;6203;47;184;1725;5770;1772;5954
220220;201512;11012;30505;9876;28773;839;2151;7180;21489;8019;23640
220225;201512;1087;3165;922;2945;37;137;762;2413;799;2550
220230;201512;5328;14714;4800;13948;169;482;4244;12374;4413;12856
220240;201512;2858;8888;2638;8483;159;594;2081;6659;2240;7253
220245;201512;1506;4047;1308;3774;35;109;1150;3370;1185;3479
220250;201512;3169;9065;2892;8645;85;334;2547;7578;2632;7912
220253;201512;1651;4985;1406;4545;174;644;982;3126;1156;3770
220255;201512;1748;4941;1511;4535;64;262;1204;3443;1268;3705
220260;201512;4732;15107;4150;14007;335;1174;3077;10444;3412;11618
220265;201512;1340;4630;1210;4414;128;517;776;2876;904;3393
220270;201512;6735;21682;6455;21158;371;1706;5418;17139;5789;18845
220271;201512;1484;4147;1350;3937;93;241;1118;3321;1211;3562
220272;201512;1773;5392;1603;5091;58;242;1273;3970;1331;4212
220273;201512;1225;3551;1075;3280;98;309;783;2364;881;2673
220275;201512;2094;5354;1731;4908;34;142;1567;4363;1601;4505
220277;201512;2278;6353;2016;5940;97;317;1605;4685;1702;5002
220280;201512;1618;4320;1416;3967;100;353;1117;3035;1217;3388
220285;201512;1609;4301;1343;3931;23;95;1208;3553;1231;3648
220290;201512;6057;20329;5250;19206;505;2117;3873;14202;4378;16319
220300;201512;1943;6352;1731;6049;87;453;1392;4766;1479;5219
220310;201512;2394;8198;2232;8012;91;382;1933;7063;2024;7445
220320;201512;3243;9691;2735;8752;289;1017;1926;6117;2215;7134
220323;201512;1467;5214;1287;4945;152;638;974;3767;1126;4405
220325;201512;1193;3809;1004;3416;81;337;719;2419;800;2756
220327;201512;1328;4260;1210;4060;36;190;985;3218;1021;3408
220330;201512;3614;9878;3350;9547;137;387;3005;8638;3142;9025
220335;201512;1910;5763;1718;5538;48;144;1580;5157;1628;5301
220340;201512;1921;5280;1640;4857;120;371;1250;3687;1370;4058
220342;201512;1113;3706;1043;3598;67;293;833;2857;900;3150
220345;201512;2928;7520;2553;6944;68;159;2298;6266;2366;6425
220350;201512;4001;10582;3431;9678;213;624;2659;7455;2872;8079
220360;201512;1287;3598;1106;3306;109;361;835;2455;944;2816
220370;201512;9197;26434;8345;25298;387;1346;7389;22275;7776;23621
220375;201512;1531;4807;1421;4672;23;74;1357;4503;1380;4577
220380;201512;1395;3747;1172;3440;50;170;954;2748;1004;2918
220385;201512;834;2142;672;1878;17;64;543;1483;560;1547
220390;201512;9533;29276;8412;27246;2158;7286;3237;10609;5395;17895
220400;201512;1548;3647;1247;3180;42;148;1041;2558;1083;2706
220410;201512;1412;3974;1163;3606;101;389;877;2638;978;3027
220415;201512;878;2383;768;2235;61;179;548;1571;609;1750
220420;201512;2169;6264;1836;5600;87;258;1455;4434;1542;4692
220430;201512;2555;7297;2484;7201;152;492;2149;6184;2301;6676
220435;201512;1633;4867;1501;4639;49;184;1241;3799;1290;3983
220440;201512;2392;7880;2210;7632;145;538;1844;6286;1989;6824
220450;201512;2151;6583;1814;6092;405;1443;1052;3534;1457;4977
220455;201512;1322;4196;1229;4063;54;201;1107;3678;1161;3879
220460;201512;914;2473;839;2382;46;130;729;2047;775;2177
220465;201512;2367;7791;2132;7431;541;1994;1199;4220;1740;6214
220470;201512;3883;11540;3517;10924;203;655;2720;8340;2923;8995
220480;201512;2541;7209;2215;6728;159;441;1725;5257;1884;5698
220490;201512;2327;6643;2134;6394;65;247;1883;5586;1948;5833
220500;201512;3276;8821;2745;7907;98;435;2204;6133;2302;6568
220510;201512;2759;7973;2200;7003;106;407;1612;5071;1718;5478
220515;201512;2002;4846;1712;4464;169;410;1349;3557;1518;3967
220520;201512;5162;14139;4687;13494;133;394;4191;12117;4324;12511
220525;201512;1311;3680;1223;3544;48;161;1047;3014;1095;3175
220527;201512;1407;4293;1238;3942;141;467;894;2886;1035;3353
220530;201512;1250;3601;1105;3387;55;224;959;2869;1014;3093
220535;201512;886;2661;837;2598;88;294;622;1913;710;2207
220540;201512;3462;11212;3302;10963;138;593;2849;9367;2987;9960
220545;201512;1393;4669;1322;4534;166;631;958;3253;1124;3884
220550;201512;9207;29585;8543;28472;989;3458;6162;20479;7151;23937
220551;201512;1443;4672;1318;4473;70;323;1057;3522;1127;3845
220552;201512;1608;5009;1388;4579;64;320;1061;3372;1125;3692
220553;201512;1616;4702;1313;4237;50;206;1018;3329;1068;3535
220554;201512;822;2369;717;2205;66;216;554;1704;620;1920
220555;201512;2300;6874;2132;6640;61;255;1914;5917;1975;6172
220556;201512;1461;4489;1291;4160;60;236;980;3076;1040;3312
220557;201512;1573;5065;1405;4733;152;532;946;3184;1098;3716
220558;201512;1067;3308;966;3130;62;282;742;2317;804;2599
220559;201512;1528;4314;1384;4066;31;99;1192;3488;1223;3587
220560;201512;1684;4158;1383;3739;68;181;1156;3091;1224;3272
220570;201512;7348;23634;6870;22784;1437;4736;4123;14054;5560;18790
220580;201512;6509;20643;6304;20352;307;989;5665;18326;5972;19315
220585;201512;2035;7134;1912;6910;177;679;1499;5423;1676;6102
220590;201512;1343;3986;1200;3786;203;669;796;2573;999;3242
220595;201512;2335;6860;2169;6638;44;192;1966;5957;2010;6149
220600;201512;1310;3144;1062;2836;169;301;777;2233;946;2534
220605;201512;1979;5744;1687;5274;83;278;1359;4197;1442;4475
220610;201512;2687;8163;2573;8004;69;264;2323;7206;2392;7470
220620;201512;7563;25250;7274;24848;338;1632;6424;21609;6762;23241
220630;201512;402;1235;336;1113;56;187;182;611;238;798
220635;201512;1702;5964;1534;5593;93;450;1084;3859;1177;4309
220640;201512;2685;7809;2418;7427;125;430;2016;6143;2141;6573
220650;201512;2268;6572;2007;6108;134;464;1548;4664;1682;5128
220660;201512;2572;8137;2296;7766;162;759;1896;6215;2058;6974
220665;201512;1199;4056;1119;3916;27;139;1000;3471;1027;3610
220667;201512;1742;5685;1635;5525;78;271;1353;4583;1431;4854
220669;201512;1883;6137;1765;5930;255;1052;1191;3896;1446;4948
220670;201512;2033;5979;1808;5688;145;371;1484;4818;1629;5189
220672;201512;2533;7239;2378;7056;233;695;1961;5868;2194;6563
220675;201512;1287;3703;1200;3549;80;201;942;2807;1022;3008
220680;201512;2287;7324;2143;7124;160;530;1785;5978;1945;6508
220690;201512;1699;4702;1465;4321;115;347;1144;3417;1259;3764
220695;201512;922;2602;839;2465;37;118;667;1940;704;2058
220700;201512;8740;24765;7565;22924;551;1876;5750;17268;6301;19144
220710;201512;823;2418;683;2171;40;121;502;1601;542;1722
220720;201512;2028;5399;1924;5265;53;165;1700;4618;1753;4783
220730;201512;1401;3950;1188;3616;28;131;1008;3014;1036;3145
220735;201512;1041;2647;839;2294;45;144;680;1825;725;1969
220740;201512;1386;4418;1208;4175;106;351;970;3436;1076;3787
220750;201512;3982;11389;3676;10919;410;1012;2846;8722;3256;9734
220755;201512;1237;3454;1108;3237;53;185;892;2561;945;2746
220760;201512;2685;9236;2461;8934;152;752;2041;7300;2193;8052
220770;201512;22541;74024;19830;68790;6534;23734;6474;23209;13008;46943
220775;201512;1253;3352;1209;3302;15;42;1175;3209;1190;3251
220777;201512;1632;4471;1429;4175;81;211;1124;3270;1205;3481
220779;201512;1330;3555;1272;3466;45;173;1137;3010;1182;3183
220780;201512;6005;15984;5284;14910;419;1180;4214;11934;4633;13114
220785;201512;1277;3363;1201;3231;49;135;1083;2883;1132;3018
220790;201512;10067;30849;9316;29667;760;2694;7428;23451;8188;26145
220793;201512;841;2388;765;2274;41;154;636;1876;677;2030
220795;201512;1466;4166;1405;4079;70;210;1276;3707;1346;3917
220800;201512;16441;44884;14745;42421;1028;3431;11092;31394;12120;34825
220810;201512;3363;9678;2886;8854;129;528;2293;6919;2422;7447
220820;201512;5437;14849;4942;14147;259;753;4294;12223;4553;12976
220830;201512;7555;21177;6991;20258;650;1899;5435;15810;6085;17709
220840;201512;14386;45241;12687;41784;2976;9995;5908;19755;8884;29750
220850;201512;2880;9849;2720;9648;128;542;2410;8583;2538;9125
220855;201512;647;1947;559;1792;36;150;411;1281;447;1431
220860;201512;965;2587;852;2410;36;130;711;1983;747;2113
220865;201512;2637;7236;2099;6288;72;344;1672;4826;1744;5170
220870;201512;2306;7623;2031;7252;78;322;1826;6521;1904;6843
220880;201512;4828;12986;4475;12570;105;294;4165;11752;4270;12046
220885;201512;1313;4684;1144;4371;92;434;849;3217;941;3651
220887;201512;1420;3508;1214;3218;20;72;1125;2956;1145;3028
220890;201512;1636;5650;1445;5278;127;464;1108;4132;1235;4596
220900;201512;1880;5355;1645;4929;64;180;1393;4172;1457;4352
220910;201512;1638;4892;1422;4567;52;162;1233;4030;1285;4192
220915;201512;1044;2928;875;2605;31;127;682;1958;713;2085
220920;201512;1364;4863;1230;4665;97;474;912;3383;1009;3857
220930;201512;1381;4564;1318;4464;59;259;1101;3719;1160;3978
220935;201512;1097;3336;956;3038;46;188;655;1994;701;2182
220937;201512;1548;4224;1299;3789;62;232;1002;2838;1064;3070
220940;201512;1386;4330;1279;4107;78;333;951;2995;1029;3328
220945;201512;439;1612;400;1538;37;161;283;1073;320;1234
220950;201512;1351;3346;970;2736;31;119;703;1916;734;2035
220955;201512;1487;4247;1295;3915;86;267;972;2922;1058;3189
220960;201512;914;2363;720;2038;20;65;568;1593;588;1658
220965;201512;1716;5067;1590;4877;63;305;1328;3943;1391;4248
220970;201512;2197;5798;1618;4863;149;467;1103;3340;1252;3807
220975;201512;664;2175;616;2105;30;155;559;1860;589;2015
220980;201512;1308;3931;1138;3642;86;311;832;2666;918;2977
220985;201512;1210;3555;1141;3454;89;327;869;2558;958;2885
220987;201512;1512;4784;1351;4507;84;371;1042;3381;1126;3752
220990;201512;1856;5327;1597;4896;42;212;1246;3720;1288;3932
220995;201512;1327;3824;967;3249;110;390;672;2312;782;2702
220997;201512;2245;6961;2115;6762;55;239;1964;6230;2019;6469
221000;201512;4283;13075;3963;12519;348;1294;3022;9415;3370;10709
221005;201512;1474;4591;1343;4339;529;1592;535;1869;1064;3461
221010;201512;1185;3118;993;2873;53;152;843;2426;896;2578
221020;201512;1807;5565;1677;5329;73;307;1240;3851;1313;4158
221030;201512;1515;4492;1358;4225;66;284;1112;3405;1178;3689
221035;201512;1454;4015;1360;3893;58;131;1250;3644;1308;3775
221037;201512;626;1849;557;1735;14;55;407;1213;421;1268
221038;201512;616;1715;498;1508;44;136;314;950;358;1086
221039;201512;922;2612;836;2487;57;227;672;1923;729;2150
221040;201512;4666;14354;4362;13850;207;718;3561;11350;3768;12068
221050;201512;3498;10654;3286;10362;174;631;2818;8840;2992;9471
221060;201512;8314;24114;7254;22405;654;2173;5402;16638;6056;18811
221062;201512;1300;4542;1197;4333;54;285;1003;3571;1057;3856
221063;201512;1059;3499;973;3330;226;729;558;2043;784;2772
221065;201512;2804;7669;2512;7191;147;412;2058;5828;2205;6240
221070;201512;3889;12149;3417;11344;158;606;2732;9075;2890;9681
221080;201512;3527;9119;2987;8378;114;360;2527;7052;2641;7412
221090;201512;1414;3871;1201;3523;35;150;995;2854;1030;3004
221093;201512;1667;4963;1565;4747;269;859;885;2616;1154;3475
221095;201512;958;2544;856;2392;22;60;730;2032;752;2092
221097;201512;801;2256;647;1973;41;161;452;1327;493;1488
221100;201512;116590;337496;105439;318594;20727;65971;61565;182880;82292;248851
221110;201512;10185;32155;9494;31285;443;1862;7975;25929;8418;27791
221120;201512;4025;13078;3795;12664;752;2619;2410;8072;3162;10691
221130;201512;4659;13400;3886;11820;1157;3537;1694;5196;2851;8733
221135;201512;1528;4668;1401;4490;113;423;1164;3684;1277;4107
221140;201512;1346;3296;1215;3119;43;108;1060;2696;1103;2804
221150;201512;1218;3105;984;2699;29;122;778;2074;807;2196
221160;201512;841;2207;782;2118;38;105;615;1665;653;1770
221170;201512;1148;3534;1061;3387;54;183;855;2721;909;2904
230010;201512;3413;9156;2692;7894;226;749;2036;5846;2262;6595
230015;201512;2929;10087;2727;9641;408;1624;1642;5699;2050;7323
230020;201512;13784;44901;13316;44089;764;2866;11159;36871;11923;39737
230030;201512;12097;34737;10913;32875;523;1829;8881;26519;9404;28348
230040;201512;4635;12595;3866;11278;310;1060;2740;7848;3050;8908
230050;201512;2639;9015;2047;7426;437;1663;734;2668;1171;4331
230060;201512;2207;6313;1888;5738;81;303;1424;4261;1505;4564
230070;201512;4407;12046;3724;10919;356;1177;2483;7295;2839;8472
230075;201512;8803;31448;8210;30247;580;3024;6326;22604;6906;25628
230080;201512;2439;6383;1970;5692;106;364;1605;4611;1711;4975
230090;201512;3815;11085;3352;10284;447;1564;2312;7063;2759;8627
230100;201512;16367;48771;14919;46123;2485;8278;8846;27512;11331;35790
230110;201512;13265;42080;12084;39533;2333;7945;6472;20956;8805;28901
230120;201512;7992;22025;6825;20281;798;2286;4534;14202;5332;16488
230125;201512;3036;8789;2478;7753;176;646;1803;5558;1979;6204
230130;201512;5983;19290;5008;17217;457;1769;3378;11451;3835;13220
230140;201512;3598;11380;3039;10367;358;1335;2023;6957;2381;8292
230150;201512;1725;5373;1469;4836;289;1035;780;2499;1069;3534
230160;201512;6352;18803;5618;17663;296;1183;4482;13917;4778;15100
230170;201512;6481;20136;5516;18283;374;1445;3899;12736;4273;14181
230180;201512;1780;5172;1561;4737;98;409;1116;3219;1214;3628
230185;201512;4074;13182;3657;12399;614;2136;2217;7726;2831;9862
230190;201512;12965;41061;11300;37644;2290;8318;5371;17642;7661;25960
230195;201512;5254;15987;4574;14817;373;1475;3467;10910;3840;12385
230200;201512;5298;15130;4742;14057;458;1434;3425;10068;3883;11502
230205;201512;4199;13491;3753;12697;248;1093;2653;8835;2901;9928
230210;201512;9059;25844;7834;23914;1516;4671;4488;14004;6004;18675
230220;201512;13212;37623;11849;35244;1159;3872;8452;24678;9611;28550
230230;201512;7546;23988;6801;22530;947;3186;4376;14643;5323;17829
230240;201512;13874;38962;12119;35965;605;2146;9440;27511;10045;29657
230250;201512;9939;30713;9801;30492;597;2212;7653;23413;8250;25625
230260;201512;14533;48293;13440;46079;2286;8378;7464;26031;9750;34409
230270;201512;7554;22190;6477;20326;749;2629;4200;13259;4949;15888
230280;201512;19861;58373;17615;54546;1792;5719;12756;39465;14548;45184
230290;201512;4862;14595;4096;13031;580;1783;2708;8658;3288;10441
230300;201512;4443;13340;4223;13023;284;1061;3410;10365;3694;11426
230310;201512;4876;14416;4228;13314;245;993;3054;9428;3299;10421
230320;201512;7115;22176;6471;21023;470;1881;4741;15179;5211;17060
230330;201512;4782;13979;4064;12572;328;1105;2845;8688;3173;9793
230340;201512;3384;11389;3062;10679;377;1470;1939;6621;2316;8091
230350;201512;18252;55172;16503;52179;2034;7296;9686;31005;11720;38301
230360;201512;3310;9395;2677;8211;252;861;1745;5252;1997;6113
230365;201512;3036;8198;2628;7507;127;477;2079;5856;2206;6333
230370;201512;54761;174034;48668;163277;13016;45854;20935;72194;33951;118048
230380;201512;6542;19150;5464;17142;332;1112;3843;12013;4175;13125
230390;201512;3530;11081;3105;10338;248;1071;2181;7105;2429;8176
230393;201512;3320;10804;2803;9739;208;998;1986;6623;2194;7621
230395;201512;5589;16439;4944;15300;797;2495;2920;9286;3717;11781
230400;201512;5465;16537;4750;15384;287;1272;3648;11551;3935;12823
230410;201512;14433;45816;12462;41594;1770;6270;7435;24772;9205;31042
230420;201512;24364;78225;21948;73300;4928;17701;10057;33247;14985;50948
230423;201512;4213;13863;3865;13159;263;1096;2891;9744;3154;10840
230425;201512;5636;18602;5117;17425;729;2555;3241;11093;3970;13648
230426;201512;2733;7606;2168;6529;80;338;1598;4683;1678;5021
230427;201512;1840;5464;1354;4382;185;610;773;2422;958;3032
230428;201512;8755;27070;8286;26179;1341;4675;4796;14901;6137;19576
230430;201512;4598;14565;4211;13822;325;1327;3025;9678;3350;11005
230435;201512;4904;15588;4377;14604;791;3048;2319;7557;3110;10605
230440;201512;355579;1049673;321609;989413;76525;246453;146639;453295;223164;699748
230445;201512;4602;12357;3855;11224;289;835;2722;7945;3011;8780
230450;201512;3600;11345;3087;10380;364;1553;2012;6583;2376;8136
230460;201512;1921;6312;1664;5831;173;690;1134;3936;1307;4626
230465;201512;4136;12270;3460;11030;253;1051;2269;7007;2522;8058
230470;201512;10880;39569;10012;37720;1342;5528;6722;25332;8064;30860
230480;201512;1475;4616;1240;4172;160;610;813;2688;973;3298
230490;201512;2321;7092;1998;6453;321;1107;968;3013;1289;4120
230495;201512;5855;19175;5190;18003;726;3004;2806;9602;3532;12606
230500;201512;9324;32667;8844;31733;661;2874;6582;23520;7243;26394
230510;201512;1515;5344;1160;4433;313;1306;359;1354;672;2660
230520;201512;4938;14939;4382;13907;478;1713;2790;8722;3268;10435
230523;201512;14762;47687;12722;42991;2922;10789;3180;10844;6102;21633
230526;201512;4229;12399;3545;11212;223;943;2693;8318;2916;9261
230530;201512;5484;17523;4903;16740;959;3390;3113;10961;4072;14351
230533;201512;4107;11282;3505;10126;514;1402;2313;6772;2827;8174
230535;201512;5612;16466;4879;15164;707;2171;2930;9439;3637;11610
230540;201512;17822;51767;15985;48847;728;2837;13128;39523;13856;42360
230550;201512;19685;58189;17458;53911;3253;10884;8953;26947;12206;37831
230560;201512;6733;19331;5892;17813;226;921;4539;13406;4765;14327
230565;201512;3469;9564;2806;8323;125;460;2059;6039;2184;6499
230570;201512;3710;10082;3273;9534;123;480;2722;7827;2845;8307
230580;201512;10113;30464;9345;29358;541;2013;7953;24856;8494;26869
230590;201512;9051;28070;7749;25583;590;2468;5459;17470;6049;19938
230600;201512;3780;10440;2909;8710;151;512;1892;5642;2043;6154
230610;201512;6115;19521;5632;18738;789;2685;3830;12931;4619;15616
230620;201512;2187;6216;1711;5175;206;675;964;2816;1170;3491
230625;201512;8125;26021;7189;23890;2059;7396;2119;6921;4178;14317
230630;201512;10975;34733;9975;32871;2645;8207;4621;16316;7266;24523
230640;201512;25973;84403;23880;81222;2702;10244;17671;59801;20373;70045
230650;201512;4970;15138;4452;14141;310;1240;3366;10399;3676;11639
230655;201512;9174;34442;8760;33691;816;3463;6791;26296;7607;29759
230660;201512;6050;18933;5150;17196;334;1518;3901;12691;4235;14209
230670;201512;6237;16502;4883;14162;191;671;3759;10555;3950;11226
230680;201512;2636;7821;2239;7035;357;1179;1304;4079;1661;5258
230690;201512;6375;20573;6166;20116;634;2388;3970;12655;4604;15043
230700;201512;9430;26446;8367;24578;718;2528;5837;16584;6555;19112
230710;201512;7578;24509;6534;22540;698;2495;4562;15785;5260;18280
230720;201512;1895;5936;1593;5303;204;716;933;3085;1137;3801
230725;201512;3735;12593;3166;11139;790;2848;1049;3649;1839;6497
230730;201512;57817;173223;47575;155839;13093;47948;11656;39236;24749;87184
230740;201512;6050;18068;5477;17099;224;918;4338;13307;4562;14225
230750;201512;8549;24470;7255;22341;441;1623;5480;16599;5921;18222
230760;201512;10630;31483;9801;29826;1080;3792;6710;19636;7790;23428
230763;201512;4315;13168;3837;12250;220;977;2885;8864;3105;9841
230765;201512;39229;123000;34634;113710;8961;31536;10699;35323;19660;66859
230770;201512;25082;69277;22546;65630;2974;9072;14728;42859;17702;51931
230780;201512;5964;22914;5682;22261;1410;5708;2711;11087;4121;16795
230790;201512;2763;8826;2528;8414;264;979;1842;6148;2106;7127
230800;201512;7457;26423;6682;24667;1485;5834;2899;10583;4384;16417
230810;201512;12067;39009;11327;37726;901;3276;8774;29139;9675;32415
230820;201512;3353;11452;2901;10436;428;1753;1598;5640;2026;7393
230830;201512;7587;22861;6641;21088;531;1993;4757;14901;5288;16894
230835;201512;4039;10643;3290;9508;212;663;2516;7233;2728;7896
230837;201512;3201;10798;2762;9913;323;1385;1805;6320;2128;7705
230840;201512;9216;29856;8398;28424;735;2844;6270;21269;7005;24113
230850;201512;9805;30236;9045;28969;1062;3532;6202;19924;7264;23456
230860;201512;5263;14930;4607;13886;245;897;3714;11094;3959;11991
230870;201512;19072;49773;16326;45648;793;2509;12464;34602;13257;37111
230880;201512;1975;6661;1857;6420;153;673;1275;4317;1428;4990
230890;201512;3925;14317;3605;13597;450;2064;2266;8258;2716;10322
230900;201512;2957;9798;2468;8742;535;1836;1127;4105;1662;5941
230910;201512;3202;9332;2576;8200;210;914;1820;5604;2030;6518
230920;201512;4755;13705;4390;13232;299;1126;3587;10744;3886;11870
230930;201512;7430;22209;6501;20439;652;2172;4328;13603;4980;15775
230940;201512;7866;22273;6809;20621;334;1119;5453;16554;5787;17673
230945;201512;6023;18325;5245;17064;436;1608;3615;11909;4051;13517
230950;201512;6485;17724;5845;16864;259;726;4950;14560;5209;15286
230960;201512;14388;43916;13010;41295;2564;8554;5936;18980;8500;27534
230970;201512;13680;41633;11879;38218;2410;8503;5190;16290;7600;24793
230980;201512;2996;9333;2604;8610;727;2409;1191;4139;1918;6548
230990;201512;1752;5195;1454;4609;125;525;924;2804;1049;3329
231000;201512;2785;7524;2165;6311;156;537;1380;3892;1536;4429
231010;201512;3196;8680;2588;7661;275;887;1714;4923;1989;5810
231020;201512;7956;26536;7486;25521;1322;4509;4526;15734;5848;20243
231025;201512;8050;24498;7264;23161;975;3256;4713;15240;5688;18496
231030;201512;7779;25070;6493;22371;1153;4260;3477;11939;4630;16199
231040;201512;3163;10073;2797;9331;170;751;2003;6484;2173;7235
231050;201512;12072;34190;10135;30685;810;2723;7415;22221;8225;24944
231060;201512;2416;7794;2207;7412;157;747;1563;5066;1720;5813
231070;201512;8862;27905;8009;26166;1343;4639;4487;14710;5830;19349
231080;201512;4086;12699;3694;12016;193;971;2827;8792;3020;9763
231085;201512;4788;14829;4570;14526;712;2201;3107;10220;3819;12421
231090;201512;4151;11611;3300;9890;176;615;2291;6758;2467;7373
231095;201512;2344;7484;1988;6756;225;864;1278;4316;1503;5180
231100;201512;3231;9920;2668;8804;208;795;1894;6189;2102;6984
231110;201512;3603;11963;3535;11838;360;1387;2395;7959;2755;9346
231120;201512;2110;7019;1964;6710;293;1077;1217;4175;1510;5252
231123;201512;2111;5772;1790;5206;139;400;1383;3996;1522;4396
231126;201512;6346;17886;5283;16108;303;1172;3865;11593;4168;12765
231130;201512;19386;59079;17325;55596;3439;11401;9869;33017;13308;44418
231135;201512;4301;12697;3594;11434;285;990;2506;7898;2791;8888
231140;201512;17043;53430;14917;49376;1274;5593;9760;31171;11034;36764
231150;201512;5942;16904;4979;15131;812;2602;2485;7533;3297;10135
231160;201512;5889;19316;5459;18440;977;3269;3164;10814;4141;14083
231170;201512;4300;13754;3833;12796;298;1233;2649;8583;2947;9816
231180;201512;14239;42174;12702;39099;2137;7065;7135;21526;9272;28591
231190;201512;4634;12987;3887;11833;253;911;2950;8772;3203;9683
231195;201512;4650;15492;3934;14035;417;1841;2669;9334;3086;11175
231200;201512;7831;26620;6790;24425;454;2295;4775;16670;5229;18965
231210;201512;5059;15753;4354;14750;291;1402;3368;11224;3659;12626
231220;201512;11969;34436;10411;31526;540;2066;7656;22687;8196;24753
231230;201512;9232;30753;8374;29407;789;3328;6126;21438;6915;24766
231240;201512;12339;38436;10978;35688;2347;7884;5160;16934;7507;24818
231250;201512;1988;5745;1356;4184;433;1308;297;906;730;2214
231260;201512;3583;10523;3201;9916;547;1679;1921;6067;2468;7746
231270;201512;7352;20144;6438;18702;348;1421;4816;13594;5164;15015
231280;201512;1760;5729;1628;5473;177;629;1108;3748;1285;4377
231290;201512;33477;113710;29969;105590;6427;25113;12108;41502;18535;66615
231300;201512;4609;13244;3693;11436;252;965;2499;7485;2751;8450
231310;201512;7551;21342;6182;18487;929;2828;3446;10112;4375;12940
231320;201512;7061;21508;5946;19292;325;1382;4221;13560;4546;14942
231325;201512;2732;8082;2374;7498;278;918;1565;5021;1843;5939
231330;201512;12512;39245;10620;35455;1677;5625;6244;21059;7921;26684
231335;201512;5388;15346;4607;13913;211;862;3580;10549;3791;11411
231340;201512;17618;57710;16147;55441;1160;4010;12709;44451;13869;48461
231350;201512;13396;41528;12823;40693;1023;3101;10827;34859;11850;37960
231355;201512;4441;14154;4094;13568;292;1184;2996;9808;3288;10992
231360;201512;7890;24941;6959;23276;1268;4282;4158;14279;5426;18561
231370;201512;2477;6843;1927;5938;88;276;1422;4385;1510;4661
231375;201512;4202;14311;3913;13756;237;1098;3084;10689;3321;11787
231380;201512;5297;16673;4973;16235;585;1987;3454;11584;4039;13571
231390;201512;3486;10850;3194;10352;279;975;2226;7157;2505;8132
231395;201512;3879;12594;3478;11848;611;2075;1941;6686;2552;8761
231400;201512;9145;28052;8483;26716;572;2193;6234;19335;6806;21528
231410;201512;14021;47582;12836;45740;1314;4857;9628;34627;10942;39484
240010;201512;2475;7381;2039;6482;354;1243;992;3045;1346;4288
240020;201512;10774;33680;9505;31225;2082;7269;4490;14775;6572;22044
240030;201512;2481;7127;2398;6997;139;483;2022;5779;2161;6262
240040;201512;832;2462;685;2159;27;132;487;1450;514;1582
240050;201512;3479;9368;2944;8445;118;402;2345;6609;2463;7011
240060;201512;1405;4031;1249;3727;58;220;989;2843;1047;3063
240070;201512;2618;7610;2423;7219;396;1233;1558;4557;1954;5790
240080;201512;3072;8181;2633;7595;203;583;2009;5776;2212;6359
240090;201512;2347;6266;1890;5440;46;167;1470;4120;1516;4287
240100;201512;8302;23667;7370;21741;666;2177;5247;15086;5913;17263
240110;201512;4888;15194;4322;14056;688;2514;2381;7446;3069;9960
240120;201512;2699;9233;2562;8955;394;1501;1594;5529;1988;7030
240130;201512;2827;7578;2405;6923;124;413;1919;5425;2043;5838
240140;201512;2252;6721;1911;6098;312;1173;1073;3285;1385;4458
240145;201512;5835;18378;5239;17298;1460;5043;2449;8283;3909;13326
240150;201512;985;3002;801;2606;80;322;514;1605;594;1927
240160;201512;1447;4632;1245;4270;158;596;774;2716;932;3312
240165;201512;908;2857;793;2612;126;370;471;1642;597;2012
240170;201512;2397;7160;2079;6566;510;1785;943;2894;1453;4679
240180;201512;2643;8338;2347;7733;462;1622;1299;4343;1761;5965
240185;201512;1446;4766;1344;4591;92;335;1054;3630;1146;3965
240190;201512;960;3026;858;2849;50;234;633;2062;683;2296
240200;201512;13837;35982;11367;32471;2598;7667;5043;14720;7641;22387
240210;201512;2906;8101;2628;7691;184;640;2117;6084;2301;6724
240220;201512;7372;24518;6860;23742;657;2959;5124;17338;5781;20297
240230;201512;5704;15102;4942;13904;169;525;4159;11667;4328;12192
240240;201512;1848;5576;1233;4051;263;955;237;668;500;1623
240250;201512;2680;7773;2514;7548;120;389;2144;6403;2264;6792
240260;201512;12419;41599;11687;40370;1911;7339;7312;25123;9223;32462
240270;201512;2248;7177;2064;6870;199;677;1572;5301;1771;5978
240280;201512;1588;4433;1381;4120;82;292;1102;3259;1184;3551
240290;201512;1314;4142;1147;3818;65;330;733;2289;798;2619
240300;201512;2262;6262;1634;4920;344;1116;616;1786;960;2902
240310;201512;9664;27473;8738;25984;1232;4049;4846;14520;6078;18569
240320;201512;2060;6089;1608;5147;59;256;1179;3612;1238;3868
240325;201512;35312;96880;27486;84063;8553;28018;6374;19825;14927;47843
240330;201512;1510;4553;1254;4018;76;301;800;2464;876;2765
240340;201512;2017;5372;1703;4866;191;575;1213;3434;1404;4009
240350;201512;1935;5689;1805;5524;131;451;1542;4713;1673;5164
240360;201512;7270;21660;6337;20238;1388;4686;3270;10724;4658;15410
240370;201512;1989;5499;1602;4784;235;681;939;2838;1174;3519
240375;201512;850;2308;737;2117;113;374;460;1236;573;1610
240380;201512;2470;7344;1880;6007;247;818;947;2976;1194;3794
240390;201512;938;2589;779;2293;42;160;556;1573;598;1733
240400;201512;1350;3688;1104;3239;88;310;765;2165;853;2475
240410;201512;510;1665;447;1536;81;330;244;802;325;1132
240420;201512;4664;17806;4362;17097;906;3957;2281;8958;3187;12915
240430;201512;3288;9260;2986;8710;148;588;2346;6596;2494;7184
240440;201512;2563;6657;2271;6200;624;1741;1110;2997;1734;4738
240450;201512;3840;11405;3276;10297;302;1251;2053;6082;2355;7333
240460;201512;2934;8976;2766;8748;183;790;2252;6906;2435;7696
240470;201512;3617;11253;2866;9616;809;2597;1293;4430;2102;7027
240480;201512;518;1380;397;1143;35;111;215;593;250;704
240485;201512;2020;6282;1763;5797;296;1040;1027;3411;1323;4451
240490;201512;1675;4276;1406;3866;39;151;1167;3128;1206;3279
240500;201512;2137;6117;1929;5797;136;467;1498;4465;1634;4932
240510;201512;1790;5313;1655;5091;146;490;1304;3996;1450;4486
240520;201512;1245;3628;1118;3413;119;422;820;2437;939;2859
240530;201512;2034;6484;1844;6178;395;1360;1134;3804;1529;5164
240540;201512;1692;5123;1618;4998;127;418;1314;4039;1441;4457
240550;201512;817;2322;704;2130;41;143;532;1579;573;1722
240560;201512;3191;9289;2968;8936;390;1179;2172;6546;2562;7725
240570;201512;3114;8692;2306;6862;527;1697;813;2137;1340;3834
240580;201512;7599;23857;7039;22842;832;2995;5258;16811;6090;19806
240590;201512;790;2225;682;2024;34;130;508;1461;542;1591
240600;201512;1625;4778;1268;4016;154;562;699;2113;853;2675
240610;201512;4719;13438;4052;12166;495;1610;2529;7388;3024;8998
240615;201512;1049;3071;836;2645;173;588;447;1362;620;1950
240620;201512;1763;5508;1564;5172;206;632;1111;3757;1317;4389
240630;201512;2052;6249;1864;5925;174;477;1297;4248;1471;4725
240640;201512;901;2595;756;2350;54;251;525;1552;579;1803
240650;201512;3848;11536;3448;10952;205;728;2742;8666;2947;9394
240660;201512;2422;7707;2266;7476;207;755;1736;5694;1943;6449
240670;201512;2715;8028;2217;6966;296;985;1233;3806;1529;4791
240680;201512;1513;4423;1213;3870;106;372;763;2395;869;2767
240690;201512;958;2637;823;2404;48;177;660;1869;708;2046
240700;201512;2673;7952;2198;7050;85;381;1673;5249;1758;5630
240710;201512;19010;49586;16331;45586;3109;8615;9183;26086;12292;34701
240720;201512;5259;15000;4730;13999;1530;4655;1938;5525;3468;10180
240725;201512;1060;3193;838;2683;74;245;491;1538;565;1783
240730;201512;2182;6546;1868;5955;130;458;1376;4364;1506;4822
240740;201512;2001;5844;1773;5419;156;607;1257;3691;1413;4298
240750;201512;2170;8108;2000;7778;494;2102;918;3559;1412;5661
240760;201512;1333;3634;1121;3345;111;276;827;2630;938;2906
240770;201512;3166;9015;2820;8531;165;656;2306;6853;2471;7509
240780;201512;6380;17318;4966;15066;844;2581;2663;8192;3507;10773
240790;201512;891;2712;733;2436;40;152;499;1678;539;1830
240800;201512;36082;103211;31735;95694;7753;24193;12847;39109;20600;63302
240810;201512;86598;248778;79425;236217;21169;64325;36506;110135;57675;174460
240820;201512;6553;19776;5632;18279;1348;4713;2306;7756;3654;12469
240830;201512;8642;26863;8058;25987;406;1694;6759;21493;7165;23187
240840;201512;1267;3495;1052;3146;93;294;658;1896;751;2190
240850;201512;1306;3850;940;3003;141;474;461;1446;602;1920
240860;201512;1329;3756;1079;3305;55;204;819;2425;874;2629
240870;201512;1204;3287;972;2854;86;284;598;1673;684;1957
240880;201512;1153;3859;1082;3735;97;425;850;2845;947;3270
240890;201512;5124;14508;4263;12868;927;2938;1795;5260;2722;8198
240895;201512;2628;9078;2399;8654;281;1110;1681;6110;1962;7220
240910;201512;2824;8540;2494;7902;172;642;1874;5870;2046;6512
240920;201512;783;2513;672;2264;128;493;312;1009;440;1502
240930;201512;3472;9075;3047;8550;161;448;2486;7054;2647;7502
240933;201512;1381;3959;1224;3705;103;359;908;2680;1011;3039
240940;201512;6532;17644;5257;15432;895;2597;2937;8635;3832;11232
240950;201512;987;3211;927;3104;66;311;697;2244;763;2555
240960;201512;792;2456;695;2265;72;247;485;1596;557;1843
240970;201512;1967;5405;1634;4835;120;438;1221;3468;1341;3906
240980;201512;3068;10010;2806;9512;520;1846;1670;5644;2190;7490
240990;201512;2873;8503;2665;8078;451;1463;1591;4743;2042;6206
241000;201512;1072;2974;908;2683;47;173;635;1840;682;2013
241010;201512;2767;9431;2572;9026;322;1384;1782;6026;2104;7410
241020;201512;2085;5795;1667;4960;160;485;1054;3044;1214;3529
241025;201512;1638;4975;1456;4636;80;363;1030;3184;1110;3547
241030;201512;2527;8305;2246;7760;225;956;1591;5422;1816;6378
241040;201512;2251;7695;2051;7327;196;809;1433;5161;1629;5970
241050;201512;1258;3744;1099;3457;64;259;829;2541;893;2800
241060;201512;885;2549;792;2384;57;172;579;1726;636;1898
241070;201512;825;2335;733;2168;67;236;521;1481;588;1717
241080;201512;1183;3482;972;3073;40;177;707;2192;747;2369
241090;201512;2173;6402;1823;5773;133;595;1370;4234;1503;4829
241100;201512;1198;3563;1025;3152;98;318;670;2040;768;2358
241105;201512;1222;3677;1082;3420;245;789;518;1694;763;2483
241110;201512;834;2581;682;2254;54;222;419;1350;473;1572
241120;201512;7431;22555;6676;21327;1535;4896;3632;12060;5167;16956
241140;201512;3444;9439;2945;8431;329;930;1994;5631;2323;6561
241142;201512;733;2171;535;1721;139;513;188;558;327;1071
241150;201512;5497;16220;4878;15145;579;1894;3248;10030;3827;11924
241160;201512;1010;2931;908;2752;142;427;570;1728;712;2155
241170;201512;1175;3438;1076;3260;99;301;830;2509;929;2810
241180;201512;935;2618;759;2283;96;309;390;1134;486;1443
241190;201512;1210;3314;961;2817;62;218;604;1690;666;1908
241200;201512;19348;56115;16980;52268;4136;13598;7249;22484;11385;36082
241210;201512;1489;4162;1176;3504;177;604;622;1777;799;2381
241220;201512;7980;26172;7376;25006;1826;6443;3669;12653;5495;19096
241230;201512;3028;8870;2752;8449;166;639;2288;6880;2454;7519
241240;201512;1210;3565;787;2547;94;335;344;1119;438;1454
241250;201512;5981;18468;4989;16524;219;1180;3809;12136;4028;13316
241255;201512;1705;6485;1565;6136;364;1573;737;2874;1101;4447
241260;201512;5144;13872;4106;12229;207;856;3024;8774;3231;9630
241270;201512;1849;5703;1619;5227;128;492;1090;3455;1218;3947
241280;201512;1870;5397;1699;5066;200;610;1195;3536;1395;4146
241290;201512;3088;8616;2583;7722;271;873;1742;5138;2013;6011
241300;201512;1463;4192;1259;3828;59;192;885;2699;944;2891
241310;201512;1625;4865;1485;4624;130;467;1110;3418;1240;3885
241320;201512;924;3153;833;2957;115;462;513;1804;628;2266
241330;201512;1465;4540;1357;4393;100;418;1119;3547;1219;3965
241335;201512;2730;8297;2512;7895;156;553;2065;6426;2221;6979
241340;201512;1865;5753;1581;5127;380;1351;676;2086;1056;3437
241350;201512;1944;6152;1750;5783;145;611;1290;4116;1435;4727
241355;201512;1409;3951;1144;3503;54;200;920;2786;974;2986
241360;201512;2055;5584;1697;4892;71;207;1243;3470;1314;3677
241370;201512;1356;4088;1105;3576;134;494;641;2011;775;2505
241380;201512;669;1894;563;1679;87;273;326;956;413;1229
241390;201512;2763;9097;2563;8739;289;1146;1874;6333;2163;7479
241400;201512;3782;10947;3443;10489;430;1409;2509;7669;2939;9078
241410;201512;2540;7666;2270;7265;528;1790;1236;3918;1764;5708
241415;201512;1692;5070;1515;4780;97;370;1193;3683;1290;4053
241420;201512;2291;7876;1975;7322;621;2506;472;1687;1093;4193
241430;201512;580;1723;449;1418;50;173;251;752;301;925
241440;201512;6259;22518;5881;21881;1135;4437;3828;14408;4963;18845
241445;201512;1038;2991;985;2926;90;219;794;2512;884;2731
241450;201512;3164;8560;2748;7960;326;1039;1880;5366;2206;6405
241460;201512;3423;9974;3007;9138;265;933;2130;6293;2395;7226
241470;201512;1361;3837;1132;3531;157;543;744;2285;901;2828
241475;201512;1248;3748;1015;3271;41;184;777;2403;818;2587
241480;201512;2796;9239;2544;8782;1019;3670;597;2188;1616;5858
241490;201512;667;1758;566;1610;37;95;352;978;389;1073
241500;201512;765;2428;649;2241;44;203;486;1639;530;1842
250010;201512;2758;8620;2350;7711;132;560;1739;5563;1871;6123
250020;201512;1673;4788;1273;4053;81;326;825;2515;906;2841
250030;201512;6941;20202;6506;19582;524;1642;5274;15824;5798;17466
250040;201512;4264;14109;3904;13324;633;2234;2379;8100;3012;10334
250050;201512;3410;10790;3204;10488;453;1550;2180;7088;2633;8638
250053;201512;1247;3729;1144;3589;148;487;780;2483;928;2970
250057;201512;640;2673;627;2659;12;22;595;2602;607;2624
250060;201512;5096;15241;4762;14743;412;1499;3771;11492;4183;12991
250070;201512;3979;12342;3680;11822;160;753;2880;8913;3040;9666
250073;201512;769;2347;675;2181;44;170;542;1725;586;1895
250077;201512;2168;6312;1815;5743;185;615;1185;3786;1370;4401
250080;201512;4186;12161;3992;11829;357;1111;3061;8903;3418;10014
250090;201512;2567;7473;2441;7262;103;323;2008;5899;2111;6222
250100;201512;3869;12712;3637;12275;348;1295;2774;9227;3122;10522
250110;201512;5240;15610;4949;15183;475;1702;3882;11726;4357;13428
250115;201512;533;1712;464;1561;32;166;310;972;342;1138
250120;201512;1990;5994;1725;5467;100;354;1323;4167;1423;4521
250130;201512;5226;16411;4831;15754;240;1005;4040;13081;4280;14086
250135;201512;1066;3253;968;3074;58;195;742;2378;800;2573
250140;201512;2004;6726;1912;6577;172;722;1472;5056;1644;5778
250150;201512;5086;17002;4601;16083;331;1448;3367;11569;3698;13017
250153;201512;1425;3903;1248;3642;48;215;1061;3016;1109;3231
250157;201512;1727;5680;1582;5385;175;686;1150;3883;1325;4569
250160;201512;3243;9783;3105;9579;139;514;2811;8642;2950;9156
250170;201512;1498;4528;1371;4329;206;697;944;2999;1150;3696
250180;201512;15755;46445;14839;44976;1453;5204;10887;32092;12340;37296
250190;201512;4200;12094;3803;11459;625;1920;2299;6828;2924;8748
250200;201512;2047;5954;1708;5453;109;424;1390;4381;1499;4805
250205;201512;876;3017;815;2901;51;261;603;2110;654;2371
250210;201512;1456;4898;1358;4748;120;485;1009;3454;1129;3939
250215;201512;1397;4560;1315;4430;114;461;861;2860;975;3321
250220;201512;738;2222;654;2111;41;165;545;1738;586;1903
250230;201512;1598;4037;1330;3592;58;199;1079;2792;1137;2991
250240;201512;2326;7776;2199;7541;126;486;1754;6011;1880;6497
250250;201512;4266;12944;3931;12487;194;669;3381;10772;3575;11441
250260;201512;1706;5226;1488;4889;81;322;1158;3785;1239;4107
250270;201512;1252;3923;1135;3775;104;350;865;2954;969;3304
250280;201512;3628;10765;3198;10072;405;1264;2306;7334;2711;8598
250290;201512;1954;5162;1650;4768;42;167;1472;4247;1514;4414
250300;201512;5467;15923;5165;15558;600;2481;4126;11806;4726;14287
250310;201512;1191;3608;1047;3383;89;321;798;2545;887;2866
250320;201512;8029;24505;7600;23719;927;3233;5234;15909;6161;19142
250330;201512;2467;7689;2114;7163;171;709;1596;5322;1767;6031
250340;201512;1105;3294;991;3104;38;142;840;2608;878;2750
250350;201512;4212;11662;3745;11095;153;534;3225;9573;3378;10107
250355;201512;1905;6077;1753;5856;78;382;1492;4866;1570;5248
250360;201512;1856;5486;1743;5320;68;188;1494;4600;1562;4788
250370;201512;11669;34007;10517;32732;901;2892;8940;27963;9841;30855
250375;201512;1097;3335;1009;3202;37;143;866;2741;903;2884
250380;201512;1688;4803;1588;4677;100;389;1345;3881;1445;4270
250390;201512;1926;5166;1534;4502;175;491;1030;3041;1205;3532
250400;201512;72115;191374;56273;165758;14368;44422;22286;66192;36654;110614
250403;201512;1521;4967;1399;4791;225;878;860;2857;1085;3735
250407;201512;1192;3402;1037;3145;69;218;755;2233;824;2451
250410;201512;548;1800;508;1722;31;155;401;1317;432;1472
250415;201512;1786;5458;1609;5138;102;342;1210;3820;1312;4162
250420;201512;1256;3745;1144;3580;36;151;1007;3110;1043;3261
250430;201512;6098;16835;5702;16240;300;1023;4724;13178;5024;14201
250435;201512;1361;4165;1229;3926;139;513;852;2687;991;3200
250440;201512;4369;12740;4044;12272;180;550;3389;10257;3569;10807
250450;201512;1990;5649;1772;5357;73;271;1500;4453;1573;4724
250460;201512;6403;19258;5954;18631;613;1987;4584;14536;5197;16523
250470;201512;1547;4222;1314;3892;142;496;881;2486;1023;2982
250480;201512;3741;11346;3479;10976;107;471;3068;9622;3175;10093
250485;201512;680;1701;553;1504;30;98;446;1171;476;1269
250490;201512;3761;11930;3660;11786;819;2618;2422;7898;3241;10516
250500;201512;1775;5370;1576;5044;314;954;996;3304;1310;4258
250510;201512;4746;13578;4226;12806;183;644;3672;11131;3855;11775
250520;201512;1732;5260;1613;5058;243;814;954;2923;1197;3737
250523;201512;1573;5062;1515;4972;227;830;1076;3479;1303;4309
250527;201512;1389;4199;1320;4114;24;118;1211;3717;1235;3835
250530;201512;647;1951;550;1832;26;82;480;1626;506;1708
250535;201512;1306;4102;1232;3953;50;220;996;3116;1046;3336
250540;201512;2396;6928;2229;6737;50;220;1971;5838;2021;6058
250550;201512;899;2990;809;2849;54;250;628;2167;682;2417
250560;201512;1669;5237;1618;5163;92;389;1415;4432;1507;4821
250570;201512;2647;8409;2313;7753;151;644;1748;5729;1899;6373
250580;201512;1137;3022;963;2746;86;304;749;2065;835;2369
250590;201512;890;2763;830;2688;82;325;674;2128;756;2453
250600;201512;7304;21188;6826;20503;750;2115;5211;15853;5961;17968
250610;201512;3113;9107;2873;8738;271;900;2148;6477;2419;7377
250620;201512;696;2037;615;1874;108;346;360;1073;468;1419
250625;201512;2380;7647;2330;7583;106;249;2173;7206;2279;7455
250630;201512;9430;29346;8620;27721;2063;6675;4268;13846;6331;20521
250640;201512;3468;10619;3305;10419;179;766;2859;8847;3038;9613
250650;201512;801;2326;714;2180;49;191;522;1520;571;1711
250660;201512;1900;5017;1720;4782;28;65;1619;4537;1647;4602
250670;201512;2386;8091;2267;7874;148;681;1848;6283;1996;6964
250680;201512;4732;13613;4499;13322;211;752;3947;11630;4158;12382
250690;201512;5968;15593;5683;15246;481;1233;4936;13266;5417;14499
250700;201512;4979;14580;4520;13890;730;2315;2963;9065;3693;11380
250710;201512;4184;13360;3919;12983;567;1997;2674;8973;3241;10970
250720;201512;2661;7720;2500;7473;96;410;2187;6435;2283;6845
250730;201512;3527;10765;3298;10438;291;980;2462;7676;2753;8656
250740;201512;1905;5596;1677;5238;167;629;1250;3777;1417;4406
250750;201512;99437;281613;91569;269822;12898;41382;61577;178851;74475;220233
250760;201512;2225;6404;1993;6071;135;509;1645;4944;1780;5453
250770;201512;3821;12876;3614;12603;547;2113;2409;8349;2956;10462
250780;201512;1837;5376;1575;4890;176;656;1008;3001;1184;3657
250790;201512;2409;7848;2275;7621;508;1709;1324;4562;1832;6271
250800;201512;2654;7453;2344;6948;102;312;1925;5605;2027;5917
250810;201512;1315;3828;1134;3556;81;333;886;2721;967;3054
250820;201512;1829;5738;1751;5638;72;312;1586;5053;1658;5365
250830;201512;5682;18284;5247;17388;625;2310;3532;11466;4157;13776
250840;201512;912;2929;766;2607;58;231;516;1753;574;1984
250850;201512;1978;6079;1798;5785;99;462;1398;4391;1497;4853
250855;201512;1054;3200;962;3059;61;263;734;2253;795;2516
250860;201512;3101;10144;2676;9351;680;2553;889;3108;1569;5661
250870;201512;1048;3059;938;2845;42;166;719;2121;761;2287
250880;201512;1391;3908;1213;3650;161;480;884;2684;1045;3164
250890;201512;9243;28104;8637;27253;1107;4326;6105;18533;7212;22859
250900;201512;2821;9156;2468;8455;246;816;1795;6187;2041;7003
250905;201512;1981;6346;1897;6231;317;1022;1370;4569;1687;5591
250910;201512;4955;14368;4671;13944;271;909;3834;11342;4105;12251
250915;201512;1420;4402;1387;4347;110;298;1180;3784;1290;4082
250920;201512;3326;9528;3099;9176;405;1131;2142;6447;2547;7578
250930;201512;1987;6167;1865;5962;202;802;1324;4113;1526;4915
250933;201512;1123;3656;1053;3517;100;381;707;2318;807;2699
250937;201512;672;2078;612;1960;61;238;428;1330;489;1568
250939;201512;1550;4824;1456;4662;145;497;1024;3251;1169;3748
250940;201512;3714;11086;3482;10712;133;508;2952;9074;3085;9582
250950;201512;1218;3765;1067;3569;55;243;858;2832;913;3075
250960;201512;1112;3633;1056;3548;82;311;848;2847;930;3158
250970;201512;8427;23288;7296;21541;824;2509;5129;15096;5953;17605
250980;201512;2552;7547;2328;7147;128;518;1692;4976;1820;5494
250990;201512;1964;6672;1752;6199;261;1054;1069;3635;1330;4689
251000;201512;2154;6449;1952;6136;78;329;1620;5039;1698;5368
251010;201512;2801;8128;2504;7665;79;268;2158;6612;2237;6880
251020;201512;1595;4613;1464;4443;89;285;1294;3935;1383;4220
251030;201512;1131;3177;1024;2985;67;220;753;2156;820;2376
251040;201512;1828;5727;1627;5370;98;452;1209;3838;1307;4290
251050;201512;1086;3141;940;2888;103;331;614;1856;717;2187
251060;201512;1017;2370;783;2063;49;157;613;1585;662;1742
251065;201512;467;1417;412;1328;30;103;282;858;312;961
251070;201512;629;1764;566;1679;41;165;447;1256;488;1421
251080;201512;19712;55487;17708;52095;4497;13741;8342;25056;12839;38797
251090;201512;2981;9274;2629;8587;202;748;1886;6047;2088;6795
251100;201512;966;3039;852;2834;86;338;556;1787;642;2125
251110;201512;1988;5809;1734;5320;168;498;1154;3542;1322;4040
251120;201512;6157;20758;5861;20227;724;2872;4238;14417;4962;17289
251130;201512;4039;10437;3681;10054;15;36;3622;9917;3637;9953
251140;201512;4160;12790;3903;12384;131;572;3269;10321;3400;10893
251150;201512;2511;8176;2339;7916;200;896;1747;5730;1947;6626
251160;201512;1795;5899;1731;5816;70;277;1568;5265;1638;5542
251170;201512;1424;4302;1345;4207;90;361;1123;3440;1213;3801
251180;201512;2539;7697;2317;7358;405;1285;1397;4426;1802;5711
251190;201512;4334;12021;4167;11833;179;521;3846;10918;4025;11439
251200;201512;3811;12357;3667;12180;101;447;3358;11093;3459;11540
251203;201512;1048;3492;1014;3427;54;270;800;2651;854;2921
251207;201512;1128;3496;972;3219;62;287;663;2100;725;2387
251210;201512;7976;22534;6789;20982;770;2328;5132;16305;5902;18633
251220;201512;1131;3028;929;2718;95;281;688;2020;783;2301
251230;201512;4463;13510;4118;13107;229;914;3664;11530;3893;12444
251240;201512;3224;9846;3001;9558;429;1357;2160;6877;2589;8234
251250;201512;10295;30426;9472;29156;964;3441;7055;21284;8019;24725
251260;201512;511;1617;465;1550;21;88;350;1150;371;1238
251270;201512;4236;13568;3936;13206;153;703;3485;11655;3638;12358
251272;201512;1351;3991;1299;3917;83;276;1138;3422;1221;3698
251274;201512;896;2823;803;2661;77;319;569;1840;646;2159
251275;201512;1234;3635;1171;3534;76;335;879;2505;955;2840
251276;201512;1202;3710;1120;3559;86;348;816;2511;902;2859
251278;201512;567;1821;504;1694;60;249;333;1100;393;1349
251280;201512;2296;7008;2161;6785;138;529;1693;5156;1831;5685
251290;201512;5610;15486;5267;15073;598;2123;4080;11305;4678;13428
251300;201512;745;2531;696;2451;42;185;547;1907;589;2092
251310;201512;3008;8911;2765;8560;119;489;2247;6788;2366;7277
251315;201512;1610;5591;1528;5446;182;663;1057;3794;1239;4457
251320;201512;1882;5255;1463;4547;60;210;1068;3301;1128;3511
251330;201512;1814;4877;1559;4536;75;308;1347;3821;1422;4129
251335;201512;1026;3480;944;3329;90;406;655;2256;745;2662
251340;201512;3469;9773;3001;9055;227;887;2241;6542;2468;7429
251350;201512;1341;4232;1238;4052;94;350;941;2995;1035;3345
251360;201512;1787;5711;1615;5489;66;290;1403;4766;1469;5056
251365;201512;817;2387;645;2018;21;87;456;1392;477;1479
251370;201512;21844;68713;21232;67856;1869;7372;16771;52039;18640;59411
251380;201512;1341;4178;1147;3845;45;243;943;3029;988;3272
251385;201512;821;2229;704;2039;87;253;456;1273;543;1526
251390;201512;5850;20017;5286;18996;1326;4896;2715;9871;4041;14767
251392;201512;1045;3115;929;2919;73;254;704;2191;777;2445
251394;201512;608;1885;495;1665;46;155;335;1121;381;1276
251396;201512;851;2396;736;2203;104;315;474;1397;578;1712
251398;201512;995;2897;855;2620;54;202;567;1704;621;1906
251400;201512;1187;3313;1012;3069;94;340;733;2148;827;2488
251410;201512;1349;3633;1233;3449;67;259;1025;2804;1092;3063
251420;201512;1961;5688;1747;5429;224;716;1248;3847;1472;4563
251430;201512;1709;5920;1549;5653;83;412;1278;4575;1361;4987
251440;201512;1299;3819;1060;3354;66;239;777;2435;843;2674
251445;201512;1505;4628;1421;4503;105;435;1094;3323;1199;3758
251450;201512;4486;14416;4198;14021;123;566;3565;11847;3688;12413
251455;201512;1083;3489;970;3282;93;355;664;2247;757;2602
251460;201512;814;2521;760;2434;84;240;592;1949;676;2189
251465;201512;445;1410;389;1287;20;91;283;905;303;996
251470;201512;1171;3435;966;3036;87;305;594;1848;681;2153
251480;201512;960;2674;850;2485;31;144;686;1930;717;2074
251490;201512;1743;5237;1562;4954;165;616;1081;3375;1246;3991
251500;201512;1705;5514;1649;5405;142;552;1270;4069;1412;4621
251510;201512;2593;8470;2332;7934;421;1476;1303;4438;1724;5914
251520;201512;930;2577;824;2399;120;350;507;1460;627;1810
251530;201512;11685;32964;11054;32074;384;1643;9481;26764;9865;28407
251540;201512;2838;9182;2611;8726;189;788;2078;6862;2267;7650
251550;201512;3525;9115;3016;8433;84;340;2544;6982;2628;7322
251560;201512;697;2168;643;2069;86;326;384;1161;470;1487
251570;201512;1006;2975;804;2564;49;211;552;1681;601;1892
251580;201512;1933;5403;1781;5193;411;1010;1089;3372;1500;4382
251590;201512;1542;4931;1478;4850;69;271;1216;3960;1285;4231
251593;201512;1004;3132;931;3035;138;470;569;1810;707;2280
251597;201512;1901;5848;1833;5762;74;314;1598;4935;1672;5249
251600;201512;6560;19242;6093;18502;378;1275;4899;14770;5277;16045
251610;201512;3203;9726;2946;9321;317;994;2144;6831;2461;7825
251615;201512;1151;3313;930;2929;72;303;650;1982;722;2285
251620;201512;15043;41610;13204;39352;935;2886;10799;32741;11734;35627
251630;201512;4575;11844;3930;10935;281;826;3110;8547;3391;9373
251640;201512;2579;7506;2146;6754;127;507;1616;5021;1743;5528
251650;201512;3904;11349;3586;10923;235;790;3064;9284;3299;10074
251660;201512;3427;11150;3167;10687;118;586;2639;8657;2757;9243
251670;201512;4438;13095;3787;12257;57;188;3474;11385;3531;11573
251675;201512;721;2300;660;2212;150;554;368;1187;518;1741
251680;201512;2696;7755;2203;6975;106;464;1721;5328;1827;5792
251690;201512;3279;9909;3055;9468;163;571;2365;7208;2528;7779
251700;201512;1979;6369;1851;6198;114;507;1570;5177;1684;5684
251710;201512;928;2403;673;1918;82;268;378;1035;460;1303
251720;201512;1410;4311;1230;3990;81;385;931;2900;1012;3285
251740;201512;779;2199;613;1907;82;264;362;1129;444;1393
260005;201512;25530;61947;21509;56228;4650;12080;11667;30659;16317;42739
260010;201512;9943;26675;8099;24312;1378;4062;4620;14519;5998;18581
260020;201512;5749;16482;4845;15130;284;1013;3769;11896;4053;12909
260030;201512;6017;17364;5379;16367;407;1394;4140;12547;4547;13941
260040;201512;10127;24507;8305;22402;793;2036;6265;17484;7058;19520
260050;201512;11260;34811;10484;33905;592;2116;9015;29440;9607;31556
260060;201512;3896;10956;3445;10169;342;1017;2519;7497;2861;8514
260070;201512;9772;28235;8964;26940;1423;4567;5699;16890;7122;21457
260080;201512;5569;15021;4914;14069;610;1818;3427;9730;4037;11548
260090;201512;5096;14224;4753;13717;978;2713;3098;9115;4076;11828
260100;201512;3314;9132;2868;8503;194;794;2339;6827;2533;7621
260105;201512;4770;13616;4501;13134;334;1202;3603;10255;3937;11457
260110;201512;20895;59086;19191;57026;895;2773;16847;50142;17742;52915
260120;201512;11454;35124;10249;32950;2448;8064;5125;17001;7573;25065
260130;201512;3258;9129;3029;8768;480;1371;2051;5980;2531;7351
260140;201512;13251;32822;11263;30383;857;2506;8911;24177;9768;26683
260150;201512;3124;8824;2771;8341;208;788;2143;6367;2351;7155
260160;201512;5650;17768;4971;16880;330;1427;4032;13617;4362;15044
260170;201512;16603;46500;15778;45294;1224;3747;12807;36495;14031;40242
260180;201512;3284;9988;2963;9529;184;660;2445;7841;2629;8501
260190;201512;16033;37477;14635;35726;488;1289;12689;30640;13177;31929
260200;201512;10667;29259;9835;28127;670;2155;8187;23605;8857;25760
260210;201512;11479;34868;10320;33111;626;2428;8371;26793;8997;29221
260220;201512;9373;27311;9035;26859;444;1718;7937;23211;8381;24929
260230;201512;9524;27391;8760;26318;453;1570;7113;21448;7566;23018
260240;201512;2993;8992;2585;8390;368;1307;1774;5787;2142;7094
260250;201512;2331;6393;2082;6068;105;314;1785;5212;1890;5526
260260;201512;12149;34179;11050;32614;1837;5710;7616;22773;9453;28483
260270;201512;3616;10494;3335;10067;280;1149;2479;7130;2759;8279
260280;201512;12863;41542;11752;39848;733;2616;9780;33494;10513;36110
260290;201512;30694;92100;28796;88639;5063;16597;17538;53056;22601;69653
260300;201512;8561;26088;7555;24559;458;1974;5836;18933;6294;20907
260310;201512;4695;13781;4280;13163;1248;3540;2210;7357;3458;10897
260320;201512;7059;22837;6503;21946;377;1479;5358;18098;5735;19577
260330;201512;2626;8403;2428;8046;133;569;1877;6091;2010;6660
260340;201512;1873;5489;1733;5269;73;258;1516;4569;1589;4827
260345;201512;23261;72031;21626;68777;5756;20138;8189;24589;13945;44727
260350;201512;4727;12833;4386;12338;235;833;3673;10169;3908;11002
260360;201512;2316;6802;2104;6435;187;693;1421;4308;1608;5001
260370;201512;5872;18097;5152;16778;487;1894;3645;11807;4132;13701
260380;201512;4877;15923;4429;15241;321;1304;3302;11310;3623;12614
260390;201512;4369;13900;3811;12789;343;1324;2692;8845;3035;10169
260392;201512;3545;11148;3241;10761;203;896;2776;9061;2979;9957
260400;201512;13635;38726;12859;37406;1755;5685;8695;24672;10450;30357
260410;201512;61386;174471;52952;160655;15300;48996;19651;60670;34951;109666
260415;201512;3873;12206;3307;11062;323;1333;2073;6656;2396;7989
260420;201512;12001;27341;10658;25894;278;854;9580;22997;9858;23851
260430;201512;2829;9220;2492;8616;259;915;1689;5880;1948;6795
260440;201512;3284;9860;2899;9077;424;1466;1739;5291;2163;6757
260450;201512;4947;14633;4717;14300;203;696;4149;12631;4352;13327
260460;201512;5612;17483;5101;16495;937;3272;2850;9022;3787;12294
260470;201512;4552;13684;4221;13263;236;726;3659;11778;3895;12504
260480;201512;4083;11637;3579;10924;581;1965;2292;7026;2873;8991
260490;201512;5028;13371;4359;12224;297;952;3463;9502;3760;10454
260500;201512;5973;17030;5291;15928;792;2407;3462;10381;4254;12788
260510;201512;8715;23366;8037;22490;402;1303;7035;19552;7437;20855
260515;201512;4759;14450;3651;12182;250;964;2322;7703;2572;8667
260520;201512;15836;41660;15128;40681;2236;6016;10924;29394;13160;35410
260530;201512;9708;29527;8598;27851;435;1595;7215;23411;7650;25006
260540;201512;6050;14945;5484;14338;782;1497;4258;11743;5040;13240
260545;201512;71;254;40;159;8;33;11;38;19;71
260550;201512;2767;9017;2342;8097;489;1866;932;3161;1421;5027
260560;201512;6295;16491;5663;15567;175;647;4970;13434;5145;14081
260570;201512;6894;22555;6273;21526;689;2658;4425;15079;5114;17737
260580;201512;3704;10411;3406;9908;181;619;2816;7993;2997;8612
260590;201512;6114;15333;5750;14902;300;824;4968;12847;5268;13671
260600;201512;27399;80525;24581;75746;2256;8132;17611;53685;19867;61817
260610;201512;6652;19840;6270;19245;936;2999;4289;13021;5225;16020
260620;201512;15947;48035;15120;46535;2628;8845;9279;27925;11907;36770
260630;201512;2206;6570;1955;6144;148;615;1542;4687;1690;5302
260640;201512;17191;47275;16037;45638;2615;7665;10208;29064;12823;36729
260650;201512;5338;17009;4749;15984;447;1624;3561;12137;4008;13761
260660;201512;7967;22058;7113;20964;360;1236;6063;17744;6423;18980
260670;201512;2396;6410;1924;5748;169;557;1347;4023;1516;4580
260680;201512;21823;60868;19732;57116;4102;12219;9616;27604;13718;39823
260690;201512;3681;9960;3093;8993;235;693;2397;6969;2632;7662
260700;201512;5667;16783;5520;16630;42;108;5409;16418;5451;16526
260710;201512;1298;3824;1189;3676;90;315;912;2818;1002;3133
260720;201512;16995;54830;15907;52724;3720;12715;8202;27358;11922;40073
260730;201512;6715;22439;6232;21624;1073;3842;4170;14484;5243;18326
260740;201512;1281;3862;1117;3570;119;441;771;2452;890;2893
260750;201512;6788;20652;6069;19702;516;1639;4959;16363;5475;18002
260760;201512;4728;12699;4394;12250;262;807;3628;10151;3890;10958
260765;201512;7780;26188;7384;25525;1103;4819;4920;16277;6023;21096
260770;201512;3774;9976;3471;9528;121;422;2895;7803;3016;8225
260775;201512;5078;14653;4765;14160;478;1702;3374;9737;3852;11439
260780;201512;3643;11724;3378;11189;671;2483;1730;5477;2401;7960
260790;201512;111448;280697;102739;267291;21278;56619;58688;151835;79966;208454
260795;201512;3043;9171;2726;8682;281;1007;1884;6008;2165;7015
260800;201512;4814;12992;4456;12491;162;642;3963;10768;4125;11410
260805;201512;3959;11437;3451;10641;404;1415;2315;6983;2719;8398
260810;201512;6917;19328;6681;19037;322;959;5857;16658;6179;17617
260820;201512;4291;12007;3861;11376;913;2772;2012;5814;2925;8586
260825;201512;2881;9195;2582;8699;218;801;1950;6609;2168;7410
260830;201512;3734;12015;3328;11212;718;2362;1907;6642;2625;9004
260840;201512;4255;12127;3771;11407;253;939;3031;9014;3284;9953
260845;201512;4194;12165;3914;11653;507;1573;2759;8247;3266;9820
260850;201512;4985;16198;4386;14845;850;3188;2082;6835;2932;10023
260860;201512;3352;10525;2985;9778;174;677;2295;7459;2469;8136
260870;201512;4224;11590;3740;10974;490;1300;2760;8291;3250;9591
260875;201512;6497;17910;5749;16772;885;2585;3785;11123;4670;13708
260880;201512;9395;28818;8601;27475;750;2435;6638;21400;7388;23835
260890;201512;13264;37859;12335;36402;892;3013;9330;27310;10222;30323
260900;201512;5934;18133;5032;16384;522;2050;3139;10019;3661;12069
260910;201512;2999;9047;2715;8614;199;738;2070;6565;2269;7303
260915;201512;4497;15143;4259;14804;83;386;3920;13615;4003;14001
260920;201512;3224;9868;2996;9543;269;1036;2338;7450;2607;8486
260930;201512;3968;12828;3482;12021;401;1457;2445;8480;2846;9937
260940;201512;13754;36643;12447;34477;1631;5068;8112;21797;9743;26865
260950;201512;6262;19317;5673;18138;872;3223;3008;9151;3880;12374
260960;201512;56727;157075;51610;148462;10199;30969;27299;77751;37498;108720
260970;201512;4860;15068;4441;14485;269;1110;3517;11374;3786;12484
260980;201512;3856;12454;3611;12142;125;524;3214;10785;3339;11309
260990;201512;16901;52875;15279;50674;1133;4221;12057;40177;13190;44398
261000;201512;16291;44055;13088;39038;2456;7736;6638;20363;9094;28099
261010;201512;2563;7144;2344;6876;155;349;2039;6163;2194;6512
261020;201512;5866;17325;5214;16233;540;1832;3852;11738;4392;13570
261030;201512;3467;11077;3161;10520;228;915;2469;8092;2697;9007
261040;201512;5182;16657;4487;15271;390;1568;3228;10853;3618;12421
261050;201512;7989;23287;7410;22220;1056;3188;4820;14442;5876;17630
261060;201512;12101;35652;11162;33927;1059;3763;8108;23988;9167;27751
261070;201512;50895;125067;44388;115707;6782;18008;28247;73718;35029;91726
261080;201512;5766;16723;5399;16161;378;1067;4570;13908;4948;14975
261090;201512;16578;45428;15178;43509;1444;4049;11776;34116;13220;38165
261100;201512;7971;25184;7071;23560;1328;4742;3911;13199;5239;17941
261110;201512;60874;179049;53711;167970;12536;41352;27253;86568;39789;127920
261120;201512;3666;9785;3211;9227;95;365;2844;8142;2939;8507
261130;201512;7007;17866;6524;17321;192;599;5937;15679;6129;16278
261140;201512;3286;9179;2961;8682;403;1348;1795;5085;2198;6433
261150;201512;5312;15577;4884;14881;425;1536;3875;11721;4300;13257
261153;201512;2100;6084;1703;5462;73;299;1263;4055;1336;4354
261160;201512;200976;523719;184801;499739;44393;124078;89513;244479;133906;368557
261170;201512;5903;16064;5320;15196;585;1718;3950;11380;4535;13098
261180;201512;9632;26784;8994;25869;1033;3233;6122;17387;7155;20620
261190;201512;5103;15805;4738;15346;524;2210;3287;10215;3811;12425
261200;201512;3673;9207;3297;8749;428;1097;2554;6936;2982;8033
261210;201512;1906;5041;1784;4886;129;351;1560;4297;1689;4648
261220;201512;13106;40855;10891;35982;1881;6788;5432;17771;7313;24559
261230;201512;4336;13118;3979;12668;163;647;3457;11019;3620;11666
261240;201512;4869;14341;4454;13621;650;1857;3002;9399;3652;11256
261245;201512;3562;10996;3037;10041;162;731;2375;7658;2537;8389
261247;201512;3321;10152;2802;9194;220;870;2009;6607;2229;7477
261250;201512;19886;52645;18632;50958;3588;9496;12683;35558;16271;45054
261255;201512;3983;12387;3583;11677;213;809;2919;9445;3132;10254
261260;201512;12051;33981;10779;32414;602;1929;8992;27148;9594;29077
261270;201512;3643;10756;3273;10148;409;1437;2195;6638;2604;8075
261280;201512;2514;7681;2308;7375;138;508;1869;5928;2007;6436
261290;201512;2929;8376;2660;8021;161;600;2153;6480;2314;7080
261300;201512;10681;34431;9309;31907;1509;5870;5539;18671;7048;24541
261310;201512;7355;22516;6880;21629;1664;5323;3746;11800;5410;17123
261320;201512;5579;17516;5132;16694;225;889;4137;13364;4362;14253
261330;201512;5440;15885;5135;15464;484;1509;4009;12014;4493;13523
261340;201512;4017;13323;3795;12947;410;1759;2520;8451;2930;10210
261350;201512;8074;26609;7522;25649;302;1485;6037;20093;6339;21578
261360;201512;8170;21469;7290;20221;614;1840;5733;15622;6347;17462
261370;201512;19675;57739;18262;55462;3847;12176;10183;30917;14030;43093
261380;201512;4114;14051;3770;13304;603;2347;2350;8284;2953;10631
261390;201512;15947;48538;14341;45763;2151;7441;8643;27465;10794;34906
261400;201512;4780;16353;4245;15220;378;1564;2949;10540;3327;12104
261410;201512;8654;24140;7795;22806;985;2882;5652;16705;6637;19587
261420;201512;7387;24853;7045;24374;1701;6652;4027;13580;5728;20232
261430;201512;3419;10671;2986;10036;284;1000;2263;7717;2547;8717
261440;201512;1565;5041;1412;4810;62;332;1107;3659;1169;3991
261450;201512;14038;39629;13537;39025;364;1305;12261;35136;12625;36441
261460;201512;7170;21049;6694;20425;450;1269;5731;17804;6181;19073
261470;201512;3921;10708;3549;10218;131;424;3215;9254;3346;9678
261480;201512;3621;12925;3313;12343;338;1392;2357;8642;2695;10034
261485;201512;5009;15301;4497;14364;739;2695;2636;8227;3375;10922
261500;201512;5709;15763;5038;14857;468;1285;3773;11465;4241;12750
261510;201512;1911;6105;1758;5863;141;514;1318;4393;1459;4907
261520;201512;2643;8589;2447;8220;145;551;1663;5806;1808;6357
261530;201512;12010;38238;10502;35271;2231;8349;4343;14394;6574;22743
261540;201512;7273;23365;6861;22629;1506;4965;4041;13624;5547;18589
261550;201512;3443;9755;3238;9455;262;984;2535;7182;2797;8166
261560;201512;7175;23308;6426;22304;1015;3898;4441;15556;5456;19454
261570;201512;3415;10385;2986;9683;425;1463;1896;6122;2321;7585
261580;201512;5908;18180;5299;17185;366;1468;4350;14003;4716;15471
261590;201512;2407;6854;2126;6430;185;569;1573;4793;1758;5362
261600;201512;5183;14151;4469;13145;346;1058;3480;10300;3826;11358
261610;201512;2434;7035;2103;6574;111;477;1658;5080;1769;5557
261618;201512;2474;6941;2246;6643;207;651;1686;4900;1893;5551
261620;201512;4100;12698;3805;12194;641;2120;2492;8090;3133;10210
261630;201512;7746;22554;6453;20115;869;3154;3594;10874;4463;14028
261640;201512;32784;82506;30422;79600;2194;5575;24376;65865;26570;71440
261650;201512;3680;11214;3407;10828;385;1395;2436;7741;2821;9136
270010;201512;4446;16704;4059;15942;452;2125;2715;10656;3167;12781
270020;201512;3849;10951;3568;10527;438;1381;2642;7702;3080;9083
270030;201512;40143;119677;37275;115000;9192;29011;19936;62042;29128;91053
270040;201512;10680;32521;9837;31405;2170;6924;5686;18745;7856;25669
270050;201512;4305;12081;3928;11606;449;1457;2994;8825;3443;10282
270060;201512;1789;5444;1655;5263;290;990;1085;3478;1375;4468
270070;201512;4231;13174;3883;12713;205;1009;3293;10477;3498;11486
270080;201512;1267;4005;1103;3665;159;601;689;2212;848;2813
270090;201512;2112;6536;1938;6176;60;313;1633;5011;1693;5324
270100;201512;5735;17753;5386;17115;919;3111;3431;10761;4350;13872
270110;201512;3226;8818;2855;8407;396;1176;1877;5907;2273;7083
270120;201512;3093;8793;2743;8352;98;367;2459;7510;2557;7877
270130;201512;5029;15303;4679;14900;654;2107;3551;11557;4205;13664
270135;201512;1759;4665;1628;4506;185;362;1372;3983;1557;4345
270140;201512;10332;25044;8867;23177;771;3016;6903;16740;7674;19756
270150;201512;2693;8911;2617;8813;77;256;2460;8336;2537;8592
270160;201512;5073;16823;4643;16277;234;979;3944;13749;4178;14728
270170;201512;3846;12342;3518;11882;606;2369;2052;6815;2658;9184
270180;201512;2214;7366;2025;7103;107;556;1650;5667;1757;6223
270190;201512;1794;5881;1705;5765;102;414;1426;4826;1528;5240
270200;201512;2595;8623;2420;8373;206;882;1839;6251;2045;7133
270210;201512;4601;13910;4322;13509;302;1239;3558;10857;3860;12096
270220;201512;1402;4548;1305;4367;250;902;735;2419;985;3321
270230;201512;10962;34395;9512;31992;1285;5281;5837;18892;7122;24173
270235;201512;6358;20509;5919;19782;403;1730;4790;15751;5193;17481
270240;201512;9504;28400;7920;26287;1976;6814;3709;12536;5685;19350
270250;201512;3250;8520;2957;8162;516;1365;2191;6056;2707;7421
270255;201512;5012;15001;3953;13081;281;1139;2805;9086;3086;10225
270260;201512;5750;18767;5559;18490;446;1869;4644;15137;5090;17006
270270;201512;1200;3413;1095;3256;206;648;635;1841;841;2489
270280;201512;3587;10155;3181;9572;374;1104;2235;6741;2609;7845
270290;201512;8232;28538;7671;27556;713;3089;5843;20666;6556;23755
270300;201512;3585;11692;3219;11257;334;1323;2335;8102;2669;9425
270310;201512;7409;22384;6467;20916;288;1459;5392;16970;5680;18429
270320;201512;5871;18625;5605;18196;814;3139;3929;12404;4743;15543
270330;201512;4358;14642;4077;14249;399;1518;3204;11260;3603;12778
270340;201512;1753;5359;1540;5074;129;436;1198;3946;1327;4382
270350;201512;1902;5210;1711;4979;145;500;1258;3633;1403;4133
270360;201512;2015;6221;1931;6125;205;583;1581;5174;1786;5757
270370;201512;1557;5131;1411;4871;131;551;1006;3455;1137;4006
270375;201512;2843;7924;2526;7486;218;757;1984;5763;2202;6520
270380;201512;5706;17616;5338;17098;532;1732;4094;13352;4626;15084
270390;201512;1240;3449;1091;3230;80;300;818;2326;898;2626
270400;201512;6367;18978;5689;18003;405;1526;4091;12621;4496;14147
270410;201512;4832;15001;4439;14249;481;1713;3124;9875;3605;11588
270420;201512;5798;18556;5570;18237;266;1209;4570;14617;4836;15826
270430;201512;134454;389872;122705;371706;33356;106115;53281;163811;86637;269926
270440;201512;4754;14265;4361;13715;231;894;3540;11131;3771;12025
270450;201512;6341;19493;6061;19134;352;1446;4979;15483;5331;16929
270460;201512;3467;9258;3088;8766;206;679;2621;7339;2827;8018
270470;201512;10427;33077;9552;31621;1487;5137;5827;19577;7314;24714
270480;201512;2922;9036;2570;8398;254;1010;1749;5487;2003;6497
270490;201512;958;3091;895;2990;40;168;723;2387;763;2555
270500;201512;4999;16825;4704;16462;337;1441;3872;13479;4209;14920
270510;201512;5988;17800;5352;16911;715;2842;3851;11646;4566;14488
270520;201512;3665;11561;3329;10982;978;3536;1228;4106;2206;7642
270530;201512;1437;4365;1316;4177;157;513;879;2866;1036;3379
270540;201512;2045;6875;1867;6615;129;661;1491;5099;1620;5760
270550;201512;7240;20976;6264;19702;884;2956;4194;13430;5078;16386
270560;201512;3051;9191;2838;8867;316;1193;2059;6254;2375;7447
270570;201512;3980;12845;3630;12244;357;1501;2742;9042;3099;10543
270580;201512;2021;6439;1920;6298;186;622;1481;4936;1667;5558
270590;201512;1370;4545;1302;4428;19;83;1250;4249;1269;4332
270600;201512;2832;9424;2548;8950;164;818;1973;6745;2137;7563
270610;201512;3205;10062;2946;9680;216;791;2381;7758;2597;8549
270620;201512;1378;4677;1294;4541;96;456;1020;3431;1116;3887
270630;201512;16942;48523;15552;46246;2374;6887;10518;32005;12892;38892
270640;201512;5778;17722;5188;16870;349;1462;4145;13187;4494;14649
270642;201512;2287;8023;2135;7799;254;1147;1567;5612;1821;6759
270644;201512;2650;7708;2343;7319;279;809;1761;5646;2040;6455
270650;201512;3697;11710;3505;11430;527;2311;2364;7202;2891;9513
270660;201512;2456;6204;1896;5397;95;363;1357;3782;1452;4145
270670;201512;16451;42414;14094;39698;1915;5185;10161;29596;12076;34781
270680;201512;4293;12680;4100;12463;162;412;3750;11550;3912;11962
270690;201512;8880;24488;7993;23482;2525;7136;4065;12636;6590;19772
270700;201512;671;2067;606;1953;78;315;417;1285;495;1600
270710;201512;5989;19082;5683;18682;458;1712;4680;15270;5138;16982
270720;201512;3330;11207;3024;10665;153;812;2453;8446;2606;9258
270730;201512;6222;18534;5890;18169;652;2179;4725;14637;5377;16816
270740;201512;2338;6650;2200;6451;277;916;1626;4671;1903;5587
270750;201512;4990;15626;4620;15043;659;2346;3245;10471;3904;12817
270760;201512;3394;10269;3035;9662;214;803;2330;7348;2544;8151
270770;201512;19424;50397;15848;46006;3403;9887;8675;26290;12078;36177
270780;201512;1818;5943;1709;5760;202;785;1203;4023;1405;4808
270790;201512;1568;4868;1426;4649;350;1221;718;2286;1068;3507
270800;201512;11345;33485;10499;32367;813;3029;8550;25924;9363;28953
270810;201512;3357;10139;2594;8744;290;1169;1593;5353;1883;6522
270820;201512;1784;5879;1603;5567;284;1071;944;3263;1228;4334
270830;201512;5543;15230;4997;14554;414;1329;3963;11747;4377;13076
270840;201512;7860;25384;7245;24584;352;1795;6260;20747;6612;22542
270850;201512;7376;23250;7092;22882;1186;4601;4762;14542;5948;19143
270860;201512;11326;31494;9555;29166;1132;4063;6438;19154;7570;23217
270870;201512;2208;6612;1813;5792;269;901;1114;3516;1383;4417
270880;201512;8163;26018;7566;25122;536;2168;6032;19717;6568;21885
270890;201512;2442;7367;2285;7088;255;960;1656;4986;1911;5946
270895;201512;2901;10656;2775;10478;166;752;2390;9034;2556;9786
270900;201512;1954;5277;1574;4729;91;308;1184;3494;1275;3802
270910;201512;3555;11634;3297;11161;257;1154;2531;8299;2788;9453
270915;201512;9709;32227;8669;30350;1449;5905;5000;17054;6449;22959
270920;201512;6103;19247;5860;18909;231;1218;5231;16379;5462;17597
270930;201512;17527;46355;14323;42392;2797;8345;8315;25544;11112;33889
270940;201512;5748;18971;5438;18631;522;2283;4277;14424;4799;16707
280010;201512;645;1926;549;1747;56;245;346;1028;402;1273
280020;201512;4782;13894;4075;12664;743;2489;2443;7474;3186;9963
280030;201512;74616;194740;63483;177856;18114;52693;24629;70270;42743;122963
280040;201512;3147;9608;2785;9056;263;996;2047;6585;2310;7581
280050;201512;3795;12083;3492;11557;1186;4167;1273;4327;2459;8494
280060;201512;4548;14703;4102;13868;836;3042;2135;7334;2971;10376
280067;201512;7395;20787;6316;19173;913;2733;3996;12326;4909;15059
280070;201512;1883;6232;1786;6086;271;975;1257;4299;1528;5274
280100;201512;3854;11913;3429;11155;669;2356;1979;6432;2648;8788
280110;201512;1413;4268;1292;4082;73;318;1076;3333;1149;3651
280120;201512;7859;24607;7182;23504;1276;3778;4700;16152;5976;19930
280130;201512;7347;20691;6682;19712;1142;3578;4297;12730;5439;16308
280140;201512;5540;15055;5001;14283;447;1349;3928;11259;4375;12608
280150;201512;3394;10166;3125;9699;327;1148;2184;6583;2511;7731
280160;201512;1378;3994;1199;3702;157;512;800;2428;957;2940
280170;201512;4827;14238;4318;13475;491;1535;3170;10072;3661;11607
280190;201512;1094;3015;967;2799;66;235;738;2073;804;2308
280200;201512;1162;3479;1057;3321;129;510;743;2235;872;2745
280210;201512;13368;40058;11945;38014;2329;7840;6893;22165;9222;30005
280220;201512;1547;4752;1444;4585;96;383;1171;3637;1267;4020
280230;201512;3467;10316;3077;9688;388;1318;1989;6283;2377;7601
280240;201512;3448;10062;3111;9525;290;856;2384;7346;2674;8202
280250;201512;810;2138;659;1895;123;414;329;853;452;1267
280260;201512;2005;5366;1850;5172;80;251;1653;4636;1733;4887
280270;201512;2300;7056;2003;6594;128;502;1548;5005;1676;5507
280280;201512;4185;13463;3783;12781;834;2307;2111;8008;2945;10315
280290;201512;17187;52329;15421;49515;2210;7821;9594;30967;11804;38788
280300;201512;9570;28869;8880;28017;926;3163;6849;22037;7775;25200
280310;201512;1350;3798;1187;3534;73;299;837;2427;910;2726
280320;201512;8507;27176;7722;25794;1545;5667;3853;12664;5398;18331
280330;201512;4506;12655;4079;11959;424;1504;3085;8678;3509;10182
280340;201512;3781;10703;3539;10372;367;1213;2734;8006;3101;9219
280350;201512;21800;61307;19308;57489;3043;9471;12280;36720;15323;46191
280360;201512;5708;17790;5308;17119;1027;3765;2936;9177;3963;12942
280370;201512;1862;5207;1609;4778;151;467;1123;3296;1274;3763
280380;201512;1043;3191;940;3024;99;373;675;2112;774;2485
280390;201512;3127;9219;2651;8309;411;1368;1675;5206;2086;6574
280400;201512;4159;11832;3733;11216;1268;3747;1631;5172;2899;8919
280410;201512;2189;6910;1836;6203;257;989;1057;3420;1314;4409
280420;201512;4057;11887;3762;11421;237;764;3157;9561;3394;10325
280430;201512;2242;5705;2017;5395;104;351;1583;4137;1687;4488
280440;201512;4713;13905;4388;13518;397;1337;3518;10722;3915;12059
280445;201512;2500;7002;2314;6688;79;310;1852;5246;1931;5556
280450;201512;8860;23877;8236;23087;608;1476;6906;19879;7514;21355
280460;201512;6970;18303;6236;17250;862;2493;4404;12321;5266;14814
280470;201512;1797;5451;1622;5152;191;600;1147;3691;1338;4291
280480;201512;30154;88162;28442;85588;4869;16543;18002;52656;22871;69199
280490;201512;3810;11351;3311;10493;256;981;2434;7537;2690;8518
280500;201512;920;2459;824;2335;54;172;674;1853;728;2025
280510;201512;2708;7783;2333;7281;225;781;1695;5301;1920;6082
280520;201512;1776;4862;1607;4649;152;427;1297;3805;1449;4232
280530;201512;2319;6457;2150;6248;154;450;1756;5139;1910;5589
280540;201512;9217;25267;8537;24328;235;975;7451;20747;7686;21722
280550;201512;6886;18131;5790;16439;626;1799;4024;11468;4650;13267
280560;201512;7471;22072;7059;21449;393;1357;5899;17676;6292;19033
280570;201512;6468;17383;5631;16251;607;1971;3792;10745;4399;12716
280580;201512;5608;17233;4714;15645;827;2792;2736;9294;3563;12086
280590;201512;2344;7099;2171;6874;240;1048;1494;4543;1734;5591
280600;201512;3744;11399;3484;11003;325;1148;2590;8079;2915;9227
280610;201512;2474;6920;2260;6596;220;786;1605;4521;1825;5307
280620;201512;5234;15464;4529;14202;613;1839;3019;9788;3632;11627
280630;201512;3793;12190;3567;11848;366;1151;2799;9583;3165;10734
280640;201512;2237;6621;2124;6492;95;253;1966;6095;2061;6348
280650;201512;1122;3473;1003;3279;102;393;700;2258;802;2651
280660;201512;2643;7453;2524;7300;430;1165;1913;5625;2343;6790
280670;201512;15990;41891;14661;40046;2828;8148;8918;24079;11746;32227
280680;201512;2756;7438;2436;6932;206;670;1903;5309;2109;5979
280690;201512;951;2705;839;2544;123;385;568;1712;691;2097
280700;201512;1085;3196;951;2989;72;239;682;2138;754;2377
280710;201512;11699;30849;10674;29671;745;1888;8996;25562;9741;27450
280720;201512;2289;6251;2074;5995;272;815;1406;4140;1678;4955
280730;201512;926;2761;858;2667;92;327;673;2056;765;2383
280740;201512;13139;35549;11308;32724;1588;4501;7199;21178;8787;25679
280750;201512;3563;10754;3239;10194;332;1125;2243;7086;2575;8211
280760;201512;5698;17243;5135;16415;791;2723;3145;10279;3936;13002
290010;201512;3004;6752;2146;5428;54;227;1688;4050;1742;4277
290020;201512;4393;14608;4308;14490;397;1090;3575;12286;3972;13376
290030;201512;3133;9744;2948;9466;535;1692;2015;6526;2550;8218
290035;201512;4672;11855;4000;10957;231;771;3104;8730;3335;9501
290040;201512;3978;10792;3403;10137;201;778;2686;7886;2887;8664
290050;201512;2507;8095;2206;7597;163;673;1648;5637;1811;6310
290060;201512;1323;3426;1117;3177;188;606;803;2214;991;2820
290070;201512;33250;82918;28132;76407;6279;16775;13261;38262;19540;55037
290080;201512;6161;18171;5202;16899;681;2202;3655;12233;4336;14435
290090;201512;2162;4675;1700;4183;175;398;1399;3518;1574;3916
290100;201512;9757;27630;8464;25589;1151;3622;5306;16381;6457;20003
290110;201512;4855;14334;4587;13857;723;2396;2923;8597;3646;10993
290115;201512;4840;14471;4259;13687;238;783;3469;11397;3707;12180
290120;201512;6880;17826;5672;16383;280;954;4684;13388;4964;14342
290130;201512;4602;12050;3828;11091;206;775;3056;8590;3262;9365
290135;201512;4588;11513;3893;10449;262;860;2847;7279;3109;8139
290140;201512;4150;12825;3559;12020;276;1061;2881;9736;3157;10797
290150;201512;2146;6469;2030;6273;238;769;1564;4768;1802;5537
290160;201512;3355;8850;3214;8674;330;669;2646;7259;2976;7928
290170;201512;2728;9015;2461;8607;180;863;2046;6993;2226;7856
290180;201512;2927;8498;2530;7876;193;719;1937;5976;2130;6695
290190;201512;3787;12585;3609;12305;211;906;2790;9369;3001;10275
290195;201512;2177;5926;1838;5405;96;395;1475;4248;1571;4643
290200;201512;3830;11926;3379;11199;294;1004;2605;8671;2899;9675
290205;201512;3173;9275;2820;8729;281;1048;2026;6120;2307;7168
290210;201512;15151;42352;13695;40464;2486;6534;8993;28592;11479;35126
290220;201512;2256;6701;2121;6483;136;574;1666;4920;1802;5494
290225;201512;2915;7494;2640;7190;164;444;2345;6412;2509;6856
290230;201512;2298;7385;2182;7250;143;582;1792;5926;1935;6508
290240;201512;3655;9803;3315;9289;309;920;2484;6834;2793;7754
290250;201512;3765;11952;3360;11354;191;647;2752;9599;2943;10246
290260;201512;4996;14211;4182;12967;348;1204;3176;9821;3524;11025
290265;201512;3344;10461;2969;9765;157;676;2313;7527;2470;8203
290270;201512;12028;43495;11381;42455;1513;5954;8160;30831;9673;36785
290280;201512;5258;17154;4859;16492;430;1639;3629;12334;4059;13973
290290;201512;9710;30488;8626;28675;1366;4626;5633;19049;6999;23675
290300;201512;4613;12992;3265;10462;258;807;2147;7121;2405;7928
290310;201512;1458;4370;1272;4081;243;857;686;2197;929;3054
290320;201512;28554;81384;23985;75180;5810;19335;11320;36372;17130;55707
290323;201512;3840;10356;3358;9800;170;526;2792;8130;2962;8656
290327;201512;4372;13267;3718;12040;554;1837;2315;7506;2869;9343
290330;201512;1821;4502;1678;4347;143;386;1442;3751;1585;4137
290340;201512;4879;15085;4546;14652;1307;4303;2456;8002;3763;12305
290350;201512;4446;13720;3848;12818;425;1448;2649;9041;3074;10489
290360;201512;4523;13726;3897;12883;175;671;3243;10820;3418;11491
290370;201512;4776;13187;4085;12293;388;1086;3236;9903;3624;10989
290380;201512;5656;16179;4883;15025;335;1145;3833;11894;4168;13039
290390;201512;14719;44765;13275;42595;2333;7638;7959;26463;10292;34101
290395;201512;2640;8506;2332;7934;142;640;1736;5876;1878;6516
290400;201512;3587;10502;3054;9710;296;952;2148;6788;2444;7740
290405;201512;4644;14620;3871;13122;608;2095;2265;7898;2873;9993
290410;201512;6015;17641;4864;15799;461;1764;3408;10748;3869;12512
290420;201512;3289;9457;2729;8658;217;751;2108;6669;2325;7420
290430;201512;3116;9764;2776;9145;508;1761;1674;5556;2182;7317
290440;201512;2997;7912;2435;7122;177;630;1860;5465;2037;6095
290450;201512;3320;9586;2833;8869;321;1080;1933;6031;2254;7111
290460;201512;12882;37216;11430;34744;3181;9841;4649;14218;7830;24059
290470;201512;4536;12359;3429;10695;808;2744;1465;4694;2273;7438
290475;201512;5206;17201;4643;16122;317;1443;3453;11755;3770;13198
290480;201512;2527;6681;2317;6407;304;858;1597;4616;1901;5474
290485;201512;4800;15142;4165;14189;302;1468;3289;10932;3591;12400
290490;201512;7980;20980;7558;20405;674;1903;6078;16261;6752;18164
290500;201512;4220;13142;3401;11496;524;1939;1790;6003;2314;7942
290510;201512;3385;9605;2923;8963;169;623;2421;7411;2590;8034
290515;201512;3340;9584;2831;8896;264;857;2235;7130;2499;7987
290520;201512;12158;37077;9722;32431;870;3441;5907;19504;6777;22945
290530;201512;5087;14946;4417;13898;338;1039;3441;10900;3779;11939
290540;201512;3899;11227;3688;10964;450;1324;2842;8555;3292;9879
290550;201512;4512;11915;3971;11288;139;417;3612;10309;3751;10726
290560;201512;6183;18009;5419;16870;1288;4041;3015;9639;4303;13680
290570;201512;43050;117324;38730;111088;4195;12358;27440;78555;31635;90913
290580;201512;7056;23819;6613;23114;845;3053;4695;16786;5540;19839
290590;201512;7417;23497;6338;21554;310;1303;5058;17161;5368;18464
290600;201512;17552;52742;16160;50686;2296;6912;11591;37611;13887;44523
290610;201512;2476;8301;2044;7447;149;695;1424;5095;1573;5790
290620;201512;6563;19633;5942;18648;410;1319;4816;15081;5226;16400
290630;201512;8009;20901;7035;19824;657;1901;5758;16380;6415;18281
290640;201512;2693;7779;2128;6847;153;600;1594;5046;1747;5646
290650;201512;11243;31801;10422;30637;2190;6341;6331;19182;8521;25523
290660;201512;3642;10106;3132;9362;143;481;2373;7327;2516;7808
290670;201512;6909;20967;6169;19744;704;2293;4333;14108;5037;16401
290680;201512;10267;30442;9213;29125;455;1786;7623;23912;8078;25698
290682;201512;4494;12862;3990;12134;159;608;3404;10224;3563;10832
290685;201512;3773;8926;2458;7063;291;879;1487;4371;1778;5250
290687;201512;7666;21258;5952;18659;1391;4417;2860;9334;4251;13751
290689;201512;3193;9161;2772;8496;253;813;2077;6585;2330;7398
290690;201512;5502;15601;4858;14728;792;2441;3158;9646;3950;12087
290700;201512;2350;7297;2211;7093;171;628;1699;5450;1870;6078
290710;201512;7750;24404;7240;23639;361;1218;6161;20229;6522;21447
290720;201512;18617;54181;16868;51979;1374;4053;13655;43055;15029;47108
290730;201512;7142;19710;6363;18684;1042;2958;4160;12412;5202;15370
290740;201512;937;2752;756;2427;81;280;513;1651;594;1931
290750;201512;9926;27561;8337;24603;1431;4641;4505;12791;5936;17432
290755;201512;2366;6641;1923;5903;94;349;1411;4287;1505;4636
290760;201512;4298;12829;3460;11299;473;1425;2125;7148;2598;8573
290770;201512;2522;8839;2376;8635;99;462;1920;6993;2019;7455
290780;201512;8974;22596;7707;20767;820;1708;5807;16367;6627;18075
290790;201512;4322;12966;3981;12487;253;814;3338;10505;3591;11319
290800;201512;7367;15574;5817;13910;659;1302;4314;10977;4973;12279
290810;201512;5161;15895;4337;14560;203;763;3277;11087;3480;11850
290820;201512;5650;15668;4983;14773;479;1619;3764;11209;4243;12828
290830;201512;4346;11514;3968;10964;228;751;2991;8058;3219;8809
290840;201512;17710;49752;15544;46483;2548;7394;9896;30780;12444;38174
290850;201512;6220;17880;5965;17556;752;1985;4703;14391;5455;16376
290860;201512;5057;16975;4685;16512;462;1729;3636;13081;4098;14810
290870;201512;4730;13752;3776;12169;266;1062;2690;8575;2956;9637
290880;201512;1450;3896;1131;3376;107;301;755;2288;862;2589
290890;201512;7001;18140;5951;16952;671;1760;4643;13486;5314;15246
290900;201512;2658;7368;1931;6156;293;963;976;3123;1269;4086
290910;201512;4726;12634;3906;11437;121;448;3310;9566;3431;10014
290920;201512;4691;13401;4265;12809;305;873;3485;10549;3790;11422
290930;201512;7796;23966;6818;22291;415;1797;5240;16824;5655;18621
290940;201512;3476;10983;3173;10565;137;471;2673;9088;2810;9559
290950;201512;1565;4318;1363;4011;164;478;904;2702;1068;3180
290960;201512;5768;16251;5222;15546;189;686;4356;13001;4545;13687
290970;201512;3698;11572;3202;10748;315;1067;2159;7377;2474;8444
290980;201512;10598;30115;8903;26933;2423;7506;2759;8336;5182;15842
290990;201512;9103;27118;7844;25016;854;2828;5638;17870;6492;20698
291000;201512;2984;8967;2707;8625;173;626;2361;7539;2534;8165
291005;201512;14384;37373;12516;34821;1767;4983;8468;23907;10235;28890
291010;201512;3322;10208;2576;8599;260;893;1644;5559;1904;6452
291020;201512;1385;3596;1042;2977;113;324;572;1539;685;1863
291030;201512;2253;6120;1620;4861;174;556;972;2860;1146;3416
291040;201512;5592;16641;4953;15733;372;1395;3849;12196;4221;13591
291050;201512;7823;25183;7039;23694;1701;6407;3527;11416;5228;17823
291060;201512;6043;21979;5674;21371;939;3905;3602;13412;4541;17317
291070;201512;16122;46215;14046;43196;1125;3808;10629;32701;11754;36509
291072;201512;23148;67496;18424;58067;4671;15922;6312;20004;10983;35926
291075;201512;5153;14487;4554;13616;252;655;3579;10952;3831;11607
291077;201512;1491;4192;1183;3685;98;318;758;2361;856;2679
291080;201512;78857;242984;69390;224111;23950;78423;15802;50510;39752;128933
291085;201512;5680;14802;4877;13733;424;1278;3920;11037;4344;12315
291090;201512;1542;3756;1393;3581;50;147;1230;3157;1280;3304
291100;201512;2644;6706;2139;6155;103;394;1691;4791;1794;5185
291110;201512;4733;17246;4302;16577;529;2369;2996;11330;3525;13699
291120;201512;7382;19760;6765;18840;891;2496;4700;13206;5591;15702
291125;201512;1887;3787;1423;3290;97;237;1120;2629;1217;2866
291130;201512;2873;8894;2407;8074;131;571;1784;5823;1915;6394
291140;201512;4201;12396;3647;11347;508;1534;2324;7308;2832;8842
291150;201512;1971;5179;1857;5045;119;365;1518;4067;1637;4432
291160;201512;5376;16612;4666;15408;1093;3629;2396;7948;3489;11577
291165;201512;2544;7093;1946;5967;53;217;1413;4224;1466;4441
291170;201512;21762;56293;18532;51938;1520;4619;12463;34991;13983;39610
291180;201512;6348;16496;5103;14601;454;1443;3620;10357;4074;11800
291185;201512;3767;10215;3355;9586;284;821;2676;7587;2960;8408
291190;201512;7113;19360;6255;18157;502;1716;4964;14236;5466;15952
291200;201512;2929;8668;2339;7569;165;552;1555;5123;1720;5675
291210;201512;6959;16605;5858;15336;314;960;4474;11664;4788;12624
291220;201512;4164;12880;3784;12270;482;1799;2551;8150;3033;9949
291230;201512;4042;10238;3660;9808;79;161;3436;9333;3515;9494
291240;201512;4650;12541;3985;11330;138;437;3228;9034;3366;9471
291250;201512;3593;10925;2814;9475;301;1032;1856;6335;2157;7367
291260;201512;1071;3099;983;2982;72;276;810;2384;882;2660
291270;201512;4358;14082;3931;13253;1310;4576;1792;6116;3102;10692
291280;201512;2186;6108;1696;5317;399;1385;797;2382;1196;3767
291290;201512;5589;15395;4829;14415;826;2464;2881;8726;3707;11190
291300;201512;4438;12536;3425;10797;216;789;2517;7796;2733;8585
291310;201512;5388;15304;4675;13998;315;996;3602;10747;3917;11743
291320;201512;6106;19035;4980;16854;1140;4044;2373;8043;3513;12087
291330;201512;1591;4790;1411;4495;135;485;986;3089;1121;3574
291340;201512;3901;11012;3213;10036;144;489;2571;7999;2715;8488
291345;201512;3473;10896;3208;10571;225;757;2694;9061;2919;9818
291350;201512;5768;16808;5014;15523;315;1058;3873;12137;4188;13195
291360;201512;33191;91119;29661;86124;7368;21430;16349;48804;23717;70234
291370;201512;8370;23794;7841;23129;545;1735;6095;18111;6640;19846
291380;201512;3733;11209;3190;10327;219;799;2336;7664;2555;8463
291390;201512;10064;27337;9297;26405;1401;3782;6636;19106;8037;22888
291400;201512;13794;37971;11894;35105;2335;6315;7181;22525;9516;28840
291410;201512;3269;8536;2400;7158;140;585;1738;4994;1878;5579
291420;201512;2090;5693;1814;5356;96;357;1504;4367;1600;4724
291430;201512;3286;9555;2913;9060;141;676;2354;7071;2495;7747
291440;201512;6597;19975;5548;18176;541;1883;4072;13450;4613;15333
291450;201512;8315;24172;7260;22682;356;1134;5795;18835;6151;19969
291460;201512;13277;39746;11879;37524;1751;6009;7340;23270;9091;29279
291465;201512;8020;22620;7066;21529;481;1755;5743;17307;6224;19062
291470;201512;15904;42443;13879;39988;1157;3128;10403;31017;11560;34145
291480;201512;34649;88641;29173;80958;4228;12817;16959;46839;21187;59656
291490;201512;4357;13884;4114;13541;478;1600;3025;10094;3503;11694
291500;201512;4315;12301;3628;11298;225;847;2855;8818;3080;9665
291510;201512;3606;10817;3300;10407;82;283;2942;9402;3024;9685
291520;201512;3922;10578;3358;9807;340;1062;2302;6735;2642;7797
291530;201512;2209;6013;1748;5313;407;1249;873;2818;1280;4067
291535;201512;3815;11448;3417;10825;212;741;2668;8490;2880;9231
291540;201512;2158;5087;1798;4709;131;228;1571;4266;1702;4494
291550;201512;5272;14057;4570;13071;991;2666;2559;7573;3550;10239
291560;201512;18645;43748;13211;37406;1084;3041;9877;28927;10961;31968
291570;201512;2235;5963;2051;5737;157;362;1738;5028;1895;5390
291580;201512;5616;16876;4940;15868;534;2109;3504;11151;4038;13260
291590;201512;1767;5566;1591;5277;168;614;1173;3920;1341;4534
291600;201512;5749;15573;4143;13053;1138;3722;1624;5082;2762;8804
291610;201512;4897;15397;4707;15175;171;598;4255;13811;4426;14409
291620;201512;2996;7035;2343;6342;141;413;1877;5214;2018;5627
291630;201512;3191;7657;2627;7005;283;742;1989;5393;2272;6135
291640;201512;17329;46701;13742;41378;3384;10620;4335;13364;7719;23984
291650;201512;8059;23864;7402;23062;649;1704;6092;19530;6741;21234
291660;201512;2221;5791;1827;5182;160;543;1188;3199;1348;3742
291670;201512;1864;5180;1667;4898;99;289;1333;3977;1432;4266
291680;201512;4165;11928;3565;10913;667;2187;2023;6175;2690;8362
291685;201512;4740;11859;3898;10741;697;1845;2492;7113;3189;8958
291690;201512;4050;10726;3129;9207;237;647;2195;6454;2432;7101
291700;201512;9139;28321;8091;26464;946;3010;5866;19477;6812;22487
291710;201512;5264;13594;4255;12321;353;1103;3114;9033;3467;10136
291720;201512;4403;14422;3731;13023;340;1366;2569;8784;2909;10150
291730;201512;6027;17891;5447;17107;550;1863;4176;13297;4726;15160
291733;201512;2611;7519;2225;6993;222;752;1459;4697;1681;5449
291735;201512;2813;7823;2331;7109;122;435;1869;5670;1991;6105
291740;201512;3648;10688;3117;9922;248;904;2422;7680;2670;8584
291750;201512;22575;57569;17283;49328;3902;11416;8337;24305;12239;35721
291760;201512;11137;35188;9765;32765;3915;14535;2553;8402;6468;22937
291770;201512;7684;22075;6478;19870;814;2687;4148;12471;4962;15158
291780;201512;4482;13487;4172;12954;288;944;3397;10520;3685;11464
291790;201512;2659;8090;2504;7877;92;408;2126;6563;2218;6971
291800;201512;30472;82413;26482;76775;4390;12799;16134;48190;20524;60989
291810;201512;10606;29065;8860;26898;419;1501;7178;21733;7597;23234
291820;201512;3747;11003;3354;10425;227;782;2557;7975;2784;8757
291830;201512;4145;10991;3793;10471;535;1515;2685;7489;3220;9004
291835;201512;6338;19614;5026;17243;1435;5309;2323;8001;3758;13310
291840;201512;47873;132923;41797;125939;6599;19379;28733;89432;35332;108811
291845;201512;2730;7900;2528;7647;156;399;2244;6968;2400;7367
291850;201512;4618;13111;3769;11761;358;1042;2761;8862;3119;9904
291855;201512;1855;4606;1594;4275;173;573;1160;3001;1333;3574
291860;201512;2154;6104;1740;5301;90;336;1149;3416;1239;3752
291870;201512;1423;3780;1013;3019;69;260;637;1820;706;2080
291875;201512;2834;8884;2556;8459;126;516;1834;5934;1960;6450
291880;201512;4907;15683;4566;15080;446;1498;3419;11416;3865;12914
291890;201512;1307;3343;1075;3062;275;747;637;1926;912;2673
291900;201512;1281;3413;1031;3012;65;239;772;2216;837;2455
291905;201512;2713;7371;2028;6107;236;831;1354;3866;1590;4697
291910;201512;2766;7318;2305;6768;132;496;1930;5597;2062;6093
291915;201512;7087;21427;5898;19257;329;1169;4586;15054;4915;16223
291920;201512;27120;78872;24553;75141;4090;13002;14775;45510;18865;58512
291930;201512;2642;7711;2312;7181;198;734;1632;4937;1830;5671
291940;201512;3387;9557;2459;7864;315;1119;1408;4367;1723;5486
291950;201512;8787;29124;7900;27437;1251;4373;4576;16379;5827;20752
291955;201512;10660;30650;9807;29544;2327;7055;5384;17019;7711;24074
291960;201512;3190;9249;2582;8329;248;808;1865;6214;2113;7022
291970;201512;3904;12066;3597;11563;417;1497;2405;7753;2822;9250
291980;201512;12010;33894;9107;29684;1070;3567;6036;20185;7106;23752
291990;201512;2203;6699;1992;6419;88;288;1671;5533;1759;5821
291992;201512;2792;8461;2710;8303;378;1192;2030;6202;2408;7394
291995;201512;2005;5813;1754;5449;118;440;1471;4546;1589;4986
292000;201512;2414;6757;2148;6389;243;829;1505;4506;1748;5335
292010;201512;6431;16137;4963;14024;523;1391;3586;10316;4109;11707
292020;201512;3993;13780;3752;13348;653;2434;2620;9298;3273;11732
292030;201512;2046;6274;1811;5929;228;799;1056;3431;1284;4230
292040;201512;4448;11927;3799;11241;299;638;3178;9991;3477;10629
292045;201512;3074;9942;2836;9610;113;460;2581;8622;2694;9082
292050;201512;6348;19182;5395;17237;450;1710;3497;11024;3947;12734
292060;201512;11705;31079;10813;29930;1141;2788;8438;23573;9579;26361
292070;201512;4697;14428;4426;14108;421;1280;3633;11732;4054;13012
292080;201512;3561;9222;2929;8429;187;587;2463;7114;2650;7701
292090;201512;3982;10391;3417;9725;218;756;2853;8136;3071;8892
292100;201512;11537;30596;9556;27834;2472;7463;4365;13248;6837;20711
292105;201512;3027;9367;2691;8825;134;563;2149;7023;2283;7586
292110;201512;6582;17440;5083;15023;1396;4128;2407;7288;3803;11416
292120;201512;7726;21513;6416;19014;1284;3740;3405;10410;4689;14150
292130;201512;2975;8045;2541;7419;484;1288;1524;4653;2008;5941
292140;201512;5040;13060;4158;11808;780;2041;2685;7850;3465;9891
292145;201512;2453;7456;2164;6952;305;952;1424;4762;1729;5714
292150;201512;12893;39203;11805;37426;634;2320;9424;29901;10058;32221
292160;201512;2534;7237;2139;6718;113;445;1847;5745;1960;6190
292170;201512;8834;25005;7235;22202;904;3079;4599;13991;5503;17070
292180;201512;3013;8749;2374;7624;398;1221;1349;4473;1747;5694
292190;201512;3439;9582;2834;8664;575;1829;1551;4792;2126;6621
292200;201512;6802;20877;5741;18948;1692;5993;2006;6596;3698;12589
292205;201512;3835;11551;3385;10851;167;715;2724;8478;2891;9193
292210;201512;6487;17403;5389;15949;333;1179;4396;12950;4729;14129
292220;201512;1899;5208;1693;4895;531;1445;742;2199;1273;3644
292225;201512;3231;9886;2918;9414;179;714;2350;7541;2529;8255
292230;201512;6552;19020;6161;18390;353;1452;4763;13680;5116;15132
292240;201512;4793;14366;4255;13267;487;1597;2943;9084;3430;10681
292250;201512;5100;15594;4675;14801;1154;3770;2086;6657;3240;10427
292260;201512;3147;9297;2929;9001;204;620;2425;7508;2629;8128
292265;201512;3164;9550;2705;8761;128;566;2042;6458;2170;7024
292270;201512;4162;10405;3273;9371;174;567;2716;7812;2890;8379
292273;201512;2793;6400;2096;5537;210;497;1544;4291;1754;4788
292275;201512;1683;4490;1488;4203;194;559;1081;3096;1275;3655
292280;201512;2086;5969;1802;5644;174;497;1359;4528;1533;5025
292285;201512;2542;6805;2098;6158;115;416;1641;4749;1756;5165
292290;201512;7109;21093;5875;19415;417;1616;4464;14866;4881;16482
292300;201512;8229;24470;7122;23100;1789;6100;3852;12775;5641;18875
292303;201512;2845;8609;2570;8234;105;437;2191;6886;2296;7323
292305;201512;2945;7886;2762;7621;65;254;2501;6805;2566;7059
292310;201512;5896;17359;5435;16653;187;651;4488;13700;4675;14351
292320;201512;6602;18569;5567;16822;437;1389;4228;12728;4665;14117
292330;201512;2183;5838;1997;5575;168;547;1592;4385;1760;4932
292335;201512;5139;13452;4567;12691;471;1241;3616;10226;4087;11467
292340;201512;6271;17829;5302;16211;522;1583;3713;11430;4235;13013
292350;201512;2312;6729;2004;6288;153;572;1580;4930;1733;5502
292360;201512;5237;13710;4959;13185;215;421;4139;11552;4354;11973
292370;201512;8096;23532;7281;22428;710;1929;5648;17758;6358;19687
292380;201512;7245;21350;6576;20281;559;1587;5124;16018;5683;17605
292390;201512;3533;7974;2965;7348;94;197;2719;6801;2813;6998
292400;201512;20816;62691;19500;60602;2458;7701;14130;44157;16588;51858
292405;201512;4515;11226;3601;10036;203;512;2889;8137;3092;8649
292410;201512;1949;5231;1808;5072;135;369;1507;4226;1642;4595
292420;201512;3782;12156;3571;11845;236;888;2949;9793;3185;10681
292430;201512;5626;16518;4198;14421;328;1291;2927;10000;3255;11291
292440;201512;8484;27873;7809;26864;220;942;6961;24118;7181;25060
292450;201512;4035;12001;3281;10749;347;1148;2262;7501;2609;8649
292460;201512;5201;15327;4452;14044;590;1990;2930;9211;3520;11201
292465;201512;2411;7100;1993;6407;207;745;1278;4157;1485;4902
292467;201512;1927;6088;1828;5931;311;1079;1193;3941;1504;5020
292470;201512;2916;7761;2377;6841;107;361;1864;5310;1971;5671
292480;201512;6075;16253;5212;15106;159;586;4665;13450;4824;14036
292490;201512;2389;6501;1953;5853;143;452;1483;4425;1626;4877
292500;201512;6536;19300;5534;17497;673;2191;3604;11557;4277;13748
292510;201512;12908;36236;11086;33623;825;2902;8490;25885;9315;28787
292520;201512;5584;15887;4789;14649;1150;3540;2443;7611;3593;11151
292525;201512;5262;13735;4488;12817;191;618;3782;10779;3973;11397
292530;201512;27671;77513;23636;71883;6362;19969;10593;33114;16955;53083
292540;201512;2848;7831;2497;7386;279;938;1893;5546;2172;6484
292550;201512;6529;20016;5662;18865;669;2368;4198;14311;4867;16679
292560;201512;4034;11167;3492;10360;188;720;2672;7791;2860;8511
292570;201512;4087;11738;3770;11406;77;176;3561;11016;3638;11192
292575;201512;6248;20642;6021;20277;687;2378;4719;15993;5406;18371
292580;201512;6814;20014;6380;19405;387;1253;5358;16290;5745;17543
292590;201512;7244;21570;6694;20741;496;1535;5485;16916;5981;18451
292593;201512;3032;7823;2479;6950;284;742;1789;5004;2073;5746
292595;201512;5813;16019;5084;15078;397;1247;3930;11698;4327;12945
292600;201512;10684;29951;9573;28520;936;2250;7347;22713;8283;24963
292610;201512;4603;12857;3733;11426;318;988;2268;7272;2586;8260
292620;201512;6049;17686;5286;16801;125;418;4884;15637;5009;16055
292630;201512;9349;23468;7694;20896;872;2290;5229;14489;6101;16779
292640;201512;7881;25295;7215;24276;476;1770;5459;18587;5935;20357
292650;201512;4775;12664;4456;12251;379;886;3710;10318;4089;11204
292660;201512;10725;32003;9810;30668;1063;3414;7316;23153;8379;26567
292665;201512;2509;7636;2386;7472;52;139;2193;6930;2245;7069
292670;201512;3711;10425;2863;8902;191;651;1824;5664;2015;6315
292680;201512;3616;10806;3259;10202;434;1262;2299;7244;2733;8506
292690;201512;2928;7900;2127;6624;183;574;1447;4631;1630;5205
292700;201512;9278;27464;8128;25738;1194;3520;5199;17289;6393;20809
292710;201512;2091;6786;1964;6618;70;278;1729;5826;1799;6104
292720;201512;9302;23563;7988;22098;355;1128;6806;18991;7161;20119
292730;201512;3587;10672;3435;10440;288;906;2666;8131;2954;9037
292740;201512;327624;872644;303692;836010;54422;158318;187329;509864;241751;668182
292750;201512;6478;17294;5526;15967;308;992;4436;12843;4744;13835
292760;201512;4045;12558;3621;11780;422;1458;2427;7927;2849;9385
292770;201512;6096;17597;5317;16477;983;3187;3147;10008;4130;13195
292780;201512;1903;4480;1449;3891;124;424;1027;2661;1151;3085
292790;201512;3285;8023;3147;7879;86;156;2987;7571;3073;7727
292800;201512;9057;26676;8314;25432;505;1693;6626;20171;7131;21864
292805;201512;2981;8326;2627;7822;322;1019;1905;5656;2227;6675
292810;201512;9483;28144;7844;25838;978;3297;5372;18095;6350;21392
292820;201512;7158;20691;5470;18228;323;1347;4264;14157;4587;15504
292830;201512;1802;5173;1613;4903;80;329;1398;4189;1478;4518
292840;201512;7800;23687;7257;22951;343;1379;6350;19736;6693;21115
292850;201512;3194;8392;2576;7438;354;1036;1569;4435;1923;5471
292860;201512;14957;38759;13657;37039;1187;3341;10524;28403;11711;31744
292870;201512;19140;52108;16562;47988;2128;6779;9650;27468;11778;34247
292880;201512;12852;35996;11312;33786;1175;3879;7874;23113;9049;26992
292890;201512;5355;17949;4804;16944;677;2527;3084;11022;3761;13549
292895;201512;2759;6695;2144;5763;264;651;1472;4020;1736;4671
292900;201512;2785;8549;2639;8316;175;776;1954;5863;2129;6639
292905;201512;4062;11945;3322;10783;243;891;2377;7679;2620;8570
292910;201512;5018;14836;4508;13887;626;2028;2667;8217;3293;10245
292920;201512;9088;26492;8564;25692;553;2000;7027;20489;7580;22489
292925;201512;5142;15518;4605;14744;420;1354;3483;11203;3903;12557
292930;201512;6488;20683;6106;19990;470;2038;4374;13878;4844;15916
292935;201512;2094;5989;1760;5625;106;370;1459;4822;1565;5192
292937;201512;3241;8212;2687;7523;226;679;2090;5839;2316;6518
292940;201512;3304;8978;2574;7948;292;897;1737;5579;2029;6476
292950;201512;8022;23355;7387;22237;544;1984;5426;15898;5970;17882
292960;201512;5226;13453;4473;12424;313;932;3290;9077;3603;10009
292970;201512;4284;12720;3749;11993;151;676;3071;9753;3222;10429
292975;201512;3480;9254;3246;8952;359;907;2712;7618;3071;8525
292980;201512;3326;8859;2571;7790;222;783;1845;5529;2067;6312
292990;201512;11864;33909;10347;31584;436;1535;8453;25669;8889;27204
293000;201512;2852;7333;2588;7024;58;179;2087;5986;2145;6165
293010;201512;18070;49712;15221;45041;2480;7762;8802;25761;11282;33523
293015;201512;7482;25364;6584;23569;752;3048;4303;15261;5055;18309
293020;201512;9124;30242;8528;29411;345;1518;7303;25083;7648;26601
293030;201512;5471;15685;4329;13882;265;883;3077;10223;3342;11106
293040;201512;3664;12062;3486;11722;185;621;3060;10320;3245;10941
293050;201512;20122;55175;17573;51910;3209;9612;9614;29706;12823;39318
293060;201512;3825;9986;3099;8780;259;782;2241;6256;2500;7038
293070;201512;21984;62362;18779;57383;4601;14139;8939;28166;13540;42305
293075;201512;3270;11044;2998;10640;229;960;2317;8236;2546;9196
293076;201512;3811;10412;3398;9859;197;531;2839;8422;3036;8953
293077;201512;4840;15120;4333;14379;998;3462;2390;8147;3388;11609
293080;201512;4588;14403;4166;13714;216;1005;3430;11062;3646;12067
293090;201512;3298;10521;2723;9646;289;1094;1920;6912;2209;8006
293100;201512;5792;17003;4775;15184;461;1546;3395;10892;3856;12438
293105;201512;3994;13045;3443;11950;551;1881;2138;7608;2689;9489
293110;201512;2008;5726;1765;5358;65;217;1459;4436;1524;4653
293120;201512;3772;12373;3561;12040;353;1078;2741;9517;3094;10595
293130;201512;4088;11447;3453;10747;148;542;3067;9615;3215;10157
293135;201512;31712;79544;23646;67928;4912;15832;9429;26715;14341;42547
293140;201512;1969;5574;1866;5431;139;520;1503;4220;1642;4740
293150;201512;5513;18075;4687;16425;782;2802;2826;10139;3608;12941
293160;201512;3796;9650;3463;9262;590;1160;2482;7212;3072;8372
293170;201512;3347;9864;3038;9412;324;1165;2125;6593;2449;7758
293180;201512;5246;14675;4165;12906;169;706;3225;9748;3394;10454
293190;201512;13828;41514;12682;39779;450;2101;10856;33380;11306;35481
293200;201512;7068;19390;6136;18188;203;746;4850;14479;5053;15225
293210;201512;4994;14372;4365;13273;295;969;3302;9997;3597;10966
293220;201512;5142;14931;4386;13575;1185;3706;1631;5166;2816;8872
293230;201512;3831;11638;3449;11037;491;1730;2334;7437;2825;9167
293240;201512;4425;12026;3531;10531;149;475;2605;7761;2754;8236
293245;201512;4251;12107;3843;11500;292;849;2948;8899;3240;9748
293250;201512;5756;15752;5156;14847;531;1575;3670;10516;4201;12091
293260;201512;4613;13634;3877;12551;283;948;2883;9452;3166;10400
293270;201512;5704;15046;5237;14539;448;1066;4465;12645;4913;13711
293280;201512;5336;14880;4517;13774;251;739;3554;11010;3805;11749
293290;201512;14945;49047;13773;46733;3344;11741;6300;21754;9644;33495
293300;201512;6886;16182;5729;14837;355;839;4452;11730;4807;12569
293305;201512;4879;12020;4087;10952;155;472;3436;9157;3591;9629
293310;201512;2522;6561;2027;5703;175;478;1398;3929;1573;4407
293315;201512;4262;10832;3621;9839;418;1078;2611;7201;3029;8279
293317;201512;2482;7146;2200;6625;222;652;1469;4481;1691;5133
293320;201512;7936;26095;7699;25788;854;3031;5992;20144;6846;23175
293325;201512;1848;5211;1503;4673;200;681;992;3070;1192;3751
293330;201512;51312;162265;45459;151696;10017;35543;21574;72460;31591;108003
293340;201512;2691;7560;2072;6476;301;980;1141;3564;1442;4544
293345;201512;3349;9811;2890;9185;260;715;2213;7346;2473;8061
293350;201512;6646;19001;6252;18534;286;633;5600;17136;5886;17769
293360;201512;13017;39577;11703;37901;1105;4043;9664;31148;10769;35191
310010;201512;1005;2724;768;2345;132;502;333;943;465;1445
310020;201512;3138;9702;2528;8438;580;2114;392;1155;972;3269
310030;201512;2354;7269;1914;6500;426;1614;999;3310;1425;4924
310040;201512;1031;2682;843;2429;67;230;645;1823;712;2053
310050;201512;1925;6513;1718;6043;348;1380;696;2370;1044;3750
310060;201512;3233;10140;2809;9593;381;1403;2021;6902;2402;8305
310070;201512;338;958;263;820;23;100;156;446;179;546
310080;201512;743;2202;595;1941;109;451;212;635;321;1086
310090;201512;4707;13866;4002;12612;508;1771;2512;7839;3020;9610
310100;201512;3391;10218;2806;9225;210;836;2126;6907;2336;7743
310110;201512;4883;13632;4149;12408;713;2405;2254;6490;2967;8895
310120;201512;620;1875;484;1587;126;524;189;496;315;1020
310130;201512;422;1257;375;1182;92;343;189;541;281;884
310140;201512;215;684;170;610;54;241;48;133;102;374
310150;201512;4696;14286;4027;12974;1000;3520;1508;4725;2508;8245
310160;201512;7562;23495;6102;20743;1800;6637;1201;3909;3001;10546
310163;201512;1001;3188;829;2841;239;864;221;738;460;1602
310170;201512;9192;25677;8144;24171;1242;3875;5242;15828;6484;19703
310180;201512;1662;4719;1388;4294;309;1060;658;1937;967;2997
310190;201512;2760;9131;2509;8720;695;2635;372;1280;1067;3915
310200;201512;1891;6091;1568;5420;340;1302;541;1845;881;3147
310205;201512;1135;3246;869;2821;157;520;467;1542;624;2062
310210;201512;2726;7897;2434;7457;216;710;1893;5822;2109;6532
310220;201512;1093;3297;976;3104;185;667;560;1731;745;2398
310230;201512;2586;7975;2143;7006;384;1484;1080;3309;1464;4793
310240;201512;931;3344;825;3120;122;509;445;1737;567;2246
310250;201512;849;2775;814;2712;156;644;474;1453;630;2097
310260;201512;3360;10547;2546;8798;625;2446;633;1923;1258;4369
310270;201512;2544;7231;2106;6597;192;729;1606;4979;1798;5708
310280;201512;2327;6140;1918;5525;231;857;1061;2884;1292;3741
310285;201512;2080;7372;1929;7137;240;1050;1418;5270;1658;6320
310290;201512;1157;3490;1084;3379;265;931;525;1470;790;2401
310300;201512;1736;5786;1633;5594;445;1740;809;2637;1254;4377
310310;201512;380;1024;266;806;38;109;125;390;163;499
310320;201512;393;1241;323;1099;44;208;157;507;201;715
310330;201512;519;1295;342;954;34;115;147;354;181;469
310340;201512;8424;25154;6877;22469;1342;4506;3445;11664;4787;16170
310350;201512;14428;37935;10251;30837;2544;8567;2839;8097;5383;16664
310360;201512;447;1329;417;1287;37;154;291;840;328;994
310370;201512;1426;4712;1287;4459;367;1281;626;2205;993;3486
310375;201512;1262;3349;796;2486;117;426;307;923;424;1349
310380;201512;388;1020;266;833;92;316;88;242;180;558
310390;201512;462;1616;388;1455;85;353;73;228;158;581
310400;201512;10515;29163;7720;24204;1882;6410;1867;5819;3749;12229
310410;201512;815;2626;544;2134;116;507;114;422;230;929
310420;201512;5749;16048;3533;11234;658;2308;556;1520;1214;3828
310430;201512;1381;4492;1035;3758;267;1069;168;551;435;1620
310440;201512;579;1642;440;1384;86;309;181;537;267;846
310445;201512;1269;4095;1034;3640;141;525;652;2291;793;2816
310450;201512;4645;12975;3698;11606;442;1461;2469;7846;2911;9307
310460;201512;1553;4627;1273;4186;372;1350;283;980;655;2330
310470;201512;3657;8995;3071;8276;288;703;2500;6907;2788;7610
310480;201512;1248;3614;913;2937;189;642;362;1088;551;1730
310490;201512;2901;9369;2457;8474;617;2500;947;3118;1564;5618
310500;201512;1299;4331;1141;3987;267;1045;432;1440;699;2485
310510;201512;2147;6692;1639;5544;413;1505;276;886;689;2391
310520;201512;1422;3679;1079;3138;85;250;724;2108;809;2358
310530;201512;1004;3000;496;1703;65;249;66;181;131;430
310540;201512;2997;9719;2689;9144;681;2418;1133;3863;1814;6281
310550;201512;1223;3432;964;3003;210;789;462;1328;672;2117
310560;201512;15691;47482;13084;42278;3533;12712;3901;11706;7434;24418
310570;201512;1178;3507;992;3184;158;602;645;2023;803;2625
310590;201512;4366;12550;3418;10755;635;2116;1328;4049;1963;6165
310600;201512;1408;4603;1247;4256;307;1219;457;1417;764;2636
310610;201512;487;1630;413;1462;86;383;125;380;211;763
310620;201512;148505;449274;124036;401876;28981;105302;47411;142209;76392;247511
310630;201512;4041;12190;3707;11602;378;1368;2701;8355;3079;9723
310640;201512;1322;3948;1033;3424;317;1149;264;793;581;1942
310650;201512;2684;8475;2136;7518;356;1340;1178;4152;1534;5492
310660;201512;1372;4114;1196;3865;134;448;847;2702;981;3150
310665;201512;1270;3824;1126;3618;104;367;870;2843;974;3210
310670;201512;43575;131686;37936;119653;9806;32792;13689;41646;23495;74438
310680;201512;689;1970;626;1875;109;364;390;1140;499;1504
310690;201512;1440;4618;1149;4093;259;1085;379;1252;638;2337
310700;201512;593;1456;451;1265;87;287;256;686;343;973
310710;201512;6448;20788;4922;18137;1029;4479;768;2467;1797;6946
310720;201512;788;2356;708;2216;106;388;428;1299;534;1687
310730;201512;9434;29042;8348;27225;1594;5639;4704;15206;6298;20845
310740;201512;5046;15900;3961;13724;965;3691;865;2795;1830;6486
310750;201512;1514;3722;1139;3218;219;651;569;1517;788;2168
310760;201512;628;1871;514;1682;104;366;198;644;302;1010
310770;201512;882;2745;673;2408;156;636;271;894;427;1530
310780;201512;3765;10362;3160;9293;495;1453;1918;5642;2413;7095
310790;201512;1949;6193;1729;5780;434;1512;773;2696;1207;4208
310800;201512;2839;8930;2152;7555;649;2619;195;610;844;3229
310810;201512;1222;3393;1074;3126;191;619;582;1599;773;2218
310820;201512;1338;3777;944;3026;224;774;246;768;470;1542
310825;201512;2523;8452;1970;7463;131;687;1423;5329;1554;6016
310830;201512;1342;4326;1037;3703;304;1167;278;917;582;2084
310840;201512;2199;6662;1684;5716;362;1328;467;1475;829;2803
310850;201512;1581;4593;1311;4243;187;653;905;2927;1092;3580
310855;201512;2945;9195;2511;8507;426;1563;1584;5411;2010;6974
310860;201512;7581;23097;6309;20780;862;3040;3651;12192;4513;15232
310870;201512;1025;2820;795;2439;143;478;405;1245;548;1723
310880;201512;1205;3608;893;3015;165;646;438;1452;603;2098
310890;201512;2706;8204;2058;7043;497;1922;451;1384;948;3306
310900;201512;4084;12829;3157;10813;734;2799;976;3074;1710;5873
310910;201512;2033;5734;1287;4232;251;942;187;503;438;1445
310920;201512;1913;5576;1484;4911;345;1297;628;2027;973;3324
310925;201512;926;3009;829;2833;317;1194;283;915;600;2109
310930;201512;6085;17076;4809;15144;861;2892;2681;8657;3542;11549
310940;201512;6276;17549;5173;15833;911;2846;2728;8298;3639;11144
310945;201512;1224;3518;1050;3255;144;525;640;1906;784;2431
310950;201512;2061;6475;1500;5229;400;1621;398;1209;798;2830
310960;201512;407;1302;332;1159;92;365;112;382;204;747
310970;201512;1508;4997;1061;3905;265;1085;146;432;411;1517
310980;201512;472;1141;289;830;39;135;139;345;178;480
310990;201512;1205;3892;965;3384;223;885;263;843;486;1728
311000;201512;3623;12198;3209;11352;875;3475;1073;3517;1948;6992
311010;201512;761;2490;701;2376;220;826;327;1065;547;1891
311020;201512;919;2711;723;2357;149;557;314;949;463;1506
311030;201512;1651;4482;1130;3523;294;1045;366;1006;660;2051
311040;201512;492;1654;426;1488;89;326;99;324;188;650
311050;201512;2133;6600;1841;6116;498;1835;798;2624;1296;4459
311060;201512;2401;7076;1736;5646;348;1266;493;1454;841;2720
311070;201512;1441;4911;1248;4523;287;1183;492;1736;779;2919
311080;201512;881;2614;755;2374;146;514;352;1012;498;1526
311090;201512;1548;5735;1308;5231;389;1713;265;1041;654;2754
311100;201512;2108;6968;1674;6021;585;2279;273;940;858;3219
311110;201512;3720;8763;2606;7167;406;1202;1353;3683;1759;4885
311115;201512;1223;3537;1005;3212;110;454;653;2030;763;2484
311120;201512;7968;22285;6037;18772;1445;5009;1569;4492;3014;9501
311130;201512;1974;6168;1646;5675;338;1429;704;2246;1042;3675
311140;201512;1402;3668;1120;3287;103;362;788;2261;891;2623
311150;201512;1842;6212;1672;5939;285;1124;1030;3650;1315;4774
311160;201512;4289;14121;3478;12629;1175;4711;864;3010;2039;7721
311170;201512;785;2342;612;2024;65;233;294;998;359;1231
311180;201512;1345;3763;1018;3128;289;966;248;691;537;1657
311190;201512;1169;3268;849;2622;171;612;230;610;401;1222
311200;201512;2102;6338;1675;5439;446;1606;325;910;771;2516
311205;201512;1033;3388;869;3046;126;502;394;1393;520;1895
311210;201512;956;3051;871;2930;163;544;587;2034;750;2578
311220;201512;898;2796;700;2363;159;579;223;722;382;1301
311230;201512;8119;25461;6319;21709;1265;4652;2239;7968;3504;12620
311240;201512;1112;3289;855;2843;216;784;239;751;455;1535
311250;201512;808;2596;713;2444;203;793;230;678;433;1471
311260;201512;2562;6740;1878;5601;469;1553;619;1799;1088;3352
311265;201512;1273;3505;995;3049;184;625;519;1581;703;2206
311270;201512;3382;10624;2924;9961;347;1574;1952;6363;2299;7937
311280;201512;1332;3654;839;2619;169;614;235;671;404;1285
311290;201512;2013;6712;1867;6378;399;1371;1052;3641;1451;5012
311300;201512;4472;14740;3987;13848;480;1974;2706;9307;3186;11281
311310;201512;558;1884;498;1774;95;393;180;584;275;977
311320;201512;4086;13368;3553;12180;693;2684;1211;3889;1904;6573
311330;201512;4896;14438;4157;13188;1120;3957;1743;5473;2863;9430
311340;201512;12218;38092;10533;34827;3136;11149;2829;9156;5965;20305
311350;201512;2336;6558;1790;5514;301;1101;798;2223;1099;3324
311360;201512;1190;3229;895;2846;355;1178;164;526;519;1704
311370;201512;3834;11352;3191;10190;679;2598;1356;3934;2035;6532
311380;201512;407;1333;352;1230;95;364;116;392;211;756
311390;201512;1820;6536;1655;6282;688;3032;492;1685;1180;4717
311400;201512;1499;4670;1229;4148;230;923;504;1521;734;2444
311410;201512;1830;6189;1639;5929;449;1811;791;2898;1240;4709
311420;201512;1971;6340;1294;4610;272;1044;207;563;479;1607
311430;201512;3972;11774;2668;8879;489;1782;323;968;812;2750
311440;201512;2413;7637;1765;6416;538;2288;300;1029;838;3317
311450;201512;2019;6903;1663;6075;447;1818;340;1139;787;2957
311455;201512;1211;3207;960;2787;232;730;433;1166;665;1896
311460;201512;709;2262;536;1898;110;468;125;411;235;879
311470;201512;517;1663;404;1412;102;433;103;301;205;734
311480;201512;784;2078;729;2005;181;486;427;1165;608;1651
311490;201512;242;879;212;793;63;254;73;252;136;506
311500;201512;471;1347;369;1157;84;304;148;453;232;757
311510;201512;3187;9729;2569;8563;811;3171;560;1734;1371;4905
311520;201512;635;2054;578;1934;182;666;228;718;410;1384
311530;201512;11889;30380;8256;24345;1879;6611;2240;6323;4119;12934
311535;201512;839;2424;526;1785;128;503;74;232;202;735
311540;201512;636;2183;586;2100;218;781;235;823;453;1604
311545;201512;2123;6426;1886;6135;198;731;1333;4270;1531;5001
311547;201512;1547;4297;1275;3854;99;330;845;2549;944;2879
311550;201512;2926;9202;2407;8127;440;1673;851;2811;1291;4484
311560;201512;256;666;213;611;27;83;122;330;149;413
311570;201512;2176;5326;1642;4622;131;411;1211;3463;1342;3874
311580;201512;2428;4937;1840;4255;510;1084;977;2407;1487;3491
311590;201512;464;1391;391;1277;102;384;145;470;247;854
311600;201512;1213;3659;1024;3403;190;618;626;2134;816;2752
311610;201512;3095;10701;2753;10089;898;3252;1107;4262;2005;7514
311615;201512;3104;9517;2545;8614;266;1046;1750;5895;2016;6941
311620;201512;428;1318;368;1210;72;271;202;655;274;926
311630;201512;1403;4052;1141;3593;254;771;637;2016;891;2787
311640;201512;825;2620;672;2347;138;532;356;1201;494;1733
311650;201512;2294;6551;1909;5909;295;999;1011;3125;1306;4124
311660;201512;2340;7754;1756;6349;340;1298;167;501;507;1799
311670;201512;1628;4725;1312;4174;424;1478;400;1237;824;2715
311680;201512;2090;6483;1747;5902;384;1375;926;3114;1310;4489
311690;201512;511;1319;428;1216;41;126;342;975;383;1101
311700;201512;2205;5924;1806;5375;148;495;1351;3953;1499;4448
311710;201512;1708;5114;1237;4209;442;1675;308;983;750;2658
311720;201512;399;1307;349;1200;71;262;160;535;231;797
311730;201512;5917;14650;3348;10084;924;3259;821;1905;1745;5164
311740;201512;848;2466;779;2380;280;833;412;1295;692;2128
311750;201512;4055;13060;3496;12149;676;2650;1809;6146;2485;8796
311760;201512;817;2704;718;2471;180;734;234;684;414;1418
311770;201512;2343;7315;1879;6416;435;1659;573;1849;1008;3508
311780;201512;1123;3937;921;3473;270;1183;212;715;482;1898
311783;201512;1974;6415;1659;5799;105;515;1212;4184;1317;4699
311787;201512;584;2002;416;1492;81;324;95;277;176;601
311790;201512;1470;4318;1062;3519;218;816;338;1067;556;1883
311800;201512;4387;14690;3543;12357;740;2783;235;653;975;3436
311810;201512;1065;3436;922;3151;68;318;612;2049;680;2367
311820;201512;625;1940;503;1645;129;470;244;747;373;1217
311830;201512;8483;28132;6753;23817;2183;8327;830;2577;3013;10904
311840;201512;3171;9286;2752;8679;719;2568;1287;3926;2006;6494
311850;201512;293;862;248;785;60;212;108;328;168;540
311860;201512;49744;146067;41628;131231;8872;30662;19541;59316;28413;89978
311870;201512;2213;6411;1629;5279;335;1238;502;1492;837;2730
311880;201512;6923;19728;6083;18687;797;2302;4267;13608;5064;15910
311890;201512;1473;4339;1164;3748;295;1042;471;1475;766;2517
311900;201512;773;2311;674;2163;104;361;391;1279;495;1640
311910;201512;4374;12663;3522;11388;841;2942;1489;4784;2330;7726
311920;201512;1951;6320;1688;5838;226;866;1008;3452;1234;4318
311930;201512;3674;10384;3076;9414;1160;3737;857;2553;2017;6290
311940;201512;12253;36506;9692;31154;2499;8749;2019;5964;4518;14713
311950;201512;2244;6502;1848;5927;161;578;1297;4112;1458;4690
311960;201512;372;1169;328;1065;77;287;129;357;206;644
311970;201512;361;1241;296;1094;54;232;76;264;130;496
311980;201512;655;1804;435;1395;75;252;159;516;234;768
311990;201512;432;1263;357;1139;130;457;120;352;250;809
311995;201512;1193;3613;708;2419;56;203;78;198;134;401
312000;201512;627;1873;559;1768;74;260;341;1088;415;1348
312010;201512;941;3009;780;2652;136;507;302;992;438;1499
312015;201512;1445;4550;1268;4230;150;602;805;2644;955;3246
312020;201512;999;3127;862;2906;173;631;417;1401;590;2032
312030;201512;1761;5186;1573;4953;112;420;1298;4058;1410;4478
312040;201512;731;2672;614;2352;160;691;133;481;293;1172
312050;201512;1314;4535;1099;4014;259;1061;158;491;417;1552
312060;201512;764;2287;659;2124;243;837;244;732;487;1569
312070;201512;1041;3176;672;2371;157;595;228;800;385;1395
312080;201512;2654;7351;2092;6469;302;1109;1101;3199;1403;4308
312083;201512;932;2622;797;2422;99;334;550;1641;649;1975
312087;201512;2188;6646;1943;6292;244;859;1354;4450;1598;5309
312090;201512;8988;27691;7707;25449;2241;7823;2806;9061;5047;16884
312100;201512;1398;4645;1164;4267;264;1102;500;1791;764;2893
312110;201512;1104;3816;953;3481;291;1218;168;517;459;1735
312120;201512;774;2494;648;2234;147;608;218;644;365;1252
312125;201512;1204;3764;1049;3477;241;817;543;1858;784;2675
312130;201512;850;2415;638;1981;92;330;238;690;330;1020
312140;201512;833;2630;696;2291;148;536;210;595;358;1131
312150;201512;530;1517;449;1346;24;88;295;841;319;929
312160;201512;7497;25150;6598;23235;1766;6810;2353;8115;4119;14925
312170;201512;966;2728;804;2452;81;267;488;1475;569;1742
312180;201512;1379;4173;1185;3782;268;927;463;1379;731;2306
312190;201512;592;1894;448;1603;143;570;90;303;233;873
312200;201512;4830;13857;3998;12488;679;2102;2271;7117;2950;9219
312210;201512;1057;2823;800;2441;225;750;324;920;549;1670
312220;201512;1893;6292;1733;6104;202;637;1406;5192;1608;5829
312230;201512;13374;40604;10100;34047;3262;12189;1521;4788;4783;16977
312235;201512;1593;4714;1372;4382;165;641;929;2916;1094;3557
312240;201512;965;3144;763;2713;177;687;225;746;402;1433
312245;201512;2228;6513;1968;6167;115;393;1598;4993;1713;5386
312247;201512;841;2482;649;2144;174;627;279;922;453;1549
312250;201512;1214;3311;926;2830;165;575;366;1039;531;1614
312260;201512;904;2837;739;2551;138;548;445;1476;583;2024
312270;201512;672;2008;557;1787;78;323;252;730;330;1053
312280;201512;412;1377;363;1268;119;448;48;159;167;607
312290;201512;766;2492;701;2395;188;752;228;755;416;1507
312300;201512;881;2912;674;2392;160;622;74;192;234;814
312310;201512;914;3383;833;3191;239;1013;305;1121;544;2134
312320;201512;1974;5594;1447;4504;323;1076;229;539;552;1615
312330;201512;991;2887;822;2630;141;537;576;1813;717;2350
312340;201512;321;844;275;768;38;143;189;479;227;622
312350;201512;305;757;271;717;27;88;224;568;251;656
312352;201512;1645;5173;1465;4891;337;1179;908;3095;1245;4274
312360;201512;3006;9579;2451;8411;535;2032;728;2456;1263;4488
312370;201512;1728;5407;1548;5109;512;1909;504;1548;1016;3457
312380;201512;1930;5352;1703;5037;95;291;1400;4244;1495;4535
312385;201512;1303;3836;1120;3540;106;429;779;2384;885;2813
312390;201512;2127;6834;1699;5936;449;1693;292;905;741;2598
312400;201512;3206;10191;2673;9146;977;3460;714;2521;1691;5981
312410;201512;10002;32384;8735;29898;1970;7362;3601;11996;5571;19358
312420;201512;3996;12142;3747;11820;577;1822;2573;8272;3150;10094
312430;201512;7899;23337;6750;21266;1183;3784;4023;12762;5206;16546
312440;201512;701;2193;609;2037;163;606;289;999;452;1605
312450;201512;1072;3524;812;2960;265;1013;237;890;502;1903
312460;201512;363;1077;323;1030;86;312;151;474;237;786
312470;201512;692;1871;443;1382;81;289;145;424;226;713
312480;201512;1270;3337;966;2994;228;786;505;1478;733;2264
312490;201512;2049;5349;1572;4644;233;776;872;2471;1105;3247
312500;201512;681;2038;593;1897;103;389;214;644;317;1033
312510;201512;3294;9544;2548;7980;422;1515;1234;3554;1656;5069
312520;201512;269;908;215;804;58;236;71;267;129;503
312530;201512;601;1784;527;1673;76;304;334;1017;410;1321
312540;201512;1468;4577;1122;3887;235;875;533;1835;768;2710
312550;201512;684;2088;579;1853;121;397;260;785;381;1182
312560;201512;2043;5368;1688;4909;101;358;1361;3909;1462;4267
312570;201512;2503;7289;2047;6488;590;2015;595;1814;1185;3829
312580;201512;532;1745;439;1544;74;317;160;531;234;848
312590;201512;1731;5692;1485;5153;276;1166;632;2010;908;3176
312595;201512;2024;6697;1790;6151;369;1341;945;3225;1314;4566
312600;201512;817;2632;627;2234;102;470;308;998;410;1468
312610;201512;7160;19968;5124;16150;1168;4089;1169;3441;2337;7530
312620;201512;2175;6247;1669;5555;168;631;1207;4138;1375;4769
312630;201512;356;1145;309;1056;79;310;122;380;201;690
312640;201512;551;1770;436;1533;87;331;137;445;224;776
312650;201512;2174;6357;1564;5133;153;565;911;2966;1064;3531
312660;201512;1355;3636;1108;3268;116;400;743;2139;859;2539
312670;201512;5677;16752;4806;15503;1301;4656;1701;5302;3002;9958
312675;201512;1277;4064;1063;3603;132;519;656;2167;788;2686
312680;201512;1474;4507;1293;4235;210;795;754;2354;964;3149
312690;201512;2208;5865;1774;5246;278;903;1086;3088;1364;3991
312695;201512;825;2924;785;2865;172;604;491;1879;663;2483
312700;201512;1945;5734;1479;4773;207;764;748;2351;955;3115
312705;201512;1279;3640;1072;3269;95;325;757;2269;852;2594
312707;201512;1639;5076;1260;4332;179;715;645;2142;824;2857
312710;201512;7260;18316;4646;13942;1244;4250;964;2652;2208;6902
312720;201512;770;2603;667;2383;155;612;247;831;402;1443
312730;201512;1910;4506;1312;3788;176;547;727;2108;903;2655
312733;201512;1673;4414;1227;3601;69;241;799;2231;868;2472
312735;201512;834;2315;722;2165;173;593;394;1119;567;1712
312737;201512;866;2154;613;1788;195;573;220;655;415;1228
312738;201512;544;1621;390;1300;100;390;128;366;228;756
312740;201512;383;974;231;795;71;278;53;172;124;450
312750;201512;1254;4392;1186;4261;242;1060;565;1924;807;2984
312760;201512;2095;6605;1584;5546;384;1480;352;1193;736;2673
312770;201512;41666;113484;31783;96682;8250;27115;8723;25363;16973;52478
312780;201512;2708;9339;2391;8788;432;1753;1261;4712;1693;6465
312790;201512;333;839;189;583;38;148;54;119;92;267
312800;201512;5033;16259;4037;14192;1232;4680;1017;3538;2249;8218
312810;201512;2175;6530;1458;5111;342;1288;255;805;597;2093
312820;201512;1930;5520;1703;5141;110;391;1155;3400;1265;3791
312825;201512;1377;3703;1177;3444;112;366;890;2583;1002;2949
312830;201512;2552;7794;1739;6112;426;1631;274;915;700;2546
312840;201512;1259;4010;1035;3587;162;691;411;1306;573;1997
312850;201512;666;2084;523;1812;88;359;166;570;254;929
312860;201512;1161;3357;885;2854;231;837;241;660;472;1497
312870;201512;5515;16991;3761;13206;727;2829;753;2522;1480;5351
312880;201512;1276;3782;1100;3503;146;508;665;2174;811;2682
312890;201512;1545;4676;1004;3451;255;958;317;1099;572;2057
312900;201512;1228;3605;1079;3396;150;498;754;2429;904;2927
312910;201512;1672;3348;1019;2492;170;472;517;1145;687;1617
312920;201512;874;2745;713;2453;192;761;270;857;462;1618
312930;201512;2241;6344;1907;5848;425;1362;898;2805;1323;4167
312940;201512;912;2950;784;2724;204;804;215;688;419;1492
312950;201512;3286;9091;2488;7860;822;2823;640;1964;1462;4787
312960;201512;1964;5616;1697;5267;245;709;1260;4046;1505;4755
312965;201512;1800;5676;1511;5145;202;811;904;3058;1106;3869
312970;201512;1002;3338;829;3029;239;1000;161;545;400;1545
312980;201512;17358;57579;16100;54815;5101;19067;6056;19654;11157;38721
312990;201512;454;1351;330;1129;100;393;100;334;200;727
313000;201512;509;1666;411;1469;98;457;164;506;262;963
313005;201512;2614;8326;2272;7673;529;1734;1152;3997;1681;5731
313010;201512;3849;12125;3208;10992;838;3126;1318;4433;2156;7559
313020;201512;992;3202;771;2632;158;632;183;505;341;1137
313030;201512;1551;4086;1134;3498;235;902;484;1375;719;2277
313040;201512;860;2836;721;2480;119;484;279;875;398;1359
313050;201512;1818;5575;1345;4840;303;1226;344;1100;647;2326
313055;201512;1580;5004;1436;4802;99;357;1115;3764;1214;4121
313060;201512;722;2332;558;1925;160;567;70;222;230;789
313065;201512;1947;6240;1655;5768;328;1264;1079;3743;1407;5007
313070;201512;1118;3192;904;2806;199;721;404;1155;603;1876
313080;201512;476;1478;354;1221;80;325;116;346;196;671
313090;201512;5284;15095;4542;13880;1066;3464;2280;6982;3346;10446
313100;201512;1096;3345;978;3148;106;354;745;2422;851;2776
313110;201512;1775;4966;1301;4029;211;736;560;1619;771;2355
313115;201512;2473;8259;2304;7899;532;2075;1022;3236;1554;5311
313120;201512;3562;9372;2974;8567;769;2485;1540;4253;2309;6738
313130;201512;25397;76201;21528;68112;4936;17248;8166;24113;13102;41361
313140;201512;679;1713;505;1455;33;116;349;985;382;1101
313150;201512;1372;4309;1146;3875;489;1794;245;792;734;2586
313160;201512;1034;3075;885;2785;146;537;504;1524;650;2061
313170;201512;7600;25672;5984;21837;1469;5726;1157;4123;2626;9849
313180;201512;2442;6609;1914;5842;499;1695;700;2041;1199;3736
313190;201512;3250;11017;2533;9152;554;2186;657;2157;1211;4343
313200;201512;1208;3885;1042;3570;135;519;694;2319;829;2838
313210;201512;4344;13250;3582;12092;822;2996;1535;4996;2357;7992
313220;201512;1409;4225;1013;3338;237;857;226;628;463;1485
313230;201512;2302;8106;2111;7825;318;1264;1434;5319;1752;6583
313240;201512;7767;23703;6049;20464;1243;4806;2224;7100;3467;11906
313250;201512;7113;22023;6171;20371;862;2934;3564;11833;4426;14767
313260;201512;617;1810;432;1422;69;249;106;331;175;580
313270;201512;5493;16225;4561;14611;886;3066;2387;7528;3273;10594
313280;201512;381;1247;277;1005;53;220;63;200;116;420
313290;201512;860;2973;686;2633;240;1012;100;328;340;1340
313300;201512;1857;6115;1498;5233;425;1617;208;609;633;2226
313310;201512;1081;3707;952;3422;231;945;174;555;405;1500
313320;201512;2403;6843;1796;5841;350;1258;758;2440;1108;3698
313330;201512;3958;12231;3269;10990;407;1621;1864;6111;2271;7732
313340;201512;1982;4841;1524;4154;302;834;815;2200;1117;3034
313350;201512;3163;9601;2403;7954;502;1838;483;1434;985;3272
313360;201512;1256;3575;925;3027;250;974;446;1338;696;2312
313370;201512;1161;3933;1066;3670;167;683;546;1743;713;2426
313375;201512;2305;5934;1529;4755;288;1112;496;1440;784;2552
313380;201512;5065;15640;4146;13729;1057;3843;1334;4133;2391;7976
313390;201512;872;2985;830;2927;100;395;554;1946;654;2341
313400;201512;3771;10259;3316;9729;310;860;2750;8272;3060;9132
313410;201512;1276;3541;1049;3203;250;845;553;1642;803;2487
313420;201512;20335;48005;11882;33478;2252;7058;2132;5788;4384;12846
313430;201512;1085;3342;820;2772;159;648;320;985;479;1633
313440;201512;6430;14353;4370;11940;285;819;2881;7924;3166;8743
313450;201512;655;1903;511;1603;102;381;170;480;272;861
313460;201512;2215;7455;1889;6889;491;2052;579;1931;1070;3983
313470;201512;3195;8727;2856;8253;422;1274;1912;5406;2334;6680
313480;201512;1106;3155;850;2711;120;452;338;993;458;1445
313490;201512;1470;4317;846;3268;258;1094;120;434;378;1528
313500;201512;398;1245;325;1065;62;228;121;379;183;607
313505;201512;9082;26444;8357;25611;394;936;7571;23701;7965;24637
313507;201512;1385;3815;1196;3547;130;429;777;2309;907;2738
313510;201512;15553;44149;13378;40893;2101;6629;7500;23028;9601;29657
313520;201512;14381;44002;11995;39586;1406;5271;7592;24753;8998;30024
313530;201512;622;1906;500;1673;49;195;169;531;218;726
313535;201512;2467;7357;2200;6866;200;695;1581;4858;1781;5553
313540;201512;1101;3399;788;2586;207;745;177;520;384;1265
313545;201512;1294;4721;1159;4436;165;778;672;2413;837;3191
313550;201512;1856;5901;1612;5401;413;1458;702;2264;1115;3722
313560;201512;2207;5190;1810;4741;328;795;1203;3293;1531;4088
313570;201512;883;3070;748;2812;245;985;214;796;459;1781
313580;201512;5915;16683;4735;14980;798;2700;2742;8741;3540;11441
313590;201512;993;2786;759;2463;376;1343;176;533;552;1876
313600;201512;3871;11528;3324;10658;420;1472;2208;7105;2628;8577
313610;201512;994;2966;837;2661;174;615;400;1234;574;1849
313620;201512;5601;17135;4771;15598;1313;4581;1645;5310;2958;9891
313630;201512;8155;22763;6129;19733;1162;4258;2659;8902;3821;13160
313640;201512;787;2268;589;1959;175;654;183;581;358;1235
313650;201512;2075;6651;1792;6186;300;1180;1135;3826;1435;5006
313652;201512;972;3424;891;3271;151;626;524;1876;675;2502
313655;201512;948;3028;784;2744;115;491;468;1573;583;2064
313657;201512;1307;3930;1078;3566;110;509;789;2425;899;2934
313660;201512;848;2749;744;2558;162;650;339;1092;501;1742
313665;201512;3591;11482;3083;10395;654;2479;1393;4487;2047;6966
313670;201512;51117;140943;33626;110141;8173;29389;9821;31271;17994;60660
313680;201512;1073;3166;930;2929;159;578;538;1632;697;2210
313690;201512;851;3039;738;2770;193;743;263;992;456;1735
313695;201512;1388;4467;1186;4102;116;453;817;2826;933;3279
313700;201512;3834;12646;3223;11858;508;1935;2171;8196;2679;10131
313710;201512;1336;3584;1031;3118;201;662;517;1520;718;2182
313720;201512;5262;16817;4103;14182;829;3145;1265;4020;2094;7165
313730;201512;1284;3468;975;3075;168;603;532;1659;700;2262
313740;201512;2135;7578;1783;6709;496;2112;156;498;652;2610
313750;201512;2269;6781;1878;6036;478;1654;590;1744;1068;3398
313753;201512;1852;5334;1450;4639;334;1188;606;1892;940;3080
313760;201512;4307;13914;3498;12217;978;3718;913;2964;1891;6682
313770;201512;3333;10721;2927;10046;882;3293;1246;4155;2128;7448
313780;201512;3907;10617;3018;9305;441;1655;1260;3889;1701;5544
313790;201512;496;1701;467;1647;106;375;251;919;357;1294
313800;201512;1256;3395;1081;3123;117;386;728;2119;845;2505
313810;201512;1515;4354;1425;4233;69;189;1235;3771;1304;3960
313820;201512;13230;35066;10618;30831;1875;6388;4890;13420;6765;19808
313830;201512;431;1415;364;1284;98;401;125;430;223;831
313835;201512;918;3048;848;2932;164;660;465;1525;629;2185
313840;201512;7580;21569;5820;18532;1437;5038;1473;4566;2910;9604
313850;201512;1208;3245;1030;2929;206;695;508;1313;714;2008
313860;201512;2821;8485;2118;6926;507;1798;469;1431;976;3229
313862;201512;1240;3092;846;2446;125;354;442;1358;567;1712
313865;201512;2238;6869;2016;6534;231;861;1463;4690;1694;5551
313867;201512;1124;3815;940;3388;284;1100;265;984;549;2084
313868;201512;1611;5453;1370;4953;140;623;902;3198;1042;3821
313870;201512;809;2502;733;2376;207;776;219;612;426;1388
313880;201512;1521;4610;1296;4247;254;965;674;2054;928;3019
313890;201512;1901;5106;1580;4680;359;1002;942;2968;1301;3970
313900;201512;4060;14520;3576;13393;1063;4492;980;3508;2043;8000
313910;201512;771;2546;628;2253;221;852;73;238;294;1090
313920;201512;3398;11130;2913;10206;487;1790;1631;5830;2118;7620
313925;201512;1931;5174;1392;4160;83;281;855;2536;938;2817
313930;201512;5277;17016;4304;15238;808;3034;2183;7838;2991;10872
313940;201512;8431;27911;7000;25579;2026;8189;2235;8598;4261;16787
313950;201512;4149;11725;3200;10136;981;3600;1037;2920;2018;6520
313960;201512;5655;14379;4081;12153;1120;3656;1096;3012;2216;6668
313970;201512;1440;4082;1248;3869;146;506;764;2481;910;2987
313980;201512;1281;3984;987;3465;268;1074;401;1391;669;2465
313990;201512;1847;6762;1546;6027;509;2191;307;1035;816;3226
314000;201512;7763;24739;6959;23159;1283;5115;3885;12287;5168;17402
314010;201512;1106;3077;905;2814;104;378;564;1691;668;2069
314015;201512;1229;4202;1034;3834;265;1095;390;1360;655;2455
314020;201512;527;1578;369;1244;84;330;83;243;167;573
314030;201512;865;2753;670;2314;91;345;241;816;332;1161
314040;201512;681;1907;550;1672;251;819;116;325;367;1144
314050;201512;1792;5485;1397;4683;302;1198;473;1399;775;2597
314053;201512;1560;4890;1377;4654;191;649;905;3201;1096;3850
314055;201512;2158;6402;1888;5995;85;351;1467;4670;1552;5021
314060;201512;1149;3522;897;3087;65;292;568;1906;633;2198
314070;201512;4054;12465;3089;10512;805;2938;702;2257;1507;5195
314080;201512;1943;5978;1276;4400;223;867;269;806;492;1673
314085;201512;1998;6600;1719;6195;439;1772;636;2253;1075;4025
314090;201512;3336;11390;2900;10507;720;2916;971;3566;1691;6482
314100;201512;3332;8499;2905;7928;207;462;2430;6874;2637;7336
314110;201512;4182;13120;3578;11834;660;2557;1464;4384;2124;6941
314120;201512;1027;2465;511;1623;114;397;134;415;248;812
314130;201512;724;2074;359;1227;48;179;72;231;120;410
314140;201512;4985;15314;4100;13536;935;3337;1712;5568;2647;8905
314150;201512;1625;4396;1300;3831;208;676;656;1892;864;2568
314160;201512;2528;6487;1976;5753;193;611;1207;3681;1400;4292
314170;201512;1097;3262;886;2803;119;416;463;1409;582;1825
314180;201512;5448;17227;4814;16175;1290;4695;2008;6806;3298;11501
314190;201512;734;2090;575;1849;126;509;228;639;354;1148
314200;201512;3014;9319;2590;8538;311;1228;1724;5535;2035;6763
314210;201512;1984;5764;1742;5331;253;923;1051;3042;1304;3965
314220;201512;1673;5156;1280;4385;372;1409;253;733;625;2142
314225;201512;1334;3846;1188;3646;94;303;981;3051;1075;3354
314230;201512;673;2180;609;2063;128;487;286;940;414;1427
314240;201512;1144;3429;951;3128;146;494;541;1870;687;2364
314250;201512;560;1657;421;1369;95;346;129;367;224;713
314260;201512;1110;3891;985;3606;264;1054;308;1064;572;2118
314270;201512;2914;9354;2426;8472;246;966;1586;5568;1832;6534
314280;201512;3244;8938;2161;6825;497;1840;688;1876;1185;3716
314290;201512;4923;13456;4171;12209;1099;3329;2112;6099;3211;9428
314300;201512;1565;5182;1330;4628;367;1349;412;1366;779;2715
314310;201512;5440;16129;4605;14555;1274;4337;1610;4878;2884;9215
314315;201512;875;3336;793;3170;87;419;520;2063;607;2482
314320;201512;3135;8624;2236;7384;597;2178;1068;3585;1665;5763
314330;201512;54040;162109;46178;149005;12823;44549;15743;49863;28566;94412
314340;201512;2918;7914;1602;5279;354;1279;127;272;481;1551
314345;201512;1246;4190;1115;3971;266;995;635;2256;901;3251
314350;201512;1369;3944;1061;3422;340;1187;222;666;562;1853
314360;201512;694;2197;458;1626;103;423;105;342;208;765
314370;201512;542;1857;500;1793;129;507;306;1088;435;1595
314380;201512;1286;3830;866;2979;234;862;134;453;368;1315
314390;201512;14388;41085;10601;33895;2569;8915;2596;7587;5165;16502
314400;201512;4560;13320;3835;12276;1370;4600;1247;4088;2617;8688
314410;201512;2667;8241;2186;7290;647;2455;658;2049;1305;4504
314420;201512;766;2179;595;1924;35;174;397;1211;432;1385
314430;201512;6654;19611;5698;17780;1642;5540;1629;5092;3271;10632
314435;201512;1321;4202;1155;3908;121;523;715;2385;836;2908
314437;201512;1140;2914;944;2616;42;120;744;2058;786;2178
314440;201512;673;1946;512;1707;165;617;97;279;262;896
314450;201512;1611;4678;1332;4258;333;1224;576;1708;909;2932
314460;201512;4324;14360;3457;12456;835;3338;639;2163;1474;5501
314465;201512;2315;7178;2119;6846;124;555;1625;5098;1749;5653
314467;201512;1072;2988;892;2666;83;241;634;1919;717;2160
314470;201512;2506;7806;2040;6811;391;1574;684;2023;1075;3597
314480;201512;6151;20191;4095;14650;629;2443;476;1442;1105;3885
314490;201512;957;2798;740;2355;182;638;311;940;493;1578
314500;201512;2101;5871;1523;4854;375;1254;577;1776;952;3030
314505;201512;1802;5279;1653;5067;255;858;1078;3330;1333;4188
314510;201512;1914;5145;1278;4237;403;1479;319;1014;722;2493
314520;201512;3170;11309;2381;9348;517;2316;331;1047;848;3363
314530;201512;6275;21906;5904;21249;1123;3947;3437;12842;4560;16789
314535;201512;2781;7715;2351;7106;222;759;1777;5329;1999;6088
314537;201512;1187;3702;936;3247;138;579;540;1819;678;2398
314540;201512;419;1247;337;1067;76;280;102;285;178;565
314545;201512;1390;4240;1191;3948;157;592;824;2748;981;3340
314550;201512;639;1722;467;1482;85;357;190;535;275;892
314560;201512;4702;15976;3880;13927;731;2983;1126;3808;1857;6791
314570;201512;309;902;233;740;65;225;100;304;165;529
314580;201512;526;1739;405;1461;100;433;65;201;165;634
314585;201512;843;2738;600;2200;136;574;145;505;281;1079
314587;201512;1930;5896;1650;5396;371;1151;764;2588;1135;3739
314590;201512;3363;11231;2329;8458;421;1735;300;939;721;2674
314600;201512;1841;5904;1309;4786;316;1289;190;593;506;1882
314610;201512;7126;23939;6314;22045;1423;5595;2610;8512;4033;14107
314620;201512;1627;4811;1458;4567;183;578;1041;3265;1224;3843
314625;201512;1466;5005;1361;4805;189;800;958;3242;1147;4042
314630;201512;4980;14618;4319;13581;317;1210;3154;9865;3471;11075
314640;201512;591;1607;453;1362;115;378;130;324;245;702
314650;201512;1178;3228;812;2578;126;475;297;828;423;1303
314655;201512;1601;4747;1172;3887;294;953;426;1435;720;2388
314660;201512;276;749;199;592;23;76;96;269;119;345
314670;201512;1643;4373;1220;3634;201;677;667;1929;868;2606
314675;201512;1823;5508;1555;5029;180;645;1034;3340;1214;3985
314690;201512;2411;7589;1938;6704;536;2131;468;1497;1004;3628
314700;201512;8831;30182;6411;24534;1894;8104;995;3608;2889;11712
314710;201512;9134;27627;6063;20722;1164;4397;810;2551;1974;6948
314720;201512;2422;7900;1987;6927;511;1983;634;2174;1145;4157
314730;201512;2354;6937;1870;6196;518;1908;668;2104;1186;4012
314740;201512;3029;9542;2592;8677;480;1838;1179;3749;1659;5587
314750;201512;346;1076;269;898;45;184;125;385;170;569
314760;201512;1731;5726;1278;4603;215;904;263;807;478;1711
314770;201512;1106;3432;614;2079;75;301;96;227;171;528
314780;201512;303;772;207;645;56;211;86;255;142;466
314790;201512;12219;35476;8856;29472;3313;12522;926;2535;4239;15057
314795;201512;1666;4772;1395;4340;119;474;1003;2994;1122;3468
314800;201512;11215;32372;7641;25098;2196;7767;937;2933;3133;10700
314810;201512;12438;35914;9402;30418;2680;9590;1960;6218;4640;15808
314820;201512;957;2588;639;2060;164;587;220;674;384;1261
314830;201512;1676;5542;1456;5155;435;1718;572;2000;1007;3718
314840;201512;977;3454;788;3162;133;681;467;1802;600;2483
314850;201512;1963;5629;1558;4890;224;867;971;2924;1195;3791
314860;201512;3275;10813;2894;10114;688;2619;1354;4662;2042;7281
314870;201512;5535;17342;4754;16274;542;2303;3369;11429;3911;13732
314875;201512;1725;5692;1637;5560;304;988;1207;4201;1511;5189
314880;201512;876;2377;733;2194;47;132;534;1684;581;1816
314890;201512;614;1830;410;1381;81;332;141;417;222;749
314900;201512;505;1527;405;1372;99;359;194;641;293;1000
314910;201512;1689;5483;1359;4910;408;1678;407;1376;815;3054
314915;201512;2527;7918;2202;7399;189;777;1571;5138;1760;5915
314920;201512;557;1538;391;1283;43;173;209;627;252;800
314930;201512;4731;15732;4004;14069;1068;4041;951;3183;2019;7224
314940;201512;406;1173;369;1107;68;223;193;546;261;769
314950;201512;364;1057;264;896;46;170;80;256;126;426
314960;201512;761;2336;575;1945;143;546;168;500;311;1046
314970;201512;567;1895;460;1680;108;451;123;436;231;887
314980;201512;1671;5103;1387;4597;397;1478;154;434;551;1912
314990;201512;2723;8464;2017;6874;556;2196;391;1091;947;3287
314995;201512;1609;4865;1390;4519;156;614;876;2761;1032;3375
315000;201512;1095;3122;897;2802;111;395;564;1742;675;2137
315010;201512;466;1418;360;1200;92;372;117;334;209;706
315015;201512;2057;6276;1829;6003;246;834;1326;4560;1572;5394
315020;201512;827;2563;612;2081;97;389;276;878;373;1267
315030;201512;745;2213;595;1934;159;553;133;407;292;960
315040;201512;880;2713;820;2599;159;527;492;1543;651;2070
315050;201512;1450;4119;1150;3642;242;881;483;1481;725;2362
315053;201512;1090;3210;956;2977;164;638;428;1328;592;1966
315057;201512;1733;5899;1501;5526;293;1087;811;3079;1104;4166
315060;201512;864;2787;607;2193;122;481;101;342;223;823
315070;201512;772;2308;660;2131;180;632;305;932;485;1564
315080;201512;2901;9594;2523;8762;654;2455;1052;3561;1706;6016
315090;201512;788;2795;676;2536;165;694;172;622;337;1316
315100;201512;1238;4144;892;3312;213;912;220;738;433;1650
315110;201512;1408;4257;1187;3820;283;985;435;1355;718;2340
315120;201512;14501;33628;9724;27392;1546;4546;4936;14701;6482;19247
315130;201512;1435;4679;1285;4379;353;1351;403;1306;756;2657
315140;201512;2696;8611;2208;7571;500;2001;746;2314;1246;4315
315150;201512;4931;13184;3604;10917;745;2536;1296;3799;2041;6335
315160;201512;1266;3624;1013;3113;202;667;446;1315;648;1982
315170;201512;1494;4432;1205;3957;260;923;462;1617;722;2540
315180;201512;17348;48713;9688;32060;1791;6729;1761;5204;3552;11933
315190;201512;2129;5487;1774;4942;477;1357;896;2511;1373;3868
315200;201512;3981;13229;3221;11534;971;3798;717;2431;1688;6229
315210;201512;7970;23186;6200;19484;1316;4639;2174;6465;3490;11104
315213;201512;1100;3490;1028;3388;60;216;832;2743;892;2959
315217;201512;2528;8554;2092;7773;258;1158;1185;4328;1443;5486
315220;201512;10110;28830;8384;26091;2440;7518;3445;11239;5885;18757
315230;201512;2931;7629;2622;7266;207;307;2195;6590;2402;6897
315240;201512;3133;9542;2651;8766;695;2534;1295;4111;1990;6645
315250;201512;10393;31294;7533;25701;1900;7176;2182;7322;4082;14498
315260;201512;998;3065;674;2342;151;583;119;367;270;950
315270;201512;776;2469;584;2080;118;465;134;424;252;889
315280;201512;3204;9074;2020;6498;466;1615;406;1132;872;2747
315290;201512;1435;3977;1036;3318;329;1152;174;531;503;1683
315300;201512;552;1428;373;1203;165;557;131;425;296;982
315310;201512;1275;4067;1060;3670;140;586;664;2186;804;2772
315320;201512;802;2411;631;2176;116;464;298;1039;414;1503
315330;201512;699;2541;430;1792;109;506;44;188;153;694
315340;201512;3753;10610;3021;9466;650;2261;1213;3650;1863;5911
315350;201512;1853;5086;1371;4367;302;1009;728;2368;1030;3377
315360;201512;1698;5592;1353;4729;258;987;443;1444;701;2431
315370;201512;507;1493;431;1376;88;307;226;732;314;1039
315380;201512;204;694;156;577;39;170;33;94;72;264
315390;201512;1379;4564;992;3616;233;967;182;589;415;1556
315400;201512;4392;13140;3555;11495;727;2630;1573;4948;2300;7578
315410;201512;2065;5435;1718;4946;212;724;1125;3233;1337;3957
315415;201512;1026;3350;928;3201;336;1190;422;1523;758;2713
315420;201512;1271;3995;939;3292;229;848;145;470;374;1318
315430;201512;3849;10353;2853;8687;772;2628;643;1847;1415;4475
315440;201512;919;2818;789;2605;150;563;356;1124;506;1687
315445;201512;2142;5939;1690;5246;198;698;1169;3581;1367;4279
315450;201512;2460;7686;2196;7281;493;1519;1238;4296;1731;5815
315460;201512;35161;113988;30519;104048;10094;36809;5843;18743;15937;55552
315470;201512;514;1525;412;1332;53;213;213;651;266;864
315480;201512;1790;5380;1114;3833;195;739;188;632;383;1371
315490;201512;3167;8429;2437;7422;348;1228;1003;2864;1351;4092
315500;201512;484;1451;317;1061;45;179;119;343;164;522
315510;201512;1445;4074;1207;3700;99;334;848;2533;947;2867
315520;201512;1112;3206;836;2775;113;419;526;1678;639;2097
315530;201512;590;1996;493;1763;183;699;133;436;316;1135
315540;201512;1109;3441;901;3043;177;710;316;1045;493;1755
315550;201512;1771;4944;1355;4346;386;1360;423;1296;809;2656
315560;201512;6521;21594;5866;20662;634;2503;3955;14011;4589;16514
315570;201512;2046;6349;1877;6063;330;1220;1014;3165;1344;4385
315580;201512;2577;7471;1977;6363;494;1832;531;1554;1025;3386
315590;201512;908;2627;796;2445;150;504;395;1183;545;1687
315600;201512;2513;8801;2007;7823;364;1494;1049;4228;1413;5722
315610;201512;1007;2853;802;2427;153;593;301;758;454;1351
315620;201512;318;1110;300;1079;93;319;159;604;252;923
315630;201512;892;2804;730;2474;186;684;183;573;369;1257
315640;201512;567;1626;459;1445;99;376;201;569;300;945
315645;201512;896;2704;734;2353;265;918;173;521;438;1439
315650;201512;1911;5238;1520;4681;91;381;1125;3428;1216;3809
315660;201512;2585;6723;2130;6009;398;1144;1278;3574;1676;4718
315670;201512;10669;35125;9291;32378;2715;10174;3158;10711;5873;20885
315680;201512;3098;10238;2380;8747;837;3244;406;1473;1243;4717
315690;201512;3512;9894;2403;7874;618;2239;469;1561;1087;3800
315700;201512;7340;22688;6138;20260;1108;4094;2808;8824;3916;12918
315710;201512;1815;5231;1432;4603;122;487;909;2836;1031;3323
315720;201512;3501;10988;3083;10215;545;2101;1585;4985;2130;7086
315725;201512;1467;4628;1311;4381;306;1050;777;2650;1083;3700
315727;201512;633;1950;522;1714;113;417;207;626;320;1043
315730;201512;841;2559;756;2398;121;443;420;1289;541;1732
315733;201512;988;2963;871;2740;266;916;263;757;529;1673
315737;201512;1312;3954;996;3369;75;320;641;2194;716;2514
315740;201512;1024;3136;844;2777;167;658;404;1231;571;1889
315750;201512;1122;3472;1019;3281;79;301;731;2335;810;2636
315760;201512;1033;2770;988;2714;31;98;888;2419;919;2517
315765;201512;1441;4455;1287;4245;71;270;1048;3489;1119;3759
315770;201512;1602;5069;1365;4600;358;1355;385;1231;743;2586
315780;201512;22485;72857;19982;67230;5194;18702;5808;19158;11002;37860
315790;201512;3513;11730;3062;10810;306;1034;2042;7427;2348;8461
315800;201512;1519;5794;1166;4748;272;1215;189;718;461;1933
315810;201512;1397;3758;1179;3423;144;423;817;2346;961;2769
315820;201512;2594;8591;2245;7962;726;2684;878;3200;1604;5884
315830;201512;1221;4064;1024;3616;129;564;312;959;441;1523
315840;201512;842;2206;589;1753;94;312;170;475;264;787
315850;201512;1023;3648;986;3568;239;933;494;1736;733;2669
315860;201512;550;1872;407;1559;102;462;71;235;173;697
315870;201512;480;1400;388;1248;112;398;140;416;252;814
315880;201512;1208;3100;943;2761;214;762;325;863;539;1625
315890;201512;1554;5192;1338;4835;478;1843;540;1919;1018;3762
315895;201512;5241;16159;4492;14487;1024;3648;1612;4876;2636;8524
315900;201512;740;2261;706;2199;85;345;533;1547;618;1892
315910;201512;527;1766;487;1695;157;606;267;890;424;1496
315920;201512;1587;4349;919;2920;204;710;181;474;385;1184
315930;201512;1113;3007;831;2508;209;698;209;590;418;1288
315935;201512;994;3231;874;2973;237;892;225;721;462;1613
315940;201512;646;2008;554;1819;133;512;250;776;383;1288
315950;201512;1177;3595;1051;3355;223;669;631;2078;854;2747
315960;201512;3395;10706;2270;8370;841;3557;97;229;938;3786
315970;201512;766;2063;582;1801;50;137;416;1352;466;1489
315980;201512;4137;9988;2487;7177;648;2144;619;1463;1267;3607
315990;201512;3995;11490;3343;10447;568;2151;1677;5065;2245;7216
316000;201512;549;1642;461;1517;142;567;168;520;310;1087
316010;201512;607;2013;480;1750;77;324;187;612;264;936
316020;201512;1134;3499;934;3177;133;517;579;1937;712;2454
316030;201512;3359;9679;2452;8055;228;857;1420;4748;1648;5605
316040;201512;3789;11834;2762;9602;440;1760;490;1354;930;3114
316045;201512;2091;6474;1901;6155;277;871;1309;4367;1586;5238
316050;201512;351;1117;276;995;55;218;124;421;179;639
316060;201512;746;2199;589;1964;80;359;341;1056;421;1415
316070;201512;6087;19082;5179;17028;1182;4355;2059;6404;3241;10759
316080;201512;755;2727;657;2471;148;643;85;301;233;944
316090;201512;581;1721;373;1264;81;313;89;276;170;589
316095;201512;1443;4580;1237;4211;219;762;740;2531;959;3293
316100;201512;2808;9207;2045;7263;492;2000;383;1220;875;3220
316105;201512;980;2740;723;2306;181;608;278;903;459;1511
316110;201512;12370;41867;10917;39337;1348;5252;7151;26394;8499;31646
316120;201512;1155;3732;929;3155;217;795;256;749;473;1544
316130;201512;1482;3326;900;2496;151;485;413;1081;564;1566
316140;201512;970;2804;739;2420;101;336;411;1369;512;1705
316150;201512;1490;4136;1300;3806;229;770;730;2102;959;2872
316160;201512;1241;3679;944;3096;163;614;428;1379;591;1993
316165;201512;940;2509;775;2268;154;519;417;1205;571;1724
316170;201512;1400;4011;1030;3354;163;598;418;1247;581;1845
316180;201512;1385;4332;944;3337;210;832;170;504;380;1336
316190;201512;2849;8780;1427;4975;273;995;226;654;499;1649
316200;201512;3814;12075;2889;10185;650;2628;759;2593;1409;5221
316210;201512;4869;15361;4070;13765;1579;5681;648;2064;2227;7745
316220;201512;794;2435;553;1944;111;446;70;260;181;706
316225;201512;1194;3319;999;2988;140;455;618;1795;758;2250
316230;201512;450;1233;343;1046;54;184;167;539;221;723
316240;201512;6593;20049;5695;18846;668;2232;4083;13654;4751;15886
316245;201512;3246;11097;2983;10643;223;1103;2290;7918;2513;9021
316250;201512;10696;30836;8150;25728;2186;7495;2124;6298;4310;13793
316255;201512;2564;7747;2236;7338;429;1519;1402;4584;1831;6103
316257;201512;1380;3801;1028;3150;185;647;385;1100;570;1747
316260;201512;1797;5091;1384;4472;103;381;802;2728;905;3109
316265;201512;1337;3723;963;2979;106;408;560;1659;666;2067
316270;201512;4174;13738;3796;12941;1007;3714;1492;4910;2499;8624
316280;201512;3287;10540;2932;9845;483;1818;1566;5162;2049;6980
316290;201512;3351;10435;2824;9401;555;2173;1159;3663;1714;5836
316292;201512;3495;11013;3083;10290;632;2363;1646;5204;2278;7567
316294;201512;895;2844;629;2248;122;514;49;166;171;680
316295;201512;1850;6150;1683;5819;243;1031;1026;3391;1269;4422
316300;201512;1008;3099;844;2823;72;261;548;1858;620;2119
316310;201512;730;2082;478;1604;96;373;142;437;238;810
316320;201512;616;1952;482;1710;86;361;96;319;182;680
316330;201512;950;2897;731;2397;88;319;452;1440;540;1759
316340;201512;987;3134;798;2742;183;758;344;1085;527;1843
316350;201512;1332;4202;1179;3944;200;687;669;2295;869;2982
316360;201512;737;1937;578;1698;72;218;405;1205;477;1423
316370;201512;4515;14536;3822;13068;1060;3972;605;2032;1665;6004
316380;201512;1598;4249;1252;3764;91;303;877;2642;968;2945
316390;201512;923;2675;758;2395;198;685;310;999;508;1684
316400;201512;1246;3895;975;3380;218;817;368;1221;586;2038
316410;201512;1079;3543;985;3398;214;776;590;2038;804;2814
316420;201512;1923;6211;1702;5916;152;656;1182;3987;1334;4643
316430;201512;952;2895;694;2355;164;602;169;502;333;1104
316440;201512;679;2206;554;1997;196;814;116;399;312;1213
316443;201512;703;2060;569;1808;129;466;214;631;343;1097
316447;201512;1601;4817;1445;4601;102;349;1222;3904;1324;4253
316450;201512;2174;7243;1833;6567;248;993;1189;4289;1437;5282
316460;201512;756;2315;680;2176;178;635;361;1098;539;1733
316470;201512;7475;23874;5831;20319;1454;5859;1633;5397;3087;11256
316480;201512;195;642;168;584;35;126;53;169;88;295
316490;201512;306;942;256;820;56;186;103;303;159;489
316500;201512;1134;4019;739;2811;138;567;35;122;173;689
316510;201512;804;2931;708;2726;230;956;188;677;418;1633
316520;201512;1143;3443;912;3063;169;622;294;877;463;1499
316530;201512;1090;3503;903;3119;197;850;313;883;510;1733
316540;201512;894;2837;777;2638;121;510;257;806;378;1316
316550;201512;1196;3956;1112;3808;221;881;671;2270;892;3151
316553;201512;1921;6626;1482;5544;403;1663;331;1197;734;2860
316555;201512;2828;9730;2495;9314;191;808;1850;6976;2041;7784
316556;201512;614;1611;477;1373;53;185;309;838;362;1023
316557;201512;755;2717;716;2654;283;1112;158;526;441;1638
316560;201512;331;1140;275;1017;62;285;61;188;123;473
316570;201512;1273;4021;1102;3671;140;504;554;1848;694;2352
316580;201512;302;858;194;629;47;179;52;156;99;335
316590;201512;1496;4039;1052;3288;273;906;438;1261;711;2167
316600;201512;1059;3399;929;3135;276;1012;313;1015;589;2027
316610;201512;589;2109;513;1954;105;463;303;1124;408;1587
316620;201512;2167;6584;1828;5970;314;1215;1060;3370;1374;4585
316630;201512;1459;4812;1228;4306;491;1810;322;1128;813;2938
316640;201512;186;580;162;529;32;137;73;201;105;338
316650;201512;922;3329;807;3140;123;482;495;2004;618;2486
316660;201512;199;511;96;289;11;46;27;60;38;106
316670;201512;1837;5253;1469;4590;592;1992;277;799;869;2791
316680;201512;1936;5221;1554;4679;203;658;1082;3242;1285;3900
316690;201512;1195;3971;1050;3650;301;1192;325;1071;626;2263
316695;201512;1111;3472;946;3138;141;488;547;1813;688;2301
316700;201512;354;1084;315;1012;47;199;188;543;235;742
316710;201512;3192;11771;2706;10699;939;3936;654;2734;1593;6670
316720;201512;15472;49356;12228;42145;3474;12654;2416;8081;5890;20735
316730;201512;371;1139;317;1029;74;274;142;417;216;691
316740;201512;695;2279;620;2148;129;527;316;1059;445;1586
316750;201512;419;1379;349;1215;62;259;115;351;177;610
316760;201512;3452;11490;2969;10835;1607;6027;788;2946;2395;8973
316770;201512;1275;3609;1158;3458;118;450;887;2614;1005;3064
316780;201512;581;1923;504;1766;145;584;106;324;251;908
316790;201512;867;2465;623;2039;154;555;186;597;340;1152
316800;201512;5215;17071;4621;15904;865;3365;2274;7367;3139;10732
316805;201512;852;2180;804;2119;79;206;671;1829;750;2035
316810;201512;618;1884;504;1651;149;544;190;573;339;1117
316820;201512;395;1020;222;709;40;153;37;99;77;252
316830;201512;601;2048;568;1984;174;667;228;771;402;1438
316840;201512;2928;8842;2549;8117;585;2166;1092;3250;1677;5416
316850;201512;2125;6200;1775;5600;268;955;970;3040;1238;3995
316860;201512;17883;55951;15185;50772;3479;13427;6217;19647;9696;33074
316870;201512;5899;18946;4661;15997;1346;5054;710;2298;2056;7352
316880;201512;881;2682;754;2462;220;836;241;742;461;1578
316890;201512;1327;3220;1045;2857;324;1032;542;1370;866;2402
316900;201512;2569;7680;2003;6478;460;1682;604;1731;1064;3413
316905;201512;463;1538;398;1391;137;506;126;433;263;939
316910;201512;803;2544;564;2039;161;626;103;373;264;999
316920;201512;1574;4349;1161;3764;325;1205;389;1185;714;2390
316930;201512;8810;29507;6783;24866;1490;6010;942;3063;2432;9073
316935;201512;5140;14882;3299;11108;850;3201;570;1749;1420;4950
316940;201512;7066;22908;5658;19835;1274;4744;1169;3941;2443;8685
316950;201512;1506;4215;1277;3886;123;453;891;2660;1014;3113
316960;201512;5025;12520;3910;11012;742;2291;2127;5889;2869;8180
316970;201512;3297;10438;3089;10082;698;2656;1184;3540;1882;6196
316980;201512;1043;3114;739;2530;223;851;141;463;364;1314
316990;201512;9771;31120;8088;27133;2493;9076;692;2189;3185;11265
317000;201512;2770;9421;2652;9290;343;1111;1925;7584;2268;8695
317005;201512;2609;7969;2294;7486;452;1507;1294;4265;1746;5772
317010;201512;31597;78293;18605;57194;4586;15814;3807;12064;8393;27878
317020;201512;60326;167133;35251;114578;7451;26465;7137;21084;14588;47549
317030;201512;767;2177;624;1948;71;284;376;1129;447;1413
317040;201512;10500;30268;8323;26334;2161;7367;3099;9681;5260;17048
317043;201512;751;2027;635;1877;87;256;400;1194;487;1450
317047;201512;1156;3036;831;2494;117;388;407;1207;524;1595
317050;201512;1533;5199;1173;4317;240;959;446;1527;686;2486
317052;201512;2327;7485;2112;7144;180;728;1536;5116;1716;5844
317057;201512;1769;4893;1325;4115;129;506;756;2260;885;2766
317060;201512;413;1187;277;878;58;216;83;217;141;433
317065;201512;1272;4086;1139;3869;119;533;829;2729;948;3262
317070;201512;9944;30652;6472;22613;1379;5418;959;3150;2338;8568
317075;201512;1107;3313;863;2783;216;755;217;624;433;1379
317080;201512;6194;16925;5191;15196;1531;4684;1613;4544;3144;9228
317090;201512;4910;16199;4523;15559;664;2276;3036;10687;3700;12963
317100;201512;3083;8439;2316;7120;722;2429;773;2234;1495;4663
317103;201512;2018;6884;1677;6186;269;1249;815;2884;1084;4133
317107;201512;1329;4050;1128;3635;186;724;686;2062;872;2786
317110;201512;672;1667;388;1175;80;291;146;430;226;721
317115;201512;1168;3659;991;3296;128;426;659;2227;787;2653
317120;201512;11253;36795;8994;31415;2158;8354;3170;10691;5328;19045
317130;201512;7581;22559;6274;20165;1342;4840;2602;8182;3944;13022
317140;201512;586;1892;550;1825;80;290;356;1179;436;1469
317150;201512;983;2690;842;2526;97;344;601;1751;698;2095
317160;201512;3552;9320;2678;8160;223;716;1849;5600;2072;6316
317170;201512;1896;5224;1519;4577;94;360;833;2333;927;2693
317180;201512;1828;6055;1439;5191;396;1564;377;1309;773;2873
317190;201512;1385;3954;1104;3551;120;426;740;2351;860;2777
317200;201512;4515;14042;3836;12644;1022;3744;1177;3684;2199;7428
317210;201512;1053;3141;863;2875;169;690;466;1505;635;2195
317220;201512;298;1028;282;1003;83;322;120;404;203;726
320010;201512;5173;16061;4417;14432;809;2807;2247;7213;3056;10020
320013;201512;1944;5818;1380;4639;222;769;602;2066;824;2835
320016;201512;3206;8979;2746;8285;379;1101;1900;5768;2279;6869
320020;201512;3889;12033;3257;10699;949;3373;1053;3390;2002;6763
320030;201512;1664;5306;1319;4544;402;1467;403;1338;805;2805
320035;201512;1802;5267;1555;4872;502;1757;553;1578;1055;3335
320040;201512;3326;10685;2658;9238;590;2230;789;2642;1379;4872
320050;201512;1805;4843;1522;4323;349;1076;656;1743;1005;2819
320060;201512;12040;37846;9041;30837;2133;7923;2526;8042;4659;15965
320070;201512;1500;4771;1187;4045;269;1021;306;902;575;1923
320080;201512;5650;16809;4239;13915;1088;3536;1156;4303;2244;7839
320090;201512;8414;24344;6582;20568;1782;5945;2430;7183;4212;13128
320100;201512;2964;9039;2347;7765;653;2269;807;2578;1460;4847
320110;201512;1304;3856;1120;3479;271;868;348;1064;619;1932
320115;201512;1838;6455;1649;6097;848;3309;435;1592;1283;4901
320120;201512;16642;50467;12668;42509;3306;12154;3591;11868;6897;24022
320130;201512;37276;118831;33459;110867;7144;26309;15568;49513;22712;75822
320140;201512;4071;12751;2830;9841;682;2632;345;1117;1027;3749
320150;201512;16810;46105;11628;35935;2759;9203;1777;5159;4536;14362
320160;201512;4938;15491;4233;13981;1071;4001;1447;4273;2518;8274
320170;201512;1763;5604;1416;4824;374;1350;530;1785;904;3135
320180;201512;820;2686;708;2490;281;1039;179;640;460;1679
320190;201512;3806;12897;2955;10733;843;3257;594;2021;1437;5278
320200;201512;1084;3308;902;2980;226;809;321;1081;547;1890
320210;201512;4963;13746;4143;12185;895;2961;1919;5204;2814;8165
320220;201512;2608;7990;2092;6965;549;2001;782;2615;1331;4616
320225;201512;1442;4877;1127;4099;399;1554;183;659;582;2213
320230;201512;4303;13858;3709;12818;1175;4370;1307;4532;2482;8902
320240;201512;12430;36478;9580;31104;2576;9088;2427;7707;5003;16795
320245;201512;3654;12342;3327;11523;1105;4093;904;2946;2009;7039
320250;201512;1851;5597;1310;4350;349;1356;230;617;579;1973
320255;201512;1831;6077;1573;5633;639;2499;534;1967;1173;4466
320260;201512;1052;3214;785;2584;205;731;195;534;400;1265
320265;201512;2436;7583;2103;7102;455;1611;1216;4216;1671;5827
320270;201512;2746;8155;2025;6714;470;1698;822;2694;1292;4392
320280;201512;7022;20962;6024;18934;1429;4947;2281;6697;3710;11644
320290;201512;1491;4829;1066;3742;337;1259;189;615;526;1874
320300;201512;4362;14368;3833;13185;1244;4553;915;3047;2159;7600
320305;201512;4598;14699;3949;13206;946;3467;1650;5196;2596;8663
320310;201512;2013;5929;1682;5248;434;1416;639;1925;1073;3341
320313;201512;2289;6632;1523;4835;351;1332;279;739;630;2071
320316;201512;1784;5341;1433;4592;456;1549;459;1388;915;2937
320320;201512;20188;61759;16062;53786;4453;16346;5217;16847;9670;33193
320330;201512;3077;9079;2593;8255;643;2020;1221;4090;1864;6110
320332;201512;5046;16644;4355;15281;1583;5888;1229;4301;2812;10189
320334;201512;1980;6286;1358;4890;389;1565;228;748;617;2313
320335;201512;2415;7044;1501;4941;381;1402;205;534;586;1936
320340;201512;5998;16148;4889;14273;1109;3520;2025;5938;3134;9458
320350;201512;5234;13890;3869;11369;850;2682;1544;4444;2394;7126
320360;201512;1765;4619;1262;3624;228;706;500;1322;728;2028
320370;201512;3239;10413;2589;8944;735;2625;825;2777;1560;5402
320380;201512;2381;6937;2071;6367;396;1350;1156;3439;1552;4789
320390;201512;7800;23160;6177;19686;1766;6134;1682;4987;3448;11121
320400;201512;3735;11244;3261;10399;950;3386;1174;3422;2124;6808
320405;201512;4145;12119;3617;11276;901;3008;1768;5332;2669;8340
320410;201512;5642;14680;4105;12641;1035;3428;1804;5494;2839;8922
320420;201512;2032;6148;1518;5209;449;1722;338;1123;787;2845
320425;201512;1981;5295;1668;4747;222;688;1016;2815;1238;3503
320430;201512;2391;6684;2046;5976;439;1370;1056;2955;1495;4325
320435;201512;2879;9378;2367;8303;1079;3945;630;2301;1709;6246
320440;201512;1159;3816;1005;3401;236;909;348;1086;584;1995
320450;201512;2071;6426;1674;5597;460;1716;686;2167;1146;3883
320455;201512;4364;14315;3106;11152;890;3424;764;2641;1654;6065
320460;201512;2797;8941;2155;7476;557;2119;607;1954;1164;4073
320465;201512;1666;5160;1257;4211;231;856;564;1829;795;2685
320470;201512;4546;13605;3001;10028;809;2990;513;1497;1322;4487
320480;201512;1832;5621;1578;5119;414;1480;537;1678;951;3158
320490;201512;16105;49186;13165;43504;3993;14445;3670;11960;7663;26405
320495;201512;1266;3818;877;2945;302;1051;106;378;408;1429
320500;201512;47228;142153;40447;129400;9999;34648;18314;56877;28313;91525
320501;201512;4385;13576;3697;12502;1246;4769;1261;4004;2507;8773
320503;201512;1930;6472;1540;5609;599;2384;384;1204;983;3588
320506;201512;3898;12107;2630;8941;838;3058;181;517;1019;3575
320510;201512;8364;25951;7084;23379;1795;6363;3126;10109;4921;16472
320515;201512;1999;5673;1592;4770;430;1321;326;895;756;2216
320517;201512;2216;7090;1766;6142;600;2296;382;1214;982;3510
320520;201512;37291;111251;29619;96475;7937;28396;10324;32869;18261;61265
320530;201512;27843;83744;22720;73528;4811;17932;10536;31695;15347;49627
330010;201512;20156;61116;17792;56411;3825;13074;9321;28902;13146;41976
330015;201512;1731;4759;1474;4274;262;886;608;1693;870;2579
330020;201512;17344;50755;15623;47871;3093;10332;8882;26564;11975;36896
330022;201512;1835;5513;1529;4994;309;1145;755;2362;1064;3507
330023;201512;3340;10253;2894;9463;823;2926;928;2871;1751;5797
330025;201512;4481;12048;3498;10436;824;2682;1788;5223;2612;7905
330030;201512;8033;26589;6976;24391;1472;5673;3243;10830;4715;16503
330040;201512;12344;35819;10564;32555;2412;7939;5136;15270;7548;23209
330045;201512;69948;192527;60507;178528;8081;25526;40444;117233;48525;142759
330050;201512;2587;7982;2235;7259;661;2378;660;1958;1321;4336
330060;201512;5801;16658;4982;15438;1240;4302;2435;7460;3675;11762
330070;201512;23237;69541;20321;64318;4582;15584;9165;28747;13747;44331
330080;201512;7980;22713;7401;21791;958;2800;5091;15149;6049;17949
330090;201512;2702;7291;2427;6826;458;1431;1305;3542;1763;4973
330093;201512;2089;6130;1689;5371;400;1320;607;1963;1007;3283
330095;201512;1045;3536;900;3207;242;985;217;704;459;1689
330100;201512;56077;177661;50520;167988;9013;33642;26712;88319;35725;121961
330110;201512;2399;7501;2089;6926;533;1914;607;1937;1140;3851
330115;201512;2044;5814;1777;5389;346;1183;898;2621;1244;3804
330120;201512;2566;7141;2244;6651;531;1751;1143;3229;1674;4980
330130;201512;3604;11521;3135;10640;825;3033;1378;4567;2203;7600
330140;201512;3011;9357;2718;8904;643;2316;1344;4351;1987;6667
330150;201512;2428;7062;1831;5839;418;1453;420;1310;838;2763
330160;201512;1168;3746;1017;3475;295;1144;449;1443;744;2587
330170;201512;103233;308161;93361;291840;17023;56329;55013;170403;72036;226732
330180;201512;2036;5948;1682;5284;164;634;997;2923;1161;3557
330185;201512;7889;24581;6807;22389;1563;5601;3412;10900;4975;16501
330187;201512;3936;11164;3339;10133;518;1764;2154;6408;2672;8172
330190;201512;26111;74065;24075;70743;4707;14531;15204;44317;19911;58848
330200;201512;14082;44262;12376;41171;3243;11184;5785;19409;9028;30593
330205;201512;2261;6115;1930;5535;367;1164;1028;2829;1395;3993
330210;201512;3941;10677;3061;8983;854;2649;734;2088;1588;4737
330220;201512;10287;31170;8801;27933;2376;8174;2258;6520;4634;14694
330225;201512;3988;12157;3562;11389;469;1747;2195;6911;2664;8658
330227;201512;17720;50591;15743;47601;4031;12466;8079;24717;12110;37183
330230;201512;1394;4143;1250;3890;314;1107;525;1531;839;2638
330240;201512;17648;53993;14820;48385;4976;17614;3307;10099;8283;27713
330245;201512;1287;3966;991;3390;255;960;188;597;443;1557
330250;201512;36065;104799;32441;98519;9863;30156;12908;40147;22771;70303
330260;201512;3722;11601;3211;10532;634;2327;1361;4180;1995;6507
330270;201512;17369;42795;12045;35227;3141;10038;4244;12246;7385;22284
330280;201512;2198;6514;1794;5700;317;1107;818;2401;1135;3508
330285;201512;18662;53297;16670;50270;2927;9555;10146;30206;13073;39761
330290;201512;3604;9992;3131;9270;537;1812;1820;5140;2357;6952
330300;201512;3352;10776;3030;10170;456;1763;1770;5767;2226;7530
330310;201512;2392;6774;2048;6180;332;1076;1118;3291;1450;4367
330320;201512;13332;39720;12375;38231;1892;6371;8805;26946;10697;33317
330330;201512;27712;76747;24174;70961;4199;13833;14570;41197;18769;55030
330340;201512;14694;42774;11252;36126;2925;9979;3335;10434;6260;20413
330350;201512;87827;261813;80764;251006;12429;40499;55631;172725;68060;213224
330360;201512;5737;17177;5517;16860;364;1253;4650;14123;5014;15376
330370;201512;3509;12384;3150;11573;1092;4161;1010;3734;2102;7895
330380;201512;4991;15983;4164;14323;945;3553;1652;5517;2597;9070
330385;201512;4157;14221;3756;13397;1178;4527;1361;4801;2539;9328
330390;201512;23768;77044;20628;70470;4993;18653;8802;29163;13795;47816
330395;201512;3054;8932;2722;8343;278;1018;1817;5389;2095;6407
330400;201512;2571;8143;2301;7651;338;1367;1318;4017;1656;5384
330410;201512;2810;8675;2305;7675;511;1867;1009;3254;1520;5121
330411;201512;2374;7336;2022;6571;243;942;1159;3589;1402;4531
330412;201512;1357;4567;1101;4031;241;1018;444;1505;685;2523
330414;201512;25212;70467;21686;65396;4402;13260;12626;38380;17028;51640
330415;201512;3601;10940;3054;9911;814;2728;1091;3554;1905;6282
330420;201512;9572;27827;6331;21486;1483;5442;1085;3530;2568;8972
330430;201512;7634;22417;6701;20619;1417;4700;3138;9384;4555;14084
330440;201512;1798;5934;1505;5278;468;1823;308;926;776;2749
330450;201512;1414;4668;1254;4361;289;1200;604;2009;893;3209
330452;201512;13957;40694;10770;34364;2816;9801;3814;11600;6630;21401
330455;201512;493178;1366950;403770;1221577;97038;310504;192286;573568;289324;884072
330460;201512;1235;3964;1088;3694;231;905;495;1616;726;2521
330470;201512;4428;13379;3883;12336;932;3225;1699;5210;2631;8435
330475;201512;7878;24295;6862;22491;2009;7219;2544;8059;4553;15278
330480;201512;5879;17248;5349;16453;1098;3660;2943;8886;4041;12546
330490;201512;108732;287893;96880;270249;10301;29804;71384;199259;81685;229063
330500;201512;5560;17087;5255;16497;672;2320;3592;11109;4264;13429
330510;201512;38273;117021;34104;110071;10790;35373;14609;47924;25399;83297
330513;201512;1522;4544;1369;4263;411;1288;515;1636;926;2924
330515;201512;3053;9409;2651;8627;800;2623;806;2596;1606;5219
330520;201512;11786;34939;10325;32261;2204;7253;4932;15181;7136;22434
330530;201512;1538;4583;1338;4193;359;1202;500;1522;859;2724
330540;201512;3085;9018;2541;8044;607;2099;1036;3122;1643;5221
330550;201512;8097;26888;7019;24750;3037;11131;1102;3868;4139;14999
330555;201512;10478;30766;9206;28855;1797;5721;5468;17501;7265;23222
330560;201512;4220;12672;3807;11901;761;2646;1934;5786;2695;8432
330570;201512;3657;10545;3066;9519;825;2673;1431;4445;2256;7118
330575;201512;5260;15132;4650;14001;777;2626;2875;8251;3652;10877
330580;201512;14697;45886;12297;40858;3272;11456;4797;15948;8069;27404
330590;201512;1661;5051;1535;4836;318;1079;909;2818;1227;3897
330600;201512;10867;30852;8552;27001;1210;4374;4638;14262;5848;18636
330610;201512;9080;28327;8175;26626;1492;5505;4567;14555;6059;20060
330615;201512;1696;5877;1511;5461;668;2608;302;1054;970;3662
330620;201512;3648;12462;3236;11676;1126;4448;799;2909;1925;7357
330630;201512;23004;67504;18602;59444;3366;12225;9675;29480;13041;41705
350010;201512;2135;6310;1424;4782;329;1211;223;633;552;1844
350020;201512;491;1286;326;957;53;166;171;466;224;632
350030;201512;4475;13840;3446;11704;1226;4585;761;2344;1987;6929
350040;201512;511;1738;389;1451;89;364;105;335;194;699
350050;201512;1068;3175;840;2755;203;775;295;850;498;1625
350055;201512;677;1988;575;1817;129;433;308;944;437;1377
350060;201512;110;318;86;281;24;94;38;115;62;209
350070;201512;3598;10925;2267;7943;473;1831;418;1276;891;3107
350075;201512;440;1470;343;1301;116;459;84;297;200;756
350080;201512;584;1646;392;1254;83;300;147;444;230;744
350090;201512;620;1624;406;1241;82;259;152;451;234;710
350100;201512;1836;5744;1295;4557;287;1114;368;1189;655;2303
350110;201512;465;1362;346;1095;47;178;172;516;219;694
350115;201512;1289;3944;1129;3593;209;779;598;1730;807;2509
350120;201512;579;1516;291;894;58;187;46;135;104;322
350130;201512;3378;9897;2936;9006;453;1598;1560;4455;2013;6053
350140;201512;604;1923;510;1754;90;363;238;779;328;1142
350150;201512;382;1288;336;1189;121;455;85;295;206;750
350160;201512;7809;22764;5218;17469;1286;4823;1912;5783;3198;10606
350170;201512;1781;6063;1507;5370;388;1498;365;1188;753;2686
350180;201512;1120;3061;746;2232;133;402;336;981;469;1383
350190;201512;3181;9849;2573;8586;547;2194;1216;3576;1763;5770
350200;201512;351;1111;294;1002;44;166;155;525;199;691
350210;201512;5255;13843;3841;11490;1089;3599;1509;4305;2598;7904
350220;201512;2641;8328;2258;7497;583;2282;790;2340;1373;4622
350230;201512;643;2094;583;1989;137;530;244;798;381;1328
350240;201512;462;1443;386;1247;78;265;221;688;299;953
350250;201512;2173;7815;2026;7507;724;2851;699;2550;1423;5401
350260;201512;967;2583;673;2051;124;409;285;813;409;1222
350270;201512;5072;15409;4160;13380;802;2747;1716;5291;2518;8038
350275;201512;1992;6608;1774;6209;498;1860;643;2139;1141;3999
350280;201512;22347;54925;13190;38883;2864;8933;2870;8254;5734;17187
350290;201512;1748;5628;1345;4764;288;1141;354;1137;642;2278
350300;201512;368;1098;316;997;77;248;162;503;239;751
350310;201512;866;2835;741;2537;114;445;336;1107;450;1552
350315;201512;530;1644;405;1375;68;272;99;300;167;572
350320;201512;11541;35707;9937;32510;2777;9684;1483;4915;4260;14599
350330;201512;13821;38852;8906;27399;1849;5685;2946;8598;4795;14283
350335;201512;372;1162;321;1057;35;107;216;728;251;835
350340;201512;1152;3390;782;2621;154;589;238;742;392;1331
350350;201512;740;2279;624;2072;122;478;227;722;349;1200
350360;201512;796;2685;666;2405;187;712;246;898;433;1610
350370;201512;714;2136;500;1655;90;326;103;290;193;616
350380;201512;4088;11748;2724;9296;753;2864;658;1968;1411;4832
350390;201512;8857;27446;7749;25339;2334;7973;2905;9245;5239;17218
350395;201512;355;991;179;615;24;92;37;121;61;213
350400;201512;8024;22755;6318;19611;1470;5087;2468;7261;3938;12348
350410;201512;8331;27627;6210;23003;1676;6800;1012;3470;2688;10270
350420;201512;556;1672;380;1337;68;288;29;90;97;378
350430;201512;744;2276;598;2000;129;491;270;845;399;1336
350440;201512;1225;3822;1086;3534;272;916;499;1597;771;2513
350450;201512;7796;23207;5841;19196;1384;4911;1399;4294;2783;9205
350460;201512;1393;3911;909;2891;190;680;276;786;466;1466
350470;201512;249;683;200;593;38;138;113;307;151;445
350480;201512;810;2447;538;1832;76;291;94;271;170;562
350490;201512;1814;5378;1544;4964;380;1351;583;1729;963;3080
350500;201512;579;1673;495;1530;109;368;235;709;344;1077
350510;201512;1057;3163;815;2626;138;529;343;1006;481;1535
350520;201512;1324;4834;999;3940;250;1091;179;651;429;1742
350530;201512;2472;7234;1993;6237;576;1907;599;1699;1175;3606
350535;201512;1309;4112;1215;3929;154;619;823;2527;977;3146
350540;201512;1935;5359;1512;4593;409;1313;515;1538;924;2851
350550;201512;11600;30836;7687;24181;1670;5830;2516;7528;4186;13358
350560;201512;3455;11232;3070;10388;462;1685;1636;5566;2098;7251
350570;201512;18466;61300;16319;56513;4849;18061;5748;18820;10597;36881
350580;201512;1693;5225;1187;4051;259;976;163;462;422;1438
350590;201512;4174;12817;3107;10577;818;3092;1035;3207;1853;6299
350600;201512;41017;100411;26510;75376;4433;13569;12183;32639;16616;46208
350610;201512;7788;22249;5932;18923;1225;4367;2573;7937;3798;12304
350620;201512;394;1103;290;937;58;216;134;400;192;616
350630;201512;1565;4646;1187;3930;261;1016;333;973;594;1989
350635;201512;6078;18085;4569;15267;1107;3988;1747;5721;2854;9709
350640;201512;710;2218;471;1613;87;335;104;328;191;663
350650;201512;7303;22203;4072;14230;992;3848;440;1394;1432;5242
350660;201512;4424;13087;3678;11804;773;2710;1921;6000;2694;8710
350670;201512;1732;5297;1591;5020;311;1037;947;2911;1258;3948
350680;201512;1158;3477;895;2936;196;737;368;1159;564;1896
350690;201512;894;2889;708;2500;156;601;225;734;381;1335
350700;201512;4147;12262;2588;9148;741;2795;607;1864;1348;4659
350710;201512;2554;7947;2253;7417;350;1281;1371;4433;1721;5714
350715;201512;852;2566;733;2334;230;784;237;675;467;1459
350720;201512;139;408;124;383;38;123;47;140;85;263
350730;201512;390;1454;368;1395;98;419;143;518;241;937
350740;201512;1939;5936;1425;4670;282;1011;455;1324;737;2335
350745;201512;383;1187;273;907;46;173;122;357;168;530
350750;201512;10307;30869;7815;25752;1836;6622;1701;5082;3537;11704
350760;201512;13282;38768;10424;33449;2657;9419;3375;9900;6032;19319
350770;201512;732;2065;484;1572;71;266;224;693;295;959
350775;201512;572;1546;477;1396;71;256;272;770;343;1026
350780;201512;2025;6110;1488;4995;418;1557;217;684;635;2241
350790;201512;2043;6328;1491;5167;375;1406;324;976;699;2382
350800;201512;3044;10012;2850;9686;468;1846;1765;5814;2233;7660
350810;201512;2061;5744;1671;5167;490;1630;624;1912;1114;3542
350820;201512;573;1535;413;1221;72;265;188;497;260;762
350830;201512;900;2749;590;2002;88;316;148;423;236;739
350840;201512;2533;8835;2044;7616;601;2413;391;1253;992;3666
350850;201512;6312;20776;5143;18098;1618;6027;1146;3862;2764;9889
350860;201512;3164;9772;3018;9547;238;963;2349;7353;2587;8316
350870;201512;2669;8436;2210;7690;559;2213;1236;4287;1795;6500
350880;201512;1327;4322;1080;3788;258;970;250;845;508;1815
350890;201512;677;1901;431;1360;62;227;97;225;159;452
350900;201512;3986;12925;2971;10546;770;2994;415;1306;1185;4300
350910;201512;847;2497;731;2254;239;780;274;805;513;1585
350920;201512;10092;28812;8948;26741;1119;3725;6061;17405;7180;21130
350925;201512;4811;14705;3895;12791;970;3397;1436;4269;2406;7666
350930;201512;1610;4363;1277;3760;150;490;812;2290;962;2780
350940;201512;1962;6382;1784;6099;345;1396;1049;3440;1394;4836
350945;201512;910;2880;757;2572;125;518;420;1358;545;1876
350950;201512;69645;210066;54965;178999;13068;46573;21977;67583;35045;114156
350960;201512;4503;14928;3777;13360;684;2723;2074;6995;2758;9718
350970;201512;4387;15005;3633;13166;1143;4509;762;2370;1905;6879
350980;201512;605;1962;541;1850;223;815;189;638;412;1453
350990;201512;1759;5970;1490;5437;448;1761;388;1369;836;3130
350995;201512;786;2703;746;2622;117;528;463;1531;580;2059
351000;201512;3239;9571;2653;8447;386;1379;1266;3778;1652;5157
351010;201512;358;1010;227;729;55;197;79;253;134;450
351015;201512;864;2842;722;2571;165;661;319;1085;484;1746
351020;201512;8021;24927;6881;23093;1724;6086;3084;10449;4808;16535
351030;201512;1666;5891;1467;5388;336;1435;453;1520;789;2955
351040;201512;3341;10058;3011;9483;489;1752;1902;5742;2391;7494
351050;201512;13650;39128;9308;31055;2412;8758;2411;7847;4823;16605
351060;201512;34101;99850;27291;87163;6204;21654;11876;36660;18080;58314
351070;201512;1591;4425;1053;3415;302;1075;135;359;437;1434
351080;201512;2695;7779;2052;6934;518;1929;883;2845;1401;4774
351090;201512;392;1312;295;1097;62;267;59;208;121;475
351100;201512;2090;6337;1622;5373;488;1675;394;1342;882;3017
351110;201512;7558;18805;3967;12636;888;3212;908;2589;1796;5801
351120;201512;636;1840;503;1550;57;213;260;697;317;910
351130;201512;992;2764;509;1735;82;309;92;295;174;604
351140;201512;1750;5828;1420;5112;432;1678;340;1129;772;2807
351150;201512;1707;5841;1226;4566;213;868;246;766;459;1634
351160;201512;1307;4424;1128;3992;298;1198;381;1213;679;2411
351170;201512;1497;4715;1187;4029;220;824;527;1670;747;2494
351190;201512;796;2512;618;2046;118;395;149;464;267;859
351200;201512;2146;6261;1744;5436;336;1183;617;1728;953;2911
351210;201512;1094;3231;810;2639;177;643;278;807;455;1450
351220;201512;3345;11050;2950;10225;588;2240;1393;4719;1981;6959
351230;201512;1777;5462;1477;4899;290;1167;757;2375;1047;3542
351240;201512;1062;3334;770;2685;219;820;184;559;403;1379
351250;201512;919;2629;603;1939;119;416;212;623;331;1039
351260;201512;935;2708;790;2404;178;556;326;949;504;1505
351270;201512;364;1243;321;1153;68;292;137;436;205;728
351280;201512;5161;15042;3803;12129;838;2863;1346;4009;2184;6872
351290;201512;1002;2836;745;2326;165;524;297;895;462;1419
351300;201512;12768;41616;9302;33859;2304;9196;2865;10104;5169;19300
351310;201512;3243;9777;2565;8501;510;1958;1180;3596;1690;5554
351320;201512;903;2992;768;2685;162;652;241;734;403;1386
351330;201512;294;809;237;715;96;296;54;148;150;444
351340;201512;5849;19430;5002;17655;1432;5382;1882;6567;3314;11949
351350;201512;7219;23158;6087;20679;1749;6158;1900;6093;3649;12251
351360;201512;4170;12841;3757;12001;911;3208;1253;3628;2164;6836
351370;201512;2312;7046;1798;5960;391;1446;661;1994;1052;3440
351380;201512;37414;109023;33365;101162;6701;22065;14712;43172;21413;65237
351385;201512;200;615;186;589;41;138;83;245;124;383
351390;201512;1127;3640;941;3254;259;1027;352;1069;611;2096
351400;201512;891;2939;837;2809;334;1204;268;856;602;2060
351410;201512;2703;8011;2341;7334;393;1315;1338;4055;1731;5370
351420;201512;368;1034;236;767;53;180;61;189;114;369
351430;201512;855;2613;774;2478;104;364;550;1742;654;2106
351440;201512;3741;10879;2827;8853;669;2152;546;1474;1215;3626
351450;201512;1692;4699;1390;4229;355;1111;576;1836;931;2947
351460;201512;736;2189;615;1984;305;1025;167;510;472;1535
351470;201512;1054;3078;903;2785;208;726;371;1070;579;1796
351480;201512;2826;9067;2560;8619;431;1841;1417;4511;1848;6352
351490;201512;1805;5896;1584;5410;213;899;928;2979;1141;3878
351492;201512;210;655;160;538;18;71;90;293;108;364
351495;201512;168;536;129;427;31;125;48;136;79;261
351500;201512;24219;69433;18327;58060;4681;16291;7132;21401;11813;37692
351510;201512;8648;26594;6986;23195;1671;6019;3295;10677;4966;16696
351512;201512;442;1279;339;1057;56;169;187;595;243;764
351515;201512;2260;7041;1571;5475;392;1483;413;1272;805;2755
351518;201512;2063;6456;1401;5172;350;1476;403;1343;753;2819
351519;201512;798;2302;599;1863;112;422;205;485;317;907
351520;201512;827;2273;417;1465;64;260;64;202;128;462
351530;201512;388;1177;270;884;40;131;81;226;121;357
351535;201512;2392;6087;1831;5238;174;588;1205;3310;1379;3898
351540;201512;1708;5168;1340;4430;428;1532;187;614;615;2146
351550;201512;5019;14576;3489;11357;733;2713;1232;3819;1965;6532
351560;201512;372;1184;313;1055;68;274;52;156;120;430
351565;201512;182;595;163;545;27;100;74;235;101;335
351570;201512;11777;35860;9853;31883;2242;7861;5056;15832;7298;23693
351580;201512;340;887;206;597;51;144;62;167;113;311
351590;201512;432;1132;305;896;34;104;128;354;162;458
351600;201512;1716;4716;1464;4282;247;814;719;1972;966;2786
351610;201512;659;1796;502;1523;59;226;237;645;296;871
351620;201512;19125;60864;14191;50437;3086;12150;3317;10407;6403;22557
351630;201512;18945;59575;16870;56015;3837;13595;9262;30325;13099;43920
351640;201512;11816;35413;9491;31108;1799;6449;5138;16467;6937;22916
351650;201512;457;1373;218;754;40;158;37;109;77;267
351660;201512;774;2465;542;1843;117;420;122;358;239;778
351670;201512;3970;12192;3188;10454;594;2210;1447;4418;2041;6628
351680;201512;651;1976;394;1345;73;262;84;269;157;531
351685;201512;435;1279;351;1138;89;286;155;512;244;798
351690;201512;1087;3168;747;2398;147;521;232;642;379;1163
351700;201512;1184;3410;1008;3069;252;763;406;1200;658;1963
351710;201512;634;2024;509;1749;88;294;199;643;287;937
351720;201512;1658;4968;1103;3593;218;752;339;991;557;1743
351730;201512;1065;3027;847;2708;262;948;320;979;582;1927
351740;201512;3996;10855;3106;9060;647;2005;1108;3066;1755;5071
351750;201512;1181;3713;803;2818;185;738;223;698;408;1436
351760;201512;3721;11507;3041;10001;810;2869;1026;3105;1836;5974
351770;201512;2296;7094;1908;6407;551;1945;787;2517;1338;4462
351780;201512;1556;4318;887;2807;156;529;239;698;395;1227
351790;201512;1054;3027;899;2780;264;799;392;1253;656;2052
351800;201512;464;1016;299;774;36;96;156;398;192;494
351810;201512;1041;2909;929;2755;131;404;674;1999;805;2403
351820;201512;2340;7392;1765;6196;449;1649;156;515;605;2164
351830;201512;4065;12596;3124;10440;552;2094;1485;4680;2037;6774
351840;201512;7303;24072;6201;21842;1660;6353;2162;7304;3822;13657
351850;201512;1851;5125;1313;4147;187;734;615;1715;802;2449
351860;201512;3391;10745;2918;9732;771;2785;1151;3598;1922;6383
351870;201512;29883;88873;24974;79693;6943;23383;10773;33787;17716;57170
351880;201512;110704;346777;92300;307266;27087;95578;24554;77529;51641;173107
351885;201512;573;2005;530;1913;142;531;229;814;371;1345
351890;201512;661;1980;496;1629;118;435;98;270;216;705
351900;201512;1264;3788;1060;3450;290;1005;325;1033;615;2038
351905;201512;461;1454;368;1269;57;234;192;609;249;843
351907;201512;17341;51102;14169;45061;1873;7081;8539;26045;10412;33126
351910;201512;989;3041;843;2731;174;645;381;1158;555;1803
351920;201512;1021;2781;882;2565;127;438;543;1524;670;1962
351925;201512;918;2825;760;2492;128;459;368;1133;496;1592
351930;201512;2663;8577;2500;8253;491;2011;1637;5015;2128;7026
351940;201512;971;2901;795;2546;183;642;339;1017;522;1659
351950;201512;1456;3983;1018;3153;143;481;521;1589;664;2070
351960;201512;4077;11692;2849;9328;665;2390;1122;3588;1787;5978
351970;201512;5379;19279;4713;17894;1416;5783;1587;5829;3003;11612
351980;201512;910;2685;681;2204;135;479;252;716;387;1195
351990;201512;1565;4378;1220;3681;273;970;266;666;539;1636
352000;201512;2248;7187;2003;6657;442;1573;939;2934;1381;4507
352010;201512;1781;5896;1519;5289;372;1421;336;1111;708;2532
352020;201512;1400;4345;1181;3925;277;1019;438;1365;715;2384
352030;201512;4849;14095;3981;12774;925;3087;2048;6599;2973;9686
352040;201512;2022;6637;1622;5717;356;1365;369;1197;725;2562
352042;201512;3210;8873;2047;6314;416;1405;940;2777;1356;4182
352044;201512;1302;4234;963;3456;185;736;161;509;346;1245
352050;201512;9585;28912;6075;20951;1399;5356;1179;3580;2578;8936
352060;201512;734;2144;596;1883;131;489;246;700;377;1189
352070;201512;801;2059;622;1754;154;458;212;579;366;1037
352080;201512;433;1230;303;964;60;206;117;339;177;545
352090;201512;1344;4594;1076;3907;218;881;204;653;422;1534
352100;201512;2604;7868;1892;6487;505;1921;647;2008;1152;3929
352110;201512;505;1756;424;1567;123;484;151;529;274;1013
352115;201512;438;1369;371;1225;65;225;175;549;240;774
352120;201512;937;2869;770;2553;148;563;383;1194;531;1757
352130;201512;1834;5242;1216;3956;353;1201;299;873;652;2074
352140;201512;1783;5121;1019;3425;171;610;369;1173;540;1783
352150;201512;753;2283;585;1945;153;525;248;809;401;1334
352160;201512;1030;2819;805;2393;167;548;281;724;448;1272
352170;201512;2704;8087;2402;7473;481;1611;1243;3601;1724;5212
352180;201512;3439;9733;2838;8532;682;2198;1026;2910;1708;5108
352190;201512;1164;3449;928;2964;178;673;302;755;480;1428
352200;201512;380;1329;305;1163;57;246;135;493;192;739
352210;201512;17202;45434;13448;39873;2577;8051;7550;22666;10127;30717
352215;201512;543;1693;502;1637;66;239;289;921;355;1160
352220;201512;12664;40471;10543;35980;3390;12425;2886;9530;6276;21955
352230;201512;12501;41557;10632;37893;3021;11784;3796;12964;6817;24748
352240;201512;11955;34639;9023;29241;2681;9745;2656;7678;5337;17423
352250;201512;21787;69665;18625;62933;5408;19553;5657;18787;11065;38340
352260;201512;5361;15102;3278;10684;646;2355;1130;3369;1776;5724
352265;201512;873;2771;741;2530;80;356;439;1397;519;1753
352270;201512;1902;6405;1558;5623;425;1628;393;1349;818;2977
352280;201512;2129;6427;1739;5740;445;1679;608;1870;1053;3549
352290;201512;1175;3646;983;3224;224;875;351;1000;575;1875
352300;201512;965;2808;747;2393;179;611;308;915;487;1526
352310;201512;38074;113254;30940;100648;7987;27378;15653;50806;23640;78184
352320;201512;5655;17230;4792;15548;1352;4697;1475;4296;2827;8993
352330;201512;2025;6395;1706;5923;553;2052;482;1613;1035;3665
352340;201512;5746;18287;4272;15173;1144;4402;755;2403;1899;6805
352350;201512;1619;5501;1431;5088;283;1157;533;1761;816;2918
352360;201512;1129;3440;984;3151;199;793;590;1754;789;2547
352370;201512;839;2856;748;2644;138;556;356;1211;494;1767
352380;201512;993;3124;837;2828;268;1047;206;621;474;1668
352390;201512;18344;49331;11810;36577;2139;7545;5560;15924;7699;23469
352400;201512;4005;11148;2478;8127;697;2402;703;2110;1400;4512
352410;201512;2960;8817;2447;7930;630;2142;864;2691;1494;4833
352420;201512;941;2633;787;2329;211;681;343;957;554;1638
352430;201512;6427;19115;5232;17090;1783;6383;1526;4804;3309;11187
352440;201512;16080;48651;12667;41820;3178;11172;4398;14039;7576;25211
352450;201512;681;1968;435;1478;93;359;115;340;208;699
352460;201512;2383;7642;1949;6792;568;2182;503;1547;1071;3729
352470;201512;4034;11067;2400;7792;409;1465;784;2363;1193;3828
352480;201512;4652;12594;3520;10429;698;2365;1331;3553;2029;5918
352490;201512;724;2452;563;2037;99;411;129;413;228;824
352500;201512;8292;24071;7181;22353;3358;11251;1905;5157;5263;16408
352510;201512;3137;9921;2447;8537;729;2789;599;1988;1328;4777
352520;201512;2092;7259;1815;6576;477;1882;764;2681;1241;4563
352530;201512;7946;25301;5811;20391;1563;5845;800;2428;2363;8273
352540;201512;479;1478;347;1175;61;233;96;288;157;521
352550;201512;867;2845;581;2144;145;608;111;353;256;961
352560;201512;666;1953;465;1499;85;274;146;404;231;678
352570;201512;1802;5910;1327;4772;278;1154;264;819;542;1973
352580;201512;897;2569;741;2319;160;554;388;1181;548;1735
352585;201512;208;670;161;573;56;212;31;115;87;327
352590;201512;12656;38523;9873;32856;2668;9634;4105;12810;6773;22444
352600;201512;1582;4779;1380;4403;345;1207;595;1774;940;2981
352610;201512;3356;10152;2752;9087;809;2998;800;2414;1609;5412
352620;201512;5238;15936;4781;15225;1014;3483;2671;8276;3685;11759
352630;201512;616;1978;574;1868;128;497;238;702;366;1199
352640;201512;2817;8575;2264;7416;305;1145;1214;3839;1519;4984
352650;201512;829;2452;593;1939;128;443;169;510;297;953
352660;201512;1027;3452;792;2892;160;647;200;713;360;1360
352670;201512;10373;31113;6134;21535;1508;5696;666;2087;2174;7783
352680;201512;2821;9472;2098;7740;505;2062;600;1975;1105;4037
352690;201512;30602;83840;20812;63909;3649;12278;9837;28723;13486;41001
352700;201512;714;2107;572;1878;169;628;249;770;418;1398
352710;201512;5712;16560;4187;13461;1014;3599;1449;4354;2463;7953
352720;201512;7644;24504;6719;22431;2010;6780;2170;7150;4180;13930
352725;201512;400;1120;237;778;37;147;88;262;125;409
352730;201512;2243;7361;1956;6597;396;1450;705;2065;1101;3515
352740;201512;1989;5551;1570;4825;254;937;906;2607;1160;3544
352750;201512;469;1329;246;810;40;148;63;181;103;329
352760;201512;1137;3883;956;3433;300;1133;339;1156;639;2289
352770;201512;743;2298;632;2074;141;512;269;835;410;1347
352780;201512;612;1997;491;1722;101;399;146;457;247;856
352790;201512;637;1824;459;1486;94;319;100;317;194;636
352800;201512;979;3460;700;2689;153;658;201;660;354;1318
352810;201512;1149;2989;734;2178;136;446;225;633;361;1079
352820;201512;607;1667;427;1367;101;370;100;311;201;681
352830;201512;528;1501;316;998;52;190;50;120;102;310
352840;201512;3631;12275;3177;11272;975;3647;1035;3547;2010;7194
352850;201512;8783;26866;7229;24126;1915;6839;2500;8105;4415;14944
352860;201512;823;2664;738;2467;171;614;270;836;441;1450
352870;201512;965;2400;692;1884;71;275;411;1001;482;1276
352880;201512;2348;6592;1662;5155;320;1024;567;1645;887;2669
352885;201512;229;759;216;728;27;99;129;414;156;513
352890;201512;677;1792;489;1407;68;231;227;574;295;805
352900;201512;19669;57272;13923;45412;2930;10440;5068;15703;7998;26143
352910;201512;345;1015;202;670;23;83;29;79;52;162
352920;201512;2511;7434;1933;6254;413;1494;783;2302;1196;3796
352930;201512;5774;17787;4406;14720;1153;4145;1001;3122;2154;7267
352940;201512;21893;70738;17659;60569;5794;21297;2199;6874;7993;28171
352950;201512;308;910;198;700;50;208;39;108;89;316
352960;201512;618;1891;385;1338;67;264;59;184;126;448
352965;201512;364;1027;229;724;52;166;36;95;88;261
352970;201512;3131;7796;2474;6803;312;894;1612;4434;1924;5328
352980;201512;1226;3666;1021;3355;227;734;562;1958;789;2692
352990;201512;4021;12684;3505;11774;947;3571;1380;4352;2327;7923
353000;201512;485;1342;257;805;34;111;46;126;80;237
353010;201512;3009;8358;2162;6676;528;1849;598;1588;1126;3437
353020;201512;4301;11656;2665;8054;378;1323;1023;2726;1401;4049
353030;201512;4007;11600;3225;10134;914;3118;712;2049;1626;5167
353040;201512;612;1684;508;1516;141;479;163;440;304;919
353050;201512;4936;16348;4073;14551;1177;4532;1463;4947;2640;9479
353060;201512;35904;108243;32577;102805;3866;14636;23271;70482;27137;85118
353070;201512;10102;31383;7044;24685;1824;6762;1750;6100;3574;12862
353080;201512;5285;16596;3493;12486;765;3004;804;2578;1569;5582
353090;201512;526;1737;470;1618;45;179;270;866;315;1045
353100;201512;254;687;124;395;27;90;25;70;52;160
353110;201512;7778;23469;6529;21304;1632;5683;3296;10786;4928;16469
353120;201512;714;2109;444;1476;96;373;116;320;212;693
353130;201512;2550;7341;2043;6502;655;2232;637;1947;1292;4179
353140;201512;2385;6453;1797;5274;443;1415;735;1999;1178;3414
353150;201512;1724;5150;1380;4535;380;1311;375;1219;755;2530
353160;201512;682;1923;426;1354;94;326;68;144;162;470
353170;201512;479;1570;430;1488;121;534;189;585;310;1119
353180;201512;7916;22607;6115;19228;1144;3960;3076;9329;4220;13289
353190;201512;3635;10977;2960;9490;552;1999;1467;4342;2019;6341
353200;201512;925;3086;740;2647;224;883;198;657;422;1540
353205;201512;402;1277;348;1170;80;278;134;442;214;720
353210;201512;990;2530;732;2069;40;154;481;1311;521;1465
353215;201512;411;1284;357;1159;57;219;138;391;195;610
353220;201512;671;2066;531;1748;134;475;129;372;263;847
353230;201512;858;2722;763;2539;187;699;214;638;401;1337
353240;201512;2042;6491;1820;6045;405;1532;933;2917;1338;4449
353250;201512;1095;2936;830;2438;124;382;409;1166;533;1548
353260;201512;957;2588;673;2064;113;397;261;750;374;1147
353270;201512;632;1850;541;1672;145;469;187;554;332;1023
353280;201512;582;1863;471;1613;116;443;113;367;229;810
353282;201512;1671;5287;1557;5072;209;781;1008;3133;1217;3914
353284;201512;343;922;199;617;35;107;51;159;86;266
353286;201512;148;441;104;342;17;52;18;62;35;114
353290;201512;566;1772;445;1550;84;354;239;774;323;1128
353300;201512;1446;4469;1186;3881;284;1064;431;1248;715;2312
353310;201512;204;606;171;542;47;168;69;193;116;361
353320;201512;528;1513;461;1399;81;280;251;721;332;1001
353325;201512;597;1926;488;1701;92;358;97;272;189;630
353330;201512;630;1789;410;1276;76;271;189;539;265;810
353340;201512;2946;8326;1877;6227;524;1857;544;1689;1068;3546
353350;201512;3242;9577;2608;8375;781;2694;985;2972;1766;5666
353360;201512;389;1249;341;1144;47;189;215;686;262;875
353370;201512;646;2082;551;1849;73;286;310;992;383;1278
353380;201512;329;1058;266;930;48;203;96;289;144;492
353390;201512;5866;15800;4028;12409;782;2632;1426;4025;2208;6657
353400;201512;502;1490;413;1306;103;368;110;282;213;650
353410;201512;616;1760;496;1557;98;331;272;844;370;1175
353420;201512;589;1622;402;1199;117;347;119;327;236;674
353430;201512;2249;7658;1608;5919;389;1510;216;711;605;2221
353440;201512;59363;187323;48735;162884;13322;46645;16498;52970;29820;99615
353450;201512;432;1280;354;1118;74;262;138;405;212;667
353460;201512;3475;9745;2936;8816;468;1575;1402;4226;1870;5801
353470;201512;8897;26466;6185;20823;1362;5100;1402;4273;2764;9373
353475;201512;1676;4667;1111;3425;208;683;320;882;528;1565
353480;201512;1426;4228;1260;3908;221;742;731;2201;952;2943
353490;201512;989;2793;774;2349;161;526;280;777;441;1303
353500;201512;1005;2667;819;2341;263;762;345;967;608;1729
353510;201512;1041;3255;772;2587;166;606;184;530;350;1136
353520;201512;1115;3193;843;2715;161;597;336;1036;497;1633
353530;201512;2577;7561;2226;6899;389;1419;1170;3458;1559;4877
353540;201512;1909;5755;1638;5287;423;1446;664;2070;1087;3516
353550;201512;6093;16621;5146;15110;611;2135;3207;8951;3818;11086
353560;201512;2094;6877;1710;6161;452;1832;446;1463;898;3295
353570;201512;429;1314;357;1164;67;224;206;644;273;868
353580;201512;2228;6823;2021;6473;371;1351;1274;3999;1645;5350
353590;201512;737;2095;542;1713;151;513;166;522;317;1035
353600;201512;1707;4720;1519;4388;235;752;794;2219;1029;2971
353610;201512;589;1946;438;1609;76;339;89;273;165;612
353620;201512;2167;7001;1797;6231;464;1732;532;1674;996;3406
353625;201512;324;896;199;653;45;163;53;175;98;338
353630;201512;1624;5557;1228;4522;232;925;161;493;393;1418
353640;201512;1353;3929;1071;3316;146;474;562;1692;708;2166
353650;201512;7302;21561;5257;17147;1087;3681;1791;5655;2878;9336
353657;201512;303;949;261;861;44;170;81;251;125;421
353660;201512;1184;2985;844;2409;318;985;136;265;454;1250
353670;201512;3727;11852;3102;10454;966;3675;978;2899;1944;6574
353680;201512;682;2222;584;2040;219;854;197;631;416;1485
353690;201512;533;1433;289;937;53;189;73;185;126;374
353700;201512;2136;6529;1820;5879;327;1144;745;2290;1072;3434
353710;201512;3019;7305;1358;4470;320;1080;265;835;585;1915
353715;201512;465;1327;317;1008;29;114;83;237;112;351
353720;201512;2032;6271;1719;5745;339;1316;873;2742;1212;4058
353730;201512;4464;13433;3395;11085;690;2463;984;2891;1674;5354
353740;201512;1893;5572;1415;4595;374;1273;376;1166;750;2439
353750;201512;830;2735;609;2204;124;511;161;572;285;1083
353760;201512;9666;27086;7701;23976;1470;5088;4201;12772;5671;17860
353770;201512;814;2460;450;1541;71;240;29;53;100;293
353780;201512;4318;14628;3667;13280;1211;4665;982;3453;2193;8118
353790;201512;1991;6768;1615;5964;441;1856;316;1137;757;2993
353800;201512;15879;48494;12202;41488;3258;11983;4171;13740;7429;25723
353810;201512;1065;3313;799;2723;166;640;266;856;432;1496
353820;201512;1275;4276;1142;3959;240;989;582;1831;822;2820
353830;201512;717;1892;540;1597;107;345;265;774;372;1119
353850;201512;1672;5200;1453;4756;319;1095;604;1932;923;3027
353860;201512;2469;8158;2028;7128;538;2041;543;1801;1081;3842
353870;201512;27310;78872;18101;60266;3868;14055;5256;15764;9124;29819
353880;201512;2505;7847;2080;7073;302;1231;1108;3672;1410;4903
353890;201512;2771;6746;1867;5262;335;1012;898;2394;1233;3406
353900;201512;1040;3197;741;2561;161;622;208;668;369;1290
353910;201512;1250;4451;1196;4337;337;1274;667;2388;1004;3662
353920;201512;2234;6580;1483;4906;323;1163;253;728;576;1891
353930;201512;4520;13554;2980;10539;774;2944;607;2079;1381;5023
353940;201512;1215;3799;935;3165;156;584;341;1064;497;1648
353950;201512;3414;10715;3021;9944;476;1781;1777;5592;2253;7373
353960;201512;602;1870;453;1528;90;325;101;272;191;597
353970;201512;550;1581;476;1480;48;166;334;1035;382;1201
353980;201512;12755;38197;10813;34358;2444;8304;5194;15909;7638;24213
353990;201512;360;1119;320;1029;55;214;149;446;204;660
354000;201512;2123;6052;1341;4386;260;908;134;379;394;1287
354010;201512;356;1061;295;962;70;231;158;527;228;758
354020;201512;4468;13757;3836;12317;1010;3497;1347;3937;2357;7434
354025;201512;892;2469;636;1983;131;431;199;585;330;1016
354030;201512;512;1405;351;1115;58;211;156;458;214;669
354040;201512;784;2090;546;1632;61;210;283;762;344;972
354050;201512;953;3021;798;2703;217;809;209;650;426;1459
354060;201512;5123;15649;3473;11931;869;3202;962;3100;1831;6302
354070;201512;2887;9465;2402;8330;605;2252;479;1564;1084;3816
354075;201512;1949;7253;1826;6991;470;1990;801;2998;1271;4988
354080;201512;1584;4801;1066;3579;219;758;243;712;462;1470
354085;201512;318;808;282;756;18;63;227;596;245;659
354090;201512;1302;3827;1226;3698;128;425;870;2645;998;3070
354100;201512;14986;49757;12193;44074;3124;12028;5086;17942;8210;29970
354105;201512;900;2731;784;2511;127;462;468;1446;595;1908
354110;201512;751;2067;594;1841;216;750;110;249;326;999
354120;201512;1985;5400;1506;4489;267;877;644;1760;911;2637
354130;201512;6156;17706;4635;14641;1741;5835;626;1618;2367;7453
354140;201512;25884;64872;15264;45271;3235;10281;4770;12934;8005;23215
354150;201512;4026;10770;2997;8867;527;1746;1432;4043;1959;5789
354160;201512;3397;10902;2769;9426;768;2833;1032;3324;1800;6157
354165;201512;380;1369;324;1235;92;396;109;393;201;789
354170;201512;1409;4300;1092;3579;210;778;418;1205;628;1983
354180;201512;478;1392;419;1262;53;196;246;659;299;855
354190;201512;1518;4793;1232;4164;335;1250;394;1239;729;2489
354200;201512;1004;2865;792;2471;119;429;337;961;456;1390
354210;201512;658;2141;563;1958;88;374;288;925;376;1299
354220;201512;2814;8253;2359;7377;538;1821;1038;3137;1576;4958
354230;201512;639;2083;568;1938;109;419;247;806;356;1225
354240;201512;1219;3913;887;3124;163;635;203;652;366;1287
354250;201512;688;1968;455;1546;159;591;118;400;277;991
354260;201512;7986;23338;6536;20826;1836;6293;2101;6563;3937;12856
354270;201512;1150;3878;960;3424;219;877;329;1094;548;1971
354280;201512;680;2049;621;1941;92;354;425;1262;517;1616
354290;201512;986;3324;877;3101;207;819;367;1279;574;2098
354300;201512;3446;11377;3309;11101;888;3072;1560;5146;2448;8218
354310;201512;875;2667;662;2233;145;520;298;992;443;1512
354320;201512;754;2209;617;1946;152;553;199;550;351;1103
354323;201512;415;1168;316;988;73;251;99;271;172;522
354325;201512;1259;4115;1015;3520;199;789;381;1219;580;2008
354330;201512;6664;19959;5363;17309;1109;3994;2521;7592;3630;11586
354340;201512;25226;77489;20135;68107;6166;22536;6934;22509;13100;45045
354350;201512;1089;3186;1002;3018;293;1001;478;1296;771;2297
354360;201512;467;1478;299;1075;45;165;24;90;69;255
354370;201512;1210;4000;1044;3657;132;558;621;2092;753;2650
354380;201512;933;2735;734;2366;220;841;130;320;350;1161
354390;201512;12699;37912;8575;29358;1848;6828;1782;5803;3630;12631
354400;201512;1609;5483;1267;4650;271;1090;366;1267;637;2357
354410;201512;5448;16518;4403;14567;1074;3762;1884;6136;2958;9898
354420;201512;1181;3515;874;2797;207;736;335;977;542;1713
354425;201512;2522;7084;2086;6269;636;2057;486;1372;1122;3429
354430;201512;1299;4188;1179;3934;255;963;509;1635;764;2598
354440;201512;518;1531;383;1246;49;188;170;515;219;703
354450;201512;429;1219;241;805;37;153;47;122;84;275
354460;201512;873;2400;641;1999;185;627;259;787;444;1414
354470;201512;567;1567;434;1286;49;184;218;580;267;764
354480;201512;678;1878;572;1712;97;329;327;939;424;1268
354490;201512;695;2301;508;1841;84;323;161;543;245;866
354500;201512;2112;6913;1815;6368;686;2741;282;869;968;3610
354510;201512;711;2034;637;1902;100;291;404;1235;504;1526
354515;201512;303;998;225;816;44;188;76;238;120;426
354520;201512;7097;22879;4006;13932;814;3203;1567;5036;2381;8239
354530;201512;2888;9928;2553;9179;685;2696;1054;3642;1739;6338
354540;201512;1262;3787;1029;3358;366;1310;157;449;523;1759
354550;201512;455;1364;379;1202;66;231;192;576;258;807
354560;201512;1584;4506;1017;3225;192;591;390;1180;582;1771
354570;201512;825;2407;511;1648;83;276;81;235;164;511
354580;201512;10357;29491;7595;24119;1473;5098;3048;9089;4521;14187
354600;201512;1559;5105;1348;4666;300;1245;653;2107;953;3352
354610;201512;391;1125;227;727;31;86;53;156;84;242
354620;201512;388;1254;302;1103;78;353;134;453;212;806
354625;201512;285;907;202;719;38;140;57;190;95;330
354630;201512;2060;6918;1803;6332;719;2652;287;932;1006;3584
354640;201512;3591;11664;2771;9809;602;2435;611;1911;1213;4346
354650;201512;905;2696;788;2471;100;351;515;1569;615;1920
354660;201512;2484;7179;1886;6099;323;1171;991;3151;1314;4322
354670;201512;1602;5159;1250;4279;321;1200;286;843;607;2043
354680;201512;4468;14547;3970;13488;1084;3965;1638;5411;2722;9376
354690;201512;773;2485;486;1736;92;339;132;448;224;787
354700;201512;1235;3446;811;2533;157;578;334;894;491;1472
354710;201512;547;1624;431;1364;63;225;190;528;253;753
354720;201512;240;627;145;441;50;146;36;107;86;253
354730;201512;7927;25762;6019;21675;1433;5622;2401;8288;3834;13910
354740;201512;246;756;143;512;24;97;30;102;54;199
354750;201512;2403;7233;1804;6119;512;1944;639;2062;1151;4006
354760;201512;1998;6302;1578;5348;461;1676;246;783;707;2459
354765;201512;260;721;137;440;12;48;18;43;30;91
354770;201512;2324;6389;1741;5394;624;2053;477;1388;1101;3441
354780;201512;47754;134222;40295;118255;7188;23682;21560;59324;28748;83006
354790;201512;802;2531;670;2285;124;476;337;1080;461;1556
354800;201512;2009;5893;1759;5542;450;1572;869;2693;1319;4265
354805;201512;969;2899;679;2246;68;233;150;456;218;689
354810;201512;595;1912;361;1314;65;289;70;190;135;479
354820;201512;989;3360;830;3006;180;778;228;720;408;1498
354830;201512;399;1112;301;930;77;253;136;376;213;629
354840;201512;654;1858;522;1615;111;365;252;758;363;1123
354850;201512;16875;51850;12304;42310;2763;10632;4758;14875;7521;25507
354860;201512;1375;4289;1151;3887;242;942;456;1437;698;2379
354870;201512;43650;129642;38536;118753;9309;30578;16453;49655;25762;80233
354880;201512;4191;11555;2309;7497;380;1436;675;1777;1055;3213
354890;201512;16275;47260;13103;41271;3240;10941;4692;14169;7932;25110
354900;201512;453;1337;323;1046;70;243;80;243;150;486
354910;201512;6572;19529;3597;12851;632;2474;222;722;854;3196
354920;201512;435;1265;295;984;61;234;75;237;136;471
354925;201512;348;1007;200;684;29;118;29;78;58;196
354930;201512;217;575;159;476;36;114;75;217;111;331
354940;201512;2034;7122;1567;5880;558;2250;189;631;747;2881
354950;201512;1487;4706;1268;4338;139;589;738;2453;877;3042
354960;201512;766;2380;662;2206;138;526;281;895;419;1421
354970;201512;4048;13063;3473;11864;637;2502;1819;5936;2456;8438
354980;201512;33834;84131;19619;59644;3686;12529;6560;18302;10246;30831
354990;201512;48568;143337;38153;122102;7186;24961;18554;57172;25740;82133
354995;201512;1756;5288;1505;4886;355;1199;766;2471;1121;3670
355000;201512;1463;4652;1263;4282;399;1557;253;720;652;2277
355010;201512;3560;10831;2755;9048;726;2522;973;3202;1699;5724
355020;201512;2720;9057;2056;7623;806;3268;437;1524;1243;4792
355030;201512;1025415;2842186;862529;2516859;200025;633056;375281;1043875;575306;1676931
355040;201512;2639;8010;2305;7425;580;2005;1186;3722;1766;5727
355050;201512;1123;3435;887;2959;292;1003;131;435;423;1438
355060;201512;4876;16231;3868;14018;902;3674;1010;3282;1912;6956
355070;201512;6511;19989;5724;18666;1207;4562;2936;8886;4143;13448
355080;201512;1092;3702;776;2926;135;604;105;297;240;901
355090;201512;1150;3913;938;3431;180;704;378;1356;558;2060
355100;201512;19081;58774;15841;53265;4401;16250;6886;22478;11287;38728
355110;201512;1284;4143;1086;3745;312;1169;283;932;595;2101
355120;201512;603;1907;499;1689;105;435;188;576;293;1011
355130;201512;603;1529;286;837;52;153;100;263;152;416
355140;201512;1114;3671;1045;3551;237;898;556;1909;793;2807
355150;201512;3368;9835;2793;8875;624;2072;1434;4576;2058;6648
355160;201512;1653;5235;1388;4808;462;1800;410;1310;872;3110
355170;201512;9523;26066;6728;21179;2067;6936;1624;5180;3691;12116
355180;201512;2864;8777;2330;7755;603;2392;747;2180;1350;4572
355190;201512;1262;4224;1057;3777;381;1461;352;1197;733;2658
355200;201512;750;2653;685;2511;281;1127;147;481;428;1608
355210;201512;2498;7979;2168;7272;420;1616;1104;3496;1524;5112
355220;201512;32046;97430;25762;84574;8717;30099;6375;19695;15092;49794
355230;201512;1395;3859;746;2408;143;464;177;513;320;977
355240;201512;26597;75940;18103;58296;3913;13524;6086;18572;9999;32096
355250;201512;25003;80285;21377;73204;6109;22392;8272;27581;14381;49973
355255;201512;833;2279;537;1651;97;322;149;414;246;736
355260;201512;1402;3947;1177;3552;276;965;485;1276;761;2241
355270;201512;1589;4611;1485;4458;121;435;1197;3535;1318;3970
355280;201512;24267;70573;19555;61231;3832;13470;8541;25170;12373;38640
355290;201512;880;2760;715;2374;140;501;270;808;410;1309
355300;201512;1112;3600;903;3146;191;725;318;1027;509;1752
355310;201512;995;3006;818;2643;141;492;426;1360;567;1852
355320;201512;609;1858;513;1642;82;323;204;548;286;871
355330;201512;1803;5556;1252;4411;271;1059;477;1600;748;2659
355340;201512;2512;6563;2244;6103;390;1087;1345;3591;1735;4678
355350;201512;1322;4434;1057;3824;267;1073;304;1006;571;2079
355360;201512;1111;3539;997;3299;157;542;666;2255;823;2797
355365;201512;274;797;191;655;41;158;56;182;97;340
355370;201512;7678;18714;5461;15915;1473;4645;2218;6725;3691;11370
355380;201512;3342;10055;2525;8164;582;2066;527;1395;1109;3461
355385;201512;845;2654;774;2540;291;1044;202;571;493;1615
355390;201512;867;2415;646;1964;140;476;260;669;400;1145
355395;201512;1857;5554;1364;4418;217;745;580;1731;797;2476
355400;201512;8815;28817;7482;25985;2263;8516;2203;7247;4466;15763
355410;201512;15872;52170;12604;45293;4041;15788;2511;8926;6552;24714
355420;201512;769;2681;697;2521;226;908;187;649;413;1557
355430;201512;3579;9944;2928;8782;578;1888;1488;4261;2066;6149
355440;201512;927;2856;693;2320;124;436;205;618;329;1054
355450;201512;3717;10552;2031;6701;387;1317;619;1875;1006;3192
355460;201512;641;1726;421;1321;78;300;123;299;201;599
355465;201512;378;1168;309;1030;67;246;79;248;146;494
355470;201512;795;2458;653;2177;149;545;285;898;434;1443
355475;201512;149;528;133;483;32;121;68;241;100;362
355480;201512;3017;10707;2746;10163;708;2761;1273;4694;1981;7455
355490;201512;978;2788;631;2061;119;403;138;420;257;823
355495;201512;700;2317;599;2093;119;450;201;665;320;1115
355500;201512;7867;22442;4877;15835;824;2949;980;2826;1804;5775
355510;201512;2066;5503;1171;3655;172;644;365;997;537;1641
355520;201512;449;1075;236;650;36;123;99;240;135;363
355530;201512;398;945;159;496;18;66;28;71;46;137
355535;201512;672;2045;519;1740;153;586;119;325;272;911
355540;201512;8249;25881;7694;24914;1996;6861;3895;12207;5891;19068
355550;201512;750;2243;634;2060;142;547;291;908;433;1455
355560;201512;1282;3772;810;2689;156;601;123;285;279;886
355570;201512;197;603;130;450;19;74;20;57;39;131
355580;201512;1254;3474;848;2621;161;578;323;964;484;1542
355590;201512;230;593;181;502;27;83;100;264;127;347
355600;201512;1130;3446;929;3025;305;1080;269;815;574;1895
355610;201512;1416;3917;1181;3523;228;772;556;1591;784;2363
355620;201512;4079;12698;3191;10674;564;2161;1429;4414;1993;6575
355630;201512;3250;9260;1940;6525;381;1382;475;1509;856;2891
355635;201512;923;2996;788;2764;98;404;532;1864;630;2268
355640;201512;3058;9696;2182;7765;386;1526;294;922;680;2448
355645;201512;3199;10910;2853;10309;489;1976;1665;5957;2154;7933
355650;201512;6536;19760;5465;17672;911;3413;3162;9572;4073;12985
355660;201512;1223;3823;956;3267;200;825;387;1222;587;2047
355670;201512;2575;7949;1789;6101;342;1375;743;2216;1085;3591
355680;201512;1610;5259;1136;4060;327;1267;217;689;544;1956
355690;201512;421;1312;304;1101;183;714;27;74;210;788
355695;201512;308;943;169;558;12;37;17;33;29;70
355700;201512;5518;18173;4604;16042;1165;4278;1756;5849;2921;10127
355710;201512;10748;26516;6249;18175;1545;4811;1576;4232;3121;9043
355715;201512;286;863;177;609;41;148;38;117;79;265
355720;201512;1529;5043;1240;4358;346;1320;356;1110;702;2430
355730;201512;789;2594;644;2258;206;744;154;533;360;1277
410010;201512;1481;4532;1255;4052;266;937;290;891;556;1828
410020;201512;1204;3902;1035;3527;276;996;409;1361;685;2357
410030;201512;1111;3779;898;3224;212;817;146;508;358;1325
410040;201512;10111;32893;8688;29992;2244;8664;2555;8445;4799;17109
410045;201512;990;2791;667;2144;158;544;157;463;315;1007
410050;201512;2440;6748;1471;4743;376;1284;130;341;506;1625
410060;201512;2226;6833;1940;6281;481;1660;811;2647;1292;4307
410070;201512;1750;4894;1324;4061;406;1371;292;779;698;2150
410080;201512;1382;3923;1094;3392;180;636;490;1394;670;2030
410090;201512;1049;3243;950;3033;240;857;306;943;546;1800
410100;201512;2650;8069;1881;6240;441;1626;203;599;644;2225
410105;201512;398;1228;253;876;49;201;35;97;84;298
410110;201512;2616;7652;2066;6551;343;1206;657;2024;1000;3230
410115;201512;537;1444;412;1197;64;199;145;377;209;576
410120;201512;2432;8307;2235;7939;718;2726;838;2958;1556;5684
410130;201512;1090;3461;985;3202;395;1324;235;716;630;2040
410140;201512;16774;43855;10919;33073;2362;7856;2977;8572;5339;16428
410150;201512;17917;44646;8596;25703;1700;5489;1387;3634;3087;9123
410160;201512;2988;9110;2663;8542;715;2553;932;2971;1647;5524
410165;201512;761;2183;596;1808;139;441;241;670;380;1111
410170;201512;2200;6330;1690;5216;476;1656;312;881;788;2537
410180;201512;10040;31853;8462;28242;2139;7733;3092;9554;5231;17287
410185;201512;569;1564;440;1323;102;311;114;295;216;606
410190;201512;2049;6018;1561;4869;331;1134;284;786;615;1920
410200;201512;3909;10859;2777;8558;613;2109;350;971;963;3080
410210;201512;2577;7588;1858;5988;310;1173;413;1100;723;2273
410220;201512;647;1801;465;1438;81;300;143;410;224;710
410230;201512;1430;4438;1219;4027;309;1174;469;1467;778;2641
410240;201512;4384;13211;3915;12218;1191;4269;798;2254;1989;6523
410250;201512;2596;7165;1781;5466;443;1472;331;926;774;2398
410260;201512;1596;4730;1314;4211;331;1146;489;1506;820;2652
410270;201512;547;1524;404;1224;64;220;150;414;214;634
410275;201512;880;2628;598;2003;86;317;281;930;367;1247
410280;201512;2320;6699;1688;5376;360;1324;481;1419;841;2743
410290;201512;3443;10248;2874;9134;688;2318;1121;3545;1809;5863
410300;201512;699;1957;582;1708;98;314;250;658;348;972
410302;201512;402;1072;248;795;27;89;132;430;159;519
410304;201512;1261;4018;1124;3711;306;1049;436;1482;742;2531
410305;201512;1930;5091;1529;4427;360;1135;803;2305;1163;3440
410310;201512;2247;7208;2001;6744;442;1663;757;2533;1199;4196
410315;201512;634;1837;384;1316;73;258;110;346;183;604
410320;201512;1185;3583;695;2378;94;367;62;186;156;553
410322;201512;550;1606;331;1095;67;230;85;263;152;493
410330;201512;1392;3788;1125;3276;255;792;316;890;571;1682
410335;201512;987;2890;838;2605;165;554;326;964;491;1518
410337;201512;814;2121;585;1681;86;296;222;556;308;852
410340;201512;497;1480;329;1023;46;162;134;363;180;525
410345;201512;1744;4986;1185;3752;271;917;327;971;598;1888
410347;201512;733;1965;481;1480;69;246;143;418;212;664
410350;201512;1006;3019;710;2382;149;552;114;327;263;879
410360;201512;3554;9842;2806;8501;482;1696;1299;3787;1781;5483
410370;201512;12330;35462;8610;26790;1628;5733;2431;6466;4059;12199
410380;201512;1261;3744;1115;3419;149;550;568;1672;717;2222
410390;201512;2679;7734;2027;6418;617;2103;513;1447;1130;3550
410395;201512;890;2915;778;2678;198;776;329;1102;527;1878
410400;201512;4408;13555;3672;12095;807;3022;1361;4258;2168;7280
410405;201512;926;2658;725;2262;165;571;252;777;417;1348
410410;201512;1265;4007;1205;3915;354;1368;479;1438;833;2806
410420;201512;7174;23002;5757;19645;1478;5436;907;2623;2385;8059
410425;201512;3156;9860;2157;7535;375;1389;240;753;615;2142
410430;201512;14688;39339;10421;31232;2152;7071;3102;8805;5254;15876
410440;201512;2936;9226;2589;8538;681;2516;1042;3264;1723;5780
410442;201512;2724;9028;2352;8154;716;2578;661;2290;1377;4868
410445;201512;2317;7603;1987;6961;523;2074;628;2219;1151;4293
410450;201512;2157;6075;1610;4976;448;1452;185;456;633;1908
410460;201512;2056;6010;1588;5045;412;1364;400;1184;812;2548
410465;201512;1975;6556;1624;5772;369;1441;604;1995;973;3436
410470;201512;1665;5334;1321;4531;295;1165;324;1076;619;2241
410480;201512;30083;84829;18742;60064;3968;13558;2534;6882;6502;20440
410490;201512;10803;33777;8160;27978;2008;7663;2038;6306;4046;13969
410500;201512;1550;4824;1241;4132;443;1645;274;855;717;2500
410510;201512;2483;6554;1716;4982;312;944;664;1739;976;2683
410520;201512;3146;10800;2935;10350;876;3310;1119;3928;1995;7238
410530;201512;1664;4536;1195;3547;226;755;371;989;597;1744
410540;201512;3079;8998;2073;6823;443;1514;614;1952;1057;3466
410550;201512;6426;18354;4205;13391;786;2786;621;1719;1407;4505
410560;201512;1242;3680;932;2997;215;808;271;723;486;1531
410570;201512;2677;8431;2370;7873;664;2419;788;2821;1452;5240
410580;201512;22275;67129;17790;57894;4552;16406;4987;14813;9539;31219
410590;201512;1339;4163;780;2604;120;398;156;468;276;866
410600;201512;1855;5382;1469;4609;359;1141;551;1715;910;2856
410610;201512;773;2175;585;1798;82;281;215;634;297;915
410620;201512;1676;5721;1196;4457;327;1321;128;450;455;1771
410630;201512;2519;7361;1757;5642;430;1499;281;736;711;2235
410640;201512;4428;12185;3175;9733;810;2884;535;1490;1345;4374
410645;201512;1138;3925;1076;3829;490;1876;254;898;744;2774
410650;201512;2256;6847;1752;5754;561;1941;273;795;834;2736
410655;201512;850;2435;648;2032;131;476;216;643;347;1119
410657;201512;730;2020;500;1524;89;311;179;467;268;778
410660;201512;2582;7507;1469;4914;321;1156;164;477;485;1633
410670;201512;944;2573;621;1886;120;392;182;484;302;876
410680;201512;2803;9208;2236;7796;663;2230;657;2462;1320;4692
410685;201512;630;1808;548;1668;49;154;386;1188;435;1342
410690;201512;117192;336880;78297;253539;16984;60200;16243;46018;33227;106218
410700;201512;2273;6905;2053;6462;544;1846;842;2513;1386;4359
410710;201512;918;2712;616;2011;138;474;163;453;301;927
410712;201512;818;2456;686;2194;237;812;190;625;427;1437
410715;201512;999;3106;736;2467;139;518;242;726;381;1244
410720;201512;3375;9857;2384;7720;495;1824;551;1596;1046;3420
410725;201512;1060;3002;721;2301;107;335;110;304;217;639
410730;201512;521;1431;414;1248;127;425;104;315;231;740
410740;201512;897;2663;623;2091;100;382;266;882;366;1264
410750;201512;1832;5311;1471;4522;313;1061;473;1359;786;2420
410752;201512;308;857;166;542;37;138;58;162;95;300
410753;201512;433;1258;263;858;35;136;88;253;123;389
410754;201512;1041;3128;890;2864;67;220;579;1944;646;2164
410755;201512;807;2024;620;1725;99;305;330;882;429;1187
410760;201512;2333;7050;2013;6444;548;1934;591;1811;1139;3745
410765;201512;15695;46447;11058;36856;1940;7237;1058;3092;2998;10329
410770;201512;937;2562;672;2033;182;621;128;346;310;967
410773;201512;1301;3739;1098;3418;201;716;627;1889;828;2605
410775;201512;1525;4298;1404;4122;322;1057;576;1620;898;2677
410780;201512;521;1439;355;1118;90;283;122;434;212;717
410785;201512;726;2293;573;1907;196;710;118;375;314;1085
410790;201512;412;1309;348;1147;75;270;55;123;130;393
410800;201512;2861;7085;2136;5842;414;1326;792;1935;1206;3261
410810;201512;334;1025;266;874;54;200;105;344;159;544
410820;201512;866;2574;644;2055;153;542;117;323;270;865
410830;201512;31493;89320;24645;77011;7122;24675;7909;23439;15031;48114
410832;201512;1007;2911;866;2639;100;369;486;1390;586;1759
410840;201512;6722;19693;4119;13848;899;3242;318;829;1217;4071
410845;201512;1266;3699;1056;3256;208;715;438;1283;646;1998
410850;201512;2749;7988;2414;7451;529;1826;1048;3229;1577;5055
410855;201512;608;1656;435;1285;76;245;164;437;240;682
410860;201512;3824;10659;2957;8955;558;1819;1051;3050;1609;4869
410865;201512;1532;5190;1447;5026;372;1417;788;2774;1160;4191
410870;201512;1190;3631;1099;3483;265;905;642;2033;907;2938
410880;201512;4030;12313;3153;10559;654;2418;630;1942;1284;4360
410890;201512;953;3064;730;2583;187;754;74;225;261;979
410895;201512;1104;3823;963;3481;329;1271;220;746;549;2017
410900;201512;890;2444;629;1970;106;383;202;579;308;962
410910;201512;409;1073;298;862;37;119;154;427;191;546
410920;201512;834;2318;649;1985;166;579;227;670;393;1249
410930;201512;1772;5149;1483;4583;359;1321;520;1539;879;2860
410940;201512;20796;66507;17462;60092;5289;19780;4486;15396;9775;35176
410950;201512;1776;5778;1641;5522;264;918;1091;3689;1355;4607
410960;201512;7272;19945;4478;14552;1353;4823;901;2699;2254;7522
410965;201512;1067;3197;885;2840;238;792;369;1150;607;1942
410970;201512;4507;13232;3472;11135;971;3587;654;1956;1625;5543
410975;201512;1628;4648;1272;3948;225;821;468;1375;693;2196
410980;201512;5683;15906;3365;11076;686;2521;593;1815;1279;4336
410990;201512;903;2594;536;1762;169;626;70;157;239;783
411000;201512;478;1440;344;1134;69;260;69;185;138;445
411005;201512;502;1474;300;977;75;268;34;82;109;350
411007;201512;2305;7181;1957;6402;582;2001;583;1843;1165;3844
411010;201512;3912;13269;3421;12097;893;3520;536;1699;1429;5219
411020;201512;2520;7749;2202;7205;695;2551;679;2132;1374;4683
411030;201512;695;1875;483;1441;86;288;129;337;215;625
411040;201512;655;1898;290;963;48;169;66;221;114;390
411050;201512;2114;7266;1856;6671;521;2071;274;856;795;2927
411060;201512;1577;4793;1252;4055;261;955;183;507;444;1462
411065;201512;367;1080;278;896;53;174;95;294;148;468
411070;201512;5774;17212;4299;14102;1183;4262;829;2431;2012;6693
411080;201512;2185;6441;1890;5860;468;1638;456;1272;924;2910
411090;201512;813;1985;561;1590;75;271;128;325;203;596
411095;201512;1460;4148;1073;3315;170;610;290;774;460;1384
411100;201512;1365;3937;970;3103;166;641;158;422;324;1063
411110;201512;576;1683;304;1020;37;137;39;98;76;235
411120;201512;1667;4971;1208;3954;314;1163;383;1148;697;2311
411125;201512;4245;13733;3997;13210;1165;4085;1515;4877;2680;8962
411130;201512;728;2149;540;1722;127;436;153;510;280;946
411140;201512;2122;7364;1791;6561;537;2048;588;2213;1125;4261
411150;201512;4421;12242;3305;9929;745;2454;584;1442;1329;3896
411155;201512;970;2630;719;2128;110;379;330;915;440;1294
411160;201512;221;639;169;535;36;119;35;98;71;217
411170;201512;671;2129;550;1843;132;495;182;571;314;1066
411180;201512;5699;16861;4579;14697;1063;3801;1499;4694;2562;8495
411190;201512;1511;4264;1225;3691;296;1039;325;824;621;1863
411200;201512;4298;12605;3387;10991;848;3093;1105;3381;1953;6474
411210;201512;2048;5856;1576;4932;443;1508;197;541;640;2049
411220;201512;1164;3272;898;2748;227;813;317;829;544;1642
411230;201512;1260;3459;777;2470;185;640;222;635;407;1275
411240;201512;1379;3304;722;2147;144;436;221;598;365;1034
411250;201512;2322;6719;1883;5884;508;1749;504;1518;1012;3267
411260;201512;302;835;200;652;27;95;77;233;104;328
411270;201512;1812;5631;1581;5170;295;1115;711;2194;1006;3309
411275;201512;1375;4056;1116;3459;279;916;255;713;534;1629
411280;201512;1534;4483;1050;3421;195;712;205;588;400;1300
411290;201512;780;2213;584;1776;149;489;179;502;328;991
411295;201512;972;2723;864;2503;163;502;328;976;491;1478
411300;201512;1325;3362;914;2541;98;301;365;939;463;1240
411310;201512;860;2338;663;1998;78;269;219;648;297;917
411320;201512;5595;16120;3997;12898;1033;3513;729;2109;1762;5622
411325;201512;1519;4749;1311;4306;277;984;641;2107;918;3091
411330;201512;3099;9521;2574;8469;838;3080;626;2024;1464;5104
411340;201512;930;2718;579;1866;65;243;214;636;279;879
411342;201512;736;2078;595;1794;164;534;190;506;354;1040
411345;201512;975;2980;859;2755;233;833;368;1146;601;1979
411350;201512;2796;8176;1942;6422;508;1867;212;637;720;2504
411360;201512;564;1413;375;1080;47;168;167;411;214;579
411370;201512;47183;131784;35193;109057;6018;21446;13672;38950;19690;60396
411373;201512;1424;4426;1186;3941;267;993;259;857;526;1850
411375;201512;1120;3055;792;2390;162;496;197;549;359;1045
411380;201512;1280;3441;726;2170;122;381;210;568;332;949
411390;201512;1839;5391;1500;4685;300;1051;489;1394;789;2445
411400;201512;2086;5917;1508;4651;277;942;397;1132;674;2074
411410;201512;2096;6261;1562;4991;346;1259;412;1096;758;2355
411420;201512;4126;11764;2772;8649;440;1551;451;1101;891;2652
411430;201512;3182;9676;2615;8669;699;2559;1145;3695;1844;6254
411435;201512;448;1453;366;1238;85;318;147;464;232;782
411440;201512;2610;8383;2313;7749;744;2624;542;1899;1286;4523
411450;201512;2263;6853;2016;6374;419;1343;1021;3328;1440;4671
411460;201512;3168;9267;1607;5581;295;1125;83;269;378;1394
411470;201512;868;2571;569;1843;81;278;95;257;176;535
411480;201512;4543;13512;3306;11013;874;3233;539;1602;1413;4835
411490;201512;1492;4456;1232;3979;266;952;307;856;573;1808
411500;201512;1876;4990;1295;3928;274;904;346;1016;620;1920
411510;201512;2059;6090;1642;5215;458;1611;296;800;754;2411
411520;201512;26411;71484;15103;47249;2889;9773;3092;8854;5981;18627
411530;201512;1028;2852;699;2236;169;605;113;301;282;906
411535;201512;527;1582;249;903;35;148;25;73;60;221
411540;201512;3088;8261;2202;6482;560;1890;561;1420;1121;3310
411545;201512;972;3216;877;3034;161;599;550;1926;711;2525
411550;201512;802;2163;637;1899;220;719;129;382;349;1101
411560;201512;2468;7252;1741;5543;315;1131;264;678;579;1809
411570;201512;6772;18021;4860;14826;1211;4169;1077;3281;2288;7450
411573;201512;882;2600;822;2495;149;474;493;1512;642;1986
411575;201512;1540;4720;1269;4121;247;851;466;1470;713;2321
411580;201512;4021;11361;2587;8324;378;1427;404;1085;782;2512
411585;201512;710;2282;381;1327;84;307;67;211;151;518
411590;201512;386;1132;326;1030;54;192;142;412;196;604
411600;201512;313;898;216;730;47;184;83;280;130;464
411605;201512;1961;5181;1279;3823;200;689;497;1411;697;2100
411610;201512;2148;5924;1784;5303;353;1165;907;2566;1260;3731
411620;201512;2717;8511;2478;8102;692;2468;1084;3556;1776;6024
411630;201512;476;1231;284;931;55;221;41;116;96;337
411640;201512;496;1459;371;1184;59;198;129;362;188;560
411650;201512;200;643;158;559;33;139;43;134;76;273
411660;201512;834;2277;640;1896;113;363;281;813;394;1176
411670;201512;1234;3394;988;2860;221;706;345;928;566;1634
411680;201512;1451;4367;1289;4070;204;677;804;2617;1008;3294
411690;201512;3312;9664;2567;8209;681;2287;544;1751;1225;4038
411695;201512;804;2599;641;2236;152;580;195;674;347;1254
411700;201512;1777;5105;1216;3918;229;814;227;622;456;1436
411705;201512;2044;6930;1773;6369;397;1421;899;3370;1296;4791
411710;201512;1775;5135;1371;4275;340;1141;279;806;619;1947
411720;201512;858;2420;637;1945;93;303;182;504;275;807
411721;201512;706;2106;589;1876;159;548;72;208;231;756
411722;201512;661;1939;437;1421;81;314;119;316;200;630
411725;201512;1388;4428;856;3033;194;721;163;553;357;1274
411727;201512;1902;5478;1419;4410;332;1125;355;984;687;2109
411729;201512;556;1482;395;1182;122;372;69;179;191;551
411730;201512;5526;15802;4524;13837;1690;5256;1123;3371;2813;8627
411740;201512;653;1856;416;1301;70;237;142;418;212;655
411745;201512;893;2568;713;2196;136;448;235;714;371;1162
411750;201512;4710;13979;3480;11153;759;2681;923;2811;1682;5492
411760;201512;7931;22870;6718;20692;2147;7178;1735;5170;3882;12348
411770;201512;3419;11303;2769;9740;827;3143;508;1685;1335;4828
411780;201512;2645;8312;2485;8061;343;1214;1590;5319;1933;6533
411790;201512;3181;8995;2231;6994;607;2156;546;1604;1153;3760
411800;201512;1239;3525;806;2592;114;413;154;402;268;815
411810;201512;1613;4674;1314;4069;276;931;440;1241;716;2172
411820;201512;14166;45094;11607;39702;4052;14368;2685;9253;6737;23621
411830;201512;501;1327;380;1116;118;391;12;53;130;444
411840;201512;10532;29979;7542;24046;1767;6140;1441;4407;3208;10547
411845;201512;535;1622;328;1077;48;166;60;163;108;329
411850;201512;6645;19898;5292;16976;1315;4545;1325;4155;2640;8700
411860;201512;893;2741;712;2348;172;601;223;699;395;1300
411870;201512;862;2829;580;2039;107;444;113;341;220;785
411880;201512;2271;6489;1810;5648;431;1563;431;1198;862;2761
411885;201512;907;2439;722;2089;135;494;250;632;385;1126
411890;201512;1106;3327;680;2256;107;406;84;208;191;614
411900;201512;978;3083;679;2329;167;586;96;329;263;915
411910;201512;1268;4132;982;3436;282;1070;241;741;523;1811
411915;201512;15671;43048;9654;30625;1893;6495;2037;5802;3930;12297
411920;201512;879;2937;744;2600;188;795;105;270;293;1065
411925;201512;600;1684;387;1269;92;300;93;276;185;576
411930;201512;6032;19458;5179;17715;2225;8137;917;2989;3142;11126
411940;201512;3282;10868;2788;9732;696;2557;630;2087;1326;4644
411950;201512;11584;36631;9587;32593;2381;8683;4123;13733;6504;22416
411960;201512;5318;15751;4833;14837;1107;3777;1976;5901;3083;9678
411965;201512;610;1730;441;1435;81;319;144;476;225;795
411970;201512;757;2090;606;1851;192;639;196;620;388;1259
411980;201512;1653;4969;1397;4438;294;985;468;1486;762;2471
411990;201512;29230;93889;23924;82189;6285;23769;6582;21625;12867;45394
411995;201512;2586;7856;2169;7043;681;2474;518;1524;1199;3998
412000;201512;2261;5846;1750;4955;272;925;853;2148;1125;3073
412010;201512;706;2394;552;2031;97;369;121;420;218;789
412015;201512;658;1948;513;1630;109;362;241;764;350;1126
412020;201512;400;1144;266;842;51;181;95;269;146;450
412030;201512;704;2212;471;1650;73;282;116;380;189;662
412033;201512;753;2197;497;1573;79;278;130;377;209;655
412035;201512;1017;2803;672;2151;149;514;238;736;387;1250
412040;201512;614;1899;472;1570;94;338;136;418;230;756
412050;201512;1687;4866;1254;3984;221;790;283;850;504;1640
412060;201512;6869;23361;6134;21763;1941;7438;1721;5980;3662;13418
412065;201512;890;2626;677;2154;146;520;197;552;343;1072
412070;201512;1344;3600;977;2815;165;511;331;930;496;1441
412080;201512;1323;4079;736;2648;98;399;33;81;131;480
412085;201512;413;1191;129;454;30;114;23;70;53;184
412090;201512;4456;13854;4146;13279;736;2526;2363;7681;3099;10207
412100;201512;1951;5986;1589;5251;453;1650;412;1299;865;2949
412110;201512;1089;3060;709;2241;158;536;159;480;317;1016
412120;201512;1837;6186;1571;5545;413;1626;541;1703;954;3329
412125;201512;703;2201;616;2027;135;496;236;724;371;1220
412130;201512;619;1827;440;1408;110;388;72;207;182;595
412135;201512;506;1408;332;1050;74;250;114;336;188;586
412140;201512;1581;4719;1267;4044;294;994;251;741;545;1735
412150;201512;2784;8054;2382;7238;296;1045;1455;4307;1751;5352
412160;201512;1122;3566;685;2431;172;650;90;271;262;921
412170;201512;4491;13773;3567;11902;951;3457;1247;3901;2198;7358
412175;201512;1378;4608;1170;4128;294;1158;475;1633;769;2791
412180;201512;1683;5163;1224;4239;287;1131;343;1106;630;2237
412190;201512;3200;9071;2369;7556;548;1939;682;2255;1230;4194
412200;201512;2232;7090;1515;5207;304;1129;460;1560;764;2689
412210;201512;727;1975;403;1283;58;206;44;113;102;319
412215;201512;3754;11430;3360;10721;741;2378;1868;6141;2609;8519
412217;201512;1116;3127;981;2888;124;453;644;1758;768;2211
412220;201512;5580;18201;5275;17597;1563;5365;2536;8467;4099;13832
412230;201512;2779;9072;2358;8205;505;1995;699;2241;1204;4236
412240;201512;9584;24703;5308;16419;952;3275;948;2545;1900;5820
412250;201512;1945;5636;1620;4949;425;1399;272;693;697;2092
412260;201512;1359;3706;833;2553;120;419;290;791;410;1210
412265;201512;1051;3189;923;2966;221;812;404;1279;625;2091
412270;201512;836;2626;539;1856;106;405;151;478;257;883
412280;201512;613;1902;436;1509;188;698;37;114;225;812
412290;201512;1033;2961;787;2463;149;505;256;726;405;1231
412300;201512;1895;5692;1544;4970;406;1454;326;977;732;2431
412310;201512;1051;3003;915;2792;130;471;469;1447;599;1918
412320;201512;834;2224;580;1767;108;383;194;578;302;961
412330;201512;1587;4478;1193;3640;207;712;574;1701;781;2413
412340;201512;929;2877;578;1955;77;288;91;262;168;550
412350;201512;2300;7111;1814;5988;381;1349;170;441;551;1790
412360;201512;296;884;183;594;23;89;62;165;85;254
412370;201512;928;2722;688;2262;166;609;154;472;320;1081
412380;201512;1601;5058;1313;4339;315;1111;358;1124;673;2235
412382;201512;686;1921;457;1426;85;278;103;275;188;553
412385;201512;2447;7581;2123;6839;695;2350;464;1429;1159;3779
412390;201512;2167;6140;1938;5754;482;1571;751;2260;1233;3831
412395;201512;854;2404;668;2083;85;292;381;1157;466;1449
412400;201512;950;2974;804;2643;225;793;200;652;425;1445
412402;201512;1935;5726;1525;4848;353;1256;340;939;693;2195
412405;201512;3713;10699;2190;7205;372;1408;200;539;572;1947
412410;201512;4765;14570;3884;12816;1116;4302;730;2172;1846;6474
412420;201512;363;1038;246;769;42;139;86;220;128;359
412430;201512;551;1528;399;1217;63;212;152;430;215;642
412440;201512;3413;10208;2697;8884;605;2196;854;2765;1459;4961
412450;201512;318;1012;232;788;35;108;21;48;56;156
412460;201512;807;2408;608;1976;156;568;123;358;279;926
412470;201512;1854;6313;1568;5542;525;1973;341;1230;866;3203
412480;201512;1326;3843;867;2816;156;526;110;273;266;799
412490;201512;891;2593;740;2273;139;439;217;632;356;1071
412500;201512;1992;5696;1628;4978;315;1078;395;1044;710;2122
412510;201512;2259;7362;1851;6354;523;1933;656;2211;1179;4144
412520;201512;1506;4208;1093;3316;250;806;231;622;481;1428
412530;201512;646;1870;490;1501;101;322;118;315;219;637
412535;201512;672;1963;423;1345;93;315;92;264;185;579
412540;201512;1214;3509;934;2931;137;502;273;842;410;1344
412545;201512;816;2320;600;1814;96;346;195;489;291;835
412550;201512;28398;84813;18495;61969;4511;16051;3391;10598;7902;26649
412555;201512;309;923;204;672;39;139;48;135;87;274
412560;201512;5227;16061;3977;13332;830;3262;990;3069;1820;6331
412570;201512;4436;12949;2953;9620;682;2489;552;1729;1234;4218
412575;201512;877;2673;659;2139;143;527;169;479;312;1006
412580;201512;1262;3468;879;2726;161;517;270;783;431;1300
412590;201512;410;1193;266;867;55;209;75;231;130;440
412600;201512;1462;4377;1094;3546;228;826;318;923;546;1749
412610;201512;734;2166;477;1510;117;404;137;388;254;792
412620;201512;1225;3882;942;3244;222;873;144;416;366;1289
412625;201512;10843;30213;7873;24302;1719;5725;1287;3526;3006;9251
412627;201512;928;2869;635;2179;181;676;61;183;242;859
412630;201512;3325;10462;2651;8943;565;1946;779;2495;1344;4441
412635;201512;479;1417;313;1035;82;268;13;29;95;297
412640;201512;915;2733;582;1919;90;298;52;138;142;436
412650;201512;1831;5363;1498;4694;314;1148;466;1238;780;2386
412660;201512;2898;8347;2182;6818;433;1498;408;1130;841;2628
412665;201512;635;1653;339;1066;88;284;65;197;153;481
412667;201512;1671;4870;1287;4080;320;1096;223;620;543;1716
412670;201512;547;1698;390;1325;98;378;68;193;166;571
412680;201512;1363;4062;834;2833;134;497;198;581;332;1078
412690;201512;768;2321;553;1832;163;568;105;334;268;902
412700;201512;1876;5718;1557;5211;524;1990;408;1303;932;3293
412710;201512;7605;23381;6069;20112;1300;4839;1361;4073;2661;8912
412720;201512;1421;4359;957;3162;161;574;177;470;338;1044
412730;201512;2226;6550;1321;4427;254;931;165;405;419;1336
412740;201512;1461;4572;1077;3704;245;933;189;650;434;1583
412750;201512;3889;11959;3420;11138;530;2071;2026;6391;2556;8462
412760;201512;2302;7400;2154;7132;453;1739;1161;3675;1614;5414
412770;201512;11315;30903;6098;19456;930;3230;1076;2939;2006;6169
412780;201512;1309;4087;1107;3651;260;930;382;1190;642;2120
412785;201512;2352;6685;1731;5400;476;1552;724;2256;1200;3808
412788;201512;1398;4396;1202;3980;273;1048;397;1155;670;2203
412790;201512;1170;3435;854;2767;174;636;182;494;356;1130
412795;201512;940;2622;746;2231;165;516;268;786;433;1302
412796;201512;2784;8495;2515;7938;619;2186;961;2798;1580;4984
412800;201512;3182;9005;2381;7310;414;1424;810;2342;1224;3766
412810;201512;11135;30227;6094;19094;868;3014;1315;3367;2183;6381
412820;201512;7182;20967;5106;16767;1174;4131;1139;3730;2313;7861
412830;201512;352;1081;270;881;43;166;84;240;127;406
412840;201512;1881;5325;1472;4462;273;919;307;842;580;1761
412850;201512;2810;8257;2315;7404;462;1729;845;2521;1307;4250
412853;201512;1647;4682;1429;4237;154;560;778;2131;932;2691
412855;201512;1511;4301;1143;3487;252;854;303;797;555;1651
412860;201512;1219;3479;981;3029;256;884;389;1160;645;2044
412862;201512;768;1973;508;1463;82;259;166;429;248;688
412863;201512;1191;4005;1150;3935;179;677;773;2593;952;3270
412865;201512;705;2124;513;1683;119;409;170;573;289;982
412870;201512;907;2531;710;2188;251;862;119;313;370;1175
412880;201512;977;2760;732;2292;172;581;141;375;313;956
420005;201512;552;1637;338;1130;57;197;126;411;183;608
420010;201512;3145;8954;2554;8107;383;1262;1722;5553;2105;6815
420020;201512;740;2403;386;1437;39;174;30;91;69;265
420030;201512;525;1373;257;855;50;200;42;128;92;328
420040;201512;766;2365;468;1710;96;389;61;148;157;537
420050;201512;694;2026;465;1529;139;485;158;501;297;986
420055;201512;216;653;121;425;21;82;23;69;44;151
420060;201512;250;819;154;572;29;131;30;86;59;217
420070;201512;1437;4485;1067;3574;174;659;446;1466;620;2125
420075;201512;193;533;96;313;20;69;21;59;41;128
420080;201512;604;1885;466;1607;152;565;113;381;265;946
420090;201512;510;1712;345;1327;85;352;58;233;143;585
420100;201512;1235;3840;1102;3653;258;900;607;2013;865;2913
420110;201512;360;1201;313;1089;74;270;122;414;196;684
420120;201512;294;1014;238;883;81;337;45;152;126;489
420125;201512;262;981;235;918;70;288;90;316;160;604
420127;201512;562;1666;214;788;57;220;31;109;88;329
420130;201512;1872;6201;1501;5428;355;1423;398;1258;753;2681
420140;201512;4899;14269;3301;11076;765;2848;547;1592;1312;4440
420150;201512;765;2112;447;1459;90;322;152;453;242;775
420160;201512;293;806;177;571;26;87;51;157;77;244
420165;201512;219;685;127;443;27;104;28;80;55;184
420170;201512;206;614;131;458;44;182;18;40;62;222
420180;201512;427;1296;232;836;41;159;45;153;86;312
420190;201512;480;1387;226;793;37;145;34;98;71;243
420195;201512;1377;3967;1073;3445;264;891;348;1087;612;1978
420200;201512;2989;9499;1801;6705;461;1954;275;889;736;2843
420205;201512;976;3124;831;2875;191;707;417;1454;608;2161
420207;201512;1570;4579;1067;3520;297;1111;229;677;526;1788
420208;201512;579;1615;311;1113;100;385;100;363;200;748
420209;201512;328;1013;201;705;38;151;74;249;112;400
420210;201512;1679;5097;1083;4038;272;1218;323;1122;595;2340
420213;201512;814;2883;764;2755;161;617;442;1603;603;2220
420215;201512;375;1215;249;897;59;237;34;107;93;344
420220;201512;189;638;155;565;35;146;50;143;85;289
420230;201512;4345;12613;3103;10298;628;2487;1303;4071;1931;6558
420240;201512;11607;31302;6864;22204;1093;4318;2861;8054;3954;12372
420243;201512;629;1906;492;1621;94;340;173;543;267;883
420245;201512;1174;3514;779;2667;139;525;231;708;370;1233
420250;201512;598;1876;539;1761;153;607;226;681;379;1288
420253;201512;542;1443;422;1275;70;220;231;723;301;943
420257;201512;343;962;219;730;40;137;104;341;144;478
420260;201512;1286;4010;1053;3570;214;815;440;1462;654;2277
420270;201512;561;1706;176;626;30;120;45;139;75;259
420280;201512;2332;6247;1403;4523;281;1028;494;1459;775;2487
420285;201512;140;423;59;221;8;33;2;9;10;42
420287;201512;556;1641;453;1457;140;455;139;450;279;905
420290;201512;6754;19798;4237;13957;811;2907;1199;3591;2010;6498
420300;201512;6764;20309;4195;14606;913;3462;689;2305;1602;5767
420310;201512;811;2241;723;2100;116;370;500;1405;616;1775
420315;201512;985;3100;755;2624;204;790;273;908;477;1698
420320;201512;4942;15019;3926;13141;1038;3799;1501;4919;2539;8718
420325;201512;277;909;253;848;51;199;103;313;154;512
420330;201512;1046;3555;754;2787;180;758;193;597;373;1355
420340;201512;1496;4549;1074;3558;220;812;148;392;368;1204
420350;201512;1546;4539;1132;3719;287;1010;414;1312;701;2322
420360;201512;3275;9841;2019;7019;441;1733;229;605;670;2338
420370;201512;1972;5465;1518;4636;175;553;1117;3367;1292;3920
420380;201512;5353;16564;3570;12329;857;3240;815;2700;1672;5940
420390;201512;1645;4602;831;2832;150;606;176;458;326;1064
420395;201512;1547;4719;1017;3483;155;611;173;488;328;1099
420400;201512;1348;3855;900;2951;230;884;215;603;445;1487
420410;201512;797;2116;540;1690;124;430;303;923;427;1353
420415;201512;471;1465;334;1131;99;351;94;303;193;654
420417;201512;751;2387;616;2051;109;378;311;1040;420;1418
420419;201512;403;1218;250;896;90;359;32;108;122;467
420420;201512;11236;33474;8695;28371;2839;10332;2157;6242;4996;16574
420425;201512;1345;3633;837;2608;81;320;361;1032;442;1352
420430;201512;3414;10308;2125;7255;459;1721;688;2303;1147;4024
420435;201512;310;911;186;635;42;159;74;234;116;393
420440;201512;994;3040;579;1971;226;827;104;328;330;1155
420445;201512;382;1133;262;840;52;167;112;361;164;528
420450;201512;869;2593;536;1834;117;445;129;376;246;821
420455;201512;2007;5939;1701;5395;309;1194;788;2356;1097;3550
420460;201512;9115;26286;6620;21704;1483;5596;2462;7552;3945;13148
420470;201512;1133;3053;695;2175;155;557;192;536;347;1093
420475;201512;127;371;63;215;17;58;11;32;28;90
420480;201512;4893;14147;3514;11452;1030;3664;630;1960;1660;5624
420490;201512;713;1861;382;1276;99;361;97;296;196;657
420500;201512;1694;5272;1273;4428;384;1510;462;1507;846;3017
420510;201512;112;439;97;408;37;157;36;143;73;300
420515;201512;117;394;94;347;15;67;16;59;31;126
420517;201512;926;2819;782;2550;126;464;409;1272;535;1736
420519;201512;546;1431;373;1118;59;190;109;307;168;497
420520;201512;677;1668;421;1300;88;293;152;392;240;685
420530;201512;1106;3614;803;2877;184;762;202;599;386;1361
420535;201512;256;740;121;434;28;113;5;14;33;127
420540;201512;21483;61029;14853;46618;3670;12593;4054;11066;7724;23659
420543;201512;413;1066;304;885;25;85;195;604;220;689
420545;201512;1626;5065;1271;4274;293;1118;410;1241;703;2359
420550;201512;4264;13403;3079;10778;742;3100;635;1871;1377;4971
420555;201512;406;1227;309;1021;79;285;102;309;181;594
420560;201512;567;1612;433;1370;82;282;205;633;287;915
420570;201512;2142;6800;1619;5567;414;1638;525;1647;939;3285
420580;201512;1393;4286;1090;3744;272;1063;446;1473;718;2536
420590;201512;3356;10076;2123;7150;417;1546;331;931;748;2477
420600;201512;851;2766;766;2585;126;452;417;1456;543;1908
420610;201512;543;1666;298;1098;81;336;73;255;154;591
420620;201512;781;2320;643;2069;191;659;181;566;372;1225
420630;201512;1069;3278;731;2473;160;575;239;720;399;1295
420640;201512;765;2316;354;1312;80;331;26;78;106;409
420650;201512;2592;7464;1546;5216;272;1058;376;1116;648;2174
420660;201512;491;1418;374;1184;69;247;164;499;233;746
420665;201512;731;2027;450;1467;73;253;131;370;204;623
420670;201512;1710;5045;1161;3857;220;862;296;858;516;1720
420675;201512;210;644;142;484;27;98;44;140;71;238
420680;201512;522;1237;296;877;50;167;101;280;151;447
420690;201512;913;3122;635;2331;108;427;144;483;252;910
420700;201512;3369;9757;2485;7924;528;1934;765;2264;1293;4198
420710;201512;609;2002;455;1676;129;541;142;478;271;1019
420720;201512;1737;4934;1342;4396;349;1220;712;2326;1061;3546
420730;201512;3399;10090;2713;8829;679;2435;1036;3196;1715;5631
420740;201512;872;2658;703;2324;219;799;283;861;502;1660
420750;201512;2444;7676;1630;5719;279;1145;494;1503;773;2648
420757;201512;105;257;49;167;7;31;24;81;31;112
420760;201512;375;1146;217;705;39;147;58;152;97;299
420765;201512;589;1823;292;1071;57;243;56;176;113;419
420768;201512;1188;4091;911;3471;315;1247;301;1141;616;2388
420770;201512;682;1954;355;1251;80;333;86;275;166;608
420775;201512;673;2034;386;1314;93;334;74;223;167;557
420780;201512;1608;4806;924;3086;197;688;153;453;350;1141
420785;201512;309;919;219;693;31;107;55;154;86;261
420790;201512;1295;4387;992;3649;287;1170;360;1221;647;2391
420800;201512;858;2421;417;1378;103;377;104;317;207;694
420810;201512;2212;7473;1689;6220;513;2144;375;1223;888;3367
420820;201512;8505;25356;5702;20325;1462;5915;1437;4903;2899;10818
420830;201512;2770;8691;2259;7720;707;2654;773;2551;1480;5205
420840;201512;1099;3219;535;1913;129;526;114;342;243;868
420845;201512;1320;3970;929;3231;256;1044;218;667;474;1711
420850;201512;1656;5174;942;3579;221;968;92;304;313;1272
420860;201512;477;1322;289;955;75;292;98;307;173;599
420870;201512;1168;3222;893;2771;297;1080;256;665;553;1745
420880;201512;1095;3575;806;2817;165;628;154;475;319;1103
420890;201512;12027;30248;5261;16948;887;3148;1300;3490;2187;6638
420895;201512;248;678;129;416;40;126;14;38;54;164
420900;201512;2107;5779;1204;3986;247;958;305;893;552;1851
420910;201512;22817;67708;14586;50442;2868;11165;4110;12970;6978;24135
420915;201512;587;2277;433;1812;94;420;197;764;291;1184
420917;201512;469;1432;214;688;45;176;87;227;132;403
420920;201512;191;534;79;270;14;54;15;49;29;103
420930;201512;19015;54231;14530;46396;3402;12039;5099;15591;8501;27630
420940;201512;3282;9760;2489;8071;659;2408;373;916;1032;3324
420945;201512;210;667;134;487;23;106;36;122;59;228
420950;201512;631;1769;281;1040;41;199;45;135;86;334
420960;201512;998;2803;779;2412;163;566;334;963;497;1529
420970;201512;2562;7954;2091;7072;608;2321;624;1978;1232;4299
420980;201512;475;1367;345;1148;116;427;118;424;234;851
420985;201512;521;1480;244;869;52;225;59;177;111;402
420990;201512;921;2515;504;1713;97;373;123;353;220;726
421000;201512;615;2051;385;1437;81;315;71;219;152;534
421003;201512;726;1970;259;870;29;100;41;86;70;186
421005;201512;192;580;148;505;28;109;81;275;109;384
421010;201512;5854;16632;3976;13127;1020;3784;920;2681;1940;6465
421020;201512;484;1502;362;1266;47;169;194;702;241;871
421030;201512;830;3006;755;2810;218;877;137;490;355;1367
421040;201512;903;2325;570;1786;109;402;278;815;387;1217
421050;201512;1703;4758;977;3205;193;707;229;627;422;1334
421055;201512;223;636;123;391;28;94;31;81;59;175
421060;201512;539;1813;356;1303;77;319;118;410;195;729
421070;201512;753;2382;461;1650;104;425;93;299;197;724
421080;201512;559;1642;469;1500;96;312;291;928;387;1240
421085;201512;584;1528;298;1006;63;238;83;291;146;529
421090;201512;412;1145;214;701;33;120;85;237;118;357
421100;201512;866;2415;464;1505;135;451;75;219;210;670
421105;201512;1523;4621;1232;4100;279;993;452;1525;731;2518
421110;201512;1062;3794;953;3532;337;1348;211;699;548;2047
421120;201512;1459;4570;956;3308;156;642;282;830;438;1472
421125;201512;423;1183;304;967;85;313;97;268;182;581
421130;201512;3371;10861;2777;9752;914;3601;902;3084;1816;6685
421140;201512;355;1030;262;821;48;152;94;266;142;418
421145;201512;607;1899;378;1271;54;198;126;396;180;594
421150;201512;553;1640;390;1348;77;292;156;526;233;818
421160;201512;1274;3535;609;2036;115;430;209;661;324;1091
421165;201512;294;1000;223;788;35;125;107;380;142;505
421170;201512;1411;4092;1116;3597;230;814;639;2029;869;2843
421175;201512;1254;3503;881;2859;202;821;311;862;513;1683
421180;201512;611;1689;312;1053;72;277;68;200;140;477
421185;201512;407;1122;277;870;54;154;132;438;186;592
421187;201512;296;879;216;707;38;132;97;295;135;427
421189;201512;428;1292;366;1166;72;243;129;377;201;620
421190;201512;11980;34221;6941;23609;1469;5458;1211;3716;2680;9174
421200;201512;952;3103;795;2752;182;697;235;725;417;1422
421205;201512;260;781;183;631;39;156;40;110;79;266
421210;201512;1679;5035;1222;3923;309;1045;329;1001;638;2046
421220;201512;2055;6864;1735;6137;504;2002;322;991;826;2993
421223;201512;623;1905;454;1560;115;425;157;507;272;932
421225;201512;1144;3579;938;3153;219;827;331;1085;550;1912
421227;201512;868;2778;761;2603;165;614;447;1492;612;2106
421230;201512;490;1563;429;1444;105;408;205;637;310;1045
421240;201512;458;1470;256;908;37;163;45;135;82;298
421250;201512;1873;5368;1165;4068;322;1225;267;882;589;2107
421260;201512;371;1038;96;351;20;72;24;80;44;152
421265;201512;665;2088;567;1911;127;463;246;806;373;1269
421270;201512;816;2188;398;1319;83;292;88;314;171;606
421280;201512;1638;5074;1285;4475;378;1493;433;1424;811;2917
421290;201512;1601;4204;786;2562;154;539;137;390;291;929
421300;201512;310;938;244;798;70;262;94;285;164;547
421310;201512;275;857;213;703;44;151;79;243;123;394
421315;201512;395;1166;217;779;45;165;18;63;63;228
421320;201512;579;1839;359;1264;55;204;51;121;106;325
421330;201512;585;1887;445;1616;138;577;80;268;218;845
421335;201512;569;1847;446;1597;108;436;89;327;197;763
421340;201512;1793;5114;1430;4523;204;797;841;2601;1045;3398
421350;201512;982;3200;788;2770;158;661;331;1071;489;1732
421360;201512;3176;9038;1954;6621;411;1603;552;1675;963;3278
421370;201512;770;2533;594;2136;169;688;183;615;352;1303
421380;201512;1007;2832;792;2406;144;501;368;1088;512;1589
421390;201512;147;431;75;259;11;34;37;134;48;168
421400;201512;287;947;191;749;48;200;61;216;109;416
421410;201512;324;932;218;714;30;100;107;343;137;443
421415;201512;369;1204;163;591;41;162;34;102;75;264
421420;201512;934;2797;656;2151;130;460;200;584;330;1044
421430;201512;247;766;180;630;32;122;42;146;74;268
421440;201512;888;2515;567;1922;138;533;235;747;373;1280
421450;201512;486;1496;297;1099;67;282;32;122;99;404
421460;201512;638;1721;313;1096;52;220;72;234;124;454
421470;201512;447;1493;347;1261;98;385;113;390;211;775
421480;201512;3033;8589;1777;6190;404;1646;344;985;748;2631
421490;201512;290;880;128;482;31;130;25;80;56;210
421500;201512;2350;7860;1907;6882;613;2512;319;1003;932;3515
421505;201512;379;1255;331;1147;69;258;159;539;228;797
421507;201512;571;1721;356;1236;71;255;112;388;183;643
421510;201512;190;619;161;567;31;146;80;231;111;377
421520;201512;868;2296;551;1638;57;207;243;636;300;843
421530;201512;411;1260;236;864;39;181;73;252;112;433
421535;201512;725;2119;400;1428;72;294;172;561;244;855
421540;201512;372;1016;290;868;55;185;112;305;167;490
421545;201512;937;3018;663;2452;169;714;169;572;338;1286
421550;201512;2004;6352;1654;5701;482;1877;476;1503;958;3380
421555;201512;343;1025;112;404;19;70;16;56;35;126
421560;201512;203;622;80;280;18;68;20;68;38;136
421565;201512;970;2837;850;2653;298;1048;340;1023;638;2071
421567;201512;772;2786;661;2516;331;1312;141;515;472;1827
421568;201512;526;1624;353;1211;79;269;87;305;166;574
421569;201512;234;704;110;402;21;87;23;73;44;160
421570;201512;1382;4157;714;2512;189;737;123;397;312;1134
421575;201512;480;1565;412;1422;70;262;253;868;323;1130
421580;201512;3388;10552;2474;8469;614;2400;634;1859;1248;4259
421590;201512;233;724;184;626;27;90;96;321;123;411
421600;201512;600;1781;442;1439;114;406;92;256;206;662
421605;201512;631;1890;442;1520;82;331;116;350;198;681
421610;201512;1481;3963;1124;3351;172;585;601;1704;773;2289
421620;201512;4761;14263;3132;10798;892;3277;932;3160;1824;6437
421625;201512;399;1114;153;523;26;93;28;93;54;186
421630;201512;2972;8838;1568;5382;379;1449;223;658;602;2107
421635;201512;273;808;143;472;16;65;63;176;79;241
421640;201512;1068;3178;797;2619;161;548;333;1054;494;1602
421650;201512;1962;6350;1501;5289;425;1700;212;616;637;2316
421660;201512;8140;26099;6426;22476;1588;6256;1988;6352;3576;12608
421670;201512;1110;3412;752;2589;220;853;208;669;428;1522
421680;201512;1246;4022;1025;3526;333;1221;202;634;535;1855
421690;201512;1812;5835;1323;4643;285;1108;181;524;466;1632
421700;201512;543;1664;300;1019;45;178;92;232;137;410
421710;201512;241;795;116;417;32;118;34;113;66;231
421715;201512;276;736;145;460;39;139;43;110;82;249
421720;201512;1868;5523;1143;4024;314;1233;216;671;530;1904
421725;201512;109;359;94;322;28;100;23;73;51;173
421730;201512;609;1767;275;952;53;201;56;148;109;349
421740;201512;788;2468;515;1805;113;479;98;256;211;735
421750;201512;958;2590;583;1830;117;399;250;723;367;1122
421755;201512;365;1048;213;669;45;159;69;199;114;358
421760;201512;731;2307;375;1343;79;317;108;354;187;671
421770;201512;3157;9359;2327;7659;643;2251;763;2505;1406;4756
421775;201512;577;1680;384;1316;80;296;104;327;184;623
421780;201512;1362;4463;999;3622;265;1083;345;1154;610;2237
421790;201512;895;2376;490;1681;121;482;145;443;266;925
421795;201512;352;1029;215;684;35;131;61;185;96;316
421800;201512;2728;8141;2012;6742;446;1713;790;2420;1236;4133
421810;201512;649;2035;456;1629;122;470;56;182;178;652
421820;201512;1132;3281;685;2314;125;462;148;433;273;895
421825;201512;1442;4605;1327;4336;194;763;800;2473;994;3236
421830;201512;2522;8531;2248;7969;513;2105;998;3352;1511;5457
421835;201512;151;438;107;373;23;106;63;204;86;310
421840;201512;353;1120;268;925;69;280;87;262;156;542
421850;201512;413;1274;245;860;54;227;57;187;111;414
421860;201512;326;997;203;729;34;127;43;128;77;255
421870;201512;4564;12810;3027;9644;898;3087;509;1532;1407;4619
421875;201512;436;1285;177;648;36;146;23;69;59;215
421880;201512;930;2850;681;2307;148;566;173;532;321;1098
421885;201512;321;1007;252;871;83;325;86;273;169;598
421890;201512;967;3205;805;2871;250;1027;255;838;505;1865
421895;201512;373;1199;326;1113;84;292;168;579;252;871
421900;201512;987;2746;612;1954;166;569;164;448;330;1017
421910;201512;531;1672;357;1274;75;317;78;222;153;539
421915;201512;558;1654;350;1146;69;229;99;285;168;514
421917;201512;603;1743;422;1441;134;533;123;386;257;919
421920;201512;813;2255;526;1855;264;1003;132;424;396;1427
421930;201512;3397;8963;1899;6254;440;1618;330;922;770;2540
421935;201512;721;2340;513;1867;112;479;174;577;286;1056
421940;201512;277;934;135;503;22;94;23;64;45;158
421950;201512;3775;10362;1754;6005;420;1571;243;805;663;2376
421960;201512;226;682;171;562;43;156;39;105;82;261
421970;201512;2324;6539;1434;4622;471;1614;348;997;819;2611
421985;201512;521;1329;274;821;46;179;82;236;128;415
422000;201512;1053;3152;866;2796;225;790;335;1106;560;1896
430003;201512;866;2502;656;2128;176;641;192;582;368;1223
430005;201512;322;967;236;798;48;175;103;325;151;500
430010;201512;2157;5816;1566;4779;397;1281;640;1964;1037;3245
430020;201512;765;1910;629;1721;81;237;415;1103;496;1340
430030;201512;1089;2840;791;2299;261;828;149;386;410;1214
430040;201512;11707;30209;8848;25164;2485;7608;1826;4812;4311;12420
430045;201512;754;2022;578;1663;113;335;273;765;386;1100
430047;201512;300;724;161;478;25;68;68;205;93;273
430050;201512;1243;3333;697;2204;134;451;176;504;310;955
430055;201512;307;829;165;515;27;98;68;194;95;292
430057;201512;74;168;28;77;4;10;6;7;10;17
430060;201512;16553;52680;14106;48216;3944;14306;5853;20174;9797;34480
430063;201512;1017;2963;807;2520;202;664;408;1287;610;1951
430064;201512;1540;4496;1231;3921;309;1002;496;1582;805;2584
430066;201512;170;408;121;328;10;35;68;173;78;208
430070;201512;632;1681;213;674;36;137;50;121;86;258
430080;201512;719;2045;436;1470;88;327;130;381;218;708
430085;201512;857;2234;552;1691;115;391;192;591;307;982
430087;201512;1054;3160;976;3023;150;547;622;1809;772;2356
430090;201512;892;2366;324;1078;37;144;46;160;83;304
430100;201512;910;2390;508;1548;125;418;152;388;277;806
430105;201512;993;2925;659;2280;178;702;208;691;386;1393
430107;201512;270;883;191;659;38;143;53;167;91;310
430110;201512;1941;5493;1566;4881;432;1396;657;1998;1089;3394
430120;201512;1752;5139;1272;4122;266;897;611;1935;877;2832
430130;201512;3910;10116;3339;9266;785;2361;1397;3771;2182;6132
430140;201512;1285;3866;857;2889;242;837;262;861;504;1698
430150;201512;839;2209;547;1652;130;420;146;427;276;847
430155;201512;449;1275;255;856;41;151;85;267;126;418
430160;201512;17071;49322;14917;45607;3222;10787;6780;20623;10002;31410
430163;201512;1976;5768;1582;5038;261;916;781;2469;1042;3385
430165;201512;467;1149;135;444;20;67;29;79;49;146
430170;201512;947;2660;343;1221;50;183;37;113;87;296
430175;201512;948;2936;756;2473;201;613;308;1086;509;1699
430180;201512;903;2439;724;2131;164;540;379;1058;543;1598
430185;201512;685;1716;349;1062;51;166;108;276;159;442
430187;201512;682;1996;511;1622;115;425;187;548;302;973
430190;201512;1774;5201;1517;4699;296;1017;844;2570;1140;3587
430192;201512;199;603;82;263;5;17;21;59;26;76
430195;201512;359;1099;83;283;8;28;4;12;12;40
430200;201512;1534;4838;1274;4275;376;1333;303;982;679;2315
430205;201512;560;1599;422;1348;45;178;302;947;347;1125
430210;201512;6642;17647;3559;11110;647;2190;813;2276;1460;4466
430215;201512;380;1036;250;755;45;138;102;288;147;426
430220;201512;780;1963;284;954;45;178;52;168;97;346
430222;201512;303;888;230;723;37;145;105;303;142;448
430223;201512;351;993;299;917;67;204;174;554;241;758
430225;201512;41;110;21;67;6;17;7;18;13;35
430230;201512;1814;5176;1686;5045;209;484;1437;4484;1646;4968
430235;201512;291;948;224;777;51;199;66;206;117;405
430237;201512;555;1411;397;1138;46;154;245;677;291;831
430240;201512;1020;2657;659;2026;126;462;286;817;412;1279
430245;201512;923;2816;697;2339;183;625;312;1077;495;1702
430250;201512;1287;3609;1094;3267;399;1262;215;616;614;1878
430258;201512;169;470;122;384;10;34;57;185;67;219
430260;201512;844;2371;568;1814;60;199;299;995;359;1194
430265;201512;318;959;240;793;49;154;21;59;70;213
430270;201512;2979;8268;2528;7497;369;1281;1450;4092;1819;5373
430280;201512;4794;12936;3792;11123;949;2851;1596;4693;2545;7544
430290;201512;2466;6435;2251;6136;168;482;1913;5251;2081;5733
430300;201512;9563;27838;7669;24187;1951;6645;3136;10030;5087;16675
430310;201512;6793;20321;5260;17341;1304;4726;1962;5972;3266;10698
430320;201512;879;2540;556;1861;110;315;266;956;376;1271
430330;201512;750;1973;573;1628;160;452;238;629;398;1081
430340;201512;780;1952;425;1387;78;287;203;654;281;941
430350;201512;6365;19402;5299;17097;1866;6236;1653;5203;3519;11439
430355;201512;381;956;141;439;27;90;18;47;45;137
430360;201512;1101;2873;900;2502;176;556;394;995;570;1551
430367;201512;272;711;170;525;50;183;56;154;106;337
430370;201512;541;1525;391;1233;110;383;96;269;206;652
430380;201512;884;2271;459;1478;138;494;128;402;266;896
430390;201512;4256;11999;2778;8929;600;2060;540;1611;1140;3671
430400;201512;1451;3436;986;2694;320;905;334;856;654;1761
430410;201512;701;1855;499;1506;107;349;229;682;336;1031
430420;201512;3934;11218;2990;9133;800;2529;1186;3519;1986;6048
430430;201512;780;2074;467;1488;133;458;119;368;252;826
430435;201512;2094;5591;1538;4573;377;1195;634;1836;1011;3031
430440;201512;4156;12931;3179;10703;696;2478;1446;4990;2142;7468
430450;201512;7885;21731;6080;18198;2057;6503;1384;4092;3441;10595
430460;201512;29818;86931;22097;72750;6086;21963;6589;21073;12675;43036
430461;201512;513;1379;152;490;24;80;31;94;55;174
430462;201512;317;903;231;751;80;290;54;151;134;441
430463;201512;4197;13231;3565;12012;779;2801;1649;5625;2428;8426
430465;201512;646;1727;530;1527;167;522;251;697;418;1219
430466;201512;3693;10128;3222;9368;634;2017;1797;5069;2431;7086
430467;201512;558;1621;470;1461;100;338;196;565;296;903
430468;201512;1470;4064;1250;3727;356;1145;458;1312;814;2457
430469;201512;417;1114;66;236;8;36;10;26;18;62
430470;201512;7851;20796;5325;16393;1566;5214;900;2629;2466;7843
430471;201512;674;2192;587;2004;176;616;148;519;324;1135
430480;201512;1049;2702;489;1541;78;282;128;359;206;641
430485;201512;228;651;105;351;15;54;33;108;48;162
430490;201512;399;1090;245;786;53;187;101;323;154;510
430495;201512;404;1174;248;846;52;197;52;146;104;343
430500;201512;1291;3563;1042;3138;294;992;437;1269;731;2261
430510;201512;21169;61884;16865;53561;5696;19857;4632;13522;10328;33379
430511;201512;412;1263;166;584;22;86;22;58;44;144
430512;201512;1207;3090;1011;2740;256;715;345;978;601;1693
430513;201512;797;2110;475;1428;99;311;183;536;282;847
430515;201512;508;1470;366;1170;58;196;177;579;235;775
430517;201512;1258;3930;1041;3480;216;740;571;1914;787;2654
430520;201512;1666;4584;1133;3470;291;973;357;990;648;1963
430530;201512;1124;3039;526;1692;72;272;129;380;201;652
430535;201512;2266;6813;1682;5606;364;1340;603;1929;967;3269
430537;201512;497;1563;423;1409;50;160;299;1011;349;1171
430540;201512;784;1729;513;1356;95;263;291;761;386;1024
430543;201512;519;1336;454;1269;84;246;318;908;402;1154
430544;201512;698;2188;578;1935;114;407;294;952;408;1359
430545;201512;1332;4199;1133;3949;389;1446;459;1631;848;3077
430550;201512;683;1965;430;1412;90;325;122;389;212;714
430558;201512;87;246;45;147;11;49;11;29;22;78
430560;201512;426;1059;243;738;26;89;79;224;105;313
430570;201512;1183;3016;741;2136;186;634;283;672;469;1306
430580;201512;1329;3360;757;2371;179;610;260;811;439;1421
430583;201512;172;477;53;179;3;15;4;13;7;28
430585;201512;362;932;225;641;59;199;92;222;151;421
430587;201512;218;661;186;600;57;195;55;182;112;377
430590;201512;1312;3658;1223;3513;180;557;826;2332;1006;2889
430593;201512;30;114;27;103;7;35;12;39;19;74
430595;201512;257;697;85;288;10;39;9;23;19;62
430597;201512;353;1019;232;724;26;90;70;184;96;274
430600;201512;2210;5934;1232;3732;235;764;402;1143;637;1907
430605;201512;1390;4141;1077;3498;242;910;427;1376;669;2286
430607;201512;784;1922;566;1586;85;252;349;994;434;1246
430610;201512;8636;22808;6406;19204;1763;5701;1848;5413;3611;11114
430613;201512;282;684;112;333;26;73;23;55;49;128
430620;201512;772;2203;599;1845;167;533;222;651;389;1184
430630;201512;472;1440;226;747;39;128;31;81;70;209
430632;201512;748;2050;395;1216;69;248;155;406;224;654
430635;201512;714;1950;507;1547;108;363;239;713;347;1076
430637;201512;515;1459;447;1321;67;232;272;763;339;995
430640;201512;1781;4687;775;2499;82;273;91;177;173;450
430642;201512;493;1302;297;933;59;199;110;334;169;533
430645;201512;278;660;105;303;18;48;23;70;41;118
430650;201512;1907;6117;1603;5497;334;1166;890;3112;1224;4278
430655;201512;196;507;169;454;28;95;91;200;119;295
430660;201512;5817;16274;4525;13968;1137;3828;1784;5428;2921;9256
430670;201512;503;1448;452;1348;41;125;339;1047;380;1172
430673;201512;746;1762;343;1031;73;223;124;364;197;587
430675;201512;275;796;110;356;17;60;46;146;63;206
430676;201512;3702;10990;3012;9701;818;2844;976;3103;1794;5947
430680;201512;1250;3556;757;2452;137;459;204;572;341;1031
430690;201512;4442;12398;3425;10378;1087;3393;898;2708;1985;6101
430692;201512;301;969;218;797;23;89;140;503;163;592
430693;201512;1399;3851;897;2803;171;623;229;646;400;1269
430695;201512;581;1617;390;1229;82;292;152;433;234;725
430697;201512;495;1380;366;1146;103;325;132;426;235;751
430700;201512;10128;26014;4643;15196;841;3102;286;858;1127;3960
430705;201512;289;871;242;778;81;284;63;182;144;466
430710;201512;1867;4676;1361;3822;301;924;523;1480;824;2404
430720;201512;924;2253;592;1763;141;450;202;587;343;1037
430730;201512;1721;4486;1156;3536;311;948;434;1379;745;2327
430740;201512;592;1632;328;1091;92;326;55;175;147;501
430745;201512;515;1449;233;743;41;149;36;101;77;250
430750;201512;1697;4615;1322;3960;263;881;653;1869;916;2750
430755;201512;580;1521;365;1062;36;122;162;426;198;548
430760;201512;3234;7860;2208;6325;499;1687;875;2531;1374;4218
430770;201512;6890;19705;5223;16551;1018;3505;2612;8168;3630;11673
430780;201512;2541;6712;1452;4576;295;1001;437;1305;732;2306
430781;201512;595;1702;397;1301;85;281;123;386;208;667
430783;201512;543;1334;322;941;58;182;146;392;204;574
430786;201512;79;254;53;188;8;30;17;52;25;82
430790;201512;4833;13080;3224;9811;749;2521;1180;3280;1929;5801
430800;201512;906;2578;599;1870;129;450;198;576;327;1026
430805;201512;547;1492;346;1090;43;132;173;554;216;686
430807;201512;445;1272;296;927;64;231;81;233;145;464
430810;201512;858;2260;369;1178;59;216;75;201;134;417
430820;201512;1348;4086;862;2909;178;642;229;734;407;1376
430825;201512;416;1082;159;478;29;82;39;95;68;177
430830;201512;2079;6218;1900;5939;285;966;1235;3816;1520;4782
430840;201512;983;2970;885;2783;234;758;412;1330;646;2088
430843;201512;103;292;49;157;10;39;16;45;26;84
430845;201512;310;934;247;796;106;363;22;58;128;421
430850;201512;2679;7759;2213;6857;512;1732;874;2614;1386;4346
430860;201512;1039;2799;526;1730;144;547;165;498;309;1045
430865;201512;693;1799;619;1682;217;619;285;742;502;1361
430870;201512;716;1992;384;1258;94;313;71;193;165;506
430880;201512;1308;3662;933;2918;270;900;250;801;520;1701
430885;201512;253;620;146;457;17;56;96;300;113;356
430890;201512;1845;4816;1227;3633;176;637;362;944;538;1581
430900;201512;2983;7796;2432;6840;541;1799;1134;2925;1675;4724
430905;201512;1085;3046;656;2110;153;535;153;462;306;997
430910;201512;1626;4760;1127;3681;261;963;426;1248;687;2211
430912;201512;507;1419;394;1218;54;192;239;723;293;915
430915;201512;577;1807;380;1408;122;481;89;349;211;830
430920;201512;16166;48700;14169;44875;2996;10498;8037;24604;11033;35102
430925;201512;107;255;56;163;15;49;22;60;37;109
430930;201512;9841;27959;6642;21701;1813;6402;1691;5553;3504;11955
430940;201512;1281;3857;727;2471;149;561;133;396;282;957
430950;201512;1123;3070;727;2235;168;580;270;736;438;1316
430955;201512;145;436;68;223;16;58;17;54;33;112
430957;201512;275;891;220;786;50;179;111;416;161;595
430960;201512;1439;3840;1157;3330;279;892;537;1568;816;2460
430965;201512;1531;4351;1293;3940;89;338;1001;2984;1090;3322
430970;201512;544;1508;313;1009;59;205;84;258;143;463
430975;201512;624;2000;470;1627;84;314;223;780;307;1094
430980;201512;461;1157;276;867;67;219;95;282;162;501
430990;201512;632;1987;446;1517;102;367;96;306;198;673
430995;201512;655;1900;518;1613;175;580;171;492;346;1072
431000;201512;1751;4413;819;2510;145;507;89;223;234;730
431010;201512;2752;7658;1580;5251;292;1080;319;899;611;1979
431020;201512;12340;30075;7643;21561;1915;5588;2021;5576;3936;11164
431030;201512;367;1058;167;595;42;171;30;103;72;274
431033;201512;2476;7126;2162;6663;579;1906;1011;3188;1590;5094
431036;201512;211;540;83;283;15;55;18;47;33;102
431040;201512;990;2787;775;2422;169;609;368;1102;537;1711
431041;201512;548;1474;491;1395;165;476;191;565;356;1041
431043;201512;453;1331;272;952;114;441;66;187;180;628
431046;201512;119;332;80;246;10;35;28;79;38;114
431050;201512;1817;4532;1360;3775;306;902;716;1956;1022;2858
431053;201512;646;2039;508;1735;150;557;117;402;267;959
431055;201512;682;1843;632;1758;65;180;468;1311;533;1491
431057;201512;406;1181;243;824;50;175;62;197;112;372
431060;201512;5819;16901;5200;15957;1628;5018;2166;6857;3794;11875
431065;201512;562;1589;416;1290;73;261;179;507;252;768
431070;201512;744;2136;426;1391;91;302;75;209;166;511
431075;201512;299;906;209;713;34;122;59;210;93;332
431080;201512;650;1993;493;1626;89;329;130;397;219;726
431085;201512;901;2414;674;1937;112;344;351;993;463;1337
431087;201512;622;1744;535;1571;67;192;362;1078;429;1270
431090;201512;546;1323;248;752;66;206;54;162;120;368
431100;201512;3838;10548;3016;9088;780;2527;993;2962;1773;5489
431110;201512;1608;4212;1164;3311;269;800;438;1138;707;1938
431112;201512;607;1922;555;1815;145;479;251;802;396;1281
431113;201512;533;1544;408;1289;112;374;119;387;231;761
431115;201512;1443;4117;1245;3774;240;754;713;2171;953;2925
431120;201512;2754;8374;2130;7118;652;2495;669;2006;1321;4501
431123;201512;503;1440;344;1137;69;240;189;635;258;875
431125;201512;1391;4190;1007;3365;306;1009;241;876;547;1885
431127;201512;259;691;53;171;5;11;8;23;13;34
431130;201512;3550;9974;2538;8061;515;1818;860;2658;1375;4476
431140;201512;4791;11802;2504;7785;408;1383;623;1676;1031;3059
431142;201512;494;1453;440;1353;39;125;311;975;350;1100
431150;201512;1176;3471;880;2875;193;706;314;1009;507;1715
431160;201512;1005;2891;833;2546;144;426;404;1330;548;1756
431162;201512;542;1416;242;821;36;154;23;46;59;200
431164;201512;173;474;43;156;7;27;4;16;11;43
431170;201512;794;2167;537;1689;148;500;150;450;298;950
431171;201512;845;2460;709;2188;235;768;198;575;433;1343
431173;201512;495;1421;422;1292;120;391;217;658;337;1049
431175;201512;1092;3023;921;2745;273;862;299;858;572;1720
431177;201512;922;2924;743;2567;236;930;306;1012;542;1942
431179;201512;373;813;88;251;14;46;23;54;37;100
431180;201512;2362;6743;1586;5110;389;1336;367;1051;756;2387
431190;201512;750;1923;362;1150;61;219;80;235;141;454
431198;201512;383;1252;333;1151;132;478;83;298;215;776
431200;201512;396;1104;105;357;16;46;4;12;20;58
431205;201512;308;921;145;490;36;112;44;154;80;266
431210;201512;777;2078;643;1849;185;522;315;936;500;1458
431213;201512;251;755;193;640;37;147;89;283;126;430
431215;201512;337;989;171;581;27;88;12;28;39;116
431217;201512;201;608;150;494;44;151;49;162;93;313
431220;201512;969;2590;572;1748;72;231;260;734;332;965
431225;201512;1384;3822;1086;3287;236;763;522;1531;758;2294
431230;201512;892;2545;648;2042;85;281;330;1011;415;1292
431235;201512;113;319;32;101;6;21;6;14;12;35
431237;201512;519;1510;405;1335;93;368;212;681;305;1049
431238;201512;46;146;37;125;9;35;11;36;20;71
431240;201512;2931;8688;2544;8075;824;2788;818;2583;1642;5371
431242;201512;392;1222;342;1126;99;335;111;381;210;716
431244;201512;421;990;256;709;42;142;129;320;171;462
431245;201512;1177;3055;828;2416;132;408;442;1251;574;1659
431247;201512;203;577;144;454;42;138;30;84;72;222
431250;201512;1595;4982;1361;4630;372;1370;552;1868;924;3238
431260;201512;363;1020;180;627;34;138;56;175;90;313
431261;201512;250;867;216;787;39;184;77;243;116;427
431262;201512;422;1139;188;607;22;88;84;268;106;356
431265;201512;1515;3910;804;2430;155;517;196;470;351;987
431267;201512;178;482;139;414;30;110;80;218;110;328
431270;201512;2815;7033;1830;5417;484;1608;621;1801;1105;3409
431275;201512;227;688;115;425;35;133;12;41;47;174
431280;201512;338;929;132;429;16;59;31;73;47;132
431290;201512;337;1026;244;815;56;220;49;138;105;358
431295;201512;101;271;53;155;3;10;23;60;26;70
431300;201512;396;990;51;197;5;20;0;0;5;20
431301;201512;272;833;120;407;27;97;22;62;49;159
431303;201512;772;2036;433;1324;66;241;137;377;203;618
431306;201512;2410;6237;1521;4616;185;682;487;1279;672;1961
431308;201512;45;153;40;136;23;83;12;39;35;122
431310;201512;822;2426;487;1652;93;320;140;493;233;813
431320;201512;926;2506;474;1547;86;295;109;317;195;612
431330;201512;2881;7062;1307;4139;342;1231;103;273;445;1504
431333;201512;456;1228;193;596;25;89;49;127;74;216
431335;201512;62;187;46;152;14;48;9;19;23;67
431337;201512;2517;7628;1832;6192;434;1548;335;1047;769;2595
431339;201512;664;1793;457;1371;82;258;207;608;289;866
431340;201512;26294;69184;18532;55435;4335;14033;5017;14456;9352;28489
431342;201512;566;1432;442;1222;146;450;217;553;363;1003
431344;201512;362;996;259;813;15;46;194;617;209;663
431346;201512;330;839;136;409;30;92;22;63;52;155
431349;201512;739;2105;489;1505;100;310;151;441;251;751
431350;201512;4140;12057;3358;10591;705;2512;1297;3823;2002;6335
431360;201512;712;1805;460;1372;114;361;144;436;258;797
431365;201512;1311;3817;1103;3464;278;943;542;1718;820;2661
431370;201512;5075;14125;3891;12029;1083;3625;1163;3580;2246;7205
431380;201512;950;2916;865;2718;130;457;531;1620;661;2077
431390;201512;3351;8754;1975;6079;388;1336;553;1503;941;2839
431395;201512;1292;3794;1076;3424;246;859;509;1581;755;2440
431400;201512;341;1069;162;555;36;137;23;62;59;199
431402;201512;1310;3060;736;2041;149;438;349;918;498;1356
431403;201512;277;790;194;640;53;186;35;111;88;297
431405;201512;4267;11735;3366;10394;660;2303;1706;5117;2366;7420
431406;201512;797;2419;580;1942;158;570;262;852;420;1422
431407;201512;595;1689;377;1246;89;296;106;314;195;610
431410;201512;14105;40269;9228;30511;2725;10136;1113;3501;3838;13637
431413;201512;232;572;104;333;8;28;33;100;41;128
431415;201512;765;2109;558;1730;126;456;207;568;333;1024
431417;201512;656;1595;520;1394;73;202;304;822;377;1024
431420;201512;1445;3918;1254;3621;273;824;556;1684;829;2508
431430;201512;544;1407;320;953;67;217;105;259;172;476
431440;201512;23879;66259;19173;58450;5596;18026;6257;19893;11853;37919
431442;201512;152;431;92;281;15;52;13;26;28;78
431445;201512;519;1467;218;695;32;99;80;241;112;340
431446;201512;477;1380;326;1062;77;262;107;337;184;599
431447;201512;707;1989;511;1589;108;345;212;666;320;1011
431449;201512;834;2321;649;1982;72;228;380;1154;452;1382
431450;201512;2244;5530;1937;5065;305;888;1354;3428;1659;4316
431454;201512;65;234;55;208;15;63;22;86;37;149
431455;201512;728;1842;374;1068;103;292;94;246;197;538
431460;201512;3492;9575;2908;8443;774;2276;932;2808;1706;5084
431470;201512;1840;5408;1372;4340;333;1055;461;1461;794;2516
431475;201512;192;562;41;161;6;24;1;3;7;27
431477;201512;756;1960;505;1456;62;202;268;724;330;926
431478;201512;289;747;107;312;17;51;21;47;38;98
431480;201512;3134;8584;2271;6990;589;2002;806;2340;1395;4342
431490;201512;114770;307788;96551;279860;12350;41988;65708;184890;78058;226878
431500;201512;730;1975;550;1630;126;372;265;770;391;1142
431505;201512;511;1226;339;961;22;52;221;643;243;695
431507;201512;364;885;225;615;40;103;131;354;171;457
431510;201512;2107;5681;1580;4665;357;1132;580;1544;937;2676
431513;201512;305;828;142;450;19;62;73;231;92;293
431514;201512;110;292;41;143;4;19;7;22;11;41
431515;201512;750;2141;510;1554;113;389;203;526;316;915
431517;201512;86;266;71;229;14;46;21;57;35;103
431520;201512;509;1396;254;825;45;167;41;119;86;286
431530;201512;4340;10220;3245;8903;1091;3211;948;2719;2039;5930
431531;201512;291;818;186;602;37;119;63;205;100;324
431532;201512;531;1463;441;1264;112;344;173;476;285;820
431535;201512;407;1048;176;536;30;101;58;151;88;252
431540;201512;2142;6975;1867;6556;212;742;1185;4389;1397;5131
431545;201512;320;874;48;167;5;18;8;28;13;46
431550;201512;2336;6785;2046;6257;403;1388;925;2712;1328;4100
431555;201512;742;1856;559;1557;86;242;337;947;423;1189
431560;201512;20374;60428;14184;48089;3566;13433;3272;11451;6838;24884
431570;201512;5622;14976;4696;13588;1322;3909;2043;6019;3365;9928
431575;201512;433;1089;298;862;45;150;78;194;123;344
431580;201512;688;1928;424;1342;89;317;142;407;231;724
431590;201512;1007;2726;606;1885;103;316;219;686;322;1002
431595;201512;490;1382;382;1155;54;163;218;666;272;829
431600;201512;2084;5742;1433;4516;322;1201;366;1033;688;2234
431610;201512;1485;4278;1079;3475;201;670;445;1427;646;2097
431620;201512;467;1380;232;744;59;201;91;263;150;464
431630;201512;1494;3957;941;2798;260;825;303;841;563;1666
431640;201512;6221;17569;5527;16511;1223;4003;3020;8977;4243;12980
431642;201512;532;1428;418;1224;62;204;202;573;264;777
431643;201512;283;715;158;435;25;72;57;134;82;206
431645;201512;1839;5186;1567;4721;304;1000;876;2601;1180;3601
431647;201512;178;507;112;349;22;76;20;50;42;126
431650;201512;321;976;220;766;32;126;52;152;84;278
431660;201512;1215;3375;733;2358;150;528;165;449;315;977
431670;201512;1362;3558;989;2882;220;727;413;1095;633;1822
431673;201512;235;645;122;393;24;81;20;55;44;136
431675;201512;654;1749;183;608;28;94;37;100;65;194
431680;201512;10462;28045;7521;22566;2062;6617;1876;5595;3938;12212
431690;201512;24731;68120;18910;58304;5270;17284;6304;19831;11574;37115
431695;201512;136;410;89;289;20;63;18;44;38;107
431697;201512;462;1309;403;1196;102;305;190;576;292;881
431700;201512;1617;4562;1351;4041;247;776;712;2078;959;2854
431710;201512;13085;37364;10432;32909;3326;11288;2503;8286;5829;19574
431720;201512;7440;20288;5554;16579;1234;4017;1991;5751;3225;9768
431725;201512;20;55;11;33;2;5;4;11;6;16
431730;201512;4006;11614;3098;9946;834;2938;809;2666;1643;5604
431740;201512;5429;15000;4230;12761;1369;4558;752;2005;2121;6563
431750;201512;9689;27027;8195;24560;1897;6175;3808;11499;5705;17674
431755;201512;332;911;70;243;12;41;14;42;26;83
431760;201512;4097;11626;3186;9947;715;2436;1140;3368;1855;5804
431770;201512;2126;5612;1734;4982;330;980;971;2751;1301;3731
431775;201512;217;583;144;437;41;127;19;50;60;177
431780;201512;2488;6664;1836;5416;470;1473;403;1086;873;2559
431790;201512;1283;3917;1063;3487;179;643;610;2012;789;2655
431795;201512;400;1086;239;726;37;121;87;255;124;376
431800;201512;8973;26214;6970;22309;2136;7387;1253;3749;3389;11136
431805;201512;333;803;96;323;15;58;16;50;31;108
431810;201512;3463;9489;2647;7835;504;1611;1138;3274;1642;4885
431820;201512;2718;8372;2315;7575;485;1744;962;3017;1447;4761
431830;201512;11125;27089;8501;23166;2398;7052;3194;8744;5592;15796
431840;201512;2800;8262;2380;7526;603;2058;1031;3269;1634;5327
431842;201512;821;2051;335;1025;46;157;84;212;130;369
431843;201512;359;1032;289;897;39;139;148;443;187;582
431844;201512;280;749;103;330;23;84;23;55;46;139
431845;201512;530;1542;418;1299;34;113;258;806;292;919
431846;201512;381;1146;335;1075;37;142;228;712;265;854
431848;201512;252;671;135;434;16;56;31;90;47;146
431849;201512;454;1109;94;286;19;60;17;38;36;98
431850;201512;5004;14409;4308;13057;1030;3334;1630;4893;2660;8227
431860;201512;806;2086;592;1728;114;370;293;798;407;1168
431861;201512;100;298;51;183;3;11;8;27;11;38
431862;201512;488;1577;388;1375;112;453;99;309;211;762
431870;201512;19487;55007;14918;46818;3716;12642;4850;15045;8566;27687
431880;201512;4463;13097;3451;10957;817;2902;1242;3694;2059;6596
431890;201512;5380;14362;3889;11624;1192;3775;987;2954;2179;6729
431900;201512;1113;3139;724;2329;195;719;289;828;484;1547
431910;201512;1043;2479;459;1326;75;215;142;371;217;586
431912;201512;627;1768;481;1493;141;417;154;507;295;924
431915;201512;1387;3715;1037;3086;238;741;388;1143;626;1884
431920;201512;1354;3734;1177;3453;137;411;851;2476;988;2887
431930;201512;1310;3529;907;2839;237;722;407;1341;644;2063
431935;201512;63;193;50;165;11;44;19;52;30;96
431936;201512;404;1163;294;918;62;200;127;401;189;601
431937;201512;349;904;192;578;48;156;32;82;80;238
431940;201512;2696;7257;1702;5276;400;1321;445;1330;845;2651
431950;201512;1722;5191;1476;4748;273;982;688;2113;961;3095
431960;201512;3082;8827;2661;7989;685;2139;852;2512;1537;4651
431970;201512;507;1364;232;745;35;135;59;166;94;301
431971;201512;111;313;76;245;8;29;29;78;37;107
431973;201512;500;1705;429;1547;63;225;254;959;317;1184
431975;201512;106;250;20;82;6;30;3;9;9;39
431980;201512;1446;4180;1169;3610;276;912;373;1081;649;1993
431990;201512;8026;21963;5885;18265;1068;3812;1880;5405;2948;9217
432000;201512;10628;29259;8178;24932;2550;8168;2673;7975;5223;16143
432010;201512;2345;6518;1881;5670;408;1306;864;2572;1272;3878
432020;201512;2380;5826;1807;5021;270;816;1184;3231;1454;4047
432023;201512;550;1562;353;1132;70;236;104;310;174;546
432026;201512;1272;3821;915;3035;152;489;467;1550;619;2039
432030;201512;420;1214;310;966;60;181;151;459;211;640
432032;201512;603;1556;391;1167;72;222;171;477;243;699
432035;201512;864;2598;767;2415;301;1026;248;776;549;1802
432040;201512;1047;2455;478;1483;95;328;132;376;227;704
432045;201512;246;700;137;471;25;92;48;163;73;255
432050;201512;676;1859;569;1661;95;281;327;985;422;1266
432055;201512;892;2616;693;2222;135;463;374;1169;509;1632
432057;201512;438;1079;327;892;51;137;205;538;256;675
432060;201512;526;1387;197;659;40;150;43;127;83;277
432065;201512;216;614;165;523;40;142;60;177;100;319
432067;201512;1009;3089;723;2453;150;535;349;1188;499;1723
432070;201512;2429;6654;1544;4806;353;1202;337;939;690;2141
432080;201512;3811;10759;3192;9661;1036;3337;1004;2989;2040;6326
432085;201512;324;883;210;693;48;166;94;312;142;478
432090;201512;1541;4362;1181;3622;353;1164;436;1253;789;2417
432100;201512;1360;3902;647;2198;107;369;68;172;175;541
432110;201512;2769;8241;2016;6646;493;1851;256;711;749;2562
432120;201512;5127;14917;4232;13331;1560;5245;1134;3435;2694;8680
432130;201512;2660;7403;2130;6695;739;2583;723;2210;1462;4793
432132;201512;436;1230;203;698;25;98;63;203;88;301
432135;201512;712;2173;672;2095;87;305;495;1509;582;1814
432140;201512;2044;6408;1598;5521;375;1361;666;2390;1041;3751
432143;201512;1445;4164;1195;3734;230;724;565;1836;795;2560
432145;201512;1236;3770;720;2526;131;510;125;396;256;906
432146;201512;211;665;138;487;36;144;32;105;68;249
432147;201512;672;2090;498;1708;133;489;145;501;278;990
432149;201512;370;1042;223;686;50;153;85;264;135;417
432150;201512;3851;10619;2783;8624;622;2162;854;2476;1476;4638
432160;201512;4592;14284;3928;13099;1219;4268;1348;4612;2567;8880
432162;201512;396;951;73;230;11;39;14;35;25;74
432163;201512;405;1070;92;293;6;21;5;15;11;36
432166;201512;727;2120;583;1823;84;305;273;812;357;1117
432170;201512;1085;3365;692;2484;141;519;125;429;266;948
432180;201512;2974;7860;1914;5845;468;1493;453;1335;921;2828
432183;201512;436;1342;340;1138;139;498;64;196;203;694
432185;201512;936;2493;568;1786;113;371;244;767;357;1138
432190;201512;3510;9493;2277;6782;546;1712;654;1795;1200;3507
432195;201512;1243;3341;977;2910;142;446;564;1616;706;2062
432200;201512;3282;9704;2565;8444;644;2316;1094;3613;1738;5929
432210;201512;441;1197;319;993;81;293;128;357;209;650
432215;201512;887;2699;749;2474;146;440;437;1542;583;1982
432218;201512;302;779;199;573;35;102;77;195;112;297
432220;201512;4339;11336;3483;9986;406;1356;2118;5876;2524;7232
432225;201512;73;232;62;212;24;88;20;65;44;153
432230;201512;1099;2932;639;1925;146;484;169;406;315;890
432232;201512;562;1607;433;1356;86;273;165;515;251;788
432234;201512;419;1142;273;808;60;177;86;240;146;417
432235;201512;108;316;38;134;11;44;1;1;12;45
432237;201512;478;1293;432;1220;18;72;321;874;339;946
432240;201512;14287;44709;11889;41395;1988;8117;6866;24478;8854;32595
432250;201512;4978;16722;4443;15623;1491;5733;1373;4789;2864;10522
432252;201512;408;1128;286;926;55;191;154;505;209;696
432253;201512;1345;4222;826;2869;215;824;132;424;347;1248
432254;201512;839;2261;222;724;55;191;31;86;86;277
432255;201512;246;624;130;424;29;99;39;119;68;218
432260;201512;7816;19321;5273;15106;1220;3577;2057;6109;3277;9686
432270;201512;2624;7720;2156;6879;621;2034;767;2514;1388;4548
432280;201512;1393;3785;704;2264;109;374;168;473;277;847
432285;201512;189;600;41;142;8;32;7;18;15;50
432290;201512;577;1691;356;1175;87;302;107;341;194;643
432300;201512;24008;70631;20766;64918;4134;14003;11454;35187;15588;49190
432310;201512;873;2523;693;2220;145;515;366;1135;511;1650
432320;201512;254;643;125;385;27;83;24;59;51;142
432330;201512;334;872;121;400;14;48;9;23;23;71
432335;201512;214;615;89;308;20;69;11;37;31;106
432340;201512;382;919;179;537;32;104;59;167;91;271
432345;201512;694;1900;630;1792;90;325;371;959;461;1284
432350;201512;399;1076;201;661;33;104;57;178;90;282
432360;201512;182;563;39;144;13;54;10;31;23;85
432370;201512;438;1211;340;1016;45;128;213;642;258;770
432375;201512;807;2014;616;1703;84;231;355;987;439;1218
432377;201512;205;665;52;173;10;31;12;26;22;57
432380;201512;910;2981;793;2758;284;1105;305;984;589;2089
500020;201512;2336;6882;1723;5748;377;1501;703;2202;1080;3703
500025;201512;1348;3088;828;2189;94;253;499;1293;593;1546
500060;201512;6921;20318;5436;17798;672;2285;3469;11766;4141;14051
500070;201512;4292;12306;3503;10926;724;2539;1506;4598;2230;7137
500080;201512;1582;4564;1128;3703;307;1123;372;1208;679;2331
500085;201512;2301;5926;1619;4898;185;608;937;2730;1122;3338
500090;201512;2414;6827;1720;5562;360;1199;770;2552;1130;3751
500100;201512;2584;7492;2170;6744;505;1816;921;2685;1426;4501
500110;201512;8740;25244;6831;22231;1127;3985;3420;11669;4547;15654
500124;201512;2060;6555;1755;6045;355;1137;924;3511;1279;4648
500150;201512;1455;3601;990;2821;193;663;409;961;602;1624
500190;201512;4980;12766;3805;11184;732;2311;2055;6129;2787;8440
500200;201512;2534;6296;1872;5121;391;1165;780;1990;1171;3155
500210;201512;4873;14349;4009;12946;911;3127;1866;6057;2777;9184
500215;201512;1621;4897;1244;4118;209;758;476;1504;685;2262
500220;201512;2977;9245;2423;8257;503;1830;974;3390;1477;5220
500230;201512;2831;7067;1977;5708;465;1476;882;2574;1347;4050
500240;201512;4784;14712;3309;11606;539;2039;1093;4034;1632;6073
500260;201512;2783;7066;2022;5871;322;1053;991;2721;1313;3774
500270;201512;123830;314668;75050;228521;18009;59036;16753;49655;34762;108691
500280;201512;1420;3625;1186;3317;103;309;895;2534;998;2843
500290;201512;4428;10113;2543;7302;535;1714;865;2339;1400;4053
500295;201512;2775;8074;1688;5542;295;1070;418;1154;713;2224
500310;201512;815;2100;672;1888;145;484;327;858;472;1342
500315;201512;3179;9777;2608;8852;390;1365;1584;5571;1974;6936
500320;201512;17062;53983;13255;46719;3836;14743;3901;14272;7737;29015
500325;201512;4118;10424;2935;8555;601;1905;1520;4409;2121;6314
500330;201512;6814;17824;4717;13893;919;3004;2090;5980;3009;8984
500345;201512;2235;5782;1711;4952;363;1144;844;2386;1207;3530
500348;201512;2412;6804;2088;6288;146;525;1517;4499;1663;5024
500350;201512;1277;3785;705;2400;102;372;237;833;339;1205
500370;201512;23659;70673;17423;58850;3880;14708;5095;17026;8975;31734
500375;201512;2943;8009;2135;6447;474;1499;583;1687;1057;3186
500380;201512;3083;8529;2424;7339;665;2103;924;2797;1589;4900
500390;201512;603;1337;339;916;54;175;188;457;242;632
500400;201512;1344;4028;966;3117;234;833;243;683;477;1516
500410;201512;2278;6286;1811;5585;479;1637;814;2508;1293;4145
500430;201512;2532;7132;1942;6257;419;1521;811;2661;1230;4182
500440;201512;1551;4041;1024;3120;184;620;467;1360;651;1980
500450;201512;1757;5250;1266;4255;267;998;245;699;512;1697
500460;201512;3757;11118;2763;9128;725;2617;624;1951;1349;4568
500470;201512;3085;8936;2071;6726;532;1928;327;929;859;2857
500480;201512;2222;6747;2039;6508;247;686;1480;5141;1727;5827
500490;201512;991;2705;740;2250;208;737;206;598;414;1335
500500;201512;3775;11550;2891;10155;1135;4554;768;2641;1903;7195
500510;201512;859;2213;538;1638;74;247;223;619;297;866
500515;201512;1897;4993;1545;4522;260;790;873;2762;1133;3552
500520;201512;3158;10667;2786;10044;437;1705;1772;6499;2209;8204
500525;201512;1190;3744;938;3252;179;704;416;1466;595;2170
500540;201512;6326;17228;3533;11812;954;3725;512;1447;1466;5172
500560;201512;4707;15277;4254;14573;548;2078;3000;10317;3548;12395
500568;201512;4212;10439;2835;8340;588;2041;1017;2751;1605;4792
500570;201512;7763;20474;4939;15070;1299;4267;1037;2945;2336;7212
500580;201512;3747;10517;2959;9226;295;946;2067;6529;2362;7475
500600;201512;3956;10349;2492;7565;592;1927;777;2286;1369;4213
500620;201512;7896;22236;5772;18164;1131;3916;2511;7890;3642;11806
500625;201512;791;2305;413;1415;87;324;127;429;214;753
500627;201512;552;1601;417;1357;84;278;112;389;196;667
500630;201512;6231;16754;4376;13569;1100;3789;1347;4013;2447;7802
500635;201512;2798;10242;2244;9354;329;1323;1441;6546;1770;7869
500640;201512;1659;3965;1242;3368;94;300;889;2358;983;2658
500660;201512;19368;54759;14674;47023;4346;15702;4440;13895;8786;29597
500690;201512;2871;8085;2206;7170;964;3307;617;2124;1581;5431
500710;201512;3753;10970;3119;9884;695;2489;1362;4209;2057;6698
500720;201512;6176;16219;3752;11863;1012;3526;905;2699;1917;6225
500730;201512;1003;2751;692;2122;158;547;218;625;376;1172
500740;201512;4112;11148;3310;9641;419;1524;1516;4493;1935;6017
500750;201512;910;2485;769;2276;136;427;418;1223;554;1650
500755;201512;1242;3586;836;2716;179;640;212;557;391;1197
500769;201512;5282;13816;2981;9004;502;1707;672;1674;1174;3381
500770;201512;1743;5033;1244;4095;311;1084;324;1091;635;2175
500780;201512;1151;3282;909;2814;238;791;279;798;517;1589
500790;201512;9543;25994;7773;22968;1393;4724;4241;12113;5634;16837
500793;201512;2374;6691;1771;5610;459;1572;477;1338;936;2910
500795;201512;2491;7285;2096;6728;271;735;1469;5034;1740;5769
500797;201512;872;2331;597;1847;103;343;227;662;330;1005
500800;201512;2865;7639;2186;6667;837;2920;585;1755;1422;4675
500830;201512;19220;51264;12917;39165;2606;8689;4265;12140;6871;20829
500840;201512;1328;3684;894;2793;114;385;379;1115;493;1500
510010;201512;1269;3761;1042;3389;276;906;507;1671;783;2577
510020;201512;3514;9926;2147;7097;497;1781;550;1660;1047;3441
510025;201512;8124;23332;6295;19881;1480;5132;2115;6079;3595;11211
510030;201512;1760;4718;1419;4169;295;972;675;1872;970;2844
510035;201512;860;2412;671;2143;136;445;369;1208;505;1653
510040;201512;1788;4802;1340;4121;215;718;714;2215;929;2933
510050;201512;1892;5434;1320;4326;350;1251;380;1199;730;2450
510060;201512;1647;4649;1202;3790;227;756;488;1491;715;2247
510080;201512;1094;3395;836;2874;251;970;154;455;405;1425
510100;201512;684;1797;473;1366;60;201;216;579;276;780
510120;201512;318;674;198;521;20;56;125;334;145;390
510125;201512;3199;8321;2395;6874;415;1441;993;2597;1408;4038
510130;201512;1887;5068;1498;4416;401;1239;507;1478;908;2717
510140;201512;2940;9310;2321;8334;967;3897;503;1539;1470;5436
510160;201512;1364;4522;1218;4271;162;647;747;2542;909;3189
510170;201512;5441;16125;4404;14308;817;2950;2085;6504;2902;9454
510180;201512;12193;31613;8309;25445;2413;7740;2500;8575;4913;16315
510185;201512;1380;4003;1115;3646;153;474;738;2634;891;3108
510190;201512;2309;6681;1567;5527;345;1323;710;2602;1055;3925
510250;201512;14265;42760;11926;39253;3562;12695;4460;15012;8022;27707
510260;201512;2291;9110;1919;8334;512;2246;848;4204;1360;6450
510263;201512;4325;11411;3046;9252;741;2391;869;2474;1610;4865
510267;201512;5877;16816;4091;12993;932;3214;1143;3396;2075;6610
510268;201512;854;2484;726;2286;150;502;408;1276;558;1778
510269;201512;1017;3111;742;2557;239;849;185;649;424;1498
510270;201512;2693;8647;2250;7734;401;1389;981;3350;1382;4739
510279;201512;1989;6048;1597;5172;430;1502;446;1265;876;2767
510285;201512;1344;3915;1030;3350;279;987;337;1043;616;2030
510300;201512;3362;9750;2768;8888;219;834;2066;6647;2285;7481
510305;201512;1594;4821;1216;4083;304;1121;404;1294;708;2415
510310;201512;853;2535;717;2271;221;757;239;711;460;1468
510320;201512;3501;10024;2705;8517;660;2440;740;2155;1400;4595
510325;201512;5376;16622;4457;15366;1218;4347;2571;9168;3789;13515
510330;201512;2809;8722;2208;7634;567;2171;748;2546;1315;4717
510335;201512;4978;14787;3990;13511;527;1735;2825;10147;3352;11882
510336;201512;612;1826;459;1535;82;302;234;767;316;1069
510337;201512;2189;7080;1721;6136;673;2531;295;1043;968;3574
510340;201512;77551;206573;52660;166849;17424;61098;9814;31914;27238;93012
510343;201512;1145;3252;948;2925;104;341;689;2168;793;2509
510345;201512;1675;4908;1334;4290;348;1198;480;1482;828;2680
510350;201512;3392;9129;2561;7924;639;2093;1143;3660;1782;5753
510360;201512;1819;4451;1159;3632;127;491;803;2455;930;2946
510370;201512;1219;3979;1017;3642;213;772;599;2244;812;3016
510380;201512;571;1697;368;1283;129;487;42;123;171;610
510385;201512;989;3673;727;3069;102;462;335;1527;437;1989
510390;201512;1132;3461;1024;3318;274;720;623;2275;897;2995
510395;201512;758;1859;545;1553;89;291;219;708;308;999
510410;201512;3868;12464;3396;11515;834;2986;1716;5870;2550;8856
510420;201512;2439;6134;1755;4989;195;701;901;2511;1096;3212
510450;201512;644;1676;454;1388;102;354;158;467;260;821
510452;201512;643;2061;460;1639;93;375;219;756;312;1131
510454;201512;859;2672;728;2411;117;421;449;1505;566;1926
510455;201512;984;3001;721;2446;141;546;231;742;372;1288
510460;201512;2298;5983;1738;5179;238;846;987;2785;1225;3631
510480;201512;4620;12104;3179;9431;711;2216;779;2145;1490;4361
510490;201512;1633;5057;1360;4627;295;1120;735;2413;1030;3533
510500;201512;1559;4574;1039;3542;257;1009;400;1285;657;2294
510510;201512;2747;9390;2345;8640;743;2988;761;2728;1504;5716
510515;201512;6388;19169;4566;15109;1010;3706;1064;3255;2074;6961
510517;201512;1718;5081;1375;4416;423;1427;392;1206;815;2633
510520;201512;2171;5020;1548;4228;76;227;1071;3100;1147;3327
510523;201512;1032;3017;899;2797;142;444;598;1910;740;2354
510525;201512;8090;20804;5284;16202;1093;3474;1984;5993;3077;9467
510530;201512;525;1471;434;1339;52;227;267;781;319;1008
510550;201512;2705;8778;2169;7718;609;2336;724;2519;1333;4855
510558;201512;1985;5628;1646;5135;326;1122;828;2637;1154;3759
510560;201512;1684;5119;1075;4032;311;1279;226;836;537;2115
510562;201512;5457;15905;4184;13357;1206;4209;1089;3485;2295;7694
510590;201512;3146;8298;2572;7557;536;1580;1418;4334;1954;5914
510600;201512;1574;4043;1034;3140;190;610;416;1199;606;1809
510610;201512;2926;8348;2391;7528;209;746;1639;5115;1848;5861
510615;201512;2287;6825;1894;6169;546;1893;830;2733;1376;4626
510617;201512;619;1829;507;1632;41;120;403;1347;444;1467
510618;201512;1448;4206;1023;3365;186;713;463;1463;649;2176
510619;201512;845;2317;482;1609;62;226;58;144;120;370
510620;201512;1501;3667;802;2570;206;738;122;353;328;1091
510621;201512;889;3100;785;2874;202;819;247;858;449;1677
510622;201512;3935;11866;2663;9118;712;2634;347;968;1059;3602
510623;201512;3478;9804;2740;8438;714;2408;1034;2977;1748;5385
510624;201512;1443;4289;960;3250;202;786;258;752;460;1538
510625;201512;2225;6247;1667;5289;448;1561;353;1073;801;2634
510626;201512;1566;4162;1006;3363;321;1202;284;942;605;2144
510627;201512;748;2118;481;1544;113;401;98;293;211;694
510628;201512;1646;3999;1142;3323;115;356;807;2350;922;2706
510629;201512;1812;5782;1445;4974;430;1666;450;1455;880;3121
510630;201512;2564;8591;1861;7079;467;1990;359;1336;826;3326
510631;201512;388;1092;343;1023;40;112;260;774;300;886
510637;201512;2741;7940;2341;7289;702;2361;901;2780;1603;5141
510642;201512;4727;15414;4061;14436;1195;4672;1774;6482;2969;11154
510645;201512;984;2214;608;1690;185;500;175;526;360;1026
510650;201512;6303;20839;5643;20038;1422;5286;3430;12638;4852;17924
510665;201512;1460;3882;948;2919;221;704;321;966;542;1670
510670;201512;403;904;213;630;22;87;103;283;125;370
510675;201512;6476;20103;5102;17334;1462;5610;1239;3964;2701;9574
510677;201512;2093;5510;1661;4953;197;590;1225;3828;1422;4418
510680;201512;764;2277;586;1907;129;451;170;488;299;939
510682;201512;2246;6995;1702;5941;456;1840;334;1024;790;2864
510685;201512;957;2544;781;2306;85;293;522;1505;607;1798
510700;201512;4338;11182;2922;9146;630;2064;1428;4569;2058;6633
510704;201512;9494;25015;7640;22067;1504;4814;3854;10804;5358;15618
510706;201512;1976;5800;1365;4854;312;1148;692;2570;1004;3718
510710;201512;3469;9545;2386;7300;567;1813;599;1634;1166;3447
510715;201512;716;1750;454;1280;89;270;159;438;248;708
510718;201512;2327;5752;1516;4802;697;2278;393;1368;1090;3646
510719;201512;445;1013;283;800;29;123;139;363;168;486
510720;201512;1166;2766;881;2386;243;732;379;939;622;1671
510724;201512;782;2309;616;1985;139;505;272;790;411;1295
510726;201512;633;1614;477;1355;96;293;205;528;301;821
510729;201512;752;1865;438;1291;94;301;162;466;256;767
510730;201512;2727;7938;2083;6747;568;2031;608;1849;1176;3880
510735;201512;1086;3559;842;3150;188;795;412;1534;600;2329
510740;201512;1104;2702;796;2241;188;497;412;1218;600;1715
510757;201512;685;2294;559;2035;202;747;171;636;373;1383
510760;201512;30840;79507;20313;61578;5902;19425;4850;14123;10752;33548
510770;201512;4381;11212;3693;10382;373;1018;2445;7595;2818;8613
510774;201512;413;1127;349;1022;70;237;167;510;237;747
510775;201512;740;2130;603;1892;188;652;166;478;354;1130
510776;201512;557;1542;421;1253;94;310;188;541;282;851
510777;201512;1618;4750;1201;4162;171;636;903;3163;1074;3799
510779;201512;659;1951;486;1616;77;264;239;817;316;1081
510780;201512;3670;10925;2993;9831;741;2571;1240;4244;1981;6815
510785;201512;1865;5277;1377;4431;445;1499;311;989;756;2488
510787;201512;2270;6777;1767;5879;671;2390;364;1144;1035;3534
510788;201512;547;1414;388;1178;168;530;89;289;257;819
510790;201512;16077;46239;10487;35314;2281;8818;1291;4094;3572;12912
510792;201512;8101;23912;5342;18404;1121;4332;876;2719;1997;7051
510794;201512;1223;3851;994;3404;339;1282;297;931;636;2213
510795;201512;8563;25350;6136;20670;1620;5978;1357;4637;2977;10615
510800;201512;1653;4587;1310;4075;303;1049;548;1554;851;2603
510805;201512;1952;5374;1527;4722;257;873;938;2865;1195;3738
510810;201512;682;1656;516;1430;149;427;226;595;375;1022
510820;201512;767;1810;513;1424;94;303;198;477;292;780
510830;201512;707;2189;588;1998;155;577;286;1037;441;1614
510835;201512;658;1962;483;1608;117;429;183;559;300;988
510840;201512;49856;121763;38299;106618;9416;27591;17704;50446;27120;78037
510850;201512;1593;4460;1112;3590;329;1171;181;462;510;1633
510860;201512;2584;8175;1855;6677;738;2911;103;315;841;3226
510880;201512;669;2178;566;1997;179;689;223;799;402;1488
510885;201512;636;1776;506;1598;98;349;202;628;300;977
510890;201512;907;2795;736;2522;209;817;306;960;515;1777
510895;201512;1134;3472;949;3108;233;878;369;1128;602;2006
520005;201512;1406;4463;1242;4218;326;1159;599;2092;925;3251
520010;201512;1706;5665;1366;4938;512;2146;256;789;768;2935
520013;201512;3581;9844;2592;7984;594;1914;913;2776;1507;4690
520015;201512;469;1316;368;1159;81;278;139;444;220;722
520017;201512;1091;3215;905;2907;225;809;356;1058;581;1867
520020;201512;443;1131;330;973;77;239;145;413;222;652
520025;201512;25959;80106;24538;78365;2811;9692;19434;61979;22245;71671
520030;201512;4629;14297;3848;12981;787;2921;1836;6222;2623;9143
520050;201512;411;1032;274;805;20;52;181;551;201;603
520055;201512;732;2209;631;1998;113;349;333;1085;446;1434
520060;201512;1399;4293;1179;3843;259;957;445;1379;704;2336
520080;201512;1816;5291;1531;4897;314;990;841;2875;1155;3865
520082;201512;1048;2900;932;2712;144;390;624;1879;768;2269
520085;201512;998;2974;833;2648;197;635;266;819;463;1454
520090;201512;994;2255;710;1896;156;388;368;1063;524;1451
520110;201512;42563;122442;32288;106389;11687;43504;5588;17502;17275;61006
520120;201512;195;520;124;392;28;108;30;93;58;201
520130;201512;3508;9768;3152;9239;788;2542;1518;4453;2306;6995
520140;201512;39305;125686;33263;114036;11288;42471;6512;20930;17800;63401
520145;201512;383;1007;272;811;66;208;102;286;168;494
520150;201512;505;1301;396;1174;57;195;248;725;305;920
520160;201512;914;2461;727;2180;236;732;198;598;434;1330
520170;201512;4274;9807;3311;8711;298;840;2618;6993;2916;7833
520180;201512;2067;6034;1677;5397;347;1298;748;2342;1095;3640
520215;201512;1920;4911;1582;4375;197;572;999;2770;1196;3342
520235;201512;709;1826;518;1541;107;360;210;588;317;948
520250;201512;1515;4393;1116;3691;294;1113;249;756;543;1869
520260;201512;788;1998;518;1483;77;241;210;561;287;802
520280;201512;514;1522;469;1460;163;545;166;579;329;1124
520310;201512;1224;2895;851;2297;238;687;291;825;529;1512
520320;201512;1826;5639;1487;4985;145;512;940;3217;1085;3729
520330;201512;2754;8337;2009;6993;522;1959;335;1067;857;3026
520340;201512;1868;4627;1437;4082;217;542;944;2874;1161;3416
520350;201512;3126;8501;2398;7157;610;2044;971;2727;1581;4771
520355;201512;1077;3561;959;3367;309;1193;363;1213;672;2406
520357;201512;879;2308;729;2067;56;174;524;1484;580;1658
520360;201512;693;1970;590;1803;135;438;260;800;395;1238
520380;201512;1322;3522;854;2616;131;432;371;1106;502;1538
520390;201512;1106;2561;635;1932;176;626;227;610;403;1236
520393;201512;515;1261;401;1094;59;170;241;642;300;812
520396;201512;751;2379;628;2139;77;309;393;1305;470;1614
520400;201512;1726;4861;1447;4466;230;758;913;2789;1143;3547
520410;201512;1483;3616;1105;3089;214;673;621;1707;835;2380
520420;201512;324;904;229;696;45;146;70;190;115;336
520425;201512;1140;3091;941;2744;255;780;456;1325;711;2105
520430;201512;2037;5306;1272;3885;279;932;391;1072;670;2004
520440;201512;3734;9515;2456;7255;735;2367;526;1512;1261;3879
520450;201512;10282;28557;6734;21653;1463;5067;616;1812;2079;6879
520455;201512;680;1995;540;1751;152;531;171;550;323;1081
520460;201512;892;2504;720;2219;130;470;375;1095;505;1565
520465;201512;803;2237;688;2091;110;356;412;1250;522;1606
520470;201512;1754;5611;1560;5301;375;1297;938;3334;1313;4631
520480;201512;979;2808;723;2360;125;446;321;969;446;1415
520485;201512;1248;3918;1071;3620;275;1058;582;1928;857;2986
520490;201512;3906;12187;3098;10905;930;3391;1337;4854;2267;8245
520495;201512;1274;3464;1112;3255;87;267;911;2718;998;2985
520500;201512;1415;3901;1164;3535;310;1020;480;1429;790;2449
520505;201512;834;2281;687;2064;157;476;351;1058;508;1534
520510;201512;9660;26938;6701;22058;1723;6225;2017;6752;3740;12977
520520;201512;1099;3031;856;2671;272;893;269;843;541;1736
520530;201512;1997;6530;1675;5956;582;2069;511;1941;1093;4010
520540;201512;2943;8215;2182;6816;585;1930;484;1471;1069;3401
520545;201512;1136;3380;924;2954;193;663;299;898;492;1561
520547;201512;715;2254;615;2063;212;733;197;619;409;1352
520549;201512;9808;28313;8032;25913;2422;8156;3598;11700;6020;19856
520551;201512;3486;10553;3199;10140;900;3154;1831;5718;2731;8872
520552;201512;791;2354;709;2240;104;360;484;1549;588;1909
520570;201512;551;1552;395;1279;148;518;103;301;251;819
520580;201512;3296;8145;2197;6555;619;2075;885;2559;1504;4634
520590;201512;1433;4008;1101;3428;244;787;257;726;501;1513
520620;201512;7342;22674;6610;21612;1687;5747;3609;11939;5296;17686
520630;201512;770;2004;563;1700;118;359;260;792;378;1151
520640;201512;2852;7870;2308;6948;654;2030;871;2674;1525;4704
520650;201512;851;2266;632;1856;141;455;307;884;448;1339
520660;201512;355;992;274;874;92;328;94;295;186;623
520670;201512;890;2622;803;2498;62;195;664;2085;726;2280
520680;201512;711;1880;565;1672;151;447;235;703;386;1150
520690;201512;372;960;261;798;58;152;116;382;174;534
520710;201512;544;1403;328;964;5;14;201;583;206;597
520725;201512;1651;4163;1219;3470;226;702;717;2014;943;2716
520735;201512;785;2197;558;1752;143;505;171;509;314;1014
520740;201512;1626;4512;1298;4077;236;826;686;2120;922;2946
520750;201512;611;1632;483;1437;98;285;249;777;347;1062
520753;201512;1377;3803;1244;3613;160;453;858;2619;1018;3072
520760;201512;868;2313;750;2151;104;303;530;1575;634;1878
520780;201512;1930;4691;1536;4149;173;448;1024;2771;1197;3219
520790;201512;2822;7290;2225;6434;246;687;1566;4700;1812;5387
520800;201512;15799;45439;13649;42841;2969;8947;8121;27332;11090;36279
520810;201512;1046;2582;830;2321;129;347;590;1751;719;2098
520815;201512;572;1828;426;1519;172;697;16;41;188;738
520830;201512;1549;4094;1270;3796;45;134;1072;3213;1117;3347
520840;201512;1528;4896;1249;4384;440;1700;256;915;696;2615
520850;201512;646;1924;473;1608;113;425;168;546;281;971
520860;201512;6872;19624;4958;16429;1249;4451;1706;5720;2955;10171
520870;201512;112077;295270;74517;231607;20483;70274;17341;50466;37824;120740
520880;201512;7302;20730;5323;17686;1749;6533;745;2317;2494;8850
520890;201512;3836;10734;3073;9458;632;2111;1492;4578;2124;6689
520910;201512;3858;11200;2767;9040;905;3148;520;1626;1425;4774
520915;201512;763;2183;583;1839;127;425;257;789;384;1214
520920;201512;3438;9222;2367;7470;519;1778;826;2679;1345;4457
520929;201512;527;1449;399;1249;83;256;223;721;306;977
520940;201512;1064;3069;873;2786;108;394;609;1920;717;2314
520945;201512;746;1747;585;1470;163;369;271;677;434;1046
520960;201512;988;2896;768;2466;90;301;366;1201;456;1502
520970;201512;3214;9504;2637;8446;650;2290;763;2335;1413;4625
520980;201512;776;2226;693;2108;248;809;314;941;562;1750
520990;201512;2961;9518;2775;9251;473;1648;1861;6438;2334;8086
520993;201512;1027;2630;824;2331;64;196;580;1651;644;1847
520995;201512;2451;6469;2147;6098;386;1032;1434;4203;1820;5235
521000;201512;7002;20973;5769;18746;1586;5746;1755;5344;3341;11090
521010;201512;4077;11747;3121;9941;825;2653;1124;3606;1949;6259
521015;201512;681;1877;574;1704;157;455;264;787;421;1242
521020;201512;3602;10165;2341;7584;650;2247;267;803;917;3050
521030;201512;720;1786;546;1486;105;277;240;680;345;957
521040;201512;5984;16110;5047;14710;1761;5255;1948;5996;3709;11251
521056;201512;890;2684;735;2425;250;866;249;887;499;1753
521060;201512;1324;3484;1055;3074;236;656;474;1457;710;2113
521080;201512;1236;2901;736;2080;89;323;293;674;382;997
521090;201512;2959;7884;2279;6992;697;2236;721;2266;1418;4502
521100;201512;1931;4269;1496;3793;288;666;970;2646;1258;3312
521120;201512;4433;12063;3544;10817;905;2989;1436;4399;2341;7388
521130;201512;1036;2781;780;2294;115;406;450;1283;565;1689
521140;201512;1056;3199;856;2812;235;804;271;894;506;1698
521150;201512;13209;33316;8091;23804;2790;8736;1836;5316;4626;14052
521160;201512;845;1987;514;1414;106;304;222;587;328;891
521170;201512;1225;2924;912;2470;193;556;502;1308;695;1864
521180;201512;6606;21425;5886;20101;1882;6913;1648;5627;3530;12540
521190;201512;9609;27083;6285;20983;1633;5874;1471;4839;3104;10713
521200;201512;772;2036;629;1799;77;244;382;1059;459;1303
521205;201512;584;1660;444;1406;44;152;247;772;291;924
521210;201512;996;2711;641;1994;192;713;154;371;346;1084
521220;201512;4134;10780;3092;9356;867;2872;1239;3728;2106;6600
521225;201512;373;902;301;822;36;88;211;609;247;697
521230;201512;1197;3740;1089;3525;349;1221;534;1678;883;2899
521250;201512;27951;88710;24630;83502;10243;37035;6714;22875;16957;59910
521260;201512;712;1736;581;1543;93;318;360;876;453;1194
521270;201512;1866;5470;1693;5219;145;353;1313;4259;1458;4612
521280;201512;1880;5658;1501;4911;443;1528;419;1324;862;2852
521290;201512;512;1431;385;1234;103;383;161;489;264;872
521295;201512;1213;2994;1016;2728;158;423;721;2022;879;2445
521300;201512;1990;5502;1662;4968;259;741;963;2949;1222;3690
521305;201512;785;2189;628;1934;115;333;349;1116;464;1449
521308;201512;4553;13285;3533;11252;957;3124;1329;4157;2286;7281
521310;201512;7833;22950;5575;18540;1450;5291;1161;3552;2611;8843
521340;201512;280;735;257;700;18;48;207;560;225;608
521350;201512;1944;5324;1611;4809;233;676;1069;3319;1302;3995
521370;201512;971;2843;741;2438;240;854;176;547;416;1401
521375;201512;1275;3792;1050;3365;230;815;471;1408;701;2223
521377;201512;1092;2760;1008;2669;79;146;874;2409;953;2555
521380;201512;5320;15058;3759;12068;660;2266;946;3131;1606;5397
521385;201512;493;1345;438;1274;105;331;237;678;342;1009
521390;201512;908;2450;699;2172;186;675;205;601;391;1276
521400;201512;2132;5920;1924;5660;247;807;1474;4353;1721;5160
521405;201512;1388;3872;1071;3291;293;967;458;1403;751;2370
521410;201512;712;2164;651;2066;233;694;283;983;516;1677
521440;201512;1434;4073;1220;3606;169;555;598;1532;767;2087
521450;201512;4194;13283;3323;11549;1099;4086;618;2030;1717;6116
521460;201512;6643;19159;5518;17227;1399;4704;2572;7905;3971;12609
521470;201512;711;2016;518;1631;113;389;88;262;201;651
521480;201512;414;1224;279;916;60;205;96;303;156;508
521483;201512;2882;7480;2183;6274;563;1627;645;1790;1208;3417
521486;201512;1582;4042;1312;3643;125;339;961;2688;1086;3027
521487;201512;627;1596;429;1263;116;351;81;231;197;582
521490;201512;787;2277;637;2025;58;263;413;1242;471;1505
521500;201512;1372;4298;1028;3525;197;762;292;849;489;1611
521520;201512;900;2123;682;1829;183;504;312;889;495;1393
521523;201512;12852;46591;12072;45150;4251;17311;1487;6285;5738;23596
521525;201512;1075;2761;915;2540;119;394;593;1585;712;1979
521530;201512;1784;5012;1065;3512;249;876;169;518;418;1394
521540;201512;952;2540;630;1972;145;539;212;616;357;1155
521550;201512;1267;3228;915;2537;221;663;436;1163;657;1826
521560;201512;3894;12698;3284;11803;1270;5016;1054;3663;2324;8679
521565;201512;644;1605;537;1475;88;217;349;982;437;1199
521570;201512;4756;13006;3016;9517;690;2426;668;2022;1358;4448
521580;201512;583;1335;378;1044;101;297;113;282;214;579
521590;201512;697;1918;570;1710;172;563;125;360;297;923
521600;201512;541;1444;378;1160;105;342;96;266;201;608
521630;201512;1481;3676;1042;3031;260;891;205;501;465;1392
521640;201512;2037;5207;1558;4543;449;1345;635;1926;1084;3271
521645;201512;615;1794;465;1461;73;249;177;509;250;758
521680;201512;1457;4615;1215;4122;577;2122;191;585;768;2707
521690;201512;581;1684;508;1557;122;436;229;634;351;1070
521710;201512;2806;8394;2274;7388;510;1727;878;2866;1388;4593
521720;201512;1900;5355;1541;4720;334;1033;832;2476;1166;3509
521730;201512;3705;12046;3212;11048;1174;4504;700;2097;1874;6601
521740;201512;3573;9710;2755;8544;756;2547;1173;3840;1929;6387
521760;201512;12952;42004;11323;39131;2873;10832;4777;16557;7650;27389
521770;201512;2754;7932;2192;6871;802;2699;577;1686;1379;4385
521800;201512;7354;21834;6283;20008;1921;6567;2295;7476;4216;14043
521805;201512;899;2036;642;1663;151;354;347;978;498;1332
521810;201512;888;2210;642;1846;146;445;272;810;418;1255
521830;201512;5434;16897;4787;15928;830;3030;3075;10218;3905;13248
521839;201512;734;2006;548;1657;103;334;188;542;291;876
521850;201512;6993;18694;5295;15649;1285;4024;1677;4562;2962;8586
521860;201512;1978;5372;1496;4592;348;1183;442;1302;790;2485
521870;201512;533;1750;429;1511;115;436;121;394;236;830
521878;201512;743;2139;520;1671;88;317;221;662;309;979
521880;201512;25411;64134;16248;49044;4158;13489;5054;15356;9212;28845
521890;201512;3518;10407;2713;8820;792;2773;588;1810;1380;4583
521900;201512;1442;3782;1029;3177;246;807;358;1004;604;1811
521910;201512;975;2636;863;2499;146;447;517;1558;663;2005
521920;201512;329;982;277;885;93;337;69;187;162;524
521925;201512;671;2028;556;1814;108;391;207;627;315;1018
521930;201512;3745;11987;3186;10848;1028;3685;620;2092;1648;5777
521935;201512;631;1798;549;1649;164;490;240;710;404;1200
521940;201512;1038;2848;837;2530;204;667;397;1169;601;1836
521945;201512;676;2145;598;2028;107;357;370;1346;477;1703
521950;201512;632;1679;506;1488;71;222;311;932;382;1154
521960;201512;720;2128;577;1856;116;424;256;792;372;1216
521970;201512;2584;6886;2169;6373;249;696;1641;5017;1890;5713
521971;201512;1110;2902;768;2257;145;437;204;553;349;990
521973;201512;923;2856;752;2528;169;618;286;932;455;1550
521975;201512;12584;34257;11522;32994;2096;6298;7860;22407;9956;28705
521980;201512;1964;5542;1692;5206;261;703;1297;4163;1558;4866
521990;201512;1122;3165;928;2871;101;346;605;1895;706;2241
522000;201512;2345;6355;1685;5512;227;815;960;3248;1187;4063
522005;201512;400;983;267;771;82;224;88;269;170;493
522010;201512;3395;9671;2798;8654;981;3115;627;1963;1608;5078
522015;201512;922;2715;770;2468;173;551;380;1234;553;1785
522020;201512;5225;13494;4078;11781;976;2889;2014;5776;2990;8665
522026;201512;627;1690;452;1481;114;410;157;528;271;938
522028;201512;526;1515;427;1297;70;214;255;774;325;988
522040;201512;2460;5941;1858;5185;414;1186;1073;3013;1487;4199
522045;201512;15216;49374;12361;43347;3597;13813;2312;7831;5909;21644
522050;201512;1211;3346;845;2645;215;720;259;712;474;1432
522060;201512;2714;8039;2104;7093;593;2218;943;3118;1536;5336
522068;201512;1662;5182;1504;4997;152;438;1179;4123;1331;4561
522070;201512;766;2270;681;2132;85;321;472;1476;557;1797
522100;201512;588;1725;511;1609;195;688;202;594;397;1282
522108;201512;896;2714;749;2489;65;267;564;1839;629;2106
522119;201512;1383;4229;1163;3880;273;973;543;1846;816;2819
522130;201512;371;1035;309;965;94;307;180;568;274;875
522140;201512;18163;49835;14428;43371;4180;13485;4226;12008;8406;25493
522145;201512;811;2250;711;2091;284;856;239;744;523;1600
522150;201512;890;2472;762;2260;220;663;281;820;501;1483
522155;201512;814;2290;707;2122;135;362;449;1421;584;1783
522157;201512;701;1921;591;1763;50;177;461;1363;511;1540
522160;201512;6010;16979;4209;13625;1263;4565;440;1292;1703;5857
522170;201512;3068;8537;2446;7470;827;2630;545;1668;1372;4298
522180;201512;340;964;256;811;79;280;73;230;152;510
522185;201512;15448;44201;12754;40673;3366;11306;6795;21850;10161;33156
522190;201512;936;2309;706;1973;109;321;367;1060;476;1381
522200;201512;1700;5407;1394;4747;369;1365;384;1224;753;2589
522205;201512;1437;4031;1150;3561;266;874;536;1618;802;2492
522220;201512;1355;3626;1078;3283;257;756;545;1822;802;2578
522230;201512;1241;3461;1044;3150;122;425;654;1957;776;2382
530010;201512;233888;727450;204148;673069;55529;202648;68429;218217;123958;420865
110001;201511;3852;12115;3165;11020;729;2684;1586;5525;2315;8209
110002;201511;13280;39329;10472;34246;3109;11053;3572;11333;6681;22386
110003;201511;801;2539;707;2367;199;700;180;559;379;1259
110004;201511;10187;31946;8223;27841;2604;9513;1782;5941;4386;15454
110005;201511;1859;5864;1611;5390;533;1837;654;2168;1187;4005
110006;201511;2034;6126;1363;4795;401;1544;218;626;619;2170
110007;201511;1365;4145;1271;3998;356;1217;530;1853;886;3070
110008;201511;2413;8109;2257;7886;391;1282;1599;5850;1990;7132
110009;201511;4659;13971;3702;12416;1063;3931;1285;4154;2348;8085
110010;201511;7687;22558;6684;21243;1774;5494;3431;11941;5205;17435
110011;201511;8099;24652;6793;22123;2238;7727;2360;7504;4598;15231
110012;201511;14336;42852;11836;38217;3620;12252;3556;11477;7176;23729
110013;201511;5486;17108;4507;15412;1675;5924;1309;4631;2984;10555
110014;201511;4223;12278;3601;11277;897;2923;1901;5959;2798;8882
110015;201511;5057;15006;3658;12350;1078;3987;864;2797;1942;6784
110018;201511;4315;12006;3214;10430;842;3090;1245;3800;2087;6890
110020;201511;60455;167809;45377;146782;10202;34885;21556;71392;31758;106277
110025;201511;4395;12626;3569;11091;645;2112;2157;6638;2802;8750
110026;201511;654;2011;603;1935;142;461;348;1131;490;1592
110028;201511;7565;21601;5333;17520;1422;5116;813;2482;2235;7598
110029;201511;1356;3996;1132;3608;336;1106;452;1461;788;2567
110030;201511;10660;28707;8009;24980;2085;7138;3343;10484;5428;17622
110032;201511;4056;12708;3501;11571;1101;3763;1134;3671;2235;7434
110033;201511;5355;16953;4803;15993;1537;5123;1873;6537;3410;11660
110034;201511;3432;9174;2903;8485;744;2211;1758;5113;2502;7324
110037;201511;2047;6800;1708;6118;445;1703;756;2653;1201;4356
110040;201511;3516;10980;3016;10039;895;3211;1208;3853;2103;7064
110045;201511;5180;16716;4458;15771;1410;5421;2180;7674;3590;13095
110050;201511;1708;5445;1443;4969;433;1563;675;2318;1108;3881
110060;201511;830;2711;680;2408;243;967;158;507;401;1474
110070;201511;2023;6695;1885;6403;548;2051;880;2857;1428;4908
110080;201511;4088;11447;3621;10905;557;1605;2660;8331;3217;9936
110090;201511;774;2280;612;1982;145;537;270;811;415;1348
110092;201511;1334;4412;1232;4276;197;740;810;2869;1007;3609
110094;201511;3577;10742;3141;10127;1040;3573;1331;4247;2371;7820
110100;201511;2244;7051;2006;6608;659;2293;888;2870;1547;5163
110110;201511;1664;5261;1498;5035;608;2084;436;1510;1044;3594
110120;201511;1830;5825;1409;4887;433;1568;300;1010;733;2578
110130;201511;2555;7304;1876;6100;600;2071;414;1283;1014;3354
110140;201511;2456;8072;2081;7324;556;2126;778;2630;1334;4756
110143;201511;1289;4023;993;3511;296;1083;432;1538;728;2621
110145;201511;1031;2946;825;2602;209;728;422;1290;631;2018
110146;201511;422;1297;364;1208;72;241;205;704;277;945
110147;201511;781;2236;612;1938;159;529;227;647;386;1176
110148;201511;1267;3795;916;3035;262;925;163;489;425;1414
110149;201511;3357;10060;2700;8949;872;2902;1159;3977;2031;6879
110150;201511;2481;7211;2089;6611;568;1913;797;2539;1365;4452
110155;201511;853;2618;755;2379;191;646;349;1041;540;1687
110160;201511;2008;6300;1647;5604;583;2044;573;1924;1156;3968
110170;201511;2990;8319;2145;6749;476;1559;1076;3327;1552;4886
110175;201511;1735;5126;1313;4571;226;835;718;2601;944;3436
110180;201511;1408;4101;1166;3730;271;865;675;2199;946;3064
120001;201511;2788;9613;2579;9257;533;2047;1560;5707;2093;7754
120005;201511;1540;6398;1445;6210;163;780;1074;4751;1237;5531
120010;201511;4564;15646;4312;15250;636;2237;3174;11526;3810;13763
120013;201511;1779;7074;1697;6948;400;1604;1015;4394;1415;5998
120017;201511;2025;7261;1873;6984;521;1994;853;3472;1374;5466
120020;201511;14057;62403;13546;61361;2152;9957;9500;44440;11652;54397
120025;201511;2507;8649;2403;8485;468;1774;1536;5458;2004;7232
120030;201511;6081;23901;5939;23740;267;1201;5344;21494;5611;22695
120032;201511;1455;6988;1391;6833;179;1060;1001;4919;1180;5979
120033;201511;3535;14090;3452;13937;326;1318;2964;12167;3290;13485
120034;201511;2012;8355;1931;8204;158;873;1578;6598;1736;7471
120035;201511;2975;13733;2909;13598;239;1264;2454;11569;2693;12833
120038;201511;2712;9799;2572;9519;663;2501;1355;5145;2018;7646
120039;201511;1637;8278;1590;8170;176;1019;1215;6314;1391;7333
120040;201511;45044;160223;40673;151579;10066;40494;19805;74711;29871;115205
120042;201511;2870;12360;2711;11988;382;1845;1906;8562;2288;10407
120043;201511;893;4242;861;4186;72;338;695;3506;767;3844
120045;201511;4254;14500;4157;14377;593;2152;3322;11561;3915;13713
120050;201511;7934;32853;7556;32017;1244;5526;5012;21975;6256;27501
120060;201511;7358;33333;7196;33009;699;3739;5739;26495;6438;30234
120070;201511;2656;9978;2576;9795;448;1664;1680;6620;2128;8284
120080;201511;3543;13384;3340;13041;655;2678;2254;8976;2909;11654
130002;201511;3036;12566;2850;12255;201;1038;2386;10254;2587;11292
130006;201511;1960;8296;1717;7839;251;1284;1192;5485;1443;6769
130008;201511;2108;8406;1985;8177;212;903;1538;6432;1750;7335
130010;201511;2935;9721;2549;9271;214;842;2171;7937;2385;8779
130014;201511;3216;10477;2830;9855;483;1816;1797;6289;2280;8105
130020;201511;2693;9816;2611;9665;66;335;2287;8357;2353;8692
130030;201511;7313;27647;7016;27299;543;1880;6038;24203;6581;26083
130040;201511;3836;11727;3419;11173;291;1023;2764;9164;3055;10187
130050;201511;6162;24813;5665;24066;485;2049;4521;19986;5006;22035
130060;201511;5602;26276;5339;25810;540;3122;4154;20004;4694;23126
130063;201511;3599;15986;3523;15889;330;1585;2959;13505;3289;15090
130068;201511;3104;13017;2796;12361;378;1795;1818;8127;2196;9922
130070;201511;6787;21801;5984;20815;667;2337;4567;16268;5234;18605
130080;201511;5041;22561;4799;22166;797;3946;3288;15507;4085;19453
130083;201511;2128;8477;2002;8283;312;1451;1353;5600;1665;7051
130090;201511;2584;9341;2491;9195;126;600;2176;7976;2302;8576
130100;201511;5622;20893;5460;20682;188;815;5077;19258;5265;20073
130110;201511;6575;21286;6166;20773;760;2378;4860;16917;5620;19295
130115;201511;4378;15477;4099;15040;203;803;3560;13110;3763;13913
130120;201511;14256;54341;13437;53295;1490;5983;10779;43781;12269;49764
130130;201511;3745;15472;3676;15335;267;1322;3112;12987;3379;14309
130140;201511;6257;24231;6153;24113;198;831;5765;22618;5963;23449
130150;201511;3371;13216;3294;13120;191;1033;2901;11360;3092;12393
130160;201511;4157;17302;4016;17100;521;2605;3223;13558;3744;16163
130165;201511;2849;11770;2714;11534;297;1395;2098;8988;2395;10383
130170;201511;9007;32533;7914;31123;1138;4762;5745;23030;6883;27792
130180;201511;3488;11376;3393;11246;156;355;3113;10518;3269;10873
130185;201511;11233;35914;10072;34576;924;2929;8241;29465;9165;32394
130190;201511;17154;58668;14992;55816;2796;10460;9713;37654;12509;48114
130195;201511;1941;8099;1868;7992;125;558;1626;7049;1751;7607
130200;201511;2000;7123;1824;6840;458;1710;1093;4213;1551;5923
130210;201511;1210;4765;1142;4673;119;587;933;3792;1052;4379
130220;201511;1973;8124;1788;7766;327;1625;972;4191;1299;5816
130230;201511;3640;16484;3380;16037;398;1973;2494;12290;2892;14263
130240;201511;8430;32044;7743;31026;442;2322;6637;26564;7079;28886
130250;201511;19716;68617;18544;67086;2803;10088;13496;50727;16299;60815
130255;201511;4129;14537;3878;14108;185;733;3404;12488;3589;13221
130260;201511;245956;804829;219258;757693;64106;234139;95352;331925;159458;566064
130270;201511;6954;29310;6381;28376;929;4320;4487;20663;5416;24983
130280;201511;3222;13258;3116;13117;166;746;2794;11935;2960;12681
130290;201511;11293;39657;10812;39095;138;250;10408;38342;10546;38592
130300;201511;4259;16745;4071;16440;276;1305;3485;14086;3761;15391
130310;201511;5019;19041;4638;18551;369;1547;3831;15601;4200;17148
130320;201511;2907;10383;2643;10006;381;1544;1830;7067;2211;8611
130330;201511;3574;13025;3269;12635;232;1092;2700;10395;2932;11487
130340;201511;17458;67211;16249;65663;2828;11341;11952;49860;14780;61201
130350;201511;3267;13620;3183;13500;299;1627;2598;10880;2897;12507
130353;201511;6030;18451;5243;17416;1209;3939;3140;11157;4349;15096
130356;201511;4544;16308;4263;15891;417;1509;3337;12886;3754;14395
130360;201511;3267;9210;2878;8786;166;447;2583;8052;2749;8499
130370;201511;5249;20628;4465;19528;261;1499;3530;15441;3791;16940
130380;201511;7698;31911;7374;31444;521;2540;6271;26920;6792;29460
130390;201511;4854;21610;4498;20960;487;2555;3327;15708;3814;18263
130395;201511;2084;7474;1827;6933;299;1242;1151;4295;1450;5537
130400;201511;2082;7957;1991;7834;159;764;1732;6767;1891;7531
130406;201511;10646;40308;9552;38686;2213;9304;5810;24161;8023;33465
130410;201511;3892;14905;3502;14174;1067;4583;1552;6485;2619;11068
130420;201511;10517;44331;10007;43527;2619;11044;6300;28896;8919;39940
130423;201511;3241;12592;3027;12289;278;1374;2505;10094;2783;11468
130426;201511;2152;9400;2082;9275;292;1360;1561;7091;1853;8451
130430;201511;3321;11832;3187;11631;383;1482;2459;9047;2842;10529
130440;201511;3499;12779;3320;12565;278;1105;2825;10764;3103;11869
140002;201511;1663;5406;1535;5223;153;549;1099;3773;1252;4322
140005;201511;3068;9007;2912;8833;104;275;2748;8396;2852;8671
140010;201511;54349;159317;44590;144182;11123;38244;19550;65288;30673;103532
140015;201511;2931;9375;2735;9126;306;882;2197;7622;2503;8504
140017;201511;3255;10162;2934;9758;298;940;2234;7710;2532;8650
140020;201511;4441;15110;4053;14544;652;2562;2781;9944;3433;12506
140023;201511;2140;7223;1866;6796;249;998;1284;4716;1533;5714
140028;201511;2119;5858;1972;5654;285;899;1394;3814;1679;4713
140030;201511;3735;11753;3508;11436;510;1397;2554;8682;3064;10079
140040;201511;1726;8052;1667;7917;117;699;1384;6551;1501;7250
140045;201511;2501;9198;2255;8839;452;1645;1463;6183;1915;7828
140047;201511;5479;15627;4837;14729;1351;4195;2266;7319;3617;11514
140050;201511;1467;4590;1314;4390;318;1080;740;2519;1058;3599
140060;201511;1510;4601;1343;4340;280;966;838;2726;1118;3692
140070;201511;1457;7833;1405;7659;103;692;1141;6195;1244;6887
150010;201511;34213;105280;32160;102500;2125;7302;26174;83676;28299;90978
150013;201511;1677;4916;1528;4743;170;514;1194;3790;1364;4304
150020;201511;12425;41562;11973;40928;1222;3957;9817;34301;11039;38258
150030;201511;6818;29387;6586;29029;776;3109;5266;24093;6042;27202
150034;201511;4268;11757;4018;11438;233;677;3487;9935;3720;10612
150040;201511;12761;41140;10852;38839;2092;6825;7408;28580;9500;35405
150050;201511;5733;22277;5493;21856;338;1625;4667;18574;5005;20199
150060;201511;17205;53868;15613;51331;2878;9326;10070;34113;12948;43439
150070;201511;5927;24209;5296;23533;347;1710;4661;20881;5008;22591
150080;201511;69209;180718;58668;166438;11539;31722;33971;100547;45510;132269
150085;201511;5306;18066;5023;17691;520;1561;4112;15066;4632;16627
150090;201511;10017;38452;9479;37667;977;3913;7349;29853;8326;33766
150095;201511;5263;17332;4794;16627;428;1368;3792;13611;4220;14979
150100;201511;3304;12277;3102;11921;187;914;2476;9343;2663;10257
150110;201511;3281;16335;3269;16306;259;1283;2811;14248;3070;15531
150120;201511;6188;23468;6034;23200;628;2335;4856;19056;5484;21391
150125;201511;748;2176;657;2064;117;408;432;1329;549;1737
150130;201511;21807;66174;20128;63784;2436;7440;14929;48539;17365;55979
150140;201511;155189;438978;145997;426756;16890;48405;112754;334379;129644;382784
150145;201511;4515;14372;4096;13832;624;2213;3027;10406;3651;12619
150150;201511;11833;36123;10765;34469;1909;6382;6922;22397;8831;28779
150157;201511;3123;9369;2704;8769;383;1386;1877;6157;2260;7543
150160;201511;3052;9830;2845;9528;936;3171;1410;4895;2346;8066
150170;201511;21657;79750;20349;77578;3304;12805;14076;54628;17380;67433
150172;201511;3072;10495;2691;9841;454;1680;1801;6758;2255;8438
150175;201511;1970;5920;1836;5765;168;549;1487;4819;1655;5368
150178;201511;10070;31397;8916;30038;1200;4279;6308;21866;7508;26145
150180;201511;18094;72527;17372;71566;1508;6852;14376;59735;15884;66587
150190;201511;6991;23437;6671;22983;324;1173;5906;20579;6230;21752
150195;201511;5104;16978;4734;16374;304;1149;3997;13917;4301;15066
150200;201511;5256;16732;5019;16459;132;427;4666;15460;4798;15887
150210;201511;24343;92313;23484;91090;2340;8911;18883;75423;21223;84334
150215;201511;6835;21524;5934;20050;1709;6007;2481;8512;4190;14519
150220;201511;12190;37849;10805;35633;2433;8205;5579;18766;8012;26971
150230;201511;11306;36696;9991;34793;1396;5288;6779;23802;8175;29090
150240;201511;35356;104617;30624;96328;10182;33058;9598;31280;19780;64338
150250;201511;4080;16692;3927;16463;609;2599;2841;12304;3450;14903
150260;201511;2047;8173;1934;7953;391;1608;1174;4978;1565;6586
150270;201511;8627;26399;6850;24135;1789;6571;3744;13488;5533;20059
150275;201511;5876;21347;5567;20832;736;2730;4012;15359;4748;18089
150276;201511;2113;6354;1871;6009;461;1586;1197;3802;1658;5388
150277;201511;4857;15027;4191;14191;806;2859;2789;9680;3595;12539
150280;201511;5779;25780;5582;25339;1134;5210;3645;17037;4779;22247
150285;201511;2739;10868;2572;10548;514;2187;1571;6694;2085;8881
150290;201511;9657;28318;9191;27784;738;1866;7800;24369;8538;26235
150293;201511;9845;26781;7398;23324;2259;7540;2580;8777;4839;16317
150295;201511;7075;21374;5853;19907;1455;5039;3296;11900;4751;16939
150300;201511;1838;6372;1742;6245;141;583;1358;4903;1499;5486
150304;201511;4069;12844;3540;12027;607;2052;2272;7983;2879;10035
150307;201511;6488;21800;6006;21120;432;1507;4950;17556;5382;19063
150309;201511;6151;21198;5602;20408;1254;4540;3464;13257;4718;17797
150310;201511;5953;26027;5734;25676;688;3278;4431;20115;5119;23393
150320;201511;9330;22428;8602;21658;593;1239;7351;18886;7944;20125
150330;201511;13580;46712;12657;45346;1790;6384;9265;34227;11055;40611
150340;201511;2399;7762;2213;7475;284;975;1577;5395;1861;6370
150345;201511;6553;21839;6119;21254;607;2095;4866;17259;5473;19354
150350;201511;7578;24008;7054;23309;1219;3452;5031;17475;6250;20927
150360;201511;21125;65623;18406;62057;3128;10559;12223;42818;15351;53377
150370;201511;9763;35778;9154;34955;1311;4867;6896;27333;8207;32200
150375;201511;2848;12433;2768;12326;248;1080;2344;10643;2592;11723
150380;201511;9895;28702;8712;27051;620;1987;7155;22467;7775;24454
150390;201511;7807;33537;7287;32549;1340;5852;4672;21736;6012;27588
150400;201511;5783;22921;5524;22387;541;2201;4291;17788;4832;19989
150405;201511;8204;24738;7296;23619;1399;3783;4847;17281;6246;21064
150410;201511;1550;5981;1449;5765;205;926;918;3677;1123;4603
150420;201511;35858;121163;30254;111683;9225;37000;10518;40163;19743;77163
150430;201511;7132;24154;6778;23581;958;3227;4898;17527;5856;20754
150440;201511;5371;18748;5146;18433;955;3272;3607;13394;4562;16666
150442;201511;20730;60632;18432;57077;3522;10946;11205;35666;14727;46612
150445;201511;5148;17841;4776;17196;672;2415;3442;12680;4114;15095
150450;201511;4335;20835;4176;20591;371;1889;3428;17220;3799;19109
150460;201511;6470;25005;5953;24384;389;2015;5024;20824;5413;22839
150470;201511;17146;52570;16470;51769;511;1324;15375;48964;15886;50288
150475;201511;2819;9770;2594;9477;263;961;2073;7745;2336;8706
150480;201511;13647;46574;12646;45062;1327;4970;9979;36019;11306;40989
150490;201511;6815;26315;6658;26073;299;1290;5860;23155;6159;24445
150495;201511;4847;18155;4728;17993;248;1014;4277;16343;4525;17357
150497;201511;2787;10139;2511;9583;804;3241;1138;4363;1942;7604
150500;201511;3127;8663;2901;8344;296;839;2232;6405;2528;7244
150503;201511;3790;11666;3247;10984;1115;3875;1621;5737;2736;9612
150506;201511;11412;39600;10305;37990;2478;8706;6318;24868;8796;33574
150510;201511;9515;37334;8724;35774;1414;5936;5735;24392;7149;30328
150520;201511;6642;26099;6523;25934;277;1077;6019;24146;6296;25223
150530;201511;12086;41431;10833;39501;1196;4131;8217;30662;9413;34793
150540;201511;4621;14153;4132;13455;310;1021;3366;10992;3676;12013
150543;201511;5552;17220;4929;16297;1036;3517;3009;10219;4045;13736
150548;201511;9059;28911;8469;28158;554;1773;7492;25213;8046;26986
150549;201511;2083;6634;1909;6432;90;326;1708;5816;1798;6142
150550;201511;19990;62848;17334;58275;5230;18115;6792;23463;12022;41578
150553;201511;23110;79186;19042;70580;6965;27621;4603;17130;11568;44751
150555;201511;1666;5082;1437;4698;101;384;1104;3604;1205;3988
150560;201511;1958;6316;1828;6044;280;908;1170;3874;1450;4782
150563;201511;2872;9270;2644;8869;655;2396;1431;4769;2086;7165
150565;201511;3762;12926;3418;12392;219;991;2768;10076;2987;11067
150570;201511;5608;20854;5466;20600;413;1825;4392;16614;4805;18439
150580;201511;9470;39725;9227;39437;652;2709;8049;35179;8701;37888
150590;201511;5673;22727;5473;22467;161;727;5057;20852;5218;21579
150600;201511;7823;30287;7514;29825;413;1739;6612;26496;7025;28235
150610;201511;2363;8052;2157;7618;254;992;1479;5160;1733;6152
150611;201511;2684;9342;2507;8998;213;792;1980;7166;2193;7958
150613;201511;12093;36568;10114;33536;3315;11544;4080;13856;7395;25400
150616;201511;3054;9264;2354;8109;584;2213;833;2727;1417;4940
150618;201511;6411;21959;5831;20896;1636;6004;2897;10601;4533;16605
150619;201511;5197;17684;4813;17069;608;2345;3426;12191;4034;14536
150620;201511;6328;22673;5775;21943;763;2935;4422;17214;5185;20149
150630;201511;5723;17252;5413;16878;586;1911;4362;13856;4948;15767
150635;201511;4027;13122;3610;12288;843;2975;1747;6057;2590;9032
150640;201511;1762;5357;1697;5275;244;705;1329;4366;1573;5071
150650;201511;12429;37401;10965;34822;2967;9562;4851;15964;7818;25526
150655;201511;4906;16479;4626;15962;671;2374;3322;11607;3993;13981
150658;201511;4215;13126;3768;12487;918;3301;2216;7420;3134;10721
150660;201511;5502;17353;4992;16611;1196;3942;2722;9385;3918;13327
150670;201511;6878;18677;5773;17285;854;2660;4300;13187;5154;15847
150680;201511;55569;197515;48799;185619;14869;58895;19810;80275;34679;139170
150690;201511;2027;6264;1823;5938;325;984;1156;3896;1481;4880
150700;201511;6188;19151;5634;18423;1051;3495;3658;12301;4709;15796
150710;201511;4262;14312;3809;13566;461;1708;2731;9912;3192;11620
150715;201511;4980;15589;4315;14569;544;2043;3134;10609;3678;12652
150720;201511;6422;26101;6030;25377;834;3659;4279;18564;5113;22223
150730;201511;9666;32890;9036;31850;1036;3689;7097;25565;8133;29254
150740;201511;3704;11809;3304;11079;658;2301;1801;6066;2459;8367
150745;201511;5318;16715;4801;15987;1156;4033;2927;9730;4083;13763
150746;201511;1367;4479;1299;4355;172;612;915;3077;1087;3689
150747;201511;5351;16691;4695;15869;409;1168;3608;13047;4017;14215
150750;201511;3190;10536;2967;10251;217;861;2423;8379;2640;9240
150760;201511;10997;35802;10239;34762;2229;7718;6237;21722;8466;29440
150770;201511;5768;21966;5415;21297;472;1761;4491;18605;4963;20366
150775;201511;1142;3464;992;3193;203;796;531;1632;734;2428
150780;201511;3216;10515;3128;10405;96;344;2889;9633;2985;9977
150790;201511;4950;16082;4579;15637;373;1331;3694;13233;4067;14564
150795;201511;15307;47810;13644;45332;3027;9986;8050;27795;11077;37781
150796;201511;2991;8905;2712;8576;409;1308;1994;6461;2403;7769
150797;201511;3626;12368;3343;11889;125;538;2854;10120;2979;10658
150800;201511;13750;45443;12604;44032;2734;9057;8326;30710;11060;39767
150803;201511;6487;23521;6081;22857;690;2731;4473;17024;5163;19755
150805;201511;2612;9304;2439;9011;339;1246;1744;6572;2083;7818
150808;201511;5722;19060;4736;17192;1901;7460;768;2790;2669;10250
150810;201511;19028;58849;15997;55103;2365;7788;10731;39068;13096;46856
150812;201511;5252;16474;4811;15714;518;1998;3389;10658;3907;12656
150815;201511;8447;27552;7561;26425;793;2768;6020;21523;6813;24291
150820;201511;11345;32333;10060;30897;744;1726;8333;26406;9077;28132
150830;201511;12871;48187;11836;46654;767;3737;9736;39250;10503;42987
150835;201511;2082;7296;1916;6972;484;1789;892;3342;1376;5131
150840;201511;6857;20863;5642;18835;1331;4868;2696;8907;4027;13775
160005;201511;723;2551;679;2463;63;271;537;1913;600;2184
160010;201511;1369;4548;1365;4543;69;145;1268;4334;1337;4479
160015;201511;1679;6194;1641;6137;94;334;1473;5614;1567;5948
160020;201511;2030;7169;1880;6961;242;911;1389;5281;1631;6192
160021;201511;947;4088;912;4023;149;762;623;2752;772;3514
160023;201511;1032;4113;1018;4088;104;421;844;3421;948;3842
160025;201511;1282;3948;1267;3932;28;106;1224;3783;1252;3889
160027;201511;8139;24352;7507;23645;2644;7856;3823;13131;6467;20987
160030;201511;45071;159627;39941;150234;9684;36571;21600;85627;31284;122198
160040;201511;4222;16547;4121;16397;200;1082;3725;14619;3925;15701
160050;201511;3192;12095;2851;11571;1402;5616;949;4193;2351;9809
160053;201511;2760;10625;2689;10518;531;2184;1825;7226;2356;9410
160055;201511;630;2457;620;2445;77;333;480;1895;557;2228
160060;201511;15517;52404;14526;51275;3068;10209;9688;35698;12756;45907
160070;201511;2494;9820;2354;9570;202;968;1963;7920;2165;8888
160080;201511;2578;9686;2541;9637;110;537;2354;8839;2464;9376
170025;201511;525;1727;479;1656;132;466;234;849;366;1315
170030;201511;1166;3804;1023;3543;311;1122;365;1283;676;2405
170035;201511;1525;4393;1207;3810;320;1114;439;1357;759;2471
170040;201511;1884;5999;1660;5701;229;889;1042;3749;1271;4638
170070;201511;1816;4781;1426;4257;317;1032;756;2204;1073;3236
170100;201511;2458;7195;2132;6676;249;816;1630;5111;1879;5927
170105;201511;764;2378;597;2035;118;468;297;957;415;1425
170110;201511;1044;3251;882;2977;201;739;395;1319;596;2058
170130;201511;1361;4263;1143;3854;320;1121;503;1728;823;2849
170190;201511;1586;4631;1191;3982;489;1594;239;904;728;2498
170200;201511;1647;4589;1057;3444;272;981;273;825;545;1806
170210;201511;31886;90227;25239;79305;7316;24751;7055;23015;14371;47766
170215;201511;1185;3701;999;3408;83;342;721;2432;804;2774
170220;201511;5687;19528;5235;18631;1242;4666;2737;9766;3979;14432
170230;201511;1446;4592;1189;4091;248;978;528;1727;776;2705
170240;201511;2679;8131;2227;7425;300;1175;1473;4860;1773;6035
170255;201511;3379;10785;2812;9801;856;3022;1167;4235;2023;7257
170270;201511;1031;2568;710;2128;77;249;475;1409;552;1658
170290;201511;2760;8458;2528;8185;186;453;2163;7321;2349;7774
170300;201511;1950;5964;1612;5399;218;829;1021;3410;1239;4239
170305;201511;771;2290;612;1997;117;424;301;982;418;1406
170307;201511;1082;3783;895;3424;182;795;435;1706;617;2501
170310;201511;1630;4486;1218;3774;322;1072;525;1638;847;2710
170320;201511;1141;3282;820;2717;205;724;270;906;475;1630
170330;201511;755;2468;686;2356;89;339;498;1682;587;2021
170360;201511;460;1467;379;1325;91;333;166;566;257;899
170370;201511;1386;3934;1091;3458;217;784;558;1738;775;2522
170380;201511;1806;5746;1446;5150;249;1016;758;2657;1007;3673
170382;201511;548;1805;464;1663;102;410;257;904;359;1314
170384;201511;1557;6310;1428;6056;335;1540;772;3270;1107;4810
170386;201511;919;2740;789;2542;189;679;342;1075;531;1754
170388;201511;642;1908;517;1700;108;428;195;604;303;1032
170389;201511;922;3083;831;2933;89;354;600;2096;689;2450
170390;201511;1285;3722;1113;3505;113;385;843;2700;956;3085
170410;201511;550;1728;463;1574;42;172;295;989;337;1161
170460;201511;498;1351;338;1078;81;288;108;330;189;618
170510;201511;789;2623;639;2341;81;351;330;1180;411;1531
170550;201511;6764;19239;4982;16089;1602;5656;751;2370;2353;8026
170555;201511;1350;3878;1054;3416;226;784;505;1668;731;2452
170560;201511;1022;3379;800;3080;171;716;443;1782;614;2498
170600;201511;1334;3861;1186;3661;265;806;745;2383;1010;3189
170610;201511;1587;4863;1257;4325;136;544;780;2679;916;3223
170625;201511;432;1326;330;1127;65;222;94;331;159;553
170650;201511;1249;4014;1061;3665;263;986;423;1515;686;2501
170700;201511;4102;12849;3309;11506;697;2644;1424;5105;2121;7749
170710;201511;1827;5366;1463;4696;236;796;861;2786;1097;3582
170720;201511;1839;4982;1541;4500;302;785;1006;3106;1308;3891
170730;201511;1008;2897;816;2602;215;719;352;1133;567;1852
170740;201511;2201;7718;1898;7164;293;1157;1211;4623;1504;5780
170755;201511;807;2491;653;2159;136;519;243;777;379;1296
170765;201511;1356;3647;1039;3117;291;928;408;1242;699;2170
170770;201511;1748;5874;1587;5590;267;1001;967;3420;1234;4421
170820;201511;3654;11609;3252;10938;747;2648;1542;5268;2289;7916
170825;201511;734;2180;584;1884;108;367;250;783;358;1150
170830;201511;1401;4074;1230;3824;55;113;1085;3472;1140;3585
170900;201511;2575;9090;2430;8844;220;811;1932;7155;2152;7966
170930;201511;3684;11253;3168;10355;940;3252;1193;4007;2133;7259
170950;201511;14080;40491;10288;33714;3149;11698;1902;5998;5051;17696
170980;201511;503;1497;380;1287;86;327;154;492;240;819
171050;201511;1479;5014;1325;4719;94;427;1050;3686;1144;4113
171070;201511;1516;4741;1381;4534;359;1174;723;2462;1082;3636
171090;201511;1019;2799;845;2553;66;192;619;1869;685;2061
171110;201511;607;1776;452;1489;123;437;190;591;313;1028
171150;201511;852;2436;613;2014;106;387;356;1169;462;1556
171180;201511;698;2105;484;1661;117;421;188;690;305;1111
171190;201511;1661;6088;1456;5651;297;1231;709;2840;1006;4071
171195;201511;819;2907;706;2682;98;419;409;1575;507;1994
171200;201511;682;2155;547;1889;165;623;179;563;344;1186
171215;201511;460;1369;353;1152;58;206;156;519;214;725
171240;201511;726;2589;668;2474;91;391;427;1624;518;2015
171245;201511;636;2086;512;1789;110;441;166;536;276;977
171250;201511;1091;3149;868;2769;150;541;498;1511;648;2052
171270;201511;418;1707;391;1648;131;525;149;711;280;1236
171280;201511;880;2667;729;2408;194;620;311;1130;505;1750
171320;201511;3862;11636;3277;10608;920;2982;1418;4705;2338;7687
171330;201511;2912;8447;2360;7572;642;2203;1008;3191;1650;5394
171360;201511;1438;4657;1265;4384;202;711;811;2852;1013;3563
171370;201511;670;1919;575;1784;135;462;298;903;433;1365
171380;201511;1326;4239;1109;3835;417;1457;350;1255;767;2712
171395;201511;889;2673;700;2320;144;564;328;1043;472;1607
171420;201511;2273;6825;1717;5800;434;1553;625;2083;1059;3636
171430;201511;1054;3232;876;2939;207;700;440;1479;647;2179
171488;201511;2480;7533;2148;7046;496;1636;1154;3919;1650;5555
171500;201511;790;2409;683;2226;106;335;450;1508;556;1843
171510;201511;901;3151;806;2985;77;329;577;2159;654;2488
171515;201511;500;1426;392;1238;66;208;208;646;274;854
171525;201511;632;2046;531;1868;99;401;279;936;378;1337
171550;201511;311;1042;239;902;83;352;44;165;127;517
171570;201511;1248;3914;1087;3593;210;702;702;2338;912;3040
171575;201511;1910;5375;1444;4524;288;925;642;2046;930;2971
171610;201511;5401;17194;4487;15553;1211;4656;1545;5264;2756;9920
171620;201511;2558;7530;2230;7074;115;450;1865;5925;1980;6375
171630;201511;914;2862;749;2589;240;890;299;1021;539;1911
171650;201511;2216;6802;1715;5790;460;1681;589;1954;1049;3635
171660;201511;2470;6826;1895;5788;237;807;1127;3429;1364;4236
171665;201511;1498;4353;1203;3894;186;668;691;2309;877;2977
171670;201511;1965;5537;1629;4979;450;1523;690;2012;1140;3535
171700;201511;1084;3529;938;3247;139;553;594;2019;733;2572
171720;201511;720;2106;594;1891;211;661;222;744;433;1405
171750;201511;1185;3662;935;3154;263;919;296;1005;559;1924
171780;201511;1155;3171;879;2771;105;360;514;1656;619;2016
171790;201511;1477;4957;1287;4657;259;919;795;3033;1054;3952
171800;201511;652;2035;580;1938;74;271;411;1408;485;1679
171820;201511;10139;29729;8518;27396;1712;5994;4595;14805;6307;20799
171830;201511;1408;5215;1267;4901;317;1222;578;2269;895;3491
171840;201511;787;2157;673;1994;49;150;542;1622;591;1772
171845;201511;743;2028;570;1734;97;322;289;884;386;1206
171850;201511;960;3405;844;3166;105;460;524;1938;629;2398
171855;201511;1142;3569;1031;3358;92;362;763;2416;855;2778
171865;201511;469;1506;400;1389;84;314;193;656;277;970
171870;201511;737;2207;588;1937;143;512;216;753;359;1265
171875;201511;1328;4169;1103;3804;120;499;748;2525;868;3024
171880;201511;818;3050;796;3014;86;341;631;2440;717;2781
171884;201511;987;2730;707;2314;170;620;195;751;365;1371
171886;201511;1444;4685;1147;4045;348;1359;287;951;635;2310
171888;201511;692;2084;547;1806;60;207;304;1034;364;1241
171889;201511;490;1583;451;1515;99;353;238;811;337;1164
171890;201511;1208;3740;1003;3427;155;579;566;1921;721;2500
171900;201511;489;1821;429;1703;113;459;202;809;315;1268
172000;201511;562;1857;483;1702;76;293;272;950;348;1243
172010;201511;1202;4147;1109;3991;132;571;801;2867;933;3438
172015;201511;331;1288;273;1174;57;236;150;681;207;917
172020;201511;2259;7520;2086;7239;281;1007;1431;5054;1712;6061
172025;201511;722;2084;548;1788;85;311;295;968;380;1279
172030;201511;1147;3740;1012;3506;76;335;750;2563;826;2898
172049;201511;1332;3510;995;2939;167;487;726;2197;893;2684
172065;201511;1296;3507;1089;3272;68;196;976;2989;1044;3185
172080;201511;2513;7735;2112;7021;231;888;1347;4424;1578;5312
172085;201511;530;1435;374;1131;57;162;109;328;166;490
172090;201511;3375;9818;2760;8873;257;908;2072;6746;2329;7654
172093;201511;599;1826;466;1603;136;545;209;709;345;1254
172097;201511;669;1979;532;1757;125;407;214;741;339;1148
172100;201511;32156;96725;24630;82943;7049;26396;6536;21668;13585;48064
172110;201511;1678;6231;1489;5917;189;818;1052;4292;1241;5110
172120;201511;5186;15910;4308;14702;615;2169;2894;10073;3509;12242
172125;201511;264;822;222;744;38;147;104;347;142;494
172130;201511;551;1536;439;1350;42;154;292;914;334;1068
172208;201511;2126;6325;1900;5987;337;1094;1083;3458;1420;4552
172210;201511;2509;7693;2208;7233;543;1901;1123;3606;1666;5507
210005;201511;21740;67382;18212;61879;5722;20796;6845;23375;12567;44171
210010;201511;1573;5695;1404;5393;130;548;1057;4121;1187;4669
210015;201511;3302;10499;2949;9962;223;624;2478;8610;2701;9234
210020;201511;6970;16993;6544;16475;217;578;5944;14898;6161;15476
210030;201511;5507;18348;5149;17854;345;1547;4228;14540;4573;16087
210040;201511;1864;5205;1713;5029;119;359;1451;4278;1570;4637
210043;201511;6482;18529;5619;17419;581;1705;4111;13335;4692;15040
210047;201511;6392;24507;5867;23594;665;3013;4259;17169;4924;20182
210050;201511;2337;8527;1919;7717;703;2892;634;2732;1337;5624
210055;201511;1724;5874;1570;5650;183;685;1176;4283;1359;4968
210060;201511;7265;27816;6716;26801;986;4097;4435;18086;5421;22183
210070;201511;6957;20588;6416;19913;176;704;5747;17849;5923;18553
210080;201511;3659;12600;3559;12468;54;264;3349;11710;3403;11974
210083;201511;4314;15044;3976;14682;140;597;3716;13785;3856;14382
210087;201511;2866;8518;2605;8178;296;959;2041;6508;2337;7467
210090;201511;9787;32066;9272;31233;507;1892;7944;26827;8451;28719
210095;201511;5928;21598;5694;21265;405;1585;4710;17833;5115;19418
210100;201511;7154;21557;6572;20840;891;2990;4910;15511;5801;18501
210110;201511;2854;9945;2756;9810;117;544;2473;8749;2590;9293
210120;201511;25974;70831;22239;66429;2803;7110;16383;51951;19186;59061
210125;201511;3527;11198;3379;11041;231;618;2950;9905;3181;10523
210130;201511;4079;12106;3795;11700;286;925;3133;9666;3419;10591
210135;201511;1678;4928;1466;4632;113;375;1173;3726;1286;4101
210140;201511;16967;54012;14648;50796;2745;9957;9055;32445;11800;42402
210150;201511;4544;11194;4067;10604;74;185;3804;9929;3878;10114
210160;201511;17444;54979;16360;53374;1533;4510;13108;44061;14641;48571
210170;201511;13786;48936;13403;48440;768;2799;11863;43388;12631;46187
210173;201511;1910;7987;1841;7852;128;764;1566;6489;1694;7253
210177;201511;3035;9404;2871;9212;171;577;2541;8202;2712;8779
210180;201511;1480;4529;1379;4374;61;229;1169;3662;1230;3891
210190;201511;4836;15367;4421;14594;237;1025;3432;11066;3669;12091
210193;201511;1386;4369;1250;4144;78;273;1034;3479;1112;3752
210197;201511;2086;6899;1920;6708;242;820;1472;5314;1714;6134
210200;201511;8522;28433;7883;27507;1126;3680;5784;21072;6910;24752
210203;201511;6452;20802;6126;20365;420;1229;5257;17769;5677;18998
210207;201511;2961;9702;2766;9338;371;1198;1983;6871;2354;8069
210210;201511;8483;28399;8023;27788;104;449;7403;25989;7507;26438
210215;201511;1251;5077;1196;4990;105;505;963;4040;1068;4545
210220;201511;6017;23024;5714;22529;417;1809;4681;18640;5098;20449
210230;201511;5034;16685;4730;16194;286;1017;4006;13843;4292;14860
210232;201511;12657;40867;10534;38210;1560;5898;6989;26928;8549;32826
210235;201511;3531;11152;3177;10693;215;865;2651;8916;2866;9781
210237;201511;2338;8992;2276;8898;70;391;2116;8199;2186;8590
210240;201511;2995;9433;2808;9176;172;529;2328;7677;2500;8206
210250;201511;5106;16430;4804;16035;140;673;4342;14358;4482;15031
210255;201511;2512;8093;2284;7675;352;1254;1588;5360;1940;6614
210260;201511;5223;16829;4729;16097;643;2133;3426;12007;4069;14140
210270;201511;5382;15178;4710;14239;136;622;4131;12346;4267;12968
210275;201511;3613;8741;3407;8519;55;81;3303;8355;3358;8436
210280;201511;5572;16750;4839;15765;320;1321;3708;11878;4028;13199
210290;201511;5625;18630;5180;18083;372;1296;4339;15348;4711;16644
210300;201511;37413;104790;30640;96397;2234;7394;23364;76188;25598;83582
210310;201511;2887;8148;2652;7836;84;196;2342;6981;2426;7177
210312;201511;2173;6911;2064;6759;75;350;1823;5914;1898;6264
210315;201511;2539;8525;2354;8266;170;678;1991;7034;2161;7712
210317;201511;4212;12751;4004;12492;222;782;3572;11150;3794;11932
210320;201511;19096;60397;17526;58485;989;3515;14884;50192;15873;53707
210325;201511;3556;11157;3164;10561;289;1074;2379;7988;2668;9062
210330;201511;36567;88104;28162;79114;4173;9842;18721;59241;22894;69083
210340;201511;11668;35224;10590;33834;1273;3484;7704;26403;8977;29887
210350;201511;9958;30842;9007;29514;671;2195;7180;23832;7851;26027
210355;201511;3870;14191;3566;13748;235;989;3021;11835;3256;12824
210360;201511;16153;48808;14685;46721;1155;3976;11574;36924;12729;40900
210370;201511;9317;22324;7795;20688;286;561;6936;18988;7222;19549
210375;201511;3083;9414;2613;8781;785;2716;1224;4255;2009;6971
210380;201511;6046;16832;5323;15822;430;1169;4345;13149;4775;14318
210390;201511;2813;10027;2554;9605;144;760;2155;8051;2299;8811
210400;201511;4866;15252;4648;14999;156;467;4313;14068;4469;14535
210405;201511;8319;22742;6619;20305;2157;6642;2393;8141;4550;14783
210407;201511;2044;7268;1768;6805;205;791;1281;5058;1486;5849
210408;201511;2378;9192;2219;8992;153;707;1872;7816;2025;8523
210409;201511;3715;13567;3497;13232;216;1021;2871;10879;3087;11900
210410;201511;3482;11588;3366;11448;364;1099;2734;9693;3098;10792
210420;201511;4013;13218;3667;12619;282;939;2932;10269;3214;11208
210430;201511;2170;6702;2093;6611;120;383;1822;5778;1942;6161
210440;201511;3989;12518;3866;12352;204;602;3492;11293;3696;11895
210450;201511;2837;8893;2526;8434;164;590;2022;6702;2186;7292
210455;201511;4108;11864;3611;11103;576;1758;2496;7981;3072;9739
210460;201511;3635;11950;3391;11567;186;738;2804;9553;2990;10291
210462;201511;1490;5391;1385;5189;96;444;1100;4111;1196;4555
210465;201511;2552;8437;2369;8173;236;665;1954;6975;2190;7640
210467;201511;6162;20423;5717;19886;441;1546;4733;16655;5174;18201
210470;201511;2058;5562;1568;4851;87;257;1187;3732;1274;3989
210480;201511;14136;45780;12300;43383;2723;9367;7628;28772;10351;38139
210490;201511;3558;10025;3124;9408;159;525;2610;7827;2769;8352
210500;201511;6358;25996;6107;25540;789;3243;4540;19562;5329;22805
210510;201511;6470;22073;6155;21690;374;1169;5218;18904;5592;20073
210515;201511;3620;11669;3458;11484;104;322;3230;10858;3334;11180
210520;201511;2599;7945;2354;7593;150;456;2002;6547;2152;7003
210530;201511;36345;112042;29254;101194;7466;29004;12508;44145;19974;73149
210535;201511;3196;11025;3061;10830;109;382;2759;9874;2868;10256
210540;201511;13291;43969;11613;41487;2618;9045;6471;24951;9089;33996
210542;201511;5792;16688;5317;16175;342;805;4581;14376;4923;15181
210545;201511;2268;7441;2151;7248;66;332;1865;6209;1931;6541
210547;201511;3791;13351;3529;12909;289;990;2770;10378;3059;11368
210550;201511;6100;18151;5604;17637;273;646;5113;16543;5386;17189
210560;201511;4140;12891;3690;12130;216;799;3091;10116;3307;10915
210565;201511;1491;5254;1282;4925;109;548;938;3609;1047;4157
210570;201511;12402;34965;11178;33569;863;1936;9497;29595;10360;31531
210580;201511;3148;9431;2817;9010;337;840;2129;7393;2466;8233
210590;201511;4079;12748;3786;12389;324;1123;3163;10377;3487;11500
210592;201511;2433;7657;2337;7500;48;214;2070;6629;2118;6843
210594;201511;2687;7530;2195;6813;118;348;1729;5488;1847;5836
210596;201511;2704;10024;2556;9744;283;1163;1906;7357;2189;8520
210598;201511;1902;5855;1751;5665;102;371;1505;4811;1607;5182
210600;201511;3216;9330;2816;8783;195;646;2250;6992;2445;7638
210610;201511;2503;8250;2328;8025;139;604;2013;6837;2152;7441
210620;201511;1919;6164;1785;5989;56;165;1626;5537;1682;5702
210630;201511;3701;12995;3239;12210;383;1644;2168;8260;2551;9904
210632;201511;4493;15706;4202;15268;436;1704;3255;11863;3691;13567
210635;201511;1901;6617;1808;6475;126;426;1561;5686;1687;6112
210637;201511;2721;9121;2502;8818;161;628;2032;7216;2193;7844
210640;201511;4201;15159;4121;15070;18;80;4012;14786;4030;14866
210650;201511;6837;20866;6637;20616;296;932;6169;19222;6465;20154
210660;201511;7915;23683;7281;22747;260;941;6654;20692;6914;21633
210663;201511;2700;8014;2531;7805;197;697;2095;6466;2292;7163
210667;201511;1804;6323;1705;6170;96;420;1455;5292;1551;5712
210670;201511;4406;16426;4195;16079;246;1112;3458;13349;3704;14461
210675;201511;5012;13941;4610;13448;357;923;3845;11497;4202;12420
210680;201511;4098;11327;3650;10779;197;521;3133;9357;3330;9878
210690;201511;7169;24108;6882;23792;295;965;6107;21714;6402;22679
210700;201511;2583;7765;2403;7567;408;986;1685;6043;2093;7029
210710;201511;4774;15711;4498;15273;224;937;3787;12792;4011;13729
210720;201511;2533;9254;2383;9036;152;701;2082;7829;2234;8530
210725;201511;1095;4113;963;3871;141;606;587;2396;728;3002
210730;201511;1111;3533;995;3363;106;307;756;2622;862;2929
210735;201511;4118;14350;3759;13741;679;2499;2493;9459;3172;11958
210740;201511;4939;14614;4668;14332;212;900;4190;12564;4402;13464
210745;201511;3871;11497;3617;11160;254;649;3036;9489;3290;10138
210750;201511;20661;55395;17995;52359;2089;6029;13778;40982;15867;47011
210760;201511;5909;16687;5509;16256;44;152;5360;15837;5404;15989
210770;201511;5887;16136;5123;15259;140;546;4651;13804;4791;14350
210780;201511;8410;27731;7652;26393;858;3056;5476;19274;6334;22330
210790;201511;4618;14526;4170;13993;292;762;3427;12090;3719;12852
210800;201511;4737;13495;4286;12946;170;492;3784;11565;3954;12057
210805;201511;3668;15394;3536;15157;174;906;3034;13097;3208;14003
210810;201511;5347;16393;4965;15919;408;849;4208;14173;4616;15022
210820;201511;7858;22590;7153;21574;1227;3587;4754;14703;5981;18290
210825;201511;5659;19464;5380;19073;646;2181;4146;15122;4792;17303
210830;201511;8276;24543;7857;24036;811;2167;6358;20102;7169;22269
210840;201511;3651;10021;3261;9433;189;480;2679;7789;2868;8269
210845;201511;5710;17491;5506;17268;111;241;5247;16731;5358;16972
210850;201511;6036;21527;5484;20569;805;3387;3658;13690;4463;17077
210860;201511;17530;52222;15732;49746;1414;4500;12267;39313;13681;43813
210870;201511;5894;19617;5368;18961;589;2032;4108;14749;4697;16781
210880;201511;4280;13854;4078;13584;358;1298;3309;11054;3667;12352
210890;201511;5292;15474;4787;14884;565;1590;3815;12357;4380;13947
210900;201511;4946;14830;4019;13274;1418;4908;1103;3861;2521;8769
210905;201511;1833;5749;1657;5499;159;403;1284;4452;1443;4855
210910;201511;8686;27396;7836;26007;1224;4356;5259;17511;6483;21867
210920;201511;2976;10561;2842;10340;161;689;2398;8725;2559;9414
210923;201511;1515;5195;1393;5012;162;653;933;3443;1095;4096
210927;201511;4791;15249;4552;14989;64;276;4383;14436;4447;14712
210930;201511;2461;8990;2330;8807;149;816;1959;7228;2108;8044
210940;201511;2823;10949;2759;10831;202;871;2320;9114;2522;9985
210945;201511;5823;17590;5634;17388;266;359;5266;16727;5532;17086
210950;201511;5313;16292;4607;15163;446;1479;3446;11567;3892;13046
210955;201511;1899;6138;1667;5790;205;701;1138;4128;1343;4829
210960;201511;8685;28376;8284;27819;2208;7251;4728;16803;6936;24054
210970;201511;1353;4824;1196;4571;158;718;827;3134;985;3852
210975;201511;1746;5867;1661;5719;133;495;1315;4540;1448;5035
210980;201511;9860;23461;9538;23127;913;1816;8146;20457;9059;22273
210990;201511;16717;50429;13471;45996;3056;10962;7002;24657;10058;35619
211000;201511;15423;49656;13682;47539;841;3491;11373;39851;12214;43342
211003;201511;4761;16927;4310;16268;340;1555;3251;12521;3591;14076
211010;201511;6497;23462;6240;23160;103;461;5916;22072;6019;22533
211020;201511;7385;23850;7139;23457;601;2128;5863;19175;6464;21303
211023;201511;2249;7588;2168;7453;180;675;1767;6095;1947;6770
211027;201511;2881;11185;2793;11045;311;1258;2202;8853;2513;10111
211030;201511;3894;11931;3624;11644;581;1381;2743;9564;3324;10945
211040;201511;4285;16260;4118;15988;152;807;3588;13989;3740;14796
211050;201511;10126;26355;9810;26005;360;856;9050;24073;9410;24929
211060;201511;6023;21404;5839;21137;484;1832;4969;18169;5453;20001
211065;201511;1859;6194;1694;5983;81;280;1532;5489;1613;5769
211070;201511;8096;27726;7439;26635;449;1722;6169;22326;6618;24048
211080;201511;1382;4169;1151;3832;90;430;878;2804;968;3234
211085;201511;1885;6475;1703;6155;321;1195;1069;3915;1390;5110
211090;201511;3517;10358;3282;10035;132;543;2813;8454;2945;8997
211100;201511;6616;16999;6453;16823;38;125;6302;16435;6340;16560
211102;201511;3049;11353;2875;11107;248;961;2398;9444;2646;10405
211105;201511;2666;8563;2278;7971;210;841;1709;5906;1919;6747
211107;201511;4463;14177;4012;13569;236;840;3320;11482;3556;12322
211110;201511;6336;18835;5077;16898;1029;3350;2981;10405;4010;13755
211120;201511;35339;96937;31220;91986;5539;15620;21129;64762;26668;80382
211125;201511;2080;6634;1852;6273;131;489;1526;5177;1657;5666
211130;201511;133569;372357;120506;355684;22762;67149;76155;229470;98917;296619
211140;201511;5306;16907;4919;16306;203;785;4193;13838;4396;14623
211150;201511;9725;28265;8826;27142;485;1733;7380;22658;7865;24391
211153;201511;2822;8662;2604;8369;421;1307;1900;6281;2321;7588
211157;201511;1206;3877;1036;3620;93;417;693;2480;786;2897
211160;201511;4097;13567;3478;12523;279;1343;2401;8412;2680;9755
211163;201511;1665;5506;1573;5373;46;143;1424;4960;1470;5103
211167;201511;1496;4994;1427;4895;41;188;1330;4559;1371;4747
211170;201511;6378;16844;6086;16496;108;329;5632;15196;5740;15525
211172;201511;2421;7136;2175;6774;151;626;1804;5496;1955;6122
211174;201511;2804;8163;2531;7819;77;371;2263;6879;2340;7250
211176;201511;4360;13522;3769;12745;444;1609;2653;9081;3097;10690
211178;201511;3751;10052;3551;9828;76;202;3376;9343;3452;9545
211180;201511;4263;14926;4001;14517;306;1282;3278;11972;3584;13254
211190;201511;2784;9369;2578;9071;89;425;2230;7851;2319;8276
211195;201511;1470;4480;1215;4160;80;241;1006;3572;1086;3813
211200;201511;2138;7133;1871;6755;387;1336;1124;4330;1511;5666
211210;201511;6837;20882;6479;20391;490;1462;5393;17171;5883;18633
211220;201511;33603;97530;29026;91671;5804;18788;18137;58643;23941;77431
211223;201511;5048;14936;4600;14218;662;2063;3181;9968;3843;12031
211227;201511;1575;5692;1446;5482;135;576;1117;4273;1252;4849
211230;201511;8424;27448;7620;26125;890;3142;5664;19727;6554;22869
211240;201511;8092;27722;7672;27194;289;1222;6870;24203;7159;25425
211245;201511;5377;15967;5337;15925;157;267;5117;15532;5274;15799
211250;201511;12913;43084;12063;42071;1673;4698;9165;34296;10838;38994
211260;201511;8553;26509;8179;26001;580;2013;7138;22611;7718;24624
211270;201511;10272;35228;9128;33750;560;2491;7240;27135;7800;29626
211280;201511;12608;37387;11786;36381;1165;3060;9591;30713;10756;33773
211285;201511;1732;6307;1521;5844;287;1200;773;3054;1060;4254
211290;201511;7187;23645;6915;23293;615;1804;5740;19862;6355;21666
211300;201511;8239;24782;7697;24052;180;528;7135;22487;7315;23015
211400;201511;11602;36349;10295;34537;2817;9617;4847;17849;7664;27466
220005;201511;1825;5268;1659;5013;72;283;1359;3986;1431;4269
220010;201511;1384;4027;1214;3764;73;276;944;2872;1017;3148
220020;201511;3285;10375;3097;10053;615;1996;1910;6212;2525;8208
220025;201511;2186;5406;1971;5079;28;98;1678;4245;1706;4343
220027;201511;1372;3702;1235;3522;70;194;1009;2901;1079;3095
220030;201511;3221;8971;3150;8862;174;589;2751;7642;2925;8231
220040;201511;7600;23689;7049;22693;1481;4777;4320;13912;5801;18689
220045;201511;1415;4597;1282;4339;62;267;977;3237;1039;3504
220050;201511;4446;13325;3888;12376;229;903;3102;9737;3331;10640
220060;201511;1941;4996;1837;4873;54;106;1668;4441;1722;4547
220070;201511;2432;7178;2217;6838;159;498;1779;5484;1938;5982
220080;201511;721;2185;672;2110;60;255;548;1658;608;1913
220090;201511;1813;4594;1533;4227;69;225;1312;3553;1381;3778
220095;201511;731;1978;678;1902;19;76;619;1703;638;1779
220100;201511;1360;4119;1138;3747;99;359;830;2728;929;3087
220105;201511;2222;7097;1971;6621;175;584;1439;4868;1614;5452
220110;201511;3385;9916;3172;9570;142;572;2723;8059;2865;8631
220115;201511;2411;8376;2309;8213;167;681;1995;7048;2162;7729
220117;201511;1315;3498;1077;3137;79;232;868;2532;947;2764
220120;201511;12261;35307;11355;34184;174;777;10664;31937;10838;32714
220130;201511;896;3041;776;2867;68;270;634;2343;702;2613
220140;201511;1624;4399;1436;4169;227;531;1113;3370;1340;3901
220150;201511;7013;21527;6604;20937;199;825;5783;18118;5982;18943
220155;201511;1117;3433;902;3021;54;221;590;1930;644;2151
220157;201511;1050;2674;935;2497;21;67;819;2159;840;2226
220160;201511;2670;7959;2353;7401;107;459;1875;5786;1982;6245
220170;201511;1362;4192;1175;3883;58;270;938;3050;996;3320
220173;201511;2069;6218;1656;5396;47;224;1353;4276;1400;4500
220177;201511;1777;5231;1741;5174;60;213;1623;4805;1683;5018
220180;201511;1143;3121;941;2747;28;100;661;1849;689;1949
220190;201511;4449;14873;4136;14403;634;2254;3024;10575;3658;12829
220191;201511;1400;4685;1323;4557;178;632;937;3195;1115;3827
220192;201511;1818;5119;1428;4420;116;392;1005;3093;1121;3485
220194;201511;1645;4974;1471;4666;120;428;1101;3407;1221;3835
220196;201511;1971;5844;1810;5575;177;579;1378;4254;1555;4833
220198;201511;1337;3791;1038;3400;15;45;964;3209;979;3254
220200;201511;4370;14692;4099;14303;645;2296;2859;10058;3504;12354
220202;201511;2088;6444;1857;6031;46;220;1608;5109;1654;5329
220205;201511;2792;7283;2495;6863;48;192;2224;6035;2272;6227
220207;201511;910;2767;775;2520;76;300;560;1791;636;2091
220208;201511;1818;5859;1560;5393;234;931;964;3281;1198;4212
220209;201511;1511;4617;1369;4392;52;232;1108;3514;1160;3746
220210;201511;1717;4644;1504;4314;41;175;1251;3493;1292;3668
220211;201511;1613;4666;1532;4562;80;324;1317;3837;1397;4161
220213;201511;1723;4929;1585;4671;40;153;1299;3726;1339;3879
220217;201511;1930;6262;1857;6174;45;166;1713;5757;1758;5923
220220;201511;10986;30447;9875;28769;854;2187;7173;21478;8027;23665
220225;201511;1083;3162;923;2946;30;125;777;2444;807;2569
220230;201511;5302;14671;4785;13920;174;509;4218;12297;4392;12806
220240;201511;2843;8862;2629;8469;161;599;2073;6652;2234;7251
220245;201511;1504;4035;1306;3759;37;117;1146;3341;1183;3458
220250;201511;3165;9052;2894;8645;88;354;2544;7545;2632;7899
220253;201511;1650;4999;1412;4564;174;646;989;3149;1163;3795
220255;201511;1740;4931;1505;4527;69;282;1197;3435;1266;3717
220260;201511;4729;15112;4152;14026;340;1199;3073;10428;3413;11627
220265;201511;1333;4623;1204;4409;126;517;778;2888;904;3405
220270;201511;6694;21595;6426;21094;367;1703;5404;17117;5771;18820
220271;201511;1482;4143;1352;3940;95;244;1119;3322;1214;3566
220272;201511;1761;5367;1593;5069;60;251;1263;3948;1323;4199
220273;201511;1220;3543;1070;3272;98;312;777;2352;875;2664
220275;201511;2090;5349;1732;4910;32;133;1571;4376;1603;4509
220277;201511;2276;6350;2021;5950;95;309;1616;4716;1711;5025
220280;201511;1610;4305;1411;3962;102;363;1113;3033;1215;3396
220285;201511;1599;4303;1339;3942;24;107;1202;3549;1226;3656
220290;201511;6004;20220;5225;19131;507;2151;3890;14249;4397;16400
220300;201511;1929;6318;1724;6032;84;434;1385;4755;1469;5189
220310;201511;2389;8204;2231;8024;88;359;1934;7098;2022;7457
220320;201511;3232;9703;2746;8809;290;1029;1942;6191;2232;7220
220323;201511;1466;5219;1288;4954;149;630;974;3770;1123;4400
220325;201511;1180;3785;1011;3442;89;375;719;2420;808;2795
220327;201511;1327;4262;1210;4065;37;199;986;3220;1023;3419
220330;201511;3606;9868;3344;9539;137;384;2999;8621;3136;9005
220335;201511;1894;5723;1709;5506;53;165;1566;5104;1619;5269
220340;201511;1916;5293;1637;4874;121;380;1245;3686;1366;4066
220342;201511;1108;3700;1039;3593;70;300;826;2839;896;3139
220345;201511;2915;7507;2545;6938;70;165;2287;6249;2357;6414
220350;201511;3988;10557;3429;9669;214;627;2657;7447;2871;8074
220360;201511;1287;3600;1107;3310;110;366;833;2448;943;2814
220370;201511;9163;26377;8327;25262;392;1368;7359;22196;7751;23564
220375;201511;1530;4781;1422;4650;22;67;1356;4477;1378;4544
220380;201511;1393;3743;1174;3444;52;179;959;2761;1011;2940
220385;201511;836;2145;675;1885;17;64;547;1498;564;1562
220390;201511;9472;29210;8414;27266;2154;7291;3260;10701;5414;17992
220400;201511;1540;3626;1240;3162;41;145;1035;2542;1076;2687
220410;201511;1407;3957;1162;3596;98;380;883;2651;981;3031
220415;201511;876;2383;770;2242;58;175;552;1574;610;1749
220420;201511;2162;6250;1830;5588;88;262;1446;4412;1534;4674
220430;201511;2545;7292;2474;7196;154;507;2139;6170;2293;6677
220435;201511;1626;4845;1496;4623;47;182;1236;3775;1283;3957
220440;201511;2391;7898;2212;7656;147;554;1845;6300;1992;6854
220450;201511;2141;6581;1811;6105;410;1465;1053;3554;1463;5019
220455;201511;1314;4182;1222;4050;57;211;1097;3651;1154;3862
220460;201511;907;2462;837;2379;44;124;734;2070;778;2194
220465;201511;2365;7788;2133;7435;549;2025;1188;4182;1737;6207
220470;201511;3870;11504;3509;10894;210;689;2714;8313;2924;9002
220480;201511;2524;7182;2200;6703;159;455;1715;5244;1874;5699
220490;201511;2319;6624;2131;6381;68;257;1875;5555;1943;5812
220500;201511;3252;8780;2744;7916;106;464;2210;6172;2316;6636
220510;201511;2745;7943;2193;6983;100;390;1608;5054;1708;5444
220515;201511;1994;4831;1706;4452;168;408;1343;3545;1511;3953
220520;201511;5141;14082;4671;13443;139;419;4161;12021;4300;12440
220525;201511;1307;3678;1220;3546;52;179;1040;3001;1092;3180
220527;201511;1405;4295;1238;3950;144;484;890;2876;1034;3360
220530;201511;1238;3583;1096;3376;58;242;947;2842;1005;3084
220535;201511;888;2668;840;2607;91;300;621;1914;712;2214
220540;201511;3440;11158;3285;10916;144;621;2830;9309;2974;9930
220545;201511;1392;4666;1325;4539;168;638;956;3244;1124;3882
220550;201511;9186;29521;8534;28435;1017;3571;6115;20294;7132;23865
220551;201511;1437;4658;1316;4465;71;327;1056;3514;1127;3841
220552;201511;1600;4994;1381;4567;64;323;1051;3341;1115;3664
220553;201511;1612;4693;1312;4233;55;221;1013;3318;1068;3539
220554;201511;819;2360;717;2202;67;219;553;1698;620;1917
220555;201511;2298;6852;2131;6624;61;255;1916;5910;1977;6165
220556;201511;1448;4485;1283;4167;59;237;973;3082;1032;3319
220557;201511;1567;5077;1401;4752;166;592;933;3163;1099;3755
220558;201511;1060;3290;960;3116;63;287;735;2298;798;2585
220559;201511;1513;4292;1373;4050;33;107;1179;3464;1212;3571
220560;201511;1685;4161;1389;3750;71;188;1153;3073;1224;3261
220570;201511;7322;23589;6859;22759;1407;4650;4151;14164;5558;18814
220580;201511;6503;20624;6299;20334;316;1023;5647;18260;5963;19283
220585;201511;2024;7116;1904;6896;177;676;1499;5440;1676;6116
220590;201511;1342;3991;1199;3791;208;689;789;2553;997;3242
220595;201511;2318;6832;2157;6616;43;187;1949;5923;1992;6110
220600;201511;1294;3127;1051;2825;172;311;762;2209;934;2520
220605;201511;1970;5742;1683;5277;83;273;1355;4203;1438;4476
220610;201511;2690;8149;2579;7993;70;265;2329;7194;2399;7459
220620;201511;7567;25274;7291;24893;344;1652;6440;21658;6784;23310
220630;201511;402;1232;336;1109;55;185;179;596;234;781
220635;201511;1696;5957;1530;5592;91;441;1080;3863;1171;4304
220640;201511;2675;7781;2417;7414;128;446;2010;6109;2138;6555
220650;201511;2264;6566;2004;6104;133;465;1542;4639;1675;5104
220660;201511;2547;8089;2272;7719;166;771;1862;6123;2028;6894
220665;201511;1188;4032;1113;3897;27;138;994;3451;1021;3589
220667;201511;1732;5658;1629;5506;79;267;1355;4595;1434;4862
220669;201511;1877;6121;1763;5918;260;1068;1182;3859;1442;4927
220670;201511;2036;5993;1814;5710;147;383;1488;4830;1635;5213
220672;201511;2525;7214;2376;7039;233;688;1957;5850;2190;6538
220675;201511;1286;3695;1200;3544;82;209;941;2798;1023;3007
220680;201511;2276;7319;2141;7134;174;577;1762;5921;1936;6498
220690;201511;1689;4696;1462;4324;105;329;1150;3434;1255;3763
220695;201511;917;2588;836;2455;38;120;663;1928;701;2048
220700;201511;8686;24702;7555;22941;559;1921;5762;17330;6321;19251
220710;201511;824;2416;685;2173;39;120;505;1600;544;1720
220720;201511;2008;5389;1911;5264;55;167;1689;4624;1744;4791
220730;201511;1398;3951;1185;3617;29;132;1004;3014;1033;3146
220735;201511;1033;2633;832;2281;45;144;673;1811;718;1955
220740;201511;1373;4417;1203;4182;107;358;962;3426;1069;3784
220750;201511;3991;11418;3690;10957;416;1024;2851;8740;3267;9764
220755;201511;1231;3447;1104;3233;52;183;888;2554;940;2737
220760;201511;2665;9210;2452;8920;155;770;2022;7243;2177;8013
220770;201511;22459;73828;19791;68679;6502;23630;6571;23594;13073;47224
220775;201511;1254;3344;1212;3296;15;42;1177;3198;1192;3240
220777;201511;1631;4480;1432;4190;84;222;1123;3268;1207;3490
220779;201511;1333;3558;1276;3470;45;173;1140;3012;1185;3185
220780;201511;6000;15978;5286;14913;410;1143;4232;11991;4642;13134
220785;201511;1264;3332;1189;3201;51;140;1069;2850;1120;2990
220790;201511;10015;30820;9278;29664;794;2809;7364;23360;8158;26169
220793;201511;837;2387;763;2275;44;170;630;1854;674;2024
220795;201511;1462;4154;1403;4069;69;208;1275;3698;1344;3906
220800;201511;16407;44842;14727;42402;1046;3493;11067;31344;12113;34837
220810;201511;3364;9692;2888;8869;129;524;2291;6926;2420;7450
220820;201511;5419;14837;4936;14157;249;747;4299;12243;4548;12990
220830;201511;7546;21152;6984;20234;650;1906;5430;15789;6080;17695
220840;201511;14319;45126;12646;41721;3003;10122;5848;19596;8851;29718
220850;201511;2873;9849;2717;9652;129;550;2405;8570;2534;9120
220855;201511;642;1941;558;1792;38;158;409;1276;447;1434
220860;201511;960;2582;850;2410;38;139;704;1968;742;2107
220865;201511;2629;7248;2109;6330;79;372;1668;4829;1747;5201
220870;201511;2298;7622;2035;7263;82;353;1825;6496;1907;6849
220880;201511;4795;12943;4461;12548;109;299;4161;11761;4270;12060
220885;201511;1308;4694;1142;4385;100;472;846;3221;946;3693
220887;201511;1418;3495;1211;3204;20;72;1122;2942;1142;3014
220890;201511;1628;5632;1442;5268;129;479;1103;4103;1232;4582
220900;201511;1873;5339;1643;4923;63;179;1388;4148;1451;4327
220910;201511;1633;4878;1422;4562;53;166;1232;4016;1285;4182
220915;201511;1038;2910;877;2602;31;127;681;1950;712;2077
220920;201511;1358;4848;1227;4657;99;489;913;3383;1012;3872
220930;201511;1376;4553;1314;4458;58;253;1094;3700;1152;3953
220935;201511;1094;3324;953;3026;45;188;649;1968;694;2156
220937;201511;1541;4211;1294;3778;62;231;1001;2843;1063;3074
220940;201511;1379;4312;1272;4090;79;337;941;2961;1020;3298
220945;201511;437;1603;400;1532;36;160;286;1074;322;1234
220950;201511;1345;3339;969;2734;32;125;701;1910;733;2035
220955;201511;1480;4233;1288;3901;87;269;963;2903;1050;3172
220960;201511;904;2344;712;2025;19;64;560;1576;579;1640
220965;201511;1710;5061;1588;4877;65;310;1326;3939;1391;4249
220970;201511;2185;5767;1611;4841;152;473;1093;3309;1245;3782
220975;201511;663;2177;615;2107;30;155;558;1862;588;2017
220980;201511;1298;3914;1131;3630;89;329;826;2648;915;2977
220985;201511;1206;3542;1137;3441;88;333;865;2536;953;2869
220987;201511;1508;4766;1350;4496;83;369;1042;3368;1125;3737
220990;201511;1844;5299;1590;4882;44;220;1236;3697;1280;3917
220995;201511;1328;3831;968;3256;110;392;673;2317;783;2709
220997;201511;2241;6958;2115;6768;56;240;1958;6214;2014;6454
221000;201511;4280;13078;3965;12528;357;1316;3020;9415;3377;10731
221005;201511;1465;4577;1335;4327;518;1567;538;1879;1056;3446
221010;201511;1162;3095;982;2862;53;154;831;2408;884;2562
221020;201511;1793;5549;1664;5312;76;322;1225;3816;1301;4138
221030;201511;1510;4484;1353;4216;67;283;1107;3397;1174;3680
221035;201511;1450;4005;1356;3883;56;128;1248;3637;1304;3765
221037;201511;628;1853;560;1740;14;55;408;1209;422;1264
221038;201511;614;1716;497;1510;45;137;315;959;360;1096
221039;201511;915;2602;831;2480;53;209;676;1952;729;2161
221040;201511;4656;14324;4358;13832;215;753;3551;11305;3766;12058
221050;201511;3496;10675;3294;10398;180;655;2820;8853;3000;9508
221060;201511;8272;23984;7235;22316;676;2255;5361;16480;6037;18735
221062;201511;1292;4519;1192;4317;56;293;1001;3566;1057;3859
221063;201511;1057;3487;971;3317;237;759;541;1988;778;2747
221065;201511;2799;7665;2510;7192;149;420;2055;5826;2204;6246
221070;201511;3882;12177;3411;11375;169;653;2735;9123;2904;9776
221080;201511;3521;9103;2989;8372;117;365;2522;7024;2639;7389
221090;201511;1403;3849;1194;3507;38;162;986;2830;1024;2992
221093;201511;1663;4957;1564;4744;275;878;876;2582;1151;3460
221095;201511;958;2544;856;2392;22;60;730;2032;752;2092
221097;201511;798;2256;647;1984;42;167;448;1320;490;1487
221100;201511;116170;336840;105310;318478;20533;65545;62219;185036;82752;250581
221110;201511;10164;32129;9485;31274;448;1890;7964;25891;8412;27781
221120;201511;4001;13041;3770;12628;752;2639;2389;8008;3141;10647
221130;201511;4637;13360;3876;11808;1163;3559;1684;5172;2847;8731
221135;201511;1521;4652;1397;4478;112;412;1156;3659;1268;4071
221140;201511;1339;3290;1209;3115;44;113;1054;2689;1098;2802
221150;201511;1215;3110;983;2707;29;125;777;2082;806;2207
221160;201511;841;2209;781;2117;39;108;615;1665;654;1773
221170;201511;1150;3553;1063;3406;56;193;856;2734;912;2927
230010;201511;3303;9037;2691;7982;244;848;2010;5811;2254;6659
230015;201511;2916;10060;2722;9629;403;1609;1640;5696;2043;7305
230020;201511;13762;44837;13300;44038;776;2915;11149;36842;11925;39757
230030;201511;12060;34710;10902;32894;539;1874;8862;26520;9401;28394
230040;201511;4633;12619;3886;11347;332;1126;2758;7913;3090;9039
230050;201511;2636;9011;2065;7488;427;1621;753;2736;1180;4357
230060;201511;2185;6297;1872;5731;83;315;1401;4221;1484;4536
230070;201511;4392;12024;3719;10928;357;1196;2492;7334;2849;8530
230075;201511;8802;31495;8215;30300;603;3094;6313;22620;6916;25714
230080;201511;2434;6374;1971;5694;106;362;1604;4608;1710;4970
230090;201511;3805;11076;3352;10292;455;1608;2308;7037;2763;8645
230100;201511;16793;49825;15321;47148;2575;8572;9066;28028;11641;36600
230110;201511;13217;42011;12060;39523;2332;7968;6473;20980;8805;28948
230120;201511;7980;21978;6822;20250;800;2274;4529;14196;5329;16470
230125;201511;3029;8780;2475;7753;177;639;1796;5552;1973;6191
230130;201511;5956;19242;4982;17168;445;1749;3373;11440;3818;13189
230140;201511;3586;11375;3034;10370;368;1357;2010;6944;2378;8301
230150;201511;1715;5346;1467;4834;294;1050;781;2506;1075;3556
230160;201511;6330;18776;5602;17642;311;1249;4448;13824;4759;15073
230170;201511;6457;20102;5498;18262;371;1430;3884;12713;4255;14143
230180;201511;1771;5172;1554;4740;100;410;1111;3234;1211;3644
230185;201511;4059;13174;3658;12422;610;2143;2225;7768;2835;9911
230190;201511;12938;41056;11275;37629;2302;8383;5357;17611;7659;25994
230195;201511;5206;15893;4551;14767;361;1454;3445;10833;3806;12287
230200;201511;5294;15140;4742;14074;424;1338;3480;10236;3904;11574
230205;201511;4238;13539;3766;12713;252;1111;2673;8863;2925;9974
230210;201511;9019;25810;7802;23890;1556;4811;4406;13804;5962;18615
230220;201511;13199;37649;11844;35279;1171;3910;8443;24674;9614;28584
230230;201511;7497;23948;6770;22506;974;3273;4319;14520;5293;17793
230240;201511;13810;38899;12096;35961;607;2219;9447;27526;10054;29745
230250;201511;9902;30640;9765;30420;599;2227;7608;23283;8207;25510
230260;201511;14503;48299;13415;46094;2301;8454;7444;26046;9745;34500
230270;201511;7526;22153;6465;20322;745;2614;4200;13272;4945;15886
230280;201511;19760;58276;17550;54494;1840;5865;12627;39208;14467;45073
230290;201511;4881;14718;4113;13156;569;1782;2712;8705;3281;10487
230300;201511;4413;13333;4199;13021;281;1055;3391;10370;3672;11425
230310;201511;4857;14393;4222;13313;246;1008;3052;9430;3298;10438
230320;201511;7050;22100;6427;20980;473;1880;4692;15104;5165;16984
230330;201511;4779;13979;4074;12599;334;1137;2850;8682;3184;9819
230340;201511;3337;11287;3026;10598;385;1499;1914;6556;2299;8055
230350;201511;18184;55051;16439;52063;2064;7367;9585;30741;11649;38108
230360;201511;3308;9403;2678;8228;254;878;1743;5256;1997;6134
230365;201511;3029;8178;2630;7502;136;506;2074;5833;2210;6339
230370;201511;54519;173790;48512;163188;12982;45930;21111;72968;34093;118898
230380;201511;6519;19110;5475;17165;338;1134;3857;12056;4195;13190
230390;201511;3529;11086;3105;10343;250;1083;2183;7112;2433;8195
230393;201511;3303;10774;2786;9705;209;1008;1974;6602;2183;7610
230395;201511;5568;16408;4948;15312;799;2498;2942;9345;3741;11843
230400;201511;5430;16505;4727;15375;289;1280;3612;11475;3901;12755
230410;201511;14357;45673;12451;41595;1776;6323;7506;25042;9282;31365
230420;201511;24184;77944;21850;73174;4969;17928;9991;33168;14960;51096
230423;201511;4175;13766;3842;13088;262;1097;2873;9671;3135;10768
230425;201511;5626;18570;5112;17398;723;2545;3254;11116;3977;13661
230426;201511;2734;7607;2171;6531;85;354;1596;4666;1681;5020
230427;201511;1835;5448;1358;4394;189;615;768;2410;957;3025
230428;201511;8708;27022;8254;26161;1329;4664;4805;14987;6134;19651
230430;201511;4589;14542;4209;13815;327;1331;3024;9674;3351;11005
230435;201511;4869;15553;4353;14592;790;3058;2308;7549;3098;10607
230440;201511;353126;1045454;319899;986467;76416;246781;145677;451581;222093;698362
230445;201511;4574;12305;3829;11180;288;830;2702;7913;2990;8743
230450;201511;3584;11336;3078;10384;375;1602;1987;6503;2362;8105
230460;201511;1902;6277;1653;5817;175;705;1125;3918;1300;4623
230465;201511;4123;12258;3449;11025;256;1065;2265;7016;2521;8081
230470;201511;10807;39417;9953;37588;1326;5486;6699;25279;8025;30765
230480;201511;1464;4607;1235;4172;161;612;804;2677;965;3289
230490;201511;2368;7208;2035;6560;342;1178;977;3032;1319;4210
230495;201511;5850;19205;5192;18051;736;3054;2799;9588;3535;12642
230500;201511;9348;32741;8882;31836;658;2861;6646;23719;7304;26580
230510;201511;1509;5327;1155;4413;312;1304;354;1344;666;2648
230520;201511;4911;14940;4360;13912;474;1728;2787;8753;3261;10481
230523;201511;14693;47514;12686;42898;2922;10812;3182;10820;6104;21632
230526;201511;4218;12402;3538;11220;226;956;2685;8316;2911;9272
230530;201511;5449;17457;4875;16682;976;3437;3089;10906;4065;14343
230533;201511;4009;11174;3493;10204;316;906;2609;7670;2925;8576
230535;201511;5609;16460;4881;15162;740;2289;2909;9337;3649;11626
230540;201511;17780;51704;15970;48821;770;2968;13067;39341;13837;42309
230550;201511;19545;58008;17385;53863;3309;11086;8880;26831;12189;37917
230560;201511;6674;19235;5862;17771;235;955;4499;13337;4734;14292
230565;201511;3455;9537;2796;8300;130;476;2043;5996;2173;6472
230570;201511;3699;10052;3267;9514;124;482;2722;7821;2846;8303
230580;201511;10044;30423;9298;29348;549;2011;7929;24928;8478;26939
230590;201511;9037;28079;7746;25614;592;2507;5470;17527;6062;20034
230600;201511;3763;10426;2910;8732;148;521;1897;5650;2045;6171
230610;201511;6078;19491;5608;18728;799;2724;3810;12914;4609;15638
230620;201511;2178;6205;1707;5177;208;690;952;2791;1160;3481
230625;201511;8092;25917;7166;23817;2054;7386;2118;6918;4172;14304
230630;201511;11004;34898;10007;33038;2627;8146;4662;16498;7289;24644
230640;201511;25924;84462;23866;81341;2658;10006;17776;60410;20434;70416
230650;201511;4974;15158;4457;14165;316;1268;3371;10417;3687;11685
230655;201511;9154;34379;8751;33655;819;3479;6807;26352;7626;29831
230660;201511;6209;19316;5273;17556;371;1637;3914;12706;4285;14343
230670;201511;6224;16471;4883;14163;199;705;3744;10499;3943;11204
230680;201511;2829;8265;2367;7376;385;1264;1354;4202;1739;5466
230690;201511;6341;20534;6151;20137;614;2334;3990;12761;4604;15095
230700;201511;9377;26393;8321;24532;739;2596;5767;16422;6506;19018
230710;201511;7529;24434;6504;22489;713;2544;4522;15710;5235;18254
230720;201511;1889;5919;1592;5301;211;737;932;3084;1143;3821
230725;201511;3736;12605;3172;11163;772;2780;1092;3795;1864;6575
230730;201511;57560;172819;47414;155637;13052;47782;12004;40492;25056;88274
230740;201511;6038;18082;5468;17118;247;1001;4304;13230;4551;14231
230750;201511;8511;24406;7229;22297;448;1633;5461;16585;5909;18218
230760;201511;10556;31298;9741;29659;1080;3858;6731;19682;7811;23540
230763;201511;4293;13133;3837;12262;198;911;2901;8921;3099;9832
230765;201511;38923;122364;34440;113283;8923;31500;10727;35458;19650;66958
230770;201511;25034;69220;22580;65736;2995;9189;14756;42929;17751;52118
230780;201511;5957;22920;5676;22269;1405;5704;2713;11098;4118;16802
230790;201511;2757;8823;2525;8414;268;1005;1834;6109;2102;7114
230800;201511;7566;26714;6793;24978;1513;5946;2945;10673;4458;16619
230810;201511;12015;38912;11295;37665;919;3334;8751;29114;9670;32448
230820;201511;3345;11441;2901;10442;431;1771;1595;5628;2026;7399
230830;201511;7544;22824;6620;21093;550;2058;4746;14938;5296;16996
230835;201511;4030;10659;3286;9534;221;704;2505;7217;2726;7921
230837;201511;3189;10775;2754;9896;320;1365;1803;6320;2123;7685
230840;201511;9189;29799;8383;28393;744;2887;6239;21167;6983;24054
230850;201511;9799;30217;9046;28961;1072;3575;6199;19896;7271;23471
230860;201511;5246;14928;4596;13891;253;923;3692;11057;3945;11980
230870;201511;19038;49781;16318;45688;802;2555;12466;34620;13268;37175
230880;201511;1955;6625;1837;6384;159;711;1252;4256;1411;4967
230890;201511;3923;14320;3608;13614;458;2091;2260;8253;2718;10344
230900;201511;2955;9797;2486;8791;536;1840;1146;4159;1682;5999
230910;201511;3199;9333;2573;8201;213;924;1820;5611;2033;6535
230920;201511;4734;13690;4377;13230;309;1167;3560;10680;3869;11847
230930;201511;7414;22233;6490;20472;660;2199;4308;13593;4968;15792
230940;201511;7842;22252;6793;20611;345;1155;5405;16430;5750;17585
230945;201511;6208;18589;5306;17187;460;1672;3629;11932;4089;13604
230950;201511;6458;17714;5824;16860;267;760;4924;14529;5191;15289
230960;201511;14243;43608;12906;41051;2549;8535;5904;18909;8453;27444
230970;201511;13571;41413;11813;38067;2373;8398;5210;16402;7583;24800
230980;201511;2987;9342;2598;8623;732;2423;1187;4145;1919;6568
230990;201511;1748;5198;1453;4619;127;526;918;2800;1045;3326
231000;201511;2784;7525;2166;6317;158;543;1384;3906;1542;4449
231010;201511;3200;8685;2592;7669;277;895;1722;4941;1999;5836
231020;201511;7936;26492;7469;25482;1328;4540;4506;15670;5834;20210
231025;201511;8041;24468;7266;23151;1002;3317;4690;15169;5692;18486
231030;201511;7761;25079;6499;22436;1173;4346;3523;12118;4696;16464
231040;201511;3166;10107;2799;9367;175;768;2000;6503;2175;7271
231050;201511;12070;34149;10152;30687;817;2726;7434;22243;8251;24969
231060;201511;2418;7813;2214;7434;162;763;1565;5070;1727;5833
231070;201511;8808;27816;7973;26117;1307;4546;4548;14943;5855;19489
231080;201511;4083;12716;3696;12042;199;994;2826;8799;3025;9793
231085;201511;4783;14848;4568;14548;741;2315;3079;10131;3820;12446
231090;201511;4137;11596;3288;9877;179;633;2285;6756;2464;7389
231095;201511;2336;7482;1983;6760;225;863;1285;4351;1510;5214
231100;201511;3230;9919;2672;8812;217;837;1891;6170;2108;7007
231110;201511;3604;11970;3537;11848;363;1400;2396;7957;2759;9357
231120;201511;2103;7024;1963;6721;300;1114;1228;4215;1528;5329
231123;201511;2108;5774;1789;5213;140;402;1380;3997;1520;4399
231126;201511;6318;17845;5269;16099;319;1234;3849;11546;4168;12780
231130;201511;19322;59008;17283;55561;3480;11555;9765;32756;13245;44311
231135;201511;4271;12639;3577;11400;290;1012;2496;7889;2786;8901
231140;201511;16901;53180;14805;49179;1282;5629;9660;30940;10942;36569
231150;201511;5933;16895;4972;15122;802;2583;2491;7541;3293;10124
231160;201511;5782;19133;5390;18351;901;3106;3271;11207;4172;14313
231170;201511;4285;13741;3831;12801;304;1269;2643;8566;2947;9835
231180;201511;14118;41940;12618;38935;2136;7065;7115;21511;9251;28576
231190;201511;4619;12970;3884;11831;259;923;2950;8788;3209;9711
231195;201511;4627;15459;3919;14017;421;1863;2654;9313;3075;11176
231200;201511;7800;26596;6764;24416;461;2330;4748;16637;5209;18967
231210;201511;5052;15684;4354;14699;291;1385;3367;11181;3658;12566
231220;201511;12112;34891;10606;32095;623;2345;7792;23040;8415;25385
231230;201511;9170;30663;8334;29348;804;3385;6092;21378;6896;24763
231240;201511;12291;38368;10953;35671;2341;7879;5155;16971;7496;24850
231250;201511;1982;5738;1361;4206;431;1310;298;911;729;2221
231260;201511;3573;10495;3197;9902;544;1671;1923;6072;2467;7743
231270;201511;7328;20132;6424;18701;345;1404;4812;13613;5157;15017
231280;201511;1751;5715;1623;5463;178;633;1107;3749;1285;4382
231290;201511;33242;113275;29819;105364;6421;25217;12080;41533;18501;66750
231300;201511;4601;13242;3693;11447;254;980;2510;7511;2764;8491
231310;201511;7515;21277;6166;18473;932;2849;3415;10031;4347;12880
231320;201511;7033;21470;5931;19283;326;1385;4204;13536;4530;14921
231325;201511;2718;8072;2362;7489;313;1026;1533;4944;1846;5970
231330;201511;12461;39214;10593;35468;1655;5573;6290;21271;7945;26844
231335;201511;5372;15310;4597;13889;215;888;3556;10464;3771;11352
231340;201511;17574;57572;16116;55325;1151;3995;12715;44424;13866;48419
231350;201511;13336;41500;12789;40700;1092;3329;10730;34656;11822;37985
231355;201511;4415;14102;4078;13535;299;1216;2991;9790;3290;11006
231360;201511;7862;24892;6955;23271;1291;4342;4141;14239;5432;18581
231370;201511;2476;6848;1924;5937;86;271;1421;4383;1507;4654
231375;201511;4183;14293;3881;13722;239;1122;3059;10647;3298;11769
231380;201511;5267;16631;4951;16200;614;2080;3409;11474;4023;13554
231390;201511;3473;10833;3185;10343;283;994;2211;7127;2494;8121
231395;201511;3863;12561;3469;11824;623;2127;1921;6606;2544;8733
231400;201511;9124;27990;8482;26699;575;2210;6227;19299;6802;21509
231410;201511;13964;47432;12796;45622;1326;4905;9591;34514;10917;39419
240010;201511;2461;7360;2037;6477;360;1263;984;3028;1344;4291
240020;201511;10766;33695;9508;31258;2090;7319;4521;14888;6611;22207
240030;201511;2454;7087;2379;6967;139;490;2003;5737;2142;6227
240040;201511;824;2453;676;2148;26;128;485;1458;511;1586
240050;201511;3464;9356;2935;8441;121;411;2336;6599;2457;7010
240060;201511;1397;4014;1243;3715;60;232;983;2828;1043;3060
240070;201511;2599;7544;2413;7173;393;1225;1567;4579;1960;5804
240080;201511;3066;8206;2631;7623;209;606;2001;5767;2210;6373
240090;201511;2335;6256;1886;5449;43;155;1458;4092;1501;4247
240100;201511;8265;23602;7354;21720;659;2154;5245;15099;5904;17253
240110;201511;4880;15182;4316;14048;684;2511;2372;7396;3056;9907
240120;201511;2687;9189;2553;8917;389;1479;1592;5513;1981;6992
240130;201511;2813;7553;2399;6919;126;436;1908;5378;2034;5814
240140;201511;2247;6706;1908;6086;317;1189;1060;3232;1377;4421
240145;201511;5817;18329;5223;17250;1452;5001;2441;8265;3893;13266
240150;201511;984;3003;802;2613;80;323;515;1606;595;1929
240160;201511;1443;4634;1241;4271;159;594;763;2696;922;3290
240165;201511;904;2854;789;2608;128;380;468;1639;596;2019
240170;201511;2389;7146;2075;6564;503;1752;936;2882;1439;4634
240180;201511;2622;8298;2331;7708;467;1653;1275;4277;1742;5930
240185;201511;1442;4759;1347;4598;97;349;1053;3617;1150;3966
240190;201511;964;3031;862;2852;48;222;636;2063;684;2285
240200;201511;13817;35969;11368;32508;2597;7651;5058;14800;7655;22451
240210;201511;2899;8092;2621;7681;191;671;2105;6046;2296;6717
240220;201511;7333;24474;6851;23754;652;2977;5136;17357;5788;20334
240230;201511;5685;15081;4934;13903;168;527;4150;11650;4318;12177
240240;201511;1850;5585;1249;4098;270;982;234;659;504;1641
240250;201511;2673;7772;2508;7549;121;399;2137;6394;2258;6793
240260;201511;12354;41509;11634;40298;1900;7324;7312;25217;9212;32541
240270;201511;2247;7175;2063;6868;197;670;1574;5309;1771;5979
240280;201511;1583;4410;1378;4101;85;303;1096;3227;1181;3530
240290;201511;1307;4130;1143;3813;66;334;728;2276;794;2610
240300;201511;2258;6259;1636;4933;355;1150;604;1757;959;2907
240310;201511;9632;27394;8716;25925;1285;4245;4786;14304;6071;18549
240320;201511;2051;6068;1603;5139;61;265;1173;3595;1234;3860
240325;201511;35243;96739;27498;84090;8541;27965;6448;20040;14989;48005
240330;201511;1508;4556;1260;4030;75;293;823;2530;898;2823
240340;201511;2007;5375;1695;4872;201;615;1196;3400;1397;4015
240350;201511;1936;5706;1806;5541;126;442;1546;4728;1672;5170
240360;201511;7206;21527;6279;20120;1303;4455;3307;10850;4610;15305
240370;201511;1989;5497;1606;4792;230;668;941;2839;1171;3507
240375;201511;851;2304;739;2115;115;377;456;1220;571;1597
240380;201511;2462;7339;1888;6034;250;835;952;3001;1202;3836
240390;201511;936;2583;778;2287;42;161;555;1567;597;1728
240400;201511;1344;3677;1102;3234;92;325;762;2155;854;2480
240410;201511;510;1662;453;1545;83;336;256;835;339;1171
240420;201511;4540;17436;4266;16798;930;4035;2229;8786;3159;12821
240430;201511;3275;9232;2976;8687;148;581;2339;6580;2487;7161
240440;201511;2544;6632;2257;6182;650;1796;1068;2915;1718;4711
240450;201511;3827;11353;3283;10301;312;1287;2058;6086;2370;7373
240460;201511;2913;8932;2747;8707;182;789;2239;6876;2421;7665
240470;201511;3620;11253;2871;9627;811;2612;1296;4427;2107;7039
240480;201511;512;1357;393;1124;38;120;210;578;248;698
240485;201511;2018;6274;1764;5795;301;1059;1022;3380;1323;4439
240490;201511;1671;4261;1405;3857;39;147;1165;3114;1204;3261
240500;201511;2133;6125;1927;5808;133;463;1500;4478;1633;4941
240510;201511;1791;5324;1655;5101;149;497;1301;3994;1450;4491
240520;201511;1244;3634;1118;3421;122;434;814;2422;936;2856
240530;201511;2031;6475;1842;6170;402;1385;1130;3795;1532;5180
240540;201511;1682;5117;1608;4992;126;423;1306;4032;1432;4455
240550;201511;821;2331;710;2144;42;146;538;1590;580;1736
240560;201511;3165;9245;2945;8896;376;1133;2150;6493;2526;7626
240570;201511;3110;8709;2317;6923;534;1734;822;2170;1356;3904
240580;201511;7574;23838;7021;22833;838;3028;5237;16779;6075;19807
240590;201511;789;2229;683;2030;34;130;510;1470;544;1600
240600;201511;1629;4785;1277;4037;159;571;705;2130;864;2701
240610;201511;4709;13407;4052;12157;497;1616;2528;7376;3025;8992
240615;201511;1043;3055;835;2645;167;556;453;1390;620;1946
240620;201511;1755;5491;1559;5162;208;651;1109;3749;1317;4400
240630;201511;2056;6255;1867;5933;185;501;1288;4233;1473;4734
240640;201511;898;2596;755;2353;54;251;521;1546;575;1797
240650;201511;3819;11466;3428;10896;197;713;2731;8637;2928;9350
240660;201511;2415;7685;2261;7459;211;762;1731;5685;1942;6447
240670;201511;2704;8019;2214;6972;298;989;1223;3790;1521;4779
240680;201511;1511;4420;1215;3877;111;385;760;2391;871;2776
240690;201511;945;2627;815;2404;52;194;656;1878;708;2072
240700;201511;2673;7954;2201;7057;86;392;1679;5258;1765;5650
240710;201511;18953;49426;16312;45498;3089;8528;9224;26178;12313;34706
240720;201511;5258;14985;4739;14009;1532;4664;1964;5587;3496;10251
240725;201511;1051;3167;832;2662;73;242;486;1519;559;1761
240730;201511;2168;6515;1857;5929;128;452;1367;4340;1495;4792
240740;201511;1994;5838;1767;5415;158;615;1249;3675;1407;4290
240750;201511;2170;8114;2000;7782;500;2129;924;3585;1424;5714
240760;201511;1331;3631;1120;3343;106;247;830;2652;936;2899
240770;201511;3159;9015;2817;8537;173;687;2300;6844;2473;7531
240780;201511;6338;17259;4946;15037;861;2624;2606;8051;3467;10675
240790;201511;885;2694;728;2418;41;157;498;1673;539;1830
240800;201511;35939;102926;31640;95507;7721;24148;12882;39256;20603;63404
240810;201511;86100;247762;79080;235496;21062;64285;36639;110557;57701;174842
240820;201511;6552;19760;5632;18266;1353;4737;2306;7747;3659;12484
240830;201511;8632;26827;8055;25957;425;1753;6742;21417;7167;23170
240840;201511;1260;3486;1048;3143;92;295;656;1893;748;2188
240850;201511;1303;3848;940;3009;143;481;456;1432;599;1913
240860;201511;1325;3748;1076;3298;54;200;814;2411;868;2611
240870;201511;1199;3280;968;2849;87;288;594;1665;681;1953
240880;201511;1138;3839;1069;3718;98;432;838;2822;936;3254
240890;201511;5110;14486;4263;12871;923;2924;1808;5301;2731;8225
240895;201511;2622;9057;2396;8641;280;1104;1676;6089;1956;7193
240910;201511;2809;8527;2484;7896;177;661;1866;5867;2043;6528
240920;201511;787;2522;676;2276;131;506;313;1012;444;1518
240930;201511;3464;9058;3048;8550;162;454;2483;7042;2645;7496
240933;201511;1380;3965;1227;3718;110;393;903;2664;1013;3057
240940;201511;6495;17578;5236;15386;909;2637;2903;8546;3812;11183
240950;201511;991;3222;932;3117;64;299;705;2272;769;2571
240960;201511;789;2444;692;2252;75;252;477;1566;552;1818
240970;201511;1961;5411;1637;4863;120;431;1224;3501;1344;3932
240980;201511;3059;9988;2806;9508;514;1822;1681;5681;2195;7503
240990;201511;2874;8502;2667;8072;457;1485;1582;4702;2039;6187
241000;201511;1065;2960;903;2671;47;173;632;1833;679;2006
241010;201511;2918;9742;2677;9257;340;1442;1831;6104;2171;7546
241020;201511;2072;5771;1657;4940;156;477;1050;3033;1206;3510
241025;201511;1634;4964;1452;4624;85;382;1019;3145;1104;3527
241030;201511;2520;8283;2241;7740;218;930;1604;5468;1822;6398
241040;201511;2248;7690;2052;7328;200;829;1428;5137;1628;5966
241050;201511;1256;3739;1100;3456;65;267;832;2543;897;2810
241060;201511;883;2548;791;2386;57;177;579;1728;636;1905
241070;201511;820;2332;730;2169;69;240;515;1474;584;1714
241080;201511;1179;3471;970;3064;41;182;707;2186;748;2368
241090;201511;2168;6392;1823;5769;135;603;1367;4219;1502;4822
241100;201511;1198;3564;1027;3156;104;330;668;2037;772;2367
241105;201511;1212;3660;1077;3411;236;771;526;1715;762;2486
241110;201511;826;2563;677;2243;53;222;418;1349;471;1571
241120;201511;7365;22423;6636;21243;1486;4729;3682;12222;5168;16951
241140;201511;3429;9417;2937;8418;329;928;1999;5655;2328;6583
241142;201511;725;2164;530;1723;136;507;187;562;323;1069
241150;201511;5483;16200;4868;15134;579;1898;3234;10003;3813;11901
241160;201511;1003;2911;905;2736;142;432;568;1711;710;2143
241170;201511;1169;3438;1078;3278;101;307;826;2510;927;2817
241180;201511;936;2628;761;2298;97;314;391;1141;488;1455
241190;201511;1212;3320;968;2836;65;233;602;1678;667;1911
241200;201511;19285;56026;16946;52219;4090;13423;7292;22693;11382;36116
241210;201511;1480;4141;1172;3494;176;602;621;1772;797;2374
241220;201511;7889;25995;7306;24872;1789;6360;3680;12703;5469;19063
241230;201511;3026;8865;2753;8450;167;646;2291;6886;2458;7532
241240;201511;1202;3545;790;2551;93;328;339;1102;432;1430
241250;201511;5974;18458;4993;16534;228;1226;3814;12141;4042;13367
241255;201511;1679;6424;1545;6094;364;1570;732;2880;1096;4450
241260;201511;5124;13830;4103;12214;212;876;3018;8749;3230;9625
241270;201511;1847;5694;1617;5219;130;498;1081;3423;1211;3921
241280;201511;1865;5394;1699;5070;202;615;1190;3529;1392;4144
241290;201511;3071;8613;2571;7727;278;901;1716;5092;1994;5993
241300;201511;1455;4170;1255;3813;60;196;895;2724;955;2920
241310;201511;1599;4825;1468;4596;135;477;1077;3334;1212;3811
241320;201511;923;3153;834;2963;122;494;505;1766;627;2260
241330;201511;1455;4519;1348;4374;105;440;1106;3511;1211;3951
241335;201511;2724;8281;2507;7881;155;542;2061;6418;2216;6960
241340;201511;1861;5760;1582;5143;380;1350;678;2103;1058;3453
241350;201511;1944;6152;1750;5783;146;616;1291;4111;1437;4727
241355;201511;1401;3942;1142;3504;59;213;916;2779;975;2992
241360;201511;2048;5577;1690;4883;72;211;1242;3473;1314;3684
241370;201511;1350;4087;1100;3571;139;510;631;1989;770;2499
241380;201511;668;1891;562;1676;89;276;325;957;414;1233
241390;201511;2736;9047;2542;8699;296;1168;1848;6272;2144;7440
241400;201511;3760;10937;3428;10492;416;1389;2508;7679;2924;9068
241410;201511;2549;7685;2279;7283;514;1753;1215;3847;1729;5600
241415;201511;1690;5058;1515;4774;97;363;1192;3682;1289;4045
241420;201511;2296;7905;1982;7351;624;2540;478;1700;1102;4240
241430;201511;580;1721;449;1417;50;173;251;751;301;924
241440;201511;6237;22458;5862;21827;1140;4432;3803;14357;4943;18789
241445;201511;1039;3002;986;2937;92;224;792;2516;884;2740
241450;201511;3166;8562;2751;7962;328;1040;1875;5343;2203;6383
241460;201511;3410;9957;3001;9136;263;930;2123;6286;2386;7216
241470;201511;1357;3834;1127;3527;160;556;725;2233;885;2789
241475;201511;1234;3728;1009;3260;40;178;770;2392;810;2570
241480;201511;2787;9234;2543;8802;1012;3650;632;2327;1644;5977
241490;201511;665;1757;565;1610;38;105;350;968;388;1073
241500;201511;772;2453;655;2265;51;230;481;1617;532;1847
250010;201511;2743;8585;2340;7688;137;576;1724;5523;1861;6099
250020;201511;1668;4778;1271;4049;87;361;824;2501;911;2862
250030;201511;6933;20216;6506;19610;528;1663;5271;15824;5799;17487
250040;201511;4253;14083;3896;13304;632;2218;2377;8130;3009;10348
250050;201511;3413;10810;3213;10515;452;1557;2188;7107;2640;8664
250053;201511;1242;3705;1139;3565;148;484;778;2468;926;2952
250057;201511;642;2672;629;2658;12;22;597;2601;609;2623
250060;201511;5082;15209;4750;14714;412;1498;3758;11452;4170;12950
250070;201511;3955;12305;3671;11819;169;783;2877;8936;3046;9719
250073;201511;756;2325;667;2168;45;181;532;1698;577;1879
250077;201511;2148;6291;1805;5742;192;642;1166;3743;1358;4385
250080;201511;4163;12116;3983;11817;368;1126;3037;8844;3405;9970
250090;201511;2552;7444;2429;7239;97;297;2000;5877;2097;6174
250100;201511;3858;12729;3634;12311;354;1314;2767;9241;3121;10555
250110;201511;5214;15585;4933;15175;478;1722;3873;11713;4351;13435
250115;201511;531;1710;462;1559;32;166;306;963;338;1129
250120;201511;1984;5974;1721;5451;103;367;1318;4143;1421;4510
250130;201511;5217;16393;4830;15749;234;979;4035;13050;4269;14029
250135;201511;1063;3244;965;3064;67;238;724;2306;791;2544
250140;201511;2000;6707;1910;6561;171;716;1472;5049;1643;5765
250150;201511;5063;16943;4585;16036;337;1472;3345;11503;3682;12975
250153;201511;1426;3911;1252;3655;51;228;1062;3019;1113;3247
250157;201511;1727;5687;1583;5392;172;680;1155;3900;1327;4580
250160;201511;3221;9757;3092;9565;139;516;2800;8626;2939;9142
250170;201511;1503;4530;1378;4335;216;726;937;2969;1153;3695
250180;201511;15676;46318;14790;44910;1443;5223;10882;32105;12325;37328
250190;201511;4186;12049;3795;11423;632;1941;2283;6765;2915;8706
250200;201511;2036;5933;1703;5443;112;436;1384;4372;1496;4808
250205;201511;875;3013;815;2899;52;262;602;2106;654;2368
250210;201511;1450;4894;1351;4738;119;479;1002;3426;1121;3905
250215;201511;1383;4534;1306;4416;109;448;861;2872;970;3320
250220;201511;738;2209;656;2101;41;165;549;1733;590;1898
250230;201511;1593;4024;1333;3594;68;224;1080;2795;1148;3019
250240;201511;2312;7759;2187;7527;125;485;1744;5997;1869;6482
250250;201511;4253;12912;3925;12469;199;691;3374;10753;3573;11444
250260;201511;1690;5201;1478;4874;80;322;1152;3787;1232;4109
250270;201511;1248;3919;1132;3773;101;343;867;2963;968;3306
250280;201511;3600;10733;3185;10065;417;1310;2282;7279;2699;8589
250290;201511;1954;5170;1654;4785;42;169;1476;4256;1518;4425
250300;201511;5453;15915;5153;15552;610;2533;4109;11763;4719;14296
250310;201511;1182;3595;1043;3376;94;347;797;2545;891;2892
250320;201511;7973;24380;7563;23629;938;3284;5191;15785;6129;19069
250330;201511;2464;7688;2114;7170;171;712;1596;5318;1767;6030
250340;201511;1096;3278;984;3093;39;146;830;2585;869;2731
250350;201511;4202;11682;3741;11122;154;537;3224;9603;3378;10140
250355;201511;1894;6074;1743;5858;81;402;1489;4890;1570;5292
250360;201511;1845;5472;1737;5315;71;193;1486;4594;1557;4787
250370;201511;11608;33953;10491;32718;899;2915;8940;28016;9839;30931
250375;201511;1099;3351;1012;3220;38;144;867;2754;905;2898
250380;201511;1689;4811;1589;4685;102;395;1348;3894;1450;4289
250390;201511;1924;5167;1535;4509;177;504;1027;3027;1204;3531
250400;201511;71638;190246;56052;165125;14147;43791;22618;67224;36765;111015
250403;201511;1521;4976;1402;4809;226;876;857;2855;1083;3731
250407;201511;1187;3382;1034;3129;73;233;747;2200;820;2433
250410;201511;548;1799;509;1723;32;159;402;1319;434;1478
250415;201511;1775;5442;1600;5127;102;341;1199;3802;1301;4143
250420;201511;1251;3733;1143;3573;36;147;1005;3101;1041;3248
250430;201511;6071;16785;5686;16210;309;1052;4706;13147;5015;14199
250435;201511;1358;4163;1227;3925;143;525;845;2668;988;3193
250440;201511;4341;12708;4020;12242;184;555;3355;10200;3539;10755
250450;201511;1974;5622;1768;5342;78;281;1494;4432;1572;4713
250460;201511;6414;19288;5967;18664;629;2039;4567;14476;5196;16515
250470;201511;1545;4230;1318;3908;147;510;879;2479;1026;2989
250480;201511;3721;11299;3466;10937;111;477;3054;9582;3165;10059
250485;201511;678;1694;553;1500;30;98;445;1164;475;1262
250490;201511;3749;11940;3655;11807;842;2757;2367;7709;3209;10466
250500;201511;1759;5332;1566;5019;318;977;983;3256;1301;4233
250510;201511;4728;13553;4220;12799;178;631;3657;11080;3835;11711
250520;201511;1719;5237;1608;5044;236;799;966;2953;1202;3752
250523;201511;1558;5043;1503;4957;240;870;1022;3332;1262;4202
250527;201511;1380;4185;1312;4102;25;121;1202;3700;1227;3821
250530;201511;642;1939;545;1820;26;79;475;1617;501;1696
250535;201511;1303;4095;1231;3950;53;231;994;3113;1047;3344
250540;201511;2379;6923;2216;6736;50;220;1961;5840;2011;6060
250550;201511;899;2983;809;2842;53;244;631;2174;684;2418
250560;201511;1659;5217;1610;5145;97;404;1402;4398;1499;4802
250570;201511;2649;8403;2316;7751;155;661;1743;5696;1898;6357
250580;201511;1133;3017;959;2741;91;326;740;2037;831;2363
250590;201511;886;2765;829;2695;82;331;674;2133;756;2464
250600;201511;7256;21073;6788;20404;743;2099;5188;15772;5931;17871
250610;201511;3086;9054;2849;8692;280;933;2114;6405;2394;7338
250620;201511;694;2035;614;1873;113;359;355;1062;468;1421
250625;201511;2370;7620;2322;7559;115;280;2155;7151;2270;7431
250630;201511;9326;29129;8570;27614;2066;6693;4241;13787;6307;20480
250640;201511;3459;10613;3298;10418;175;744;2854;8862;3029;9606
250650;201511;791;2312;706;2168;48;188;511;1502;559;1690
250660;201511;1906;5018;1728;4785;29;67;1626;4535;1655;4602
250670;201511;2382;8094;2266;7882;146;672;1850;6298;1996;6970
250680;201511;4704;13578;4478;13294;208;759;3920;11558;4128;12317
250690;201511;5959;15583;5677;15241;488;1266;4927;13237;5415;14503
250700;201511;4961;14545;4503;13855;741;2344;2937;9008;3678;11352
250710;201511;4169;13362;3910;12994;581;2076;2643;8876;3224;10952
250720;201511;2601;7654;2462;7433;101;429;2145;6373;2246;6802
250730;201511;3504;10722;3288;10411;298;1005;2447;7622;2745;8627
250740;201511;1897;5581;1680;5238;167;640;1251;3761;1418;4401
250750;201511;99085;280842;91340;269260;12997;41762;61359;178253;74356;220015
250760;201511;2217;6379;1988;6052;149;554;1627;4880;1776;5434
250770;201511;3778;12820;3580;12560;560;2174;2351;8196;2911;10370
250780;201511;1823;5348;1571;4876;181;671;1008;2997;1189;3668
250790;201511;2404;7852;2271;7630;518;1759;1313;4530;1831;6289
250800;201511;2636;7438;2335;6943;101;319;1920;5605;2021;5924
250810;201511;1311;3822;1134;3556;82;336;885;2713;967;3049
250820;201511;1822;5713;1746;5615;69;301;1587;5049;1656;5350
250830;201511;5674;18255;5244;17374;635;2338;3509;11389;4144;13727
250840;201511;914;2930;767;2607;57;226;516;1749;573;1975
250850;201511;1966;6053;1787;5761;99;462;1387;4366;1486;4828
250855;201511;1052;3206;964;3071;61;263;735;2262;796;2525
250860;201511;3084;10131;2671;9362;682;2590;866;3023;1548;5613
250870;201511;1063;3094;966;2915;42;167;733;2146;775;2313
250880;201511;1375;3874;1208;3636;165;503;873;2637;1038;3140
250890;201511;9187;28026;8588;27177;1105;4331;6056;18420;7161;22751
250900;201511;2811;9122;2463;8430;259;846;1779;6139;2038;6985
250905;201511;1973;6343;1890;6229;326;1049;1351;4533;1677;5582
250910;201511;4926;14309;4651;13898;275;921;3805;11266;4080;12187
250915;201511;1419;4396;1388;4343;120;329;1166;3736;1286;4065
250920;201511;3319;9530;3099;9189;424;1191;2124;6386;2548;7577
250930;201511;1976;6154;1855;5950;203;804;1299;4045;1502;4849
250933;201511;1116;3649;1052;3524;95;376;723;2363;818;2739
250937;201511;664;2078;612;1972;61;244;430;1348;491;1592
250939;201511;1548;4837;1453;4669;149;507;1017;3247;1166;3754
250940;201511;3705;11072;3478;10706;132;496;2945;9058;3077;9554
250950;201511;1212;3748;1066;3558;55;240;852;2805;907;3045
250960;201511;1109;3628;1054;3546;85;324;845;2835;930;3159
250970;201511;8395;23246;7279;21526;856;2593;5060;14933;5916;17526
250980;201511;2543;7532;2319;7130;132;529;1681;4954;1813;5483
250990;201511;1949;6638;1740;6170;266;1075;1051;3592;1317;4667
251000;201511;2139;6437;1944;6130;80;341;1611;5021;1691;5362
251010;201511;2795;8114;2501;7659;86;303;2148;6568;2234;6871
251020;201511;1583;4603;1458;4439;88;279;1287;3926;1375;4205
251030;201511;1125;3172;1019;2981;68;229;749;2149;817;2378
251040;201511;1814;5704;1628;5381;105;481;1206;3828;1311;4309
251050;201511;1079;3135;938;2890;104;337;610;1850;714;2187
251060;201511;1012;2363;781;2059;49;158;610;1577;659;1735
251065;201511;465;1418;411;1331;29;104;281;858;310;962
251070;201511;627;1759;564;1674;46;182;440;1233;486;1415
251080;201511;19694;55479;17738;52164;4526;13840;8414;25242;12940;39082
251090;201511;2964;9234;2621;8564;207;765;1879;6033;2086;6798
251100;201511;957;3032;847;2833;89;356;552;1778;641;2134
251110;201511;1986;5806;1735;5321;165;494;1161;3556;1326;4050
251120;201511;6098;20674;5811;20158;723;2906;4199;14324;4922;17230
251130;201511;4031;10424;3672;10040;15;36;3611;9899;3626;9935
251140;201511;4141;12758;3894;12364;128;560;3265;10314;3393;10874
251150;201511;2510;8181;2342;7928;206;913;1749;5736;1955;6649
251160;201511;1783;5875;1721;5794;72;282;1553;5229;1625;5511
251170;201511;1416;4300;1340;4211;93;383;1115;3423;1208;3806
251180;201511;2538;7720;2320;7385;426;1336;1390;4442;1816;5778
251190;201511;4314;11993;4150;11808;182;533;3829;10889;4011;11422
251200;201511;3796;12303;3660;12136;99;445;3355;11055;3454;11500
251203;201511;1041;3480;1007;3415;55;276;793;2633;848;2909
251207;201511;1117;3483;962;3207;70;331;659;2091;729;2422
251210;201511;7944;22506;6776;20970;769;2331;5119;16288;5888;18619
251220;201511;1116;3006;926;2717;100;299;681;2002;781;2301
251230;201511;4456;13535;4120;13142;236;940;3664;11557;3900;12497
251240;201511;3213;9828;3002;9553;427;1338;2160;6894;2587;8232
251250;201511;10261;30367;9454;29124;982;3496;7024;21207;8006;24703
251260;201511;513;1623;467;1556;23;94;349;1149;372;1243
251270;201511;4230;13552;3933;13189;155;710;3483;11637;3638;12347
251272;201511;1344;3980;1291;3905;82;270;1132;3419;1214;3689
251274;201511;887;2804;797;2647;81;323;562;1834;643;2157
251275;201511;1222;3610;1161;3512;79;351;865;2457;944;2808
251276;201511;1187;3688;1106;3538;84;345;809;2509;893;2854
251278;201511;561;1807;499;1682;62;255;326;1083;388;1338
251280;201511;2288;7008;2159;6793;141;536;1688;5147;1829;5683
251290;201511;5581;15435;5251;15037;607;2155;4057;11240;4664;13395
251300;201511;745;2525;696;2445;44;194;542;1883;586;2077
251310;201511;3011;8932;2769;8582;119;495;2259;6828;2378;7323
251315;201511;1606;5588;1524;5443;188;678;1045;3767;1233;4445
251320;201511;1871;5237;1467;4562;60;214;1072;3308;1132;3522
251330;201511;1807;4879;1559;4549;80;330;1344;3818;1424;4148
251335;201511;1018;3484;939;3343;91;416;650;2254;741;2670
251340;201511;3460;9747;2996;9043;229;899;2233;6507;2462;7406
251350;201511;1337;4225;1236;4045;97;361;938;2984;1035;3345
251360;201511;1777;5693;1611;5482;68;304;1399;4745;1467;5049
251365;201511;818;2393;648;2030;25;101;459;1399;484;1500
251370;201511;21746;68592;21148;67754;1865;7400;16727;52012;18592;59412
251380;201511;1343;4185;1152;3856;46;247;948;3040;994;3287
251385;201511;818;2227;707;2044;87;246;458;1286;545;1532
251390;201511;5832;20017;5283;19024;1302;4831;2776;10112;4078;14943
251392;201511;1039;3099;935;2924;74;247;701;2173;775;2420
251394;201511;608;1877;497;1661;43;148;340;1125;383;1273
251396;201511;844;2387;734;2201;109;328;467;1382;576;1710
251398;201511;995;2896;856;2624;55;207;568;1707;623;1914
251400;201511;1175;3297;1005;3061;95;349;725;2134;820;2483
251410;201511;1346;3627;1233;3448;66;258;1028;2806;1094;3064
251420;201511;1962;5687;1748;5428;225;721;1247;3841;1472;4562
251430;201511;1709;5931;1549;5664;85;426;1277;4577;1362;5003
251440;201511;1294;3810;1056;3345;67;239;775;2430;842;2669
251445;201511;1501;4590;1421;4472;95;395;1149;3493;1244;3888
251450;201511;4452;14377;4171;13991;129;605;3541;11809;3670;12414
251455;201511;1081;3486;971;3284;92;349;663;2243;755;2592
251460;201511;814;2523;760;2436;85;245;591;1946;676;2191
251465;201511;445;1413;390;1291;20;92;284;907;304;999
251470;201511;1170;3438;966;3041;89;312;590;1839;679;2151
251480;201511;960;2682;853;2497;30;142;692;1952;722;2094
251490;201511;1728;5214;1559;4951;168;629;1075;3372;1243;4001
251500;201511;1698;5507;1647;5411;142;544;1262;4056;1404;4600
251510;201511;2580;8441;2323;7910;436;1536;1285;4363;1721;5899
251520;201511;922;2567;818;2392;122;361;500;1450;622;1811
251530;201511;11659;32933;11049;32082;397;1713;9465;26714;9862;28427
251540;201511;2827;9181;2604;8737;199;842;2058;6809;2257;7651
251550;201511;3506;9077;3007;8408;86;341;2539;6959;2625;7300
251560;201511;700;2171;646;2072;86;326;387;1166;473;1492
251570;201511;999;2974;802;2575;53;229;544;1670;597;1899
251580;201511;1919;5380;1768;5170;403;993;1092;3396;1495;4389
251590;201511;1534;4931;1470;4850;69;278;1209;3956;1278;4234
251593;201511;999;3120;926;3023;142;513;579;1837;721;2350
251597;201511;1900;5857;1833;5772;77;329;1594;4926;1671;5255
251600;201511;6550;19228;6090;18499;383;1295;4895;14759;5278;16054
251610;201511;3197;9738;2949;9349;315;998;2151;6850;2466;7848
251615;201511;1144;3321;925;2939;73;305;643;1981;716;2286
251620;201511;15000;41749;13161;39489;943;2936;10742;32750;11685;35686
251630;201511;4538;11791;3921;10920;273;805;3114;8568;3387;9373
251640;201511;2571;7491;2140;6744;133;531;1605;4993;1738;5524
251650;201511;3892;11332;3581;10913;234;788;3062;9279;3296;10067
251660;201511;3402;11107;3147;10654;122;617;2615;8593;2737;9210
251670;201511;4426;13056;3786;12226;58;187;3477;11371;3535;11558
251675;201511;717;2299;657;2214;149;546;358;1173;507;1719
251680;201511;2691;7737;2210;6976;110;480;1728;5328;1838;5808
251690;201511;3258;9870;3036;9432;164;571;2346;7172;2510;7743
251700;201511;1964;6326;1836;6157;119;520;1549;5121;1668;5641
251710;201511;932;2403;676;1920;82;268;381;1036;463;1304
251720;201511;1398;4293;1223;3979;84;406;923;2874;1007;3280
251740;201511;774;2196;612;1913;78;253;367;1151;445;1404
260005;201511;25437;61781;21469;56148;4658;12104;11658;30667;16316;42771
260010;201511;9898;26599;8066;24256;1367;4036;4637;14599;6004;18635
260020;201511;5645;16373;4783;15072;299;1072;3712;11828;4011;12900
260030;201511;5883;17142;5330;16281;399;1381;4118;12517;4517;13898
260040;201511;10113;24441;8289;22335;800;2041;6246;17414;7046;19455
260050;201511;11215;34759;10447;33860;595;2151;8987;29391;9582;31542
260060;201511;3889;10961;3444;10187;340;1020;2516;7492;2856;8512
260070;201511;9723;28162;8939;26913;1424;4587;5660;16786;7084;21373
260080;201511;5529;14982;4877;14032;621;1841;3377;9652;3998;11493
260090;201511;5086;14227;4755;13746;992;2780;3068;9032;4060;11812
260100;201511;3308;9127;2866;8500;191;771;2338;6829;2529;7600
260105;201511;4755;13602;4491;13127;361;1282;3556;10148;3917;11430
260110;201511;20856;59069;19196;57058;911;2825;16848;50171;17759;52996
260120;201511;11416;34970;10259;32893;2453;8027;5190;17239;7643;25266
260130;201511;3245;9116;3020;8758;486;1372;2038;5978;2524;7350
260140;201511;13243;32857;11264;30429;873;2560;8886;24146;9759;26706
260150;201511;3119;8821;2769;8341;212;818;2140;6351;2352;7169
260160;201511;5638;17748;4986;16894;334;1425;4028;13577;4362;15002
260170;201511;16435;46144;15654;45004;1220;3744;12727;36333;13947;40077
260180;201511;3244;9957;2947;9527;206;750;2418;7784;2624;8534
260190;201511;15969;37421;14586;35689;505;1324;12657;30658;13162;31982
260200;201511;10601;29233;9781;28115;701;2274;8122;23480;8823;25754
260210;201511;11402;34706;10270;32999;632;2465;8331;26669;8963;29134
260220;201511;9358;27309;9023;26858;464;1792;7901;23125;8365;24917
260230;201511;9472;27324;8712;26259;458;1606;7068;21381;7526;22987
260240;201511;2983;8978;2578;8384;374;1323;1771;5780;2145;7103
260250;201511;2310;6362;2067;6044;100;302;1781;5219;1881;5521
260260;201511;12132;34155;11050;32626;1822;5649;7660;22935;9482;28584
260270;201511;3599;10466;3322;10046;283;1151;2467;7094;2750;8245
260280;201511;12813;41461;11741;39820;724;2639;9794;33504;10518;36143
260290;201511;30299;91062;28445;87684;4962;16329;17385;52634;22347;68963
260300;201511;8523;25995;7528;24477;454;1946;5825;18891;6279;20837
260310;201511;4681;13764;4271;13148;1248;3542;2212;7368;3460;10910
260320;201511;7004;22791;6469;21932;401;1572;5310;18032;5711;19604
260330;201511;2612;8373;2419;8028;137;587;1873;6092;2010;6679
260340;201511;1874;5503;1734;5282;75;269;1514;4563;1589;4832
260345;201511;23143;71809;21538;68609;5715;20060;8256;24846;13971;44906
260350;201511;4702;12811;4380;12334;244;866;3652;10115;3896;10981
260360;201511;2305;6782;2094;6417;189;716;1415;4283;1604;4999
260370;201511;5893;18170;5170;16854;506;1970;3645;11801;4151;13771
260380;201511;4845;15854;4410;15191;322;1303;3296;11299;3618;12602
260390;201511;4360;13875;3807;12774;341;1311;2682;8810;3023;10121
260392;201511;3538;11105;3236;10719;209;911;2765;9001;2974;9912
260400;201511;13561;38588;12795;37290;1772;5761;8674;24664;10446;30425
260410;201511;61058;173845;52810;160381;15276;48968;19852;61349;35128;110317
260415;201511;3860;12185;3294;11042;327;1357;2051;6591;2378;7948
260420;201511;11982;27328;10654;25893;284;869;9577;22986;9861;23855
260430;201511;2787;9159;2473;8597;250;902;1693;5893;1943;6795
260440;201511;3253;9811;2879;9048;422;1474;1725;5263;2147;6737
260450;201511;4922;14587;4692;14252;201;704;4129;12581;4330;13285
260460;201511;5598;17396;5100;16451;926;3237;2879;9075;3805;12312
260470;201511;4549;13683;4232;13278;261;796;3661;11745;3922;12541
260480;201511;4057;11575;3557;10871;588;2022;2276;6957;2864;8979
260490;201511;5012;13364;4351;12231;308;984;3445;9479;3753;10463
260500;201511;5957;17004;5284;15928;781;2378;3471;10415;4252;12793
260510;201511;8699;23326;8036;22472;405;1308;7037;19544;7442;20852
260515;201511;4730;14407;3643;12184;260;999;2296;7641;2556;8640
260520;201511;15801;41609;15105;40643;2290;6161;10837;29196;13127;35357
260530;201511;9690;29478;8594;27831;446;1644;7218;23401;7664;25045
260540;201511;6038;14916;5477;14314;779;1507;4252;11697;5031;13204
260545;201511;71;254;40;159;8;33;11;38;19;71
260550;201511;2757;8999;2344;8115;492;1881;941;3208;1433;5089
260560;201511;6275;16435;5653;15523;178;653;4963;13401;5141;14054
260570;201511;6861;22511;6257;21509;696;2709;4402;15021;5098;17730
260580;201511;3703;10411;3410;9915;187;642;2816;7982;3003;8624
260590;201511;6111;15328;5748;14898;294;811;4979;12863;5273;13674
260600;201511;27106;79971;24354;75300;2304;8349;17374;53097;19678;61446
260610;201511;6643;19841;6266;19254;944;3039;4298;13059;5242;16098
260620;201511;15910;47949;15106;46484;2627;8818;9285;27967;11912;36785
260630;201511;2202;6553;1955;6133;153;638;1531;4627;1684;5265
260640;201511;17131;47189;15997;45586;2594;7629;10239;29168;12833;36797
260650;201511;5337;17027;4750;16006;453;1642;3551;12117;4004;13759
260660;201511;7961;22059;7111;20970;367;1251;6055;17728;6422;18979
260670;201511;2378;6396;1918;5749;174;573;1340;4020;1514;4593
260680;201511;21729;60628;19668;56939;4150;12312;9515;27359;13665;39671
260690;201511;3670;9950;3095;9011;159;535;2505;7209;2664;7744
260700;201511;5646;16735;5500;16583;47;128;5386;16353;5433;16481
260710;201511;1285;3805;1179;3659;90;324;911;2821;1001;3145
260720;201511;16103;52493;15162;50764;3580;12460;7876;26537;11456;38997
260730;201511;6670;22352;6211;21567;1078;3886;4164;14448;5242;18334
260740;201511;1273;3852;1114;3575;127;457;757;2421;884;2878
260750;201511;6723;20635;6046;19732;541;1741;4900;16224;5441;17965
260760;201511;4697;12641;4368;12199;259;802;3617;10129;3876;10931
260765;201511;7719;26057;7334;25415;1104;4830;4904;16258;6008;21088
260770;201511;3742;9902;3450;9476;123;429;2876;7758;2999;8187
260775;201511;5068;14632;4760;14150;482;1714;3379;9753;3861;11467
260780;201511;3634;11699;3377;11183;670;2496;1745;5517;2415;8013
260790;201511;110983;279691;102458;266616;21025;56021;59017;152773;80042;208794
260795;201511;3019;9140;2706;8654;295;1061;1849;5913;2144;6974
260800;201511;4805;12963;4445;12459;165;649;3951;10736;4116;11385
260805;201511;3939;11394;3443;10626;408;1433;2299;6928;2707;8361
260810;201511;6808;19150;6592;18884;323;975;5774;16480;6097;17455
260820;201511;4281;12004;3862;11392;947;2871;1993;5777;2940;8648
260825;201511;2873;9174;2579;8685;221;810;1955;6620;2176;7430
260830;201511;3714;11970;3313;11178;740;2439;1879;6560;2619;8999
260840;201511;4250;12114;3765;11393;258;976;3024;8971;3282;9947
260845;201511;4181;12128;3903;11618;512;1596;2748;8208;3260;9804
260850;201511;4950;16121;4358;14787;843;3205;2078;6805;2921;10010
260860;201511;3317;10466;2957;9733;181;701;2267;7412;2448;8113
260870;201511;4178;11539;3708;10939;485;1298;2737;8256;3222;9554
260875;201511;6475;17838;5740;16721;894;2615;3762;11032;4656;13647
260880;201511;9351;28761;8568;27443;759;2467;6596;21311;7355;23778
260890;201511;13241;37815;12321;36374;903;3041;9332;27318;10235;30359
260900;201511;5901;18085;5013;16365;540;2124;3125;9996;3665;12120
260910;201511;2992;9021;2710;8592;199;733;2073;6571;2272;7304
260915;201511;4471;15110;4246;14786;84;396;3910;13596;3994;13992
260920;201511;3213;9837;2991;9521;322;1245;2277;7203;2599;8448
260930;201511;3955;12812;3475;12024;399;1458;2446;8488;2845;9946
260940;201511;13743;36730;12461;34610;1579;5040;8273;22311;9852;27351
260950;201511;6247;19275;5675;18142;874;3239;3016;9157;3890;12396
260960;201511;56497;156607;51490;148210;10185;30973;27427;78174;37612;109147
260970;201511;4796;15014;4404;14467;274;1141;3487;11331;3761;12472
260980;201511;3845;12417;3606;12111;125;543;3220;10776;3345;11319
260990;201511;16864;52882;15273;50716;1159;4308;12060;40250;13219;44558
261000;201511;16262;44063;13056;39027;2471;7781;6592;20273;9063;28054
261010;201511;2550;7150;2334;6883;155;352;2034;6177;2189;6529
261020;201511;5866;17333;5256;16348;469;1717;4039;12145;4508;13862
261030;201511;3447;11049;3154;10515;225;908;2469;8101;2694;9009
261040;201511;5142;16562;4476;15253;392;1574;3218;10840;3610;12414
261050;201511;7966;23236;7399;22194;1047;3135;4843;14527;5890;17662
261060;201511;11997;35485;11102;33847;1089;3884;8043;23846;9132;27730
261070;201511;50940;125200;44500;115962;6828;18168;27967;73029;34795;91197
261080;201511;5769;16744;5402;16181;386;1084;4558;13882;4944;14966
261090;201511;16526;45315;15144;43426;1458;4089;11738;34036;13196;38125
261100;201511;7918;25082;7026;23474;1359;4842;3834;12990;5193;17832
261110;201511;60490;178161;53447;167249;12369;40766;27401;87100;39770;127866
261120;201511;3651;9746;3197;9191;100;379;2828;8102;2928;8481
261130;201511;6987;17872;6507;17329;215;688;5911;15614;6126;16302
261140;201511;3276;9173;2957;8687;407;1371;1791;5076;2198;6447
261150;201511;5286;15553;4867;14873;435;1572;3841;11661;4276;13233
261153;201511;2093;6071;1697;5453;72;297;1261;4052;1333;4349
261160;201511;200134;521869;184302;498500;43733;122150;90698;248015;134431;370165
261170;201511;5863;15982;5290;15129;605;1772;3913;11294;4518;13066
261180;201511;9595;26709;8963;25810;992;3131;6154;17481;7146;20612
261190;201511;5077;15765;4719;15316;541;2277;3255;10122;3796;12399
261200;201511;3663;9181;3293;8731;427;1106;2543;6896;2970;8002
261210;201511;1906;5037;1786;4885;125;342;1567;4308;1692;4650
261220;201511;13114;40936;10896;36061;1920;6918;5398;17712;7318;24630
261230;201511;4325;13112;3974;12671;162;639;3455;11036;3617;11675
261240;201511;4813;14261;4424;13587;647;1867;2978;9363;3625;11230
261245;201511;3533;10976;3017;10028;169;772;2364;7659;2533;8431
261247;201511;3309;10119;2791;9161;219;867;1998;6568;2217;7435
261250;201511;19778;52446;18541;50792;3608;9564;12602;35383;16210;44947
261255;201511;3982;12392;3600;11725;216;834;2943;9502;3159;10336
261260;201511;12008;33929;10739;32364;617;1980;8954;27059;9571;29039
261270;201511;3633;10724;3265;10113;409;1425;2181;6592;2590;8017
261280;201511;2491;7631;2283;7319;138;505;1849;5881;1987;6386
261290;201511;2911;8362;2647;8013;168;641;2137;6437;2305;7078
261300;201511;10651;34454;9301;31975;1517;5932;5530;18696;7047;24628
261310;201511;7339;22481;6873;21614;1649;5296;3770;11879;5419;17175
261320;201511;5548;17506;5112;16702;236;937;4110;13341;4346;14278
261330;201511;5408;15855;5112;15448;474;1483;3992;11994;4466;13477
261340;201511;4022;13348;3803;12982;404;1732;2531;8494;2935;10226
261350;201511;8060;26560;7518;25614;306;1511;6041;20081;6347;21592
261360;201511;8131;21392;7265;20166;624;1876;5709;15555;6333;17431
261370;201511;19613;57649;18218;55414;3822;12113;10225;31100;14047;43213
261380;201511;4111;14045;3767;13300;606;2365;2343;8257;2949;10622
261390;201511;15857;48382;14292;45685;2169;7546;8630;27445;10799;34991
261400;201511;4761;16323;4232;15203;388;1608;2931;10485;3319;12093
261410;201511;8577;24008;7749;22729;981;2913;5622;16633;6603;19546
261420;201511;7363;24803;7027;24331;1673;6586;4047;13650;5720;20236
261430;201511;3398;10629;2977;10012;279;985;2246;7650;2525;8635
261440;201511;1575;5112;1422;4881;61;318;1124;3759;1185;4077
261450;201511;13998;39537;13505;38941;379;1374;12215;34959;12594;36333
261460;201511;7142;20984;6689;20394;448;1248;5758;17891;6206;19139
261470;201511;3909;10691;3532;10192;140;456;3200;9212;3340;9668
261480;201511;3552;12810;3258;12249;340;1415;2312;8554;2652;9969
261485;201511;5000;15284;4512;14405;772;2851;2628;8177;3400;11028
261500;201511;5695;15734;5029;14835;468;1277;3769;11465;4237;12742
261510;201511;1926;6146;1774;5907;134;490;1361;4536;1495;5026
261520;201511;2642;8579;2442;8203;150;573;1660;5781;1810;6354
261530;201511;11978;38195;10482;35259;2231;8343;4325;14391;6556;22734
261540;201511;7266;23365;6856;22637;1503;4954;4057;13703;5560;18657
261550;201511;3428;9709;3224;9411;263;987;2530;7172;2793;8159
261560;201511;7152;23267;6413;22274;1025;3909;4422;15509;5447;19418
261570;201511;3404;10381;2978;9681;432;1486;1890;6118;2322;7604
261580;201511;5812;18074;5208;17087;370;1485;4258;13891;4628;15376
261590;201511;2402;6851;2131;6441;190;583;1577;4804;1767;5387
261600;201511;5182;14164;4470;13161;347;1068;3480;10307;3827;11375
261610;201511;2473;7104;2106;6579;118;494;1657;5066;1775;5560
261618;201511;2469;6941;2247;6655;208;659;1683;4889;1891;5548
261620;201511;4090;12669;3798;12170;625;2073;2515;8149;3140;10222
261630;201511;7726;22515;6448;20108;877;3187;3598;10904;4475;14091
261640;201511;32697;82378;30322;79452;2224;5691;24270;65593;26494;71284
261650;201511;3655;11177;3379;10787;404;1441;2399;7665;2803;9106
270010;201511;4416;16622;4042;15886;463;2174;2697;10590;3160;12764
270020;201511;3830;10932;3558;10527;442;1418;2638;7697;3080;9115
270030;201511;40001;119431;37203;114872;9188;29046;19962;62163;29150;91209
270040;201511;10615;32372;9782;31269;2208;7013;5564;18448;7772;25461
270050;201511;4279;12068;3911;11600;427;1422;3000;8852;3427;10274
270060;201511;1736;5363;1615;5203;284;979;1068;3471;1352;4450
270070;201511;4230;13168;3884;12710;205;1002;3287;10449;3492;11451
270080;201511;1260;3996;1098;3660;163;616;681;2195;844;2811
270090;201511;2107;6523;1940;6177;59;311;1633;5007;1692;5318
270100;201511;5706;17725;5360;17090;937;3185;3349;10532;4286;13717
270110;201511;3217;8796;2849;8388;398;1185;1879;5907;2277;7092
270120;201511;3086;8785;2744;8355;102;382;2455;7493;2557;7875
270130;201511;4998;15251;4661;14862;654;2107;3538;11527;4192;13634
270135;201511;1760;4669;1633;4514;189;369;1374;3985;1563;4354
270140;201511;10303;25046;8848;23191;767;2993;6874;16719;7641;19712
270150;201511;2693;8933;2620;8838;82;273;2453;8326;2535;8599
270160;201511;5049;16816;4626;16282;233;1007;3930;13737;4163;14744
270170;201511;3838;12357;3516;11905;618;2425;2043;6803;2661;9228
270180;201511;2205;7341;2017;7079;111;578;1643;5640;1754;6218
270190;201511;1778;5846;1690;5731;103;421;1411;4788;1514;5209
270200;201511;2574;8583;2401;8336;201;861;1825;6233;2026;7094
270210;201511;4578;13921;4305;13528;312;1265;3509;10778;3821;12043
270220;201511;1398;4539;1304;4362;246;894;737;2423;983;3317
270230;201511;10894;34315;9493;32002;1300;5368;5814;18847;7114;24215
270235;201511;6337;20500;5908;19788;406;1747;4769;15700;5175;17447
270240;201511;9475;28470;7947;26427;1932;6710;3791;12788;5723;19498
270250;201511;3252;8516;2962;8161;515;1359;2194;6049;2709;7408
270255;201511;5000;15036;3963;13157;286;1170;2806;9143;3092;10313
270260;201511;5733;18741;5545;18469;449;1887;4624;15089;5073;16976
270270;201511;1195;3400;1090;3244;199;625;631;1835;830;2460
270280;201511;3577;10148;3188;9587;369;1113;2258;6762;2627;7875
270290;201511;8222;28561;7672;27595;725;3159;5851;20715;6576;23874
270300;201511;3578;11698;3219;11277;338;1335;2329;8095;2667;9430
270310;201511;7378;22345;6446;20891;301;1514;5359;16890;5660;18404
270320;201511;5823;18554;5567;18137;842;3252;3857;12213;4699;15465
270330;201511;4339;14617;4066;14231;394;1521;3218;11293;3612;12814
270340;201511;1741;5347;1529;5063;130;440;1189;3939;1319;4379
270350;201511;1885;5192;1697;4964;150;526;1244;3611;1394;4137
270360;201511;2007;6221;1927;6129;204;593;1578;5167;1782;5760
270370;201511;1555;5131;1408;4869;136;566;1002;3450;1138;4016
270375;201511;2824;7910;2513;7476;230;808;1949;5664;2179;6472
270380;201511;5702;17630;5342;17121;562;1840;4058;13240;4620;15080
270390;201511;1237;3453;1089;3236;79;291;819;2340;898;2631
270400;201511;6334;18922;5675;17976;417;1571;4070;12562;4487;14133
270410;201511;4814;14960;4428;14220;477;1700;3102;9812;3579;11512
270420;201511;5747;18448;5526;18138;271;1238;4527;14517;4798;15755
270430;201511;134045;388584;122796;371314;32758;103869;55260;169860;88018;273729
270440;201511;4733;14235;4345;13689;235;913;3526;11110;3761;12023
270450;201511;6308;19415;6038;19066;349;1440;4953;15394;5302;16834
270460;201511;3470;9269;3092;8777;208;687;2617;7327;2825;8014
270470;201511;10354;32937;9497;31506;1543;5343;5666;19070;7209;24413
270480;201511;2917;9039;2572;8408;249;1000;1752;5495;2001;6495
270490;201511;959;3094;897;2994;41;171;726;2395;767;2566
270500;201511;4953;16741;4663;16386;341;1454;3833;13410;4174;14864
270510;201511;5989;17830;5357;16955;729;2900;3827;11578;4556;14478
270520;201511;3651;11535;3326;10977;970;3506;1237;4137;2207;7643
270530;201511;1430;4348;1314;4174;162;531;874;2855;1036;3386
270540;201511;2038;6874;1861;6615;131;674;1486;5096;1617;5770
270550;201511;7145;20829;6195;19586;882;2960;4130;13305;5012;16265
270560;201511;3048;9207;2836;8886;325;1226;2050;6240;2375;7466
270570;201511;3958;12803;3614;12214;354;1497;2729;9012;3083;10509
270580;201511;1990;6387;1890;6249;187;640;1454;4883;1641;5523
270590;201511;1372;4550;1304;4433;21;90;1249;4244;1270;4334
270600;201511;2812;9378;2532;8910;170;840;1945;6663;2115;7503
270610;201511;3201;10066;2947;9691;218;798;2381;7757;2599;8555
270620;201511;1380;4682;1299;4552;97;472;1027;3443;1124;3915
270630;201511;16866;48401;15519;46194;2345;6809;10545;32122;12890;38931
270640;201511;5735;17631;5163;16816;337;1422;4137;13180;4474;14602
270642;201511;2256;7957;2111;7743;265;1191;1531;5511;1796;6702
270644;201511;2636;7684;2338;7309;266;764;1763;5649;2029;6413
270650;201511;3673;11676;3484;11399;532;2325;2341;7164;2873;9489
270660;201511;2464;6218;1909;5427;97;371;1359;3787;1456;4158
270670;201511;16343;42319;13992;39608;1900;5138;10100;29599;12000;34737
270680;201511;4275;12673;4089;12464;166;433;3733;11520;3899;11953
270690;201511;8839;24428;7966;23432;2527;7184;4028;12503;6555;19687
270700;201511;670;2064;606;1951;81;326;416;1277;497;1603
270710;201511;5958;19053;5656;18658;461;1748;4655;15219;5116;16967
270720;201511;3311;11167;3010;10633;157;832;2436;8405;2593;9237
270730;201511;6199;18557;5878;18203;672;2262;4691;14557;5363;16819
270740;201511;2328;6619;2189;6419;267;884;1627;4679;1894;5563
270750;201511;4947;15569;4585;14996;661;2355;3202;10387;3863;12742
270760;201511;3354;10160;3002;9569;209;782;2315;7316;2524;8098
270770;201511;19369;50261;15823;45922;3342;9695;8752;26511;12094;36206
270780;201511;1809;5932;1701;5752;213;829;1180;3958;1393;4787
270790;201511;1569;4873;1428;4655;352;1234;711;2259;1063;3493
270800;201511;11313;33416;10476;32306;816;3024;8518;25845;9334;28869
270810;201511;3344;10102;2583;8707;289;1160;1587;5324;1876;6484
270820;201511;1764;5867;1592;5574;281;1062;940;3279;1221;4341
270830;201511;5535;15252;4994;14581;420;1362;3952;11731;4372;13093
270840;201511;7837;25397;7233;24614;364;1825;6241;20775;6605;22600
270850;201511;7319;23184;7055;22846;1205;4713;4721;14450;5926;19163
270860;201511;11319;31509;9562;29202;1146;4113;6439;19168;7585;23281
270870;201511;2191;6594;1801;5778;268;896;1100;3493;1368;4389
270880;201511;8138;25979;7560;25121;545;2201;6011;19659;6556;21860
270890;201511;2427;7340;2270;7061;254;965;1646;4962;1900;5927
270895;201511;2882;10634;2758;10459;171;772;2367;8987;2538;9759
270900;201511;1955;5276;1575;4725;89;303;1189;3500;1278;3803
270910;201511;3540;11618;3289;11158;257;1160;2534;8321;2791;9481
270915;201511;9703;32276;8680;30428;1475;6025;4980;16988;6455;23013
270920;201511;6073;19248;5832;18913;233;1224;5205;16389;5438;17613
270930;201511;17512;46395;14316;42444;2809;8439;8293;25505;11102;33944
270940;201511;5727;18953;5429;18629;531;2331;4277;14447;4808;16778
280010;201511;647;1934;552;1756;57;251;345;1021;402;1272
280020;201511;4754;13857;4055;12637;742;2489;2433;7463;3175;9952
280030;201511;74315;194189;63424;177725;17974;52383;24955;71165;42929;123548
280040;201511;3137;9614;2781;9073;261;987;2039;6601;2300;7588
280050;201511;3753;12040;3464;11528;1172;4136;1264;4318;2436;8454
280060;201511;4430;14440;4042;13732;820;2985;2136;7367;2956;10352
280067;201511;7371;20791;6302;19191;895;2719;4021;12393;4916;15112
280070;201511;1868;6233;1771;6086;285;1004;1230;4261;1515;5265
280100;201511;3828;11881;3414;11140;689;2413;1936;6329;2625;8742
280110;201511;1407;4270;1289;4090;75;335;1070;3320;1145;3655
280120;201511;7813;24505;7162;23459;1272;3794;4693;16121;5965;19915
280130;201511;7307;20654;6649;19679;1166;3666;4224;12566;5390;16232
280140;201511;5475;14948;4963;14213;470;1405;3866;11120;4336;12525
280150;201511;3383;10142;3117;9681;331;1165;2177;6561;2508;7726
280160;201511;1369;3984;1195;3700;151;498;805;2447;956;2945
280170;201511;4809;14206;4304;13447;483;1500;3170;10084;3653;11584
280190;201511;1089;3018;966;2810;64;225;738;2089;802;2314
280200;201511;1158;3471;1055;3314;129;514;739;2224;868;2738
280210;201511;13206;39850;11858;37923;2303;7764;6891;22322;9194;30086
280220;201511;1537;4719;1434;4553;98;375;1164;3620;1262;3995
280230;201511;3455;10299;3070;9676;391;1328;1976;6253;2367;7581
280240;201511;3438;10069;3107;9538;291;867;2379;7347;2670;8214
280250;201511;816;2146;663;1898;122;401;332;853;454;1254
280260;201511;2005;5367;1849;5174;80;251;1653;4646;1733;4897
280270;201511;2292;7054;1998;6599;129;512;1538;4984;1667;5496
280280;201511;4175;13484;3783;12825;859;2399;2088;7959;2947;10358
280290;201511;17114;52225;15378;49463;2249;7941;9520;30805;11769;38746
280300;201511;9544;28830;8862;27996;957;3250;6809;21940;7766;25190
280310;201511;1346;3797;1183;3534;73;303;839;2437;912;2740
280320;201511;8463;27111;7695;25750;1545;5689;3817;12568;5362;18257
280330;201511;4491;12618;4062;11923;419;1475;3087;8712;3506;10187
280340;201511;3750;10683;3517;10364;363;1212;2719;7998;3082;9210
280350;201511;21705;61123;19252;57377;2999;9310;12279;36764;15278;46074
280360;201511;5694;17811;5303;17156;1035;3835;2949;9238;3984;13073
280370;201511;1856;5191;1606;4769;146;460;1128;3298;1274;3758
280380;201511;1033;3136;944;3006;99;379;688;2127;787;2506
280390;201511;3112;9200;2647;8320;420;1394;1659;5181;2079;6575
280400;201511;4133;11824;3712;11213;1247;3692;1645;5238;2892;8930
280410;201511;2163;6853;1830;6200;252;973;1053;3418;1305;4391
280420;201511;4064;11911;3773;11452;242;786;3170;9589;3412;10375
280430;201511;2232;5687;2015;5386;107;351;1573;4104;1680;4455
280440;201511;4699;13897;4382;13519;400;1350;3524;10760;3924;12110
280445;201511;2484;6979;2300;6669;80;320;1840;5220;1920;5540
280450;201511;8803;23790;8192;23020;614;1513;6850;19754;7464;21267
280460;201511;6945;18298;6226;17268;871;2540;4375;12269;5246;14809
280470;201511;1802;5460;1627;5160;192;601;1152;3700;1344;4301
280480;201511;30061;88002;28418;85551;4789;16319;18147;53081;22936;69400
280490;201511;3788;11328;3294;10475;265;1023;2403;7459;2668;8482
280500;201511;916;2454;824;2335;55;182;674;1847;729;2029
280510;201511;2704;7784;2334;7295;227;792;1695;5310;1922;6102
280520;201511;1760;4849;1594;4639;150;417;1285;3797;1435;4214
280530;201511;2292;6439;2127;6230;152;447;1733;5113;1885;5560
280540;201511;9196;25231;8536;24325;239;1003;7456;20753;7695;21756
280550;201511;6867;18142;5789;16469;638;1841;4022;11477;4660;13318
280560;201511;7444;22029;7037;21421;398;1403;5880;17626;6278;19029
280570;201511;6417;17309;5592;16189;609;1985;3759;10677;4368;12662
280580;201511;5590;17196;4706;15632;829;2786;2728;9284;3557;12070
280590;201511;2346;7109;2180;6899;245;1061;1493;4534;1738;5595
280600;201511;3744;11422;3486;11025;334;1195;2598;8114;2932;9309
280610;201511;2466;6899;2254;6582;219;796;1605;4516;1824;5312
280620;201511;5213;15434;4516;14175;612;1835;3009;9767;3621;11602
280630;201511;3781;12187;3559;11853;375;1171;2785;9574;3160;10745
280640;201511;2226;6617;2115;6491;98;273;1954;6072;2052;6345
280650;201511;1120;3474;1003;3281;110;409;694;2251;804;2660
280660;201511;2629;7441;2512;7289;429;1181;1898;5583;2327;6764
280670;201511;15937;41791;14630;39968;2813;8070;8950;24207;11763;32277
280680;201511;2748;7425;2432;6926;212;692;1896;5296;2108;5988
280690;201511;948;2700;840;2544;128;399;569;1715;697;2114
280700;201511;1083;3195;950;2991;70;236;681;2136;751;2372
280710;201511;11641;30774;10647;29632;762;1979;8972;25461;9734;27440
280720;201511;2264;6203;2053;5951;262;782;1422;4215;1684;4997
280730;201511;924;2758;858;2666;92;328;677;2066;769;2394
280740;201511;13075;35443;11272;32681;1599;4561;7163;21104;8762;25665
280750;201511;3546;10735;3223;10174;339;1153;2230;7061;2569;8214
280760;201511;5642;17160;5094;16359;774;2668;3157;10354;3931;13022
290010;201511;3002;6742;2141;5411;54;227;1687;4045;1741;4272
290020;201511;4380;14604;4299;14491;401;1117;3561;12251;3962;13368
290030;201511;3110;9721;2932;9450;539;1731;1977;6419;2516;8150
290035;201511;4663;11866;3992;10975;235;788;3114;8787;3349;9575
290040;201511;3935;10740;3380;10108;207;819;2675;7866;2882;8685
290050;201511;2501;8078;2200;7580;165;675;1641;5617;1806;6292
290060;201511;1313;3390;1111;3149;193;614;789;2169;982;2783
290070;201511;33086;82593;28004;76154;6238;16688;13245;38282;19483;54970
290080;201511;6141;18143;5193;16887;688;2239;3661;12242;4349;14481
290090;201511;2159;4679;1698;4187;175;394;1396;3522;1571;3916
290100;201511;9734;27608;8457;25600;1166;3656;5288;16357;6454;20013
290110;201511;4830;14304;4564;13832;715;2370;2922;8644;3637;11014
290115;201511;4817;14432;4245;13662;247;813;3449;11340;3696;12153
290120;201511;6858;17797;5664;16370;281;958;4684;13397;4965;14355
290130;201511;4589;12033;3814;11075;206;776;3040;8556;3246;9332
290135;201511;4565;11527;3886;10481;265;881;2843;7302;3108;8183
290140;201511;4126;12807;3549;12019;287;1117;2863;9683;3150;10800
290150;201511;2146;6450;2030;6258;255;833;1543;4687;1798;5520
290160;201511;3347;8844;3209;8674;313;644;2662;7287;2975;7931
290170;201511;2723;9010;2460;8605;187;889;2036;6950;2223;7839
290180;201511;2909;8456;2525;7856;196;730;1929;5952;2125;6682
290190;201511;3760;12519;3586;12244;210;894;2763;9301;2973;10195
290195;201511;2186;5941;1845;5418;97;390;1481;4276;1578;4666
290200;201511;3816;11897;3374;11189;301;1021;2601;8678;2902;9699
290205;201511;3145;9256;2795;8714;288;1080;1984;6031;2272;7111
290210;201511;14966;42080;13668;40396;2508;6623;8970;28453;11478;35076
290220;201511;2238;6671;2106;6457;137;583;1648;4879;1785;5462
290225;201511;2902;7496;2633;7196;166;456;2338;6409;2504;6865
290230;201511;2292;7391;2181;7261;142;577;1787;5925;1929;6502
290240;201511;3652;9823;3314;9315;313;927;2472;6833;2785;7760
290250;201511;3726;11882;3315;11269;187;642;2713;9483;2900;10125
290260;201511;4860;14036;4140;12903;354;1216;3136;9741;3490;10957
290265;201511;3319;10418;2951;9738;157;682;2296;7492;2453;8174
290270;201511;11937;43333;11301;42311;1521;6002;8090;30695;9611;36697
290280;201511;5225;17092;4845;16461;427;1619;3630;12346;4057;13965
290290;201511;9656;30440;8595;28664;1375;4678;5591;18998;6966;23676
290300;201511;4603;12997;3258;10471;265;828;2133;7113;2398;7941
290310;201511;1467;4388;1282;4098;245;861;693;2210;938;3071
290320;201511;28111;80900;23729;74953;5722;19185;11383;36833;17105;56018
290323;201511;3830;10346;3350;9795;172;532;2788;8130;2960;8662
290327;201511;4345;13249;3717;12076;572;1922;2306;7478;2878;9400
290330;201511;1815;4506;1676;4355;144;393;1443;3758;1587;4151
290340;201511;4844;15057;4518;14631;1323;4349;2425;7937;3748;12286
290350;201511;4404;13647;3826;12769;426;1439;2632;9023;3058;10462
290360;201511;4513;13716;3901;12894;179;695;3244;10801;3423;11496
290370;201511;4747;13179;4069;12292;392;1086;3217;9915;3609;11001
290380;201511;5593;16082;4851;14973;347;1235;3799;11779;4146;13014
290390;201511;14607;44654;13220;42575;2380;7857;7860;26245;10240;34102
290395;201511;2632;8495;2326;7927;144;644;1731;5874;1875;6518
290400;201511;3531;10463;3037;9744;305;1006;2142;6846;2447;7852
290405;201511;4635;14622;3867;13126;575;1980;2301;8006;2876;9986
290410;201511;6007;17637;4859;15802;471;1813;3393;10706;3864;12519
290420;201511;3281;9436;2725;8645;224;775;2105;6655;2329;7430
290430;201511;3067;9656;2751;9083;496;1730;1676;5579;2172;7309
290440;201511;2978;7892;2428;7118;179;636;1857;5465;2036;6101
290450;201511;3303;9544;2831;8856;332;1115;1940;6056;2272;7171
290460;201511;12822;37155;11410;34757;3083;9574;4801;14717;7884;24291
290470;201511;4520;12325;3423;10684;801;2725;1469;4722;2270;7447
290475;201511;5126;17140;4584;16093;333;1527;3402;11713;3735;13240
290480;201511;2500;6640;2288;6363;312;880;1563;4546;1875;5426
290485;201511;4788;15113;4158;14170;309;1505;3276;10885;3585;12390
290490;201511;7960;20970;7550;20409;673;1923;6070;16234;6743;18157
290500;201511;4206;13107;3391;11471;524;1935;1788;6005;2312;7940
290510;201511;3368;9600;2914;8967;169;625;2411;7409;2580;8034
290515;201511;3301;9514;2802;8841;285;931;2180;6979;2465;7910
290520;201511;12118;37005;9717;32446;879;3492;5905;19523;6784;23015
290530;201511;5075;14900;4415;13870;337;1037;3451;10908;3788;11945
290540;201511;3891;11230;3682;10969;438;1296;2850;8607;3288;9903
290550;201511;4484;11917;3951;11298;146;446;3587;10285;3733;10731
290560;201511;6152;17969;5399;16842;1314;4131;2972;9528;4286;13659
290570;201511;42814;116899;38524;110708;4248;12551;27207;78046;31455;90597
290580;201511;7015;23749;6577;23052;848;3084;4666;16714;5514;19798
290590;201511;7396;23418;6316;21468;314;1316;5033;17066;5347;18382
290600;201511;17351;52394;15975;50347;2352;7130;11367;37068;13719;44198
290610;201511;2475;8304;2047;7456;153;716;1423;5089;1576;5805
290620;201511;6524;19582;5911;18611;407;1307;4796;15073;5203;16380
290630;201511;7963;20828;7018;19787;640;1867;5764;16367;6404;18234
290640;201511;2676;7752;2118;6831;153;603;1587;5040;1740;5643
290650;201511;11194;31658;10380;30505;2176;6292;6325;19151;8501;25443
290660;201511;3631;10100;3128;9366;147;498;2372;7330;2519;7828
290670;201511;6881;20937;6146;19729;712;2335;4314;14084;5026;16419
290680;201511;10224;30368;9190;29081;462;1820;7603;23864;8065;25684
290682;201511;4467;12810;3975;12105;163;625;3391;10200;3554;10825
290685;201511;3760;8917;2455;7064;291;879;1484;4373;1775;5252
290687;201511;7633;21158;5932;18593;1392;4428;2862;9321;4254;13749
290689;201511;3174;9134;2751;8465;259;832;2067;6561;2326;7393
290690;201511;5499;15622;4867;14767;790;2441;3162;9647;3952;12088
290700;201511;2346;7301;2207;7095;180;665;1680;5394;1860;6059
290710;201511;7728;24374;7227;23619;363;1237;6153;20204;6516;21441
290720;201511;18576;54146;16832;51951;1401;4163;13599;42906;15000;47069
290730;201511;7140;19728;6365;18706;1056;3006;4154;12391;5210;15397
290740;201511;931;2756;770;2469;84;292;515;1663;599;1955
290750;201511;9990;27753;8387;24784;1468;4782;4478;12699;5946;17481
290755;201511;2360;6628;1919;5894;97;350;1408;4285;1505;4635
290760;201511;4288;12802;3464;11309;459;1384;2148;7218;2607;8602
290770;201511;2513;8830;2371;8632;103;480;1910;6967;2013;7447
290780;201511;8950;22549;7695;20738;821;1698;5803;16364;6624;18062
290790;201511;4309;12969;3982;12507;257;827;3335;10513;3592;11340
290800;201511;7350;15574;5818;13930;684;1354;4291;10948;4975;12302
290810;201511;5133;15832;4316;14506;211;792;3254;11034;3465;11826
290820;201511;5649;15671;4983;14781;475;1609;3762;11199;4237;12808
290830;201511;4324;11488;3944;10935;233;785;2968;7999;3201;8784
290840;201511;17649;49629;15507;46400;2537;7369;9864;30707;12401;38076
290850;201511;6213;17902;5970;17587;731;1918;4732;14483;5463;16401
290860;201511;5018;16917;4658;16474;471;1785;3598;12977;4069;14762
290870;201511;4694;13707;3768;12161;269;1069;2688;8586;2957;9655
290880;201511;1440;3887;1128;3380;104;295;750;2276;854;2571
290890;201511;6963;18118;5939;16962;689;1835;4596;13352;5285;15187
290900;201511;2651;7360;1930;6160;295;973;959;3068;1254;4041
290910;201511;4684;12579;3893;11423;121;452;3309;9591;3430;10043
290920;201511;4673;13457;4255;12872;314;901;3455;10552;3769;11453
290930;201511;7736;23872;6794;22243;428;1852;5201;16721;5629;18573
290940;201511;3468;10959;3171;10551;138;477;2683;9115;2821;9592
290950;201511;1554;4296;1354;3990;170;490;888;2664;1058;3154
290960;201511;5747;16234;5208;15533;194;701;4342;12981;4536;13682
290970;201511;3678;11550;3193;10743;322;1092;2139;7325;2461;8417
290980;201511;10569;30119;8899;26990;2400;7451;2830;8582;5230;16033
290990;201511;9054;27018;7813;24957;860;2846;5620;17838;6480;20684
291000;201511;2945;8910;2675;8575;175;639;2325;7468;2500;8107
291005;201511;14274;37226;12434;34715;1791;5054;8369;23750;10160;28804
291010;201511;3307;10186;2568;8596;264;910;1625;5507;1889;6417
291020;201511;1383;3607;1041;2988;118;347;566;1525;684;1872
291030;201511;2264;6144;1638;4905;174;558;980;2869;1154;3427
291040;201511;5554;16587;4931;15702;383;1428;3812;12103;4195;13531
291050;201511;7764;25121;6990;23651;1713;6478;3493;11361;5206;17839
291060;201511;6021;21946;5657;21348;940;3938;3586;13356;4526;17294
291070;201511;16098;46176;14030;43162;1132;3818;10617;32686;11749;36504
291072;201511;23080;67345;18443;58145;4680;15965;6437;20390;11117;36355
291075;201511;5079;14344;4488;13496;258;661;3518;10861;3776;11522
291077;201511;1488;4178;1182;3674;97;317;761;2363;858;2680
291080;201511;78391;241819;69048;223183;23680;77706;16170;51618;39850;129324
291085;201511;5653;14763;4859;13707;439;1318;3889;10963;4328;12281
291090;201511;1500;3717;1359;3549;53;158;1195;3115;1248;3273
291100;201511;2620;6685;2126;6149;101;391;1681;4792;1782;5183
291110;201511;4712;17191;4293;16530;551;2437;2965;11214;3516;13651
291120;201511;7354;19713;6745;18808;883;2487;4702;13221;5585;15708
291125;201511;1887;3788;1423;3291;98;237;1120;2632;1218;2869
291130;201511;2862;8870;2403;8061;130;566;1783;5823;1913;6389
291140;201511;4208;12395;3671;11393;520;1559;2338;7334;2858;8893
291150;201511;1963;5168;1852;5038;119;366;1516;4067;1635;4433
291160;201511;5364;16574;4660;15386;1115;3698;2377;7889;3492;11587
291165;201511;2533;7069;1938;5952;59;236;1398;4180;1457;4416
291170;201511;21651;56083;18445;51788;1462;4447;12550;35280;14012;39727
291180;201511;6331;16492;5097;14614;459;1468;3624;10397;4083;11865
291185;201511;3762;10212;3356;9598;294;847;2670;7583;2964;8430
291190;201511;7119;19412;6268;18221;509;1744;4967;14263;5476;16007
291200;201511;2917;8633;2330;7539;164;547;1561;5133;1725;5680
291210;201511;6947;16619;5854;15358;307;948;4502;11782;4809;12730
291220;201511;4148;12857;3773;12256;497;1855;2542;8142;3039;9997
291230;201511;4030;10223;3650;9795;82;167;3423;9314;3505;9481
291240;201511;4632;12511;3976;11313;146;460;3210;8984;3356;9444
291250;201511;3574;10898;2810;9477;296;1015;1862;6362;2158;7377
291260;201511;1070;3103;980;2983;71;278;808;2386;879;2664
291270;201511;4323;13990;3909;13184;1326;4610;1756;6020;3082;10630
291280;201511;2206;6116;1709;5326;412;1407;796;2361;1208;3768
291290;201511;5557;15311;4806;14346;853;2544;2829;8568;3682;11112
291300;201511;4413;12491;3410;10761;220;805;2506;7776;2726;8581
291310;201511;5389;15306;4682;14011;325;1030;3593;10707;3918;11737
291320;201511;6057;18941;4972;16844;1132;4053;2400;8090;3532;12143
291330;201511;1583;4767;1404;4473;134;489;981;3069;1115;3558
291340;201511;3889;11025;3212;10063;152;497;2562;8005;2714;8502
291345;201511;3472;10914;3209;10596;223;753;2701;9098;2924;9851
291350;201511;5698;16654;4960;15393;306;1035;3846;12061;4152;13096
291360;201511;32997;91017;29597;86207;7336;21325;16411;49199;23747;70524
291370;201511;8350;23779;7825;23116;563;1777;6081;18128;6644;19905
291380;201511;3667;11097;3130;10220;223;819;2270;7523;2493;8342
291390;201511;9991;27193;9237;26275;1410;3810;6588;18993;7998;22803
291400;201511;15249;40391;12562;36554;2433;6527;7326;22880;9759;29407
291410;201511;3246;8500;2397;7158;143;594;1727;4967;1870;5561
291420;201511;2088;5707;1815;5373;96;354;1502;4364;1598;4718
291430;201511;3274;9537;2909;9052;139;660;2356;7086;2495;7746
291440;201511;6567;19925;5529;18144;549;1912;4053;13418;4602;15330
291450;201511;8303;24164;7262;22694;368;1165;5775;18775;6143;19940
291460;201511;13167;39569;11780;37358;1771;6105;7240;23043;9011;29148
291465;201511;8006;22601;7064;21525;484;1752;5726;17282;6210;19034
291470;201511;15831;42391;13814;39944;1163;3193;10363;30990;11526;34183
291480;201511;34345;88209;28960;80647;4111;12491;16968;47062;21079;59553
291490;201511;4344;13926;4110;13593;468;1587;3029;10132;3497;11719
291500;201511;4302;12278;3629;11293;232;859;2844;8790;3076;9649
291510;201511;3569;10753;3263;10348;84;289;2920;9353;3004;9642
291520;201511;3912;10570;3358;9817;349;1095;2286;6692;2635;7787
291530;201511;2145;5919;1723;5286;402;1235;865;2819;1267;4054
291535;201511;3823;11473;3427;10853;218;760;2666;8483;2884;9243
291540;201511;2158;5098;1799;4722;136;238;1566;4265;1702;4503
291550;201511;5245;14031;4552;13063;1010;2747;2530;7499;3540;10246
291560;201511;18471;43514;13152;37322;1115;3145;9828;28820;10943;31965
291570;201511;2231;5959;2047;5733;155;363;1734;5017;1889;5380
291580;201511;5602;16857;4929;15853;550;2181;3499;11117;4049;13298
291590;201511;1757;5540;1585;5257;175;636;1158;3871;1333;4507
291600;201511;5736;15533;4139;13032;1142;3726;1617;5036;2759;8762
291610;201511;4894;15354;4708;15134;178;621;4245;13730;4423;14351
291620;201511;2989;7030;2340;6341;143;424;1876;5195;2019;5619
291630;201511;3182;7674;2627;7031;287;745;1974;5370;2261;6115
291640;201511;17219;46473;13699;41286;3390;10693;4405;13598;7795;24291
291650;201511;7963;23726;7334;22957;659;1736;6023;19419;6682;21155
291660;201511;2211;5780;1827;5186;157;546;1198;3230;1355;3776
291670;201511;1835;5125;1646;4852;99;287;1320;3951;1419;4238
291680;201511;4147;11948;3556;10941;666;2202;2026;6207;2692;8409
291685;201511;4732;11855;3901;10751;692;1824;2499;7135;3191;8959
291690;201511;4036;10689;3126;9195;232;641;2199;6460;2431;7101
291700;201511;9087;28215;8052;26388;955;3042;5822;19371;6777;22413
291710;201511;5230;13541;4239;12297;367;1132;3084;8980;3451;10112
291720;201511;4362;14341;3709;12986;338;1362;2548;8760;2886;10122
291730;201511;6006;17898;5432;17119;570;1914;4144;13253;4714;15167
291733;201511;2584;7473;2202;6949;220;747;1441;4660;1661;5407
291735;201511;2800;7807;2322;7098;125;452;1860;5645;1985;6097
291740;201511;3627;10657;3108;9905;248;902;2420;7675;2668;8577
291750;201511;22477;57414;17240;49264;3889;11418;8324;24290;12213;35708
291760;201511;11107;35156;9760;32784;3890;14423;2609;8640;6499;23063
291770;201511;7650;21995;6458;19812;852;2807;4104;12324;4956;15131
291780;201511;4468;13462;4160;12935;303;980;3361;10430;3664;11410
291790;201511;2637;8062;2485;7851;94;419;2104;6518;2198;6937
291800;201511;30172;81951;26269;76444;4348;12760;16039;48096;20387;60856
291810;201511;10578;29082;8849;26947;441;1577;7136;21659;7577;23236
291820;201511;3720;10947;3334;10373;236;805;2542;7929;2778;8734
291830;201511;4142;11015;3800;10516;544;1570;2690;7492;3234;9062
291835;201511;6304;19553;5009;17218;1447;5348;2298;7945;3745;13293
291840;201511;47606;132326;41616;125451;6488;19097;28789;89552;35277;108649
291845;201511;2719;7898;2524;7653;162;414;2236;6953;2398;7367
291850;201511;4612;13129;3766;11784;370;1071;2750;8870;3120;9941
291855;201511;1835;4596;1575;4264;175;598;1138;2964;1313;3562
291860;201511;2150;6099;1740;5302;91;337;1144;3406;1235;3743
291870;201511;1418;3764;1013;3011;70;262;638;1817;708;2079
291875;201511;2823;8870;2552;8456;126;525;1837;5948;1963;6473
291880;201511;4902;15658;4572;15083;452;1506;3431;11440;3883;12946
291890;201511;1300;3339;1075;3069;289;810;630;1899;919;2709
291900;201511;1272;3421;1039;3049;63;233;797;2303;860;2536
291905;201511;2717;7372;2038;6136;198;700;1401;4017;1599;4717
291910;201511;2765;7317;2309;6773;134;505;1929;5582;2063;6087
291915;201511;7080;21415;5898;19256;338;1191;4593;15078;4931;16269
291920;201511;28278;81704;25584;77818;4348;13706;15363;47036;19711;60742
291930;201511;2629;7693;2303;7170;197;731;1626;4931;1823;5662
291940;201511;3358;9514;2451;7845;318;1133;1396;4333;1714;5466
291950;201511;8714;28954;7860;27343;1239;4347;4570;16373;5809;20720
291955;201511;10441;30218;9625;29168;2275;6946;5322;16899;7597;23845
291960;201511;3182;9252;2580;8341;248;809;1864;6221;2112;7030
291970;201511;3881;12020;3585;11540;418;1524;2389;7693;2807;9217
291980;201511;11971;33826;9079;29631;1086;3626;6004;20108;7090;23734
291990;201511;2198;6689;1987;6409;88;286;1664;5518;1752;5804
291992;201511;2759;8380;2684;8237;370;1190;2013;6141;2383;7331
291995;201511;1990;5785;1742;5425;118;449;1458;4512;1576;4961
292000;201511;2402;6734;2138;6370;251;867;1495;4464;1746;5331
292010;201511;6399;16112;4940;14007;520;1388;3584;10325;4104;11713
292020;201511;3989;13776;3756;13363;660;2452;2622;9306;3282;11758
292030;201511;2040;6259;1808;5921;230;803;1049;3412;1279;4215
292040;201511;4433;11929;3785;11243;299;647;3169;9985;3468;10632
292045;201511;3054;9909;2822;9581;117;467;2567;8601;2684;9068
292050;201511;6319;19124;5374;17197;454;1725;3486;10991;3940;12716
292060;201511;11568;30951;10685;29816;1158;2861;8284;23325;9442;26186
292070;201511;4693;14411;4424;14100;420;1274;3638;11748;4058;13022
292080;201511;3538;9167;2918;8389;195;621;2447;7049;2642;7670
292090;201511;3978;10389;3417;9730;220;745;2858;8166;3078;8911
292100;201511;11405;30333;9476;27642;2510;7583;4272;13013;6782;20596
292105;201511;3022;9342;2687;8804;135;567;2152;7018;2287;7585
292110;201511;6568;17424;5080;15029;1386;4105;2427;7353;3813;11458
292120;201511;7718;21506;6421;19029;1298;3791;3406;10404;4704;14195
292130;201511;2971;8033;2535;7404;482;1286;1524;4653;2006;5939
292140;201511;5001;12988;4137;11765;789;2058;2654;7772;3443;9830
292145;201511;2448;7451;2167;6961;306;955;1424;4765;1730;5720
292150;201511;12846;39067;11774;37315;643;2335;9381;29756;10024;32091
292160;201511;2525;7227;2134;6716;122;482;1830;5693;1952;6175
292170;201511;8769;24908;7203;22160;903;3099;4589;13976;5492;17075
292180;201511;2993;8721;2376;7638;387;1199;1381;4563;1768;5762
292190;201511;3435;9564;2833;8659;577;1842;1558;4815;2135;6657
292200;201511;6752;20784;5705;18878;1683;5969;1989;6544;3672;12513
292205;201511;3809;11590;3372;10910;178;785;2714;8507;2892;9292
292210;201511;6478;17436;5395;16002;355;1243;4380;12940;4735;14183
292220;201511;1896;5207;1691;4894;540;1467;724;2152;1264;3619
292225;201511;3226;9870;2917;9402;180;712;2352;7534;2532;8246
292230;201511;6521;18995;6141;18377;360;1488;4738;13631;5098;15119
292240;201511;4783;14327;4247;13237;488;1597;2930;9037;3418;10634
292250;201511;5077;15538;4650;14744;1156;3759;2041;6548;3197;10307
292260;201511;3135;9273;2923;8982;205;639;2417;7466;2622;8105
292265;201511;3131;9534;2678;8755;138;616;2011;6421;2149;7037
292270;201511;4136;10380;3252;9355;168;561;2700;7793;2868;8354
292273;201511;2763;6363;2073;5511;203;499;1536;4289;1739;4788
292275;201511;1680;4495;1484;4205;199;573;1072;3082;1271;3655
292280;201511;2082;5971;1799;5645;175;503;1354;4519;1529;5022
292285;201511;2520;6791;2092;6169;113;410;1636;4751;1749;5161
292290;201511;7110;21119;5884;19454;413;1598;4495;14946;4908;16544
292300;201511;8153;24275;7072;22943;1771;6024;3838;12749;5609;18773
292303;201511;2832;8611;2565;8249;106;452;2184;6878;2290;7330
292305;201511;2939;7903;2759;7642;64;243;2500;6834;2564;7077
292310;201511;5872;17308;5419;16620;190;662;4476;13684;4666;14346
292320;201511;6544;18503;5524;16778;451;1448;4178;12628;4629;14076
292330;201511;2181;5845;1998;5585;175;574;1580;4342;1755;4916
292335;201511;5112;13382;4550;12634;463;1231;3614;10200;4077;11431
292340;201511;6250;17809;5294;16205;534;1639;3705;11394;4239;13033
292350;201511;2281;6678;1978;6243;166;637;1548;4850;1714;5487
292360;201511;5218;13706;4945;13186;219;446;4123;11529;4342;11975
292370;201511;8078;23515;7288;22435;719;1949;5655;17774;6374;19723
292380;201511;7237;21337;6577;20280;557;1585;5139;16060;5696;17645
292390;201511;3480;7910;2929;7301;92;195;2685;6754;2777;6949
292400;201511;20701;62357;19435;60350;2438;7667;14126;44065;16564;51732
292405;201511;4512;11252;3603;10068;206;529;2892;8166;3098;8695
292410;201511;1940;5197;1810;5055;131;351;1520;4244;1651;4595
292420;201511;3760;12127;3551;11818;236;883;2939;9803;3175;10686
292430;201511;5602;16503;4195;14439;326;1307;2936;10049;3262;11356
292440;201511;8456;27823;7799;26834;228;972;6950;24067;7178;25039
292450;201511;4019;11952;3276;10722;337;1106;2274;7542;2611;8648
292460;201511;5161;15271;4420;13996;602;2029;2897;9152;3499;11181
292465;201511;2396;7082;1989;6405;209;768;1277;4149;1486;4917
292467;201511;1919;6086;1822;5933;302;1044;1200;3979;1502;5023
292470;201511;2889;7726;2377;6856;105;362;1869;5326;1974;5688
292480;201511;6047;16224;5202;15099;162;604;4642;13393;4804;13997
292490;201511;2378;6488;1948;5848;154;492;1484;4433;1638;4925
292500;201511;6502;19235;5512;17449;691;2243;3569;11462;4260;13705
292510;201511;12885;36226;11087;33654;843;2971;8500;25925;9343;28896
292520;201511;5511;15789;4752;14604;1141;3525;2429;7597;3570;11122
292525;201511;5230;13715;4471;12813;198;639;3768;10783;3966;11422
292530;201511;27523;77203;23541;71668;6315;19818;10644;33355;16959;53173
292540;201511;2836;7821;2491;7381;275;934;1895;5558;2170;6492
292550;201511;6450;19829;5600;18708;663;2351;4156;14216;4819;16567
292560;201511;4002;11120;3469;10323;191;736;2659;7769;2850;8505
292570;201511;4062;11737;3759;11421;79;182;3549;11028;3628;11210
292575;201511;6226;20623;6001;20259;707;2447;4678;15899;5385;18346
292580;201511;6801;19973;6376;19377;391;1266;5337;16198;5728;17464
292590;201511;7210;21567;6665;20747;504;1578;5454;16899;5958;18477
292593;201511;3030;7862;2487;7007;239;617;1859;5230;2098;5847
292595;201511;5792;16006;5079;15084;396;1246;3923;11705;4319;12951
292600;201511;10615;29816;9526;28413;940;2264;7278;22543;8218;24807
292610;201511;4585;12831;3726;11426;325;1025;2257;7225;2582;8250
292620;201511;5993;17438;5252;16576;126;426;4862;15436;4988;15862
292630;201511;9344;23451;7700;20907;888;2322;5234;14519;6122;16841
292640;201511;7849;25269;7197;24275;471;1760;5461;18616;5932;20376
292650;201511;4750;12632;4440;12228;385;895;3696;10301;4081;11196
292660;201511;10655;31863;9779;30579;1072;3444;7294;23089;8366;26533
292665;201511;2525;7696;2407;7539;54;144;2221;7015;2275;7159
292670;201511;3701;10405;2858;8894;189;640;1829;5676;2018;6316
292680;201511;3610;10805;3260;10216;419;1227;2316;7291;2735;8518
292690;201511;2910;7888;2126;6638;184;584;1453;4655;1637;5239
292700;201511;9235;27398;8102;25696;1174;3481;5220;17355;6394;20836
292710;201511;2086;6789;1963;6625;72;283;1734;5856;1806;6139
292720;201511;9263;23519;7953;22055;363;1159;6784;18946;7147;20105
292730;201511;3576;10664;3426;10434;302;962;2630;8026;2932;8988
292740;201511;324413;865044;301075;829495;53640;156361;186986;509617;240626;665978
292750;201511;6453;17249;5506;15931;306;993;4429;12823;4735;13816
292760;201511;4027;12525;3612;11763;423;1457;2416;7909;2839;9366
292770;201511;6065;17547;5306;16456;1003;3256;3127;9970;4130;13226
292780;201511;1900;4487;1450;3901;128;436;1026;2663;1154;3099
292790;201511;3281;8019;3141;7873;89;162;2978;7557;3067;7719
292800;201511;8995;26558;8276;25354;512;1726;6598;20111;7110;21837
292805;201511;2949;8284;2605;7793;323;1033;1892;5634;2215;6667
292810;201511;9435;28118;7830;25857;945;3221;5399;18223;6344;21444
292820;201511;7094;20607;5460;18235;323;1345;4251;14147;4574;15492
292830;201511;1785;5136;1597;4868;85;351;1373;4114;1458;4465
292840;201511;7619;23429;7096;22714;343;1430;6200;19465;6543;20895
292850;201511;3190;8382;2578;7435;355;1040;1565;4422;1920;5462
292860;201511;14881;38644;13584;36926;1192;3348;10464;28342;11656;31690
292870;201511;19043;51916;16484;47833;2158;6882;9566;27270;11724;34152
292880;201511;12742;35862;11225;33688;1217;4032;7740;22826;8957;26858
292890;201511;5332;17905;4787;16913;677;2523;3078;11027;3755;13550
292895;201511;2751;6697;2143;5776;264;647;1465;4020;1729;4667
292900;201511;2781;8559;2636;8327;184;816;1945;5846;2129;6662
292905;201511;4061;11928;3346;10821;237;857;2432;7847;2669;8704
292910;201511;5000;14817;4509;13910;642;2083;2672;8247;3314;10330
292920;201511;9056;26432;8531;25624;568;2053;6974;20344;7542;22397
292925;201511;5110;15474;4590;14709;424;1373;3463;11141;3887;12514
292930;201511;6467;20640;6094;19958;482;2062;4360;13856;4842;15918
292935;201511;2098;6038;1763;5673;111;397;1458;4845;1569;5242
292937;201511;3229;8181;2672;7490;229;690;2071;5787;2300;6477
292940;201511;3281;8942;2560;7930;301;924;1714;5533;2015;6457
292950;201511;7964;23244;7358;22195;550;2002;5404;15866;5954;17868
292960;201511;5206;13413;4460;12392;319;950;3270;9021;3589;9971
292970;201511;4263;12700;3736;11983;154;692;3058;9730;3212;10422
292975;201511;3454;9218;3231;8930;360;914;2696;7587;3056;8501
292980;201511;3301;8822;2553;7763;223;787;1825;5493;2048;6280
292990;201511;11859;33854;10352;31553;440;1560;8457;25606;8897;27166
293000;201511;2830;7315;2566;7000;59;188;2082;5977;2141;6165
293010;201511;17982;49528;15152;44900;2501;7891;8781;25688;11282;33579
293015;201511;7413;25274;6551;23558;763;3120;4260;15169;5023;18289
293020;201511;9118;30258;8522;29427;353;1570;7291;25054;7644;26624
293030;201511;5449;15671;4319;13890;277;926;3060;10209;3337;11135
293040;201511;3659;12037;3484;11702;193;655;3045;10246;3238;10901
293050;201511;20018;54917;17527;51742;3062;9217;9896;30453;12958;39670
293060;201511;3815;9962;3094;8769;266;811;2236;6241;2502;7052
293070;201511;21580;61761;18700;57253;4592;14136;9004;28353;13596;42489
293075;201511;3268;11053;2998;10651;231;960;2315;8255;2546;9215
293076;201511;3785;10365;3384;9824;199;539;2825;8381;3024;8920
293077;201511;4781;15016;4294;14298;1024;3594;2299;7841;3323;11435
293080;201511;4580;14376;4168;13709;207;966;3436;11065;3643;12031
293090;201511;3266;10477;2694;9602;297;1125;1884;6821;2181;7946
293100;201511;5774;17000;4771;15206;457;1552;3413;10957;3870;12509
293105;201511;3988;13055;3445;11978;552;1875;2137;7624;2689;9499
293110;201511;2000;5706;1758;5339;64;217;1456;4427;1520;4644
293120;201511;3750;12356;3546;12033;358;1100;2723;9495;3081;10595
293130;201511;4079;11459;3447;10762;152;548;3058;9627;3210;10175
293135;201511;31562;79211;23548;67713;4900;15820;9414;26701;14314;42521
293140;201511;1965;5578;1864;5437;143;526;1494;4208;1637;4734
293150;201511;5491;18028;4677;16398;787;2835;2809;10066;3596;12901
293160;201511;3763;9602;3440;9224;592;1178;2450;7143;3042;8321
293170;201511;3332;9832;3028;9387;327;1176;2113;6567;2440;7743
293180;201511;5232;14641;4159;12881;178;736;3223;9736;3401;10472
293190;201511;13789;41439;12686;39762;449;2101;10869;33390;11318;35491
293200;201511;7034;19365;6104;18163;211;779;4837;14472;5048;15251
293210;201511;4960;14318;4347;13244;290;946;3292;9993;3582;10939
293220;201511;5126;14909;4389;13596;1170;3650;1651;5255;2821;8905
293230;201511;3823;11626;3453;11048;491;1719;2351;7496;2842;9215
293240;201511;4408;12007;3523;10530;150;485;2598;7746;2748;8231
293245;201511;4223;12055;3825;11461;302;886;2916;8798;3218;9684
293250;201511;5728;15705;5137;14811;528;1563;3649;10463;4177;12026
293260;201511;4581;13576;3865;12522;283;952;2885;9452;3168;10404
293270;201511;5678;15015;5233;14536;438;1035;4494;12741;4932;13776
293280;201511;5309;14866;4501;13776;255;765;3548;11018;3803;11783
293290;201511;14938;49088;13782;46805;3319;11649;6372;22033;9691;33682
293300;201511;6855;16139;5711;14808;355;838;4440;11719;4795;12557
293305;201511;4858;12001;4088;10963;154;474;3437;9163;3591;9637
293310;201511;2517;6548;2027;5703;177;488;1398;3923;1575;4411
293315;201511;4228;10792;3605;9823;425;1103;2589;7156;3014;8259
293317;201511;2450;7107;2173;6589;209;633;1465;4482;1674;5115
293320;201511;7933;26159;7700;25858;797;2873;6076;20433;6873;23306
293325;201511;1841;5199;1496;4660;198;680;987;3064;1185;3744
293330;201511;51159;161785;45404;151459;9887;35233;21972;73731;31859;108964
293340;201511;2681;7524;2071;6458;312;1004;1132;3525;1444;4529
293345;201511;3349;9819;2891;9194;264;722;2212;7352;2476;8074
293350;201511;6645;19001;6252;18538;296;664;5584;17079;5880;17743
293360;201511;12985;39582;11685;37928;1032;3760;9730;31486;10762;35246
310010;201511;1002;2719;768;2346;132;500;333;944;465;1444
310020;201511;3174;9797;2541;8484;575;2093;406;1204;981;3297
310030;201511;2345;7270;1910;6508;433;1644;992;3306;1425;4950
310040;201511;1028;2682;841;2430;70;244;639;1810;709;2054
310050;201511;1911;6484;1709;6023;337;1343;691;2350;1028;3693
310060;201511;3231;10165;2812;9623;377;1353;1994;6838;2371;8191
310070;201511;340;966;265;828;23;100;157;450;180;550
310080;201511;738;2193;590;1935;111;463;212;633;323;1096
310090;201511;4686;13826;3985;12580;515;1796;2478;7747;2993;9543
310100;201511;3354;10139;2780;9164;210;819;2118;6937;2328;7756
310110;201511;4849;13542;4125;12344;714;2399;2249;6485;2963;8884
310120;201511;618;1874;485;1593;131;545;187;493;318;1038
310130;201511;421;1257;375;1184;92;343;188;538;280;881
310140;201511;203;668;165;601;53;236;44;128;97;364
310150;201511;4668;14255;4013;12966;999;3522;1511;4755;2510;8277
310160;201511;7591;23537;6132;20834;1809;6657;1298;4248;3107;10905
310163;201511;996;3178;822;2827;228;821;228;773;456;1594
310170;201511;9122;25584;8102;24104;1251;3899;5187;15695;6438;19594
310180;201511;1643;4689;1371;4262;310;1059;639;1903;949;2962
310190;201511;2757;9123;2506;8713;699;2646;371;1280;1070;3926
310200;201511;1891;6096;1568;5421;345;1326;540;1838;885;3164
310205;201511;1129;3230;867;2811;157;521;461;1513;618;2034
310210;201511;2724;7908;2440;7483;224;745;1890;5810;2114;6555
310220;201511;1067;3263;973;3103;188;685;557;1721;745;2406
310230;201511;2559;7937;2127;6986;396;1537;1056;3247;1452;4784
310240;201511;922;3327;817;3106;130;549;431;1683;561;2232
310250;201511;851;2790;817;2728;153;628;481;1488;634;2116
310260;201511;3333;10476;2544;8788;635;2476;652;2005;1287;4481
310270;201511;2532;7219;2103;6598;190;721;1604;4977;1794;5698
310280;201511;2310;6120;1910;5518;246;905;1030;2795;1276;3700
310285;201511;2062;7345;1926;7133;246;1065;1416;5282;1662;6347
310290;201511;1150;3476;1081;3375;261;926;528;1488;789;2414
310300;201511;1733;5791;1630;5595;448;1750;809;2644;1257;4394
310310;201511;376;1020;267;809;38;109;123;382;161;491
310320;201511;386;1223;317;1082;46;217;150;486;196;703
310330;201511;508;1270;337;943;33;112;145;348;178;460
310340;201511;8405;25124;6875;22473;1341;4473;3454;11706;4795;16179
310350;201511;14295;37613;10172;30618;2520;8494;2855;8180;5375;16674
310360;201511;442;1321;413;1281;38;160;288;832;326;992
310370;201511;1414;4690;1287;4464;367;1288;637;2245;1004;3533
310375;201511;1253;3330;788;2467;116;422;303;919;419;1341
310380;201511;386;1021;268;842;93;320;90;252;183;572
310390;201511;460;1606;385;1442;85;354;73;230;158;584
310400;201511;10430;28980;7683;24114;1867;6365;1849;5773;3716;12138
310410;201511;811;2624;541;2132;115;511;113;417;228;928
310420;201511;5731;16015;3515;11199;637;2223;552;1516;1189;3739
310430;201511;1375;4482;1035;3764;262;1049;170;557;432;1606
310440;201511;579;1647;441;1391;86;316;180;531;266;847
310445;201511;1248;4055;1024;3620;144;533;639;2257;783;2790
310450;201511;4626;12949;3691;11594;454;1486;2453;7819;2907;9305
310460;201511;1540;4603;1268;4172;367;1331;281;972;648;2303
310470;201511;3630;8969;3049;8254;287;713;2478;6863;2765;7576
310480;201511;1242;3602;911;2932;185;625;360;1085;545;1710
310490;201511;2939;9480;2486;8564;627;2515;946;3111;1573;5626
310500;201511;1300;4345;1145;4005;264;1035;432;1438;696;2473
310510;201511;2141;6668;1641;5543;407;1486;278;896;685;2382
310520;201511;1420;3677;1079;3139;84;249;722;2101;806;2350
310530;201511;968;2910;503;1712;67;253;67;186;134;439
310540;201511;2989;9710;2684;9142;670;2378;1136;3886;1806;6264
310550;201511;1212;3424;961;3004;215;808;447;1285;662;2093
310560;201511;15577;47199;13001;42076;3537;12754;3891;11708;7428;24462
310570;201511;1179;3510;994;3188;157;598;648;2033;805;2631
310590;201511;4349;12528;3417;10768;638;2136;1315;4015;1953;6151
310600;201511;1394;4575;1236;4232;306;1218;445;1371;751;2589
310610;201511;487;1629;415;1467;85;376;127;386;212;762
310620;201511;147408;446899;123369;400465;28929;105307;47335;142635;76264;247942
310630;201511;4004;12117;3685;11562;377;1367;2705;8411;3082;9778
310640;201511;1320;3942;1030;3415;321;1161;258;775;579;1936
310650;201511;2677;8476;2136;7526;361;1354;1172;4137;1533;5491
310660;201511;1369;4108;1195;3862;135;449;844;2695;979;3144
310665;201511;1268;3820;1125;3615;107;378;866;2826;973;3204
310670;201511;43260;130890;37728;119100;9707;32501;13646;41596;23353;74097
310680;201511;686;1959;622;1862;112;370;383;1117;495;1487
310690;201511;1431;4599;1143;4078;260;1087;368;1216;628;2303
310700;201511;591;1469;451;1282;87;292;257;697;344;989
310710;201511;6419;20763;4927;18169;1038;4539;817;2630;1855;7169
310720;201511;777;2330;699;2193;104;383;421;1277;525;1660
310730;201511;9402;28972;8319;27159;1599;5663;4697;15201;6296;20864
310740;201511;4997;15816;3936;13685;968;3725;853;2783;1821;6508
310750;201511;1511;3716;1137;3212;216;640;573;1531;789;2171
310760;201511;625;1863;512;1673;108;380;197;640;305;1020
310770;201511;881;2743;674;2413;156;640;273;901;429;1541
310780;201511;3737;10326;3137;9262;498;1472;1884;5557;2382;7029
310790;201511;1938;6173;1722;5768;434;1522;774;2699;1208;4221
310800;201511;2823;8900;2139;7540;649;2623;195;615;844;3238
310810;201511;1219;3382;1074;3122;191;618;580;1592;771;2210
310820;201511;1300;3691;927;2983;228;804;246;763;474;1567
310825;201511;2513;8413;1965;7435;132;688;1416;5294;1548;5982
310830;201511;1334;4297;1029;3677;303;1165;268;889;571;2054
310840;201511;2181;6614;1674;5686;369;1349;456;1439;825;2788
310850;201511;1579;4596;1309;4245;198;687;887;2873;1085;3560
310855;201511;2921;9151;2493;8475;424;1570;1571;5377;1995;6947
310860;201511;7557;23040;6294;20749;869;3070;3632;12135;4501;15205
310870;201511;1021;2809;795;2436;142;475;405;1246;547;1721
310880;201511;1200;3603;889;3011;160;634;437;1453;597;2087
310890;201511;2686;8154;2051;7023;493;1909;449;1373;942;3282
310900;201511;4050;12742;3143;10778;725;2770;970;3061;1695;5831
310910;201511;2017;5686;1281;4207;256;957;191;515;447;1472
310920;201511;1908;5567;1480;4903;346;1308;622;2011;968;3319
310925;201511;923;3001;827;2827;310;1171;287;929;597;2100
310930;201511;6070;17062;4810;15167;850;2861;2693;8720;3543;11581
310940;201511;6276;17626;5182;15928;924;2914;2703;8257;3627;11171
310945;201511;1222;3518;1048;3255;145;533;639;1905;784;2438
310950;201511;2048;6457;1489;5217;395;1613;382;1166;777;2779
310960;201511;403;1294;329;1154;90;360;110;376;200;736
310970;201511;1494;4969;1049;3880;261;1076;138;411;399;1487
310980;201511;470;1139;289;832;39;135;138;343;177;478
310990;201511;1206;3901;966;3389;222;890;269;854;491;1744
311000;201511;3644;12302;3229;11450;872;3501;1095;3582;1967;7083
311010;201511;756;2485;697;2373;216;813;326;1071;542;1884
311020;201511;910;2688;712;2334;153;566;302;926;455;1492
311030;201511;1642;4469;1129;3525;291;1037;369;1015;660;2052
311040;201511;486;1633;421;1469;86;311;98;323;184;634
311050;201511;2084;6479;1812;6041;496;1829;789;2614;1285;4443
311060;201511;2344;6932;1702;5544;345;1255;459;1359;804;2614
311070;201511;1431;4891;1242;4515;290;1205;486;1720;776;2925
311080;201511;874;2604;751;2371;141;502;359;1033;500;1535
311090;201511;1529;5670;1295;5186;396;1753;243;957;639;2710
311100;201511;2102;6954;1674;6023;589;2291;284;985;873;3276
311110;201511;3713;8759;2602;7168;393;1165;1374;3756;1767;4921
311115;201511;1206;3514;998;3199;110;457;646;2012;756;2469
311120;201511;7908;22167;6017;18729;1437;4978;1560;4457;2997;9435
311130;201511;1957;6129;1633;5643;343;1440;696;2240;1039;3680
311140;201511;1394;3653;1113;3276;107;378;783;2249;890;2627
311150;201511;1832;6189;1667;5918;285;1129;1023;3619;1308;4748
311160;201511;4265;14076;3465;12606;1171;4696;871;3051;2042;7747
311170;201511;784;2341;611;2023;65;233;301;1022;366;1255
311180;201511;1338;3752;1014;3123;289;969;245;681;534;1650
311190;201511;1124;3184;866;2669;179;643;250;669;429;1312
311200;201511;2102;6345;1679;5451;456;1645;327;914;783;2559
311205;201511;1031;3381;870;3046;132;519;387;1366;519;1885
311210;201511;946;3034;869;2925;163;540;593;2066;756;2606
311220;201511;897;2800;702;2371;162;588;218;708;380;1296
311230;201511;8092;25373;6349;21770;1276;4681;2313;8212;3589;12893
311240;201511;1106;3273;848;2824;210;761;236;739;446;1500
311250;201511;838;2703;742;2549;212;840;246;720;458;1560
311260;201511;2554;6729;1877;5604;475;1570;606;1769;1081;3339
311265;201511;1266;3492;991;3038;183;623;521;1584;704;2207
311270;201511;3355;10578;2902;9919;350;1584;1936;6338;2286;7922
311280;201511;1322;3632;837;2617;170;621;238;684;408;1305
311290;201511;2007;6707;1864;6380;400;1380;1052;3651;1452;5031
311300;201511;4460;14733;3980;13850;484;1972;2697;9321;3181;11293
311310;201511;559;1889;499;1779;89;381;197;638;286;1019
311320;201511;4068;13336;3541;12159;693;2693;1185;3809;1878;6502
311330;201511;4885;14434;4145;13182;1138;4030;1719;5392;2857;9422
311340;201511;12171;37992;10511;34769;3142;11174;2851;9244;5993;20418
311350;201511;2326;6547;1787;5521;307;1128;789;2208;1096;3336
311360;201511;1187;3243;896;2864;343;1145;170;550;513;1695
311370;201511;3825;11350;3194;10212;694;2660;1344;3904;2038;6564
311380;201511;404;1325;349;1222;94;362;116;394;210;756
311390;201511;1817;6547;1655;6300;688;3028;489;1681;1177;4709
311400;201511;1485;4663;1222;4150;222;902;510;1547;732;2449
311410;201511;1819;6167;1632;5915;444;1804;792;2905;1236;4709
311420;201511;1965;6311;1288;4587;272;1043;211;570;483;1613
311430;201511;3976;11797;2674;8902;491;1790;323;970;814;2760
311440;201511;2384;7571;1749;6371;538;2301;298;1024;836;3325
311450;201511;1993;6832;1649;6041;443;1798;344;1155;787;2953
311455;201511;1215;3221;968;2810;230;725;446;1199;676;1924
311460;201511;707;2266;536;1910;111;476;125;416;236;892
311470;201511;517;1662;405;1414;99;425;108;321;207;746
311480;201511;778;2057;723;1984;183;490;426;1159;609;1649
311490;201511;242;881;212;795;64;260;74;255;138;515
311500;201511;467;1336;366;1147;83;301;147;453;230;754
311510;201511;3170;9715;2559;8548;798;3127;555;1708;1353;4835
311520;201511;637;2069;583;1953;187;691;227;711;414;1402
311530;201511;11840;30292;8245;24325;1890;6651;2231;6307;4121;12958
311535;201511;831;2398;524;1773;128;505;72;227;200;732
311540;201511;635;2187;588;2113;220;785;234;828;454;1613
311545;201511;2107;6424;1884;6145;197;729;1330;4277;1527;5006
311547;201511;1550;4309;1279;3865;100;332;848;2560;948;2892
311550;201511;2914;9206;2406;8148;445;1700;840;2788;1285;4488
311560;201511;258;671;215;616;30;97;125;335;155;432
311570;201511;2179;5350;1647;4652;125;404;1220;3497;1345;3901
311580;201511;2420;4927;1842;4258;519;1098;976;2408;1495;3506
311590;201511;458;1385;387;1273;104;396;141;461;245;857
311600;201511;1210;3653;1023;3398;190;621;628;2133;818;2754
311610;201511;3092;10693;2752;10085;889;3223;1109;4271;1998;7494
311615;201511;3100;9510;2544;8613;268;1056;1745;5881;2013;6937
311620;201511;427;1322;370;1220;73;274;201;654;274;928
311630;201511;1405;4059;1144;3604;267;802;624;1985;891;2787
311640;201511;827;2623;674;2350;138;535;359;1207;497;1742
311650;201511;2274;6578;1896;5942;285;961;1031;3278;1316;4239
311660;201511;2453;8108;1908;6796;368;1414;231;654;599;2068
311670;201511;1616;4714;1304;4169;419;1479;401;1236;820;2715
311680;201511;2077;6460;1742;5893;384;1375;919;3092;1303;4467
311690;201511;507;1309;425;1207;41;126;338;962;379;1088
311700;201511;2200;5927;1806;5383;141;487;1361;3974;1502;4461
311710;201511;1701;5104;1239;4216;443;1671;306;975;749;2646
311720;201511;395;1300;347;1197;67;250;163;546;230;796
311730;201511;5899;14600;3345;10073;921;3243;840;1960;1761;5203
311740;201511;851;2480;782;2394;280;832;409;1289;689;2121
311750;201511;4023;13007;3473;12112;689;2716;1767;6017;2456;8733
311760;201511;814;2701;717;2471;176;719;238;705;414;1424
311770;201511;2333;7305;1875;6416;431;1655;565;1823;996;3478
311780;201511;1110;3916;919;3472;267;1178;207;694;474;1872
311783;201511;1972;6413;1663;5809;106;520;1215;4187;1321;4707
311787;201511;580;1987;415;1491;77;306;92;271;169;577
311790;201511;1462;4309;1059;3526;235;884;331;1049;566;1933
311800;201511;4344;14571;3496;12222;720;2711;215;589;935;3300
311810;201511;1063;3435;926;3163;72;328;619;2069;691;2397
311820;201511;612;1909;494;1621;126;460;239;736;365;1196
311830;201511;8396;27905;6699;23668;2162;8252;826;2566;2988;10818
311840;201511;3154;9256;2735;8649;728;2598;1263;3873;1991;6471
311850;201511;292;862;249;788;61;213;108;331;169;544
311860;201511;49377;145270;41372;130628;8931;30927;19242;58462;28173;89389
311870;201511;2202;6392;1629;5279;340;1263;499;1470;839;2733
311880;201511;6912;19740;6078;18713;802;2325;4272;13654;5074;15979
311890;201511;1443;4280;1151;3712;290;1026;461;1447;751;2473
311900;201511;767;2292;674;2158;111;383;386;1257;497;1640
311910;201511;4338;12606;3497;11350;835;2940;1471;4739;2306;7679
311920;201511;1938;6301;1679;5824;228;880;995;3429;1223;4309
311930;201511;3659;10380;3073;9430;1153;3715;869;2598;2022;6313
311940;201511;12150;36293;9664;31106;2485;8692;1977;5873;4462;14565
311950;201511;2240;6497;1849;5932;160;566;1295;4109;1455;4675
311960;201511;367;1152;324;1051;75;283;124;338;199;621
311970;201511;359;1243;294;1096;61;268;74;254;135;522
311980;201511;652;1795;432;1389;77;259;155;502;232;761
311990;201511;431;1261;356;1137;130;457;119;350;249;807
311995;201511;1190;3614;716;2448;57;207;81;207;138;414
312000;201511;627;1869;559;1764;75;266;342;1087;417;1353
312010;201511;938;3012;781;2661;134;503;311;1021;445;1524
312015;201511;1428;4519;1261;4215;154;624;799;2625;953;3249
312020;201511;988;3103;857;2891;172;626;416;1405;588;2031
312030;201511;1759;5191;1573;4960;118;442;1292;4042;1410;4484
312040;201511;730;2672;612;2347;160;698;132;473;292;1171
312050;201511;1364;4660;1138;4138;266;1085;155;483;421;1568
312060;201511;760;2280;654;2114;244;842;241;724;485;1566
312070;201511;1033;3157;669;2364;153;579;225;796;378;1375
312080;201511;2642;7329;2081;6443;317;1144;1085;3162;1402;4306
312083;201511;917;2592;786;2396;100;342;537;1604;637;1946
312087;201511;2187;6643;1938;6282;249;877;1341;4412;1590;5289
312090;201511;8935;27571;7685;25374;2232;7813;2812;9076;5044;16889
312100;201511;1391;4636;1157;4260;259;1078;502;1821;761;2899
312110;201511;1100;3819;948;3479;294;1241;167;512;461;1753
312120;201511;773;2495;648;2240;146;602;219;653;365;1255
312125;201511;1193;3744;1039;3458;241;815;532;1833;773;2648
312130;201511;846;2406;634;1969;95;338;233;672;328;1010
312140;201511;855;2683;711;2330;146;532;217;610;363;1142
312150;201511;538;1541;456;1365;24;88;299;852;323;940
312160;201511;7454;25084;6577;23229;1762;6828;2331;8062;4093;14890
312170;201511;964;2730;804;2456;80;268;488;1471;568;1739
312180;201511;1376;4157;1185;3774;269;924;458;1367;727;2291
312190;201511;589;1885;448;1602;142;566;91;306;233;872
312200;201511;4803;13782;3992;12456;620;1951;2381;7413;3001;9364
312210;201511;1041;2795;794;2427;224;756;319;907;543;1663
312220;201511;1891;6268;1729;6078;211;679;1387;5105;1598;5784
312230;201511;13285;40365;10065;33938;3243;12106;1545;4884;4788;16990
312235;201511;1586;4713;1367;4382;167;657;918;2875;1085;3532
312240;201511;960;3133;762;2709;177;688;226;744;403;1432
312245;201511;2226;6509;1968;6167;118;402;1598;4992;1716;5394
312247;201511;839;2483;649;2147;174;629;279;925;453;1554
312250;201511;1208;3312;922;2834;165;578;362;1036;527;1614
312260;201511;902;2848;739;2568;137;557;446;1484;583;2041
312270;201511;668;1998;554;1778;78;323;251;728;329;1051
312280;201511;407;1368;360;1263;117;444;49;162;166;606
312290;201511;762;2480;699;2385;189;756;228;755;417;1511
312300;201511;873;2877;675;2393;159;617;79;209;238;826
312310;201511;913;3386;832;3194;237;1002;304;1128;541;2130
312320;201511;1964;5580;1443;4500;324;1074;235;555;559;1629
312330;201511;990;2885;821;2628;142;541;575;1809;717;2350
312340;201511;321;844;275;768;38;142;188;477;226;619
312350;201511;306;758;273;719;25;78;228;580;253;658
312352;201511;1627;5131;1446;4847;350;1228;875;2996;1225;4224
312360;201511;2983;9546;2428;8375;531;2028;705;2397;1236;4425
312370;201511;1724;5399;1548;5116;520;1934;499;1539;1019;3473
312380;201511;1923;5328;1699;5017;102;320;1387;4191;1489;4511
312385;201511;1303;3834;1120;3540;107;435;779;2377;886;2812
312390;201511;2128;6848;1698;5943;444;1675;287;896;731;2571
312400;201511;3194;10168;2670;9142;941;3338;747;2637;1688;5975
312410;201511;9950;32263;8698;29790;1966;7345;3554;11830;5520;19175
312420;201511;3990;12148;3745;11832;565;1798;2580;8304;3145;10102
312430;201511;7843;23233;6719;21209;1212;3887;3965;12607;5177;16494
312440;201511;697;2186;606;2031;162;602;288;998;450;1600
312450;201511;1087;3571;828;3015;273;1041;244;912;517;1953
312460;201511;364;1084;324;1037;89;320;150;474;239;794
312470;201511;691;1872;444;1388;80;287;145;428;225;715
312480;201511;1265;3337;963;2996;231;801;495;1444;726;2245
312490;201511;2040;5328;1568;4631;233;775;873;2469;1106;3244
312500;201511;682;2056;595;1917;104;398;222;675;326;1073
312510;201511;3256;9451;2518;7903;424;1531;1220;3524;1644;5055
312520;201511;269;907;215;803;58;236;71;267;129;503
312530;201511;598;1785;527;1678;76;307;337;1026;413;1333
312540;201511;1465;4581;1123;3896;240;894;530;1823;770;2717
312550;201511;681;2085;576;1852;120;399;259;784;379;1183
312560;201511;2036;5374;1690;4924;103;362;1359;3915;1462;4277
312570;201511;2494;7280;2041;6484;589;2012;596;1823;1185;3835
312580;201511;532;1747;439;1544;75;323;158;522;233;845
312590;201511;1727;5696;1484;5164;286;1216;625;1987;911;3203
312595;201511;2021;6725;1790;6184;380;1390;936;3211;1316;4601
312600;201511;812;2616;624;2227;101;468;303;977;404;1445
312610;201511;7121;19858;5122;16135;1174;4118;1188;3482;2362;7600
312620;201511;2107;6159;1636;5511;171;655;1193;4103;1364;4758
312630;201511;355;1139;309;1052;77;303;124;385;201;688
312640;201511;549;1758;434;1517;89;340;137;441;226;781
312650;201511;2160;6333;1555;5114;153;556;904;2957;1057;3513
312660;201511;1345;3621;1102;3263;113;391;741;2142;854;2533
312670;201511;5660;16743;4801;15512;1311;4684;1694;5301;3005;9985
312675;201511;1273;4060;1059;3599;135;525;648;2150;783;2675
312680;201511;1471;4506;1291;4235;211;799;748;2332;959;3131
312690;201511;2203;5862;1775;5254;282;924;1076;3056;1358;3980
312695;201511;821;2921;781;2862;174;616;488;1872;662;2488
312700;201511;1936;5721;1473;4762;207;767;740;2329;947;3096
312705;201511;1273;3622;1069;3261;99;338;756;2262;855;2600
312707;201511;1650;5090;1269;4345;182;721;663;2184;845;2905
312710;201511;7227;18277;4635;13941;1246;4284;948;2592;2194;6876
312720;201511;768;2602;665;2382;153;607;243;823;396;1430
312730;201511;1897;4486;1310;3786;179;563;727;2104;906;2667
312733;201511;1676;4427;1226;3598;68;239;807;2258;875;2497
312735;201511;834;2317;723;2168;173;590;394;1122;567;1712
312737;201511;862;2144;613;1788;195;574;223;668;418;1242
312738;201511;541;1620;388;1299;97;386;126;362;223;748
312740;201511;382;976;233;800;69;264;55;186;124;450
312750;201511;1251;4388;1183;4257;248;1091;565;1906;813;2997
312760;201511;2089;6586;1582;5543;380;1469;356;1207;736;2676
312770;201511;41418;113116;31772;96717;8258;27183;8777;25611;17035;52794
312780;201511;2706;9347;2399;8821;435;1760;1259;4708;1694;6468
312790;201511;330;834;187;579;38;151;53;118;91;269
312800;201511;5012;16225;4030;14192;1226;4656;1028;3596;2254;8252
312810;201511;2171;6531;1457;5121;351;1327;260;831;611;2158
312820;201511;1927;5513;1705;5146;114;409;1152;3388;1266;3797
312825;201511;1373;3707;1173;3448;114;372;885;2586;999;2958
312830;201511;2552;7822;1747;6158;437;1667;288;974;725;2641
312840;201511;1258;4016;1035;3596;159;683;413;1312;572;1995
312850;201511;655;2065;520;1805;90;374;161;544;251;918
312860;201511;1154;3340;888;2864;231;844;240;657;471;1501
312870;201511;5498;16966;3763;13217;727;2828;746;2505;1473;5333
312880;201511;1269;3752;1094;3473;152;528;649;2116;801;2644
312890;201511;1613;4855;1073;3653;288;1083;327;1118;615;2201
312900;201511;1225;3595;1075;3384;150;498;753;2428;903;2926
312910;201511;1661;3330;1012;2480;165;461;515;1142;680;1603
312920;201511;870;2740;712;2457;194;765;272;871;466;1636
312930;201511;2228;6328;1899;5841;418;1346;895;2808;1313;4154
312940;201511;911;2949;783;2725;207;819;211;680;418;1499
312950;201511;3280;9079;2490;7862;819;2807;648;1988;1467;4795
312960;201511;1957;5620;1693;5274;246;724;1256;4039;1502;4763
312965;201511;1795;5665;1510;5142;200;804;903;3054;1103;3858
312970;201511;991;3336;821;3030;242;1029;149;510;391;1539
312980;201511;17271;57387;16050;54708;5083;19028;6098;19810;11181;38838
312990;201511;456;1359;332;1138;102;398;94;316;196;714
313000;201511;505;1656;407;1459;98;457;163;505;261;962
313005;201511;2597;8292;2260;7648;530;1737;1139;3963;1669;5700
313010;201511;3807;12022;3184;10928;828;3090;1312;4425;2140;7515
313020;201511;987;3196;776;2667;162;649;188;530;350;1179
313030;201511;1525;4051;1117;3475;243;946;468;1338;711;2284
313040;201511;861;2841;722;2485;119;484;280;880;399;1364
313050;201511;1811;5556;1349;4853;310;1263;342;1096;652;2359
313055;201511;1576;5025;1435;4828;107;382;1106;3760;1213;4142
313060;201511;715;2313;552;1909;158;564;68;217;226;781
313065;201511;1950;6249;1659;5778;340;1308;1077;3734;1417;5042
313070;201511;1114;3188;899;2799;206;752;394;1118;600;1870
313080;201511;475;1480;356;1231;86;351;115;344;201;695
313090;201511;5273;15076;4527;13854;1032;3355;2298;7052;3330;10407
313100;201511;1089;3338;974;3146;110;373;735;2392;845;2765
313110;201511;1771;4959;1301;4031;214;748;561;1617;775;2365
313115;201511;2464;8231;2301;7884;538;2079;1017;3232;1555;5311
313120;201511;3523;9299;2941;8501;801;2618;1462;3998;2263;6616
313130;201511;25018;75203;21241;67335;4944;17308;7940;23467;12884;40775
313140;201511;679;1713;505;1455;34;121;350;988;384;1109
313150;201511;1365;4288;1141;3859;482;1774;249;801;731;2575
313160;201511;1029;3081;884;2801;146;546;505;1538;651;2084
313170;201511;7883;26666;6239;22728;1559;6066;1252;4429;2811;10495
313180;201511;2427;6590;1910;5837;503;1709;694;2029;1197;3738
313190;201511;3214;10932;2512;9091;551;2177;661;2178;1212;4355
313200;201511;1207;3893;1042;3580;140;552;692;2311;832;2863
313210;201511;4324;13239;3574;12104;834;3035;1538;5008;2372;8043
313220;201511;1393;4186;1014;3342;245;897;222;615;467;1512
313230;201511;2293;8091;2103;7813;326;1295;1416;5267;1742;6562
313240;201511;7661;23431;5992;20292;1247;4798;2212;7102;3459;11900
313250;201511;7108;22017;6174;20379;864;2931;3565;11843;4429;14774
313260;201511;611;1793;432;1416;70;255;104;320;174;575
313270;201511;5476;16207;4558;14617;865;2996;2438;7692;3303;10688
313280;201511;379;1247;283;1031;50;211;69;218;119;429
313290;201511;864;2985;688;2640;240;1014;101;331;341;1345
313300;201511;1848;6102;1493;5228;425;1625;213;629;638;2254
313310;201511;1100;3763;968;3481;234;954;183;589;417;1543
313320;201511;2378;6810;1791;5839;342;1236;760;2446;1102;3682
313330;201511;3949;12218;3266;10991;405;1608;1852;6072;2257;7680
313340;201511;1983;4846;1527;4161;304;839;821;2214;1125;3053
313350;201511;3155;9572;2396;7934;505;1853;473;1399;978;3252
313360;201511;1236;3541;911;3001;248;974;441;1339;689;2313
313370;201511;1151;3901;1055;3638;163;673;538;1710;701;2383
313375;201511;2289;5904;1519;4736;282;1094;491;1430;773;2524
313380;201511;5020;15498;4108;13605;1038;3758;1322;4110;2360;7868
313390;201511;871;2986;829;2926;97;389;558;1961;655;2350
313400;201511;3744;10231;3312;9732;302;842;2752;8278;3054;9120
313410;201511;1271;3548;1047;3214;246;840;555;1658;801;2498
313420;201511;20337;48017;11926;33589;2267;7102;2172;5887;4439;12989
313430;201511;1081;3330;817;2761;159;648;319;983;478;1631
313440;201511;6349;14274;4338;11921;280;836;2872;7914;3152;8750
313450;201511;655;1905;514;1613;104;395;173;490;277;885
313460;201511;2209;7443;1887;6883;499;2085;572;1903;1071;3988
313470;201511;3184;8723;2860;8280;411;1229;1954;5563;2365;6792
313480;201511;1111;3167;855;2723;123;461;339;992;462;1453
313490;201511;1453;4282;847;3264;254;1078;123;444;377;1522
313500;201511;397;1237;339;1099;60;224;131;392;191;616
313505;201511;9045;26407;8319;25571;408;983;7516;23594;7924;24577
313507;201511;1357;3775;1180;3524;133;437;760;2279;893;2716
313510;201511;15506;44067;13348;40843;2127;6728;7501;23054;9628;29782
313520;201511;14328;43918;11968;39546;1417;5335;7569;24699;8986;30034
313530;201511;620;1909;499;1677;50;202;168;529;218;731
313535;201511;2446;7309;2182;6827;200;692;1565;4824;1765;5516
313540;201511;1081;3355;797;2618;206;746;185;548;391;1294
313545;201511;1288;4704;1155;4423;166;781;667;2397;833;3178
313550;201511;1848;5883;1606;5386;416;1472;701;2263;1117;3735
313560;201511;2198;5194;1811;4756;337;817;1182;3252;1519;4069
313570;201511;882;3066;745;2805;245;989;214;793;459;1782
313580;201511;5892;16631;4732;14955;796;2696;2746;8742;3542;11438
313590;201511;993;2791;758;2467;368;1314;179;551;547;1865
313600;201511;3851;11502;3309;10639;452;1591;2158;6936;2610;8527
313610;201511;993;2963;840;2663;178;624;396;1218;574;1842
313620;201511;5579;17082;4751;15543;1303;4538;1646;5319;2949;9857
313630;201511;8091;22638;6101;19662;1182;4334;2611;8736;3793;13070
313640;201511;780;2264;591;1966;175;655;184;584;359;1239
313650;201511;2072;6658;1789;6194;303;1205;1140;3848;1443;5053
313652;201511;968;3414;888;3264;149;623;524;1873;673;2496
313655;201511;940;3004;777;2721;118;502;458;1543;576;2045
313657;201511;1283;3884;1075;3555;117;539;770;2334;887;2873
313660;201511;833;2711;733;2528;161;653;335;1081;496;1734
313665;201511;3552;11379;3070;10351;650;2460;1387;4477;2037;6937
313670;201511;50677;139889;33430;109619;8155;29343;9775;31177;17930;60520
313680;201511;1070;3167;930;2933;160;583;542;1641;702;2224
313690;201511;851;3043;738;2774;195;753;264;994;459;1747
313695;201511;1384;4456;1183;4093;113;442;820;2836;933;3278
313700;201511;3795;12572;3191;11792;509;1947;2137;8112;2646;10059
313710;201511;1311;3540;1016;3086;203;671;503;1480;706;2151
313720;201511;5214;16684;4084;14128;831;3171;1248;3968;2079;7139
313730;201511;1270;3440;970;3059;172;619;527;1641;699;2260
313740;201511;2134;7569;1781;6704;499;2141;162;517;661;2658
313750;201511;2265;6785;1878;6046;476;1652;597;1772;1073;3424
313753;201511;1847;5332;1451;4645;339;1203;591;1849;930;3052
313760;201511;4329;14012;3522;12336;974;3731;924;3001;1898;6732
313770;201511;3321;10748;2939;10104;892;3326;1212;4050;2104;7376
313780;201511;3869;10542;3011;9270;443;1671;1263;3878;1706;5549
313790;201511;493;1694;464;1640;103;366;254;933;357;1299
313800;201511;1246;3389;1079;3132;125;408;710;2076;835;2484
313810;201511;1511;4346;1426;4231;69;194;1237;3766;1306;3960
313820;201511;13162;34892;10576;30686;1851;6315;4908;13475;6759;19790
313830;201511;423;1392;356;1261;97;397;118;412;215;809
313835;201511;918;3046;848;2930;158;641;466;1525;624;2166
313840;201511;7569;21525;5810;18497;1441;5072;1474;4554;2915;9626
313850;201511;1206;3241;1030;2929;205;693;506;1307;711;2000
313860;201511;2801;8450;2103;6903;504;1793;453;1397;957;3190
313862;201511;1227;3063;835;2418;124;349;430;1325;554;1674
313865;201511;2230;6858;2010;6529;240;897;1449;4644;1689;5541
313867;201511;1119;3797;935;3369;289;1113;260;971;549;2084
313868;201511;1595;5454;1370;4985;135;589;903;3242;1038;3831
313870;201511;804;2495;730;2373;205;768;220;624;425;1392
313880;201511;1517;4604;1295;4251;242;943;700;2133;942;3076
313890;201511;1883;5090;1567;4672;354;1003;934;2958;1288;3961
313900;201511;4042;14491;3563;13372;1054;4464;987;3527;2041;7991
313910;201511;766;2535;625;2244;221;854;75;244;296;1098
313920;201511;3399;11155;2919;10238;489;1801;1645;5888;2134;7689
313925;201511;1928;5167;1390;4155;84;284;856;2537;940;2821
313930;201511;5256;17010;4291;15246;811;3041;2162;7781;2973;10822
313940;201511;8437;27874;7022;25570;2040;8249;2270;8619;4310;16868
313950;201511;4124;11692;3194;10132;977;3602;1037;2913;2014;6515
313960;201511;5629;14340;4078;12163;1130;3692;1087;2993;2217;6685
313970;201511;1436;4084;1244;3870;150;523;763;2481;913;3004
313980;201511;1276;3976;982;3457;268;1084;397;1376;665;2460
313990;201511;1845;6760;1544;6021;505;2174;310;1055;815;3229
314000;201511;7708;24632;6912;23065;1262;5049;3844;12182;5106;17231
314010;201511;1106;3084;906;2821;105;384;564;1692;669;2076
314015;201511;1205;4137;1013;3773;255;1050;381;1342;636;2392
314020;201511;523;1572;373;1255;85;333;85;248;170;581
314030;201511;866;2761;672;2322;94;355;242;819;336;1174
314040;201511;682;1921;560;1708;250;807;132;394;382;1201
314050;201511;1785;5478;1394;4687;302;1200;464;1372;766;2572
314053;201511;1548;4875;1374;4651;192;654;910;3226;1102;3880
314055;201511;2144;6400;1883;6002;90;382;1457;4650;1547;5032
314060;201511;1144;3511;893;3078;68;302;560;1882;628;2184
314070;201511;4036;12407;3088;10517;801;2921;705;2270;1506;5191
314080;201511;1962;6019;1294;4436;232;897;281;827;513;1724
314085;201511;1983;6582;1707;6186;444;1798;623;2226;1067;4024
314090;201511;3331;11379;2897;10501;724;2928;966;3548;1690;6476
314100;201511;3307;8473;2889;7908;206;462;2422;6867;2628;7329
314110;201511;4156;13034;3567;11784;663;2578;1455;4339;2118;6917
314120;201511;1015;2454;514;1641;116;410;137;421;253;831
314130;201511;726;2071;368;1247;51;186;74;235;125;421
314140;201511;4960;15245;4093;13501;927;3308;1674;5422;2601;8730
314150;201511;1603;4375;1290;3826;211;701;655;1902;866;2603
314160;201511;2533;6498;1980;5763;193;611;1211;3691;1404;4302
314170;201511;1094;3262;885;2807;121;418;463;1419;584;1837
314180;201511;5441;17256;4806;16202;1285;4689;2021;6880;3306;11569
314190;201511;736;2103;576;1857;125;505;230;654;355;1159
314200;201511;3003;9320;2585;8551;313;1239;1724;5556;2037;6795
314210;201511;1965;5737;1734;5325;252;918;1044;3036;1296;3954
314220;201511;1672;5162;1282;4398;372;1418;253;734;625;2152
314225;201511;1329;3836;1183;3638;91;291;981;3053;1072;3344
314230;201511;661;2162;598;2047;134;511;271;899;405;1410
314240;201511;1134;3401;945;3111;140;478;544;1880;684;2358
314250;201511;560;1661;421;1372;96;351;129;366;225;717
314260;201511;1100;3875;981;3608;265;1064;307;1063;572;2127
314270;201511;2922;9383;2434;8501;245;965;1594;5593;1839;6558
314280;201511;3221;8871;2145;6762;489;1812;676;1835;1165;3647
314290;201511;4907;13447;4171;12224;1127;3419;2086;6029;3213;9448
314300;201511;1561;5167;1328;4616;367;1350;411;1358;778;2708
314310;201511;5369;15983;4559;14454;1305;4458;1553;4700;2858;9158
314315;201511;872;3326;795;3172;88;422;520;2058;608;2480
314320;201511;3119;8557;2228;7335;603;2198;1063;3547;1666;5745
314330;201511;53665;161295;46054;148628;12747;44303;15976;50667;28723;94970
314340;201511;2891;7854;1591;5246;348;1250;127;272;475;1522
314345;201511;1239;4169;1108;3950;266;993;630;2244;896;3237
314350;201511;1367;3937;1064;3426;356;1249;222;664;578;1913
314360;201511;692;2198;458;1632;99;409;103;342;202;751
314370;201511;536;1850;494;1786;133;533;297;1059;430;1592
314380;201511;1285;3827;869;2987;236;872;135;453;371;1325
314390;201511;14355;41021;10623;33968;2568;8913;2619;7678;5187;16591
314400;201511;4544;13281;3825;12252;1360;4561;1275;4189;2635;8750
314410;201511;2652;8211;2176;7271;641;2438;663;2063;1304;4501
314420;201511;754;2147;584;1893;36;179;388;1188;424;1367
314430;201511;6629;19577;5698;17800;1637;5540;1645;5169;3282;10709
314435;201511;1312;4168;1149;3878;117;500;721;2410;838;2910
314437;201511;1140;2923;946;2627;42;121;749;2075;791;2196
314440;201511;667;1933;506;1695;163;608;90;261;253;869
314450;201511;1606;4674;1327;4254;333;1226;567;1686;900;2912
314460;201511;4310;14332;3444;12426;832;3334;638;2162;1470;5496
314465;201511;2301;7161;2106;6830;126;564;1610;5072;1736;5636
314467;201511;1062;2964;884;2645;85;243;623;1895;708;2138
314470;201511;2488;7771;2029;6788;394;1569;657;1943;1051;3512
314480;201511;6134;20176;4073;14600;626;2438;461;1389;1087;3827
314490;201511;957;2802;741;2362;181;633;310;940;491;1573
314500;201511;2105;5862;1531;4857;376;1245;614;1900;990;3145
314505;201511;1786;5257;1639;5046;257;866;1063;3297;1320;4163
314510;201511;1911;5150;1273;4238;402;1483;316;1016;718;2499
314520;201511;3132;11182;2347;9237;519;2330;330;1047;849;3377
314530;201511;6263;21950;5906;21320;1133;3999;3437;12872;4570;16871
314535;201511;2764;7699;2345;7109;223;759;1777;5345;2000;6104
314537;201511;1186;3709;937;3257;138;582;540;1828;678;2410
314540;201511;418;1245;339;1075;77;282;102;285;179;567
314545;201511;1387;4236;1192;3948;165;630;812;2698;977;3328
314550;201511;634;1713;462;1469;78;331;193;552;271;883
314560;201511;4678;15923;3862;13887;738;3020;1106;3743;1844;6763
314570;201511;309;902;233;740;64;220;101;309;165;529
314580;201511;520;1735;401;1458;100;438;64;196;164;634
314585;201511;842;2735;602;2204;140;589;146;510;286;1099
314587;201511;1915;5868;1642;5381;368;1145;762;2587;1130;3732
314590;201511;3351;11209;2323;8444;407;1665;290;906;697;2571
314600;201511;1865;6008;1336;4904;328;1350;191;612;519;1962
314610;201511;7084;23830;6278;21946;1423;5602;2577;8424;4000;14026
314620;201511;1623;4806;1454;4564;182;578;1030;3243;1212;3821
314625;201511;1465;5021;1363;4817;187;796;958;3240;1145;4036
314630;201511;4946;14554;4292;13526;325;1238;3130;9819;3455;11057
314640;201511;584;1589;447;1347;110;360;128;323;238;683
314650;201511;1169;3211;808;2571;131;499;294;822;425;1321
314655;201511;1602;4753;1174;3895;291;935;427;1443;718;2378
314660;201511;275;745;198;588;24;79;97;267;121;346
314670;201511;1641;4376;1224;3652;195;656;677;1978;872;2634
314675;201511;1797;5455;1531;4979;169;623;1022;3319;1191;3942
314690;201511;2408;7582;1939;6709;535;2121;471;1506;1006;3627
314700;201511;8743;30001;6397;24524;1913;8213;1021;3717;2934;11930
314710;201511;9103;27513;6037;20632;1151;4343;808;2548;1959;6891
314720;201511;2407;7853;1983;6913;509;1977;651;2230;1160;4207
314730;201511;2331;6867;1857;6150;513;1877;656;2072;1169;3949
314740;201511;3020;9531;2594;8694;483;1847;1178;3747;1661;5594
314750;201511;346;1078;274;913;48;196;126;383;174;579
314760;201511;1754;5832;1305;4715;228;955;265;812;493;1767
314770;201511;1125;3504;639;2163;79;314;93;219;172;533
314780;201511;300;768;204;641;56;211;83;250;139;461
314790;201511;12147;35318;8821;29422;3340;12665;955;2654;4295;15319
314795;201511;1666;4768;1400;4346;125;505;1017;3009;1142;3514
314800;201511;11890;34187;8249;26809;2334;8231;1160;3522;3494;11753
314810;201511;12467;36066;9500;30747;2712;9706;1988;6336;4700;16042
314820;201511;950;2569;633;2043;168;606;213;652;381;1258
314830;201511;1669;5533;1451;5150;437;1726;570;2000;1007;3726
314840;201511;978;3461;788;3166;136;702;468;1799;604;2501
314850;201511;1971;5684;1568;4948;231;906;965;2905;1196;3811
314860;201511;3263;10809;2893;10132;694;2640;1337;4627;2031;7267
314870;201511;5515;17319;4759;16300;543;2319;3375;11455;3918;13774
314875;201511;1719;5690;1628;5554;314;1022;1181;4139;1495;5161
314880;201511;868;2368;727;2187;45;133;534;1688;579;1821
314890;201511;611;1821;408;1373;84;344;138;408;222;752
314900;201511;499;1510;400;1355;93;336;195;649;288;985
314910;201511;1674;5459;1347;4894;408;1696;403;1371;811;3067
314915;201511;2512;7906;2198;7403;185;769;1576;5160;1761;5929
314920;201511;557;1540;392;1286;43;173;210;630;253;803
314930;201511;4715;15673;3994;14023;1068;4053;954;3189;2022;7242
314940;201511;404;1171;369;1107;69;229;191;535;260;764
314950;201511;357;1042;264;894;48;174;78;249;126;423
314960;201511;758;2322;571;1930;141;538;165;488;306;1026
314970;201511;562;1883;457;1673;102;433;123;438;225;871
314980;201511;1665;5102;1384;4598;400;1499;155;438;555;1937
314990;201511;2704;8424;2008;6865;555;2197;386;1092;941;3289
314995;201511;1603;4846;1389;4510;146;567;883;2789;1029;3356
315000;201511;1079;3116;884;2798;113;416;546;1702;659;2118
315010;201511;461;1420;360;1208;90;363;116;333;206;696
315015;201511;2049;6262;1820;5991;245;830;1324;4560;1569;5390
315020;201511;826;2556;612;2080;101;399;274;872;375;1271
315030;201511;742;2205;594;1931;164;578;135;411;299;989
315040;201511;875;2698;815;2584;154;510;494;1551;648;2061
315050;201511;1440;4098;1142;3625;244;892;477;1468;721;2360
315053;201511;1083;3200;951;2971;161;626;427;1337;588;1963
315057;201511;1731;5905;1502;5538;298;1098;808;3086;1106;4184
315060;201511;859;2778;606;2195;120;473;109;371;229;844
315070;201511;777;2323;667;2150;179;625;312;954;491;1579
315080;201511;2876;9578;2515;8785;626;2375;1094;3756;1720;6131
315090;201511;781;2779;673;2527;166;702;171;619;337;1321
315100;201511;1232;4116;885;3285;212;909;219;731;431;1640
315110;201511;1403;4261;1187;3836;284;990;447;1404;731;2394
315120;201511;14442;33517;9715;27368;1535;4508;4930;14671;6465;19179
315130;201511;1438;4703;1286;4400;351;1349;400;1304;751;2653
315140;201511;2677;8556;2199;7534;504;2009;740;2289;1244;4298
315150;201511;4918;13173;3602;10930;741;2526;1289;3793;2030;6319
315160;201511;1254;3573;1015;3099;201;661;457;1337;658;1998
315170;201511;1475;4351;1193;3895;242;847;489;1710;731;2557
315180;201511;17289;48634;9757;32294;1801;6778;1730;5113;3531;11891
315190;201511;2126;5494;1772;4948;485;1391;886;2483;1371;3874
315200;201511;3955;13161;3205;11480;962;3780;723;2441;1685;6221
315210;201511;7876;22930;6150;19358;1344;4730;2113;6311;3457;11041
315213;201511;1089;3479;1019;3379;59;215;826;2737;885;2952
315217;201511;2521;8565;2087;7788;272;1223;1183;4352;1455;5575
315220;201511;10082;28779;8354;26044;2437;7506;3442;11221;5879;18727
315230;201511;2921;7600;2609;7233;206;306;2183;6559;2389;6865
315240;201511;3055;9434;2638;8765;683;2502;1302;4151;1985;6653
315250;201511;10279;30964;7450;25447;1878;7088;2163;7293;4041;14381
315260;201511;978;3049;673;2350;152;589;120;367;272;956
315270;201511;776;2474;584;2083;124;490;136;438;260;928
315280;201511;3185;9021;2010;6467;461;1607;409;1134;870;2741
315290;201511;1426;3959;1031;3307;329;1151;169;515;498;1666
315300;201511;549;1415;371;1192;165;557;129;414;294;971
315310;201511;1271;4066;1060;3675;136;575;663;2183;799;2758
315320;201511;800;2414;633;2188;115;461;298;1052;413;1513
315330;201511;697;2519;435;1805;110;510;44;191;154;701
315340;201511;3734;10597;3020;9484;654;2272;1202;3629;1856;5901
315350;201511;1836;5051;1355;4333;285;960;722;2358;1007;3318
315360;201511;1685;5550;1342;4679;254;973;434;1402;688;2375
315370;201511;501;1479;426;1365;95;326;225;734;320;1060
315380;201511;202;690;155;574;39;170;33;94;72;264
315390;201511;1373;4548;990;3610;235;975;181;584;416;1559
315400;201511;4380;13098;3546;11460;731;2640;1569;4937;2300;7577
315410;201511;2057;5434;1712;4946;223;757;1106;3185;1329;3942
315415;201511;1027;3366;932;3222;338;1200;427;1539;765;2739
315420;201511;1267;3997;936;3289;229;846;141;461;370;1307
315430;201511;3838;10357;2847;8692;755;2577;643;1859;1398;4436
315440;201511;910;2803;780;2586;155;582;345;1099;500;1681
315445;201511;2135;5933;1692;5254;195;695;1171;3581;1366;4276
315450;201511;2437;7658;2184;7267;493;1525;1233;4293;1726;5818
315460;201511;34921;113430;30365;103676;10049;36726;5841;18766;15890;55492
315470;201511;511;1519;410;1327;53;213;212;648;265;861
315480;201511;1786;5368;1105;3804;196;747;185;617;381;1364
315490;201511;3162;8434;2435;7428;352;1243;1016;2920;1368;4163
315500;201511;481;1449;313;1057;42;161;114;334;156;495
315510;201511;1436;4066;1199;3692;96;335;851;2558;947;2893
315520;201511;1115;3214;842;2787;111;411;535;1701;646;2112
315530;201511;578;1971;489;1751;184;706;131;434;315;1140
315540;201511;1108;3436;903;3040;177;716;314;1034;491;1750
315550;201511;1765;4936;1362;4365;398;1407;431;1324;829;2731
315560;201511;6522;21601;5869;20670;638;2521;3963;14038;4601;16559
315570;201511;2043;6343;1881;6074;341;1255;1008;3141;1349;4396
315580;201511;2570;7453;1973;6351;496;1849;533;1554;1029;3403
315590;201511;910;2639;798;2457;152;506;398;1204;550;1710
315600;201511;2513;8816;2011;7845;362;1489;1053;4245;1415;5734
315610;201511;1003;2849;800;2424;157;611;298;742;455;1353
315620;201511;315;1100;298;1070;92;318;159;600;251;918
315630;201511;887;2786;728;2464;183;674;187;584;370;1258
315640;201511;566;1622;458;1441;99;374;201;569;300;943
315645;201511;896;2714;737;2370;268;932;172;520;440;1452
315650;201511;1916;5254;1526;4699;93;391;1131;3441;1224;3832
315660;201511;2578;6722;2130;6019;405;1167;1268;3556;1673;4723
315670;201511;10449;34470;9097;31780;2686;10081;3042;10353;5728;20434
315680;201511;3084;10225;2375;8750;834;3250;397;1440;1231;4690
315690;201511;3499;9880;2402;7878;618;2240;473;1575;1091;3815
315700;201511;7295;22601;6104;20197;1115;4123;2772;8750;3887;12873
315710;201511;1857;5395;1494;4798;129;517;944;2936;1073;3453
315720;201511;3489;10936;3074;10174;564;2165;1546;4857;2110;7022
315725;201511;1454;4619;1297;4370;324;1127;736;2522;1060;3649
315727;201511;630;1940;519;1704;109;400;208;632;317;1032
315730;201511;843;2565;758;2404;124;452;419;1286;543;1738
315733;201511;981;2953;868;2736;269;922;258;752;527;1674
315737;201511;1310;3954;993;3357;80;340;636;2179;716;2519
315740;201511;1025;3137;844;2775;167;662;408;1239;575;1901
315750;201511;1119;3462;1020;3278;80;303;731;2327;811;2630
315760;201511;1029;2766;984;2710;31;98;880;2407;911;2505
315765;201511;1426;4427;1276;4223;68;257;1041;3474;1109;3731
315770;201511;1586;5026;1356;4574;355;1346;391;1256;746;2602
315780;201511;22347;72496;19894;66987;5240;18865;5694;18852;10934;37717
315790;201511;3481;11664;3035;10755;314;1058;2012;7359;2326;8417
315800;201511;1524;5824;1176;4788;273;1230;193;732;466;1962
315810;201511;1395;3768;1181;3439;148;436;815;2350;963;2786
315820;201511;2594;8631;2255;8022;730;2705;899;3286;1629;5991
315830;201511;1214;4048;1022;3606;127;558;312;955;439;1513
315840;201511;843;2201;591;1756;97;320;169;467;266;787
315850;201511;1026;3657;990;3580;242;932;489;1720;731;2652
315860;201511;549;1869;406;1556;101;454;67;218;168;672
315870;201511;477;1394;389;1252;113;401;138;410;251;811
315880;201511;1206;3102;944;2766;213;761;329;873;542;1634
315890;201511;1535;5159;1326;4818;470;1817;540;1935;1010;3752
315895;201511;5200;16062;4504;14523;1025;3655;1661;5025;2686;8680
315900;201511;743;2273;709;2212;87;354;531;1539;618;1893
315910;201511;528;1777;490;1711;162;622;263;884;425;1506
315920;201511;1583;4346;923;2937;207;717;184;485;391;1202
315930;201511;1110;3008;830;2510;211;709;207;582;418;1291
315935;201511;983;3213;874;2969;241;899;233;759;474;1658
315940;201511;643;2003;553;1816;134;520;248;763;382;1283
315950;201511;1173;3593;1049;3353;219;663;634;2081;853;2744
315960;201511;3362;10605;2257;8294;849;3573;94;217;943;3790
315970;201511;761;2049;578;1788;50;137;413;1341;463;1478
315980;201511;4128;9967;2485;7175;647;2143;613;1439;1260;3582
315990;201511;3972;11478;3337;10457;583;2217;1661;5015;2244;7232
316000;201511;542;1628;460;1517;148;582;170;537;318;1119
316010;201511;597;1988;473;1729;78;339;185;605;263;944
316020;201511;1124;3504;927;3185;142;568;552;1863;694;2431
316030;201511;3351;9669;2452;8060;242;907;1414;4711;1656;5618
316040;201511;3787;11847;2768;9635;441;1764;479;1328;920;3092
316045;201511;2088;6478;1900;6167;286;902;1303;4360;1589;5262
316050;201511;348;1100;273;978;57;224;119;399;176;623
316060;201511;745;2201;588;1966;81;356;338;1052;419;1408
316070;201511;6030;18942;5138;16929;1174;4333;2051;6398;3225;10731
316080;201511;752;2717;654;2462;147;636;90;323;237;959
316090;201511;575;1702;370;1256;79;307;90;275;169;582
316095;201511;1435;4570;1233;4205;231;805;733;2519;964;3324
316100;201511;2806;9227;2054;7305;488;1982;383;1222;871;3204
316105;201511;973;2720;717;2289;184;624;271;877;455;1501
316110;201511;12322;41820;10886;39309;1363;5309;7136;26405;8499;31714
316120;201511;1147;3708;925;3143;227;830;256;762;483;1592
316130;201511;1476;3311;898;2485;153;496;410;1059;563;1555
316140;201511;966;2804;737;2425;100;330;409;1378;509;1708
316150;201511;1487;4128;1303;3808;231;783;730;2086;961;2869
316160;201511;1239;3678;949;3106;162;612;432;1390;594;2002
316165;201511;940;2525;782;2298;159;539;417;1209;576;1748
316170;201511;1396;4004;1028;3346;165;605;418;1249;583;1854
316180;201511;1376;4298;942;3326;212;835;166;495;378;1330
316190;201511;2837;8753;1415;4954;268;973;209;615;477;1588
316200;201511;3785;12034;2890;10210;658;2685;742;2523;1400;5208
316210;201511;4862;15352;4079;13788;1593;5708;651;2076;2244;7784
316220;201511;792;2433;551;1945;115;470;72;263;187;733
316225;201511;1184;3300;995;2980;136;454;637;1850;773;2304
316230;201511;450;1232;344;1049;55;187;167;539;222;726
316240;201511;6535;19980;5656;18800;651;2206;4067;13653;4718;15859
316245;201511;3226;11065;2969;10625;225;1106;2278;7888;2503;8994
316250;201511;10584;30619;8135;25731;2198;7566;2131;6333;4329;13899
316255;201511;2554;7745;2235;7343;423;1498;1413;4630;1836;6128
316257;201511;1379;3813;1031;3171;188;660;386;1113;574;1773
316260;201511;1785;5075;1382;4482;106;394;807;2751;913;3145
316265;201511;1330;3708;961;2974;109;418;555;1646;664;2064
316270;201511;4174;13773;3800;12988;1003;3697;1514;5008;2517;8705
316280;201511;3281;10552;2930;9870;486;1831;1569;5201;2055;7032
316290;201511;3337;10398;2812;9371;554;2184;1151;3619;1705;5803
316292;201511;3449;10933;3052;10235;636;2385;1612;5134;2248;7519
316294;201511;895;2852;627;2251;127;541;50;169;177;710
316295;201511;1827;6096;1664;5770;247;1047;1012;3350;1259;4397
316300;201511;1003;3090;840;2816;71;258;545;1855;616;2113
316310;201511;730;2077;477;1596;95;371;138;423;233;794
316320;201511;618;1960;485;1724;88;370;98;329;186;699
316330;201511;941;2872;724;2374;88;315;445;1421;533;1736
316340;201511;981;3120;796;2731;189;776;334;1053;523;1829
316350;201511;1330;4208;1179;3952;201;693;669;2299;870;2992
316360;201511;733;1931;574;1693;68;210;405;1205;473;1415
316370;201511;4463;14430;3792;12994;1065;4002;602;2028;1667;6030
316380;201511;1591;4244;1251;3766;90;303;874;2634;964;2937
316390;201511;919;2675;754;2395;198;687;308;998;506;1685
316400;201511;1261;3966;994;3456;216;802;385;1289;601;2091
316410;201511;1075;3539;985;3401;220;792;584;2024;804;2816
316420;201511;1870;6137;1661;5855;153;682;1136;3889;1289;4571
316430;201511;954;2905;702;2391;163;598;172;514;335;1112
316440;201511;677;2198;553;1991;198;823;115;392;313;1215
316443;201511;704;2068;572;1820;131;474;212;623;343;1097
316447;201511;1601;4828;1446;4615;102;351;1229;3938;1331;4289
316450;201511;2158;7200;1829;6549;249;1003;1183;4266;1432;5269
316460;201511;749;2300;672;2158;174;625;362;1102;536;1727
316470;201511;7444;23824;5807;20282;1463;5918;1620;5357;3083;11275
316480;201511;195;647;168;589;36;129;54;177;90;306
316490;201511;302;934;255;819;55;182;101;301;156;483
316500;201511;1134;4028;750;2846;134;545;39;135;173;680
316510;201511;802;2926;709;2731;232;958;188;685;420;1643
316520;201511;1146;3442;921;3078;166;617;308;909;474;1526
316530;201511;1092;3505;905;3123;199;857;323;921;522;1778
316540;201511;888;2820;774;2625;122;511;253;791;375;1302
316550;201511;1190;3934;1106;3786;220;880;666;2247;886;3127
316553;201511;1894;6528;1472;5502;401;1651;333;1214;734;2865
316555;201511;2830;9725;2498;9310;190;790;1844;6947;2034;7737
316556;201511;611;1609;481;1387;57;198;311;844;368;1042
316557;201511;757;2729;718;2666;282;1107;158;530;440;1637
316560;201511;333;1142;277;1019;62;284;63;190;125;474
316570;201511;1272;4026;1104;3682;141;511;559;1866;700;2377
316580;201511;300;860;192;631;48;184;50;151;98;335
316590;201511;1501;4057;1058;3310;275;909;440;1272;715;2181
316600;201511;1049;3373;918;3105;278;1011;302;986;580;1997
316610;201511;586;2101;510;1946;104;458;302;1124;406;1582
316620;201511;2147;6553;1821;5958;324;1253;1041;3313;1365;4566
316630;201511;1459;4813;1232;4320;495;1824;316;1108;811;2932
316640;201511;183;576;159;525;32;137;72;201;104;338
316650;201511;911;3313;797;3125;126;515;487;1977;613;2492
316660;201511;199;511;96;289;12;50;26;56;38;106
316670;201511;1831;5258;1469;4607;577;1955;289;827;866;2782
316680;201511;1927;5195;1548;4658;215;683;1076;3232;1291;3915
316690;201511;1194;3965;1054;3656;303;1192;330;1090;633;2282
316695;201511;1105;3466;942;3136;135;473;547;1820;682;2293
316700;201511;350;1082;311;1009;48;203;183;536;231;739
316710;201511;3182;11761;2705;10706;937;3920;655;2760;1592;6680
316720;201511;15328;48979;12208;42101;3514;12832;2391;8014;5905;20846
316730;201511;366;1130;312;1019;73;269;144;427;217;696
316740;201511;688;2272;611;2132;144;588;292;978;436;1566
316750;201511;415;1366;345;1202;65;272;112;342;177;614
316760;201511;3426;11433;2951;10801;1607;6023;787;2964;2394;8987
316770;201511;1255;3570;1140;3421;114;431;868;2580;982;3011
316780;201511;583;1934;507;1780;140;559;112;347;252;906
316790;201511;865;2457;626;2043;154;550;191;615;345;1165
316800;201511;5185;17018;4606;15887;882;3435;2265;7359;3147;10794
316805;201511;848;2190;802;2131;78;204;670;1843;748;2047
316810;201511;621;1891;508;1659;152;553;191;571;343;1124
316820;201511;393;1014;221;705;43;165;39;105;82;270
316830;201511;602;2052;569;1988;174;669;230;773;404;1442
316840;201511;2922;8844;2549;8135;593;2189;1076;3217;1669;5406
316850;201511;2096;6145;1759;5560;267;956;955;2995;1222;3951
316860;201511;17786;55811;15119;50707;3473;13462;6238;19806;9711;33268
316870;201511;5858;18823;4639;15926;1342;5053;731;2382;2073;7435
316880;201511;822;2559;733;2402;210;795;250;773;460;1568
316890;201511;1314;3204;1035;2844;319;1020;537;1368;856;2388
316900;201511;2551;7645;1996;6466;461;1668;590;1699;1051;3367
316905;201511;461;1531;397;1386;133;494;129;441;262;935
316910;201511;808;2565;576;2081;165;642;103;373;268;1015
316920;201511;1563;4339;1155;3756;320;1185;388;1190;708;2375
316930;201511;8767;29430;6782;24887;1487;6008;936;3059;2423;9067
316935;201511;5123;14831;3283;11059;844;3187;565;1711;1409;4898
316940;201511;7050;22925;5664;19879;1287;4803;1174;3962;2461;8765
316950;201511;1494;4215;1273;3897;125;461;884;2661;1009;3122
316960;201511;5000;12496;3904;11016;735;2276;2141;5929;2876;8205
316970;201511;3278;10405;3068;10047;700;2673;1173;3521;1873;6194
316980;201511;1044;3129;741;2548;233;891;141;470;374;1361
316990;201511;9701;30940;8035;26992;2497;9095;699;2210;3196;11305
317000;201511;2753;9398;2650;9282;334;1086;1931;7603;2265;8689
317005;201511;2606;7969;2296;7500;456;1516;1299;4286;1755;5802
317010;201511;31373;77886;18619;57247;4612;15924;3882;12304;8494;28228
317020;201511;59633;165589;35037;114014;7422;26431;7104;21034;14526;47465
317030;201511;767;2180;624;1951;70;279;378;1138;448;1417
317040;201511;10431;30121;8289;26240;2161;7383;3097;9681;5258;17064
317043;201511;753;2042;639;1894;87;251;403;1210;490;1461
317047;201511;1149;3021;823;2478;123;409;395;1174;518;1583
317050;201511;1527;5193;1175;4326;239;957;448;1536;687;2493
317052;201511;2323;7477;2107;7135;183;726;1528;5103;1711;5829
317057;201511;1760;4873;1319;4098;129;503;757;2266;886;2769
317060;201511;409;1177;275;871;56;209;84;223;140;432
317065;201511;1250;4071;1130;3872;126;561;821;2711;947;3272
317070;201511;9868;30459;6451;22543;1370;5389;986;3233;2356;8622
317075;201511;1088;3256;866;2782;219;766;231;665;450;1431
317080;201511;6113;16743;5142;15069;1506;4633;1622;4565;3128;9198
317090;201511;4902;16173;4524;15547;675;2334;3024;10605;3699;12939
317100;201511;3070;8425;2310;7114;714;2408;779;2263;1493;4671
317103;201511;2015;6883;1677;6192;271;1256;811;2875;1082;4131
317107;201511;1322;4028;1123;3613;188;720;679;2043;867;2763
317110;201511;669;1669;387;1180;79;291;145;430;224;721
317115;201511;1166;3659;990;3295;128;427;655;2216;783;2643
317120;201511;11168;36514;8933;31207;2165;8372;3149;10629;5314;19001
317130;201511;7627;22735;6352;20400;1353;4887;2686;8424;4039;13311
317140;201511;580;1880;546;1817;82;294;352;1171;434;1465
317150;201511;978;2690;838;2527;101;359;589;1721;690;2080
317160;201511;3534;9294;2667;8144;231;739;1831;5557;2062;6296
317170;201511;1825;5030;1472;4450;93;357;846;2367;939;2724
317180;201511;1818;6024;1430;5162;391;1538;372;1295;763;2833
317190;201511;1387;3953;1107;3552;122;430;743;2353;865;2783
317200;201511;4470;13900;3801;12530;1014;3689;1166;3651;2180;7340
317210;201511;1045;3130;860;2873;165;676;461;1502;626;2178
317220;201511;297;1023;282;999;82;318;121;406;203;724
320010;201511;5119;15948;4385;14366;801;2773;2229;7196;3030;9969
320013;201511;1943;5820;1383;4650;216;734;607;2094;823;2828
320016;201511;3193;8966;2746;8290;388;1131;1886;5724;2274;6855
320020;201511;3879;12011;3254;10695;951;3386;1061;3416;2012;6802
320030;201511;1656;5293;1311;4528;397;1442;405;1349;802;2791
320035;201511;1795;5256;1549;4863;499;1754;559;1594;1058;3348
320040;201511;3319;10660;2657;9232;602;2290;781;2598;1383;4888
320050;201511;1794;4835;1515;4321;346;1066;655;1754;1001;2820
320060;201511;12055;37922;9072;30969;2155;8015;2561;8181;4716;16196
320070;201511;1487;4743;1179;4027;265;1017;306;903;571;1920
320080;201511;5476;15680;4078;12810;1100;3591;1001;3213;2101;6804
320090;201511;8397;24318;6573;20563;1777;5934;2451;7267;4228;13201
320100;201511;2969;9036;2353;7766;641;2244;825;2622;1466;4866
320110;201511;1301;3850;1126;3498;262;843;373;1140;635;1983
320115;201511;1839;6460;1651;6103;849;3302;436;1604;1285;4906
320120;201511;16493;50096;12603;42309;3297;12133;3614;11972;6911;24105
320130;201511;36904;117867;33190;110140;7117;26303;15463;49293;22580;75596
320140;201511;4054;12704;2818;9804;683;2638;326;1040;1009;3678
320150;201511;16741;45912;11648;35960;2802;9367;1819;5310;4621;14677
320160;201511;4904;15411;4211;13928;1080;4019;1430;4262;2510;8281
320170;201511;1756;5584;1411;4807;376;1362;525;1771;901;3133
320180;201511;816;2677;705;2484;283;1044;181;646;464;1690
320190;201511;3801;12882;2954;10730;837;3227;622;2120;1459;5347
320200;201511;1077;3291;897;2966;227;816;323;1091;550;1907
320210;201511;4955;13713;4151;12185;893;2950;1942;5274;2835;8224
320220;201511;2596;7974;2083;6955;542;1983;783;2629;1325;4612
320225;201511;1437;4869;1125;4099;392;1529;190;691;582;2220
320230;201511;4264;13780;3681;12761;1178;4401;1284;4469;2462;8870
320240;201511;12326;36197;9500;30882;2570;9075;2398;7634;4968;16709
320245;201511;3656;12371;3336;11569;1108;4112;928;3039;2036;7151
320250;201511;1846;5583;1304;4330;349;1356;236;644;585;2000
320255;201511;1818;6058;1563;5613;630;2467;545;2016;1175;4483
320260;201511;1048;3214;782;2578;207;735;184;501;391;1236
320265;201511;2402;7482;2084;7036;428;1506;1248;4323;1676;5829
320270;201511;2743;8162;2028;6730;484;1761;816;2677;1300;4438
320280;201511;6949;20841;6028;18977;1415;4900;2381;7037;3796;11937
320290;201511;1479;4794;1065;3735;341;1280;187;601;528;1881
320300;201511;4336;14320;3818;13167;1207;4420;923;3100;2130;7520
320305;201511;4557;14566;3921;13102;944;3471;1659;5229;2603;8700
320310;201511;2007;5927;1683;5262;432;1409;644;1947;1076;3356
320313;201511;2278;6622;1526;4862;367;1400;277;734;644;2134
320316;201511;1764;5295;1428;4594;465;1576;491;1499;956;3075
320320;201511;20083;61652;16023;53809;4458;16449;5271;17074;9729;33523
320330;201511;3070;9050;2597;8249;639;1997;1239;4145;1878;6142
320332;201511;4977;16493;4299;15162;1547;5761;1239;4383;2786;10144
320334;201511;1947;6194;1341;4840;387;1563;225;734;612;2297
320335;201511;2394;6988;1502;4945;383;1411;211;555;594;1966
320340;201511;5969;16125;4848;14219;1091;3476;2025;5974;3116;9450
320350;201511;5192;13819;3844;11332;866;2721;1504;4364;2370;7085
320360;201511;1768;4620;1276;3648;229;708;511;1332;740;2040
320370;201511;3230;10385;2587;8935;744;2651;823;2774;1567;5425
320380;201511;2371;6922;2069;6374;366;1264;1208;3607;1574;4871
320390;201511;7781;23137;6170;19688;1760;6125;1673;4971;3433;11096
320400;201511;3731;11228;3260;10391;964;3439;1173;3413;2137;6852
320405;201511;4107;12023;3588;11199;902;3026;1761;5315;2663;8341
320410;201511;5635;14654;4104;12631;1043;3453;1804;5479;2847;8932
320420;201511;1982;6001;1478;5078;440;1682;312;1040;752;2722
320425;201511;1968;5267;1666;4745;225;700;1007;2791;1232;3491
320430;201511;2369;6641;2038;5961;435;1361;1059;2968;1494;4329
320435;201511;2866;9348;2359;8290;1066;3916;633;2316;1699;6232
320440;201511;1150;3795;1000;3392;237;911;347;1095;584;2006
320450;201511;2059;6395;1667;5577;458;1706;691;2190;1149;3896
320455;201511;4327;14233;3080;11106;876;3379;767;2676;1643;6055
320460;201511;2797;8948;2166;7518;561;2130;632;2044;1193;4174
320465;201511;1641;5100;1243;4179;239;890;540;1761;779;2651
320470;201511;4505;13491;2971;9943;794;2935;503;1474;1297;4409
320480;201511;1873;5714;1606;5192;409;1458;559;1740;968;3198
320490;201511;15964;48931;13092;43357;3998;14490;3650;11936;7648;26426
320495;201511;1269;3833;885;2974;312;1085;108;388;420;1473
320500;201511;46949;141459;40243;128871;10034;34826;18271;56850;28305;91676
320501;201511;4353;13491;3681;12441;1243;4738;1264;4004;2507;8742
320503;201511;1938;6499;1551;5641;602;2403;390;1211;992;3614
320506;201511;3883;12072;2625;8942;840;3053;179;524;1019;3577
320510;201511;8257;25694;7001;23161;1792;6351;3051;9897;4843;16248
320515;201511;1995;5657;1599;4794;433;1329;350;966;783;2295
320517;201511;2200;7038;1757;6104;595;2285;375;1178;970;3463
320520;201511;36843;110121;29326;95649;7917;28404;10314;32961;18231;61365
320530;201511;27496;82874;22488;72875;4791;17934;10404;31278;15195;49212
330010;201511;20036;60835;17753;56284;3745;12844;9424;29178;13169;42022
330015;201511;1720;4724;1467;4249;254;863;610;1693;864;2556
330020;201511;17229;50517;15536;47686;3081;10319;8855;26563;11936;36882
330022;201511;1817;5467;1525;4976;303;1135;767;2390;1070;3525
330023;201511;3320;10205;2880;9424;812;2888;941;2915;1753;5803
330025;201511;4435;11954;3472;10380;828;2707;1761;5142;2589;7849
330030;201511;7910;26314;6892;24191;1485;5769;3195;10680;4680;16449
330040;201511;12195;35382;10441;32167;2386;7876;5076;15072;7462;22948
330045;201511;69336;191260;60152;177637;8031;25372;40210;116723;48241;142095
330050;201511;2578;7995;2252;7332;669;2398;656;1952;1325;4350
330060;201511;5765;16611;4968;15419;1232;4302;2444;7486;3676;11788
330070;201511;23090;69229;20224;64109;4579;15626;9156;28775;13735;44401
330080;201511;7939;22622;7377;21732;967;2806;5093;15203;6060;18009
330090;201511;2682;7276;2413;6822;462;1450;1293;3533;1755;4983
330093;201511;2068;6095;1681;5349;398;1325;610;1957;1008;3282
330095;201511;1041;3529;901;3208;246;1002;212;691;458;1693
330100;201511;55708;176796;50229;167269;9015;33694;26482;87741;35497;121435
330110;201511;2378;7471;2083;6915;534;1913;614;1964;1148;3877
330115;201511;2047;5831;1784;5414;341;1167;910;2663;1251;3830
330120;201511;2503;7015;2184;6531;534;1781;1098;3133;1632;4914
330130;201511;3595;11498;3131;10625;819;3022;1388;4603;2207;7625
330140;201511;2987;9302;2698;8854;636;2293;1312;4264;1948;6557
330150;201511;2418;7036;1823;5817;414;1448;429;1336;843;2784
330160;201511;1146;3714;1007;3463;293;1142;442;1430;735;2572
330170;201511;102915;307348;93268;291505;16521;54736;55932;173318;72453;228054
330180;201511;2029;5934;1676;5271;167;644;996;2926;1163;3570
330185;201511;7834;24485;6777;22345;1560;5625;3432;11015;4992;16640
330187;201511;3925;11145;3333;10125;516;1766;2160;6426;2676;8192
330190;201511;25924;73684;23918;70420;4696;14570;15118;44126;19814;58696
330200;201511;13956;43985;12280;40939;3181;11008;5763;19368;8944;30376
330205;201511;2258;6101;1931;5532;373;1183;1024;2811;1397;3994
330210;201511;4064;10949;3126;9165;873;2706;732;2080;1605;4786
330220;201511;10213;31008;8770;27861;2390;8225;2266;6555;4656;14780
330225;201511;3969;12115;3563;11398;473;1762;2208;6968;2681;8730
330227;201511;17680;50508;15720;47541;4041;12504;8027;24573;12068;37077
330230;201511;1391;4137;1249;3887;312;1094;516;1504;828;2598
330240;201511;17465;53562;14720;48101;4990;17685;3227;9864;8217;27549
330245;201511;1283;3956;989;3387;255;959;190;609;445;1568
330250;201511;36022;104795;32434;98592;9856;30220;12979;40378;22835;70598
330260;201511;3701;11553;3195;10484;643;2350;1345;4137;1988;6487
330270;201511;16088;41034;11659;34613;3095;10005;4138;12118;7233;22123
330280;201511;2187;6491;1787;5687;320;1123;806;2360;1126;3483
330285;201511;18510;52940;16572;50021;2891;9452;10176;30348;13067;39800
330290;201511;3594;9986;3130;9281;540;1829;1822;5148;2362;6977
330300;201511;3344;10778;3027;10182;451;1743;1770;5783;2221;7526
330310;201511;2386;6767;2047;6182;338;1093;1109;3266;1447;4359
330320;201511;13261;39476;12314;38001;1874;6317;8779;26841;10653;33158
330330;201511;27410;76160;24030;70660;4176;13839;14608;41370;18784;55209
330340;201511;14587;42538;11181;35957;2937;10003;3297;10397;6234;20400
330350;201511;87671;261704;80748;251144;12251;39857;56077;174388;68328;214245
330360;201511;5682;17065;5469;16755;359;1233;4602;14016;4961;15249
330370;201511;3479;12318;3125;11520;1082;4126;998;3711;2080;7837
330380;201511;4953;15870;4134;14236;927;3516;1682;5598;2609;9114
330385;201511;4122;14128;3730;13331;1172;4499;1356;4790;2528;9289
330390;201511;23323;76061;20428;69979;4911;18400;8926;29662;13837;48062
330395;201511;3045;8919;2720;8346;279;1007;1810;5386;2089;6393
330400;201511;2518;7989;2252;7505;342;1380;1283;3932;1625;5312
330410;201511;2794;8649;2300;7673;502;1858;1021;3277;1523;5135
330411;201511;2350;7267;2003;6511;243;946;1148;3549;1391;4495
330412;201511;1350;4554;1096;4024;255;1083;431;1456;686;2539
330414;201511;25041;70163;21592;65218;4314;13012;12693;38684;17007;51696
330415;201511;3584;10889;3056;9897;807;2700;1110;3604;1917;6304
330420;201511;9503;27689;6301;21410;1478;5422;1087;3543;2565;8965
330430;201511;7619;22393;6697;20626;1426;4748;3147;9417;4573;14165
330440;201511;1794;5925;1504;5276;465;1810;304;914;769;2724
330450;201511;1406;4653;1249;4352;286;1192;607;2019;893;3211
330452;201511;13806;40300;10658;34048;2769;9664;3772;11487;6541;21151
330455;201511;488807;1357490;401200;1215447;96730;310062;191536;572570;288266;882632
330460;201511;1231;3965;1091;3710;228;899;503;1645;731;2544
330470;201511;4393;13310;3857;12285;931;3238;1693;5213;2624;8451
330475;201511;7865;24305;6862;22528;1979;7126;2570;8168;4549;15294
330480;201511;5839;17166;5313;16378;1110;3710;2889;8737;3999;12447
330490;201511;107912;286312;96415;269210;10109;29292;71507;199938;81616;229230
330500;201511;5537;17054;5242;16483;655;2270;3612;11201;4267;13471
330510;201511;38271;117081;34151;110243;10699;35090;14843;48687;25542;83777
330513;201511;1518;4538;1366;4256;410;1280;510;1622;920;2902
330515;201511;3045;9384;2651;8621;807;2651;812;2614;1619;5265
330520;201511;11781;34963;10327;32296;2198;7259;4940;15220;7138;22479
330530;201511;1528;4556;1333;4176;354;1180;498;1521;852;2701
330540;201511;3075;9004;2543;8053;605;2102;1047;3145;1652;5247
330550;201511;8066;26814;6993;24682;3022;11092;1115;3917;4137;15009
330555;201511;10450;30763;9197;28895;1784;5698;5503;17660;7287;23358
330560;201511;4198;12651;3792;11895;770;2679;1918;5762;2688;8441
330570;201511;3648;10535;3076;9557;834;2696;1439;4478;2273;7174
330575;201511;5219;15043;4625;13949;786;2652;2854;8235;3640;10887
330580;201511;14655;45772;12289;40819;3275;11455;4825;16040;8100;27495
330590;201511;1659;5042;1531;4820;315;1068;913;2822;1228;3890
330600;201511;10809;30710;8507;26888;1227;4450;4590;14107;5817;18557
330610;201511;9042;28238;8151;26563;1488;5499;4537;14430;6025;19929
330615;201511;1684;5852;1501;5431;659;2573;296;1035;955;3608
330620;201511;3633;12443;3229;11678;1130;4467;798;2913;1928;7380
330630;201511;22760;66973;18423;59028;3403;12386;9545;29209;12948;41595
350010;201511;2127;6300;1425;4803;338;1246;224;646;562;1892
350020;201511;463;1204;310;904;53;168;164;453;217;621
350030;201511;4448;13799;3444;11710;1238;4625;745;2298;1983;6923
350040;201511;507;1731;386;1446;87;357;103;333;190;690
350050;201511;1062;3168;835;2751;200;766;295;863;495;1629
350055;201511;672;1969;574;1804;129;434;309;937;438;1371
350060;201511;104;300;81;264;23;89;35;106;58;195
350070;201511;3556;10843;2254;7921;477;1827;413;1267;890;3094
350075;201511;436;1464;340;1297;115;464;84;297;199;761
350080;201511;574;1605;388;1233;82;289;148;445;230;734
350090;201511;611;1612;409;1250;82;256;147;433;229;689
350100;201511;1828;5724;1288;4538;284;1106;363;1180;647;2286
350110;201511;466;1366;347;1099;46;173;173;522;219;695
350115;201511;1288;3949;1130;3603;216;812;594;1718;810;2530
350120;201511;579;1512;287;881;58;189;46;132;104;321
350130;201511;3380;9902;2939;9015;451;1594;1562;4456;2013;6050
350140;201511;599;1916;509;1753;91;363;235;776;326;1139
350150;201511;382;1287;337;1190;120;450;85;295;205;745
350160;201511;7447;21905;5093;17058;1283;4828;1883;5700;3166;10528
350170;201511;1768;6032;1498;5347;396;1532;365;1197;761;2729
350180;201511;1120;3052;753;2249;142;433;339;988;481;1421
350190;201511;3164;9793;2564;8554;548;2198;1224;3609;1772;5807
350200;201511;351;1115;294;1006;46;177;152;516;198;693
350210;201511;5207;13745;3820;11435;1076;3582;1505;4280;2581;7862
350220;201511;2613;8235;2252;7465;584;2268;783;2324;1367;4592
350230;201511;633;2071;576;1970;134;513;241;800;375;1313
350240;201511;447;1394;384;1230;79;263;223;690;302;953
350250;201511;2154;7762;2015;7476;725;2865;691;2521;1416;5386
350260;201511;965;2576;675;2052;126;413;284;806;410;1219
350270;201511;5054;15367;4193;13455;813;2767;1746;5379;2559;8146
350275;201511;1994;6619;1776;6220;499;1861;642;2142;1141;4003
350280;201511;22187;54647;13155;38823;2872;8961;2815;8136;5687;17097
350290;201511;1712;5540;1326;4717;289;1133;330;1075;619;2208
350300;201511;357;1060;311;977;68;218;174;549;242;767
350310;201511;866;2834;742;2540;115;447;335;1104;450;1551
350315;201511;528;1651;405;1387;68;273;102;314;170;587
350320;201511;11479;35519;9883;32347;2747;9594;1482;4912;4229;14506
350330;201511;13723;38681;8867;27353;1844;5693;2889;8466;4733;14159
350335;201511;370;1140;319;1035;37;119;195;636;232;755
350340;201511;1136;3353;776;2604;153;588;238;745;391;1333
350350;201511;737;2268;621;2061;118;463;230;735;348;1198
350360;201511;797;2688;669;2411;184;699;247;901;431;1600
350370;201511;708;2114;498;1643;89;319;102;290;191;609
350380;201511;3579;10674;2586;8916;791;3025;637;1942;1428;4967
350390;201511;8764;27284;7693;25236;2299;7871;2910;9313;5209;17184
350395;201511;355;996;180;621;24;92;37;126;61;218
350400;201511;7975;22620;6286;19509;1473;5091;2443;7176;3916;12267
350410;201511;8221;27339;6166;22848;1673;6817;1025;3524;2698;10341
350420;201511;555;1651;386;1340;70;294;34;101;104;395
350430;201511;746;2296;601;2022;123;468;282;903;405;1371
350440;201511;1225;3828;1088;3549;273;912;506;1629;779;2541
350450;201511;7748;23040;5815;19092;1380;4891;1392;4267;2772;9158
350460;201511;1363;3831;894;2840;192;682;268;757;460;1439
350470;201511;248;676;200;588;37;131;114;309;151;440
350480;201511;805;2439;533;1821;75;288;88;251;163;539
350490;201511;1800;5352;1539;4952;378;1345;587;1732;965;3077
350500;201511;577;1672;491;1522;108;364;229;692;337;1056
350510;201511;1047;3133;807;2603;139;527;333;978;472;1505
350520;201511;1297;4749;990;3925;250;1097;178;650;428;1747
350530;201511;2428;7112;1954;6130;568;1896;576;1638;1144;3534
350535;201511;1310;4101;1214;3916;147;592;832;2541;979;3133
350540;201511;1931;5344;1508;4575;411;1316;511;1526;922;2842
350550;201511;11661;30904;7771;24313;1667;5838;2648;7817;4315;13655
350560;201511;3415;11133;3045;10330;457;1667;1624;5537;2081;7204
350570;201511;18262;60844;16203;56229;4796;17870;5753;18900;10549;36770
350580;201511;1684;5195;1176;4019;249;942;162;464;411;1406
350590;201511;4132;12714;3070;10487;816;3114;997;3081;1813;6195
350600;201511;40678;99573;26453;75262;4386;13497;12299;33040;16685;46537
350610;201511;7728;22068;5885;18777;1205;4302;2566;7894;3771;12196
350620;201511;398;1111;298;952;61;228;139;411;200;639
350630;201511;1571;4667;1193;3950;267;1039;326;950;593;1989
350635;201511;5988;17833;4504;15068;1095;3941;1720;5649;2815;9590
350640;201511;730;2271;487;1654;93;352;115;357;208;709
350650;201511;7250;22055;4027;14108;977;3793;425;1364;1402;5157
350660;201511;4382;13002;3658;11769;773;2718;1911;5985;2684;8703
350670;201511;1722;5281;1585;5013;310;1047;947;2908;1257;3955
350680;201511;1146;3451;886;2919;197;751;366;1158;563;1909
350690;201511;883;2865;705;2494;162;636;221;717;383;1353
350700;201511;4172;12356;2672;9450;787;2979;625;1929;1412;4908
350710;201511;2534;7897;2239;7377;345;1265;1372;4441;1717;5706
350715;201511;874;2630;761;2422;242;832;246;693;488;1525
350720;201511;135;393;121;370;38;123;44;127;82;250
350730;201511;390;1454;367;1393;98;422;140;509;238;931
350740;201511;1937;5932;1445;4725;282;1007;479;1410;761;2417
350745;201511;374;1153;268;887;46;172;118;339;164;511
350750;201511;10209;30589;7740;25536;1842;6661;1681;5031;3523;11692
350760;201511;13163;38451;10367;33252;2636;9364;3427;10073;6063;19437
350770;201511;732;2063;485;1572;71;266;222;686;293;952
350775;201511;561;1521;467;1372;69;252;270;764;339;1016
350780;201511;2018;6105;1490;5002;430;1601;201;623;631;2224
350790;201511;2025;6286;1482;5143;371;1386;322;977;693;2363
350800;201511;3015;9918;2824;9598;472;1847;1749;5785;2221;7632
350810;201511;2053;5740;1670;5172;489;1631;621;1904;1110;3535
350820;201511;563;1510;403;1193;73;268;180;478;253;746
350830;201511;885;2712;588;2003;88;325;147;403;235;728
350840;201511;2513;8755;2027;7542;593;2409;370;1153;963;3562
350850;201511;6269;20651;5119;18022;1625;6064;1140;3855;2765;9919
350860;201511;3144;9737;3002;9523;246;988;2328;7298;2574;8286
350870;201511;2650;8403;2205;7687;565;2233;1232;4269;1797;6502
350880;201511;1309;4275;1066;3751;260;987;241;810;501;1797
350890;201511;677;1902;432;1366;62;230;98;230;160;460
350900;201511;3909;12730;2936;10450;762;2969;413;1316;1175;4285
350910;201511;848;2503;732;2260;243;789;270;794;513;1583
350920;201511;9987;28590;8879;26589;1137;3794;5975;17202;7112;20996
350925;201511;4863;14807;3961;12921;995;3462;1486;4404;2481;7866
350930;201511;1600;4324;1270;3728;148;480;810;2277;958;2757
350940;201511;1925;6288;1753;6021;324;1330;1069;3543;1393;4873
350945;201511;906;2879;759;2577;125;517;411;1327;536;1844
350950;201511;68770;207886;54401;177657;13006;46545;21728;67120;34734;113665
350960;201511;4409;14656;3693;13113;663;2653;2042;6936;2705;9589
350970;201511;4372;14977;3628;13166;1150;4559;777;2427;1927;6986
350980;201511;600;1954;538;1848;226;833;185;626;411;1459
350990;201511;1733;5894;1461;5351;447;1755;382;1355;829;3110
350995;201511;778;2683;739;2604;117;529;456;1514;573;2043
351000;201511;3231;9563;2650;8440;377;1358;1291;3861;1668;5219
351010;201511;357;1012;226;730;56;202;77;251;133;453
351015;201511;862;2839;724;2575;168;672;316;1070;484;1742
351020;201511;7977;24834;6856;23032;1708;6054;3065;10400;4773;16454
351030;201511;1644;5834;1452;5351;332;1422;446;1500;778;2922
351040;201511;3326;10029;2995;9448;482;1737;1893;5723;2375;7460
351050;201511;13571;39059;9302;31117;2414;8812;2436;7955;4850;16767
351060;201511;33457;98385;26881;86130;6131;21481;11616;35990;17747;57471
351070;201511;1595;4426;1059;3428;302;1076;140;370;442;1446
351080;201511;2664;7677;2029;6856;518;1931;872;2808;1390;4739
351090;201511;388;1298;293;1087;62;264;59;208;121;472
351100;201511;2050;6203;1597;5274;487;1657;389;1328;876;2985
351110;201511;7517;18670;3939;12539;881;3178;884;2526;1765;5704
351120;201511;637;1834;509;1565;57;211;262;703;319;914
351130;201511;1012;2824;533;1818;90;344;95;297;185;641
351140;201511;1758;5854;1437;5162;431;1686;362;1185;793;2871
351150;201511;1704;5832;1235;4593;210;864;257;800;467;1664
351160;201511;1318;4454;1141;4031;299;1199;388;1250;687;2449
351170;201511;1491;4696;1185;4022;228;851;519;1647;747;2498
351190;201511;772;2432;599;1989;112;375;140;435;252;810
351200;201511;2135;6243;1737;5422;338;1197;614;1713;952;2910
351210;201511;1082;3196;804;2618;173;630;275;798;448;1428
351220;201511;3317;10985;2926;10167;595;2268;1374;4676;1969;6944
351230;201511;1765;5449;1478;4919;298;1196;757;2384;1055;3580
351240;201511;1051;3300;756;2640;207;779;175;525;382;1304
351250;201511;916;2606;614;1962;126;434;215;636;341;1070
351260;201511;929;2690;784;2386;179;569;324;935;503;1504
351270;201511;356;1210;317;1130;67;282;139;440;206;722
351280;201511;5151;15017;3795;12105;836;2862;1338;3970;2174;6832
351290;201511;1001;2828;744;2319;166;531;296;891;462;1422
351300;201511;12617;41231;9227;33651;2298;9206;2831;10013;5129;19219
351310;201511;3216;9699;2550;8446;503;1920;1176;3587;1679;5507
351320;201511;902;3009;769;2707;166;675;237;726;403;1401
351330;201511;292;807;238;716;96;295;56;157;152;452
351340;201511;5803;19266;4970;17542;1414;5301;1883;6585;3297;11886
351350;201511;7134;22920;6033;20523;1756;6213;1861;5953;3617;12166
351360;201511;4156;12812;3749;11981;909;3201;1255;3641;2164;6842
351370;201511;2296;7010;1786;5930;393;1455;653;1980;1046;3435
351380;201511;37059;108297;33157;100730;6602;21781;14733;43350;21335;65131
351385;201511;199;613;185;587;41;138;83;247;124;385
351390;201511;1127;3643;942;3260;257;1019;354;1080;611;2099
351400;201511;886;2925;834;2799;329;1172;262;841;591;2013
351410;201511;2690;7986;2337;7333;389;1297;1339;4067;1728;5364
351420;201511;361;1012;233;756;53;180;60;185;113;365
351430;201511;854;2610;776;2480;101;351;549;1740;650;2091
351440;201511;3728;10845;2817;8819;675;2175;539;1449;1214;3624
351450;201511;1684;4667;1383;4194;352;1108;584;1855;936;2963
351460;201511;733;2188;612;1983;301;1016;167;512;468;1528
351470;201511;1049;3080;900;2790;211;741;367;1068;578;1809
351480;201511;2803;9036;2544;8597;439;1862;1388;4444;1827;6306
351490;201511;1787;5857;1568;5377;217;908;918;2964;1135;3872
351492;201511;207;643;157;526;18;71;88;286;106;357
351495;201511;161;519;126;420;29;117;46;133;75;250
351500;201511;23782;68319;18057;57290;4624;16113;7008;21082;11632;37195
351510;201511;8576;26478;6951;23146;1645;5963;3291;10707;4936;16670
351512;201511;431;1244;338;1049;57;175;193;612;250;787
351515;201511;2253;7026;1571;5481;388;1459;416;1292;804;2751
351518;201511;2038;6397;1383;5129;342;1458;394;1312;736;2770
351519;201511;794;2305;600;1882;112;429;207;503;319;932
351520;201511;825;2263;415;1455;63;256;62;196;125;452
351530;201511;387;1176;269;885;39;129;78;223;117;352
351535;201511;2366;6037;1811;5202;179;608;1177;3244;1356;3852
351540;201511;1729;5208;1356;4467;432;1546;190;608;622;2154
351550;201511;4944;14377;3450;11263;743;2755;1197;3720;1940;6475
351560;201511;370;1184;310;1050;68;274;53;160;121;434
351565;201511;182;596;165;549;29;108;76;239;105;347
351570;201511;11519;35193;9679;31402;2218;7784;4959;15586;7177;23370
351580;201511;339;884;206;597;50;140;61;165;111;305
351590;201511;428;1127;307;902;35;107;127;352;162;459
351600;201511;1713;4735;1466;4313;271;888;666;1838;937;2726
351610;201511;658;1799;501;1526;57;212;233;639;290;851
351620;201511;18894;60240;14041;50012;3081;12165;3239;10188;6320;22353
351630;201511;18584;58647;16585;55222;3772;13411;9110;29905;12882;43316
351640;201511;11288;34291;9170;30348;1778;6440;4943;16002;6721;22442
351650;201511;452;1361;219;756;39;152;37;109;76;261
351660;201511;775;2455;543;1840;116;413;120;352;236;765
351670;201511;3946;12117;3180;10431;579;2169;1459;4469;2038;6638
351680;201511;646;1962;390;1335;66;238;84;272;150;510
351685;201511;425;1250;343;1115;87;280;151;502;238;782
351690;201511;1070;3122;735;2359;142;508;218;597;360;1105
351700;201511;1189;3426;1013;3085;256;776;411;1216;667;1992
351710;201511;637;2042;512;1767;89;300;198;641;287;941
351720;201511;1647;4946;1094;3570;218;750;335;983;553;1733
351730;201511;1058;3006;844;2696;269;970;309;938;578;1908
351740;201511;3985;10857;3117;9118;640;1986;1095;3040;1735;5026
351750;201511;1179;3709;805;2824;184;737;226;703;410;1440
351760;201511;3705;11479;3038;9998;803;2840;1035;3151;1838;5991
351770;201511;2295;7111;1907;6429;551;1952;791;2533;1342;4485
351780;201511;1557;4327;887;2813;158;539;234;686;392;1225
351790;201511;1030;2962;882;2729;257;781;391;1253;648;2034
351800;201511;468;1023;310;800;39;107;164;415;203;522
351810;201511;1023;2864;923;2731;132;405;673;1999;805;2404
351820;201511;2315;7324;1752;6158;452;1657;152;500;604;2157
351830;201511;4037;12530;3100;10382;553;2089;1470;4632;2023;6721
351840;201511;7224;23820;6143;21651;1643;6284;2155;7308;3798;13592
351850;201511;1843;5123;1310;4150;190;753;606;1689;796;2442
351860;201511;3391;10749;2922;9741;772;2781;1161;3635;1933;6416
351870;201511;29709;88613;24950;79674;6810;23024;11020;34562;17830;57586
351880;201511;109775;344844;92290;307450;27443;96980;25629;81146;53072;178126
351885;201511;572;2002;528;1906;140;527;231;814;371;1341
351890;201511;670;1994;507;1645;117;432;107;292;224;724
351900;201511;1266;3800;1062;3463;293;1018;326;1038;619;2056
351905;201511;459;1447;370;1275;56;230;194;616;250;846
351907;201511;17093;50427;14005;44577;1908;7218;8367;25540;10275;32758
351910;201511;972;2989;834;2706;174;648;380;1153;554;1801
351920;201511;1023;2792;886;2580;129;448;549;1542;678;1990
351925;201511;918;2832;759;2493;128;460;371;1148;499;1608
351930;201511;2664;8591;2502;8269;495;2029;1632;5000;2127;7029
351940;201511;952;2853;786;2518;179;619;339;1031;518;1650
351950;201511;1441;3949;1015;3140;146;492;527;1593;673;2085
351960;201511;4019;11515;2801;9179;645;2326;1091;3483;1736;5809
351970;201511;5313;19072;4656;17706;1400;5723;1585;5847;2985;11570
351980;201511;905;2686;679;2211;140;501;250;715;390;1216
351990;201511;1549;4334;1216;3679;271;966;264;664;535;1630
352000;201511;2214;7086;1975;6566;442;1581;918;2860;1360;4441
352010;201511;1764;5849;1512;5272;372;1418;339;1123;711;2541
352020;201511;1394;4325;1178;3912;278;1015;438;1366;716;2381
352030;201511;4880;14209;4020;12904;956;3191;2070;6676;3026;9867
352040;201511;2001;6569;1618;5703;359;1384;375;1209;734;2593
352042;201511;3173;8781;2036;6285;420;1414;934;2768;1354;4182
352044;201511;1305;4293;969;3511;185;740;161;513;346;1253
352050;201511;9340;28326;5952;20623;1388;5303;1135;3475;2523;8778
352060;201511;727;2120;593;1871;126;469;248;707;374;1176
352070;201511;783;2019;613;1731;153;453;209;570;362;1023
352080;201511;427;1210;301;958;56;194;120;349;176;543
352090;201511;1514;4998;1176;4205;243;958;224;705;467;1663
352100;201511;2588;7814;1881;6445;505;1909;627;1939;1132;3848
352110;201511;502;1747;422;1560;116;458;154;538;270;996
352115;201511;431;1358;366;1217;71;246;162;507;233;753
352120;201511;932;2847;773;2555;146;558;390;1205;536;1763
352130;201511;1831;5224;1223;3968;349;1191;302;877;651;2068
352140;201511;1774;5107;1016;3426;169;606;371;1184;540;1790
352150;201511;744;2265;576;1925;147;508;245;803;392;1311
352160;201511;1029;2813;805;2392;165;538;280;721;445;1259
352170;201511;2687;8043;2389;7438;478;1612;1241;3598;1719;5210
352180;201511;3396;9619;2821;8483;692;2260;1007;2836;1699;5096
352190;201511;1130;3383;927;2959;180;674;316;816;496;1490
352200;201511;377;1316;304;1158;52;228;141;512;193;740
352210;201511;17119;45284;13406;39802;2567;7997;7526;22669;10093;30666
352215;201511;539;1687;498;1631;64;235;290;924;354;1159
352220;201511;12430;39930;10465;35767;3352;12313;2960;9830;6312;22143
352230;201511;12436;41402;10583;37778;3019;11780;3787;12990;6806;24770
352240;201511;11870;34445;8971;29121;2680;9741;2629;7628;5309;17369
352250;201511;22276;71251;19087;64515;5492;19897;5913;19630;11405;39527
352260;201511;5314;14964;3265;10670;639;2335;1114;3342;1753;5677
352265;201511;869;2769;738;2528;77;343;439;1404;516;1747
352270;201511;1896;6395;1554;5614;432;1655;390;1340;822;2995
352280;201511;2120;6426;1732;5739;453;1719;614;1902;1067;3621
352290;201511;1158;3612;977;3204;223;872;347;987;570;1859
352300;201511;955;2794;741;2388;180;621;302;902;482;1523
352310;201511;37213;111156;30454;99295;7832;26932;15655;50923;23487;77855
352320;201511;5648;17222;4790;15550;1350;4680;1476;4314;2826;8994
352330;201511;2020;6380;1704;5916;549;2019;483;1634;1032;3653
352340;201511;5727;18259;4256;15145;1142;4414;736;2334;1878;6748
352350;201511;1600;5437;1416;5038;285;1166;531;1761;816;2927
352360;201511;1122;3426;977;3134;192;771;590;1762;782;2533
352370;201511;835;2852;748;2646;139;554;354;1203;493;1757
352380;201511;988;3113;836;2828;270;1052;204;618;474;1670
352390;201511;18127;48915;11714;36378;2123;7547;5499;15757;7622;23304
352400;201511;3973;11068;2460;8074;695;2398;689;2071;1384;4469
352410;201511;2957;8811;2449;7943;631;2145;867;2702;1498;4847
352420;201511;939;2643;793;2357;209;680;350;982;559;1662
352430;201511;6396;19087;5221;17084;1762;6330;1510;4752;3272;11082
352440;201511;15933;48290;12581;41610;3149;11107;4411;14098;7560;25205
352450;201511;681;1964;435;1473;95;360;110;322;205;682
352460;201511;2377;7643;1959;6841;576;2217;508;1569;1084;3786
352470;201511;4245;11606;2465;8003;415;1483;783;2363;1198;3846
352480;201511;4638;12542;3523;10428;688;2345;1362;3653;2050;5998
352490;201511;724;2452;564;2039;97;402;130;422;227;824
352500;201511;8203;23919;7147;22282;3350;11265;1889;5115;5239;16380
352510;201511;3113;9859;2428;8488;733;2810;596;1994;1329;4804
352520;201511;2083;7234;1816;6578;469;1846;783;2748;1252;4594
352530;201511;7877;25091;5787;20298;1561;5822;796;2431;2357;8253
352540;201511;508;1565;372;1259;68;264;101;299;169;563
352550;201511;866;2853;589;2171;143;609;113;357;256;966
352560;201511;660;1938;464;1497;88;281;143;398;231;679
352570;201511;1805;5919;1335;4791;273;1134;274;843;547;1977
352580;201511;881;2531;736;2297;164;566;382;1157;546;1723
352585;201511;208;672;161;575;56;212;32;118;88;330
352590;201511;12539;38221;9774;32560;2561;9260;4132;12938;6693;22198
352600;201511;1578;4774;1378;4401;347;1215;594;1779;941;2994
352610;201511;3328;10083;2737;9041;809;3001;800;2404;1609;5405
352620;201511;5222;15914;4775;15222;1018;3491;2670;8282;3688;11773
352630;201511;615;1978;573;1868;129;502;241;712;370;1214
352640;201511;2802;8545;2255;7390;314;1174;1204;3809;1518;4983
352650;201511;828;2454;595;1945;131;456;166;499;297;955
352660;201511;1015;3419;780;2855;155;624;186;658;341;1282
352670;201511;10301;30935;6093;21433;1514;5747;677;2132;2191;7879
352680;201511;2863;9655;2145;7919;507;2066;596;1973;1103;4039
352690;201511;30365;83300;20636;63466;3693;12411;9671;28323;13364;40734
352700;201511;712;2121;573;1897;165;616;255;806;420;1422
352710;201511;5694;16559;4185;13481;1007;3605;1457;4387;2464;7992
352720;201511;7568;24285;6672;22301;2009;6765;2193;7251;4202;14016
352725;201511;400;1120;237;779;37;147;88;261;125;408
352730;201511;2229;7329;1939;6556;392;1442;697;2053;1089;3495
352740;201511;1943;5423;1532;4718;255;940;885;2554;1140;3494
352750;201511;466;1327;244;807;41;151;63;180;104;331
352760;201511;1117;3811;955;3427;299;1130;349;1183;648;2313
352770;201511;733;2278;628;2065;141;518;267;832;408;1350
352780;201511;613;1997;495;1726;96;382;149;459;245;841
352790;201511;636;1822;458;1482;96;322;96;306;192;628
352800;201511;969;3430;696;2676;158;683;194;629;352;1312
352810;201511;1142;2972;732;2170;140;459;222;627;362;1086
352820;201511;594;1638;427;1369;108;396;103;317;211;713
352830;201511;522;1481;316;1001;51;189;50;117;101;306
352840;201511;3840;12918;3331;11801;1024;3828;1044;3590;2068;7418
352850;201511;8602;26530;7186;24024;1900;6836;2504;8111;4404;14947
352860;201511;818;2651;738;2464;177;631;269;835;446;1466
352870;201511;964;2399;695;1889;71;270;410;1003;481;1273
352880;201511;2343;6586;1662;5162;324;1038;559;1617;883;2655
352885;201511;228;756;215;725;27;99;129;414;156;513
352890;201511;677;1792;490;1409;70;237;233;591;303;828
352900;201511;19525;56854;13831;45116;2937;10464;5041;15628;7978;26092
352910;201511;311;950;192;650;22;84;28;80;50;164
352920;201511;2463;7277;1930;6255;430;1573;772;2252;1202;3825
352930;201511;5713;17611;4361;14588;1150;4124;981;3077;2131;7201
352940;201511;23143;75002;19008;65201;6291;23070;2518;7963;8809;31033
352950;201511;297;859;189;653;47;190;41;115;88;305
352960;201511;620;1907;388;1354;68;268;58;181;126;449
352965;201511;331;975;226;718;51;170;36;91;87;261
352970;201511;3009;7553;2380;6593;298;866;1540;4282;1838;5148
352980;201511;1231;3684;1029;3379;233;758;564;1964;797;2722
352990;201511;4018;12688;3504;11781;952;3585;1368;4324;2320;7909
353000;201511;475;1308;257;796;36;116;48;127;84;243
353010;201511;3003;8358;2165;6691;529;1860;603;1596;1132;3456
353020;201511;4281;11598;2662;8032;373;1309;1025;2724;1398;4033
353030;201511;3977;11527;3217;10097;912;3107;719;2067;1631;5174
353040;201511;614;1692;512;1526;143;484;162;438;305;922
353050;201511;4911;16298;4060;14538;1168;4498;1461;4975;2629;9473
353060;201511;35341;107198;32265;102168;3822;14503;23157;70435;26979;84938
353070;201511;9646;30408;6849;24280;1824;6847;1707;6023;3531;12870
353080;201511;5266;16575;3488;12495;767;3036;798;2576;1565;5612
353090;201511;521;1713;464;1591;45;179;268;854;313;1033
353100;201511;248;665;121;387;25;85;25;70;50;155
353110;201511;7726;23337;6490;21191;1625;5623;3280;10765;4905;16388
353120;201511;712;2107;443;1475;94;367;117;325;211;692
353130;201511;2532;7297;2041;6495;663;2266;640;1956;1303;4222
353140;201511;2342;6327;1760;5165;438;1403;713;1928;1151;3331
353150;201511;1714;5139;1375;4527;387;1338;377;1237;764;2575
353160;201511;680;1913;425;1347;94;323;68;140;162;463
353170;201511;473;1552;423;1468;117;525;186;577;303;1102
353180;201511;7877;22523;6086;19166;1119;3884;3071;9334;4190;13218
353190;201511;3603;10911;2946;9464;555;2014;1448;4300;2003;6314
353200;201511;924;3084;739;2645;223;873;196;654;419;1527
353205;201511;403;1281;349;1174;80;282;134;440;214;722
353210;201511;984;2516;731;2067;41;161;482;1313;523;1474
353215;201511;411;1291;361;1178;58;221;136;388;194;609
353220;201511;673;2071;532;1750;134;477;129;368;263;845
353230;201511;848;2695;759;2522;194;723;210;618;404;1341
353240;201511;2022;6419;1801;5979;407;1540;921;2873;1328;4413
353250;201511;1078;2892;825;2427;125;388;407;1162;532;1550
353260;201511;948;2570;676;2066;112;386;265;759;377;1145
353270;201511;630;1852;539;1673;146;482;187;550;333;1032
353280;201511;581;1867;473;1625;117;448;114;373;231;821
353282;201511;1654;5258;1544;5050;214;802;989;3088;1203;3890
353284;201511;343;928;200;627;36;112;50;157;86;269
353286;201511;146;434;102;334;16;47;18;62;34;109
353290;201511;558;1758;440;1541;86;362;236;768;322;1130
353300;201511;1450;4486;1190;3898;284;1063;432;1253;716;2316
353310;201511;204;607;171;543;46;165;67;187;113;352
353320;201511;529;1515;462;1401;81;271;250;723;331;994
353325;201511;590;1906;484;1690;93;361;93;262;186;623
353330;201511;628;1787;409;1278;76;275;189;540;265;815
353340;201511;2940;8300;1870;6198;519;1833;548;1705;1067;3538
353350;201511;3228;9550;2600;8360;783;2686;990;3001;1773;5687
353360;201511;383;1224;335;1119;46;186;210;668;256;854
353370;201511;643;2079;548;1845;73;286;309;992;382;1278
353380;201511;329;1054;265;920;48;203;97;293;145;496
353390;201511;5826;15707;3999;12343;765;2584;1424;4031;2189;6615
353400;201511;497;1466;408;1282;102;362;110;279;212;641
353410;201511;609;1742;488;1537;98;336;266;822;364;1158
353420;201511;586;1618;406;1210;116;344;124;340;240;684
353430;201511;2243;7647;1605;5909;395;1537;201;653;596;2190
353440;201511;58617;185624;48441;162199;13218;46334;16438;52936;29656;99270
353450;201511;431;1283;355;1126;76;275;138;406;214;681
353460;201511;3481;9742;2947;8835;476;1591;1397;4208;1873;5799
353470;201511;9071;26991;6347;21311;1397;5228;1472;4451;2869;9679
353475;201511;1657;4608;1103;3397;208;680;314;856;522;1536
353480;201511;1423;4231;1257;3911;221;748;730;2205;951;2953
353490;201511;984;2762;772;2331;165;538;279;772;444;1310
353500;201511;1001;2667;816;2342;264;764;340;961;604;1725
353510;201511;1031;3232;766;2567;168;617;181;515;349;1132
353520;201511;1107;3182;838;2710;162;608;329;1018;491;1626
353530;201511;2564;7553;2215;6894;393;1435;1158;3442;1551;4877
353540;201511;1901;5733;1633;5272;417;1433;665;2067;1082;3500
353550;201511;6007;16428;5103;15006;613;2148;3191;8913;3804;11061
353560;201511;2086;6856;1704;6143;439;1782;446;1464;885;3246
353570;201511;423;1298;354;1156;64;217;205;638;269;855
353580;201511;2210;6806;2006;6461;376;1394;1260;3964;1636;5358
353590;201511;730;2076;539;1700;154;522;162;507;316;1029
353600;201511;1689;4676;1506;4359;233;753;787;2194;1020;2947
353610;201511;578;1914;429;1581;77;346;88;270;165;616
353620;201511;2144;6933;1782;6186;478;1782;537;1707;1015;3489
353625;201511;314;859;195;630;43;150;47;150;90;300
353630;201511;1612;5511;1217;4476;225;889;156;472;381;1361
353640;201511;1351;3911;1073;3312;151;489;560;1671;711;2160
353650;201511;7216;21346;5226;17073;1064;3628;1787;5627;2851;9255
353657;201511;303;952;264;870;48;180;82;252;130;432
353660;201511;1177;2973;838;2402;318;982;135;266;453;1248
353670;201511;3709;11784;3091;10404;966;3671;974;2891;1940;6562
353680;201511;672;2198;578;2023;220;852;195;627;415;1479
353690;201511;531;1419;294;946;53;190;86;220;139;410
353700;201511;2128;6519;1805;5850;331;1163;726;2237;1057;3400
353710;201511;3006;7273;1353;4452;315;1065;265;829;580;1894
353715;201511;461;1316;315;1001;28;110;84;240;112;350
353720;201511;2012;6244;1714;5741;340;1327;874;2753;1214;4080
353730;201511;4436;13342;3369;11006;691;2456;958;2827;1649;5283
353740;201511;1957;5777;1488;4822;405;1380;404;1244;809;2624
353750;201511;816;2697;612;2202;125;509;163;573;288;1082
353760;201511;9565;26868;7623;23780;1481;5147;4109;12509;5590;17656
353770;201511;814;2462;453;1554;71;239;29;50;100;289
353780;201511;4287;14555;3645;13228;1206;4660;976;3446;2182;8106
353790;201511;1970;6708;1600;5914;436;1833;312;1120;748;2953
353800;201511;15746;48160;12120;41243;3232;11894;4132;13611;7364;25505
353810;201511;1060;3297;796;2717;167;648;266;861;433;1509
353820;201511;1255;4223;1123;3910;242;997;575;1819;817;2816
353830;201511;707;1874;537;1590;108;347;258;755;366;1102
353850;201511;1657;5167;1446;4746;310;1066;619;1982;929;3048
353860;201511;2472;8179;2032;7150;539;2049;545;1812;1084;3861
353870;201511;27140;78476;18029;60114;3857;14031;5203;15644;9060;29675
353880;201511;2485;7803;2058;7022;295;1208;1106;3679;1401;4887
353890;201511;2764;6761;1868;5293;341;1048;881;2336;1222;3384
353900;201511;1038;3191;742;2560;159;619;213;675;372;1294
353910;201511;1240;4422;1189;4314;336;1279;665;2374;1001;3653
353920;201511;2212;6510;1471;4864;323;1157;251;732;574;1889
353930;201511;4505;13524;2968;10512;767;2929;616;2114;1383;5043
353940;201511;1206;3782;931;3158;160;597;354;1108;514;1705
353950;201511;3381;10632;2999;9891;461;1743;1803;5686;2264;7429
353960;201511;595;1861;447;1523;90;330;98;264;188;594
353970;201511;550;1588;477;1488;48;166;336;1045;384;1211
353980;201511;12576;37776;10696;34057;2391;8152;5205;15996;7596;24148
353990;201511;356;1107;316;1018;54;212;147;441;201;653
354000;201511;2101;6005;1335;4376;254;892;137;399;391;1291
354010;201511;355;1061;297;969;73;241;159;531;232;772
354020;201511;4453;13727;3833;12309;1007;3477;1347;3958;2354;7435
354025;201511;892;2472;635;1985;132;441;194;569;326;1010
354030;201511;512;1402;353;1115;56;207;160;464;216;671
354040;201511;774;2072;543;1623;60;210;283;761;343;971
354050;201511;950;3014;796;2698;215;797;213;666;428;1463
354060;201511;5106;15613;3469;11933;855;3155;985;3191;1840;6346
354070;201511;2850;9342;2390;8283;605;2255;479;1565;1084;3820
354075;201511;1943;7240;1822;6987;473;2007;800;2995;1273;5002
354080;201511;1576;4801;1064;3593;222;779;239;703;461;1482
354085;201511;314;804;278;752;18;63;223;592;241;655
354090;201511;1306;3837;1230;3708;127;420;879;2671;1006;3091
354100;201511;14910;49494;12158;43907;3100;11917;5116;18062;8216;29979
354105;201511;898;2735;783;2516;131;480;463;1432;594;1912
354110;201511;755;2069;598;1843;204;713;133;318;337;1031
354120;201511;1980;5396;1506;4497;268;886;641;1752;909;2638
354130;201511;6099;17570;4620;14602;1742;5830;632;1640;2374;7470
354140;201511;25617;64345;15220;45198;3200;10212;4771;12959;7971;23171
354150;201511;3998;10724;2993;8880;529;1758;1426;4039;1955;5797
354160;201511;3387;10894;2767;9434;761;2811;1037;3350;1798;6161
354165;201511;373;1346;319;1216;90;390;108;387;198;777
354170;201511;1403;4295;1088;3582;204;769;416;1199;620;1968
354180;201511;469;1368;413;1248;55;205;236;633;291;838
354190;201511;1516;4803;1231;4176;345;1296;389;1227;734;2523
354200;201511;1003;2859;794;2470;122;435;330;937;452;1372
354210;201511;663;2161;570;1982;86;366;298;954;384;1320
354220;201511;2751;8091;2315;7255;531;1793;1015;3094;1546;4887
354230;201511;638;2084;571;1951;110;425;249;808;359;1233
354240;201511;1199;3854;874;3085;154;605;193;616;347;1221
354250;201511;679;1940;449;1529;159;590;118;404;277;994
354260;201511;7965;23297;6531;20814;1835;6316;2119;6607;3954;12923
354270;201511;1132;3848;946;3399;217;879;327;1098;544;1977
354280;201511;672;2029;616;1929;84;321;429;1284;513;1605
354290;201511;980;3296;875;3085;205;810;366;1269;571;2079
354300;201511;3443;11377;3306;11101;879;3044;1574;5202;2453;8246
354310;201511;874;2671;668;2249;149;539;283;933;432;1472
354320;201511;746;2185;617;1938;146;532;210;579;356;1111
354323;201511;415;1168;316;988;73;251;99;271;172;522
354325;201511;1240;4059;1011;3504;198;791;383;1222;581;2013
354330;201511;6613;19871;5351;17302;1111;3989;2532;7651;3643;11640
354340;201511;24921;76719;19926;67528;6131;22452;6846;22308;12977;44760
354350;201511;1079;3172;994;3008;291;992;472;1296;763;2288
354360;201511;470;1493;304;1097;48;180;24;90;72;270
354370;201511;1205;3985;1038;3640;128;547;617;2083;745;2630
354380;201511;928;2733;733;2376;218;838;130;328;348;1166
354390;201511;12451;37329;8468;29066;1836;6826;1798;5860;3634;12686
354400;201511;1588;5416;1251;4600;268;1091;353;1221;621;2312
354410;201511;5394;16386;4377;14499;1051;3686;1899;6220;2950;9906
354420;201511;1166;3469;865;2760;206;731;328;960;534;1691
354425;201511;2513;7042;2084;6245;645;2073;487;1367;1132;3440
354430;201511;1280;4150;1164;3899;257;979;500;1609;757;2588
354440;201511;517;1527;382;1242;49;188;170;515;219;703
354450;201511;427;1211;242;805;37;152;47;121;84;273
354460;201511;877;2408;649;2016;186;628;265;804;451;1432
354470;201511;562;1555;437;1296;49;185;218;577;267;762
354480;201511;679;1888;572;1718;92;319;329;944;421;1263
354490;201511;715;2350;529;1892;93;363;172;562;265;925
354500;201511;2068;6823;1786;6300;670;2700;292;905;962;3605
354510;201511;707;2025;634;1896;100;291;403;1234;503;1525
354515;201511;310;1024;233;840;43;182;80;257;123;439
354520;201511;7012;22650;3973;13856;806;3167;1547;4994;2353;8161
354530;201511;2871;9886;2542;9147;672;2657;1067;3696;1739;6353
354540;201511;1244;3741;1015;3322;362;1306;159;448;521;1754
354550;201511;458;1368;382;1206;66;227;195;586;261;813
354560;201511;1573;4490;1022;3250;197;613;387;1167;584;1780
354570;201511;811;2373;519;1674;83;274;83;236;166;510
354580;201511;9908;28537;7522;23857;1478;5102;3160;9455;4638;14557
354600;201511;1545;5067;1341;4646;298;1242;647;2091;945;3333
354610;201511;395;1142;231;745;31;88;52;156;83;244
354620;201511;385;1246;301;1097;77;346;134;452;211;798
354625;201511;279;896;201;715;39;145;56;186;95;331
354630;201511;2036;6826;1787;6266;715;2605;309;1002;1024;3607
354640;201511;3580;11614;2767;9777;599;2405;610;1923;1209;4328
354650;201511;906;2707;799;2498;101;354;521;1581;622;1935
354660;201511;2451;7114;1880;6085;329;1197;989;3148;1318;4345
354670;201511;1597;5148;1255;4300;321;1197;288;843;609;2040
354680;201511;4433;14467;3947;13434;1061;3890;1638;5417;2699;9307
354690;201511;774;2478;492;1745;95;343;141;478;236;821
354700;201511;1231;3436;806;2518;155;571;335;897;490;1468
354710;201511;544;1612;430;1356;62;217;189;527;251;744
354720;201511;214;581;143;437;49;141;37;112;86;253
354730;201511;7794;25428;5937;21438;1432;5639;2357;8155;3789;13794
354740;201511;243;750;142;510;25;103;29;97;54;200
354750;201511;2439;7338;1833;6216;516;1964;645;2087;1161;4051
354760;201511;1986;6273;1566;5335;455;1670;253;804;708;2474
354765;201511;231;640;136;440;12;46;16;38;28;84
354770;201511;2279;6311;1736;5381;630;2066;467;1362;1097;3428
354780;201511;46838;132223;39778;116980;7213;23842;21063;58028;28276;81870
354790;201511;799;2527;670;2290;125;482;335;1079;460;1561
354800;201511;2002;5870;1755;5523;446;1556;865;2677;1311;4233
354805;201511;959;2863;673;2223;68;237;148;445;216;682
354810;201511;596;1917;366;1326;63;276;73;199;136;475
354820;201511;986;3349;828;2997;182;786;236;751;418;1537
354830;201511;395;1097;296;914;76;249;136;376;212;625
354840;201511;656;1871;525;1631;113;375;253;765;366;1140
354850;201511;16698;51356;12194;41977;2765;10640;4664;14568;7429;25208
354860;201511;1366;4264;1150;3879;238;920;461;1457;699;2377
354870;201511;42681;127792;37829;117416;9226;30443;16198;49256;25424;79699
354880;201511;4147;11417;2318;7521;383;1436;676;1782;1059;3218
354890;201511;16116;46915;12998;41011;3242;10971;4580;13861;7822;24832
354900;201511;451;1329;324;1045;73;253;83;256;156;509
354910;201511;6552;19477;3588;12814;626;2447;218;711;844;3158
354920;201511;435;1266;295;985;61;234;74;233;135;467
354925;201511;350;1007;204;693;29;115;29;78;58;193
354930;201511;216;572;159;478;39;124;74;213;113;337
354940;201511;2034;7139;1572;5912;564;2266;197;669;761;2935
354950;201511;1482;4690;1266;4331;141;592;737;2447;878;3039
354960;201511;764;2375;661;2204;138;526;279;890;417;1416
354970;201511;4046;13064;3475;11880;637;2512;1827;5977;2464;8489
354980;201511;33494;82916;19719;59649;3787;12842;6756;18944;10543;31786
354990;201511;47591;141243;37561;120777;7132;24871;18296;56700;25428;81571
354995;201511;1742;5258;1500;4870;355;1197;771;2492;1126;3689
355000;201511;1458;4646;1261;4283;396;1547;250;716;646;2263
355010;201511;3559;10829;2769;9078;727;2524;1009;3317;1736;5841
355020;201511;2745;9167;2086;7756;841;3410;447;1562;1288;4972
355030;201511;1008303;2806732;853077;2496830;198592;629922;372285;1040774;570877;1670696
355040;201511;2621;7991;2294;7416;583;2033;1177;3709;1760;5742
355050;201511;1130;3461;897;2988;295;1016;135;445;430;1461
355060;201511;4860;16193;3858;13997;904;3683;1009;3288;1913;6971
355070;201511;6477;19896;5708;18623;1214;4581;2960;9003;4174;13584
355080;201511;1089;3697;778;2932;138;619;105;298;243;917
355090;201511;1139;3897;926;3408;175;695;375;1354;550;2049
355100;201511;18960;58443;15758;53008;4410;16296;6860;22428;11270;38724
355110;201511;1276;4125;1080;3728;308;1158;282;932;590;2090
355120;201511;605;1904;502;1689;114;464;177;526;291;990
355130;201511;602;1522;288;840;52;153;100;263;152;416
355140;201511;1098;3622;1028;3500;231;873;552;1904;783;2777
355150;201511;3330;9713;2768;8782;618;2061;1427;4537;2045;6598
355160;201511;1629;5163;1370;4750;453;1788;416;1316;869;3104
355170;201511;9488;25925;6689;21027;2049;6882;1601;5093;3650;11975
355180;201511;2849;8734;2318;7717;607;2397;740;2172;1347;4569
355190;201511;1256;4206;1054;3761;377;1446;347;1170;724;2616
355200;201511;740;2626;677;2489;275;1103;145;480;420;1583
355210;201511;2472;7916;2149;7220;423;1630;1079;3421;1502;5051
355220;201511;31558;96051;25402;83504;8618;29773;6246;19362;14864;49135
355230;201511;1394;3862;747;2417;138;452;178;512;316;964
355240;201511;26443;75423;18030;58020;3899;13524;6121;18633;10020;32157
355250;201511;24770;79812;21311;73059;6067;22257;8470;28324;14537;50581
355255;201511;814;2245;536;1654;97;322;144;403;241;725
355260;201511;1404;3950;1183;3567;275;955;491;1302;766;2257
355270;201511;1570;4581;1469;4432;117;428;1191;3531;1308;3959
355280;201511;23891;69590;19347;60594;3820;13447;8444;24917;12264;38364
355290;201511;879;2765;719;2390;142;507;273;818;415;1325
355300;201511;1101;3565;898;3130;186;707;315;1015;501;1722
355310;201511;993;2996;816;2635;142;494;419;1340;561;1834
355320;201511;612;1868;516;1652;85;338;206;547;291;885
355330;201511;1776;5482;1231;4349;269;1064;464;1564;733;2628
355340;201511;2497;6533;2237;6085;391;1107;1329;3534;1720;4641
355350;201511;1318;4438;1061;3839;267;1076;309;1022;576;2098
355360;201511;1084;3454;983;3254;156;540;670;2274;826;2814
355365;201511;253;771;188;648;39;159;54;173;93;332
355370;201511;7642;18674;5439;15896;1476;4653;2190;6653;3666;11306
355380;201511;3335;10038;2522;8148;580;2065;531;1400;1111;3465
355385;201511;839;2636;772;2529;292;1046;201;568;493;1614
355390;201511;855;2376;639;1939;134;456;266;692;400;1148
355395;201511;1854;5545;1363;4421;220;761;560;1666;780;2427
355400;201511;8765;28675;7459;25906;2248;8443;2236;7386;4484;15829
355410;201511;15600;51552;12479;44978;4021;15791;2527;9004;6548;24795
355420;201511;765;2662;694;2504;226;907;189;654;415;1561
355430;201511;3539;9878;2907;8746;573;1883;1480;4254;2053;6137
355440;201511;924;2851;694;2323;120;423;204;615;324;1038
355450;201511;3657;10418;2014;6660;384;1309;608;1851;992;3160
355460;201511;638;1713;426;1326;80;308;125;296;205;604
355465;201511;373;1156;307;1028;66;240;75;237;141;477
355470;201511;782;2429;643;2159;142;530;286;908;428;1438
355475;201511;144;514;130;475;29;109;66;237;95;346
355480;201511;2989;10667;2725;10132;709;2757;1251;4647;1960;7404
355490;201511;974;2784;631;2067;116;389;136;415;252;804
355495;201511;696;2307;608;2117;121;464;219;716;340;1180
355500;201511;7841;22359;4876;15831;830;2960;976;2811;1806;5771
355510;201511;2047;5432;1160;3611;173;651;367;997;540;1648
355520;201511;452;1089;241;669;35;122;100;246;135;368
355530;201511;389;920;157;488;19;68;28;74;47;142
355535;201511;668;2038;516;1734;154;591;120;324;274;915
355540;201511;8225;25853;7676;24908;1982;6825;3920;12323;5902;19148
355550;201511;748;2236;633;2055;143;553;290;901;433;1454
355560;201511;1276;3765;812;2701;155;602;124;289;279;891
355570;201511;199;607;131;449;18;68;21;58;39;126
355580;201511;1234;3396;846;2607;163;587;321;955;484;1542
355590;201511;227;592;180;502;24;72;106;291;130;363
355600;201511;1124;3436;926;3021;305;1079;262;798;567;1877
355610;201511;1409;3901;1182;3524;230;776;554;1579;784;2355
355620;201511;4046;12603;3162;10587;556;2132;1409;4359;1965;6491
355630;201511;3238;9222;1939;6510;385;1392;484;1525;869;2917
355635;201511;917;2976;783;2747;97;400;528;1851;625;2251
355640;201511;3030;9603;2185;7759;389;1548;307;957;696;2505
355645;201511;3186;10898;2849;10309;482;1942;1673;6013;2155;7955
355650;201511;6483;19584;5448;17588;868;3248;3221;9751;4089;12999
355660;201511;1217;3814;959;3275;198;820;382;1204;580;2024
355670;201511;2537;7842;1759;6014;340;1365;720;2152;1060;3517
355680;201511;1604;5241;1135;4057;330;1278;220;700;550;1978
355690;201511;403;1260;292;1066;183;717;23;59;206;776
355695;201511;308;943;176;581;13;40;18;34;31;74
355700;201511;5454;17997;4547;15883;1153;4247;1741;5813;2894;10060
355710;201511;10773;26510;6277;18218;1557;4827;1580;4236;3137;9063
355715;201511;263;783;161;551;37;131;31;97;68;228
355720;201511;1526;5034;1241;4363;337;1292;359;1118;696;2410
355730;201511;784;2589;642;2258;209;752;149;521;358;1273
410010;201511;1463;4495;1246;4038;268;936;291;907;559;1843
410020;201511;1200;3900;1037;3541;284;1026;402;1345;686;2371
410030;201511;1127;3828;914;3272;211;819;147;513;358;1332
410040;201511;9993;32557;8633;29829;2262;8743;2530;8369;4792;17112
410045;201511;983;2777;665;2142;157;543;159;469;316;1012
410050;201511;2435;6747;1484;4793;383;1307;128;337;511;1644
410060;201511;2212;6790;1938;6264;478;1653;805;2626;1283;4279
410070;201511;1741;4881;1316;4047;406;1373;290;781;696;2154
410080;201511;1297;3790;1036;3291;177;636;450;1321;627;1957
410090;201511;1031;3216;933;3006;237;848;300;929;537;1777
410100;201511;2627;8002;1867;6209;439;1611;198;598;637;2209
410105;201511;394;1221;250;871;46;192;36;102;82;294
410110;201511;2571;7561;2032;6475;342;1206;643;1992;985;3198
410115;201511;529;1435;407;1198;55;178;157;417;212;595
410120;201511;2420;8275;2233;7929;705;2692;871;3073;1576;5765
410130;201511;1081;3451;975;3190;384;1296;237;729;621;2025
410140;201511;16685;43702;10866;32993;2371;7929;2963;8561;5334;16490
410150;201511;17778;44192;8580;25619;1712;5526;1390;3642;3102;9168
410160;201511;2948;9009;2630;8457;711;2547;928;2973;1639;5520
410165;201511;744;2138;590;1802;137;436;241;681;378;1117
410170;201511;2171;6279;1677;5204;474;1650;318;911;792;2561
410180;201511;9919;31486;8375;27967;2108;7610;3048;9430;5156;17040
410185;201511;564;1551;440;1321;101;310;117;303;218;613
410190;201511;2041;6005;1560;4873;331;1130;285;796;616;1926
410200;201511;3883;10811;2754;8517;612;2100;348;969;960;3069
410210;201511;2554;7532;1857;5995;305;1155;422;1136;727;2291
410220;201511;643;1796;460;1431;79;294;140;403;219;697
410230;201511;1413;4410;1207;4005;312;1182;464;1454;776;2636
410240;201511;4348;13119;3887;12153;1148;4105;868;2505;2016;6610
410250;201511;2581;7132;1770;5439;439;1456;327;908;766;2364
410260;201511;1577;4719;1308;4215;324;1132;489;1513;813;2645
410270;201511;543;1519;398;1215;64;216;146;412;210;628
410275;201511;876;2617;600;2008;85;313;279;918;364;1231
410280;201511;2302;6663;1672;5338;356;1322;470;1382;826;2704
410290;201511;3420;10211;2855;9101;686;2328;1129;3583;1815;5911
410300;201511;693;1937;583;1706;93;300;252;660;345;960
410302;201511;379;1013;247;791;29;98;141;455;170;553
410304;201511;1234;3936;1105;3657;305;1058;427;1447;732;2505
410305;201511;1921;5056;1532;4426;365;1147;810;2328;1175;3475
410310;201511;2235;7207;1998;6766;449;1703;753;2533;1202;4236
410315;201511;634;1834;382;1306;72;254;109;342;181;596
410320;201511;1186;3588;694;2385;97;379;57;174;154;553
410322;201511;548;1601;336;1111;65;223;86;263;151;486
410330;201511;1383;3775;1121;3272;251;780;312;884;563;1664
410335;201511;975;2859;829;2584;163;542;319;942;482;1484
410337;201511;811;2117;583;1680;86;302;221;549;307;851
410340;201511;495;1469;328;1014;46;162;133;364;179;526
410345;201511;1713;4893;1174;3721;267;899;329;987;596;1886
410347;201511;725;1953;476;1476;72;263;147;434;219;697
410350;201511;991;2997;700;2374;147;553;111;323;258;876
410360;201511;3475;9667;2758;8389;473;1656;1269;3706;1742;5362
410370;201511;12187;35055;8524;26534;1634;5751;2403;6449;4037;12200
410380;201511;1239;3692;1094;3373;156;571;547;1605;703;2176
410390;201511;2676;7729;2026;6422;624;2129;513;1452;1137;3581
410395;201511;885;2907;776;2675;197;774;328;1100;525;1874
410400;201511;4356;13449;3638;12023;814;3064;1336;4180;2150;7244
410405;201511;925;2658;722;2256;166;576;254;786;420;1362
410410;201511;1257;4000;1198;3909;353;1372;475;1418;828;2790
410420;201511;7153;22940;5754;19642;1490;5467;924;2700;2414;8167
410425;201511;3141;9823;2152;7525;377;1401;237;748;614;2149
410430;201511;14589;39121;10373;31143;2142;7039;3101;8869;5243;15908
410440;201511;2932;9244;2586;8558;688;2532;1038;3281;1726;5813
410442;201511;2694;8952;2341;8121;727;2621;651;2245;1378;4866
410445;201511;2302;7579;1980;6954;521;2082;623;2205;1144;4287
410450;201511;2151;6049;1606;4950;447;1443;183;456;630;1899
410460;201511;2061;6023;1600;5075;407;1349;418;1229;825;2578
410465;201511;1948;6466;1602;5695;365;1429;593;1956;958;3385
410470;201511;1642;5278;1310;4503;291;1148;323;1071;614;2219
410480;201511;29714;83840;18769;60119;4072;13932;2634;7199;6706;21131
410490;201511;10738;33633;8098;27816;2003;7664;1994;6165;3997;13829
410500;201511;1546;4808;1240;4121;446;1645;283;892;729;2537
410510;201511;2480;6550;1713;4981;316;959;663;1739;979;2698
410520;201511;3133;10789;2932;10358;868;3284;1110;3911;1978;7195
410530;201511;1647;4512;1193;3549;228;769;380;1010;608;1779
410540;201511;3065;8972;2064;6813;441;1527;615;1955;1056;3482
410550;201511;6365;18190;4164;13276;781;2779;626;1741;1407;4520
410560;201511;1218;3623;917;2957;218;814;265;712;483;1526
410570;201511;2645;8343;2339;7792;653;2379;785;2807;1438;5186
410580;201511;22068;66686;17683;57662;4536;16386;4953;14778;9489;31164
410590;201511;1334;4144;778;2607;116;386;154;465;270;851
410600;201511;1843;5366;1463;4602;355;1129;550;1713;905;2842
410610;201511;760;2163;587;1815;85;293;216;642;301;935
410620;201511;1655;5670;1199;4479;334;1348;132;469;466;1817
410630;201511;2504;7329;1764;5666;428;1481;288;755;716;2236
410640;201511;4361;12053;3162;9724;819;2910;533;1498;1352;4408
410645;201511;1136;3931;1074;3836;495;1905;253;899;748;2804
410650;201511;2252;6846;1754;5768;571;1980;271;791;842;2771
410655;201511;839;2410;641;2015;130;478;211;628;341;1106
410657;201511;724;2014;495;1524;87;311;183;486;270;797
410660;201511;2541;7393;1441;4819;306;1100;160;463;466;1563
410670;201511;944;2577;622;1889;119;391;183;488;302;879
410680;201511;2776;9156;2215;7751;646;2187;670;2505;1316;4692
410685;201511;632;1804;549;1663;48;151;389;1191;437;1342
410690;201511;116091;334106;77664;251774;16954;60158;15897;45084;32851;105242
410700;201511;2254;6842;2043;6425;539;1842;844;2506;1383;4348
410710;201511;913;2705;616;2013;140;479;166;464;306;943
410712;201511;816;2458;684;2200;237;824;184;605;421;1429
410715;201511;997;3093;734;2455;137;506;251;754;388;1260
410720;201511;3345;9791;2379;7719;499;1839;551;1599;1050;3438
410725;201511;1062;3012;722;2307;111;348;109;298;220;646
410730;201511;518;1431;415;1254;123;413;106;324;229;737
410740;201511;891;2647;619;2080;100;381;267;888;367;1269
410750;201511;1820;5277;1461;4493;313;1062;467;1339;780;2401
410752;201511;309;859;168;547;36;136;60;166;96;302
410753;201511;432;1244;263;846;33;124;91;260;124;384
410754;201511;1042;3142;888;2874;70;229;580;1948;650;2177
410755;201511;805;2025;620;1727;94;303;335;889;429;1192
410760;201511;2308;6990;1986;6381;548;1932;576;1779;1124;3711
410765;201511;15662;46329;11029;36791;1962;7325;1058;3106;3020;10431
410770;201511;929;2550;670;2028;183;625;131;350;314;975
410773;201511;1305;3749;1101;3425;214;768;603;1801;817;2569
410775;201511;1517;4282;1402;4114;324;1051;579;1627;903;2678
410780;201511;516;1432;356;1128;88;281;123;439;211;720
410785;201511;718;2289;576;1929;205;739;123;395;328;1134
410790;201511;398;1265;335;1105;66;241;57;127;123;368
410800;201511;2829;7000;2120;5804;414;1308;790;1950;1204;3258
410810;201511;330;1013;263;864;52;195;102;335;154;530
410820;201511;864;2570;642;2050;158;559;109;301;267;860
410830;201511;31562;89720;24801;77601;7199;24949;7974;23718;15173;48667
410832;201511;996;2892;859;2622;102;378;479;1371;581;1749
410840;201511;6802;19959;4219;14180;936;3386;336;881;1272;4267
410845;201511;1263;3706;1053;3265;207;721;439;1287;646;2008
410850;201511;2760;8003;2428;7474;534;1844;1063;3272;1597;5116
410855;201511;605;1647;434;1281;75;239;163;434;238;673
410860;201511;3779;10533;2934;8885;553;1795;1053;3063;1606;4858
410865;201511;1520;5199;1436;5031;393;1517;758;2683;1151;4200
410870;201511;1171;3596;1083;3455;286;984;607;1924;893;2908
410880;201511;3998;12229;3136;10508;655;2418;627;1923;1282;4341
410890;201511;950;3052;728;2574;178;717;75;227;253;944
410895;201511;1104;3811;967;3476;326;1258;223;747;549;2005
410900;201511;883;2422;622;1951;107;396;206;585;313;981
410910;201511;408;1074;308;885;38;118;164;458;202;576
410920;201511;830;2313;649;1982;165;574;229;673;394;1247
410930;201511;1753;5116;1475;4581;353;1307;525;1563;878;2870
410940;201511;20640;66257;17405;60050;5238;19650;4616;15920;9854;35570
410950;201511;1765;5768;1631;5514;272;956;1075;3643;1347;4599
410960;201511;7215;19808;4464;14498;1348;4788;914;2740;2262;7528
410965;201511;1057;3164;890;2843;253;858;373;1152;626;2010
410970;201511;4483;13212;3462;11149;967;3589;660;2002;1627;5591
410975;201511;1606;4588;1262;3919;223;812;463;1368;686;2180
410980;201511;5810;16243;3437;11307;684;2495;562;1723;1246;4218
410990;201511;899;2578;535;1754;170;626;71;159;241;785
411000;201511;475;1429;344;1128;68;255;67;176;135;431
411005;201511;502;1474;302;981;78;275;34;82;112;357
411007;201511;2280;7135;1934;6355;565;1971;587;1854;1152;3825
411010;201511;3873;13141;3386;11974;884;3500;527;1660;1411;5160
411020;201511;2505;7709;2187;7163;699;2564;667;2087;1366;4651
411030;201511;689;1860;487;1452;88;290;130;337;218;627
411040;201511;647;1869;290;962;49;173;67;224;116;397
411050;201511;2094;7232;1840;6647;518;2072;278;877;796;2949
411060;201511;1561;4755;1249;4057;255;926;181;511;436;1437
411065;201511;362;1071;274;891;53;180;92;285;145;465
411070;201511;5734;17118;4258;14016;1182;4285;798;2335;1980;6620
411080;201511;2173;6420;1886;5854;470;1643;449;1247;919;2890
411090;201511;803;1967;559;1591;76;275;127;323;203;598
411095;201511;1439;4117;1063;3302;173;626;279;747;452;1373
411100;201511;1359;3941;965;3110;159;615;153;416;312;1031
411110;201511;573;1679;306;1032;39;149;38;93;77;242
411120;201511;1659;4945;1204;3937;308;1133;386;1162;694;2295
411125;201511;4218;13689;3975;13175;1150;4041;1532;4946;2682;8987
411130;201511;720;2121;538;1717;128;440;151;504;279;944
411140;201511;2108;7345;1783;6555;559;2146;557;2104;1116;4250
411150;201511;4397;12161;3301;9900;750;2480;594;1456;1344;3936
411155;201511;961;2605;713;2108;112;385;328;907;440;1292
411160;201511;223;641;178;552;37;124;44;115;81;239
411170;201511;668;2125;549;1844;133;500;182;573;315;1073
411180;201511;5656;16778;4556;14669;1052;3788;1500;4715;2552;8503
411190;201511;1489;4207;1207;3639;293;1025;324;829;617;1854
411200;201511;4270;12548;3377;10965;842;3081;1117;3428;1959;6509
411210;201511;2044;5862;1572;4939;447;1523;195;545;642;2068
411220;201511;1164;3280;896;2747;225;808;319;838;544;1646
411230;201511;1259;3469;779;2484;185;642;222;631;407;1273
411240;201511;1372;3294;725;2161;138;415;222;607;360;1022
411250;201511;2312;6714;1881;5900;511;1766;500;1509;1011;3275
411260;201511;302;835;201;653;28;100;77;233;105;333
411270;201511;1795;5598;1570;5159;299;1138;708;2200;1007;3338
411275;201511;1366;4042;1113;3454;282;929;248;699;530;1628
411280;201511;1515;4444;1040;3397;186;685;205;591;391;1276
411290;201511;781;2223;585;1782;149;490;178;497;327;987
411295;201511;966;2710;859;2491;163;497;329;982;492;1479
411300;201511;1338;3398;920;2568;100;313;363;932;463;1245
411310;201511;855;2333;659;1992;80;283;213;632;293;915
411320;201511;5588;16109;4004;12927;1043;3551;734;2135;1777;5686
411325;201511;1529;4790;1326;4362;277;987;673;2202;950;3189
411330;201511;3115;9592;2601;8574;860;3172;645;2071;1505;5243
411340;201511;925;2723;574;1872;69;259;208;631;277;890
411342;201511;728;2054;589;1774;159;517;190;504;349;1021
411345;201511;977;2994;862;2769;231;831;373;1168;604;1999
411350;201511;2771;8089;1924;6349;502;1848;218;652;720;2500
411360;201511;559;1397;371;1065;45;165;167;410;212;575
411370;201511;46798;130927;34952;108506;6097;21769;13397;38233;19494;60002
411373;201511;1410;4395;1173;3909;259;972;257;852;516;1824
411375;201511;1111;3034;788;2385;162;505;194;539;356;1044
411380;201511;1281;3443;731;2193;119;369;208;565;327;934
411390;201511;1828;5360;1504;4693;309;1083;482;1373;791;2456
411400;201511;2064;5892;1487;4619;271;933;386;1107;657;2040
411410;201511;2094;6261;1566;5003;343;1249;415;1101;758;2350
411420;201511;4106;11730;2788;8688;450;1574;460;1137;910;2711
411430;201511;3125;9505;2579;8550;698;2541;1121;3619;1819;6160
411435;201511;447;1450;363;1231;85;317;145;459;230;776
411440;201511;2629;8445;2330;7810;765;2720;557;1954;1322;4674
411450;201511;2246;6816;2005;6352;415;1344;1035;3366;1450;4710
411460;201511;3156;9245;1607;5586;299;1146;84;277;383;1423
411470;201511;862;2559;561;1826;80;274;92;247;172;521
411480;201511;4478;13296;3278;10916;856;3171;556;1665;1412;4836
411490;201511;1472;4405;1215;3933;272;982;297;829;569;1811
411500;201511;1865;4974;1290;3932;270;904;346;1010;616;1914
411510;201511;2048;6061;1640;5213;463;1626;301;805;764;2431
411520;201511;26191;70962;15077;47192;2892;9801;3090;8837;5982;18638
411530;201511;1023;2856;699;2246;171;619;111;295;282;914
411535;201511;525;1576;250;905;36;146;27;82;63;228
411540;201511;3059;8207;2194;6480;542;1836;615;1607;1157;3443
411545;201511;964;3196;869;3014;158;588;545;1913;703;2501
411550;201511;798;2152;637;1898;224;735;133;385;357;1120
411560;201511;2472;7273;1764;5619;323;1148;272;690;595;1838
411570;201511;6690;17863;4825;14763;1204;4177;1064;3236;2268;7413
411573;201511;878;2591;820;2488;146;471;496;1516;642;1987
411575;201511;1522;4699;1266;4131;244;848;463;1470;707;2318
411580;201511;4009;11344;2586;8343;382;1428;404;1091;786;2519
411585;201511;696;2253;375;1313;80;298;65;205;145;503
411590;201511;385;1129;327;1034;56;199;141;409;197;608
411600;201511;305;877;209;710;46;183;78;263;124;446
411605;201511;1942;5128;1259;3764;197;677;484;1363;681;2040
411610;201511;2143;5893;1792;5306;346;1128;933;2640;1279;3768
411620;201511;2698;8468;2461;8059;691;2454;1080;3557;1771;6011
411630;201511;475;1227;284;930;55;221;43;119;98;340
411640;201511;497;1461;374;1190;61;204;131;365;192;569
411650;201511;201;644;160;563;33;138;46;143;79;281
411660;201511;826;2261;634;1885;118;384;276;798;394;1182
411670;201511;1223;3375;979;2845;219;701;349;946;568;1647
411680;201511;1438;4345;1280;4052;200;665;805;2626;1005;3291
411690;201511;3269;9566;2544;8153;669;2252;540;1747;1209;3999
411695;201511;794;2566;633;2207;146;557;192;665;338;1222
411700;201511;1770;5094;1212;3910;231;829;226;620;457;1449
411705;201511;2034;6914;1772;6379;397;1415;898;3379;1295;4794
411710;201511;1752;5078;1353;4232;325;1087;283;825;608;1912
411720;201511;843;2385;632;1931;93;308;181;497;274;805
411721;201511;703;2100;592;1882;163;563;73;206;236;769
411722;201511;661;1941;439;1427;85;325;120;318;205;643
411725;201511;1379;4411;845;3011;194;722;159;544;353;1266
411727;201511;1895;5481;1426;4448;346;1189;374;1040;720;2229
411729;201511;553;1478;393;1181;127;385;67;177;194;562
411730;201511;5513;15775;4529;13846;1723;5364;1116;3352;2839;8716
411740;201511;638;1810;417;1299;71;241;144;424;215;665
411745;201511;887;2553;712;2192;137;452;238;720;375;1172
411750;201511;4669;13880;3464;11099;767;2718;892;2692;1659;5410
411760;201511;7893;22786;6700;20656;2139;7157;1741;5200;3880;12357
411770;201511;3392;11233;2755;9697;835;3181;515;1715;1350;4896
411780;201511;2597;8171;2435;7923;316;1135;1569;5264;1885;6399
411790;201511;3151;8915;2214;6948;596;2128;553;1635;1149;3763
411800;201511;1226;3491;800;2582;117;429;149;399;266;828
411810;201511;1597;4638;1313;4068;275;943;438;1227;713;2170
411820;201511;14025;44635;11544;39466;4026;14252;2742;9493;6768;23745
411830;201511;498;1321;379;1113;127;418;8;36;135;454
411840;201511;10409;29715;7481;23904;1765;6139;1447;4442;3212;10581
411845;201511;528;1602;329;1088;53;188;61;170;114;358
411850;201511;6585;19747;5238;16859;1316;4563;1317;4152;2633;8715
411860;201511;886;2723;707;2335;175;616;225;705;400;1321
411870;201511;848;2794;574;2029;108;448;113;344;221;792
411880;201511;2254;6455;1803;5627;431;1561;441;1232;872;2793
411885;201511;906;2438;720;2085;135;496;249;629;384;1125
411890;201511;1089;3284;666;2220;104;396;84;208;188;604
411900;201511;977;3088;679;2338;167;587;96;326;263;913
411910;201511;1261;4126;984;3452;285;1082;242;753;527;1835
411915;201511;15401;42416;9575;30372;1863;6398;2023;5784;3886;12182
411920;201511;864;2892;734;2565;184;778;108;278;292;1056
411925;201511;597;1673;382;1249;92;301;94;280;186;581
411930;201511;5992;19379;5190;17801;2235;8168;924;3030;3159;11198
411940;201511;3247;10770;2771;9701;689;2539;641;2138;1330;4677
411950;201511;11739;36990;9691;32924;2444;8933;4152;13838;6596;22771
411960;201511;5267;15627;4792;14728;1129;3849;1945;5811;3074;9660
411965;201511;606;1721;438;1430;84;329;146;485;230;814
411970;201511;749;2075;599;1838;196;656;189;602;385;1258
411980;201511;1628;4911;1376;4391;288;972;465;1486;753;2458
411990;201511;28787;92709;23627;81398;6232;23653;6508;21513;12740;45166
411995;201511;2564;7801;2152;6997;681;2483;508;1496;1189;3979
412000;201511;2255;5827;1753;4953;269;910;860;2168;1129;3078
412010;201511;707;2398;555;2037;99;379;124;428;223;807
412015;201511;656;1938;511;1622;112;381;237;748;349;1129
412020;201511;394;1121;263;829;51;181;97;273;148;454
412030;201511;703;2213;473;1653;74;287;120;386;194;673
412033;201511;742;2176;495;1572;78;279;128;370;206;649
412035;201511;1007;2779;673;2151;151;518;238;735;389;1253
412040;201511;607;1890;469;1575;99;361;138;424;237;785
412050;201511;1676;4842;1261;4013;224;800;283;850;507;1650
412060;201511;6838;23317;6121;21770;1944;7451;1730;6041;3674;13492
412065;201511;891;2631;682;2167;147;521;197;548;344;1069
412070;201511;1305;3501;963;2777;164;507;329;921;493;1428
412080;201511;1367;4231;779;2799;106;437;32;69;138;506
412085;201511;410;1189;137;480;38;142;28;84;66;226
412090;201511;4298;13531;4018;13010;687;2428;2338;7634;3025;10062
412100;201511;1928;5972;1588;5266;450;1638;426;1352;876;2990
412110;201511;1087;3065;709;2245;160;548;160;485;320;1033
412120;201511;1838;6185;1570;5540;423;1674;537;1685;960;3359
412125;201511;701;2198;615;2028;130;474;239;739;369;1213
412130;201511;611;1807;437;1402;108;380;71;201;179;581
412135;201511;504;1406;333;1057;75;251;114;340;189;591
412140;201511;1577;4717;1268;4058;295;994;254;754;549;1748
412150;201511;2809;8121;2405;7304;296;1046;1469;4335;1765;5381
412160;201511;1112;3530;679;2404;167;633;83;249;250;882
412170;201511;4462;13707;3550;11863;944;3436;1244;3912;2188;7348
412175;201511;1361;4578;1157;4105;287;1127;458;1596;745;2723
412180;201511;1661;5112;1211;4206;292;1157;326;1051;618;2208
412190;201511;3171;9010;2347;7505;551;1947;658;2179;1209;4126
412200;201511;2232;7082;1521;5221;314;1164;468;1583;782;2747
412210;201511;726;1979;402;1291;59;208;45;120;104;328
412215;201511;3750;11421;3363;10730;733;2340;1880;6193;2613;8533
412217;201511;1103;3100;970;2864;118;438;644;1761;762;2199
412220;201511;5565;18188;5263;17588;1556;5338;2536;8482;4092;13820
412230;201511;2756;9016;2343;8176;511;2017;677;2169;1188;4186
412240;201511;9507;24491;5258;16279;947;3268;945;2550;1892;5818
412250;201511;1918;5568;1617;4943;403;1336;312;823;715;2159
412260;201511;1353;3707;833;2567;117;413;291;799;408;1212
412265;201511;1046;3181;919;2961;222;825;404;1283;626;2108
412270;201511;822;2582;530;1829;104;396;142;456;246;852
412280;201511;612;1897;435;1506;186;693;36;111;222;804
412290;201511;1025;2935;782;2440;147;492;255;724;402;1216
412300;201511;1892;5686;1544;4977;412;1478;327;989;739;2467
412310;201511;1054;3018;922;2816;130;462;477;1480;607;1942
412320;201511;820;2201;569;1749;111;395;186;555;297;950
412330;201511;1575;4443;1188;3624;201;688;578;1716;779;2404
412340;201511;920;2856;578;1954;75;280;87;247;162;527
412350;201511;2292;7103;1809;5983;387;1382;174;456;561;1838
412360;201511;290;861;178;574;23;89;60;161;83;250
412370;201511;919;2699;688;2263;167;610;156;478;323;1088
412380;201511;1590;5021;1307;4317;314;1109;362;1138;676;2247
412382;201511;678;1908;455;1429;88;287;101;272;189;559
412385;201511;2426;7520;2110;6794;685;2316;460;1410;1145;3726
412390;201511;2139;6102;1915;5726;483;1592;735;2231;1218;3823
412395;201511;849;2400;665;2083;88;306;379;1154;467;1460
412400;201511;937;2944;800;2641;225;797;195;642;420;1439
412402;201511;1934;5734;1524;4851;360;1281;340;936;700;2217
412405;201511;3705;10670;2210;7256;369;1384;209;572;578;1956
412410;201511;4681;14382;3833;12689;1111;4297;728;2181;1839;6478
412420;201511;363;1038;246;769;42;139;86;220;128;359
412430;201511;555;1539;404;1233;61;206;158;446;219;652
412440;201511;3404;10190;2703;8895;612;2222;876;2840;1488;5062
412450;201511;317;1013;233;792;35;114;21;48;56;162
412460;201511;799;2389;602;1963;145;529;126;366;271;895
412470;201511;1886;6418;1597;5643;520;1942;377;1374;897;3316
412480;201511;1320;3837;869;2830;155;523;112;283;267;806
412490;201511;877;2569;737;2274;142;452;215;625;357;1077
412500;201511;1970;5656;1615;4952;317;1096;396;1050;713;2146
412510;201511;2256;7358;1859;6376;523;1933;670;2255;1193;4188
412520;201511;1493;4170;1088;3300;249;808;236;638;485;1446
412530;201511;644;1866;489;1499;101;323;117;317;218;640
412535;201511;666;1956;419;1346;90;312;94;277;184;589
412540;201511;1213;3511;938;2947;141;511;273;840;414;1351
412545;201511;806;2301;597;1806;95;340;193;489;288;829
412550;201511;28095;84009;18374;61642;4526;16106;3306;10364;7832;26470
412555;201511;304;906;205;675;39;141;47;131;86;272
412560;201511;5196;16008;3943;13275;864;3383;948;2940;1812;6323
412570;201511;4387;12861;2937;9604;679;2484;547;1728;1226;4212
412575;201511;875;2666;661;2142;152;556;170;489;322;1045
412580;201511;1258;3462;877;2719;162;521;267;778;429;1299
412590;201511;409;1192;266;872;56;214;76;236;132;450
412600;201511;1449;4338;1093;3537;227;819;319;934;546;1753
412610;201511;731;2159;481;1522;117;408;137;385;254;793
412620;201511;1209;3833;930;3210;223;867;140;408;363;1275
412625;201511;10795;30094;7867;24287;1737;5785;1315;3611;3052;9396
412627;201511;925;2857;632;2167;178;653;63;190;241;843
412630;201511;3318;10470;2656;8981;575;1989;775;2487;1350;4476
412635;201511;474;1414;307;1028;80;270;14;32;94;302
412640;201511;910;2715;584;1920;92;307;52;139;144;446
412650;201511;1813;5313;1487;4657;312;1137;466;1242;778;2379
412660;201511;2853;8247;2155;6765;419;1451;405;1139;824;2590
412665;201511;636;1654;340;1067;90;287;63;191;153;478
412667;201511;1642;4796;1269;4033;308;1055;222;628;530;1683
412670;201511;546;1696;389;1321;103;398;68;188;171;586
412680;201511;1363;4076;835;2851;142;528;196;577;338;1105
412690;201511;766;2318;556;1844;164;569;108;353;272;922
412700;201511;1867;5694;1553;5196;519;1976;411;1315;930;3291
412710;201511;7590;23365;6062;20112;1311;4898;1367;4111;2678;9009
412720;201511;1419;4355;954;3155;157;561;177;473;334;1034
412730;201511;2209;6502;1312;4397;255;947;161;393;416;1340
412740;201511;1450;4524;1074;3686;248;946;195;665;443;1611
412750;201511;3872;11929;3410;11124;541;2134;2007;6301;2548;8435
412760;201511;2271;7318;2129;7060;464;1781;1128;3562;1592;5343
412770;201511;11264;30802;6142;19570;935;3272;1102;2995;2037;6267
412780;201511;1295;4062;1103;3652;257;920;385;1206;642;2126
412785;201511;2338;6673;1714;5374;464;1542;718;2234;1182;3776
412788;201511;1397;4407;1210;4005;261;1003;414;1212;675;2215
412790;201511;1168;3428;853;2762;169;620;183;489;352;1109
412795;201511;921;2561;743;2215;165;512;266;782;431;1294
412796;201511;2742;8420;2477;7878;627;2244;914;2674;1541;4918
412800;201511;3135;8897;2350;7242;403;1385;795;2324;1198;3709
412810;201511;10994;29907;6004;18880;862;3010;1289;3333;2151;6343
412820;201511;7111;20779;5089;16722;1170;4122;1112;3682;2282;7804
412830;201511;352;1078;271;880;42;163;85;240;127;403
412840;201511;1870;5301;1471;4463;269;902;306;842;575;1744
412850;201511;2769;8163;2279;7317;462;1733;837;2497;1299;4230
412853;201511;1690;4816;1471;4366;154;563;805;2196;959;2759
412855;201511;1497;4268;1137;3469;255;857;296;775;551;1632
412860;201511;1230;3508;995;3067;253;872;398;1185;651;2057
412862;201511;768;1979;510;1473;83;260;171;447;254;707
412863;201511;1186;4006;1145;3935;181;690;770;2585;951;3275
412865;201511;697;2106;511;1677;124;424;171;577;295;1001
412870;201511;901;2509;706;2171;250;849;118;308;368;1157
412880;201511;965;2725;727;2273;170;571;147;393;317;964
420005;201511;551;1635;341;1138;56;193;126;409;182;602
420010;201511;3135;8946;2553;8109;384;1264;1722;5554;2106;6818
420020;201511;744;2417;390;1454;41;189;32;100;73;289
420030;201511;526;1378;259;862;52;206;43;131;95;337
420040;201511;763;2369;470;1724;101;404;59;144;160;548
420050;201511;681;2006;463;1532;140;486;157;508;297;994
420055;201511;217;656;123;431;21;82;24;72;45;154
420060;201511;242;796;151;562;29;128;29;85;58;213
420070;201511;1436;4482;1069;3581;175;666;452;1482;627;2148
420075;201511;193;534;97;316;19;65;23;66;42;131
420080;201511;606;1887;469;1611;152;559;114;384;266;943
420090;201511;510;1713;345;1327;85;352;56;225;141;577
420100;201511;1220;3808;1087;3621;249;878;611;2033;860;2911
420110;201511;362;1205;316;1098;75;275;124;418;199;693
420120;201511;290;995;238;877;79;326;46;154;125;480
420125;201511;265;1000;238;937;71;294;92;325;163;619
420127;201511;557;1650;213;782;58;223;30;103;88;326
420130;201511;1862;6173;1490;5398;355;1416;393;1245;748;2661
420140;201511;4893;14287;3303;11108;771;2868;551;1617;1322;4485
420150;201511;766;2116;449;1466;92;328;152;452;244;780
420160;201511;294;810;179;576;26;87;53;162;79;249
420165;201511;215;673;126;440;24;89;28;85;52;174
420170;201511;205;622;131;464;46;193;16;35;62;228
420180;201511;427;1305;232;841;43;164;44;156;87;320
420190;201511;478;1386;231;813;38;151;35;101;73;252
420195;201511;1366;3934;1066;3422;262;883;355;1112;617;1995
420200;201511;2959;9416;1786;6644;455;1926;275;883;730;2809
420205;201511;963;3086;823;2846;192;712;409;1420;601;2132
420207;201511;1566;4573;1069;3524;297;1108;234;695;531;1803
420208;201511;574;1600;317;1119;106;403;97;341;203;744
420209;201511;328;1010;202;705;39;156;71;234;110;390
420210;201511;1658;5048;1074;4011;262;1175;314;1090;576;2265
420213;201511;812;2887;762;2758;158;612;447;1629;605;2241
420215;201511;389;1262;255;922;64;259;37;118;101;377
420220;201511;185;622;152;553;34;143;50;145;84;288
420230;201511;4312;12537;3084;10248;619;2454;1314;4125;1933;6579
420240;201511;11327;30508;6741;21829;1092;4332;2792;7879;3884;12211
420243;201511;622;1886;489;1610;96;351;170;531;266;882
420245;201511;1156;3466;766;2624;140;532;220;674;360;1206
420250;201511;595;1873;541;1770;155;615;224;678;379;1293
420253;201511;540;1435;422;1271;69;218;234;729;303;947
420257;201511;338;953;216;723;37;128;106;351;143;479
420260;201511;1282;4022;1060;3611;223;859;444;1482;667;2341
420270;201511;556;1701;172;620;29;118;41;131;70;249
420280;201511;2350;6267;1405;4517;284;1049;491;1423;775;2472
420285;201511;143;428;58;216;7;32;2;9;9;41
420287;201511;553;1631;453;1454;139;448;141;459;280;907
420290;201511;6726;19755;4235;13986;822;2959;1196;3586;2018;6545
420300;201511;6708;20219;4212;14711;916;3474;710;2405;1626;5879
420310;201511;804;2233;722;2105;117;374;499;1410;616;1784
420315;201511;984;3100;762;2641;208;806;270;895;478;1701
420320;201511;4931;15014;3923;13147;1047;3824;1514;4975;2561;8799
420325;201511;274;901;252;846;53;209;105;326;158;535
420330;201511;1040;3545;752;2791;183;775;194;599;377;1374
420340;201511;1487;4547;1083;3602;231;862;151;402;382;1264
420350;201511;1522;4497;1133;3731;285;1005;410;1307;695;2312
420360;201511;3257;9810;2014;7010;451;1788;238;646;689;2434
420370;201511;1962;5445;1516;4630;175;552;1121;3371;1296;3923
420380;201511;5316;16509;3571;12378;855;3262;817;2715;1672;5977
420390;201511;1646;4601;831;2832;153;614;174;454;327;1068
420395;201511;1541;4694;1018;3477;158;618;175;487;333;1105
420400;201511;1336;3832;898;2946;230;882;215;603;445;1485
420410;201511;794;2115;539;1692;123;430;301;922;424;1352
420415;201511;472;1468;339;1147;101;358;92;292;193;650
420417;201511;744;2364;613;2039;98;345;322;1071;420;1416
420419;201511;403;1222;251;904;93;373;33;113;126;486
420420;201511;11137;33246;8640;28233;2761;10035;2171;6303;4932;16338
420425;201511;1342;3630;840;2614;82;324;358;1017;440;1341
420430;201511;3386;10200;2119;7235;461;1730;695;2321;1156;4051
420435;201511;307;902;182;623;39;149;73;232;112;381
420440;201511;994;3041;580;1976;225;824;103;325;328;1149
420445;201511;380;1130;267;860;52;165;116;377;168;542
420450;201511;864;2568;535;1819;118;443;129;372;247;815
420455;201511;1995;5910;1695;5376;311;1204;784;2340;1095;3544
420460;201511;8931;25811;6498;21371;1455;5540;2417;7456;3872;12996
420470;201511;1134;3057;700;2191;159;571;193;532;352;1103
420475;201511;127;371;63;215;17;58;11;32;28;90
420480;201511;4810;13967;3485;11346;1065;3821;603;1855;1668;5676
420490;201511;710;1852;382;1277;98;359;97;296;195;655
420500;201511;1689;5273;1271;4434;386;1515;468;1536;854;3051
420510;201511;109;428;95;398;37;157;35;137;72;294
420515;201511;117;394;94;347;15;67;16;59;31;126
420517;201511;926;2814;785;2551;129;471;407;1253;536;1724
420519;201511;547;1435;376;1127;59;190;109;307;168;497
420520;201511;676;1671;421;1304;86;286;154;402;240;688
420530;201511;1103;3603;804;2884;190;784;198;584;388;1368
420535;201511;258;747;125;446;29;119;6;17;35;136
420540;201511;21401;60897;14804;46538;3681;12676;4024;11014;7705;23690
420543;201511;413;1075;304;894;27;91;195;613;222;704
420545;201511;1621;5061;1271;4280;296;1128;409;1238;705;2366
420550;201511;4237;13351;3074;10781;743;3098;632;1878;1375;4976
420555;201511;406;1230;312;1031;81;294;104;317;185;611
420560;201511;564;1613;437;1383;81;281;207;635;288;916
420570;201511;2109;6712;1600;5510;416;1645;511;1603;927;3248
420580;201511;1367;4220;1069;3685;266;1034;437;1454;703;2488
420590;201511;3331;10029;2123;7164;428;1581;332;952;760;2533
420600;201511;839;2733;754;2553;123;445;408;1428;531;1873
420610;201511;539;1653;300;1100;78;324;74;259;152;583
420620;201511;779;2315;642;2066;193;667;183;569;376;1236
420630;201511;1059;3246;721;2448;154;549;233;697;387;1246
420640;201511;766;2328;361;1336;82;337;27;83;109;420
420650;201511;2563;7387;1515;5132;270;1048;347;1012;617;2060
420660;201511;487;1407;382;1201;66;238;176;531;242;769
420665;201511;731;2025;450;1466;74;256;131;368;205;624
420670;201511;1703;5035;1154;3846;220;866;290;841;510;1707
420675;201511;210;645;142;485;27;99;45;141;72;240
420680;201511;522;1238;302;897;52;175;99;269;151;444
420690;201511;911;3116;637;2335;108;425;148;494;256;919
420700;201511;3743;10681;2773;8704;604;2196;841;2438;1445;4634
420710;201511;594;1964;451;1665;128;525;143;489;271;1014
420720;201511;1719;4896;1331;4362;343;1195;724;2375;1067;3570
420730;201511;3390;10062;2715;8820;679;2434;1048;3224;1727;5658
420740;201511;867;2649;702;2326;219;798;288;879;507;1677
420750;201511;2424;7644;1617;5692;278;1158;484;1464;762;2622
420757;201511;105;257;49;167;7;31;24;81;31;112
420760;201511;368;1127;215;702;45;175;56;146;101;321
420765;201511;589;1825;293;1074;57;243;55;172;112;415
420768;201511;1173;4056;895;3429;302;1201;291;1103;593;2304
420770;201511;679;1941;352;1236;79;331;83;264;162;595
420775;201511;673;2041;387;1323;94;342;73;219;167;561
420780;201511;1600;4794;931;3105;201;692;169;503;370;1195
420785;201511;310;924;219;692;32;110;55;152;87;262
420790;201511;1291;4383;992;3655;282;1153;366;1256;648;2409
420800;201511;852;2425;425;1413;104;390;103;315;207;705
420810;201511;2205;7443;1683;6194;503;2092;379;1253;882;3345
420820;201511;8324;24903;5593;20026;1450;5925;1417;4866;2867;10791
420830;201511;2705;8507;2212;7573;699;2622;752;2495;1451;5117
420840;201511;1098;3239;554;1996;129;525;114;348;243;873
420845;201511;1327;3993;935;3251;257;1049;222;679;479;1728
420850;201511;1685;5247;965;3645;232;1006;94;308;326;1314
420860;201511;475;1315;288;950;74;286;99;311;173;597
420870;201511;1167;3236;894;2788;290;1054;262;698;552;1752
420880;201511;1075;3500;798;2772;171;663;168;504;339;1167
420890;201511;13018;32166;5548;17759;972;3438;1365;3634;2337;7072
420895;201511;247;676;127;412;39;124;13;36;52;160
420900;201511;2107;5787;1207;3999;252;981;303;880;555;1861
420910;201511;23068;68515;14730;51063;2915;11407;4063;12928;6978;24335
420915;201511;581;2251;427;1786;93;414;193;752;286;1166
420917;201511;470;1436;215;692;46;181;87;226;133;407
420920;201511;189;520;75;253;13;48;15;49;28;97
420930;201511;19029;54169;14555;46406;3420;12077;5061;15446;8481;27523
420940;201511;3266;9728;2491;8073;670;2454;384;949;1054;3403
420945;201511;210;666;134;486;24;110;36;121;60;231
420950;201511;626;1754;280;1039;41;198;43;134;84;332
420960;201511;984;2751;776;2386;167;584;347;991;514;1575
420970;201511;2566;7959;2096;7077;600;2294;622;1966;1222;4260
420980;201511;473;1362;343;1143;114;417;118;427;232;844
420985;201511;516;1471;244;873;52;225;57;174;109;399
420990;201511;924;2521;505;1716;98;373;127;367;225;740
421000;201511;614;2061;386;1455;84;333;68;209;152;542
421003;201511;719;1951;258;865;28;95;40;84;68;179
421005;201511;192;583;148;508;30;117;81;276;111;393
421010;201511;5817;16548;3944;13069;1024;3823;907;2631;1931;6454
421020;201511;484;1502;362;1266;47;169;196;708;243;877
421030;201511;827;3000;756;2816;216;867;142;508;358;1375
421040;201511;794;2153;571;1790;115;417;279;825;394;1242
421050;201511;1691;4726;977;3199;198;724;227;616;425;1340
421055;201511;222;635;122;389;27;92;31;81;58;173
421060;201511;528;1778;347;1275;78;322;117;408;195;730
421070;201511;752;2380;461;1649;103;424;96;307;199;731
421080;201511;552;1624;462;1482;94;306;285;912;379;1218
421085;201511;580;1526;297;1011;64;246;83;293;147;539
421090;201511;405;1127;214;703;34;122;84;239;118;361
421100;201511;870;2431;482;1560;145;482;81;238;226;720
421105;201511;1505;4579;1225;4080;280;999;451;1521;731;2520
421110;201511;1052;3775;946;3518;333;1327;212;712;545;2039
421120;201511;1460;4588;958;3326;163;669;282;835;445;1504
421125;201511;421;1178;304;968;85;316;98;270;183;586
421130;201511;3348;10792;2765;9708;890;3512;927;3180;1817;6692
421140;201511;356;1038;262;827;50;161;91;260;141;421
421145;201511;584;1834;373;1255;55;204;127;399;182;603
421150;201511;547;1636;386;1344;75;288;155;529;230;817
421160;201511;1280;3560;616;2062;117;439;214;677;331;1116
421165;201511;291;996;221;785;34;123;106;378;140;501
421170;201511;1412;4103;1118;3609;227;800;652;2084;879;2884
421175;201511;1251;3500;903;2920;205;828;312;867;517;1695
421180;201511;607;1675;313;1046;70;269;70;197;140;466
421185;201511;408;1124;278;873;54;157;134;440;188;597
421187;201511;295;875;215;703;38;134;97;293;135;427
421189;201511;427;1294;366;1172;72;245;127;373;199;618
421190;201511;11931;34165;6993;23788;1506;5603;1252;3862;2758;9465
421200;201511;946;3083;788;2732;178;685;230;709;408;1394
421205;201511;257;780;182;633;40;163;39;108;79;271
421210;201511;1676;5029;1215;3902;314;1066;317;958;631;2024
421220;201511;2059;6884;1745;6170;508;2006;343;1078;851;3084
421223;201511;625;1915;461;1585;117;435;159;513;276;948
421225;201511;1119;3501;920;3096;215;818;329;1077;544;1895
421227;201511;866;2775;760;2602;160;595;452;1514;612;2109
421230;201511;488;1556;428;1440;104;403;205;638;309;1041
421240;201511;459;1474;256;908;37;163;45;135;82;298
421250;201511;1868;5351;1164;4061;322;1224;267;883;589;2107
421260;201511;370;1036;96;352;20;72;24;81;44;153
421265;201511;653;2061;558;1883;125;459;237;779;362;1238
421270;201511;814;2185;398;1319;90;317;83;299;173;616
421280;201511;1626;5045;1277;4456;380;1490;420;1389;800;2879
421290;201511;1597;4186;790;2565;155;542;136;381;291;923
421300;201511;311;941;245;801;70;262;95;289;165;551
421310;201511;274;856;213;703;45;154;79;243;124;397
421315;201511;395;1168;217;781;44;161;18;66;62;227
421320;201511;577;1846;363;1284;58;210;49;116;107;326
421330;201511;579;1867;439;1595;137;576;78;262;215;838
421335;201511;567;1840;445;1593;109;440;86;313;195;753
421340;201511;1785;5091;1426;4508;205;797;844;2604;1049;3401
421350;201511;968;3156;773;2724;161;671;310;997;471;1668
421360;201511;3170;9042;1955;6649;400;1567;552;1685;952;3252
421370;201511;772;2541;597;2148;173;705;182;608;355;1313
421380;201511;1007;2839;792;2414;144;502;372;1105;516;1607
421390;201511;147;431;77;264;11;34;37;134;48;168
421400;201511;252;876;187;728;46;189;61;220;107;409
421410;201511;323;928;217;710;30;100;107;342;137;442
421415;201511;365;1196;161;588;40;163;34;102;74;265
421420;201511;929;2790;651;2144;131;466;194;567;325;1033
421430;201511;244;753;178;621;35;135;38;128;73;263
421440;201511;882;2510;564;1923;139;535;233;751;372;1286
421450;201511;489;1511;300;1114;71;293;31;117;102;410
421460;201511;635;1714;310;1088;50;214;71;231;121;445
421470;201511;452;1510;356;1291;100;390;119;416;219;806
421480;201511;2987;8491;1765;6153;391;1594;345;997;736;2591
421490;201511;287;867;124;467;31;130;25;80;56;210
421500;201511;2345;7861;1908;6901;622;2540;330;1068;952;3608
421505;201511;379;1255;331;1147;69;258;159;539;228;797
421507;201511;573;1725;358;1240;72;261;111;383;183;644
421510;201511;188;613;160;563;30;137;80;236;110;373
421520;201511;860;2283;548;1638;55;202;248;652;303;854
421530;201511;410;1257;235;861;37;173;74;257;111;430
421535;201511;726;2127;402;1438;73;300;171;557;244;857
421540;201511;372;1015;297;876;62;198;120;329;182;527
421545;201511;933;3011;663;2455;168;707;171;591;339;1298
421550;201511;1995;6344;1652;5704;475;1859;466;1470;941;3329
421555;201511;340;1020;117;423;18;66;16;57;34;123
421560;201511;193;587;78;274;19;72;19;66;38;138
421565;201511;969;2836;849;2652;298;1050;339;1020;637;2070
421567;201511;774;2796;665;2530;332;1315;144;526;476;1841
421568;201511;521;1609;347;1194;78;266;79;279;157;545
421569;201511;233;697;109;395;24;100;23;72;47;172
421570;201511;1379;4157;711;2508;195;768;125;407;320;1175
421575;201511;479;1566;411;1423;68;254;253;873;321;1127
421580;201511;3447;10687;2520;8591;631;2457;620;1802;1251;4259
421590;201511;232;722;183;624;26;89;95;319;121;408
421600;201511;598;1780;443;1449;116;414;91;256;207;670
421605;201511;626;1883;443;1523;82;332;112;339;194;671
421610;201511;1477;3960;1131;3370;169;578;618;1752;787;2330
421620;201511;4721;14164;3109;10731;885;3258;919;3118;1804;6376
421625;201511;397;1111;155;533;27;97;27;89;54;186
421630;201511;2946;8762;1562;5369;375;1429;211;621;586;2050
421635;201511;271;804;153;504;21;80;69;203;90;283
421640;201511;1066;3173;799;2621;162;551;333;1043;495;1594
421650;201511;1968;6366;1515;5322;440;1756;216;640;656;2396
421660;201511;8084;25946;6392;22361;1608;6352;1993;6381;3601;12733
421670;201511;1107;3399;753;2587;220;849;203;655;423;1504
421680;201511;1244;4012;1024;3519;328;1196;204;638;532;1834
421690;201511;1810;5831;1328;4656;281;1084;179;517;460;1601
421700;201511;536;1643;299;1016;47;190;89;219;136;409
421710;201511;241;798;118;429;35;132;33;107;68;239
421715;201511;276;738;145;462;39;141;42;111;81;252
421720;201511;1879;5572;1165;4090;321;1251;228;706;549;1957
421725;201511;110;363;95;326;28;100;24;77;52;177
421730;201511;595;1723;274;951;52;198;56;148;108;346
421740;201511;763;2410;508;1785;108;455;99;258;207;713
421750;201511;949;2589;585;1844;116;395;254;743;370;1138
421755;201511;358;1028;214;674;46;167;69;196;115;363
421760;201511;706;2256;367;1327;78;314;108;363;186;677
421770;201511;3146;9334;2326;7662;649;2282;755;2465;1404;4747
421775;201511;573;1672;384;1317;79;289;106;339;185;628
421780;201511;1356;4444;1000;3622;261;1069;354;1179;615;2248
421790;201511;896;2381;491;1686;121;482;146;447;267;929
421795;201511;350;1027;215;686;35;131;62;191;97;322
421800;201511;2688;8024;1983;6645;425;1633;794;2443;1219;4076
421810;201511;645;2027;455;1625;121;464;53;174;174;638
421820;201511;1132;3288;691;2347;125;471;153;455;278;926
421825;201511;1430;4583;1318;4319;194;765;786;2438;980;3203
421830;201511;2516;8511;2244;7963;518;2117;1003;3383;1521;5500
421835;201511;149;434;105;369;23;106;61;200;84;306
421840;201511;356;1138;270;939;69;280;89;276;158;556
421850;201511;412;1272;245;862;52;218;59;196;111;414
421860;201511;353;1059;220;777;39;147;45;130;84;277
421870;201511;4514;12689;3003;9589;888;3064;523;1580;1411;4644
421875;201511;439;1304;187;691;37;151;26;85;63;236
421880;201511;925;2839;682;2308;150;576;174;534;324;1110
421885;201511;322;1012;253;876;85;331;87;276;172;607
421890;201511;957;3183;800;2861;245;1009;254;845;499;1854
421895;201511;370;1205;323;1119;82;284;168;596;250;880
421900;201511;985;2756;613;1969;163;568;164;451;327;1019
421910;201511;534;1680;361;1280;77;326;80;224;157;550
421915;201511;559;1663;349;1147;69;229;98;281;167;510
421917;201511;598;1740;423;1446;127;516;125;392;252;908
421920;201511;814;2258;528;1860;257;970;138;451;395;1421
421930;201511;3375;8925;1895;6252;437;1607;331;934;768;2541
421935;201511;726;2369;519;1897;107;462;186;627;293;1089
421940;201511;277;934;135;503;24;101;21;57;45;158
421950;201511;3744;10296;1751;6004;421;1573;247;835;668;2408
421960;201511;225;677;172;560;44;161;40;104;84;265
421970;201511;2303;6508;1430;4626;470;1618;338;971;808;2589
421985;201511;523;1334;277;828;47;176;84;249;131;425
422000;201511;1032;3085;849;2736;213;745;336;1109;549;1854
430003;201511;852;2477;650;2117;173;631;190;581;363;1212
430005;201511;322;972;236;803;47;169;105;339;152;508
430010;201511;2154;5807;1564;4772;402;1292;632;1939;1034;3231
430020;201511;758;1901;626;1715;78;231;420;1118;498;1349
430030;201511;1085;2823;788;2283;258;819;149;383;407;1202
430040;201511;11705;30213;8910;25323;2529;7713;1900;5035;4429;12748
430045;201511;750;2016;575;1656;113;335;271;761;384;1096
430047;201511;295;719;163;485;26;72;71;216;97;288
430050;201511;1241;3336;697;2210;134;454;180;520;314;974
430055;201511;307;829;166;517;26;95;70;199;96;294
430057;201511;74;167;27;72;3;7;6;7;9;14
430060;201511;16407;52301;14023;47954;3891;14101;5947;20549;9838;34650
430063;201511;1006;2949;802;2517;199;655;409;1305;608;1960
430064;201511;1536;4486;1230;3919;310;1004;497;1591;807;2595
430066;201511;170;409;121;329;10;35;67;171;77;206
430070;201511;624;1670;213;678;40;146;47;115;87;261
430080;201511;715;2035;437;1478;87;329;127;372;214;701
430085;201511;849;2209;549;1680;115;386;196;601;311;987
430087;201511;1050;3140;973;3008;146;537;627;1819;773;2356
430090;201511;895;2371;327;1087;37;141;49;168;86;309
430100;201511;895;2355;503;1535;124;411;149;385;273;796
430105;201511;968;2867;643;2234;174;682;200;677;374;1359
430107;201511;271;888;193;665;38;143;54;169;92;312
430110;201511;1933;5483;1560;4867;434;1395;642;1969;1076;3364
430120;201511;1737;5123;1276;4142;264;892;619;1964;883;2856
430130;201511;3895;10102;3332;9268;757;2285;1431;3870;2188;6155
430140;201511;1269;3825;853;2886;237;822;263;869;500;1691
430150;201511;835;2201;545;1649;131;426;145;427;276;853
430155;201511;443;1258;253;854;38;138;89;288;127;426
430160;201511;16940;49094;14882;45568;3123;10458;6901;21081;10024;31539
430163;201511;1934;5664;1557;4964;269;948;753;2370;1022;3318
430165;201511;466;1149;134;444;20;67;30;88;50;155
430170;201511;945;2651;350;1251;54;198;35;106;89;304
430175;201511;950;2951;760;2493;202;616;309;1093;511;1709
430180;201511;900;2434;724;2133;168;554;378;1055;546;1609
430185;201511;686;1717;349;1062;51;166;108;276;159;442
430187;201511;683;2008;513;1635;116;429;189;559;305;988
430190;201511;1762;5187;1510;4691;290;1007;840;2564;1130;3571
430192;201511;200;607;85;270;6;19;21;59;27;78
430195;201511;349;1063;82;279;8;28;4;12;12;40
430200;201511;1533;4839;1275;4278;378;1344;302;977;680;2321
430205;201511;559;1603;425;1360;47;187;303;950;350;1137
430210;201511;6620;17619;3530;11052;664;2257;785;2199;1449;4456
430215;201511;379;1033;250;752;45;135;102;285;147;420
430220;201511;775;1946;286;951;47;176;51;155;98;331
430222;201511;305;896;232;731;37;145;105;305;142;450
430223;201511;352;1000;301;925;69;212;174;554;243;766
430225;201511;40;106;20;63;5;13;7;18;12;31
430230;201511;1812;5201;1684;5070;206;481;1437;4511;1643;4992
430235;201511;289;942;223;776;51;199;65;203;116;402
430237;201511;553;1414;395;1142;44;151;248;694;292;845
430240;201511;1016;2646;658;2021;130;475;280;802;410;1277
430245;201511;920;2814;697;2345;182;623;316;1091;498;1714
430250;201511;1286;3624;1097;3288;405;1291;218;629;623;1920
430258;201511;169;474;122;388;11;37;55;182;66;219
430260;201511;847;2379;571;1822;60;199;302;1001;362;1200
430265;201511;320;969;242;803;51;163;21;59;72;222
430270;201511;2965;8251;2524;7502;381;1331;1436;4058;1817;5389
430280;201511;4774;12911;3797;11153;933;2813;1598;4705;2531;7518
430290;201511;2456;6414;2243;6116;167;475;1913;5259;2080;5734
430300;201511;9502;27747;7641;24164;1971;6698;3110;9984;5081;16682
430310;201511;6701;20121;5211;17221;1297;4719;1939;5926;3236;10645
430320;201511;875;2529;553;1853;104;295;265;954;369;1249
430330;201511;749;1975;572;1630;159;452;237;628;396;1080
430340;201511;777;1947;423;1384;76;281;206;667;282;948
430350;201511;6322;19330;5264;17039;1852;6210;1639;5190;3491;11400
430355;201511;382;957;142;440;27;90;18;47;45;137
430360;201511;1094;2852;895;2483;175;557;398;1002;573;1559
430367;201511;272;714;172;532;47;171;60;174;107;345
430370;201511;533;1506;388;1223;113;394;93;259;206;653
430380;201511;883;2263;459;1472;136;480;128;400;264;880
430390;201511;4341;12242;2863;9175;625;2128;571;1708;1196;3836
430400;201511;1449;3442;989;2710;316;913;337;859;653;1772
430410;201511;701;1862;503;1522;107;348;230;683;337;1031
430420;201511;3913;11162;2975;9090;787;2484;1195;3558;1982;6042
430430;201511;779;2072;466;1486;133;459;117;360;250;819
430435;201511;2080;5567;1535;4576;371;1179;641;1868;1012;3047
430440;201511;4133;12879;3175;10693;692;2478;1438;4961;2130;7439
430450;201511;7868;21711;6071;18192;2068;6538;1369;4062;3437;10600
430460;201511;29548;86277;22001;72426;6019;21754;6651;21370;12670;43124
430461;201511;512;1377;153;494;23;76;31;94;54;170
430462;201511;317;903;230;746;79;285;54;151;133;436
430463;201511;4145;13084;3528;11907;767;2779;1649;5646;2416;8425
430465;201511;643;1722;530;1525;165;519;252;695;417;1214
430466;201511;3671;10061;3208;9315;617;1958;1803;5093;2420;7051
430467;201511;560;1632;478;1488;96;331;209;606;305;937
430468;201511;1456;4046;1243;3721;359;1167;450;1298;809;2465
430469;201511;378;1029;64;231;7;32;9;25;16;57
430470;201511;7817;20723;5328;16396;1571;5238;894;2606;2465;7844
430471;201511;673;2192;586;2004;177;622;146;515;323;1137
430480;201511;1080;2806;526;1667;78;282;134;384;212;666
430485;201511;228;651;106;356;15;54;33;108;48;162
430490;201511;397;1089;248;796;53;190;104;332;157;522
430495;201511;402;1171;245;841;48;182;54;160;102;342
430500;201511;1285;3545;1039;3123;294;984;436;1262;730;2246
430510;201511;20890;61126;16672;52988;5644;19676;4614;13521;10258;33197
430511;201511;414;1268;168;591;22;85;22;58;44;143
430512;201511;1205;3092;1014;2751;257;723;347;982;604;1705
430513;201511;775;2074;477;1431;99;305;180;526;279;831
430515;201511;507;1473;366;1171;62;208;179;584;241;792
430517;201511;1255;3923;1038;3473;215;738;570;1914;785;2652
430520;201511;1660;4577;1136;3485;293;981;359;1001;652;1982
430530;201511;1125;3044;534;1710;70;263;131;386;201;649
430535;201511;2264;6800;1684;5599;364;1339;608;1931;972;3270
430537;201511;496;1562;422;1408;51;165;297;1005;348;1170
430540;201511;785;1736;514;1363;95;266;293;769;388;1035
430543;201511;518;1335;453;1268;84;246;317;907;401;1153
430544;201511;696;2185;576;1932;116;414;291;944;407;1358
430545;201511;1329;4199;1133;3954;381;1417;467;1661;848;3078
430550;201511;680;1952;426;1396;88;316;122;388;210;704
430558;201511;86;251;45;155;12;52;11;30;23;82
430560;201511;425;1050;243;731;26;88;79;220;105;308
430570;201511;1184;3014;745;2140;187;638;284;673;471;1311
430580;201511;1328;3360;755;2368;175;600;261;814;436;1414
430583;201511;170;472;54;181;3;15;4;13;7;28
430585;201511;360;932;225;643;58;197;94;228;152;425
430587;201511;217;657;186;599;57;194;56;183;113;377
430590;201511;1307;3646;1221;3504;183;565;827;2332;1010;2897
430593;201511;30;114;27;103;7;35;12;39;19;74
430595;201511;257;701;85;291;13;55;9;23;22;78
430597;201511;351;1022;233;738;28;98;68;183;96;281
430600;201511;2191;5876;1230;3736;233;763;403;1152;636;1915
430605;201511;1385;4136;1073;3495;243;903;418;1368;661;2271
430607;201511;779;1909;561;1573;87;260;343;980;430;1240
430610;201511;8610;22766;6407;19215;1770;5727;1884;5547;3654;11274
430613;201511;278;672;112;332;27;75;21;49;48;124
430620;201511;772;2194;600;1836;162;514;224;650;386;1164
430630;201511;472;1440;226;747;39;128;31;81;70;209
430632;201511;746;2048;400;1240;68;245;160;423;228;668
430635;201511;715;1952;508;1549;108;363;240;715;348;1078
430637;201511;514;1455;446;1317;68;237;271;756;339;993
430640;201511;1769;4647;771;2478;81;263;90;174;171;437
430642;201511;492;1302;298;937;59;199;111;335;170;534
430645;201511;275;654;102;296;17;47;22;67;39;114
430650;201511;1898;6099;1598;5491;339;1184;889;3118;1228;4302
430655;201511;175;479;148;426;27;90;71;176;98;266
430660;201511;5788;16208;4501;13919;1154;3875;1756;5353;2910;9228
430670;201511;502;1451;450;1347;40;122;341;1055;381;1177
430673;201511;747;1765;344;1034;73;223;125;367;198;590
430675;201511;275;796;110;356;17;60;46;146;63;206
430676;201511;3671;10921;2996;9671;814;2841;987;3150;1801;5991
430680;201511;1245;3555;765;2482;143;484;206;573;349;1057
430690;201511;4426;12374;3421;10378;1074;3345;915;2784;1989;6129
430692;201511;296;964;213;792;25;97;133;490;158;587
430693;201511;1395;3833;896;2793;172;625;231;649;403;1274
430695;201511;582;1627;391;1239;83;297;150;429;233;726
430697;201511;491;1368;369;1155;97;297;134;439;231;736
430700;201511;10103;25965;4649;15201;837;3087;294;880;1131;3967
430705;201511;287;869;243;784;82;290;65;191;147;481
430710;201511;1858;4670;1356;3821;300;920;521;1480;821;2400
430720;201511;924;2260;599;1784;146;471;200;588;346;1059
430730;201511;1724;4511;1165;3577;306;931;436;1393;742;2324
430740;201511;591;1632;328;1093;92;327;56;178;148;505
430745;201511;516;1460;244;777;43;154;37;101;80;255
430750;201511;1697;4609;1322;3955;262;873;651;1855;913;2728
430755;201511;579;1522;363;1057;36;122;161;421;197;543
430760;201511;3236;7863;2213;6342;484;1631;905;2638;1389;4269
430770;201511;6851;19582;5207;16484;1015;3501;2601;8106;3616;11607
430780;201511;2533;6700;1447;4570;293;997;435;1308;728;2305
430781;201511;596;1709;399;1309;84;280;123;384;207;664
430783;201511;543;1340;327;971;61;196;147;398;208;594
430786;201511;79;254;54;191;9;34;21;69;30;103
430790;201511;4810;13038;3215;9790;743;2524;1162;3217;1905;5741
430800;201511;898;2564;592;1855;130;454;191;560;321;1014
430805;201511;546;1494;348;1099;43;133;172;553;215;686
430807;201511;440;1257;292;914;62;223;81;233;143;456
430810;201511;827;2179;367;1174;57;207;73;193;130;400
430820;201511;1326;4044;861;2903;181;666;228;719;409;1385
430825;201511;416;1087;171;519;34;104;45;110;79;214
430830;201511;2078;6220;1900;5944;277;934;1256;3903;1533;4837
430840;201511;983;2988;885;2801;231;748;415;1353;646;2101
430843;201511;103;296;50;163;10;39;17;51;27;90
430845;201511;322;970;259;833;107;367;23;60;130;427
430850;201511;2668;7752;2211;6877;515;1751;867;2594;1382;4345
430860;201511;1039;2786;528;1721;143;541;165;492;308;1033
430865;201511;691;1797;618;1681;215;617;284;738;499;1355
430870;201511;716;2000;386;1269;95;316;72;197;167;513
430880;201511;1309;3666;934;2922;266;896;252;803;518;1699
430885;201511;250;608;144;446;18;59;92;284;110;343
430890;201511;1842;4811;1229;3632;173;613;365;955;538;1568
430900;201511;2952;7733;2424;6812;540;1799;1144;2948;1684;4747
430905;201511;1081;3030;654;2101;154;536;152;461;306;997
430910;201511;1613;4717;1123;3660;263;952;431;1282;694;2234
430912;201511;506;1413;393;1212;57;200;238;719;295;919
430915;201511;572;1796;378;1402;122;481;89;348;211;829
430920;201511;15967;48182;14015;44453;3009;10549;7929;24333;10938;34882
430925;201511;107;258;56;164;16;53;22;60;38;113
430930;201511;9709;27767;6631;21721;1813;6408;1712;5647;3525;12055
430940;201511;1256;3798;735;2501;144;548;133;384;277;932
430950;201511;1124;3077;735;2257;172;594;272;740;444;1334
430955;201511;144;434;65;212;15;54;18;59;33;113
430957;201511;273;890;217;782;50;178;109;414;159;592
430960;201511;1422;3814;1156;3333;285;915;524;1538;809;2453
430965;201511;1522;4341;1285;3934;90;337;987;2955;1077;3292
430970;201511;542;1501;312;1006;60;206;85;266;145;472
430975;201511;630;2017;475;1644;83;312;227;793;310;1105
430980;201511;454;1140;272;855;64;215;95;275;159;490
430990;201511;631;1985;449;1531;104;370;94;301;198;671
430995;201511;651;1893;516;1612;174;574;168;488;342;1062
431000;201511;1746;4414;832;2550;146;517;90;225;236;742
431010;201511;2748;7657;1584;5248;297;1087;340;956;637;2043
431020;201511;12312;30025;7644;21569;1914;5568;2020;5594;3934;11162
431030;201511;369;1066;171;601;43;173;31;107;74;280
431033;201511;2460;7100;2152;6644;564;1878;1015;3193;1579;5071
431036;201511;211;540;82;280;16;56;17;46;33;102
431040;201511;991;2792;776;2429;173;619;365;1095;538;1714
431041;201511;547;1478;490;1399;164;479;188;553;352;1032
431043;201511;415;1270;270;949;114;441;66;191;180;632
431046;201511;119;334;80;248;11;40;27;76;38;116
431050;201511;1796;4485;1349;3736;293;887;725;1961;1018;2848
431053;201511;632;2003;502;1713;151;563;115;389;266;952
431055;201511;680;1838;630;1753;63;184;468;1306;531;1490
431057;201511;403;1178;241;825;51;179;64;207;115;386
431060;201511;5808;16874;5216;15993;1604;4875;2294;7326;3898;12201
431065;201511;560;1585;415;1287;74;260;178;507;252;767
431070;201511;744;2143;427;1402;94;313;73;206;167;519
431075;201511;298;906;208;712;34;122;58;208;92;330
431080;201511;661;2039;512;1700;99;364;132;413;231;777
431085;201511;904;2427;686;1979;112;341;369;1044;481;1385
431087;201511;620;1741;532;1567;67;194;357;1066;424;1260
431090;201511;545;1323;248;753;67;209;56;166;123;375
431100;201511;3835;10575;3022;9132;779;2545;1001;2995;1780;5540
431110;201511;1598;4195;1164;3316;262;779;453;1185;715;1964
431112;201511;609;1927;557;1820;145;479;253;807;398;1286
431113;201511;534;1554;410;1300;115;383;118;387;233;770
431115;201511;1437;4090;1239;3747;240;755;708;2147;948;2902
431120;201511;2738;8347;2122;7107;646;2491;679;2031;1325;4522
431123;201511;494;1419;344;1133;71;246;187;623;258;869
431125;201511;1393;4196;1008;3367;309;1024;240;868;549;1892
431127;201511;260;689;52;168;5;11;8;23;13;34
431130;201511;3549;9974;2546;8082;525;1875;874;2691;1399;4566
431140;201511;4717;11617;2477;7698;411;1383;600;1605;1011;2988
431142;201511;494;1452;440;1352;40;127;309;968;349;1095
431150;201511;1176;3482;886;2902;190;695;329;1064;519;1759
431160;201511;989;2866;831;2544;146;439;409;1353;555;1792
431162;201511;540;1411;242;819;35;151;24;48;59;199
431164;201511;173;474;43;156;7;27;4;17;11;44
431170;201511;796;2172;540;1695;146;496;154;458;300;954
431171;201511;840;2451;705;2180;236;771;195;568;431;1339
431173;201511;495;1423;425;1302;116;384;226;683;342;1067
431175;201511;1092;3025;922;2748;274;868;306;880;580;1748
431177;201511;918;2913;741;2562;236;928;305;1006;541;1934
431179;201511;373;815;89;259;14;48;22;52;36;100
431180;201511;2339;6694;1584;5107;387;1317;371;1066;758;2383
431190;201511;746;1915;365;1167;61;219;82;246;143;465
431198;201511;383;1263;334;1164;135;488;85;314;220;802
431200;201511;395;1102;107;364;17;51;4;12;21;63
431205;201511;308;921;146;492;34;106;45;157;79;263
431210;201511;773;2077;645;1855;183;517;321;954;504;1471
431213;201511;252;761;198;656;39;153;90;288;129;441
431215;201511;334;979;168;571;26;84;12;26;38;110
431217;201511;200;611;149;497;43;151;49;165;92;316
431220;201511;971;2590;575;1756;71;227;261;736;332;963
431225;201511;1377;3815;1083;3292;231;750;529;1561;760;2311
431230;201511;893;2545;653;2051;83;272;334;1018;417;1290
431235;201511;110;313;32;101;6;21;6;14;12;35
431237;201511;516;1507;402;1332;96;383;206;662;302;1045
431238;201511;46;146;37;125;9;35;11;36;20;71
431240;201511;2974;8834;2588;8223;841;2854;809;2548;1650;5402
431242;201511;385;1205;335;1103;98;329;106;368;204;697
431244;201511;419;985;255;707;42;142;129;320;171;462
431245;201511;1175;3052;830;2418;133;411;444;1257;577;1668
431247;201511;199;570;142;451;42;139;30;88;72;227
431250;201511;1591;4978;1359;4630;367;1343;563;1919;930;3262
431260;201511;364;1021;181;628;34;138;56;173;90;311
431261;201511;248;856;213;775;38;180;75;238;113;418
431262;201511;419;1139;186;608;21;87;84;272;105;359
431265;201511;1512;3913;812;2464;154;509;201;490;355;999
431267;201511;174;474;135;406;31;113;74;204;105;317
431270;201511;2808;7034;1837;5437;483;1601;625;1819;1108;3420
431275;201511;228;696;117;434;35;133;12;41;47;174
431280;201511;336;922;130;421;15;53;31;74;46;127
431290;201511;332;1012;243;808;59;229;48;129;107;358
431295;201511;101;271;53;155;3;10;23;60;26;70
431300;201511;396;990;52;199;5;20;0;0;5;20
431301;201511;272;833;123;415;27;97;22;62;49;159
431303;201511;767;2024;435;1326;68;249;134;369;202;618
431306;201511;2384;6176;1519;4604;180;654;483;1274;663;1928
431308;201511;45;153;40;136;23;83;12;39;35;122
431310;201511;821;2435;487;1663;96;332;143;505;239;837
431320;201511;936;2525;477;1554;87;298;110;321;197;619
431330;201511;2858;7019;1302;4124;336;1207;105;278;441;1485
431333;201511;456;1228;195;602;26;92;51;135;77;227
431335;201511;62;188;45;148;14;48;9;19;23;67
431337;201511;2486;7545;1814;6139;427;1520;333;1044;760;2564
431339;201511;658;1779;450;1354;77;245;205;598;282;843
431340;201511;26175;68932;18524;55404;4329;14038;5042;14538;9371;28576
431342;201511;550;1414;440;1227;144;446;216;557;360;1003
431344;201511;362;998;264;823;13;40;199;628;212;668
431346;201511;331;841;136;409;27;87;24;66;51;153
431349;201511;735;2090;487;1496;100;309;150;437;250;746
431350;201511;4122;12023;3351;10582;709;2520;1320;3917;2029;6437
431360;201511;711;1804;458;1367;115;360;138;421;253;781
431365;201511;1309;3809;1102;3457;276;936;542;1717;818;2653
431370;201511;5057;14115;3894;12062;1091;3654;1172;3624;2263;7278
431380;201511;952;2927;869;2734;134;476;529;1609;663;2085
431390;201511;3332;8745;1976;6100;391;1357;550;1492;941;2849
431395;201511;1287;3778;1070;3409;244;860;510;1579;754;2439
431400;201511;338;1058;163;555;35;132;23;60;58;192
431402;201511;1311;3064;736;2042;150;445;351;919;501;1364
431403;201511;276;785;193;635;52;184;35;110;87;294
431405;201511;4247;11687;3353;10359;663;2307;1698;5093;2361;7400
431406;201511;798;2426;581;1949;159;573;261;851;420;1424
431407;201511;573;1634;367;1210;84;277;106;315;190;592
431410;201511;14027;40139;9243;30598;2715;10078;1125;3603;3840;13681
431413;201511;232;572;104;333;8;28;33;100;41;128
431415;201511;763;2106;555;1724;128;467;208;571;336;1038
431417;201511;655;1590;520;1391;70;190;305;828;375;1018
431420;201511;1435;3904;1238;3593;268;819;555;1687;823;2506
431430;201511;538;1392;320;957;67;219;108;274;175;493
431440;201511;23694;65901;19058;58243;5550;17948;6352;20253;11902;38201
431442;201511;148;417;92;277;15;52;13;24;28;76
431445;201511;520;1467;223;709;32;97;85;259;117;356
431446;201511;477;1384;327;1068;78;269;108;341;186;610
431447;201511;708;1992;511;1591;110;351;211;664;321;1015
431449;201511;832;2316;647;1976;70;217;381;1163;451;1380
431450;201511;2193;5460;1922;5051;307;886;1340;3419;1647;4305
431454;201511;65;237;56;214;16;65;21;85;37;150
431455;201511;729;1844;375;1069;101;284;94;246;195;530
431460;201511;3492;9613;2922;8512;784;2312;939;2832;1723;5144
431470;201511;1843;5414;1374;4350;337;1060;467;1480;804;2540
431475;201511;192;562;42;163;6;24;1;3;7;27
431477;201511;754;1952;503;1448;61;198;271;736;332;934
431478;201511;273;696;100;294;16;48;22;55;38;103
431480;201511;3124;8574;2273;7014;596;2035;800;2333;1396;4368
431490;201511;113698;305402;95882;278254;12248;41761;65418;184378;77666;226139
431500;201511;726;1966;548;1624;123;362;264;763;387;1125
431505;201511;507;1221;346;987;25;62;232;680;257;742
431507;201511;362;872;224;604;42;106;130;344;172;450
431510;201511;2111;5698;1586;4685;355;1121;588;1576;943;2697
431513;201511;306;832;142;451;19;62;72;227;91;289
431514;201511;106;279;39;137;4;19;4;13;8;32
431515;201511;747;2139;506;1551;113;395;199;512;312;907
431517;201511;86;269;74;238;17;56;23;64;40;120
431520;201511;507;1384;248;804;33;129;39;110;72;239
431530;201511;4333;10227;3250;8930;1104;3257;942;2710;2046;5967
431531;201511;291;819;186;603;38;124;63;203;101;327
431532;201511;528;1458;441;1268;115;356;173;481;288;837
431535;201511;406;1045;178;539;29;97;59;152;88;249
431540;201511;2141;6977;1866;6558;225;802;1177;4343;1402;5145
431545;201511;320;874;48;167;6;20;7;26;13;46
431550;201511;2323;6752;2033;6220;403;1401;930;2724;1333;4125
431555;201511;731;1838;560;1562;88;246;337;947;425;1193
431560;201511;20171;59954;14127;47914;3534;13306;3294;11532;6828;24838
431570;201511;5364;14736;4669;13598;1310;3895;2061;6105;3371;10000
431575;201511;434;1094;299;867;46;155;78;194;124;349
431580;201511;684;1920;424;1340;87;309;142;406;229;715
431590;201511;1007;2733;605;1888;99;303;223;703;322;1006
431595;201511;486;1371;378;1145;58;176;208;635;266;811
431600;201511;2071;5726;1424;4504;326;1231;351;990;677;2221
431610;201511;1485;4307;1083;3509;208;693;445;1437;653;2130
431620;201511;468;1383;233;747;59;201;92;266;151;467
431630;201511;1492;3962;947;2829;262;831;307;860;569;1691
431640;201511;6202;17540;5516;16497;1203;3983;3035;9010;4238;12993
431642;201511;528;1418;415;1218;63;209;199;562;262;771
431643;201511;246;617;155;417;24;67;59;136;83;203
431645;201511;1835;5192;1569;4744;309;1018;871;2600;1180;3618
431647;201511;178;509;112;351;22;76;20;50;42;126
431650;201511;316;961;215;751;31;123;52;154;83;277
431660;201511;1207;3358;728;2342;150;527;172;477;322;1004
431670;201511;1357;3550;991;2891;220;727;410;1092;630;1819
431673;201511;229;633;119;385;24;83;19;54;43;137
431675;201511;652;1751;182;612;30;101;34;95;64;196
431680;201511;10379;27811;7497;22496;2036;6535;1900;5678;3936;12213
431690;201511;24612;67850;18870;58177;5245;17237;6366;20022;11611;37259
431695;201511;137;411;90;290;18;55;21;54;39;109
431697;201511;461;1309;402;1196;101;302;191;584;292;886
431700;201511;1611;4554;1348;4039;244;777;711;2063;955;2840
431710;201511;13034;37276;10397;32850;3300;11186;2509;8368;5809;19554
431720;201511;7398;20210;5554;16603;1217;3976;2028;5853;3245;9829
431725;201511;22;64;12;39;2;5;4;11;6;16
431730;201511;3985;11580;3086;9926;832;2935;802;2644;1634;5579
431740;201511;5408;14955;4222;12749;1361;4531;759;2033;2120;6564
431750;201511;9650;26973;8191;24568;1889;6160;3836;11609;5725;17769
431755;201511;333;912;72;253;13;44;12;38;25;82
431760;201511;4046;11558;3169;9930;719;2457;1110;3293;1829;5750
431770;201511;2117;5602;1733;4987;334;1002;966;2732;1300;3734
431775;201511;217;583;146;447;46;143;19;51;65;194
431780;201511;2483;6650;1842;5428;472;1474;412;1107;884;2581
431790;201511;1278;3908;1057;3474;184;659;597;1977;781;2636
431795;201511;397;1084;240;733;38;126;87;257;125;383
431800;201511;8969;26251;6976;22367;2121;7341;1276;3836;3397;11177
431805;201511;329;795;97;325;15;58;16;52;31;110
431810;201511;3458;9489;2651;7856;510;1634;1139;3287;1649;4921
431820;201511;2702;8348;2301;7555;488;1761;943;2968;1431;4729
431830;201511;11055;26975;8476;23123;2393;7055;3213;8791;5606;15846
431840;201511;2788;8223;2373;7497;599;2038;1026;3249;1625;5287
431842;201511;820;2050;337;1029;48;161;82;207;130;368
431843;201511;360;1040;291;909;39;143;149;448;188;591
431844;201511;270;722;103;334;22;80;22;55;44;135
431845;201511;530;1538;419;1297;35;118;262;815;297;933
431846;201511;378;1134;332;1063;38;147;226;703;264;850
431848;201511;246;661;130;424;15;52;28;81;43;133
431849;201511;450;1102;91;276;18;57;17;38;35;95
431850;201511;4993;14372;4312;13052;1030;3332;1647;4933;2677;8265
431860;201511;807;2098;593;1738;121;397;286;779;407;1176
431861;201511;104;310;55;194;7;24;8;27;15;51
431862;201511;483;1571;386;1377;112;451;97;306;209;757
431870;201511;19190;54244;14708;46261;3698;12614;4740;14772;8438;27386
431880;201511;4441;13071;3440;10947;805;2853;1243;3725;2048;6578
431890;201511;5362;14326;3884;11619;1198;3794;1000;3008;2198;6802
431900;201511;1107;3140;720;2338;193;714;287;835;480;1549
431910;201511;1044;2478;464;1341;76;217;147;385;223;602
431912;201511;625;1764;479;1489;140;412;153;505;293;917
431915;201511;1371;3673;1032;3068;238;743;392;1154;630;1897
431920;201511;1353;3733;1177;3454;137;410;852;2477;989;2887
431930;201511;1281;3480;907;2843;237;724;408;1344;645;2068
431935;201511;64;198;51;170;12;49;19;52;31;101
431936;201511;403;1168;300;941;63;195;133;434;196;629
431937;201511;348;898;196;585;49;155;35;87;84;242
431940;201511;2686;7255;1704;5291;399;1317;444;1335;843;2652
431950;201511;1699;5134;1458;4704;279;1012;674;2064;953;3076
431960;201511;3061;8801;2643;7968;678;2140;851;2499;1529;4639
431970;201511;510;1377;244;780;38;147;59;163;97;310
431971;201511;111;313;76;242;8;26;30;82;38;108
431973;201511;499;1701;429;1547;60;219;255;960;315;1179
431975;201511;104;243;19;77;5;25;2;5;7;30
431980;201511;1441;4174;1168;3612;275;912;370;1072;645;1984
431990;201511;8005;21930;5903;18317;1067;3809;1898;5465;2965;9274
432000;201511;10566;29111;8138;24831;2522;8076;2686;8027;5208;16103
432010;201511;2333;6516;1881;5689;403;1287;872;2614;1275;3901
432020;201511;2382;5830;1809;5025;270;816;1186;3234;1456;4050
432023;201511;550;1562;353;1132;70;236;105;313;175;549
432026;201511;1274;3816;919;3038;154;495;475;1569;629;2064
432030;201511;416;1203;309;965;61;185;146;445;207;630
432032;201511;604;1557;392;1168;70;217;176;488;246;705
432035;201511;855;2592;756;2403;291;978;240;775;531;1753
432040;201511;1042;2443;473;1474;98;341;129;366;227;707
432045;201511;244;696;138;476;24;88;50;172;74;260
432050;201511;675;1854;570;1659;95;276;330;995;425;1271
432055;201511;883;2596;691;2219;133;459;377;1179;510;1638
432057;201511;437;1082;326;896;48;132;209;552;257;684
432060;201511;525;1386;197;660;40;150;42;124;82;274
432065;201511;216;614;165;523;40;142;60;177;100;319
432067;201511;1006;3080;720;2444;147;528;346;1177;493;1705
432070;201511;2428;6647;1545;4809;352;1196;341;948;693;2144
432080;201511;3782;10694;3171;9606;1028;3325;995;2953;2023;6278
432085;201511;326;890;213;703;50;175;93;307;143;482
432090;201511;1530;4337;1183;3628;360;1190;437;1246;797;2436
432100;201511;1361;3902;658;2229;116;396;74;187;190;583
432110;201511;2749;8178;2012;6623;498;1857;264;734;762;2591
432120;201511;5116;14899;4231;13335;1555;5246;1148;3479;2703;8725
432130;201511;2652;7372;2118;6659;741;2580;726;2223;1467;4803
432132;201511;438;1232;205;704;23;93;65;206;88;299
432135;201511;713;2180;672;2100;88;305;498;1526;586;1831
432140;201511;2045;6426;1606;5563;376;1364;672;2418;1048;3782
432143;201511;1435;4160;1187;3731;229;728;563;1841;792;2569
432145;201511;1213;3701;702;2468;133;525;121;384;254;909
432146;201511;210;660;137;484;35;139;32;105;67;244
432147;201511;668;2075;494;1693;134;492;144;497;278;989
432149;201511;373;1049;226;700;47;149;88;273;135;422
432150;201511;3840;10597;2781;8623;617;2145;853;2475;1470;4620
432160;201511;4575;14248;3918;13097;1224;4287;1344;4630;2568;8917
432162;201511;396;951;73;230;11;39;14;35;25;74
432163;201511;407;1074;92;293;5;17;6;19;11;36
432166;201511;730;2136;588;1843;86;314;282;846;368;1160
432170;201511;1069;3320;680;2448;140;521;119;411;259;932
432180;201511;2974;7849;1940;5914;469;1507;477;1406;946;2913
432183;201511;437;1346;342;1144;140;501;66;202;206;703
432185;201511;936;2502;569;1801;111;364;243;768;354;1132
432190;201511;3492;9461;2275;6783;550;1741;648;1772;1198;3513
432195;201511;1246;3356;980;2925;140;443;574;1656;714;2099
432200;201511;3278;9730;2566;8482;644;2339;1111;3676;1755;6015
432210;201511;440;1196;319;994;81;293;129;362;210;655
432215;201511;882;2691;745;2468;140;422;434;1535;574;1957
432218;201511;300;779;200;577;35;102;77;195;112;297
432220;201511;4331;11318;3484;9986;394;1327;2144;5946;2538;7273
432225;201511;70;220;60;203;22;79;19;59;41;138
432230;201511;1100;2933;640;1925;147;488;169;407;316;895
432232;201511;563;1609;434;1358;88;282;165;517;253;799
432234;201511;418;1138;272;804;59;172;89;251;148;423
432235;201511;84;230;38;132;11;44;3;7;14;51
432237;201511;479;1300;436;1232;19;75;327;891;346;966
432240;201511;14247;44652;11875;41379;2003;8177;6844;24440;8847;32617
432250;201511;4944;16659;4420;15592;1491;5771;1372;4776;2863;10547
432252;201511;402;1123;283;925;54;188;152;504;206;692
432253;201511;1345;4220;838;2907;217;826;147;483;364;1309
432254;201511;837;2254;221;724;55;192;31;86;86;278
432255;201511;246;626;130;426;30;104;38;116;68;220
432260;201511;7776;19236;5259;15062;1240;3650;2024;6004;3264;9654
432270;201511;2615;7690;2153;6865;625;2044;778;2558;1403;4602
432280;201511;1386;3768;698;2244;116;403;164;456;280;859
432285;201511;196;614;44;150;8;32;7;18;15;50
432290;201511;579;1704;362;1199;86;298;110;351;196;649
432300;201511;23761;70026;20586;64450;4095;13875;11397;35130;15492;49005
432310;201511;869;2517;690;2215;146;518;364;1132;510;1650
432320;201511;254;643;125;385;27;83;24;59;51;142
432330;201511;332;870;122;405;14;48;8;22;22;70
432335;201511;212;612;89;309;20;69;11;37;31;106
432340;201511;379;912;176;530;32;103;58;164;90;267
432345;201511;692;1909;629;1805;95;344;371;974;466;1318
432350;201511;401;1077;203;666;34;108;56;174;90;282
432360;201511;179;550;37;135;12;50;9;27;21;77
432370;201511;434;1199;339;1008;41;115;213;641;254;756
432375;201511;807;2012;616;1701;83;227;356;989;439;1216
432377;201511;204;662;51;170;10;31;13;29;23;60
432380;201511;886;2922;775;2715;283;1102;298;976;581;2078
500020;201511;2294;6798;1709;5716;368;1463;681;2130;1049;3593
500025;201511;1341;3080;822;2184;92;252;493;1282;585;1534
500060;201511;6856;20159;5413;17719;694;2360;3440;11671;4134;14031
500070;201511;4258;12228;3486;10880;720;2529;1502;4595;2222;7124
500080;201511;1556;4540;1125;3728;306;1120;372;1222;678;2342
500085;201511;2287;5903;1617;4895;182;590;937;2742;1119;3332
500090;201511;2389;6762;1706;5514;357;1193;767;2528;1124;3721
500100;201511;2566;7455;2168;6737;502;1800;918;2668;1420;4468
500110;201511;8735;25217;6837;22231;1116;3926;3458;11801;4574;15727
500124;201511;2050;6525;1746;6018;351;1127;918;3493;1269;4620
500150;201511;1454;3588;994;2821;191;650;419;986;610;1636
500190;201511;4957;12751;3814;11213;740;2345;2072;6172;2812;8517
500200;201511;2525;6279;1868;5113;392;1164;767;1963;1159;3127
500210;201511;4857;14333;4002;12944;900;3086;1876;6101;2776;9187
500215;201511;1628;4928;1257;4164;211;768;482;1528;693;2296
500220;201511;2964;9201;2415;8224;503;1834;965;3356;1468;5190
500230;201511;2816;7026;1970;5680;468;1485;872;2535;1340;4020
500240;201511;4755;14640;3312;11615;538;2030;1117;4130;1655;6160
500260;201511;2758;7011;2006;5833;317;1038;979;2692;1296;3730
500270;201511;122798;312220;74787;227761;17951;58894;16765;49702;34716;108596
500280;201511;1414;3620;1182;3314;101;311;889;2522;990;2833
500290;201511;4392;10058;2522;7263;532;1713;846;2294;1378;4007
500295;201511;2733;7982;1698;5565;292;1063;418;1145;710;2208
500310;201511;829;2126;681;1908;148;488;331;869;479;1357
500315;201511;3175;9778;2609;8861;394;1387;1588;5583;1982;6970
500320;201511;16976;53799;13225;46647;3826;14676;3897;14286;7723;28962
500325;201511;4110;10409;2936;8564;607;1922;1520;4410;2127;6332
500330;201511;6717;17646;4725;13918;920;2988;2092;6004;3012;8992
500345;201511;2227;5763;1705;4935;349;1100;855;2421;1204;3521
500348;201511;2400;6776;2079;6266;147;529;1514;4497;1661;5026
500350;201511;1272;3781;716;2448;100;361;237;842;337;1203
500370;201511;23457;70207;17344;58673;3867;14674;5112;17112;8979;31786
500375;201511;2931;7966;2132;6432;477;1521;590;1698;1067;3219
500380;201511;3066;8503;2426;7350;671;2121;912;2758;1583;4879
500390;201511;600;1308;348;920;42;130;213;516;255;646
500400;201511;1322;3973;960;3105;228;813;245;689;473;1502
500410;201511;2281;6300;1813;5598;479;1632;810;2495;1289;4127
500430;201511;2516;7107;1937;6256;418;1524;809;2656;1227;4180
500440;201511;1550;4048;1028;3139;182;618;473;1382;655;2000
500450;201511;1751;5224;1265;4241;269;1008;247;705;516;1713
500460;201511;3746;11089;2766;9139;728;2626;628;1968;1356;4594
500470;201511;3083;8930;2072;6730;538;1940;324;920;862;2860
500480;201511;2207;6710;2032;6481;236;694;1486;5118;1722;5812
500490;201511;991;2712;746;2269;213;749;206;605;419;1354
500500;201511;3742;11489;2881;10136;1151;4632;734;2499;1885;7131
500510;201511;852;2190;529;1612;71;238;225;629;296;867
500515;201511;1886;4975;1535;4507;257;792;868;2746;1125;3538
500520;201511;3072;10378;2724;9845;442;1731;1712;6298;2154;8029
500525;201511;1185;3733;938;3249;182;710;416;1467;598;2177
500540;201511;6278;17129;3519;11772;945;3691;517;1462;1462;5153
500560;201511;4694;15258;4244;14560;558;2114;2987;10286;3545;12400
500568;201511;4126;10328;2812;8308;582;2028;1023;2787;1605;4815
500570;201511;7726;20439;4931;15082;1293;4253;1052;3009;2345;7262
500580;201511;3731;10475;2949;9192;299;963;2055;6487;2354;7450
500600;201511;3926;10293;2477;7539;582;1922;788;2308;1370;4230
500620;201511;7792;21995;5727;18057;1138;3941;2505;7865;3643;11806
500625;201511;792;2315;415;1427;87;324;125;423;212;747
500627;201511;543;1584;414;1354;82;274;113;395;195;669
500630;201511;6184;16670;4357;13531;1083;3737;1339;4002;2422;7739
500635;201511;2783;10227;2229;9336;335;1355;1411;6459;1746;7814
500640;201511;1646;3951;1237;3366;98;312;880;2342;978;2654
500660;201511;19240;54554;14613;46937;4326;15681;4388;13797;8714;29478
500690;201511;2827;8023;2218;7216;957;3294;626;2161;1583;5455
500710;201511;3744;10972;3119;9906;690;2481;1390;4308;2080;6789
500720;201511;6143;16170;3765;11904;1022;3553;938;2794;1960;6347
500730;201511;996;2737;688;2111;156;541;216;620;372;1161
500740;201511;4082;11095;3301;9628;419;1515;1515;4479;1934;5994
500750;201511;901;2451;767;2254;134;419;425;1241;559;1660
500755;201511;1237;3573;834;2712;177;631;211;559;388;1190
500769;201511;5193;13654;2997;9064;518;1759;671;1681;1189;3440
500770;201511;1737;5034;1244;4112;313;1103;327;1093;640;2196
500780;201511;1140;3261;909;2821;237;788;283;810;520;1598
500790;201511;9406;25775;7738;22912;1373;4676;4253;12166;5626;16842
500793;201511;2364;6675;1769;5615;455;1562;483;1365;938;2927
500795;201511;2482;7265;2090;6713;266;727;1472;5036;1738;5763
500797;201511;869;2324;598;1844;105;345;226;659;331;1004
500800;201511;2780;7482;2144;6576;826;2881;596;1802;1422;4683
500830;201511;19071;51013;12825;39027;2594;8708;4210;12028;6804;20736
500840;201511;1325;3676;905;2822;112;372;383;1132;495;1504
510010;201511;1265;3753;1039;3383;274;905;505;1667;779;2572
510020;201511;3479;9858;2144;7100;489;1749;554;1683;1043;3432
510025;201511;8075;23205;6295;19875;1490;5161;2143;6163;3633;11324
510030;201511;1752;4712;1416;4171;299;991;668;1862;967;2853
510035;201511;861;2416;673;2152;138;453;370;1207;508;1660
510040;201511;1759;4738;1327;4086;219;742;703;2171;922;2913
510050;201511;1885;5419;1320;4332;351;1250;379;1210;730;2460
510060;201511;1640;4639;1196;3780;226;753;481;1472;707;2225
510080;201511;1109;3440;851;2918;256;993;162;480;418;1473
510100;201511;682;1814;479;1404;62;202;211;577;273;779
510120;201511;317;676;197;523;20;56;120;325;140;381
510125;201511;3160;8245;2373;6826;414;1437;988;2577;1402;4014
510130;201511;1885;5076;1495;4419;397;1235;512;1491;909;2726
510140;201511;2932;9295;2314;8322;951;3840;513;1582;1464;5422
510160;201511;1364;4520;1242;4342;180;710;839;2912;1019;3622
510170;201511;5440;16172;4409;14367;830;3003;2066;6458;2896;9461
510180;201511;12299;31813;8481;25770;2428;7756;2642;8872;5070;16628
510185;201511;1374;3988;1111;3636;152;474;734;2625;886;3099
510190;201511;2276;6608;1551;5487;342;1318;710;2604;1052;3922
510250;201511;14191;42672;11893;39239;3533;12627;4483;15124;8016;27751
510260;201511;2254;9021;1918;8301;527;2330;838;4111;1365;6441
510263;201511;4320;11383;3054;9262;742;2387;876;2493;1618;4880
510267;201511;5879;16850;4114;13074;936;3238;1155;3430;2091;6668
510268;201511;851;2485;725;2289;148;499;412;1290;560;1789
510269;201511;1009;3080;742;2543;242;860;186;646;428;1506
510270;201511;2692;8661;2258;7768;403;1410;992;3389;1395;4799
510279;201511;1988;6048;1607;5190;427;1501;458;1290;885;2791
510285;201511;1345;3920;1036;3366;279;984;343;1061;622;2045
510300;201511;3349;9722;2760;8867;220;841;2066;6645;2286;7486
510305;201511;1577;4775;1203;4044;300;1099;402;1290;702;2389
510310;201511;842;2509;711;2257;217;737;236;705;453;1442
510320;201511;3468;9937;2677;8437;667;2467;727;2108;1394;4575
510325;201511;5294;16553;4452;15394;1219;4336;2583;9238;3802;13574
510330;201511;2815;8748;2214;7660;568;2176;751;2559;1319;4735
510335;201511;4908;14657;3965;13443;531;1739;2809;10105;3340;11844
510336;201511;599;1802;453;1523;81;295;230;762;311;1057
510337;201511;2197;7110;1733;6175;673;2529;302;1069;975;3598
510340;201511;76553;204188;52347;165944;17466;61250;9832;32064;27298;93314
510343;201511;1123;3212;933;2898;100;330;685;2172;785;2502
510345;201511;1675;4901;1334;4283;346;1185;475;1460;821;2645
510350;201511;3383;9126;2563;7942;638;2096;1144;3668;1782;5764
510360;201511;1804;4407;1149;3594;131;504;789;2397;920;2901
510370;201511;1181;3900;1000;3595;211;778;592;2217;803;2995
510380;201511;569;1701;373;1300;129;487;47;137;176;624
510385;201511;985;3669;724;3067;102;462;333;1531;435;1993
510390;201511;1129;3452;1027;3317;281;727;624;2287;905;3014
510395;201511;752;1855;549;1566;89;279;228;743;317;1022
510410;201511;3845;12391;3382;11461;832;2976;1718;5885;2550;8861
510420;201511;2425;6113;1744;4973;201;720;899;2507;1100;3227
510450;201511;638;1656;447;1367;103;350;152;449;255;799
510452;201511;639;2049;454;1623;94;379;212;733;306;1112
510454;201511;848;2662;721;2412;116;419;451;1533;567;1952
510455;201511;985;3014;723;2464;143;554;233;758;376;1312
510460;201511;2272;5923;1721;5130;231;835;983;2765;1214;3600
510480;201511;4624;12132;3189;9471;717;2241;774;2123;1491;4364
510490;201511;1626;5053;1354;4623;283;1092;734;2418;1017;3510
510500;201511;1548;4571;1042;3559;255;1007;404;1298;659;2305
510510;201511;2735;9381;2340;8646;739;2976;764;2758;1503;5734
510515;201511;6288;18910;4538;15019;1001;3684;1064;3272;2065;6956
510517;201511;1718;5083;1378;4422;428;1437;398;1227;826;2664
510520;201511;2158;5013;1544;4231;76;224;1069;3106;1145;3330
510523;201511;1029;3011;895;2793;143;448;601;1930;744;2378
510525;201511;8061;20727;5270;16171;1101;3501;1962;5951;3063;9452
510530;201511;522;1463;432;1332;53;230;266;777;319;1007
510550;201511;2603;8537;2160;7693;618;2368;714;2496;1332;4864
510558;201511;1978;5612;1638;5118;334;1149;813;2597;1147;3746
510560;201511;1678;5111;1083;4064;310;1272;229;854;539;2126
510562;201511;5423;15875;4182;13372;1195;4204;1104;3515;2299;7719
510590;201511;3121;8246;2550;7510;544;1611;1379;4227;1923;5838
510600;201511;1576;4063;1040;3162;191;620;419;1201;610;1821
510610;201511;2875;8229;2375;7467;190;683;1703;5315;1893;5998
510615;201511;2274;6793;1883;6141;542;1885;838;2760;1380;4645
510617;201511;606;1816;495;1620;42;124;392;1337;434;1461
510618;201511;1448;4206;1025;3368;190;720;455;1443;645;2163
510619;201511;843;2312;480;1601;65;239;59;152;124;391
510620;201511;1501;3665;800;2561;203;727;122;357;325;1084
510621;201511;896;3127;790;2899;206;838;248;863;454;1701
510622;201511;3904;11757;2636;9012;704;2604;344;952;1048;3556
510623;201511;3471;9800;2739;8451;722;2431;1032;2975;1754;5406
510624;201511;1415;4220;965;3256;204;780;269;785;473;1565
510625;201511;2196;6175;1653;5246;442;1545;356;1081;798;2626
510626;201511;1558;4153;1006;3367;321;1205;285;946;606;2151
510627;201511;744;2096;482;1536;116;410;102;302;218;712
510628;201511;1635;3978;1139;3310;113;352;808;2347;921;2699
510629;201511;1800;5730;1441;4951;438;1696;441;1411;879;3107
510630;201511;2550;8568;1858;7081;462;1974;358;1339;820;3313
510631;201511;384;1080;340;1014;40;114;255;757;295;871
510637;201511;2726;7901;2331;7257;689;2313;908;2805;1597;5118
510642;201511;4702;15357;4039;14387;1186;4643;1772;6493;2958;11136
510645;201511;982;2207;606;1683;186;500;173;523;359;1023
510650;201511;6292;20876;5642;20083;1396;5216;3424;12629;4820;17845
510665;201511;1406;3763;918;2843;220;710;305;923;525;1633
510670;201511;401;898;211;624;22;87;104;286;126;373
510675;201511;6448;20031;5096;17320;1454;5573;1235;3968;2689;9541
510677;201511;2087;5484;1656;4931;196;590;1223;3810;1419;4400
510680;201511;763;2273;584;1902;129;458;177;519;306;977
510682;201511;2247;6986;1711;5963;449;1805;343;1052;792;2857
510685;201511;955;2545;779;2307;91;314;513;1482;604;1796
510700;201511;4316;11149;2910;9125;630;2060;1429;4589;2059;6649
510704;201511;9380;24812;7595;21986;1501;4823;3861;10868;5362;15691
510706;201511;1962;5746;1360;4817;308;1127;696;2568;1004;3695
510710;201511;3469;9553;2398;7334;567;1831;594;1605;1161;3436
510715;201511;713;1749;446;1268;91;279;159;427;250;706
510718;201511;2318;5742;1519;4811;704;2310;394;1369;1098;3679
510719;201511;439;1003;277;790;28;118;135;361;163;479
510720;201511;1159;2747;887;2391;233;700;400;991;633;1691
510724;201511;774;2302;625;2021;146;533;292;871;438;1404
510726;201511;632;1614;476;1353;99;299;199;514;298;813
510729;201511;756;1874;441;1303;96;315;165;469;261;784
510730;201511;2683;7821;2089;6743;564;1999;653;1993;1217;3992
510735;201511;1092;3584;847;3174;189;802;414;1545;603;2347
510740;201511;1106;2724;800;2263;194;515;410;1223;604;1738
510757;201511;683;2296;557;2035;199;737;176;655;375;1392
510760;201511;30403;78544;20182;61186;5864;19299;4917;14349;10781;33648
510770;201511;4357;11151;3687;10353;367;988;2452;7626;2819;8614
510774;201511;413;1129;350;1027;72;242;168;515;240;757
510775;201511;738;2131;604;1903;193;672;162;468;355;1140
510776;201511;553;1532;418;1246;90;297;190;549;280;846
510777;201511;1603;4741;1207;4186;172;638;906;3178;1078;3816
510779;201511;687;2008;506;1664;79;270;246;823;325;1093
510780;201511;3658;10907;2997;9850;763;2636;1240;4246;2003;6882
510785;201511;1850;5246;1374;4420;447;1498;322;1029;769;2527
510787;201511;2253;6742;1753;5850;654;2316;368;1164;1022;3480
510788;201511;544;1405;384;1168;169;531;91;294;260;825
510790;201511;15924;45808;10419;35078;2287;8819;1266;4014;3553;12833
510792;201511;7979;23656;5295;18304;1115;4336;879;2730;1994;7066
510794;201511;1213;3825;988;3388;340;1287;292;914;632;2201
510795;201511;8465;25057;6068;20457;1601;5893;1362;4673;2963;10566
510800;201511;1643;4574;1311;4083;308;1064;546;1548;854;2612
510805;201511;1934;5343;1525;4724;248;839;955;2942;1203;3781
510810;201511;682;1652;515;1423;150;428;225;593;375;1021
510820;201511;764;1807;510;1420;94;303;194;470;288;773
510830;201511;700;2175;584;1989;158;589;283;1030;441;1619
510835;201511;650;1948;482;1607;116;426;183;564;299;990
510840;201511;49699;121304;38245;106375;9306;27224;17870;50915;27176;78139
510850;201511;1545;4370;1106;3576;334;1190;184;478;518;1668
510860;201511;2557;8130;1847;6661;740;2917;100;305;840;3222
510880;201511;665;2173;564;1997;181;701;221;796;402;1497
510885;201511;633;1763;504;1587;100;353;195;601;295;954
510890;201511;899;2777;729;2506;214;830;294;926;508;1756
510895;201511;1108;3412;928;3058;235;891;366;1123;601;2014
520005;201511;1386;4403;1228;4169;329;1176;585;2026;914;3202
520010;201511;1681;5600;1358;4922;517;2171;260;806;777;2977
520013;201511;3573;9826;2597;7997;594;1915;914;2782;1508;4697
520015;201511;468;1316;369;1164;83;283;138;442;221;725
520017;201511;1095;3238;909;2929;233;849;356;1049;589;1898
520020;201511;434;1120;327;969;72;227;146;415;218;642
520025;201511;25794;79763;24417;78076;2743;9467;19436;62070;22179;71537
520030;201511;4591;14203;3829;12921;787;2932;1821;6153;2608;9085
520050;201511;397;999;265;780;21;56;175;534;196;590
520055;201511;736;2225;636;2018;116;357;332;1083;448;1440
520060;201511;1389;4283;1175;3848;252;943;449;1399;701;2342
520080;201511;1799;5276;1522;4892;322;1021;843;2887;1165;3908
520082;201511;1034;2880;918;2690;148;398;606;1848;754;2246
520085;201511;998;2975;834;2650;191;606;269;838;460;1444
520090;201511;984;2247;709;1898;161;403;361;1047;522;1450
520110;201511;42281;121720;32249;106088;11560;43023;5907;18476;17467;61499
520120;201511;197;537;129;415;32;125;30;92;62;217
520130;201511;3460;9692;3125;9186;788;2544;1478;4348;2266;6892
520140;201511;39091;125133;33169;113739;11208;42170;6635;21417;17843;63587
520145;201511;381;999;272;808;66;205;104;293;170;498
520150;201511;503;1313;394;1186;58;199;247;740;305;939
520160;201511;836;2305;667;2048;214;680;193;588;407;1268
520170;201511;4192;9678;3270;8629;300;850;2592;6927;2892;7777
520180;201511;2058;6002;1672;5376;355;1331;728;2264;1083;3595
520215;201511;1917;4912;1588;4394;207;589;994;2771;1201;3360
520235;201511;706;1825;519;1548;109;365;216;607;325;972
520250;201511;1375;4139;1048;3561;276;1070;259;803;535;1873
520260;201511;787;1997;519;1489;80;250;210;563;290;813
520280;201511;509;1509;463;1446;161;531;164;580;325;1111
520310;201511;1222;2898;857;2309;239;694;292;819;531;1513
520320;201511;1809;5608;1473;4955;152;546;926;3176;1078;3722
520330;201511;2631;8095;1956;6867;516;1961;331;1062;847;3023
520340;201511;1860;4608;1440;4086;226;569;942;2867;1168;3436
520350;201511;3106;8463;2388;7136;600;2009;982;2772;1582;4781
520355;201511;1061;3538;949;3354;312;1206;356;1196;668;2402
520357;201511;857;2248;716;2020;53;157;515;1457;568;1614
520360;201511;687;1960;587;1796;132;430;257;791;389;1221
520380;201511;1315;3513;864;2645;135;446;359;1072;494;1518
520390;201511;1051;2477;620;1900;180;637;216;584;396;1221
520393;201511;502;1245;391;1080;58;170;236;636;294;806
520396;201511;751;2377;629;2140;77;306;394;1308;471;1614
520400;201511;1715;4839;1450;4462;233;770;910;2766;1143;3536
520410;201511;1393;3456;1045;2975;216;674;580;1631;796;2305
520420;201511;319;891;226;687;45;147;66;179;111;326
520425;201511;1134;3079;941;2744;252;776;460;1331;712;2107
520430;201511;2030;5293;1271;3879;280;940;400;1095;680;2035
520440;201511;3721;9481;2453;7244;737;2369;528;1522;1265;3891
520450;201511;10268;28468;6918;22132;1526;5290;717;2080;2243;7370
520455;201511;685;2014;545;1769;154;543;173;554;327;1097
520460;201511;887;2498;716;2212;133;483;366;1070;499;1553
520465;201511;800;2236;689;2102;116;375;408;1250;524;1625
520470;201511;1750;5611;1559;5306;370;1280;942;3357;1312;4637
520480;201511;974;2791;720;2351;127;456;327;987;454;1443
520485;201511;1244;3922;1069;3628;273;1057;583;1942;856;2999
520490;201511;3888;12140;3087;10869;929;3394;1331;4832;2260;8226
520495;201511;1261;3447;1100;3238;89;276;907;2715;996;2991
520500;201511;1412;3895;1164;3532;316;1039;479;1422;795;2461
520505;201511;830;2271;683;2054;159;481;346;1044;505;1525
520510;201511;9603;26814;6667;21970;1723;6220;2000;6717;3723;12937
520520;201511;1090;2998;851;2644;268;871;269;840;537;1711
520530;201511;1997;6525;1675;5950;582;2072;514;1944;1096;4016
520540;201511;2932;8195;2180;6808;574;1893;487;1486;1061;3379
520545;201511;1127;3371;921;2953;198;682;300;900;498;1582
520547;201511;715;2255;614;2061;211;729;196;616;407;1345
520549;201511;9738;28158;8003;25846;2379;8011;3679;12007;6058;20018
520551;201511;3468;10495;3187;10093;896;3148;1827;5692;2723;8840
520552;201511;784;2328;704;2217;103;353;483;1542;586;1895
520570;201511;543;1541;389;1272;155;544;90;265;245;809
520580;201511;3264;8101;2182;6531;618;2084;873;2527;1491;4611
520590;201511;1430;4002;1101;3424;247;794;262;741;509;1535
520620;201511;7260;22512;6547;21470;1644;5661;3582;11862;5226;17523
520630;201511;769;1999;564;1698;127;379;255;775;382;1154
520640;201511;2839;7840;2300;6926;645;2005;879;2695;1524;4700
520650;201511;850;2280;634;1872;143;466;309;896;452;1362
520660;201511;351;985;273;871;98;345;88;276;186;621
520670;201511;878;2596;794;2477;56;180;665;2089;721;2269
520680;201511;699;1862;555;1661;148;448;232;705;380;1153
520690;201511;373;962;262;800;59;157;116;379;175;536
520710;201511;544;1404;328;966;6;19;200;578;206;597
520725;201511;1636;4131;1217;3465;229;706;709;1992;938;2698
520735;201511;776;2168;558;1744;141;498;169;499;310;997
520740;201511;1629;4543;1304;4111;245;861;682;2112;927;2973
520750;201511;606;1619;480;1427;97;281;248;774;345;1055
520753;201511;1323;3707;1213;3544;152;422;849;2614;1001;3036
520760;201511;867;2315;750;2154;105;307;528;1571;633;1878
520780;201511;1925;4666;1540;4142;177;446;1031;2790;1208;3236
520790;201511;2739;7173;2203;6396;246;697;1558;4673;1804;5370
520800;201511;15697;45263;13586;42717;2934;8878;8140;27385;11074;36263
520810;201511;1043;2587;832;2332;136;373;584;1738;720;2111
520815;201511;572;1827;424;1517;163;658;17;46;180;704
520830;201511;1545;4092;1271;3799;47;139;1069;3200;1116;3339
520840;201511;1495;4809;1219;4301;407;1600;249;885;656;2485
520850;201511;633;1905;468;1604;111;419;171;564;282;983
520860;201511;6787;19447;4913;16328;1236;4393;1693;5706;2929;10099
520870;201511;111310;293692;74097;230688;20353;69966;17307;50578;37660;120544
520880;201511;7255;20617;5287;17585;1702;6380;755;2373;2457;8753
520890;201511;3788;10648;3047;9413;640;2148;1469;4535;2109;6683
520910;201511;3831;11141;2754;9008;906;3162;512;1602;1418;4764
520915;201511;758;2167;586;1846;131;433;254;773;385;1206
520920;201511;3413;9181;2353;7439;525;1786;791;2564;1316;4350
520929;201511;526;1447;399;1250;83;259;223;719;306;978
520940;201511;1055;3053;867;2773;104;373;608;1927;712;2300
520945;201511;741;1730;582;1459;177;395;256;645;433;1040
520960;201511;965;2830;758;2425;89;292;360;1181;449;1473
520970;201511;3207;9476;2634;8424;650;2296;773;2363;1423;4659
520980;201511;775;2220;695;2108;245;803;317;943;562;1746
520990;201511;2951;9518;2769;9258;478;1662;1852;6430;2330;8092
520993;201511;1025;2626;823;2328;64;196;579;1648;643;1844
520995;201511;2442;6458;2138;6087;385;1038;1434;4207;1819;5245
521000;201511;6968;20939;5756;18753;1547;5626;1788;5465;3335;11091
521010;201511;4036;11639;3090;9851;808;2596;1108;3574;1916;6170
521015;201511;677;1872;569;1698;158;462;257;772;415;1234
521020;201511;3593;10159;2337;7590;643;2215;270;822;913;3037
521030;201511;717;1780;545;1482;106;280;239;674;345;954
521040;201511;5893;15886;4966;14498;1769;5308;1872;5770;3641;11078
521056;201511;881;2668;729;2413;251;876;252;897;503;1773
521060;201511;1307;3435;1042;3032;237;663;465;1428;702;2091
521080;201511;1232;2907;734;2085;91;330;286;661;377;991
521090;201511;2940;7835;2259;6941;687;2204;715;2254;1402;4458
521100;201511;1888;4179;1476;3736;284;645;961;2623;1245;3268
521120;201511;4409;12056;3544;10839;905;2989;1434;4406;2339;7395
521130;201511;1027;2783;776;2302;119;424;439;1262;558;1686
521140;201511;1036;3152;847;2783;233;800;270;888;503;1688
521150;201511;13121;33192;8062;23762;2775;8694;1820;5292;4595;13986
521160;201511;844;1987;512;1411;105;303;220;582;325;885
521170;201511;1222;2917;912;2470;194;560;502;1312;696;1872
521180;201511;6530;21298;5834;20008;1899;6983;1648;5648;3547;12631
521190;201511;9592;27077;6302;21048;1656;5944;1488;4924;3144;10868
521200;201511;759;2010;622;1781;80;258;377;1044;457;1302
521205;201511;581;1660;441;1406;44;151;245;773;289;924
521210;201511;987;2688;637;1980;192;710;155;372;347;1082
521220;201511;4081;10740;3075;9357;901;2984;1174;3547;2075;6531
521225;201511;371;901;299;821;33;79;214;622;247;701
521230;201511;1192;3735;1085;3521;348;1220;532;1674;880;2894
521250;201511;27902;88769;24689;83737;10267;37131;6804;23139;17071;60270
521260;201511;714;1741;583;1548;91;311;363;884;454;1195
521270;201511;1855;5458;1693;5228;145;362;1315;4264;1460;4626
521280;201511;1874;5651;1506;4926;444;1528;424;1340;868;2868
521290;201511;509;1426;383;1230;104;384;158;481;262;865
521295;201511;1159;2903;980;2659;150;412;710;1992;860;2404
521300;201511;1989;5503;1660;4966;263;752;961;2947;1224;3699
521305;201511;784;2187;630;1934;118;339;350;1119;468;1458
521308;201511;4524;13215;3518;11217;942;3080;1339;4207;2281;7287
521310;201511;7753;22843;5562;18565;1444;5282;1167;3589;2611;8871
521340;201511;273;720;250;685;17;46;201;547;218;593
521350;201511;1936;5293;1606;4790;237;681;1058;3288;1295;3969
521370;201511;965;2838;741;2441;234;842;183;576;417;1418
521375;201511;1264;3766;1045;3349;229;808;471;1404;700;2212
521377;201511;1085;2754;1004;2667;77;146;871;2402;948;2548
521380;201511;5256;14899;3728;11975;660;2269;895;2964;1555;5233
521385;201511;493;1350;438;1279;106;336;237;681;343;1017
521390;201511;904;2433;696;2156;181;657;209;614;390;1271
521400;201511;2133;5935;1926;5676;248;816;1476;4363;1724;5179
521405;201511;1387;3877;1072;3301;284;940;467;1431;751;2371
521410;201511;708;2160;647;2062;234;701;283;986;517;1687
521440;201511;1392;3968;1203;3553;164;539;613;1579;777;2118
521450;201511;4162;13179;3306;11477;1077;4014;625;2039;1702;6053
521460;201511;6567;19027;5485;17174;1405;4740;2549;7856;3954;12596
521470;201511;711;2014;520;1635;113;388;88;260;201;648
521480;201511;411;1216;281;921;64;215;98;310;162;525
521483;201511;2862;7444;2178;6264;587;1731;644;1789;1231;3520
521486;201511;1555;3973;1296;3597;122;338;957;2667;1079;3005
521487;201511;627;1596;428;1260;118;359;80;230;198;589
521490;201511;775;2269;627;2024;62;279;400;1233;462;1512
521500;201511;1342;4238;1026;3522;197;761;293;854;490;1615
521520;201511;900;2122;681;1827;186;510;308;881;494;1391
521523;201511;12707;46163;11964;44794;4240;17278;1484;6275;5724;23553
521525;201511;1068;2757;914;2546;120;394;595;1602;715;1996
521530;201511;1754;4928;1051;3479;241;847;170;522;411;1369
521540;201511;952;2538;635;1985;148;551;205;589;353;1140
521550;201511;1231;3128;911;2506;224;664;435;1148;659;1812
521560;201511;3864;12659;3276;11802;1259;4986;1067;3732;2326;8718
521565;201511;643;1600;537;1471;90;222;348;975;438;1197
521570;201511;4683;12857;2987;9453;691;2422;695;2124;1386;4546
521580;201511;581;1330;380;1046;98;285;117;294;215;579
521590;201511;691;1916;564;1708;170;559;122;361;292;920
521600;201511;536;1443;376;1164;102;337;97;268;199;605
521630;201511;1453;3629;1032;3011;263;898;201;491;464;1389
521640;201511;2030;5182;1555;4528;448;1336;630;1915;1078;3251
521645;201511;599;1751;456;1426;77;263;169;480;246;743
521680;201511;1454;4608;1214;4120;572;2105;193;593;765;2698
521690;201511;578;1684;505;1557;122;436;227;632;349;1068
521710;201511;2695;8190;2221;7260;489;1667;886;2902;1375;4569
521720;201511;1883;5292;1532;4680;336;1025;830;2469;1166;3494
521730;201511;3687;12026;3203;11054;1176;4506;708;2143;1884;6649
521740;201511;3534;9592;2730;8457;765;2574;1148;3750;1913;6324
521760;201511;12867;41875;11268;39056;2837;10766;4797;16644;7634;27410
521770;201511;2729;7881;2172;6828;791;2660;559;1647;1350;4307
521800;201511;7337;21797;6280;19998;1924;6561;2292;7485;4216;14046
521805;201511;894;2030;638;1657;151;352;347;979;498;1331
521810;201511;884;2218;642;1857;144;443;274;816;418;1259
521830;201511;5398;16828;4770;15890;817;2982;3068;10211;3885;13193
521839;201511;731;2001;547;1658;102;333;185;537;287;870
521850;201511;6906;18565;5247;15573;1299;4075;1621;4394;2920;8469
521860;201511;1948;5328;1480;4563;346;1180;436;1299;782;2479
521870;201511;533;1754;431;1520;117;444;119;386;236;830
521878;201511;736;2130;516;1668;89;323;217;667;306;990
521880;201511;25272;63856;16195;48926;4146;13455;5025;15282;9171;28737
521890;201511;3503;10365;2706;8799;795;2791;591;1824;1386;4615
521900;201511;1405;3704;1015;3136;248;816;355;994;603;1810
521910;201511;967;2625;858;2492;145;442;518;1568;663;2010
521920;201511;326;975;274;878;91;331;66;177;157;508
521925;201511;658;2001;547;1796;105;384;202;611;307;995
521930;201511;3724;11928;3188;10842;1009;3609;649;2188;1658;5797
521935;201511;616;1764;538;1622;156;468;238;708;394;1176
521940;201511;1032;2839;832;2522;205;674;387;1141;592;1815
521945;201511;668;2142;597;2037;108;367;370;1349;478;1716
521950;201511;621;1656;496;1466;75;239;296;889;371;1128
521960;201511;718;2130;579;1868;115;421;256;795;371;1216
521970;201511;2557;6856;2160;6364;249;697;1636;5013;1885;5710
521971;201511;1092;2876;766;2264;145;436;205;564;350;1000
521973;201511;917;2848;750;2530;165;604;281;919;446;1523
521975;201511;12529;34096;11493;32864;2058;6166;7912;22537;9970;28703
521980;201511;1950;5536;1691;5220;258;701;1299;4179;1557;4880
521990;201511;1108;3139;922;2854;102;352;600;1880;702;2232
522000;201511;2343;6347;1689;5513;235;846;955;3223;1190;4069
522005;201511;399;978;266;766;82;226;89;271;171;497
522010;201511;3296;9465;2722;8493;943;3068;615;1905;1558;4973
522015;201511;911;2685;760;2441;175;559;376;1221;551;1780
522020;201511;5209;13482;4086;11819;964;2862;2050;5883;3014;8745
522026;201511;619;1663;444;1454;116;426;153;513;269;939
522028;201511;526;1520;429;1304;72;222;255;773;327;995
522040;201511;2447;5924;1849;5172;408;1172;1065;3000;1473;4172
522045;201511;15099;49072;12300;43150;3591;13793;2288;7738;5879;21531
522050;201511;1189;3302;849;2655;212;717;266;728;478;1445
522060;201511;2706;8013;2096;7066;593;2222;943;3115;1536;5337
522068;201511;1651;5157;1499;4978;156;445;1172;4103;1328;4548
522070;201511;768;2288;685;2154;86;334;476;1486;562;1820
522100;201511;588;1724;513;1611;189;668;202;593;391;1261
522108;201511;896;2710;749;2485;65;265;564;1834;629;2099
522119;201511;1376;4212;1161;3873;272;968;536;1828;808;2796
522130;201511;365;1027;302;956;93;313;177;558;270;871
522140;201511;17970;49297;14332;43031;4155;13396;4283;12178;8438;25574
522145;201511;809;2249;709;2091;289;877;228;708;517;1585
522150;201511;884;2464;762;2259;219;658;279;809;498;1467
522155;201511;810;2278;703;2112;135;363;445;1409;580;1772
522157;201511;698;1923;588;1765;49;177;461;1370;510;1547
522160;201511;5970;16876;4194;13569;1264;4565;448;1312;1712;5877
522170;201511;3064;8552;2464;7535;809;2570;590;1830;1399;4400
522180;201511;331;947;254;808;80;284;72;229;152;513
522185;201511;15310;43959;12677;40510;3329;11223;6805;21896;10134;33119
522190;201511;936;2309;706;1973;109;321;367;1058;476;1379
522200;201511;1662;5290;1375;4682;368;1367;383;1221;751;2588
522205;201511;1435;4041;1156;3581;267;883;544;1641;811;2524
522220;201511;1353;3625;1075;3280;264;794;532;1787;796;2581
522230;201511;1224;3433;1038;3141;122;428;650;1946;772;2374
530010;201511;232468;724980;203570;672104;55736;203817;68361;218472;124097;422289
110001;201510;3843;12094;3163;11016;710;2613;1598;5577;2308;8190
110002;201510;13209;39188;10469;34237;3087;11002;3637;11546;6724;22548
110003;201510;802;2541;708;2369;203;715;178;550;381;1265
110004;201510;10167;31894;8221;27831;2607;9530;1815;6050;4422;15580
110005;201510;1850;5846;1606;5385;529;1826;656;2179;1185;4005
110006;201510;2027;6114;1363;4797;397;1537;224;648;621;2185
110007;201510;1364;4145;1270;3998;351;1202;540;1889;891;3091
110008;201510;2408;8087;2256;7868;390;1264;1599;5845;1989;7109
110009;201510;4640;13898;3700;12372;1051;3882;1306;4204;2357;8086
110010;201510;7683;22578;6685;21270;1753;5449;3455;12030;5208;17479
110011;201510;8054;24562;6762;22059;2206;7653;2375;7554;4581;15207
110012;201510;14220;42594;11780;38055;3626;12297;3578;11543;7204;23840
110013;201510;5399;16921;4459;15292;1622;5742;1333;4738;2955;10480
110014;201510;4211;12263;3603;11284;895;2924;1909;5980;2804;8904
110015;201510;5023;14945;3655;12367;1081;4006;883;2874;1964;6880
110018;201510;4299;11981;3221;10452;849;3115;1252;3827;2101;6942
110020;201510;59911;166753;45184;146311;10107;34564;21764;72214;31871;106778
110025;201510;4381;12603;3567;11094;655;2151;2153;6627;2808;8778
110026;201510;655;2020;604;1944;141;460;349;1136;490;1596
110028;201510;7551;21572;5328;17503;1416;5090;808;2471;2224;7561
110029;201510;1351;3994;1133;3613;337;1110;454;1469;791;2579
110030;201510;10614;28631;7980;24922;2059;7041;3376;10593;5435;17634
110032;201510;4024;12634;3495;11559;1114;3810;1155;3761;2269;7571
110033;201510;5368;17015;4830;16087;1526;5097;1945;6801;3471;11898
110034;201510;3445;9210;2914;8518;747;2220;1766;5137;2513;7357
110037;201510;2045;6804;1706;6122;443;1698;760;2671;1203;4369
110040;201510;3516;10977;3026;10055;903;3232;1217;3882;2120;7114
110045;201510;5162;16699;4450;15780;1405;5415;2211;7794;3616;13209
110050;201510;1689;5392;1433;4932;433;1554;674;2323;1107;3877
110060;201510;831;2715;681;2411;236;943;164;532;400;1475
110070;201510;2010;6651;1877;6372;529;1979;912;2975;1441;4954
110080;201510;4043;11380;3589;10849;544;1575;2648;8306;3192;9881
110090;201510;769;2277;613;1994;149;555;273;822;422;1377
110092;201510;1328;4401;1228;4268;196;735;809;2871;1005;3606
110094;201510;3533;10673;3135;10103;1035;3546;1343;4291;2378;7837
110100;201510;2217;6992;1979;6551;662;2295;865;2814;1527;5109
110110;201510;1663;5281;1504;5065;616;2125;441;1530;1057;3655
110120;201510;1822;5822;1410;4898;432;1568;304;1026;736;2594
110130;201510;2552;7327;1892;6171;626;2163;428;1346;1054;3509
110140;201510;2458;8058;2090;7333;520;1959;846;2894;1366;4853
110143;201510;1279;4017;990;3514;295;1080;433;1551;728;2631
110145;201510;1035;2953;831;2612;212;739;428;1302;640;2041
110146;201510;421;1290;364;1203;71;237;207;705;278;942
110147;201510;782;2244;613;1946;159;527;226;645;385;1172
110148;201510;1269;3801;922;3053;265;926;168;517;433;1443
110149;201510;3367;10087;2710;8978;874;2907;1178;4039;2052;6946
110150;201510;2462;7185;2088;6622;566;1910;799;2555;1365;4465
110155;201510;852;2613;755;2374;188;632;352;1050;540;1682
110160;201510;2006;6307;1648;5616;585;2064;575;1928;1160;3992
110170;201510;2984;8324;2149;6772;475;1561;1084;3355;1559;4916
110175;201510;1725;5141;1320;4610;221;819;737;2671;958;3490
110180;201510;1410;4118;1168;3747;271;871;677;2211;948;3082
120001;201510;2783;9590;2578;9239;526;2011;1578;5769;2104;7780
120005;201510;1535;6354;1441;6170;161;768;1077;4736;1238;5504
120010;201510;4535;15604;4287;15213;646;2272;3135;11428;3781;13700
120013;201510;1768;7036;1687;6915;397;1590;1010;4382;1407;5972
120017;201510;2030;7285;1879;7008;518;1980;858;3500;1376;5480
120020;201510;13983;62271;13494;61281;2142;9933;9455;44362;11597;54295
120025;201510;2500;8641;2400;8490;463;1748;1540;5494;2003;7242
120030;201510;6050;23848;5914;23693;270;1183;5323;21485;5593;22668
120032;201510;1453;6978;1389;6823;182;1069;998;4913;1180;5982
120033;201510;3532;14062;3450;13910;339;1360;2948;12088;3287;13448
120034;201510;2002;8309;1925;8176;168;898;1562;6553;1730;7451
120035;201510;2945;13667;2889;13552;236;1250;2439;11529;2675;12779
120038;201510;2689;9754;2554;9485;654;2473;1354;5161;2008;7634
120039;201510;1618;8232;1577;8138;174;1018;1201;6261;1375;7279
120040;201510;44953;160065;40606;151461;10077;40542;19761;74636;29838;115178
120042;201510;2855;12337;2697;11969;381;1838;1896;8554;2277;10392
120043;201510;891;4245;859;4189;74;350;693;3508;767;3858
120045;201510;4233;14461;4140;14342;612;2227;3287;11455;3899;13682
120050;201510;7903;32836;7533;32007;1280;5668;4969;21874;6249;27542
120060;201510;7320;33251;7174;32946;694;3713;5728;26470;6422;30183
120070;201510;2627;9926;2551;9751;441;1648;1669;6609;2110;8257
120080;201510;3521;13338;3320;13000;632;2602;2271;9066;2903;11668
130002;201510;3027;12563;2845;12258;202;1032;2371;10225;2573;11257
130006;201510;1951;8284;1711;7834;249;1281;1187;5481;1436;6762
130008;201510;2097;8381;1978;8160;212;899;1537;6440;1749;7339
130010;201510;2913;9703;2530;9256;209;832;2160;7940;2369;8772
130014;201510;3189;10432;2815;9827;471;1781;1801;6312;2272;8093
130020;201510;2675;9732;2596;9583;62;315;2281;8326;2343;8641
130030;201510;7258;27500;6974;27166;556;1940;5975;23981;6531;25921
130040;201510;3818;11677;3411;11136;280;1000;2775;9173;3055;10173
130050;201510;6128;24723;5633;23978;487;2059;4484;19874;4971;21933
130060;201510;5600;26308;5344;25852;539;3110;4156;20037;4695;23147
130063;201510;3595;15948;3520;15852;324;1543;2964;13521;3288;15064
130068;201510;3100;12979;2797;12341;382;1819;1814;8090;2196;9909
130070;201510;6742;21741;5954;20770;664;2345;4552;16252;5216;18597
130080;201510;4989;22389;4752;22004;804;3970;3255;15405;4059;19375
130083;201510;2137;8515;2014;8329;313;1442;1365;5658;1678;7100
130090;201510;2577;9313;2486;9167;128;609;2165;7920;2293;8529
130100;201510;5606;20896;5447;20688;188;820;5059;19237;5247;20057
130110;201510;6560;21240;6150;20722;752;2359;4842;16852;5594;19211
130115;201510;4327;15340;4053;14906;206;816;3502;12932;3708;13748
130120;201510;14190;54140;13407;53138;1494;5988;10754;43634;12248;49622
130130;201510;3733;15435;3664;15296;273;1353;3090;12900;3363;14253
130140;201510;6235;24180;6133;24064;186;795;5746;22549;5932;23344
130150;201510;3371;13232;3297;13141;193;1042;2893;11339;3086;12381
130160;201510;4156;17333;4016;17131;523;2627;3223;13574;3746;16201
130165;201510;2842;11769;2709;11539;301;1420;2088;8953;2389;10373
130170;201510;8938;32412;7886;31050;1108;4662;5760;23087;6868;27749
130180;201510;3471;11328;3376;11196;151;361;3099;10457;3250;10818
130185;201510;11154;35765;10030;34475;912;2888;8209;29391;9121;32279
130190;201510;17085;58477;14957;55673;2781;10406;9714;37647;12495;48053
130195;201510;1940;8093;1868;7987;127;565;1624;7035;1751;7600
130200;201510;1989;7093;1824;6835;455;1696;1097;4224;1552;5920
130210;201510;1200;4726;1132;4634;116;576;925;3760;1041;4336
130220;201510;1955;8054;1774;7700;319;1591;969;4183;1288;5774
130230;201510;3634;16456;3380;16021;403;2016;2489;12239;2892;14255
130240;201510;8413;32022;7740;31023;440;2306;6625;26519;7065;28825
130250;201510;19620;68397;18470;66898;2796;10101;13444;50577;16240;60678
130255;201510;4122;14541;3876;14118;180;702;3403;12508;3583;13210
130260;201510;244456;801101;218324;755040;63543;232084;95347;332546;158890;564630
130270;201510;6942;29365;6389;28472;905;4210;4578;21080;5483;25290
130280;201510;3219;13244;3115;13105;171;766;2788;11900;2959;12666
130290;201510;11276;39656;10809;39110;139;248;10406;38360;10545;38608
130300;201510;4255;16710;4067;16404;276;1303;3479;14041;3755;15344
130310;201510;5012;18998;4633;18511;365;1518;3830;15595;4195;17113
130320;201510;2902;10339;2641;9968;379;1529;1832;7043;2211;8572
130330;201510;3572;13027;3275;12648;232;1084;2701;10401;2933;11485
130340;201510;17371;66955;16185;65431;2864;11543;11827;49334;14691;60877
130350;201510;3255;13576;3172;13457;298;1635;2581;10797;2879;12432
130353;201510;6006;18378;5228;17354;1203;3911;3137;11136;4340;15047
130356;201510;4507;16206;4233;15798;409;1465;3326;12869;3735;14334
130360;201510;3240;9148;2871;8746;163;455;2577;8006;2740;8461
130370;201510;5239;20600;4462;19501;251;1448;3513;15323;3764;16771
130380;201510;7694;31923;7376;31465;525;2557;6273;26931;6798;29488
130390;201510;4838;21570;4484;20925;480;2521;3332;15769;3812;18290
130395;201510;2077;7452;1824;6921;298;1221;1146;4279;1444;5500
130400;201510;2079;7942;1991;7822;159;757;1731;6751;1890;7508
130406;201510;10591;40108;9509;38494;2219;9333;5779;24022;7998;33355
130410;201510;3884;14897;3497;14168;1063;4569;1556;6512;2619;11081
130420;201510;10504;44275;9995;43470;2649;11189;6242;28590;8891;39779
130423;201510;3228;12569;3023;12276;272;1351;2499;10070;2771;11421
130426;201510;2142;9382;2078;9268;296;1375;1544;7027;1840;8402
130430;201510;3296;11812;3163;11608;374;1458;2431;9002;2805;10460
130440;201510;3492;12757;3328;12568;270;1061;2832;10768;3102;11829
140002;201510;1635;5336;1517;5170;156;547;1090;3765;1246;4312
140005;201510;3031;8943;2883;8778;106;283;2715;8331;2821;8614
140010;201510;53615;158054;44181;143396;10963;37871;19610;65669;30573;103540
140015;201510;2932;9383;2736;9136;312;907;2189;7597;2501;8504
140017;201510;3255;10151;2935;9745;302;952;2234;7694;2536;8646
140020;201510;4416;15045;4048;14511;622;2421;2816;10073;3438;12494
140023;201510;2144;7262;1871;6835;258;1031;1283;4731;1541;5762
140028;201510;2109;5858;1971;5664;277;881;1395;3825;1672;4706
140030;201510;3727;11736;3505;11422;514;1413;2556;8681;3070;10094
140040;201510;1707;7958;1651;7831;114;668;1368;6477;1482;7145
140045;201510;2472;9114;2245;8781;446;1613;1464;6193;1910;7806
140047;201510;5448;15447;4814;14574;1374;4267;2254;7223;3628;11490
140050;201510;1460;4590;1310;4394;324;1099;732;2505;1056;3604
140060;201510;1508;4609;1346;4356;290;993;831;2715;1121;3708
140070;201510;1427;7686;1382;7522;103;688;1127;6117;1230;6805
150010;201510;34150;105341;32137;102616;2112;7284;26229;84006;28341;91290
150013;201510;1677;4916;1531;4745;169;510;1196;3788;1365;4298
150020;201510;12336;41253;11906;40651;1097;3615;9956;34580;11053;38195
150030;201510;6797;29206;6569;28854;724;2888;5315;24204;6039;27092
150034;201510;4237;11741;3997;11432;234;677;3463;9910;3697;10587
150040;201510;12717;41113;10828;38836;2121;6960;7334;28371;9455;35331
150050;201510;5712;22151;5481;21743;337;1625;4652;18446;4989;20071
150060;201510;17026;53435;15486;50994;2781;8963;10127;34407;12908;43370
150070;201510;5916;24199;5292;23530;356;1755;4650;20835;5006;22590
150080;201510;68500;179362;58157;165346;11313;31106;34035;100895;45348;132001
150085;201510;5250;17921;4982;17564;525;1586;4058;14900;4583;16486
150090;201510;9991;38390;9463;37622;979;3907;7340;29830;8319;33737
150095;201510;5234;17297;4769;16598;430;1386;3769;13575;4199;14961
150100;201510;3296;12265;3098;11920;192;933;2472;9344;2664;10277
150110;201510;3276;16311;3264;16282;248;1203;2821;14305;3069;15508
150120;201510;6160;23417;6012;23160;638;2379;4832;18987;5470;21366
150125;201510;748;2177;658;2066;118;409;434;1334;552;1743
150130;201510;21747;66030;20098;63688;2382;7300;15010;48771;17392;56071
150140;201510;153201;434816;144526;423334;16524;47480;112252;333443;128776;380923
150145;201510;4498;14382;4086;13852;621;2178;3018;10439;3639;12617
150150;201510;11777;36013;10723;34377;1887;6289;6936;22483;8823;28772
150157;201510;3111;9347;2696;8753;379;1374;1873;6141;2252;7515
150160;201510;3032;9806;2828;9508;906;3091;1420;4943;2326;8034
150170;201510;21573;79590;20286;77448;3324;12916;14015;54459;17339;67375
150172;201510;3060;10475;2682;9821;460;1695;1789;6731;2249;8426
150175;201510;1980;5946;1851;5798;167;543;1495;4824;1662;5367
150178;201510;10006;31259;8886;29940;1175;4166;6318;21912;7493;26078
150180;201510;18079;72442;17360;71482;1492;6790;14382;59715;15874;66505
150190;201510;6977;23412;6660;22964;321;1143;5895;20572;6216;21715
150195;201510;5085;16966;4717;16365;312;1181;3969;13856;4281;15037
150200;201510;5257;16755;5025;16487;133;427;4670;15490;4803;15917
150210;201510;24243;92074;23391;90862;2349;8907;18789;75214;21138;84121
150215;201510;6644;20953;5761;19508;1642;5795;2417;8315;4059;14110
150220;201510;12170;37817;10797;35622;2425;8213;5589;18801;8014;27014
150230;201510;11237;36698;9974;34860;1355;5202;6853;24100;8208;29302
150240;201510;35017;103789;30409;95751;10017;32554;9829;32116;19846;64670
150250;201510;4075;16647;3925;16421;573;2464;2879;12415;3452;14879
150260;201510;2042;8156;1933;7949;385;1579;1186;5032;1571;6611
150270;201510;8576;26329;6838;24126;1779;6533;3777;13633;5556;20166
150275;201510;5836;21238;5532;20734;734;2760;3992;15269;4726;18029
150276;201510;2081;6276;1850;5949;446;1539;1197;3807;1643;5346
150277;201510;4847;14996;4189;14175;805;2857;2784;9659;3589;12516
150280;201510;5759;25674;5566;25244;1119;5093;3656;17100;4775;22193
150285;201510;2737;10871;2571;10552;517;2193;1564;6683;2081;8876
150290;201510;9643;28342;9186;27816;734;1852;7794;24394;8528;26246
150293;201510;9787;26714;7378;23304;2246;7515;2588;8820;4834;16335
150295;201510;7030;21314;5830;19867;1459;5057;3262;11804;4721;16861
150300;201510;1811;6338;1723;6225;151;609;1338;4894;1489;5503
150304;201510;4018;12728;3521;11979;608;2070;2270;7977;2878;10047
150307;201510;6489;21826;6011;21150;422;1489;4964;17595;5386;19084
150309;201510;6145;21222;5605;20444;1251;4526;3481;13341;4732;17867
150310;201510;5927;26029;5714;25690;690;3277;4427;20200;5117;23477
150320;201510;9285;22271;8573;21523;570;1168;7367;18884;7937;20052
150330;201510;13524;46575;12616;45237;1705;6073;9362;34599;11067;40672
150340;201510;2371;7692;2187;7409;289;1021;1552;5305;1841;6326
150345;201510;6523;21775;6095;21196;610;2112;4854;17229;5464;19341
150350;201510;7551;23965;7035;23271;1203;3389;5047;17531;6250;20920
150360;201510;21030;65509;18360;62003;3075;10440;12238;42868;15313;53308
150370;201510;9707;35694;9119;34896;1297;4817;6897;27365;8194;32182
150375;201510;2826;12373;2753;12275;252;1098;2332;10596;2584;11694
150380;201510;9810;28564;8645;26926;644;2091;7080;22304;7724;24395
150390;201510;7775;33462;7264;32488;1350;5924;4653;21647;6003;27571
150400;201510;5776;22891;5523;22370;538;2189;4299;17806;4837;19995
150405;201510;8177;24687;7278;23576;1396;3762;4849;17264;6245;21026
150410;201510;1556;6008;1457;5799;205;928;928;3715;1133;4643
150420;201510;35590;120647;30122;111427;9067;36344;10838;41591;19905;77935
150430;201510;7124;24126;6774;23561;964;3233;4891;17509;5855;20742
150440;201510;5379;18790;5156;18478;959;3294;3615;13422;4574;16716
150442;201510;20459;60133;18290;56779;3467;10829;11222;35768;14689;46597
150445;201510;5087;17703;4716;17055;681;2452;3385;12506;4066;14958
150450;201510;4335;20838;4181;20601;367;1858;3450;17341;3817;19199
150460;201510;6445;24976;5933;24363;390;2026;5011;20789;5401;22815
150470;201510;17075;52401;16413;51618;508;1322;15328;48838;15836;50160
150475;201510;2734;9489;2513;9200;253;923;2011;7532;2264;8455
150480;201510;13638;46545;12644;45047;1320;4964;9990;36034;11310;40998
150490;201510;6813;26313;6658;26078;300;1291;5860;23153;6160;24444
150495;201510;4853;18165;4735;18004;247;1010;4283;16345;4530;17355
150497;201510;2764;10116;2502;9579;792;3200;1143;4387;1935;7587
150500;201510;3116;8639;2889;8320;308;875;2212;6359;2520;7234
150503;201510;3765;11626;3233;10954;1118;3906;1614;5700;2732;9606
150506;201510;11380;39604;10286;38014;2458;8653;6346;25029;8804;33682
150510;201510;9468;37194;8688;35659;1420;5961;5710;24295;7130;30256
150520;201510;6646;26082;6528;25918;286;1115;6019;24111;6305;25226
150530;201510;12041;41324;10802;39421;1194;4148;8191;30580;9385;34728
150540;201510;4592;14119;4114;13440;301;1009;3378;11058;3679;12067
150543;201510;5491;17103;4896;16218;1034;3532;3004;10199;4038;13731
150548;201510;8984;28732;8405;27990;561;1837;7431;25002;7992;26839
150549;201510;2091;6687;1920;6489;91;330;1715;5851;1806;6181
150550;201510;19875;62611;17250;58087;5231;18136;6766;23409;11997;41545
150553;201510;23010;78941;18995;70436;6965;27617;4620;17184;11585;44801
150555;201510;1649;5032;1426;4657;100;380;1095;3571;1195;3951
150560;201510;1955;6327;1829;6060;277;899;1177;3903;1454;4802
150563;201510;2854;9246;2629;8854;651;2394;1421;4744;2072;7138
150565;201510;3748;12909;3406;12380;223;1010;2752;10045;2975;11055
150570;201510;5604;20866;5461;20610;412;1812;4382;16602;4794;18414
150580;201510;9467;39675;9227;39392;649;2687;8052;35159;8701;37846
150590;201510;5652;22735;5473;22507;142;597;5118;21198;5260;21795
150600;201510;7818;30256;7517;29812;407;1691;6642;26616;7049;28307
150610;201510;2360;8067;2156;7638;254;1003;1486;5189;1740;6192
150611;201510;2660;9312;2486;8969;206;791;1963;7130;2169;7921
150613;201510;12033;36435;10079;33461;3323;11588;4097;13932;7420;25520
150616;201510;3033;9233;2343;8096;577;2191;854;2815;1431;5006
150618;201510;6375;21914;5826;20903;1622;5932;2909;10673;4531;16605
150619;201510;5183;17662;4807;17061;603;2338;3424;12177;4027;14515
150620;201510;6314;22687;5772;21972;760;2914;4435;17300;5195;20214
150630;201510;5706;17206;5400;16839;578;1865;4379;13912;4957;15777
150635;201510;3983;13044;3598;12278;819;2894;1803;6235;2622;9129
150640;201510;1749;5330;1686;5250;258;751;1303;4290;1561;5041
150650;201510;12409;37384;10955;34832;2964;9550;4848;15970;7812;25520
150655;201510;4895;16482;4618;15970;660;2332;3342;11721;4002;14053
150658;201510;4187;13087;3759;12472;924;3340;2196;7345;3120;10685
150660;201510;5495;17396;4996;16670;1206;3980;2724;9423;3930;13403
150670;201510;6770;18468;5691;17108;859;2691;4215;12976;5074;15667
150680;201510;55292;197327;48637;185619;14851;58891;19838;80716;34689;139607
150690;201510;2014;6243;1812;5919;329;1001;1143;3864;1472;4865
150700;201510;6176;19107;5630;18393;1045;3475;3664;12304;4709;15779
150710;201510;4244;14255;3797;13519;453;1689;2734;9918;3187;11607
150715;201510;4964;15578;4304;14561;540;2026;3129;10618;3669;12644
150720;201510;6414;26122;6028;25418;848;3711;4257;18527;5105;22238
150730;201510;9588;32753;8977;31739;1004;3577;7097;25640;8101;29217
150740;201510;3702;11796;3304;11072;642;2258;1830;6148;2472;8406
150745;201510;5298;16672;4794;15963;1165;4068;2913;9684;4078;13752
150746;201510;1370;4496;1306;4380;171;608;923;3114;1094;3722
150747;201510;5354;16705;4696;15882;415;1196;3612;13057;4027;14253
150750;201510;3146;10451;2925;10171;218;860;2381;8302;2599;9162
150760;201510;10923;35656;10181;34637;2222;7689;6217;21712;8439;29401
150770;201510;5747;21943;5390;21254;472;1750;4474;18590;4946;20340
150775;201510;1141;3473;995;3212;204;807;533;1642;737;2449
150780;201510;3172;10394;3091;10291;93;326;2862;9551;2955;9877
150790;201510;4939;16062;4571;15620;376;1362;3694;13200;4070;14562
150795;201510;15283;47725;13633;45275;2951;9737;8139;28059;11090;37796
150796;201510;2964;8854;2695;8540;414;1322;1975;6407;2389;7729
150797;201510;3625;12336;3351;11882;123;531;2883;10189;3006;10720
150800;201510;13717;45426;12592;44044;2734;9078;8327;30729;11061;39807
150803;201510;6491;23573;6089;22917;682;2716;4497;17120;5179;19836
150805;201510;2609;9300;2440;9012;338;1236;1751;6598;2089;7834
150808;201510;5677;19011;4727;17198;1901;7460;773;2824;2674;10284
150810;201510;18939;58721;15952;55028;2328;7693;10747;39127;13075;46820
150812;201510;5222;16385;4780;15626;512;1973;3380;10649;3892;12622
150815;201510;8391;27435;7541;26368;793;2756;6038;21581;6831;24337
150820;201510;11312;32286;10033;30858;741;1731;8324;26394;9065;28125
150830;201510;12833;48166;11803;46637;759;3681;9773;39509;10532;43190
150835;201510;2072;7272;1908;6953;470;1739;897;3358;1367;5097
150840;201510;6787;20699;5598;18710;1325;4844;2674;8841;3999;13685
160005;201510;706;2511;663;2424;65;283;523;1877;588;2160
160010;201510;1370;4553;1366;4548;68;144;1270;4340;1338;4484
160015;201510;1673;6189;1634;6132;95;325;1462;5613;1557;5938
160020;201510;2024;7154;1874;6946;241;909;1385;5269;1626;6178
160021;201510;951;4105;916;4040;148;756;628;2775;776;3531
160023;201510;1032;4103;1019;4079;100;387;859;3488;959;3875
160025;201510;1281;3940;1265;3923;32;126;1218;3751;1250;3877
160027;201510;8132;24363;7507;23662;2633;7824;3827;13149;6460;20973
160030;201510;44667;158731;39607;149434;9578;36271;21526;85554;31104;121825
160040;201510;4148;16358;4048;16206;192;1042;3656;14437;3848;15479
160050;201510;3163;11981;2837;11494;1329;5286;1062;4633;2391;9919
160053;201510;2741;10549;2671;10445;526;2160;1801;7129;2327;9289
160055;201510;633;2471;623;2459;78;340;482;1902;560;2242
160060;201510;15470;52322;14479;51193;3052;10177;9666;35644;12718;45821
160070;201510;2467;9748;2328;9499;199;968;1935;7829;2134;8797
160080;201510;2575;9675;2539;9628;108;533;2352;8831;2460;9364
170025;201510;524;1724;479;1654;130;456;235;853;365;1309
170030;201510;1162;3792;1020;3532;317;1145;357;1252;674;2397
170035;201510;1522;4392;1209;3816;323;1125;439;1351;762;2476
170040;201510;1885;6023;1656;5714;238;921;1034;3731;1272;4652
170070;201510;1813;4785;1426;4264;316;1029;756;2208;1072;3237
170100;201510;2455;7203;2135;6692;249;837;1636;5116;1885;5953
170105;201510;766;2381;597;2034;121;476;304;980;425;1456
170110;201510;1045;3260;883;2986;204;748;397;1331;601;2079
170130;201510;1359;4266;1145;3865;317;1112;509;1749;826;2861
170190;201510;1579;4608;1187;3966;491;1588;240;918;731;2506
170200;201510;1636;4571;1054;3442;268;965;273;833;541;1798
170210;201510;31776;90124;25187;79258;7246;24548;7153;23370;14399;47918
170215;201510;1185;3695;1000;3404;83;347;730;2452;813;2799
170220;201510;5626;19356;5188;18484;1189;4477;2803;10022;3992;14499
170230;201510;1439;4586;1184;4088;254;1017;522;1702;776;2719
170240;201510;2672;8120;2225;7420;308;1213;1466;4832;1774;6045
170255;201510;3357;10740;2796;9770;852;3001;1164;4244;2016;7245
170270;201510;1029;2563;713;2131;79;254;477;1414;556;1668
170290;201510;2736;8413;2513;8149;179;450;2154;7283;2333;7733
170300;201510;1945;5963;1608;5400;218;825;1019;3420;1237;4245
170305;201510;770;2297;617;2011;120;430;303;988;423;1418
170307;201510;1085;3796;898;3437;182;795;437;1714;619;2509
170310;201510;1625;4483;1216;3777;323;1072;523;1638;846;2710
170320;201510;1123;3256;817;2717;203;714;278;942;481;1656
170330;201510;753;2469;685;2358;88;336;495;1670;583;2006
170360;201510;458;1465;379;1327;91;337;164;561;255;898
170370;201510;1376;3908;1085;3435;215;770;563;1762;778;2532
170380;201510;1806;5763;1449;5175;248;1019;768;2686;1016;3705
170382;201510;542;1796;461;1661;105;420;249;885;354;1305
170384;201510;1532;6250;1410;6014;325;1518;775;3294;1100;4812
170386;201510;918;2738;791;2547;187;676;347;1085;534;1761
170388;201510;644;1919;519;1711;107;422;199;624;306;1046
170389;201510;920;3086;832;2940;88;354;600;2097;688;2451
170390;201510;1280;3713;1114;3503;114;390;840;2687;954;3077
170410;201510;544;1706;458;1552;43;177;292;975;335;1152
170460;201510;499;1351;340;1081;82;294;108;323;190;617
170510;201510;790;2626;644;2351;81;351;333;1182;414;1533
170550;201510;6717;19141;4957;16020;1586;5612;774;2440;2360;8052
170555;201510;1343;3860;1047;3398;235;819;500;1646;735;2465
170560;201510;1019;3381;801;3086;175;738;443;1773;618;2511
170600;201510;1328;3848;1182;3650;264;801;743;2380;1007;3181
170610;201510;1579;4855;1254;4325;135;543;781;2690;916;3233
170625;201510;430;1323;331;1129;65;224;95;334;160;558
170650;201510;1245;4001;1060;3658;250;937;443;1571;693;2508
170700;201510;4091;12879;3303;11539;688;2650;1432;5146;2120;7796
170710;201510;1820;5376;1472;4743;232;798;877;2841;1109;3639
170720;201510;1826;4936;1527;4452;305;791;982;3033;1287;3824
170730;201510;997;2867;808;2574;213;717;357;1140;570;1857
170740;201510;2178;7711;1897;7200;291;1170;1228;4724;1519;5894
170755;201510;805;2486;652;2157;136;517;241;770;377;1287
170765;201510;1351;3645;1038;3122;289;923;410;1250;699;2173
170770;201510;1746;5877;1586;5594;262;987;978;3455;1240;4442
170820;201510;3640;11563;3238;10892;757;2692;1531;5229;2288;7921
170825;201510;737;2190;586;1893;109;371;251;787;360;1158
170830;201510;1397;4078;1230;3833;55;115;1084;3477;1139;3592
170900;201510;2576;9093;2435;8853;230;855;1933;7151;2163;8006
170930;201510;3667;11238;3166;10359;956;3302;1167;3942;2123;7244
170950;201510;14014;40352;10269;33653;3152;11726;1922;6058;5074;17784
170980;201510;500;1495;376;1280;86;331;154;493;240;824
171050;201510;1476;5013;1324;4723;95;424;1049;3697;1144;4121
171070;201510;1520;4750;1384;4542;360;1176;727;2474;1087;3650
171090;201510;1014;2788;842;2543;66;194;617;1863;683;2057
171110;201510;601;1759;446;1472;123;442;185;575;308;1017
171150;201510;850;2431;615;2016;105;380;359;1179;464;1559
171180;201510;693;2089;481;1648;114;410;185;681;299;1091
171190;201510;1664;6083;1460;5648;296;1215;725;2883;1021;4098
171195;201510;820;2911;707;2684;102;431;405;1562;507;1993
171200;201510;674;2139;545;1890;162;617;188;587;350;1204
171215;201510;458;1369;354;1158;59;207;153;514;212;721
171240;201510;727;2592;668;2475;90;390;429;1629;519;2019
171245;201510;642;2113;519;1816;110;439;172;559;282;998
171250;201510;1091;3146;870;2769;147;530;504;1528;651;2058
171270;201510;417;1705;390;1646;132;531;149;711;281;1242
171280;201510;878;2665;734;2426;193;613;318;1154;511;1767
171320;201510;3855;11619;3270;10589;917;2981;1427;4725;2344;7706
171330;201510;2909;8442;2356;7568;635;2175;1018;3228;1653;5403
171360;201510;1426;4605;1255;4334;206;718;795;2787;1001;3505
171370;201510;671;1923;576;1788;133;454;303;918;436;1372
171380;201510;1324;4240;1110;3841;413;1443;354;1268;767;2711
171395;201510;884;2669;695;2314;146;581;321;1020;467;1601
171420;201510;2258;6787;1708;5776;431;1543;618;2056;1049;3599
171430;201510;1043;3198;864;2905;201;685;437;1462;638;2147
171488;201510;2471;7514;2146;7040;494;1628;1154;3919;1648;5547
171500;201510;780;2387;676;2206;104;334;445;1487;549;1821
171510;201510;899;3145;806;2985;77;333;576;2152;653;2485
171515;201510;494;1404;388;1219;64;204;204;628;268;832
171525;201510;621;2028;524;1855;101;400;267;907;368;1307
171550;201510;303;1018;233;883;82;344;39;153;121;497
171570;201510;1240;3900;1079;3578;201;677;706;2358;907;3035
171575;201510;1904;5363;1441;4510;283;916;648;2054;931;2970
171610;201510;5362;17117;4468;15510;1219;4697;1542;5273;2761;9970
171620;201510;2549;7507;2228;7058;113;439;1865;5917;1978;6356
171630;201510;907;2848;742;2574;242;911;295;1007;537;1918
171650;201510;2203;6778;1711;5785;460;1691;596;1976;1056;3667
171660;201510;2469;6825;1892;5786;236;807;1127;3428;1363;4235
171665;201510;1503;4371;1209;3913;187;663;695;2330;882;2993
171670;201510;1950;5532;1625;4993;447;1529;686;1999;1133;3528
171700;201510;1083;3532;937;3250;141;562;594;2026;735;2588
171720;201510;721;2110;597;1898;211;662;224;748;435;1410
171750;201510;1179;3653;934;3156;259;912;299;1017;558;1929
171780;201510;1150;3159;876;2760;106;365;513;1653;619;2018
171790;201510;1463;4924;1276;4630;234;833;821;3130;1055;3963
171800;201510;642;2025;570;1929;73;275;413;1424;486;1699
171820;201510;10080;29629;8497;27363;1693;5958;4633;14921;6326;20879
171830;201510;1411;5236;1272;4923;324;1259;577;2251;901;3510
171840;201510;792;2182;678;2019;51;155;545;1642;596;1797
171845;201510;740;2013;566;1718;99;329;287;871;386;1200
171850;201510;953;3389;841;3160;103;436;520;1941;623;2377
171855;201510;1135;3542;1026;3336;91;363;760;2396;851;2759
171865;201510;469;1510;400;1393;88;329;189;645;277;974
171870;201510;730;2183;587;1929;142;508;218;755;360;1263
171875;201510;1329;4179;1104;3812;120;500;749;2530;869;3030
171880;201510;818;3055;796;3019;85;342;632;2442;717;2784
171884;201510;981;2709;700;2291;165;607;196;744;361;1351
171886;201510;1444;4696;1148;4056;350;1371;290;958;640;2329
171888;201510;686;2087;545;1815;63;221;303;1033;366;1254
171889;201510;488;1571;451;1505;97;347;240;806;337;1153
171890;201510;1210;3745;1005;3433;160;593;560;1899;720;2492
171900;201510;487;1826;428;1709;113;459;200;812;313;1271
172000;201510;562;1859;483;1704;75;287;273;954;348;1241
172010;201510;1199;4142;1107;3987;131;567;799;2861;930;3428
172015;201510;334;1292;275;1178;58;238;151;683;209;921
172020;201510;2250;7501;2079;7223;282;1006;1430;5059;1712;6065
172025;201510;723;2094;550;1799;84;310;299;984;383;1294
172030;201510;1146;3752;1011;3518;76;337;747;2561;823;2898
172049;201510;1327;3513;998;2952;165;484;731;2214;896;2698
172065;201510;1300;3542;1092;3306;67;208;981;3013;1048;3221
172080;201510;2510;7743;2109;7026;237;917;1341;4414;1578;5331
172085;201510;531;1435;374;1128;56;159;110;328;166;487
172090;201510;3322;9771;2722;8841;271;963;2020;6653;2291;7616
172093;201510;598;1825;468;1610;139;564;206;690;345;1254
172097;201510;666;1970;530;1751;126;411;212;735;338;1146
172100;201510;31479;95181;24284;82007;7036;26406;6510;21620;13546;48026
172110;201510;1677;6223;1492;5923;190;819;1056;4310;1246;5129
172120;201510;5143;15806;4280;14632;601;2168;2890;10038;3491;12206
172125;201510;266;827;224;749;38;144;105;351;143;495
172130;201510;550;1533;440;1352;43;160;294;916;337;1076
172208;201510;2107;6311;1895;5988;341;1130;1070;3408;1411;4538
172210;201510;2490;7663;2199;7215;518;1822;1142;3674;1660;5496
210005;201510;21681;67285;18185;61847;5675;20637;6894;23548;12569;44185
210010;201510;1574;5702;1406;5402;132;563;1056;4115;1188;4678
210015;201510;3303;10491;2955;9961;224;632;2480;8591;2704;9223
210020;201510;6934;16965;6515;16457;221;584;5924;14910;6145;15494
210030;201510;5511;18349;5157;17862;345;1541;4236;14548;4581;16089
210040;201510;1849;5196;1700;5025;117;357;1438;4264;1555;4621
210043;201510;6448;18490;5602;17396;565;1657;4123;13399;4688;15056
210047;201510;6350;24445;5835;23541;681;3076;4203;17018;4884;20094
210050;201510;2326;8496;1914;7694;701;2878;635;2732;1336;5610
210055;201510;1724;5882;1571;5658;184;696;1181;4296;1365;4992
210060;201510;7246;27756;6706;26761;968;4052;4476;18228;5444;22280
210070;201510;6879;20466;6350;19806;175;699;5665;17673;5840;18372
210080;201510;3659;12608;3563;12480;54;261;3347;11704;3401;11965
210083;201510;4309;15030;3977;14674;140;590;3718;13786;3858;14376
210087;201510;2861;8518;2600;8178;294;959;2041;6506;2335;7465
210090;201510;9698;31825;9203;31027;427;1654;8009;27026;8436;28680
210095;201510;5900;21580;5679;21261;418;1637;4690;17805;5108;19442
210100;201510;7142;21542;6558;20819;901;3021;4891;15468;5792;18489
210110;201510;2849;9949;2753;9815;120;565;2468;8736;2588;9301
210120;201510;25933;70933;22177;66506;2735;6955;16489;52461;19224;59416
210125;201510;3522;11203;3376;11050;234;626;2942;9891;3176;10517
210130;201510;4073;12095;3803;11710;274;874;3169;9769;3443;10643
210135;201510;1676;4929;1467;4638;113;374;1173;3730;1286;4104
210140;201510;16917;53963;14621;50778;2729;9890;9053;32503;11782;42393
210150;201510;4515;11125;4043;10540;71;182;3785;9873;3856;10055
210160;201510;17370;54914;16302;53331;1537;4541;13057;44002;14594;48543
210170;201510;13762;48902;13387;48418;771;2821;11849;43371;12620;46192
210173;201510;1915;7979;1851;7855;125;737;1573;6504;1698;7241
210177;201510;3027;9418;2864;9227;171;592;2527;8174;2698;8766
210180;201510;1479;4526;1378;4370;60;227;1170;3661;1230;3888
210190;201510;4801;15287;4413;14567;233;1016;3431;11055;3664;12071
210193;201510;1386;4372;1251;4148;76;272;1036;3481;1112;3753
210197;201510;2091;6914;1928;6727;247;836;1477;5326;1724;6162
210200;201510;8509;28398;7878;27480;1123;3655;5784;21068;6907;24723
210203;201510;6424;20762;6108;20337;415;1216;5242;17742;5657;18958
210207;201510;2958;9724;2766;9366;375;1188;1998;6975;2373;8163
210210;201510;8471;28396;8027;27818;106;464;7411;26029;7517;26493
210215;201510;1250;5087;1195;5000;105;505;963;4054;1068;4559
210220;201510;5994;22994;5696;22504;424;1822;4652;18576;5076;20398
210230;201510;4960;16524;4668;16053;288;1038;3941;13676;4229;14714
210232;201510;12454;40495;10403;37967;1544;5850;7002;27038;8546;32888
210235;201510;3507;11091;3158;10637;212;852;2634;8864;2846;9716
210237;201510;2326;9042;2268;8953;85;498;2077;8075;2162;8573
210240;201510;3001;9456;2816;9199;176;542;2334;7692;2510;8234
210250;201510;5071;16329;4774;15939;143;693;4305;14217;4448;14910
210255;201510;2497;8051;2273;7645;355;1255;1571;5315;1926;6570
210260;201510;5223;16816;4734;16090;645;2137;3434;12018;4079;14155
210270;201510;5372;15176;4704;14242;137;623;4123;12341;4260;12964
210275;201510;3605;8731;3396;8506;58;91;3289;8332;3347;8423
210280;201510;5556;16714;4830;15740;324;1340;3698;11830;4022;13170
210290;201510;5605;18617;5170;18080;375;1315;4334;15353;4709;16668
210300;201510;37219;104501;30512;96200;2223;7399;23277;76064;25500;83463
210310;201510;2887;8158;2653;7849;82;194;2344;6989;2426;7183
210312;201510;2167;6915;2062;6770;73;341;1822;5923;1895;6264
210315;201510;2505;8468;2323;8212;175;705;1957;6957;2132;7662
210317;201510;4226;12826;4020;12565;227;806;3570;11153;3797;11959
210320;201510;18808;60142;17414;58416;981;3524;14830;50182;15811;53706
210325;201510;3543;11159;3162;10579;295;1102;2359;7927;2654;9029
210330;201510;36574;88078;28188;79114;4118;9639;18848;59582;22966;69221
210340;201510;11615;35171;10547;33796;1284;3519;7655;26309;8939;29828
210350;201510;9940;30921;9013;29624;636;2117;7244;24081;7880;26198
210355;201510;3862;14156;3565;13725;229;939;3025;11846;3254;12785
210360;201510;16107;48779;14653;46715;1142;3917;11589;37059;12731;40976
210370;201510;9280;22285;7802;20693;289;570;6936;18983;7225;19553
210375;201510;3056;9353;2596;8735;767;2652;1236;4293;2003;6945
210380;201510;6041;16836;5319;15827;420;1147;4361;13191;4781;14338
210390;201510;2809;10001;2551;9580;141;751;2158;8044;2299;8795
210400;201510;4858;15263;4657;15028;150;452;4310;14054;4460;14506
210405;201510;8275;22680;6617;20318;2112;6503;2498;8503;4610;15006
210407;201510;2045;7267;1772;6806;203;771;1288;5085;1491;5856
210408;201510;2362;9176;2206;8983;151;713;1866;7818;2017;8531
210409;201510;3711;13558;3492;13222;220;1033;2872;10894;3092;11927
210410;201510;3472;11574;3360;11438;358;1103;2738;9682;3096;10785
210420;201510;4014;13220;3670;12620;280;933;2937;10274;3217;11207
210430;201510;2174;6707;2097;6616;120;388;1826;5777;1946;6165
210440;201510;3986;12514;3866;12351;201;596;3498;11311;3699;11907
210450;201510;2834;8892;2523;8433;164;596;2021;6702;2185;7298
210455;201510;4100;11894;3605;11134;570;1759;2497;7996;3067;9755
210460;201510;3624;11936;3386;11562;181;721;2814;9592;2995;10313
210462;201510;1492;5411;1388;5213;96;438;1103;4141;1199;4579
210465;201510;2553;8458;2371;8195;265;736;1930;6932;2195;7668
210467;201510;6177;20418;5737;19891;433;1485;4753;16684;5186;18169
210470;201510;2045;5561;1557;4855;82;250;1191;3769;1273;4019
210480;201510;13961;45436;12195;43122;2705;9359;7562;28547;10267;37906
210490;201510;3545;10014;3117;9404;159;528;2604;7822;2763;8350
210500;201510;6345;25981;6098;25528;778;3198;4536;19558;5314;22756
210510;201510;6462;22056;6147;21672;378;1191;5204;18831;5582;20022
210515;201510;3583;11661;3428;11483;105;331;3196;10831;3301;11162
210520;201510;2558;7915;2316;7567;122;400;2002;6600;2124;7000
210530;201510;36104;111484;29097;100792;7404;28869;12546;44294;19950;73163
210535;201510;3190;11002;3055;10805;112;396;2750;9832;2862;10228
210540;201510;13268;44025;11614;41568;2656;9224;6467;24972;9123;34196
210542;201510;5764;16656;5302;16158;338;803;4565;14343;4903;15146
210545;201510;2265;7439;2149;7247;66;331;1862;6205;1928;6536
210547;201510;3779;13315;3519;12876;290;993;2771;10388;3061;11381
210550;201510;6082;18155;5597;17653;276;661;5111;16558;5387;17219
210560;201510;4136;12889;3688;12135;214;806;3093;10124;3307;10930
210565;201510;1486;5256;1277;4930;115;585;933;3595;1048;4180
210570;201510;12371;34880;11158;33496;855;1905;9491;29578;10346;31483
210580;201510;3145;9464;2821;9054;343;882;2121;7384;2464;8266
210590;201510;4074;12751;3783;12397;316;1107;3170;10412;3486;11519
210592;201510;2417;7623;2324;7471;48;210;2057;6603;2105;6813
210594;201510;2683;7523;2196;6814;120;352;1731;5497;1851;5849
210596;201510;2682;9976;2544;9714;264;1056;1928;7478;2192;8534
210598;201510;1899;5852;1752;5668;103;376;1505;4812;1608;5188
210600;201510;3202;9331;2815;8799;191;640;2263;7049;2454;7689
210610;201510;2494;8226;2322;8005;140;599;2005;6818;2145;7417
210620;201510;1915;6154;1785;5983;56;159;1626;5534;1682;5693
210630;201510;3683;12996;3231;12221;393;1682;2145;8203;2538;9885
210632;201510;4488;15713;4202;15281;429;1677;3262;11906;3691;13583
210635;201510;1893;6662;1799;6518;101;356;1588;5836;1689;6192
210637;201510;2709;9100;2496;8805;157;609;2041;7262;2198;7871
210640;201510;4213;15205;4134;15118;18;80;4022;14826;4040;14906
210650;201510;6827;20894;6635;20655;304;970;6159;19218;6463;20188
210660;201510;7886;23669;7265;22747;264;962;6645;20697;6909;21659
210663;201510;2682;7987;2513;7778;198;698;2078;6442;2276;7140
210667;201510;1796;6301;1699;6150;93;405;1450;5280;1543;5685
210670;201510;4365;16336;4167;16009;247;1114;3436;13298;3683;14412
210675;201510;5008;13926;4607;13435;356;924;3847;11496;4203;12420
210680;201510;4062;11306;3642;10791;195;509;3127;9373;3322;9882
210690;201510;7128;24025;6844;23714;284;908;6086;21703;6370;22611
210700;201510;2573;7740;2397;7546;408;995;1680;6012;2088;7007
210710;201510;4755;15659;4480;15222;211;884;3784;12789;3995;13673
210720;201510;2527;9241;2377;9022;155;718;2070;7787;2225;8505
210725;201510;1090;4102;955;3854;140;603;583;2383;723;2986
210730;201510;1109;3530;996;3365;104;295;754;2617;858;2912
210735;201510;4107;14324;3749;13715;682;2514;2479;9407;3161;11921
210740;201510;4935;14597;4669;14320;201;833;4184;12543;4385;13376
210745;201510;3861;11494;3609;11161;252;641;3037;9519;3289;10160
210750;201510;20546;55167;17918;52180;2078;6004;13748;40916;15826;46920
210760;201510;5876;16622;5492;16217;60;296;5342;15697;5402;15993
210770;201510;5879;16114;5127;15253;140;545;4658;13809;4798;14354
210780;201510;8392;27727;7645;26406;854;3063;5494;19347;6348;22410
210790;201510;4618;14548;4174;14020;297;779;3428;12111;3725;12890
210800;201510;4718;13466;4274;12925;167;485;3772;11540;3939;12025
210805;201510;3659;15369;3526;15131;175;917;3026;13066;3201;13983
210810;201510;5331;16381;4958;15915;403;831;4205;14176;4608;15007
210820;201510;7841;22562;7137;21549;1232;3591;4736;14665;5968;18256
210825;201510;5659;19456;5378;19060;636;2150;4154;15134;4790;17284
210830;201510;8245;24531;7836;24037;792;2127;6377;20200;7169;22327
210840;201510;3656;10031;3270;9450;194;495;2679;7775;2873;8270
210845;201510;5666;17493;5465;17274;122;275;5192;16694;5314;16969
210850;201510;6025;21542;5484;20599;816;3431;3633;13606;4449;17037
210860;201510;17449;52064;15680;49633;1415;4513;12247;39261;13662;43774
210870;201510;5904;19689;5380;19040;576;1962;4140;14907;4716;16869
210880;201510;4274;13852;4076;13586;357;1296;3303;11036;3660;12332
210890;201510;5298;15511;4794;14924;560;1597;3827;12385;4387;13982
210900;201510;4933;14802;4022;13272;1412;4875;1127;3945;2539;8820
210905;201510;1831;5753;1663;5516;155;394;1289;4461;1444;4855
210910;201510;8676;27419;7836;26061;1241;4430;5256;17513;6497;21943
210920;201510;2979;10555;2850;10346;159;674;2420;8783;2579;9457
210923;201510;1520;5211;1398;5028;165;661;937;3457;1102;4118
210927;201510;4770;15186;4546;14944;58;264;4389;14415;4447;14679
210930;201510;2455;8970;2327;8793;150;826;1959;7220;2109;8046
210940;201510;2810;10941;2747;10823;198;835;2314;9149;2512;9984
210945;201510;5824;17623;5635;17421;260;350;5274;16772;5534;17122
210950;201510;5310;16290;4612;15173;449;1500;3449;11561;3898;13061
210955;201510;1901;6148;1671;5803;203;695;1148;4169;1351;4864
210960;201510;8684;28396;8287;27845;2237;7355;4705;16729;6942;24084
210970;201510;1343;4800;1187;4548;159;725;817;3107;976;3832
210975;201510;1731;5852;1648;5706;135;520;1299;4503;1434;5023
210980;201510;9869;23480;9552;23150;926;1830;8146;20451;9072;22281
210990;201510;16588;50117;13403;45779;2982;10731;7089;24917;10071;35648
211000;201510;15420;49722;13704;47638;839;3475;11384;39918;12223;43393
211003;201510;4731;16840;4291;16193;346;1571;3227;12433;3573;14004
211010;201510;6524;23579;6272;23285;102;464;5947;22184;6049;22648
211020;201510;7342;23770;7106;23393;572;2035;5866;19198;6438;21233
211023;201510;2247;7618;2167;7482;179;685;1772;6132;1951;6817
211027;201510;2870;11192;2784;11056;307;1245;2212;8935;2519;10180
211030;201510;3887;11925;3620;11643;584;1402;2742;9556;3326;10958
211040;201510;4258;16207;4101;15950;155;815;3562;13917;3717;14732
211050;201510;10106;26352;9808;26022;356;861;9039;24047;9395;24908
211060;201510;5961;21272;5784;21012;484;1827;4911;18031;5395;19858
211065;201510;1856;6194;1692;5984;83;292;1528;5476;1611;5768
211070;201510;8094;27705;7442;26619;451;1733;6177;22322;6628;24055
211080;201510;1382;4170;1152;3834;92;431;880;2814;972;3245
211085;201510;1872;6434;1692;6118;323;1202;1056;3868;1379;5070
211090;201510;3498;10344;3269;10029;125;531;2811;8466;2936;8997
211100;201510;6618;17018;6455;16842;40;137;6304;16449;6344;16586
211102;201510;3038;11329;2867;11089;245;937;2403;9479;2648;10416
211105;201510;2665;8563;2275;7969;206;822;1717;5938;1923;6760
211107;201510;4472;14215;4023;13606;235;834;3341;11549;3576;12383
211110;201510;6308;18807;5063;16896;1020;3327;2975;10413;3995;13740
211120;201510;35066;96281;30976;91363;5377;15203;21119;64742;26496;79945
211125;201510;2081;6663;1853;6303;132;489;1529;5210;1661;5699
211130;201510;133195;371754;120259;355268;22531;66494;76527;230663;99058;297157
211140;201510;5292;16874;4910;16281;206;802;4180;13789;4386;14591
211150;201510;9701;28230;8812;27121;488;1741;7373;22656;7861;24397
211153;201510;2809;8651;2603;8370;427;1320;1887;6238;2314;7558
211157;201510;1205;3874;1037;3619;94;419;692;2472;786;2891
211160;201510;4082;13553;3470;12519;286;1377;2388;8381;2674;9758
211163;201510;1659;5495;1574;5372;45;141;1426;4957;1471;5098
211167;201510;1489;4967;1420;4869;42;194;1322;4525;1364;4719
211170;201510;6369;16852;6080;16509;111;346;5625;15190;5736;15536
211172;201510;2415;7134;2171;6777;151;631;1801;5496;1952;6127
211174;201510;2803;8161;2532;7821;79;382;2263;6872;2342;7254
211176;201510;4371;13536;3783;12767;447;1589;2682;9175;3129;10764
211178;201510;3730;10000;3537;9780;75;200;3356;9275;3431;9475
211180;201510;4240;14883;3988;14496;314;1312;3261;11930;3575;13242
211190;201510;2789;9394;2584;9099;89;429;2236;7876;2325;8305
211195;201510;1472;4493;1217;4173;78;236;1010;3590;1088;3826
211200;201510;2127;7118;1867;6756;367;1281;1174;4511;1541;5792
211210;201510;6824;20870;6476;20392;470;1388;5436;17330;5906;18718
211220;201510;33425;97222;28937;91481;5753;18679;18170;58771;23923;77450
211223;201510;5045;14946;4604;14234;656;2053;3194;9999;3850;12052
211227;201510;1572;5722;1449;5525;133;573;1129;4336;1262;4909
211230;201510;8396;27477;7601;26166;895;3184;5662;19800;6557;22984
211240;201510;8101;27764;7686;27243;290;1222;6882;24243;7172;25465
211245;201510;5378;15925;5338;15883;159;269;5114;15473;5273;15742
211250;201510;12856;43120;12032;42140;1636;4576;9201;34511;10837;39087
211260;201510;8526;26438;8169;25952;578;1992;7126;22551;7704;24543
211270;201510;10257;35216;9133;33769;554;2471;7264;27207;7818;29678
211280;201510;12630;37443;11823;36462;1174;3069;9633;30825;10807;33894
211285;201510;1731;6310;1521;5848;286;1201;777;3068;1063;4269
211290;201510;7162;23600;6891;23249;604;1787;5732;19842;6336;21629
211300;201510;8234;24811;7699;24089;180;530;7135;22514;7315;23044
211400;201510;11553;36204;10285;34452;2752;9346;4941;18150;7693;27496
220005;201510;1826;5274;1664;5026;74;295;1361;3987;1435;4282
220010;201510;1386;4025;1217;3764;73;276;944;2864;1017;3140
220020;201510;3277;10365;3090;10048;601;1964;1928;6278;2529;8242
220025;201510;2182;5412;1968;5085;29;98;1680;4263;1709;4361
220027;201510;1374;3709;1238;3530;70;196;1011;2904;1081;3100
220030;201510;3220;8988;3151;8881;170;580;2759;7682;2929;8262
220040;201510;7554;23631;7016;22661;1458;4722;4339;14026;5797;18748
220045;201510;1396;4540;1265;4287;66;279;959;3185;1025;3464
220050;201510;4439;13312;3888;12371;239;949;3096;9704;3335;10653
220060;201510;1941;4998;1837;4875;55;108;1665;4431;1720;4539
220070;201510;2415;7147;2205;6816;156;492;1772;5473;1928;5965
220080;201510;718;2179;669;2104;60;255;545;1652;605;1907
220090;201510;1816;4600;1537;4234;70;227;1313;3552;1383;3779
220095;201510;732;1981;679;1905;19;76;620;1706;639;1782
220100;201510;1359;4112;1139;3742;101;363;828;2715;929;3078
220105;201510;2206;7089;1962;6625;176;595;1428;4858;1604;5453
220110;201510;3382;9920;3170;9577;142;565;2722;8069;2864;8634
220115;201510;2382;8339;2286;8187;163;680;1975;7016;2138;7696
220117;201510;1311;3499;1076;3143;81;234;866;2540;947;2774
220120;201510;12238;35278;11341;34165;179;798;10642;31882;10821;32680
220130;201510;896;3049;776;2875;68;271;634;2350;702;2621
220140;201510;1625;4400;1438;4170;229;536;1113;3366;1342;3902
220150;201510;7005;21537;6596;20944;202;836;5777;18126;5979;18962
220155;201510;1115;3426;900;3014;55;224;588;1923;643;2147
220157;201510;1050;2674;935;2496;20;65;821;2164;841;2229
220160;201510;2666;7967;2352;7414;110;462;1876;5807;1986;6269
220170;201510;1353;4189;1172;3887;55;259;940;3068;995;3327
220173;201510;2045;6172;1650;5394;51;247;1340;4246;1391;4493
220177;201510;1774;5216;1739;5160;61;218;1619;4783;1680;5001
220180;201510;1143;3115;941;2741;29;104;658;1834;687;1938
220190;201510;4426;14837;4123;14376;635;2259;3016;10561;3651;12820
220191;201510;1396;4687;1324;4565;193;671;923;3170;1116;3841
220192;201510;1820;5133;1430;4433;116;395;1006;3103;1122;3498
220194;201510;1644;4968;1471;4661;121;432;1099;3395;1220;3827
220196;201510;1966;5834;1806;5566;181;593;1368;4227;1549;4820
220198;201510;1338;3777;1040;3387;16;48;964;3187;980;3235
220200;201510;4358;14671;4096;14295;650;2319;2857;10054;3507;12373
220202;201510;2088;6457;1858;6045;49;236;1610;5120;1659;5356
220205;201510;2781;7270;2488;6854;50;202;2219;6025;2269;6227
220207;201510;904;2746;773;2510;76;300;561;1791;637;2091
220208;201510;1794;5808;1544;5356;227;908;960;3275;1187;4183
220209;201510;1506;4607;1364;4378;54;240;1103;3498;1157;3738
220210;201510;1710;4636;1502;4311;41;173;1253;3507;1294;3680
220211;201510;1615;4664;1534;4560;80;324;1318;3830;1398;4154
220213;201510;1715;4907;1576;4649;42;161;1293;3716;1335;3877
220217;201510;1922;6245;1849;6157;44;166;1708;5745;1752;5911
220220;201510;10958;30412;9855;28749;861;2215;7148;21410;8009;23625
220225;201510;1076;3148;921;2938;30;127;772;2424;802;2551
220230;201510;5276;14629;4767;13889;171;512;4188;12213;4359;12725
220240;201510;2840;8853;2627;8462;167;625;2064;6611;2231;7236
220245;201510;1504;4035;1308;3761;38;123;1146;3329;1184;3452
220250;201510;3169;9052;2902;8649;85;340;2557;7565;2642;7905
220253;201510;1652;5006;1414;4571;170;628;998;3183;1168;3811
220255;201510;1737;4931;1503;4530;71;290;1192;3424;1263;3714
220260;201510;4725;15115;4150;14033;338;1197;3076;10448;3414;11645
220265;201510;1329;4620;1203;4410;121;491;784;2923;905;3414
220270;201510;6666;21545;6405;21058;359;1690;5397;17115;5756;18805
220271;201510;1474;4134;1348;3936;89;234;1127;3340;1216;3574
220272;201510;1754;5357;1588;5061;62;259;1257;3933;1319;4192
220273;201510;1216;3533;1067;3263;101;318;770;2334;871;2652
220275;201510;2096;5369;1739;4933;32;136;1577;4394;1609;4530
220277;201510;2278;6365;2023;5964;95;309;1618;4726;1713;5035
220280;201510;1608;4305;1410;3967;101;371;1111;3025;1212;3396
220285;201510;1592;4299;1341;3948;26;112;1200;3542;1226;3654
220290;201510;6009;20241;5230;19151;508;2158;3893;14261;4401;16419
220300;201510;1920;6301;1718;6023;83;419;1380;4761;1463;5180
220310;201510;2377;8193;2222;8017;89;363;1925;7085;2014;7448
220320;201510;3220;9663;2743;8790;310;1102;1949;6212;2259;7314
220323;201510;1467;5223;1288;4957;147;618;974;3775;1121;4393
220325;201510;1172;3781;1016;3461;92;384;725;2455;817;2839
220327;201510;1323;4253;1208;4061;39;210;984;3210;1023;3420
220330;201510;3602;9865;3340;9536;138;387;2994;8608;3132;8995
220335;201510;1887;5714;1707;5502;53;164;1565;5105;1618;5269
220340;201510;1911;5293;1635;4876;123;383;1244;3689;1367;4072
220342;201510;1107;3699;1038;3592;73;314;824;2831;897;3145
220345;201510;2917;7536;2550;6971;70;165;2291;6279;2361;6444
220350;201510;3976;10553;3430;9680;213;624;2662;7473;2875;8097
220360;201510;1282;3589;1103;3300;109;364;831;2444;940;2808
220370;201510;9156;26362;8324;25251;404;1424;7337;22100;7741;23524
220375;201510;1532;4768;1425;4638;24;78;1355;4450;1379;4528
220380;201510;1385;3737;1170;3444;54;182;950;2748;1004;2930
220385;201510;836;2145;674;1884;17;64;546;1497;563;1561
220390;201510;9444;29225;8414;27327;2147;7282;3281;10777;5428;18059
220400;201510;1528;3600;1232;3142;40;139;1027;2521;1067;2660
220410;201510;1406;3962;1162;3602;98;379;883;2658;981;3037
220415;201510;876;2385;770;2244;56;165;558;1598;614;1763
220420;201510;2161;6248;1832;5592;90;274;1448;4412;1538;4686
220430;201510;2541;7297;2470;7201;153;495;2137;6188;2290;6683
220435;201510;1620;4823;1491;4602;46;177;1229;3750;1275;3927
220440;201510;2386;7899;2207;7657;146;552;1843;6311;1989;6863
220450;201510;2139;6574;1811;6099;405;1446;1055;3556;1460;5002
220455;201510;1311;4186;1219;4054;59;219;1089;3629;1148;3848
220460;201510;908;2465;841;2385;48;145;736;2060;784;2205
220465;201510;2361;7778;2130;7427;562;2079;1172;4121;1734;6200
220470;201510;3872;11509;3514;10906;208;681;2720;8325;2928;9006
220480;201510;2513;7143;2195;6673;156;444;1714;5222;1870;5666
220490;201510;2321;6635;2133;6392;72;273;1874;5545;1946;5818
220500;201510;3255;8794;2754;7939;107;464;2224;6210;2331;6674
220510;201510;2734;7913;2184;6955;99;393;1598;5015;1697;5408
220515;201510;1994;4833;1709;4458;170;408;1341;3538;1511;3946
220520;201510;5140;14085;4678;13457;145;437;4160;12010;4305;12447
220525;201510;1307;3683;1221;3552;53;182;1042;3008;1095;3190
220527;201510;1405;4312;1240;3969;145;489;891;2890;1036;3379
220530;201510;1236;3577;1096;3373;57;238;945;2828;1002;3066
220535;201510;887;2673;839;2612;89;295;623;1923;712;2218
220540;201510;3429;11162;3275;10921;147;634;2817;9294;2964;9928
220545;201510;1393;4677;1328;4554;169;647;955;3238;1124;3885
220550;201510;9177;29515;8537;28451;1030;3655;6105;20226;7135;23881
220551;201510;1433;4654;1312;4460;72;333;1051;3505;1123;3838
220552;201510;1593;4989;1377;4566;67;335;1044;3326;1111;3661
220553;201510;1613;4679;1316;4225;55;219;1012;3292;1067;3511
220554;201510;817;2357;717;2202;66;217;551;1692;617;1909
220555;201510;2297;6849;2131;6623;60;252;1917;5908;1977;6160
220556;201510;1449;4484;1284;4168;63;255;972;3072;1035;3327
220557;201510;1560;5081;1396;4760;168;606;929;3166;1097;3772
220558;201510;1056;3284;959;3113;64;286;731;2287;795;2573
220559;201510;1510;4286;1369;4042;33;107;1175;3454;1208;3561
220560;201510;1682;4165;1387;3755;70;184;1151;3078;1221;3262
220570;201510;7216;23339;6773;22547;1316;4361;4251;14530;5567;18891
220580;201510;6477;20661;6278;20381;313;1022;5624;18277;5937;19299
220585;201510;2003;7116;1888;6903;181;705;1480;5423;1661;6128
220590;201510;1334;3988;1198;3795;208;692;790;2557;998;3249
220595;201510;2308;6814;2147;6599;45;198;1932;5874;1977;6072
220600;201510;1291;3126;1049;2825;173;314;759;2206;932;2520
220605;201510;1957;5718;1672;5255;83;273;1346;4186;1429;4459
220610;201510;2688;8146;2579;7992;71;272;2327;7176;2398;7448
220620;201510;7568;25282;7305;24919;334;1583;6463;21748;6797;23331
220630;201510;402;1234;336;1111;54;180;180;603;234;783
220635;201510;1692;5953;1529;5596;91;430;1076;3863;1167;4293
220640;201510;2673;7769;2420;7410;128;452;2014;6101;2142;6553
220650;201510;2264;6566;2004;6106;130;461;1552;4668;1682;5129
220660;201510;2537;8093;2265;7722;168;779;1845;6084;2013;6863
220665;201510;1187;4057;1112;3921;29;152;992;3463;1021;3615
220667;201510;1727;5660;1627;5512;76;260;1364;4635;1440;4895
220669;201510;1873;6107;1760;5905;267;1092;1171;3819;1438;4911
220670;201510;2040;6011;1819;5729;148;383;1492;4847;1640;5230
220672;201510;2524;7222;2376;7048;237;694;1955;5857;2192;6551
220675;201510;1281;3687;1195;3536;80;211;940;2794;1020;3005
220680;201510;2267;7313;2135;7131;177;582;1754;5916;1931;6498
220690;201510;1682;4681;1456;4311;101;319;1151;3438;1252;3757
220695;201510;915;2585;835;2453;39;122;660;1919;699;2041
220700;201510;8619;24625;7525;22916;548;1904;5760;17383;6308;19287
220710;201510;818;2405;681;2166;41;126;497;1583;538;1709
220720;201510;2007;5394;1911;5271;55;166;1690;4635;1745;4801
220730;201510;1395;3952;1186;3626;29;133;1003;3015;1032;3148
220735;201510;1020;2625;827;2284;44;147;671;1812;715;1959
220740;201510;1369;4416;1199;4180;104;347;963;3436;1067;3783
220750;201510;3983;11428;3688;10974;417;1017;2849;8757;3266;9774
220755;201510;1231;3449;1106;3238;54;190;889;2554;943;2744
220760;201510;2667;9216;2459;8932;152;750;2027;7255;2179;8005
220770;201510;22375;73664;19774;68643;6514;23672;6662;23935;13176;47607
220775;201510;1251;3344;1209;3296;15;44;1171;3189;1186;3233
220777;201510;1625;4485;1438;4212;81;217;1127;3276;1208;3493
220779;201510;1329;3558;1274;3476;46;174;1137;3014;1183;3188
220780;201510;5990;15955;5283;14903;406;1139;4240;12003;4646;13142
220785;201510;1256;3328;1183;3201;46;119;1064;2856;1110;2975
220790;201510;10001;30858;9272;29714;844;2959;7300;23229;8144;26188
220793;201510;838;2386;764;2273;47;182;629;1842;676;2024
220795;201510;1463;4157;1406;4074;70;210;1275;3697;1345;3907
220800;201510;16395;44873;14723;42447;1039;3502;11082;31416;12121;34918
220810;201510;3345;9657;2875;8843;130;530;2279;6903;2409;7433
220820;201510;5332;14669;4882;14033;211;692;4315;12291;4526;12983
220830;201510;7533;21185;6986;20282;650;1931;5437;15828;6087;17759
220840;201510;14272;45045;12617;41686;2973;10019;5838;19603;8811;29622
220850;201510;2872;9855;2717;9659;132;561;2400;8558;2532;9119
220855;201510;633;1923;550;1776;38;149;404;1278;442;1427
220860;201510;958;2582;848;2410;37;134;702;1965;739;2099
220865;201510;2628;7250;2113;6346;81;384;1675;4844;1756;5228
220870;201510;2286;7620;2031;7271;90;391;1811;6449;1901;6840
220880;201510;4775;12913;4451;12529;112;305;4154;11745;4266;12050
220885;201510;1310;4702;1148;4401;103;486;850;3229;953;3715
220887;201510;1418;3499;1212;3210;20;72;1123;2948;1143;3020
220890;201510;1626;5645;1446;5289;129;480;1103;4113;1232;4593
220900;201510;1868;5340;1644;4933;62;176;1387;4150;1449;4326
220910;201510;1631;4881;1422;4569;50;157;1238;4035;1288;4192
220915;201510;1025;2888;872;2595;34;145;680;1953;714;2098
220920;201510;1349;4832;1218;4640;101;497;904;3367;1005;3864
220930;201510;1366;4543;1302;4446;60;260;1077;3660;1137;3920
220935;201510;1087;3310;948;3015;46;193;649;1971;695;2164
220937;201510;1541;4214;1293;3780;62;228;1002;2850;1064;3078
220940;201510;1378;4315;1272;4095;81;345;940;2958;1021;3303
220945;201510;437;1603;399;1530;36;160;285;1072;321;1232
220950;201510;1340;3329;968;2731;30;119;698;1905;728;2024
220955;201510;1467;4219;1280;3897;86;269;951;2868;1037;3137
220960;201510;897;2333;708;2018;18;59;557;1569;575;1628
220965;201510;1710;5067;1592;4889;65;307;1332;3960;1397;4267
220970;201510;2189;5784;1616;4861;151;473;1096;3317;1247;3790
220975;201510;662;2174;615;2106;31;160;558;1860;589;2020
220980;201510;1293;3908;1129;3627;89;330;820;2630;909;2960
220985;201510;1210;3543;1142;3443;90;336;867;2533;957;2869
220987;201510;1500;4748;1343;4480;80;354;1036;3349;1116;3703
220990;201510;1843;5292;1589;4875;44;219;1235;3690;1279;3909
220995;201510;1328;3832;967;3256;110;392;674;2322;784;2714
220997;201510;2227;6948;2103;6762;59;254;1943;6194;2002;6448
221000;201510;4281;13079;3966;12529;356;1309;3023;9420;3379;10729
221005;201510;1453;4546;1326;4304;506;1524;541;1895;1047;3419
221010;201510;1154;3086;977;2856;54;157;823;2387;877;2544
221020;201510;1792;5551;1664;5317;79;338;1226;3818;1305;4156
221030;201510;1506;4464;1351;4199;67;286;1109;3387;1176;3673
221035;201510;1446;4003;1353;3882;53;117;1249;3649;1302;3766
221037;201510;629;1857;561;1744;15;57;409;1213;424;1270
221038;201510;612;1707;496;1504;46;141;314;955;360;1096
221039;201510;912;2604;830;2484;50;204;682;1972;732;2176
221040;201510;4631;14250;4337;13768;209;745;3541;11263;3750;12008
221050;201510;3489;10672;3290;10398;179;651;2819;8858;2998;9509
221060;201510;8249;23903;7225;22253;691;2304;5334;16368;6025;18672
221062;201510;1287;4514;1191;4320;56;296;1005;3583;1061;3879
221063;201510;1049;3473;966;3306;233;757;539;1974;772;2731
221065;201510;2785;7648;2499;7180;152;433;2041;5802;2193;6235
221070;201510;3887;12202;3417;11402;170;658;2742;9151;2912;9809
221080;201510;3511;9101;2988;8384;120;380;2529;7056;2649;7436
221090;201510;1397;3843;1191;3506;39;174;982;2816;1021;2990
221093;201510;1657;4954;1559;4743;276;888;872;2576;1148;3464
221095;201510;955;2552;856;2403;22;60;731;2046;753;2106
221097;201510;795;2234;645;1965;43;167;447;1309;490;1476
221100;201510;115932;336537;105210;318401;20506;65564;62320;185477;82826;251041
221110;201510;10144;32159;9487;31334;447;1884;7972;25958;8419;27842
221120;201510;3982;12999;3754;12591;750;2644;2387;8018;3137;10662
221130;201510;4618;13331;3870;11805;1171;3585;1673;5150;2844;8735
221135;201510;1515;4671;1394;4500;117;438;1147;3652;1264;4090
221140;201510;1336;3290;1208;3117;44;113;1050;2680;1094;2793
221150;201510;1216;3116;985;2713;28;122;780;2091;808;2213
221160;201510;834;2194;780;2109;39;108;618;1673;657;1781
221170;201510;1150;3558;1063;3411;56;193;855;2735;911;2928
230010;201510;3260;9038;2718;8113;265;952;2012;5842;2277;6794
230015;201510;2915;10060;2723;9633;404;1622;1638;5676;2042;7298
230020;201510;13753;44845;13302;44062;761;2876;11181;36944;11942;39820
230030;201510;12038;34692;10889;32889;536;1863;8874;26578;9410;28441
230040;201510;4624;12622;3886;11369;340;1159;2759;7930;3099;9089
230050;201510;2637;9020;2067;7493;430;1625;762;2766;1192;4391
230060;201510;2177;6281;1870;5719;82;306;1400;4215;1482;4521
230070;201510;4383;12018;3718;10939;351;1179;2502;7375;2853;8554
230075;201510;8777;31453;8192;30259;611;3145;6289;22555;6900;25700
230080;201510;2420;6331;1959;5654;107;367;1598;4587;1705;4954
230090;201510;3794;11071;3348;10296;453;1590;2301;7029;2754;8619
230100;201510;16823;49933;15352;47261;2623;8718;9068;28057;11691;36775
230110;201510;13180;41944;12041;39493;2310;7914;6511;21120;8821;29034
230120;201510;7969;21964;6821;20255;791;2287;4568;14299;5359;16586
230125;201510;3025;8784;2474;7760;170;606;1791;5551;1961;6157
230130;201510;5947;19238;4978;17169;456;1794;3377;11456;3833;13250
230140;201510;3581;11364;3031;10362;371;1370;2005;6915;2376;8285
230150;201510;1716;5355;1470;4845;296;1058;790;2535;1086;3593
230160;201510;6311;18792;5591;17672;327;1321;4427;13794;4754;15115
230170;201510;6430;20064;5476;18232;367;1420;3870;12690;4237;14110
230180;201510;1768;5179;1552;4747;104;427;1107;3229;1211;3656
230185;201510;4054;13184;3657;12438;600;2110;2239;7817;2839;9927
230190;201510;12892;41000;11246;37596;2285;8373;5348;17577;7633;25950
230195;201510;5186;15850;4545;14754;359;1455;3443;10825;3802;12280
230200;201510;5287;15143;4742;14088;367;1184;3580;10522;3947;11706
230205;201510;4236;13539;3775;12734;262;1150;2686;8913;2948;10063
230210;201510;8999;25800;7780;23872;1564;4844;4369;13716;5933;18560
230220;201510;13149;37587;11804;35238;1161;3898;8411;24615;9572;28513
230230;201510;7480;23968;6760;22533;966;3229;4286;14467;5252;17696
230240;201510;13762;38865;12072;35967;615;2260;9416;27471;10031;29731
230250;201510;9894;30643;9760;30430;599;2240;7592;23241;8191;25481
230260;201510;14485;48372;13409;46177;2321;8584;7444;26055;9765;34639
230270;201510;7518;22175;6463;20350;741;2623;4209;13303;4950;15926
230280;201510;19731;58362;17546;54613;1858;5942;12592;39215;14450;45157
230290;201510;4856;14710;4113;13197;566;1793;2713;8720;3279;10513
230300;201510;4417;13368;4206;13060;282;1055;3399;10406;3681;11461
230310;201510;4846;14397;4220;13335;246;1014;3054;9448;3300;10462
230320;201510;7018;22076;6405;20975;469;1864;4682;15126;5151;16990
230330;201510;4766;13972;4067;12599;333;1146;2853;8682;3186;9828
230340;201510;3318;11235;3013;10561;386;1515;1923;6592;2309;8107
230350;201510;18154;55045;16409;52047;2104;7514;9538;30619;11642;38133
230360;201510;3300;9391;2669;8212;253;877;1735;5241;1988;6118
230365;201510;3003;8150;2614;7490;132;491;2062;5827;2194;6318
230370;201510;54193;173176;48268;162730;12866;45717;21281;73644;34147;119361
230380;201510;6510;19110;5491;17223;339;1146;3894;12172;4233;13318
230390;201510;3523;11085;3104;10351;251;1091;2178;7098;2429;8189
230393;201510;3291;10767;2775;9701;212;1019;1960;6572;2172;7591
230395;201510;5542;16359;4925;15259;805;2520;2925;9310;3730;11830
230400;201510;5405;16489;4704;15361;296;1308;3596;11471;3892;12779
230410;201510;14305;45620;12442;41621;1774;6347;7522;25141;9296;31488
230420;201510;24091;77854;21814;73191;4979;17973;10014;33342;14993;51315
230423;201510;4181;13789;3848;13110;264;1108;2878;9686;3142;10794
230425;201510;5627;18574;5117;17412;728;2566;3263;11139;3991;13705
230426;201510;2726;7600;2171;6541;88;366;1593;4663;1681;5029
230427;201510;1838;5452;1361;4397;190;614;768;2409;958;3023
230428;201510;8662;26943;8215;26095;1337;4699;4804;15018;6141;19717
230430;201510;4556;14489;4196;13798;332;1348;3007;9635;3339;10983
230435;201510;4838;15498;4337;14562;790;3061;2295;7510;3085;10571
230440;201510;351311;1042664;318654;984660;76089;246444;145732;452751;221821;699195
230445;201510;4551;12274;3814;11164;287;844;2699;7922;2986;8766
230450;201510;3541;11224;3047;10291;370;1562;1961;6424;2331;7986
230460;201510;1891;6260;1647;5806;173;707;1120;3896;1293;4603
230465;201510;4111;12269;3443;11048;259;1077;2254;7015;2513;8092
230470;201510;10791;39407;9943;37595;1317;5448;6717;25380;8034;30828
230480;201510;1459;4612;1232;4180;162;620;800;2674;962;3294
230490;201510;2365;7213;2034;6563;342;1185;986;3052;1328;4237
230495;201510;5805;19124;5156;17986;729;3041;2799;9625;3528;12666
230500;201510;9359;32800;8900;31909;656;2856;6676;23833;7332;26689
230510;201510;1506;5328;1159;4427;311;1304;356;1352;667;2656
230520;201510;4882;14920;4340;13906;456;1685;2796;8832;3252;10517
230523;201510;14616;47365;12643;42812;2921;10821;3176;10818;6097;21639
230526;201510;4193;12360;3522;11196;232;981;2673;8307;2905;9288
230530;201510;5427;17428;4855;16653;998;3499;3062;10845;4060;14344
230533;201510;3971;11132;3498;10254;289;836;2665;7859;2954;8695
230535;201510;5602;16468;4878;15173;759;2349;2880;9261;3639;11610
230540;201510;17767;51688;15963;48811;799;3052;13016;39203;13815;42255
230550;201510;19324;57759;17252;53753;3360;11295;8812;26789;12172;38084
230560;201510;6646;19204;5841;17751;248;995;4471;13288;4719;14283
230565;201510;3447;9547;2789;8310;132;483;2031;5987;2163;6470
230570;201510;3688;10049;3261;9518;121;472;2721;7833;2842;8305
230580;201510;10035;30468;9307;29425;548;1992;7975;25119;8523;27111
230590;201510;9022;28077;7754;25655;591;2509;5496;17619;6087;20128
230600;201510;3757;10434;2908;8756;152;549;1904;5680;2056;6229
230610;201510;6056;19463;5593;18709;788;2710;3798;12874;4586;15584
230620;201510;2172;6191;1704;5172;207;686;956;2810;1163;3496
230625;201510;8067;25867;7144;23770;2050;7368;2114;6921;4164;14289
230630;201510;11287;35706;10215;33718;2678;8345;4708;16621;7386;24966
230640;201510;25917;84661;23878;81580;2656;10023;17850;60845;20506;70868
230650;201510;4972;15164;4455;14173;314;1260;3369;10422;3683;11682
230655;201510;9133;34353;8739;33646;822;3523;6814;26376;7636;29899
230660;201510;6195;19270;5260;17519;375;1645;3895;12634;4270;14279
230670;201510;6222;16485;4890;14189;195;696;3757;10538;3952;11234
230680;201510;2826;8261;2367;7380;380;1270;1360;4204;1740;5474
230690;201510;6326;20552;6157;20202;599;2305;4025;12891;4624;15196
230700;201510;9336;26357;8294;24521;735;2585;5745;16409;6480;18994
230710;201510;7526;24441;6513;22511;725;2579;4530;15733;5255;18312
230720;201510;1879;5910;1589;5305;210;747;938;3120;1148;3867
230725;201510;3731;12605;3176;11189;760;2731;1115;3889;1875;6620
230730;201510;57463;172724;47351;155594;12991;47583;12354;41768;25345;89351
230740;201510;6015;18080;5461;17142;248;1014;4303;13253;4551;14267
230750;201510;8491;24374;7218;22281;460;1657;5439;16546;5899;18203
230760;201510;10542;31306;9731;29681;1073;3830;6727;19710;7800;23540
230763;201510;4257;13099;3822;12261;194;920;2893;8915;3087;9835
230765;201510;38690;121993;34300;113090;8886;31450;10822;35881;19708;67331
230770;201510;24955;69092;22537;65667;2944;9050;14777;43007;17721;52057
230780;201510;5950;22941;5672;22299;1417;5771;2712;11117;4129;16888
230790;201510;2733;8807;2504;8404;268;1006;1812;6083;2080;7089
230800;201510;7527;26663;6776;24986;1506;5946;2955;10730;4461;16676
230810;201510;11995;38913;11286;37683;925;3363;8747;29126;9672;32489
230820;201510;3344;11441;2902;10448;436;1797;1586;5600;2022;7397
230830;201510;7527;22846;6612;21133;555;2087;4737;14968;5292;17055
230835;201510;4024;10664;3289;9557;224;716;2497;7201;2721;7917
230837;201510;3182;10780;2751;9910;320;1374;1801;6322;2121;7696
230840;201510;9180;29815;8379;28415;750;2913;6225;21140;6975;24053
230850;201510;9779;30208;9035;28967;1057;3561;6209;19926;7266;23487
230860;201510;5197;14825;4555;13803;255;942;3651;10949;3906;11891
230870;201510;19011;49808;16319;45766;807;2598;12490;34725;13297;37323
230880;201510;1945;6594;1828;6355;163;723;1251;4253;1414;4976
230890;201510;3916;14320;3600;13609;464;2111;2253;8253;2717;10364
230900;201510;2945;9781;2482;8785;531;1825;1157;4200;1688;6025
230910;201510;3196;9342;2572;8214;210;910;1817;5614;2027;6524
230920;201510;4711;13689;4363;13240;304;1157;3551;10700;3855;11857
230930;201510;7398;22236;6483;20494;663;2205;4318;13674;4981;15879
230940;201510;7820;22233;6776;20599;356;1168;5380;16404;5736;17572
230945;201510;6207;18611;5307;17224;474;1733;3629;11942;4103;13675
230950;201510;6424;17694;5795;16844;267;768;4899;14503;5166;15271
230960;201510;14187;43531;12858;40985;2566;8604;5858;18798;8424;27402
230970;201510;13527;41356;11792;38048;2370;8423;5240;16530;7610;24953
230980;201510;2972;9328;2585;8611;735;2448;1180;4135;1915;6583
230990;201510;1737;5173;1442;4592;125;520;910;2779;1035;3299
231000;201510;2787;7537;2167;6327;160;549;1386;3911;1546;4460
231010;201510;3198;8686;2594;7672;273;885;1733;4982;2006;5867
231020;201510;7921;26488;7460;25497;1332;4570;4508;15699;5840;20269
231025;201510;8031;24476;7261;23172;1008;3348;4690;15188;5698;18536
231030;201510;7730;25055;6503;22485;1179;4373;3542;12207;4721;16580
231040;201510;3155;10097;2791;9364;177;767;1990;6490;2167;7257
231050;201510;12065;34143;10159;30704;825;2761;7446;22261;8271;25022
231060;201510;2414;7799;2211;7421;164;778;1558;5037;1722;5815
231070;201510;8785;27803;7961;26126;1305;4556;4554;14991;5859;19547
231080;201510;4076;12711;3689;12035;203;1016;2814;8769;3017;9785
231085;201510;4769;14814;4555;14518;739;2333;3071;10079;3810;12412
231090;201510;4132;11602;3288;9890;180;636;2288;6769;2468;7405
231095;201510;2324;7458;1977;6754;224;862;1289;4381;1513;5243
231100;201510;3222;9913;2671;8815;226;862;1885;6156;2111;7018
231110;201510;3597;11967;3530;11845;364;1399;2387;7943;2751;9342
231120;201510;2092;7010;1953;6709;294;1081;1237;4274;1531;5355
231123;201510;2108;5785;1792;5230;142;407;1382;4010;1524;4417
231126;201510;6303;17829;5270;16113;319;1236;3843;11534;4162;12770
231130;201510;19270;58983;17241;55555;3521;11665;9677;32575;13198;44240
231135;201510;4258;12637;3571;11413;284;1004;2500;7923;2784;8927
231140;201510;16791;52990;14741;49070;1300;5745;9602;30785;10902;36530
231150;201510;5920;16872;4961;15107;794;2580;2506;7567;3300;10147
231160;201510;5739;19057;5360;18313;918;3208;3286;11287;4204;14495
231170;201510;4264;13718;3820;12793;305;1276;2638;8568;2943;9844
231180;201510;14061;41966;12587;39017;2113;7040;7227;21972;9340;29012
231190;201510;4617;12977;3888;11852;265;964;2954;8789;3219;9753
231195;201510;4602;15426;3900;13991;421;1868;2640;9295;3061;11163
231200;201510;7783;26616;6761;24464;475;2394;4743;16659;5218;19053
231210;201510;5040;15622;4348;14650;298;1412;3352;11113;3650;12525
231220;201510;12061;34842;10584;32098;626;2377;7778;23063;8404;25440
231230;201510;9071;30503;8258;29223;795;3373;6063;21374;6858;24747
231240;201510;12269;38383;10941;35686;2322;7859;5162;17000;7484;24859
231250;201510;1975;5737;1359;4219;428;1298;291;898;719;2196
231260;201510;3559;10475;3189;9891;540;1666;1929;6094;2469;7760
231270;201510;7310;20143;6415;18718;346;1414;4807;13629;5153;15043
231280;201510;1746;5717;1619;5464;178;640;1105;3744;1283;4384
231290;201510;33176;113321;29783;105478;6393;25223;12139;41800;18532;67023
231300;201510;4600;13252;3701;11476;254;987;2526;7558;2780;8545
231310;201510;7471;21184;6133;18402;926;2839;3384;9958;4310;12797
231320;201510;7005;21436;5915;19273;335;1430;4191;13516;4526;14946
231325;201510;2711;8068;2361;7491;315;1035;1536;4967;1851;6002
231330;201510;12423;39178;10589;35506;1646;5546;6313;21378;7959;26924
231335;201510;5366;15325;4595;13908;219;896;3544;10447;3763;11343
231340;201510;17551;57524;16105;55303;1144;3981;12727;44460;13871;48441
231350;201510;13257;41633;12730;40861;1096;3373;10646;34665;11742;38038
231355;201510;4401;14087;4075;13538;300;1235;3000;9823;3300;11058
231360;201510;7819;24827;6938;23252;1347;4539;4083;14076;5430;18615
231370;201510;2477;6862;1927;5953;86;273;1425;4398;1511;4671
231375;201510;4163;14243;3864;13678;242;1134;3036;10570;3278;11704
231380;201510;5252;16634;4940;16209;623;2124;3394;11436;4017;13560
231390;201510;3453;10830;3172;10354;275;987;2208;7136;2483;8123
231395;201510;3867;12601;3483;11883;632;2177;1930;6635;2562;8812
231400;201510;9098;27929;8463;26654;569;2194;6224;19292;6793;21486
231410;201510;13903;47303;12762;45521;1305;4841;9591;34520;10896;39361
240010;201510;2451;7359;2035;6492;359;1262;978;3024;1337;4286
240020;201510;10735;33677;9493;31263;2107;7397;4512;14900;6619;22297
240030;201510;2428;7044;2355;6928;142;505;1976;5679;2118;6184
240040;201510;828;2464;682;2166;27;134;491;1471;518;1605
240050;201510;3454;9365;2931;8461;122;421;2334;6622;2456;7043
240060;201510;1395;4014;1241;3715;63;248;980;2820;1043;3068
240070;201510;2598;7531;2417;7171;391;1219;1581;4609;1972;5828
240080;201510;3058;8200;2625;7618;214;627;1993;5754;2207;6381
240090;201510;2334;6260;1889;5461;45;161;1462;4101;1507;4262
240100;201510;8245;23579;7363;21754;661;2168;5256;15125;5917;17293
240110;201510;4875;15160;4317;14037;688;2533;2371;7367;3059;9900
240120;201510;2690;9197;2561;8935;383;1481;1622;5585;2005;7066
240130;201510;2814;7559;2403;6931;130;466;1900;5330;2030;5796
240140;201510;2244;6707;1905;6086;319;1196;1055;3225;1374;4421
240145;201510;5809;18335;5222;17264;1435;4946;2465;8336;3900;13282
240150;201510;981;3005;802;2622;81;332;514;1609;595;1941
240160;201510;1441;4633;1242;4278;162;615;762;2684;924;3299
240165;201510;903;2857;790;2617;126;381;472;1647;598;2028
240170;201510;2383;7135;2072;6566;498;1738;940;2896;1438;4634
240180;201510;2611;8278;2325;7701;473;1677;1267;4250;1740;5927
240185;201510;1427;4743;1343;4595;101;366;1051;3619;1152;3985
240190;201510;968;3024;868;2847;46;212;642;2063;688;2275
240200;201510;13808;35929;11379;32518;2578;7588;5120;14974;7698;22562
240210;201510;2887;8074;2610;7664;199;713;2087;5980;2286;6693
240220;201510;7338;24457;6865;23750;639;2910;5162;17398;5801;20308
240230;201510;5659;15040;4918;13877;165;536;4142;11625;4307;12161
240240;201510;1846;5587;1252;4118;269;984;238;679;507;1663
240250;201510;2660;7764;2496;7546;126;422;2118;6361;2244;6783
240260;201510;12270;41307;11568;40128;1891;7327;7271;25090;9162;32417
240270;201510;2242;7183;2059;6878;202;691;1567;5303;1769;5994
240280;201510;1582;4410;1381;4107;87;317;1097;3220;1184;3537
240290;201510;1302;4136;1142;3825;69;349;738;2320;807;2669
240300;201510;2257;6256;1636;4931;359;1157;597;1737;956;2894
240310;201510;9613;27372;8701;25907;1277;4233;4781;14288;6058;18521
240320;201510;2047;6063;1602;5139;61;264;1169;3589;1230;3853
240325;201510;35185;96651;27482;84081;8519;27887;6538;20291;15057;48178
240330;201510;1500;4538;1256;4019;80;315;814;2498;894;2813
240340;201510;1988;5369;1681;4874;202;629;1186;3391;1388;4020
240350;201510;1936;5724;1805;5558;130;448;1542;4743;1672;5191
240360;201510;7158;21394;6237;19999;1244;4260;3348;10987;4592;15247
240370;201510;1982;5489;1601;4788;228;670;939;2830;1167;3500
240375;201510;845;2288;734;2104;115;378;451;1210;566;1588
240380;201510;2454;7318;1885;6027;253;844;952;3005;1205;3849
240390;201510;937;2584;778;2287;43;165;555;1566;598;1731
240400;201510;1337;3659;1099;3220;91;312;758;2142;849;2454
240410;201510;503;1647;462;1569;89;363;269;876;358;1239
240420;201510;4535;17422;4270;16816;949;4072;2257;8924;3206;12996
240430;201510;3265;9213;2975;8685;146;580;2342;6582;2488;7162
240440;201510;2546;6655;2258;6206;632;1748;1084;2975;1716;4723
240450;201510;3813;11332;3279;10303;311;1295;2056;6070;2367;7365
240460;201510;2899;8898;2736;8677;188;807;2227;6853;2415;7660
240470;201510;3622;11272;2878;9659;808;2605;1300;4452;2108;7057
240480;201510;513;1355;394;1123;38;118;210;576;248;694
240485;201510;2016;6282;1768;5812;302;1062;1020;3378;1322;4440
240490;201510;1662;4240;1397;3837;40;154;1163;3106;1203;3260
240500;201510;2115;6088;1913;5779;132;458;1484;4445;1616;4903
240510;201510;1794;5345;1659;5123;154;519;1298;3996;1452;4515
240520;201510;1244;3640;1118;3427;123;432;811;2422;934;2854
240530;201510;2029;6482;1841;6178;392;1368;1144;3843;1536;5211
240540;201510;1629;5014;1559;4895;123;429;1267;3951;1390;4380
240550;201510;823;2338;712;2151;42;146;540;1597;582;1743
240560;201510;3168;9343;2955;9004;359;1130;2184;6623;2543;7753
240570;201510;3100;8702;2317;6934;525;1701;821;2174;1346;3875
240580;201510;7552;23812;7003;22814;843;3051;5219;16749;6062;19800
240590;201510;783;2218;679;2023;34;133;507;1464;541;1597
240600;201510;1622;4785;1273;4042;160;578;700;2126;860;2704
240610;201510;4703;13404;4050;12162;497;1623;2532;7396;3029;9019
240615;201510;1035;3019;837;2640;163;541;455;1387;618;1928
240620;201510;1755;5493;1559;5165;201;638;1117;3767;1318;4405
240630;201510;2051;6245;1868;5933;181;493;1305;4280;1486;4773
240640;201510;919;2649;775;2404;61;277;528;1559;589;1836
240650;201510;3801;11415;3417;10856;199;733;2730;8619;2929;9352
240660;201510;2402;7683;2250;7461;209;758;1730;5715;1939;6473
240670;201510;2694;8022;2210;6986;294;983;1224;3800;1518;4783
240680;201510;1507;4419;1215;3882;112;389;757;2387;869;2776
240690;201510;941;2622;812;2400;53;194;655;1880;708;2074
240700;201510;2655;7917;2189;7026;87;402;1670;5230;1757;5632
240710;201510;18919;49316;16294;45429;3082;8505;9295;26349;12377;34854
240720;201510;5253;14961;4747;14016;1520;4624;2015;5721;3535;10345
240725;201510;1044;3162;829;2670;73;244;481;1509;554;1753
240730;201510;2166;6515;1856;5931;131;466;1367;4346;1498;4812
240740;201510;1988;5835;1763;5414;162;622;1242;3670;1404;4292
240750;201510;2168;8114;2001;7785;502;2134;937;3640;1439;5774
240760;201510;1324;3638;1115;3354;102;232;832;2684;934;2916
240770;201510;3143;8991;2805;8517;173;693;2287;6812;2460;7505
240780;201510;6307;17240;4936;15039;859;2631;2594;8035;3453;10666
240790;201510;884;2694;728;2420;41;158;491;1656;532;1814
240800;201510;35843;102764;31583;95410;7689;24069;12974;39580;20663;63649
240810;201510;85897;247554;78965;235442;20977;64130;36808;111167;57785;175297
240820;201510;6540;19753;5625;18265;1358;4741;2310;7773;3668;12514
240830;201510;8629;26863;8057;26001;428;1756;6747;21471;7175;23227
240840;201510;1260;3489;1048;3146;90;291;662;1913;752;2204
240850;201510;1298;3839;937;3005;146;496;452;1422;598;1918
240860;201510;1318;3736;1075;3299;54;200;812;2409;866;2609
240870;201510;1195;3273;964;2841;85;286;594;1666;679;1952
240880;201510;1139;3843;1071;3724;98;428;839;2827;937;3255
240890;201510;5097;14491;4260;12889;917;2943;1812;5326;2729;8269
240895;201510;2618;9041;2395;8631;280;1111;1678;6081;1958;7192
240910;201510;2799;8504;2476;7876;179;673;1855;5828;2034;6501
240920;201510;788;2536;680;2299;137;531;314;1014;451;1545
240930;201510;3457;9055;3049;8558;165;465;2479;7030;2644;7495
240933;201510;1372;3965;1224;3728;116;417;892;2640;1008;3057
240940;201510;6464;17532;5218;15363;930;2710;2864;8451;3794;11161
240950;201510;995;3229;938;3126;64;299;712;2286;776;2585
240960;201510;784;2438;689;2251;79;273;470;1539;549;1812
240970;201510;1951;5398;1634;4864;122;442;1218;3489;1340;3931
240980;201510;3041;9967;2791;9491;525;1875;1671;5659;2196;7534
240990;201510;2864;8481;2662;8060;453;1472;1584;4709;2037;6181
241000;201510;1057;2942;896;2652;45;162;625;1811;670;1973
241010;201510;2916;9754;2677;9273;339;1432;1832;6131;2171;7563
241020;201510;2066;5766;1655;4944;152;472;1054;3048;1206;3520
241025;201510;1631;4950;1450;4612;86;383;1014;3120;1100;3503
241030;201510;2507;8258;2236;7728;210;911;1612;5492;1822;6403
241040;201510;2250;7698;2054;7335;203;824;1425;5134;1628;5958
241050;201510;1248;3719;1093;3437;63;266;828;2525;891;2791
241060;201510;882;2543;791;2384;59;184;577;1725;636;1909
241070;201510;821;2341;732;2179;71;250;516;1473;587;1723
241080;201510;1172;3461;963;3055;43;187;699;2173;742;2360
241090;201510;2176;6397;1833;5781;135;604;1380;4238;1515;4842
241100;201510;1192;3561;1021;3152;103;328;661;2030;764;2358
241105;201510;1208;3648;1076;3404;237;783;534;1731;771;2514
241110;201510;820;2573;676;2263;49;219;426;1392;475;1611
241120;201510;7337;22412;6619;21246;1452;4657;3749;12418;5201;17075
241140;201510;3408;9367;2922;8383;329;929;1991;5638;2320;6567
241142;201510;721;2166;527;1723;140;525;181;548;321;1073
241150;201510;5464;16175;4860;15127;581;1902;3237;10044;3818;11946
241160;201510;999;2905;907;2739;142;431;567;1706;709;2137
241170;201510;1153;3419;1064;3261;98;299;814;2496;912;2795
241180;201510;935;2625;762;2296;95;305;394;1147;489;1452
241190;201510;1213;3329;968;2841;65;235;598;1665;663;1900
241200;201510;19235;55976;16916;52212;4066;13386;7344;22881;11410;36267
241210;201510;1477;4141;1172;3502;180;620;618;1768;798;2388
241220;201510;7800;25812;7245;24744;1726;6196;3725;12866;5451;19062
241230;201510;3021;8869;2750;8458;162;639;2296;6909;2458;7548
241240;201510;1201;3535;811;2605;100;353;343;1104;443;1457
241250;201510;5968;18456;5003;16569;230;1213;3829;12224;4059;13437
241255;201510;1664;6391;1531;6063;356;1530;746;2965;1102;4495
241260;201510;5085;13762;4089;12191;218;903;3002;8717;3220;9620
241270;201510;1839;5692;1615;5231;141;531;1070;3409;1211;3940
241280;201510;1861;5394;1695;5071;205;623;1185;3522;1390;4145
241290;201510;3055;8600;2560;7723;284;911;1697;5066;1981;5977
241300;201510;1455;4165;1257;3811;60;195;896;2721;956;2916
241310;201510;1589;4811;1458;4581;138;489;1067;3321;1205;3810
241320;201510;921;3157;835;2971;124;497;503;1768;627;2265
241330;201510;1452;4515;1345;4370;106;443;1102;3501;1208;3944
241335;201510;2714;8250;2499;7855;156;548;2056;6398;2212;6946
241340;201510;1854;5751;1578;5141;378;1343;677;2111;1055;3454
241350;201510;1934;6132;1742;5768;145;617;1288;4103;1433;4720
241355;201510;1398;3945;1145;3517;61;220;919;2798;980;3018
241360;201510;2043;5567;1689;4880;73;213;1244;3482;1317;3695
241370;201510;1349;4086;1099;3570;141;518;627;1968;768;2486
241380;201510;668;1895;561;1679;89;274;324;959;413;1233
241390;201510;2725;9019;2538;8681;307;1208;1840;6238;2147;7446
241400;201510;3751;10923;3423;10484;412;1372;2510;7693;2922;9065
241410;201510;2552;7679;2284;7279;516;1752;1215;3835;1731;5587
241415;201510;1683;5044;1511;4766;97;364;1186;3668;1283;4032
241420;201510;2287;7896;1986;7373;629;2569;480;1716;1109;4285
241430;201510;579;1722;448;1417;49;171;251;753;300;924
241440;201510;6216;22399;5842;21769;1140;4409;3769;14263;4909;18672
241445;201510;1037;2995;984;2930;90;222;793;2512;883;2734
241450;201510;3163;8584;2750;7985;325;1034;1873;5350;2198;6384
241460;201510;3401;9946;2994;9124;262;922;2118;6282;2380;7204
241470;201510;1350;3819;1124;3517;159;544;716;2208;875;2752
241475;201510;1230;3730;1007;3268;41;180;766;2390;807;2570
241480;201510;2770;9210;2541;8817;998;3610;685;2525;1683;6135
241490;201510;666;1757;564;1608;38;105;349;965;387;1070
241500;201510;773;2445;660;2263;49;217;480;1596;529;1813
250010;201510;2730;8564;2332;7673;139;584;1716;5503;1855;6087
250020;201510;1660;4765;1266;4039;84;351;833;2535;917;2886
250030;201510;6910;20195;6492;19597;533;1685;5250;15780;5783;17465
250040;201510;4234;14081;3884;13317;635;2264;2374;8140;3009;10404
250050;201510;3413;10824;3215;10530;456;1567;2188;7120;2644;8687
250053;201510;1239;3715;1139;3578;147;487;780;2482;927;2969
250057;201510;640;2663;630;2653;12;22;599;2599;611;2621
250060;201510;5057;15184;4728;14693;416;1504;3732;11418;4148;12922
250070;201510;3941;12296;3662;11818;167;784;2867;8922;3034;9706
250073;201510;756;2327;667;2169;45;181;532;1699;577;1880
250077;201510;2137;6275;1800;5732;187;628;1164;3743;1351;4371
250080;201510;4140;12086;3967;11801;388;1205;3005;8758;3393;9963
250090;201510;2559;7494;2441;7296;97;299;2013;5937;2110;6236
250100;201510;3851;12731;3637;12337;360;1340;2761;9228;3121;10568
250110;201510;5228;15632;4947;15222;487;1749;3879;11737;4366;13486
250115;201510;529;1708;461;1559;33;172;302;949;335;1121
250120;201510;1981;5963;1720;5443;103;368;1312;4113;1415;4481
250130;201510;5215;16422;4842;15806;219;902;4031;13052;4250;13954
250135;201510;1061;3256;967;3087;70;252;718;2291;788;2543
250140;201510;1994;6699;1908;6558;171;708;1467;5043;1638;5751
250150;201510;5039;16910;4571;16024;343;1493;3327;11468;3670;12961
250153;201510;1425;3925;1255;3672;42;186;1069;3049;1111;3235
250157;201510;1724;5690;1584;5403;174;686;1154;3906;1328;4592
250160;201510;3204;9751;3090;9576;140;527;2793;8612;2933;9139
250170;201510;1493;4524;1366;4328;217;723;927;2965;1144;3688
250180;201510;15592;46212;14730;44847;1430;5193;10851;32108;12281;37301
250190;201510;4167;12033;3785;11422;631;1952;2280;6763;2911;8715
250200;201510;2032;5919;1703;5437;112;437;1384;4367;1496;4804
250205;201510;877;3018;819;2907;53;266;607;2117;660;2383
250210;201510;1455;4897;1357;4744;117;466;1009;3454;1126;3920
250215;201510;1383;4542;1308;4427;107;441;864;2888;971;3329
250220;201510;740;2207;658;2099;41;160;551;1736;592;1896
250230;201510;1584;4012;1333;3600;79;248;1068;2769;1147;3017
250240;201510;2300;7740;2178;7511;127;508;1736;5970;1863;6478
250250;201510;4248;12913;3927;12480;201;686;3371;10761;3572;11447
250260;201510;1684;5182;1482;4868;83;333;1159;3794;1242;4127
250270;201510;1237;3898;1124;3756;103;349;859;2946;962;3295
250280;201510;3588;10711;3172;10045;423;1344;2272;7250;2695;8594
250290;201510;1947;5151;1651;4770;42;169;1475;4246;1517;4415
250300;201510;5444;15904;5145;15542;603;2509;4117;11804;4720;14313
250310;201510;1163;3550;1029;3336;95;360;789;2513;884;2873
250320;201510;7934;24346;7543;23618;935;3295;5204;15862;6139;19157
250330;201510;2458;7697;2117;7190;166;696;1606;5353;1772;6049
250340;201510;1096;3271;984;3085;39;143;829;2571;868;2714
250350;201510;4189;11683;3735;11131;156;550;3216;9598;3372;10148
250355;201510;1893;6056;1748;5847;88;452;1487;4829;1575;5281
250360;201510;1835;5461;1728;5305;69;187;1479;4588;1548;4775
250370;201510;11539;33959;10449;32754;897;2927;8910;28060;9807;30987
250375;201510;1090;3353;1010;3234;38;144;866;2768;904;2912
250380;201510;1684;4814;1585;4689;103;401;1345;3894;1448;4295
250390;201510;1920;5157;1531;4498;174;501;1030;3029;1204;3530
250400;201510;68840;185635;55563;164042;14053;43541;23266;69257;37319;112798
250403;201510;1516;4967;1405;4813;230;880;851;2829;1081;3709
250407;201510;1188;3383;1036;3133;76;240;743;2190;819;2430
250410;201510;548;1804;510;1729;32;159;404;1327;436;1486
250415;201510;1774;5448;1605;5147;101;334;1203;3812;1304;4146
250420;201510;1242;3733;1141;3583;38;158;1004;3100;1042;3258
250430;201510;6063;16768;5685;16200;309;1049;4703;13137;5012;14186
250435;201510;1342;4135;1218;3912;144;532;838;2657;982;3189
250440;201510;4342;12695;4023;12234;183;548;3353;10181;3536;10729
250450;201510;1970;5621;1767;5344;77;279;1495;4435;1572;4714
250460;201510;6386;19207;5944;18590;627;2025;4540;14375;5167;16400
250470;201510;1527;4200;1303;3885;148;510;864;2445;1012;2955
250480;201510;3709;11289;3459;10932;114;494;3039;9536;3153;10030
250485;201510;680;1699;556;1506;30;98;447;1168;477;1266
250490;201510;3745;11959;3652;11827;833;2743;2350;7656;3183;10399
250500;201510;1753;5315;1562;5005;317;975;981;3247;1298;4222
250510;201510;4681;13486;4190;12754;179;633;3629;11032;3808;11665
250520;201510;1699;5201;1591;5011;246;834;952;2925;1198;3759
250523;201510;1565;5063;1511;4979;241;874;1023;3331;1264;4205
250527;201510;1381;4187;1313;4104;25;121;1203;3702;1228;3823
250530;201510;629;1924;537;1810;27;85;468;1603;495;1688
250535;201510;1302;4094;1232;3953;54;236;994;3111;1048;3347
250540;201510;2361;6919;2212;6746;52;232;1954;5833;2006;6065
250550;201510;894;2976;804;2835;52;241;629;2173;681;2414
250560;201510;1660;5220;1610;5147;98;406;1400;4393;1498;4799
250570;201510;2635;8367;2305;7721;156;663;1733;5676;1889;6339
250580;201510;1133;3026;959;2749;95;343;736;2024;831;2367
250590;201510;884;2768;829;2702;86;346;669;2118;755;2464
250600;201510;7234;21071;6772;20412;703;2007;5212;15865;5915;17872
250610;201510;3066;9042;2827;8676;291;947;2078;6377;2369;7324
250620;201510;692;2033;610;1868;118;373;346;1042;464;1415
250625;201510;2359;7593;2313;7534;126;331;2134;7073;2260;7404
250630;201510;9262;29009;8547;27567;2071;6717;4256;13839;6327;20556
250640;201510;3448;10588;3292;10401;176;754;2846;8829;3022;9583
250650;201510;786;2316;703;2176;53;216;510;1512;563;1728
250660;201510;1905;5034;1731;4809;29;67;1630;4562;1659;4629
250670;201510;2380;8099;2266;7890;148;679;1851;6311;1999;6990
250680;201510;4701;13580;4479;13299;207;777;3917;11525;4124;12302
250690;201510;5950;15582;5673;15245;477;1254;4935;13254;5412;14508
250700;201510;4944;14530;4486;13843;735;2330;2931;9017;3666;11347
250710;201510;4159;13356;3903;12991;580;2065;2636;8866;3216;10931
250720;201510;2586;7621;2454;7409;101;429;2136;6346;2237;6775
250730;201510;3500;10722;3287;10414;301;1021;2435;7580;2736;8601
250740;201510;1891;5582;1683;5252;169;658;1253;3769;1422;4427
250750;201510;98878;280482;91208;269016;13032;41870;61259;178042;74291;219912
250760;201510;2208;6357;1983;6034;145;531;1616;4842;1761;5373
250770;201510;3773;12832;3577;12572;568;2201;2334;8155;2902;10356
250780;201510;1818;5337;1568;4872;181;677;1006;2991;1187;3668
250790;201510;2404;7868;2274;7651;527;1795;1305;4506;1832;6301
250800;201510;2635;7439;2337;6948;102;328;1922;5610;2024;5938
250810;201510;1303;3802;1128;3538;87;360;878;2686;965;3046
250820;201510;1815;5684;1742;5589;67;293;1585;5031;1652;5324
250830;201510;5669;18239;5247;17371;640;2342;3495;11335;4135;13677
250840;201510;902;2913;765;2609;55;219;513;1743;568;1962
250850;201510;1961;6044;1783;5750;99;465;1386;4358;1485;4823
250855;201510;1046;3186;963;3063;62;265;734;2258;796;2523
250860;201510;3077;10108;2671;9350;682;2590;861;3010;1543;5600
250870;201510;1055;3090;966;2926;40;162;739;2167;779;2329
250880;201510;1374;3890;1207;3652;170;517;856;2602;1026;3119
250890;201510;9138;27984;8544;27148;1108;4368;5984;18276;7092;22644
250900;201510;2808;9121;2464;8437;262;862;1777;6134;2039;6996
250905;201510;1966;6333;1884;6221;324;1047;1342;4507;1666;5554
250910;201510;4917;14295;4646;13889;282;949;3796;11243;4078;12192
250915;201510;1414;4378;1383;4325;126;356;1156;3696;1282;4052
250920;201510;3299;9506;3083;9170;419;1179;2115;6382;2534;7561
250930;201510;1965;6131;1846;5932;210;837;1293;4028;1503;4865
250933;201510;1117;3668;1056;3546;92;365;737;2422;829;2787
250937;201510;664;2092;613;1988;64;266;434;1363;498;1629
250939;201510;1536;4826;1444;4663;147;505;1010;3239;1157;3744
250940;201510;3704;11074;3477;10706;138;522;2936;9021;3074;9543
250950;201510;1216;3752;1071;3565;55;233;857;2822;912;3055
250960;201510;1109;3627;1055;3546;88;338;841;2816;929;3154
250970;201510;8380;23234;7283;21543;875;2648;5039;14877;5914;17525
250980;201510;2538;7527;2315;7124;131;527;1677;4941;1808;5468
250990;201510;1942;6628;1738;6174;265;1077;1045;3584;1310;4661
251000;201510;2132;6435;1943;6136;80;342;1608;5021;1688;5363
251010;201510;2788;8117;2500;7670;90;313;2145;6573;2235;6886
251020;201510;1583;4614;1458;4450;86;272;1291;3949;1377;4221
251030;201510;1116;3158;1012;2969;67;230;742;2137;809;2367
251040;201510;1804;5691;1623;5380;113;514;1191;3790;1304;4304
251050;201510;1069;3118;930;2874;102;337;606;1843;708;2180
251060;201510;1000;2351;775;2054;50;163;604;1570;654;1733
251065;201510;464;1414;410;1327;29;105;282;857;311;962
251070;201510;630;1761;567;1676;47;187;442;1231;489;1418
251080;201510;19655;55423;17739;52172;4564;13904;8407;25241;12971;39145
251090;201510;2953;9221;2618;8560;208;771;1875;6023;2083;6794
251100;201510;949;3018;841;2827;91;362;546;1772;637;2134
251110;201510;1981;5804;1731;5321;162;494;1162;3559;1324;4053
251120;201510;6076;20650;5792;20141;729;2947;4186;14309;4915;17256
251130;201510;4031;10430;3672;10047;16;37;3610;9905;3626;9942
251140;201510;4145;12762;3897;12368;127;553;3272;10331;3399;10884
251150;201510;2505;8165;2338;7913;210;930;1741;5704;1951;6634
251160;201510;1769;5828;1707;5747;69;268;1541;5188;1610;5456
251170;201510;1417;4308;1342;4219;98;400;1113;3414;1211;3814
251180;201510;2537;7734;2324;7409;439;1373;1379;4427;1818;5800
251190;201510;4307;12018;4143;11833;184;539;3819;10899;4003;11438
251200;201510;3788;12303;3661;12148;95;422;3357;11062;3452;11484
251203;201510;1037;3462;1004;3398;55;276;790;2617;845;2893
251207;201510;1113;3481;963;3213;69;330;660;2091;729;2421
251210;201510;7922;22493;6770;20975;762;2322;5128;16318;5890;18640
251220;201510;1104;2971;918;2692;97;293;680;1996;777;2289
251230;201510;4437;13536;4112;13154;234;932;3666;11608;3900;12540
251240;201510;3182;9807;2991;9559;420;1321;2174;6977;2594;8298
251250;201510;10234;30351;9448;29138;989;3547;7020;21185;8009;24732
251260;201510;508;1610;462;1543;23;92;345;1139;368;1231
251270;201510;4215;13513;3918;13150;165;754;3462;11565;3627;12319
251272;201510;1335;3971;1282;3896;82;262;1123;3416;1205;3678
251274;201510;873;2781;791;2633;79;313;559;1826;638;2139
251275;201510;1222;3605;1162;3509;82;348;864;2455;946;2803
251276;201510;1188;3699;1107;3549;83;336;811;2527;894;2863
251278;201510;557;1804;496;1683;62;255;321;1077;383;1332
251280;201510;2284;7000;2155;6785;142;540;1681;5125;1823;5665
251290;201510;5571;15426;5251;15040;608;2155;4062;11249;4670;13404
251300;201510;743;2523;694;2443;44;193;540;1882;584;2075
251310;201510;3000;8901;2763;8559;120;494;2255;6814;2375;7308
251315;201510;1601;5579;1522;5437;194;702;1032;3725;1226;4427
251320;201510;1857;5212;1461;4551;63;234;1068;3289;1131;3523
251330;201510;1803;4886;1561;4563;86;363;1330;3747;1416;4110
251335;201510;1013;3488;937;3354;94;437;649;2251;743;2688
251340;201510;3456;9732;2992;9029;226;888;2234;6509;2460;7397
251350;201510;1338;4229;1239;4053;99;366;940;2989;1039;3355
251360;201510;1774;5690;1612;5481;68;306;1401;4743;1469;5049
251365;201510;813;2383;646;2027;26;106;457;1395;483;1501
251370;201510;21684;68477;21097;67647;1862;7414;16694;51941;18556;59355
251380;201510;1344;4186;1153;3857;47;247;948;3037;995;3284
251385;201510;816;2226;706;2044;86;246;456;1275;542;1521
251390;201510;5788;19921;5264;18983;1249;4636;2878;10515;4127;15151
251392;201510;1030;3073;936;2928;76;255;701;2174;777;2429
251394;201510;606;1875;496;1660;43;149;342;1133;385;1282
251396;201510;838;2387;730;2203;110;334;468;1391;578;1725
251398;201510;986;2882;849;2614;54;208;563;1697;617;1905
251400;201510;1176;3310;1009;3077;98;367;727;2134;825;2501
251410;201510;1346;3624;1235;3446;66;259;1028;2796;1094;3055
251420;201510;1967;5733;1751;5472;230;740;1240;3843;1470;4583
251430;201510;1704;5930;1547;5668;89;448;1274;4571;1363;5019
251440;201510;1291;3801;1054;3338;67;239;772;2420;839;2659
251445;201510;1508;4605;1431;4495;83;359;1185;3606;1268;3965
251450;201510;4463;14377;4191;14002;138;653;3550;11765;3688;12418
251455;201510;1084;3498;975;3297;92;347;664;2248;756;2595
251460;201510;818;2533;764;2445;86;248;594;1952;680;2200
251465;201510;441;1406;386;1284;19;84;283;915;302;999
251470;201510;1170;3443;967;3049;91;319;588;1841;679;2160
251480;201510;962;2693;856;2510;29;139;697;1970;726;2109
251490;201510;1718;5217;1554;4960;170;638;1068;3363;1238;4001
251500;201510;1693;5500;1643;5405;143;549;1260;4050;1403;4599
251510;201510;2579;8443;2323;7911;437;1550;1280;4342;1717;5892
251520;201510;916;2554;814;2385;121;361;498;1450;619;1811
251530;201510;11643;32961;11037;32114;396;1710;9446;26719;9842;28429
251540;201510;2827;9154;2605;8710;199;838;2061;6793;2260;7631
251550;201510;3497;9068;3005;8410;85;340;2542;6975;2627;7315
251560;201510;702;2176;647;2075;87;330;387;1165;474;1495
251570;201510;999;2972;802;2573;51;221;546;1671;597;1892
251580;201510;1911;5386;1767;5184;397;999;1098;3409;1495;4408
251590;201510;1527;4951;1464;4871;67;280;1210;3990;1277;4270
251593;201510;993;3112;924;3019;138;497;581;1855;719;2352
251597;201510;1898;5853;1832;5769;77;329;1585;4891;1662;5220
251600;201510;6544;19231;6091;18510;383;1295;4903;14791;5286;16086
251610;201510;3196;9726;2953;9349;317;1011;2146;6813;2463;7824
251615;201510;1141;3320;924;2943;77;320;640;1980;717;2300
251620;201510;15029;42006;13189;39744;949;2943;10763;32964;11712;35907
251630;201510;4520;11789;3915;10937;268;799;3123;8619;3391;9418
251640;201510;2569;7490;2137;6741;135;534;1600;4983;1735;5517
251650;201510;3876;11314;3578;10909;237;807;3057;9255;3294;10062
251660;201510;3398;11101;3149;10663;126;631;2613;8587;2739;9218
251670;201510;4388;13036;3763;12225;58;189;3461;11376;3519;11565
251675;201510;712;2284;652;2199;147;528;351;1157;498;1685
251680;201510;2684;7730;2216;6988;112;494;1734;5335;1846;5829
251690;201510;3246;9857;3025;9419;165;591;2343;7150;2508;7741
251700;201510;1953;6325;1828;6159;122;534;1539;5110;1661;5644
251710;201510;926;2394;672;1914;78;260;383;1046;461;1306
251720;201510;1389;4276;1216;3968;85;412;918;2864;1003;3276
251740;201510;774;2203;613;1923;73;239;374;1172;447;1411
260005;201510;25350;61676;21423;56122;4656;12134;11659;30705;16315;42839
260010;201510;9872;26546;8041;24209;1353;4022;4671;14695;6024;18717
260020;201510;5619;16358;4766;15067;303;1086;3684;11766;3987;12852
260030;201510;5873;17162;5323;16307;404;1413;4104;12503;4508;13916
260040;201510;10125;24472;8303;22374;787;2011;6267;17453;7054;19464
260050;201510;11193;34775;10431;33881;594;2171;8976;29389;9570;31560
260060;201510;3888;10980;3441;10200;337;1001;2516;7524;2853;8525
260070;201510;9708;28169;8936;26932;1440;4654;5641;16755;7081;21409
260080;201510;5495;14943;4853;14004;622;1859;3367;9651;3989;11510
260090;201510;5084;14228;4759;13754;987;2740;3071;9060;4058;11800
260100;201510;3305;9118;2867;8494;190;761;2337;6818;2527;7579
260105;201510;4714;13541;4458;13075;379;1319;3484;9984;3863;11303
260110;201510;20829;59093;19201;57124;914;2837;16873;50310;17787;53147
260120;201510;11382;34898;10250;32885;2466;8072;5192;17273;7658;25345
260130;201510;3242;9127;3019;8773;477;1333;2048;6025;2525;7358
260140;201510;13219;32861;11249;30448;873;2586;8866;24119;9739;26705
260150;201510;3109;8808;2764;8335;206;790;2140;6370;2346;7160
260160;201510;5617;17747;4987;16924;331;1409;4019;13566;4350;14975
260170;201510;16252;45871;15540;44825;1206;3714;12670;36294;13876;40008
260180;201510;3230;9937;2947;9530;205;746;2419;7786;2624;8532
260190;201510;15909;37309;14546;35606;516;1355;12623;30589;13139;31944
260200;201510;10578;29238;9753;28113;707;2298;8100;23457;8807;25755
260210;201510;11352;34625;10237;32947;633;2475;8304;26628;8937;29103
260220;201510;9347;27328;9013;26874;472;1830;7888;23105;8360;24935
260230;201510;9456;27329;8702;26270;456;1599;7056;21387;7512;22986
260240;201510;2978;8996;2578;8408;376;1332;1770;5800;2146;7132
260250;201510;2289;6323;2054;6014;100;304;1766;5179;1866;5483
260260;201510;12109;34124;11040;32624;1789;5564;7707;23097;9496;28661
260270;201510;3598;10456;3326;10048;294;1197;2462;7050;2756;8247
260280;201510;12794;41454;11731;39822;719;2639;9799;33525;10518;36164
260290;201510;29887;89997;28126;86805;4905;16225;17237;52208;22142;68433
260300;201510;8509;25963;7519;24455;454;1927;5816;18879;6270;20806
260310;201510;4669;13745;4263;13132;1254;3572;2212;7368;3466;10940
260320;201510;6956;22723;6440;21893;417;1607;5263;17935;5680;19542
260330;201510;2607;8388;2418;8051;137;590;1883;6153;2020;6743
260340;201510;1871;5505;1731;5282;75;272;1505;4535;1580;4807
260345;201510;23069;71703;21495;68567;5662;19921;8323;25121;13985;45042
260350;201510;4695;12802;4375;12330;247;882;3642;10094;3889;10976
260360;201510;2291;6759;2079;6391;187;710;1408;4266;1595;4976
260370;201510;5848;18113;5142;16816;505;1968;3627;11769;4132;13737
260380;201510;4818;15823;4392;15179;322;1320;3290;11301;3612;12621
260390;201510;4366;13891;3818;12802;339;1298;2699;8871;3038;10169
260392;201510;3527;11096;3233;10723;215;940;2760;8978;2975;9918
260400;201510;13498;38476;12746;37205;1759;5756;8674;24682;10433;30438
260410;201510;60780;173286;52660;160076;15264;48942;20081;62119;35345;111061
260415;201510;3851;12174;3285;11031;334;1387;2034;6545;2368;7932
260420;201510;11962;27304;10636;25867;286;874;9555;22931;9841;23805
260430;201510;2767;9118;2457;8562;252;918;1676;5837;1928;6755
260440;201510;3241;9779;2873;9027;416;1455;1723;5252;2139;6707
260450;201510;4911;14569;4682;14234;203;720;4114;12536;4317;13256
260460;201510;5577;17300;5093;16402;914;3193;2911;9169;3825;12362
260470;201510;4538;13680;4241;13295;269;843;3653;11675;3922;12518
260480;201510;4054;11595;3559;10898;594;2048;2275;6962;2869;9010
260490;201510;5011;13376;4356;12254;311;1004;3446;9484;3757;10488
260500;201510;5944;16966;5277;15902;764;2319;3488;10477;4252;12796
260510;201510;8674;23286;8030;22454;415;1321;7032;19535;7447;20856
260515;201510;4727;14401;3645;12189;259;1002;2295;7641;2554;8643
260520;201510;15787;41590;15102;40636;2318;6223;10816;29154;13134;35377
260530;201510;9683;29497;8601;27873;447;1642;7225;23452;7672;25094
260540;201510;6020;14902;5472;14315;771;1498;4258;11704;5029;13202
260545;201510;70;250;39;155;8;33;11;38;19;71
260550;201510;2756;9011;2354;8156;496;1888;941;3214;1437;5102
260560;201510;6273;16436;5660;15534;177;643;4972;13423;5149;14066
260570;201510;6838;22484;6245;21495;706;2744;4403;15077;5109;17821
260580;201510;3705;10415;3415;9927;189;657;2823;7988;3012;8645
260590;201510;6104;15304;5747;14880;300;829;4977;12839;5277;13668
260600;201510;26909;79582;24208;74981;2342;8482;17240;52746;19582;61228
260610;201510;6639;19831;6262;19246;943;3032;4298;13064;5241;16096
260620;201510;15886;47928;15098;46495;2627;8831;9292;28028;11919;36859
260630;201510;2186;6545;1944;6133;154;639;1518;4620;1672;5259
260640;201510;17108;47204;15991;45623;2553;7521;10307;29381;12860;36902
260650;201510;5324;16995;4739;15972;454;1640;3534;12056;3988;13696
260660;201510;7946;22091;7107;21015;369;1271;6054;17760;6423;19031
260670;201510;2371;6386;1917;5747;174;567;1340;4025;1514;4592
260680;201510;21634;60442;19621;56860;4179;12396;9491;27331;13670;39727
260690;201510;3668;9949;3103;9018;145;523;2539;7271;2684;7794
260700;201510;5631;16747;5486;16596;48;134;5370;16359;5418;16493
260710;201510;1269;3771;1165;3627;90;329;906;2807;996;3136
260720;201510;15947;52151;15057;50543;3576;12420;7850;26556;11426;38976
260730;201510;6649;22353;6202;21591;1043;3784;4212;14645;5255;18429
260740;201510;1265;3846;1107;3571;128;459;748;2410;876;2869
260750;201510;6653;20604;6019;19750;547;1763;4872;16203;5419;17966
260760;201510;4678;12593;4350;12153;255;785;3605;10106;3860;10891
260765;201510;7683;25996;7301;25363;1106;4866;4875;16183;5981;21049
260770;201510;3732;9875;3444;9454;121;425;2872;7741;2993;8166
260775;201510;5052;14605;4750;14129;470;1682;3387;9780;3857;11462
260780;201510;3624;11695;3372;11185;667;2474;1755;5562;2422;8036
260790;201510;110483;278660;102130;265920;20787;55456;59273;153553;80060;209009
260795;201510;2995;9126;2692;8656;304;1105;1827;5861;2131;6966
260800;201510;4799;12961;4441;12460;165;644;3946;10733;4111;11377
260805;201510;3928;11382;3444;10634;408;1437;2297;6919;2705;8356
260810;201510;6727;19051;6527;18813;325;986;5711;16389;6036;17375
260820;201510;4282;12030;3872;11429;950;2903;2001;5789;2951;8692
260825;201510;2859;9149;2570;8671;222;805;1956;6634;2178;7439
260830;201510;3701;11935;3310;11162;761;2479;1866;6538;2627;9017
260840;201510;4239;12085;3768;11388;257;970;3024;8962;3281;9932
260845;201510;4177;12117;3901;11609;515;1612;2744;8188;3259;9800
260850;201510;4922;16048;4330;14715;839;3210;2061;6755;2900;9965
260860;201510;3303;10458;2951;9738;186;712;2255;7402;2441;8114
260870;201510;4172;11550;3704;10952;489;1315;2729;8247;3218;9562
260875;201510;6471;17824;5740;16713;892;2621;3752;10989;4644;13610
260880;201510;9301;28716;8532;27428;772;2525;6561;21241;7333;23766
260890;201510;13236;37805;12325;36380;900;3033;9343;27327;10243;30360
260900;201510;5884;18055;5002;16349;551;2168;3105;9950;3656;12118
260910;201510;2986;9017;2706;8586;197;723;2071;6565;2268;7288
260915;201510;4461;15089;4244;14778;86;406;3909;13588;3995;13994
260920;201510;3219;9851;3003;9541;349;1334;2252;7096;2601;8430
260930;201510;3948;12796;3471;12015;395;1444;2443;8478;2838;9922
260940;201510;13712;36731;12433;34612;1556;5049;8316;22434;9872;27483
260950;201510;6225;19224;5667;18118;860;3185;3029;9196;3889;12381
260960;201510;56298;156296;51388;148087;10125;30852;27586;78739;37711;109591
260970;201510;4772;14990;4383;14447;274;1146;3472;11326;3746;12472
260980;201510;3835;12399;3601;12100;123;537;3219;10772;3342;11309
260990;201510;16834;52924;15279;50811;1174;4373;12079;40343;13253;44716
261000;201510;16236;43989;13027;38947;2474;7777;6566;20201;9040;27978
261010;201510;2550;7178;2339;6918;156;358;2033;6186;2189;6544
261020;201510;5909;17500;5302;16529;478;1760;4050;12209;4528;13969
261030;201510;3414;11015;3145;10519;217;883;2472;8137;2689;9020
261040;201510;5124;16568;4472;15284;388;1571;3225;10893;3613;12464
261050;201510;7949;23231;7390;22201;1037;3088;4871;14660;5908;17748
261060;201510;11959;35372;11075;33748;1098;3902;8027;23766;9125;27668
261070;201510;50531;124329;44162;115205;6834;18137;27710;72470;34544;90607
261080;201510;5764;16748;5397;16185;385;1083;4559;13899;4944;14982
261090;201510;16475;45268;15119;43413;1465;4129;11712;33983;13177;38112
261100;201510;7880;25012;6995;23412;1370;4872;3808;12945;5178;17817
261110;201510;60290;177780;53332;166983;12300;40513;27476;87406;39776;127919
261120;201510;3650;9736;3202;9189;96;358;2843;8134;2939;8492
261130;201510;6976;17874;6506;17342;224;723;5896;15577;6120;16300
261140;201510;3270;9162;2951;8677;413;1380;1778;5054;2191;6434
261150;201510;5266;15530;4851;14856;441;1598;3817;11605;4258;13203
261153;201510;2084;6065;1689;5448;71;298;1259;4062;1330;4360
261160;201510;199509;520610;183912;497658;43356;120995;91466;250469;134822;371464
261170;201510;5845;15978;5287;15149;612;1795;3930;11362;4542;13157
261180;201510;9572;26669;8942;25765;960;3044;6220;17673;7180;20717
261190;201510;5068;15725;4713;15282;553;2312;3243;10070;3796;12382
261200;201510;3663;9207;3295;8760;437;1130;2539;6904;2976;8034
261210;201510;1889;5013;1785;4881;125;337;1570;4317;1695;4654
261220;201510;13072;40838;10864;35992;1935;6962;5377;17670;7312;24632
261230;201510;4317;13102;3972;12666;165;650;3451;11021;3616;11671
261240;201510;4755;14151;4401;13547;659;1913;2960;9322;3619;11235
261245;201510;3503;10940;2997;10011;172;805;2353;7655;2525;8460
261247;201510;3305;10113;2790;9158;226;893;1993;6547;2219;7440
261250;201510;19748;52417;18532;50788;3585;9497;12634;35468;16219;44965
261255;201510;3948;12345;3580;11705;213;838;2924;9476;3137;10314
261260;201510;11957;33827;10708;32285;619;1979;8927;26974;9546;28953
261270;201510;3615;10697;3254;10098;406;1405;2166;6568;2572;7973
261280;201510;2477;7605;2272;7299;139;500;1843;5875;1982;6375
261290;201510;2904;8341;2642;7997;174;669;2126;6394;2300;7063
261300;201510;10580;34330;9259;31901;1532;6047;5503;18616;7035;24663
261310;201510;7323;22473;6872;21636;1647;5311;3794;11964;5441;17275
261320;201510;5534;17457;5113;16681;239;948;4113;13322;4352;14270
261330;201510;5396;15861;5103;15457;477;1487;3978;11983;4455;13470
261340;201510;4018;13345;3799;12980;406;1750;2523;8459;2929;10209
261350;201510;8039;26535;7508;25605;318;1554;6028;20058;6346;21612
261360;201510;8087;21346;7237;20139;616;1856;5691;15545;6307;17401
261370;201510;19572;57610;18190;55400;3746;11871;10358;31568;14104;43439
261380;201510;4089;14024;3754;13299;601;2359;2337;8254;2938;10613
261390;201510;15678;47952;14153;45326;2148;7493;8580;27345;10728;34838
261400;201510;4754;16328;4236;15237;398;1665;2937;10509;3335;12174
261410;201510;8547;23990;7729;22724;992;2960;5605;16632;6597;19592
261420;201510;7343;24761;7014;24299;1676;6596;4050;13669;5726;20265
261430;201510;3388;10620;2973;10013;281;995;2244;7655;2525;8650
261440;201510;1575;5121;1422;4889;60;306;1123;3771;1183;4077
261450;201510;13953;39429;13462;38834;387;1413;12174;34836;12561;36249
261460;201510;7135;21006;6691;20425;451;1267;5754;17901;6205;19168
261470;201510;3904;10675;3527;10175;143;466;3199;9200;3342;9666
261480;201510;3533;12773;3244;12219;331;1378;2299;8532;2630;9910
261485;201510;4991;15272;4507;14400;777;2874;2610;8110;3387;10984
261500;201510;5689;15737;5024;14839;475;1300;3767;11473;4242;12773
261510;201510;1926;6145;1778;5912;131;480;1374;4566;1505;5046
261520;201510;2638;8575;2440;8199;151;581;1663;5780;1814;6361
261530;201510;11936;38125;10455;35226;2246;8410;4320;14400;6566;22810
261540;201510;7272;23399;6866;22679;1503;4937;4076;13783;5579;18720
261550;201510;3420;9701;3217;9404;264;1007;2527;7158;2791;8165
261560;201510;7121;23209;6402;22244;1026;3901;4404;15440;5430;19341
261570;201510;3396;10372;2977;9683;435;1487;1880;6092;2315;7579
261580;201510;5704;17940;5109;16967;376;1507;4167;13766;4543;15273
261590;201510;2396;6845;2132;6446;187;575;1585;4828;1772;5403
261600;201510;5181;14174;4472;13173;349;1081;3478;10303;3827;11384
261610;201510;2462;7092;2095;6562;117;486;1645;5051;1762;5537
261618;201510;2468;6942;2249;6660;209;663;1684;4888;1893;5551
261620;201510;4079;12648;3789;12149;619;2056;2522;8175;3141;10231
261630;201510;7707;22494;6438;20102;895;3256;3567;10808;4462;14064
261640;201510;32649;82313;30262;79371;2212;5663;24253;65540;26465;71203
261650;201510;3635;11183;3362;10794;413;1465;2371;7627;2784;9092
270010;201510;4399;16624;4029;15896;475;2228;2683;10574;3158;12802
270020;201510;3809;10908;3548;10523;400;1299;2684;7842;3084;9141
270030;201510;39899;119284;37142;114785;9156;29010;20024;62403;29180;91413
270040;201510;10591;32347;9766;31253;2268;7163;5438;18133;7706;25296
270050;201510;4265;12044;3900;11578;419;1413;3000;8834;3419;10247
270060;201510;1726;5374;1607;5216;289;1003;1058;3463;1347;4466
270070;201510;4223;13144;3877;12685;207;1008;3276;10408;3483;11416
270080;201510;1254;3987;1094;3653;163;614;678;2191;841;2805
270090;201510;2114;6533;1946;6185;59;309;1639;5015;1698;5324
270100;201510;5703;17723;5360;17092;954;3243;3326;10468;4280;13711
270110;201510;3209;8790;2842;8384;401;1198;1866;5885;2267;7083
270120;201510;3082;8822;2748;8402;109;421;2452;7504;2561;7925
270130;201510;4985;15259;4661;14887;646;2086;3556;11603;4202;13689
270135;201510;1746;4656;1629;4511;184;373;1373;3965;1557;4338
270140;201510;10270;24990;8831;23161;758;2964;6855;16654;7613;19618
270150;201510;2691;8959;2618;8864;87;298;2445;8318;2532;8616
270160;201510;5051;16853;4627;16317;234;1017;3933;13773;4167;14790
270170;201510;3826;12343;3510;11898;623;2410;2028;6772;2651;9182
270180;201510;2203;7347;2017;7086;117;604;1639;5627;1756;6231
270190;201510;1776;5842;1688;5727;104;422;1408;4784;1512;5206
270200;201510;2563;8589;2393;8345;205;887;1817;6227;2022;7114
270210;201510;4540;13921;4277;13543;326;1319;3468;10717;3794;12036
270220;201510;1396;4540;1302;4362;246;902;738;2425;984;3327
270230;201510;10871;34308;9490;32036;1296;5379;5832;18923;7128;24302
270235;201510;6317;20485;5896;19791;408;1752;4771;15753;5179;17505
270240;201510;9442;28432;7948;26434;1895;6595;3847;12935;5742;19530
270250;201510;3254;8545;2967;8194;492;1302;2222;6139;2714;7441
270255;201510;4979;15007;3945;13130;280;1166;2795;9116;3075;10282
270260;201510;5707;18718;5524;18453;455;1914;4601;15059;5056;16973
270270;201510;1187;3392;1084;3238;195;611;628;1835;823;2446
270280;201510;3576;10169;3199;9628;382;1173;2274;6800;2656;7973
270290;201510;8196;28550;7664;27614;729;3163;5855;20786;6584;23949
270300;201510;3552;11637;3197;11226;333;1334;2314;8045;2647;9379
270310;201510;7366;22341;6440;20887;302;1526;5357;16903;5659;18429
270320;201510;5781;18538;5536;18133;853;3320;3829;12170;4682;15490
270330;201510;4332;14633;4070;14261;390;1517;3229;11335;3619;12852
270340;201510;1738;5344;1527;5061;128;440;1193;3947;1321;4387
270350;201510;1873;5189;1687;4963;154;544;1235;3602;1389;4146
270360;201510;2000;6212;1928;6128;193;560;1582;5170;1775;5730
270370;201510;1556;5151;1411;4892;143;595;998;3441;1141;4036
270375;201510;2804;7914;2502;7488;239;848;1905;5547;2144;6395
270380;201510;5712;17680;5358;17178;566;1864;4063;13247;4629;15111
270390;201510;1245;3474;1094;3250;82;298;820;2338;902;2636
270400;201510;6331;18936;5677;17999;431;1615;4045;12492;4476;14107
270410;201510;4801;14937;4419;14198;474;1677;3083;9768;3557;11445
270420;201510;5708;18377;5494;18076;271;1249;4488;14414;4759;15663
270430;201510;133394;387195;122660;370837;32385;102641;56640;174088;89025;276729
270440;201510;4717;14216;4332;13672;238;922;3512;11086;3750;12008
270450;201510;6278;19346;6015;19009;350;1466;4925;15293;5275;16759
270460;201510;3457;9214;3080;8724;212;693;2600;7261;2812;7954
270470;201510;10284;32840;9446;31438;1543;5371;5577;18842;7120;24213
270480;201510;2919;9056;2575;8426;247;993;1756;5514;2003;6507
270490;201510;956;3083;895;2984;42;179;722;2373;764;2552
270500;201510;4926;16724;4638;16370;351;1500;3809;13388;4160;14888
270510;201510;5963;17798;5341;16940;721;2911;3828;11582;4549;14493
270520;201510;3631;11521;3317;10980;967;3504;1246;4170;2213;7674
270530;201510;1424;4331;1308;4157;159;524;871;2850;1030;3374
270540;201510;2013;6831;1835;6569;132;673;1463;5058;1595;5731
270550;201510;7122;20809;6185;19584;880;2946;4110;13261;4990;16207
270560;201510;3040;9197;2829;8878;332;1246;2036;6203;2368;7449
270570;201510;3955;12809;3614;12225;353;1498;2733;9031;3086;10529
270580;201510;1973;6349;1877;6219;190;650;1438;4845;1628;5495
270590;201510;1369;4541;1301;4424;24;109;1241;4207;1265;4316
270600;201510;2797;9341;2521;8879;175;864;1928;6612;2103;7476
270610;201510;3191;10054;2942;9685;221;815;2372;7742;2593;8557
270620;201510;1370;4662;1294;4538;97;478;1024;3426;1121;3904
270630;201510;16836;48386;15518;46225;2313;6766;10635;32398;12948;39164
270640;201510;5720;17616;5153;16810;343;1453;4125;13152;4468;14605
270642;201510;2255;7958;2111;7745;267;1199;1527;5503;1794;6702
270644;201510;2622;7658;2332;7298;254;719;1773;5691;2027;6410
270650;201510;3663;11667;3484;11406;529;2306;2333;7135;2862;9441
270660;201510;2464;6212;1910;5421;99;382;1356;3780;1455;4162
270670;201510;16304;42299;13974;39606;1860;5003;10180;29950;12040;34953
270680;201510;4254;12651;4072;12446;163;427;3724;11528;3887;11955
270690;201510;8790;24389;7930;23403;2504;7119;4018;12502;6522;19621
270700;201510;671;2071;607;1958;82;328;415;1276;497;1604
270710;201510;5943;19069;5647;18683;466;1791;4644;15219;5110;17010
270720;201510;3306;11170;3012;10647;159;843;2438;8420;2597;9263
270730;201510;6192;18570;5876;18222;675;2297;4697;14580;5372;16877
270740;201510;2318;6599;2181;6403;265;887;1623;4664;1888;5551
270750;201510;4908;15522;4557;14969;621;2213;3214;10475;3835;12688
270760;201510;3357;10157;3009;9570;208;765;2326;7351;2534;8116
270770;201510;19122;49888;15731;45738;3290;9563;8831;26823;12121;36386
270780;201510;1797;5926;1694;5752;219;859;1167;3927;1386;4786
270790;201510;1556;4850;1421;4642;346;1221;716;2271;1062;3492
270800;201510;11290;33390;10467;32298;808;2984;8508;25847;9316;28831
270810;201510;3343;10104;2587;8717;285;1153;1594;5339;1879;6492
270820;201510;1754;5873;1585;5583;270;1029;946;3333;1216;4362
270830;201510;5525;15266;4988;14599;432;1418;3929;11680;4361;13098
270840;201510;7814;25420;7222;24658;365;1842;6233;20816;6598;22658
270850;201510;7289;23139;7032;22810;1206;4720;4711;14444;5917;19164
270860;201510;11306;31500;9557;29208;1152;4141;6444;19193;7596;23334
270870;201510;2191;6599;1802;5781;274;918;1099;3487;1373;4405
270880;201510;8123;25991;7564;25161;567;2286;5983;19576;6550;21862
270890;201510;2403;7271;2250;6997;256;969;1631;4909;1887;5878
270895;201510;2852;10594;2728;10420;174;787;2335;8929;2509;9716
270900;201510;1948;5264;1568;4711;83;294;1187;3489;1270;3783
270910;201510;3507;11560;3271;11127;260;1171;2524;8324;2784;9495
270915;201510;9669;32245;8660;30412;1498;6113;4934;16867;6432;22980
270920;201510;6038;19199;5801;18869;236;1235;5176;16336;5412;17571
270930;201510;17488;46372;14300;42434;2793;8399;8289;25502;11082;33901
270940;201510;5715;18943;5426;18628;536;2330;4269;14446;4805;16776
280010;201510;647;1948;554;1774;58;253;344;1028;402;1281
280020;201510;4738;13825;4043;12611;736;2469;2427;7446;3163;9915
280030;201510;73929;193389;63256;177273;17821;52013;25256;71955;43077;123968
280040;201510;3137;9620;2779;9074;271;1017;2033;6588;2304;7605
280050;201510;3744;12031;3458;11527;1165;4110;1268;4331;2433;8441
280060;201510;4400;14355;4021;13668;811;2944;2136;7371;2947;10315
280067;201510;7359;20796;6298;19211;882;2705;4047;12466;4929;15171
280070;201510;1839;6201;1744;6057;286;1022;1206;4224;1492;5246
280100;201510;3810;11845;3402;11113;707;2465;1902;6236;2609;8701
280110;201510;1404;4274;1287;4098;76;338;1065;3312;1141;3650
280120;201510;7770;24435;7135;23415;1260;3809;4696;16111;5956;19920
280130;201510;7263;20595;6613;19633;1174;3704;4179;12465;5353;16169
280140;201510;5456;14934;4951;14210;476;1410;3846;11097;4322;12507
280150;201510;3367;10127;3104;9674;336;1187;2160;6522;2496;7709
280160;201510;1358;3959;1195;3694;144;474;812;2460;956;2934
280170;201510;4793;14175;4293;13426;480;1517;3166;10052;3646;11569
280190;201510;1081;3019;963;2816;70;240;724;2061;794;2301
280200;201510;1152;3458;1050;3302;132;516;734;2212;866;2728
280210;201510;13118;39713;11800;37821;2296;7729;6893;22377;9189;30106
280220;201510;1532;4726;1432;4563;94;353;1170;3662;1264;4015
280230;201510;3446;10281;3061;9656;391;1335;1972;6239;2363;7574
280240;201510;3419;10058;3099;9542;289;871;2374;7344;2663;8215
280250;201510;817;2152;669;1914;116;398;347;881;463;1279
280260;201510;2004;5368;1850;5177;81;251;1655;4653;1736;4904
280270;201510;2287;7055;1996;6606;128;515;1538;4991;1666;5506
280280;201510;4160;13486;3770;12824;854;2419;2089;7969;2943;10388
280290;201510;17052;52156;15337;49426;2256;7961;9481;30764;11737;38725
280300;201510;9497;28796;8820;27971;980;3323;6757;21842;7737;25165
280310;201510;1342;3790;1184;3538;74;305;837;2433;911;2738
280320;201510;8445;27101;7684;25754;1547;5698;3797;12530;5344;18228
280330;201510;4482;12592;4061;11903;402;1410;3117;8799;3519;10209
280340;201510;3732;10677;3506;10363;364;1215;2697;7953;3061;9168
280350;201510;21618;60925;19211;57255;2943;9125;12334;36926;15277;46051
280360;201510;5689;17836;5311;17201;1036;3850;2954;9255;3990;13105
280370;201510;1849;5177;1602;4757;145;457;1127;3301;1272;3758
280380;201510;1030;3115;940;2986;99;384;687;2112;786;2496
280390;201510;3097;9163;2640;8304;424;1406;1646;5142;2070;6548
280400;201510;4108;11785;3703;11192;1211;3589;1680;5345;2891;8934
280410;201510;2160;6850;1828;6199;250;963;1053;3418;1303;4381
280420;201510;4055;11899;3767;11442;240;777;3169;9591;3409;10368
280430;201510;2225;5688;2012;5392;106;348;1563;4086;1669;4434
280440;201510;4692;13889;4385;13522;390;1303;3540;10811;3930;12114
280445;201510;2462;6935;2279;6626;76;313;1823;5183;1899;5496
280450;201510;8751;23718;8147;22953;611;1516;6806;19682;7417;21198
280460;201510;6931;18292;6212;17262;872;2560;4360;12241;5232;14801
280470;201510;1793;5445;1620;5149;191;603;1151;3698;1342;4301
280480;201510;29989;87909;28388;85522;4730;16190;18304;53606;23034;69796
280490;201510;3780;11312;3293;10467;263;1012;2401;7449;2664;8461
280500;201510;915;2449;826;2333;55;182;677;1848;732;2030
280510;201510;2704;7787;2333;7299;225;791;1707;5346;1932;6137
280520;201510;1753;4851;1593;4649;153;433;1280;3788;1433;4221
280530;201510;2271;6434;2110;6230;154;457;1716;5109;1870;5566
280540;201510;9174;25176;8525;24281;239;1015;7448;20702;7687;21717
280550;201510;6866;18148;5796;16486;637;1838;4027;11498;4664;13336
280560;201510;7406;21985;7014;21400;399;1404;5858;17584;6257;18988
280570;201510;6400;17312;5591;16212;633;2079;3740;10609;4373;12688
280580;201510;5591;17239;4714;15685;834;2797;2728;9307;3562;12104
280590;201510;2332;7092;2167;6883;243;1067;1482;4507;1725;5574
280600;201510;3740;11420;3489;11043;339;1216;2610;8160;2949;9376
280610;201510;2455;6881;2247;6574;218;791;1601;4519;1819;5310
280620;201510;5188;15399;4501;14155;617;1856;2996;9732;3613;11588
280630;201510;3775;12204;3561;11885;380;1196;2794;9626;3174;10822
280640;201510;2213;6611;2104;6487;96;258;1943;6072;2039;6330
280650;201510;1115;3465;1000;3274;108;399;688;2239;796;2638
280660;201510;2626;7456;2510;7305;437;1204;1888;5575;2325;6779
280670;201510;15889;41725;14605;39938;2781;7967;9004;24385;11785;32352
280680;201510;2742;7394;2428;6901;214;701;1895;5283;2109;5984
280690;201510;945;2689;840;2541;127;398;573;1724;700;2122
280700;201510;1083;3203;950;2999;69;231;687;2169;756;2400
280710;201510;11605;30764;10621;29633;772;2031;8925;25357;9697;27388
280720;201510;2247;6173;2038;5924;264;790;1414;4187;1678;4977
280730;201510;922;2758;861;2671;91;320;686;2089;777;2409
280740;201510;13048;35440;11248;32687;1602;4607;7163;21137;8765;25744
280750;201510;3536;10722;3217;10168;345;1188;2226;7048;2571;8236
280760;201510;5619;17117;5076;16328;767;2630;3156;10368;3923;12998
290010;201510;2999;6735;2139;5404;54;226;1687;4043;1741;4269
290020;201510;4369;14592;4289;14480;399;1115;3550;12222;3949;13337
290030;201510;3111;9736;2932;9462;542;1732;1959;6390;2501;8122
290035;201510;4654;11862;3989;10980;238;800;3122;8802;3360;9602
290040;201510;3885;10665;3350;10055;214;852;2653;7816;2867;8668
290050;201510;2496;8073;2200;7583;170;699;1641;5612;1811;6311
290060;201510;1307;3372;1109;3135;203;657;782;2130;985;2787
290070;201510;32843;82105;27815;75754;6158;16493;13305;38510;19463;55003
290080;201510;6135;18140;5197;16901;686;2232;3692;12354;4378;14586
290090;201510;2157;4691;1697;4200;176;401;1392;3519;1568;3920
290100;201510;9713;27592;8451;25598;1164;3671;5306;16402;6470;20073
290110;201510;4814;14297;4547;13823;708;2321;2926;8716;3634;11037
290115;201510;4784;14393;4215;13628;249;840;3421;11285;3670;12125
290120;201510;6836;17760;5665;16357;284;962;4687;13390;4971;14352
290130;201510;4580;12019;3815;11072;211;790;3047;8561;3258;9351
290135;201510;4546;11519;3880;10486;267;900;2848;7322;3115;8222
290140;201510;4107;12781;3538;11997;285;1106;2862;9694;3147;10800
290150;201510;2144;6439;2028;6244;259;847;1535;4657;1794;5504
290160;201510;3340;8834;3211;8674;305;633;2672;7300;2977;7933
290170;201510;2723;9036;2465;8638;188;904;2034;6944;2222;7848
290180;201510;2898;8436;2526;7855;198;735;1929;5947;2127;6682
290190;201510;3758;12532;3585;12258;221;929;2753;9280;2974;10209
290195;201510;2170;5924;1841;5422;98;381;1470;4267;1568;4648
290200;201510;3813;11902;3378;11205;297;992;2611;8734;2908;9726
290205;201510;3126;9229;2775;8685;294;1085;1953;5971;2247;7056
290210;201510;14937;42002;13684;40385;2531;6663;8963;28368;11494;35031
290220;201510;2221;6638;2091;6429;143;600;1626;4825;1769;5425
290225;201510;2879;7487;2621;7198;170;484;2327;6393;2497;6877
290230;201510;2289;7388;2178;7258;139;564;1787;5929;1926;6493
290240;201510;3641;9823;3316;9333;315;935;2465;6823;2780;7758
290250;201510;3699;11848;3278;11219;190;685;2687;9397;2877;10082
290260;201510;4823;13989;4128;12888;343;1200;3134;9736;3477;10936
290265;201510;3307;10388;2940;9710;161;691;2286;7468;2447;8159
290270;201510;11941;43358;11305;42337;1517;5982;8092;30720;9609;36702
290280;201510;5207;17070;4837;16461;418;1595;3652;12434;4070;14029
290290;201510;9616;30395;8580;28666;1375;4687;5595;19052;6970;23739
290300;201510;4602;13035;3266;10529;278;868;2135;7151;2413;8019
290310;201510;1493;4434;1311;4147;247;866;726;2266;973;3132
290320;201510;27916;80696;23623;74883;5688;19089;11404;37063;17092;56152
290323;201510;3813;10307;3339;9768;176;548;2779;8109;2955;8657
290327;201510;4322;13224;3701;12065;573;1933;2292;7453;2865;9386
290330;201510;1811;4512;1674;4363;146;399;1441;3761;1587;4160
290340;201510;4791;14985;4466;14558;1323;4328;2379;7852;3702;12180
290350;201510;4369;13584;3808;12735;432;1466;2623;9007;3055;10473
290360;201510;4501;13690;3896;12876;178;688;3240;10781;3418;11469
290370;201510;4714;13152;4048;12277;419;1144;3179;9849;3598;10993
290380;201510;5559;16053;4827;14958;370;1349;3757;11654;4127;13003
290390;201510;14483;44542;13151;42542;2391;7891;7871;26452;10262;34343
290395;201510;2625;8483;2320;7917;146;648;1722;5855;1868;6503
290400;201510;3515;10443;3037;9755;298;997;2164;6922;2462;7919
290405;201510;4616;14614;3860;13138;589;2029;2293;7988;2882;10017
290410;201510;5994;17622;4861;15816;481;1851;3386;10683;3867;12534
290420;201510;3278;9428;2728;8650;224;767;2107;6657;2331;7424
290430;201510;3045;9611;2745;9072;484;1699;1686;5614;2170;7313
290440;201510;2949;7852;2414;7098;182;652;1849;5453;2031;6105
290450;201510;3295;9516;2831;8843;332;1123;1949;6072;2281;7195
290460;201510;12782;37084;11398;34753;3010;9385;4885;14983;7895;24368
290470;201510;4507;12322;3419;10694;784;2701;1520;4871;2304;7572
290475;201510;5030;17009;4502;15982;345;1586;3319;11580;3664;13166
290480;201510;2484;6595;2268;6311;323;927;1536;4453;1859;5380
290485;201510;4780;15101;4157;14170;321;1554;3265;10832;3586;12386
290490;201510;7946;20960;7544;20410;666;1889;6065;16246;6731;18135
290500;201510;4197;13086;3384;11454;526;1942;1784;5991;2310;7933
290510;201510;3355;9594;2906;8966;174;644;2405;7422;2579;8066
290515;201510;3281;9506;2789;8841;298;970;2153;6931;2451;7901
290520;201510;12098;36977;9707;32436;861;3440;5941;19657;6802;23097
290530;201510;5075;14896;4426;13892;334;1030;3463;10926;3797;11956
290540;201510;3881;11251;3675;10995;430;1267;2855;8669;3285;9936
290550;201510;4472;11940;3948;11329;149;445;3581;10317;3730;10762
290560;201510;6144;17992;5402;16882;1309;4137;2975;9536;4284;13673
290570;201510;42594;116454;38350;110332;4300;12716;26997;77530;31297;90246
290580;201510;6992;23703;6557;23011;841;3073;4666;16725;5507;19798
290590;201510;7376;23365;6299;21420;324;1355;5015;16999;5339;18354
290600;201510;17254;52298;15908;50282;2353;7172;11319;36975;13672;44147
290610;201510;2475;8296;2044;7442;150;706;1426;5093;1576;5799
290620;201510;6497;19544;5894;18590;403;1287;4784;15064;5187;16351
290630;201510;7941;20818;7016;19798;629;1835;5778;16418;6407;18253
290640;201510;2673;7745;2117;6825;152;607;1589;5032;1741;5639
290650;201510;11158;31594;10351;30458;2176;6275;6317;19150;8493;25425
290660;201510;3623;10092;3116;9349;149;508;2365;7305;2514;7813
290670;201510;6857;20902;6144;19728;716;2339;4317;14103;5033;16442
290680;201510;10217;30366;9196;29100;461;1804;7609;23889;8070;25693
290682;201510;4456;12792;3972;12098;166;628;3388;10193;3554;10821
290685;201510;3742;8900;2445;7051;293;884;1480;4369;1773;5253
290687;201510;7625;21135;5935;18604;1402;4471;2868;9337;4270;13808
290689;201510;3158;9119;2733;8444;259;842;2060;6546;2319;7388
290690;201510;5486;15618;4862;14778;760;2361;3194;9736;3954;12097
290700;201510;2349;7312;2211;7108;182;671;1680;5386;1862;6057
290710;201510;7702;24360;7220;23630;363;1242;6143;20201;6506;21443
290720;201510;18545;54130;16800;51934;1400;4171;13586;42927;14986;47098
290730;201510;7145;19759;6373;18746;1057;3014;4154;12382;5211;15396
290740;201510;929;2750;772;2472;85;292;515;1663;600;1955
290750;201510;9938;27644;8331;24663;1473;4822;4432;12605;5905;17427
290755;201510;2355;6614;1916;5883;96;340;1407;4282;1503;4622
290760;201510;4272;12785;3459;11316;456;1375;2150;7236;2606;8611
290770;201510;2512;8837;2376;8649;103;480;1909;6962;2012;7442
290780;201510;8928;22511;7681;20709;823;1715;5799;16342;6622;18057
290790;201510;4286;12940;3970;12489;256;825;3328;10506;3584;11331
290800;201510;7335;15559;5816;13926;682;1354;4286;10927;4968;12281
290810;201510;5104;15775;4290;14454;215;810;3236;10998;3451;11808
290820;201510;5639;15669;4973;14778;474;1612;3757;11186;4231;12798
290830;201510;4287;11455;3908;10900;237;798;2943;7986;3180;8784
290840;201510;17580;49490;15463;46302;2539;7409;9878;30728;12417;38137
290850;201510;6212;17909;5968;17593;728;1912;4733;14499;5461;16411
290860;201510;4991;16875;4637;16440;489;1840;3563;12902;4052;14742
290870;201510;4646;13644;3753;12159;268;1077;2706;8675;2974;9752
290880;201510;1426;3861;1118;3359;97;280;750;2274;847;2554
290890;201510;6954;18168;5943;17032;702;1887;4593;13386;5295;15273
290900;201510;2636;7358;1929;6168;299;995;951;3045;1250;4040
290910;201510;4608;12460;3867;11371;122;456;3307;9601;3429;10057
290920;201510;4648;13492;4242;12915;325;937;3429;10548;3754;11485
290930;201510;7710;23871;6792;22280;434;1856;5218;16843;5652;18699
290940;201510;3460;10953;3179;10567;149;512;2712;9189;2861;9701
290950;201510;1542;4280;1352;3993;168;476;884;2661;1052;3137
290960;201510;5735;16218;5204;15528;193;703;4343;12990;4536;13693
290970;201510;3651;11511;3180;10723;325;1113;2139;7321;2464;8434
290980;201510;10508;30000;8858;26911;2404;7475;2855;8692;5259;16167
290990;201510;9035;27021;7818;25003;854;2828;5631;17879;6485;20707
291000;201510;2907;8868;2642;8538;183;678;2281;7382;2464;8060
291005;201510;14191;37138;12394;34688;1804;5116;8324;23686;10128;28802
291010;201510;3296;10165;2562;8583;271;932;1612;5478;1883;6410
291020;201510;1385;3616;1043;2997;119;354;572;1549;691;1903
291030;201510;2273;6188;1642;4937;172;550;982;2884;1154;3434
291040;201510;5521;16521;4908;15651;392;1434;3788;12063;4180;13497
291050;201510;7697;25022;6954;23608;1707;6492;3478;11362;5185;17854
291060;201510;5986;21899;5627;21308;926;3916;3573;13335;4499;17251
291070;201510;16072;46121;14015;43122;1146;3854;10618;32700;11764;36554
291072;201510;22932;67059;18347;57940;4650;15876;6391;20298;11041;36174
291075;201510;5058;14288;4472;13461;265;680;3496;10819;3761;11499
291077;201510;1486;4174;1180;3669;95;318;763;2367;858;2685
291080;201510;77979;240913;68775;222550;23471;77104;16524;52797;39995;129901
291085;201510;5621;14747;4837;13705;458;1351;3851;10915;4309;12266
291090;201510;1480;3677;1339;3506;58;180;1174;3066;1232;3246
291100;201510;2617;6674;2127;6145;102;394;1679;4783;1781;5177
291110;201510;4687;17148;4287;16515;555;2439;2961;11219;3516;13658
291120;201510;7346;19696;6738;18790;880;2490;4709;13227;5589;15717
291125;201510;1880;3779;1418;3284;99;238;1115;2631;1214;2869
291130;201510;2853;8858;2399;8057;132;575;1783;5827;1915;6402
291140;201510;4181;12362;3666;11404;525;1583;2331;7316;2856;8899
291150;201510;1957;5169;1849;5042;121;377;1511;4059;1632;4436
291160;201510;5347;16548;4648;15367;1131;3746;2356;7833;3487;11579
291165;201510;2526;7063;1936;5952;59;234;1398;4189;1457;4423
291170;201510;21509;55744;18331;51489;1381;4241;12668;35559;14049;39800
291180;201510;6309;16457;5082;14588;466;1497;3602;10331;4068;11828
291185;201510;3757;10196;3353;9588;303;873;2661;7554;2964;8427
291190;201510;7093;19401;6248;18219;509;1732;4946;14262;5455;15994
291200;201510;2901;8595;2321;7512;162;534;1563;5144;1725;5678
291210;201510;6923;16607;5832;15348;304;937;4509;11841;4813;12778
291220;201510;4140;12845;3771;12256;501;1867;2539;8131;3040;9998
291230;201510;4026;10226;3647;9799;84;184;3416;9292;3500;9476
291240;201510;4624;12483;3970;11286;150;479;3204;8950;3354;9429
291250;201510;3555;10838;2802;9452;299;1016;1855;6342;2154;7358
291260;201510;1066;3102;977;2983;68;270;806;2386;874;2656
291270;201510;4423;14202;3999;13384;1338;4636;1806;6135;3144;10771
291280;201510;2226;6139;1719;5349;409;1395;812;2403;1221;3798
291290;201510;5532;15281;4791;14325;857;2575;2813;8524;3670;11099
291300;201510;4388;12435;3402;10730;224;823;2496;7741;2720;8564
291310;201510;5381;15319;4681;14036;320;1016;3587;10710;3907;11726
291320;201510;6032;18944;4966;16885;1139;4117;2412;8132;3551;12249
291330;201510;1581;4754;1403;4461;134;485;981;3061;1115;3546
291340;201510;3889;11045;3215;10087;152;513;2567;8019;2719;8532
291345;201510;3485;10959;3229;10650;226;759;2722;9164;2948;9923
291350;201510;5678;16618;4954;15371;302;1019;3852;12079;4154;13098
291360;201510;32873;90908;29535;86183;7304;21281;16434;49369;23738;70650
291370;201510;8363;23857;7844;23203;562;1776;6107;18232;6669;20008
291380;201510;3657;11077;3123;10204;226;826;2252;7485;2478;8311
291390;201510;9986;27202;9238;26290;1410;3806;6588;19010;7998;22816
291400;201510;15134;40178;12490;36420;2400;6451;7310;22878;9710;29329
291410;201510;3230;8462;2392;7142;147;613;1733;4977;1880;5590
291420;201510;2088;5716;1818;5386;100;367;1506;4379;1606;4746
291430;201510;3262;9530;2905;9057;142;677;2350;7087;2492;7764
291440;201510;6543;19900;5518;18136;550;1927;4035;13378;4585;15305
291450;201510;8277;24193;7256;22753;374;1193;5759;18784;6133;19977
291460;201510;13105;39453;11721;37241;1784;6159;7190;22903;8974;29062
291465;201510;8005;22648;7081;21591;490;1735;5727;17322;6217;19057
291470;201510;15744;42291;13755;39872;1167;3249;10307;30854;11474;34103
291480;201510;34156;87899;28817;80401;4036;12332;17007;47225;21043;59557
291490;201510;4335;13934;4115;13621;458;1585;3072;10258;3530;11843
291500;201510;4298;12261;3629;11277;237;879;2843;8769;3080;9648
291510;201510;3551;10712;3246;10308;86;296;2911;9320;2997;9616
291520;201510;3895;10543;3348;9796;355;1112;2269;6655;2624;7767
291530;201510;2135;5920;1719;5295;411;1286;854;2775;1265;4061
291535;201510;3815;11471;3425;10867;223;777;2657;8464;2880;9241
291540;201510;2160;5092;1803;4718;146;260;1560;4234;1706;4494
291550;201510;5197;13980;4514;13022;1009;2766;2498;7447;3507;10213
291560;201510;18389;43461;13144;37352;1132;3190;9816;28816;10948;32006
291570;201510;2220;5934;2038;5710;157;368;1726;4994;1883;5362
291580;201510;5574;16823;4907;15832;541;2173;3494;11116;4035;13289
291590;201510;1755;5545;1585;5266;172;619;1160;3891;1332;4510
291600;201510;5722;15445;4131;12960;1126;3671;1627;5017;2753;8688
291610;201510;4877;15333;4701;15122;181;651;4236;13688;4417;14339
291620;201510;2982;7007;2336;6323;145;429;1864;5159;2009;5588
291630;201510;3174;7663;2632;7035;281;733;1986;5384;2267;6117
291640;201510;17136;46315;13691;41246;3368;10657;4472;13779;7840;24436
291650;201510;7909;23624;7307;22889;659;1743;6010;19383;6669;21126
291660;201510;2202;5774;1823;5189;162;556;1190;3227;1352;3783
291670;201510;1807;5083;1635;4838;100;288;1314;3945;1414;4233
291680;201510;4123;11922;3543;10939;663;2206;2028;6227;2691;8433
291685;201510;4718;11826;3893;10727;676;1768;2500;7146;3176;8914
291690;201510;4022;10674;3126;9203;230;634;2204;6483;2434;7117
291700;201510;9055;28155;8040;26366;972;3139;5799;19286;6771;22425
291710;201510;5202;13509;4220;12277;369;1152;3074;8966;3443;10118
291720;201510;4345;14330;3694;12980;350;1396;2529;8750;2879;10146
291730;201510;5978;17846;5415;17080;567;1910;4132;13215;4699;15125
291733;201510;2567;7440;2188;6921;216;739;1434;4647;1650;5386
291735;201510;2787;7766;2312;7062;126;462;1849;5597;1975;6059
291740;201510;3601;10654;3095;9917;248;918;2412;7680;2660;8598
291750;201510;22402;57301;17197;49186;3905;11469;8295;24244;12200;35713
291760;201510;11101;35182;9756;32814;3903;14466;2632;8729;6535;23195
291770;201510;7609;21892;6434;19748;865;2832;4097;12345;4962;15177
291780;201510;4455;13440;4153;12925;309;1002;3346;10385;3655;11387
291790;201510;2634;8067;2485;7861;95;415;2101;6527;2196;6942
291800;201510;29971;81784;26154;76391;4305;12667;16088;48473;20393;61140
291810;201510;10554;29089;8838;26970;435;1583;7131;21676;7566;23259
291820;201510;3697;10897;3314;10329;239;813;2530;7896;2769;8709
291830;201510;4129;10990;3797;10506;535;1521;2711;7562;3246;9083
291835;201510;6292;19554;4999;17227;1418;5248;2328;8083;3746;13331
291840;201510;47386;132006;41504;125264;6355;18700;28966;90169;35321;108869
291845;201510;2694;7873;2507;7636;166;429;2217;6925;2383;7354
291850;201510;4609;13132;3766;11792;378;1081;2751;8894;3129;9975
291855;201510;1808;4558;1551;4229;174;600;1121;2929;1295;3529
291860;201510;2141;6089;1738;5310;94;350;1144;3416;1238;3766
291870;201510;1422;3780;1023;3034;72;269;647;1842;719;2111
291875;201510;2826;8871;2555;8457;128;535;1840;5947;1968;6482
291880;201510;4887;15613;4560;15053;444;1487;3439;11470;3883;12957
291890;201510;1295;3343;1081;3085;284;790;631;1903;915;2693
291900;201510;1273;3437;1042;3069;71;258;803;2334;874;2592
291905;201510;2721;7355;2066;6195;167;601;1450;4144;1617;4745
291910;201510;2747;7296;2292;6750;132;503;1919;5560;2051;6063
291915;201510;7048;21336;5881;19204;336;1188;4583;15050;4919;16238
291920;201510;28561;82511;25863;78626;4432;13937;15517;47565;19949;61502
291930;201510;2624;7700;2305;7185;202;742;1631;4960;1833;5702
291940;201510;3349;9514;2444;7848;325;1159;1386;4313;1711;5472
291950;201510;8648;28822;7821;27264;1238;4359;4582;16436;5820;20795
291955;201510;10101;29565;9386;28665;2184;6685;5406;17279;7590;23964
291960;201510;3167;9221;2567;8314;247;808;1856;6212;2103;7020
291970;201510;3859;11980;3571;11516;427;1546;2371;7655;2798;9201
291980;201510;11931;33788;9058;29614;1087;3649;5986;20077;7073;23726
291990;201510;2197;6675;1986;6395;91;296;1662;5499;1753;5795
291992;201510;2758;8380;2684;8239;370;1186;2011;6138;2381;7324
291995;201510;1986;5774;1741;5417;115;424;1459;4530;1574;4954
292000;201510;2395;6717;2130;6351;257;892;1486;4428;1743;5320
292010;201510;6373;16082;4916;13971;501;1354;3599;10370;4100;11724
292020;201510;3977;13756;3751;13359;636;2379;2650;9409;3286;11788
292030;201510;2037;6260;1807;5927;229;801;1044;3397;1273;4198
292040;201510;4415;11923;3767;11238;296;654;3164;9982;3460;10636
292045;201510;3039;9903;2821;9592;115;451;2566;8616;2681;9067
292050;201510;6285;19084;5360;17203;457;1744;3482;11003;3939;12747
292060;201510;11486;30861;10608;29731;1158;2889;8206;23199;9364;26088
292070;201510;4686;14398;4417;14087;424;1297;3629;11720;4053;13017
292080;201510;3540;9183;2921;8406;195;622;2449;7060;2644;7682
292090;201510;3965;10380;3409;9727;220;744;2857;8176;3077;8920
292100;201510;11295;30143;9390;27480;2521;7659;4199;12839;6720;20498
292105;201510;3011;9328;2685;8806;135;571;2153;7025;2288;7596
292110;201510;6565;17422;5084;15047;1384;4098;2441;7400;3825;11498
292120;201510;7710;21531;6422;19073;1319;3863;3401;10416;4720;14279
292130;201510;2965;8017;2533;7394;480;1290;1526;4643;2006;5933
292140;201510;4988;12956;4124;11733;807;2102;2628;7702;3435;9804
292145;201510;2445;7446;2165;6959;308;961;1426;4776;1734;5737
292150;201510;12805;38940;11739;37195;652;2348;9345;29650;9997;31998
292160;201510;2526;7255;2137;6748;119;462;1831;5717;1950;6179
292170;201510;8724;24838;7184;22128;889;3080;4606;14027;5495;17107
292180;201510;2974;8688;2384;7649;374;1149;1407;4632;1781;5781
292190;201510;3436;9590;2839;8696;587;1881;1575;4881;2162;6762
292200;201510;6703;20659;5672;18772;1683;5985;1979;6502;3662;12487
292205;201510;3782;11589;3351;10916;176;792;2691;8484;2867;9276
292210;201510;6465;17450;5387;16024;358;1264;4370;12940;4728;14204
292220;201510;1890;5202;1685;4888;540;1468;720;2143;1260;3611
292225;201510;3221;9870;2918;9418;182;723;2349;7529;2531;8252
292230;201510;6465;18919;6091;18306;362;1508;4693;13542;5055;15050
292240;201510;4774;14295;4252;13236;493;1613;2945;9065;3438;10678
292250;201510;5064;15523;4638;14726;1164;3790;2020;6498;3184;10288
292260;201510;3126;9259;2916;8969;208;658;2414;7453;2622;8111
292265;201510;3117;9511;2667;8739;141;619;1999;6404;2140;7023
292270;201510;4102;10357;3229;9343;171;567;2672;7772;2843;8339
292273;201510;2757;6353;2073;5510;205;504;1528;4267;1733;4771
292275;201510;1680;4506;1483;4215;199;573;1072;3092;1271;3665
292280;201510;2071;5954;1790;5634;177;510;1348;4506;1525;5016
292285;201510;2520;6798;2096;6180;116;421;1638;4745;1754;5166
292290;201510;7114;21164;5893;19508;412;1599;4523;15060;4935;16659
292300;201510;8084;24167;7028;22854;1747;5948;3846;12807;5593;18755
292303;201510;2824;8593;2561;8236;105;445;2182;6870;2287;7315
292305;201510;2933;7907;2756;7649;64;243;2494;6829;2558;7072
292310;201510;5863;17296;5414;16615;207;713;4465;13669;4672;14382
292320;201510;6530;18495;5520;16779;454;1453;4171;12620;4625;14073
292330;201510;2171;5839;1989;5580;176;581;1570;4327;1746;4908
292335;201510;5109;13373;4548;12632;459;1233;3637;10251;4096;11484
292340;201510;6236;17806;5293;16229;537;1652;3705;11405;4242;13057
292350;201510;2268;6667;1972;6241;186;698;1527;4804;1713;5502
292360;201510;5207;13697;4940;13183;221;452;4125;11534;4346;11986
292370;201510;8060;23523;7295;22467;721;1944;5653;17771;6374;19715
292380;201510;7232;21325;6577;20279;561;1598;5151;16087;5712;17685
292390;201510;3439;7848;2917;7282;93;204;2675;6733;2768;6937
292400;201510;20597;62079;19377;60157;2427;7693;14126;44009;16553;51702
292405;201510;4513;11269;3609;10094;206;534;2897;8181;3103;8715
292410;201510;1936;5187;1809;5048;132;372;1524;4230;1656;4602
292420;201510;3723;12086;3518;11782;238;891;2913;9779;3151;10670
292430;201510;5594;16515;4198;14473;303;1240;2994;10258;3297;11498
292440;201510;8419;27776;7773;26803;237;1014;6921;24002;7158;25016
292450;201510;4011;11932;3276;10719;336;1108;2277;7547;2613;8655
292460;201510;5156;15269;4420;14003;620;2079;2881;9113;3501;11192
292465;201510;2388;7068;1984;6396;205;759;1280;4165;1485;4924
292467;201510;1910;6085;1812;5929;294;1022;1202;4006;1496;5028
292470;201510;2874;7705;2369;6849;107;373;1866;5331;1973;5704
292480;201510;6038;16208;5201;15089;163;613;4640;13375;4803;13988
292490;201510;2368;6489;1946;5858;152;497;1493;4471;1645;4968
292500;201510;6485;19207;5497;17427;681;2222;3579;11480;4260;13702
292510;201510;12867;36204;11085;33656;853;2990;8498;25929;9351;28919
292520;201510;5428;15682;4720;14564;1145;3552;2417;7568;3562;11120
292525;201510;5214;13701;4469;12815;200;644;3765;10784;3965;11428
292530;201510;27323;76705;23389;71260;6186;19485;10723;33614;16909;53099
292540;201510;2823;7794;2487;7362;272;928;1896;5550;2168;6478
292550;201510;6434;19797;5585;18679;644;2297;4179;14319;4823;16616
292560;201510;3989;11093;3459;10304;188;736;2660;7770;2848;8506
292570;201510;4055;11796;3755;11483;78;178;3546;11094;3624;11272
292575;201510;6212;20638;5994;20286;711;2453;4681;15962;5392;18415
292580;201510;6774;19946;6357;19366;401;1291;5310;16162;5711;17453
292590;201510;7192;21542;6647;20720;515;1610;5437;16878;5952;18488
292593;201510;3022;7862;2488;7022;224;578;1893;5344;2117;5922
292595;201510;5788;16002;5081;15085;398;1255;3927;11701;4325;12956
292600;201510;10608;29824;9524;28432;943;2276;7280;22566;8223;24842
292610;201510;4561;12803;3704;11386;328;1034;2244;7195;2572;8229
292620;201510;5985;17424;5250;16571;126;426;4864;15431;4990;15857
292630;201510;9318;23399;7693;20888;871;2293;5261;14583;6132;16876
292640;201510;7796;25178;7156;24207;477;1784;5429;18546;5906;20330
292650;201510;4747;12646;4444;12248;387;893;3701;10331;4088;11224
292660;201510;10593;31799;9742;30553;1052;3398;7280;23105;8332;26503
292665;201510;2539;7770;2429;7627;52;127;2263;7175;2315;7302
292670;201510;3689;10395;2856;8900;194;659;1826;5668;2020;6327
292680;201510;3602;10790;3263;10221;422;1238;2322;7304;2744;8542
292690;201510;2883;7854;2121;6646;176;576;1468;4710;1644;5286
292700;201510;9196;27310;8065;25614;1160;3464;5213;17337;6373;20801
292710;201510;2082;6782;1960;6619;74;292;1732;5851;1806;6143
292720;201510;9224;23465;7923;22013;361;1171;6774;18903;7135;20074
292730;201510;3566;10649;3417;10422;315;1000;2608;7974;2923;8974
292740;201510;322427;860235;299516;825576;53108;154929;187316;511261;240424;666190
292750;201510;6426;17191;5492;15890;303;989;4427;12804;4730;13793
292760;201510;4007;12503;3602;11756;423;1469;2402;7886;2825;9355
292770;201510;6029;17520;5291;16473;993;3247;3148;10048;4141;13295
292780;201510;1883;4460;1437;3878;134;452;1007;2614;1141;3066
292790;201510;3259;7992;3119;7846;91;173;2954;7519;3045;7692
292800;201510;8959;26506;8248;25315;508;1717;6593;20122;7101;21839
292805;201510;2924;8258;2588;7778;329;1069;1881;5626;2210;6695
292810;201510;9385;28069;7827;25887;939;3220;5412;18271;6351;21491
292820;201510;7051;20537;5462;18228;308;1254;4239;14110;4547;15364
292830;201510;1779;5131;1594;4867;77;332;1376;4129;1453;4461
292840;201510;7606;23479;7086;22772;329;1343;6204;19610;6533;20953
292850;201510;3186;8362;2576;7418;352;1030;1566;4420;1918;5450
292860;201510;14829;38595;13542;36883;1190;3357;10443;28302;11633;31659
292870;201510;19002;51808;16455;47740;2164;6915;9583;27306;11747;34221
292880;201510;12660;35747;11164;33601;1221;4071;7681;22716;8902;26787
292890;201510;5290;17824;4760;16867;678;2549;3086;11072;3764;13621
292895;201510;2738;6688;2133;5769;264;659;1461;4008;1725;4667
292900;201510;2769;8536;2627;8307;186;827;1933;5814;2119;6641
292905;201510;4050;11921;3355;10847;219;801;2474;7978;2693;8779
292910;201510;4985;14815;4498;13910;635;2074;2699;8341;3334;10415
292920;201510;9019;26362;8495;25557;568;2061;6938;20261;7506;22322
292925;201510;5083;15422;4562;14652;420;1367;3437;11082;3857;12449
292930;201510;6446;20614;6085;19955;481;2062;4358;13876;4839;15938
292935;201510;2093;6010;1755;5642;113;411;1450;4802;1563;5213
292937;201510;3203;8139;2645;7447;229;693;2049;5741;2278;6434
292940;201510;3256;8889;2536;7878;296;920;1695;5484;1991;6404
292950;201510;7909;23142;7312;22114;564;2070;5356;15738;5920;17808
292960;201510;5183;13378;4442;12365;322;962;3253;8985;3575;9947
292970;201510;4251;12684;3728;11972;161;717;3045;9700;3206;10417
292975;201510;3436;9213;3228;8942;357;909;2696;7610;3053;8519
292980;201510;3278;8795;2526;7728;225;798;1811;5484;2036;6282
292990;201510;11820;33815;10334;31535;442;1571;8455;25611;8897;27182
293000;201510;2810;7294;2544;6976;62;200;2083;5976;2145;6176
293010;201510;17909;49388;15106;44812;2527;7952;8784;25758;11311;33710
293015;201510;7388;25259;6537;23555;790;3239;4207;15013;4997;18252
293020;201510;9106;30230;8511;29400;355;1579;7275;25005;7630;26584
293030;201510;5401;15610;4289;13861;290;972;3033;10176;3323;11148
293040;201510;3651;12003;3478;11670;195;669;3035;10192;3230;10861
293050;201510;19944;54809;17488;51684;2932;8919;10135;31097;13067;40016
293060;201510;3812;9971;3095;8785;263;806;2242;6263;2505;7069
293070;201510;21386;61354;18573;56950;4564;14041;8980;28375;13544;42416
293075;201510;3258;11015;2991;10616;235;969;2307;8210;2542;9179
293076;201510;3770;10353;3378;9824;203;560;2819;8367;3022;8927
293077;201510;4725;14890;4255;14198;1040;3648;2245;7675;3285;11323
293080;201510;4525;14295;4119;13634;209;986;3389;10984;3598;11970
293090;201510;3250;10447;2683;9578;293;1095;1872;6797;2165;7892
293100;201510;5759;16993;4766;15213;456;1557;3446;11097;3902;12654
293105;201510;3979;13042;3443;11986;564;1904;2132;7634;2696;9538
293110;201510;1999;5710;1758;5344;64;218;1458;4434;1522;4652
293120;201510;3722;12296;3522;11979;352;1096;2711;9464;3063;10560
293130;201510;4061;11442;3435;10750;149;538;3051;9629;3200;10167
293135;201510;31411;78865;23457;67491;4888;15797;9412;26714;14300;42511
293140;201510;1958;5575;1861;5438;143;525;1486;4187;1629;4712
293150;201510;5469;17999;4667;16392;793;2858;2798;10041;3591;12899
293160;201510;3761;9604;3439;9227;599;1206;2438;7103;3037;8309
293170;201510;3313;9813;3020;9389;327;1187;2112;6578;2439;7765
293180;201510;5226;14621;4161;12873;181;749;3220;9713;3401;10462
293190;201510;13767;41418;12684;39768;450;2119;10872;33393;11322;35512
293200;201510;7005;19338;6077;18138;212;775;4826;14468;5038;15243
293210;201510;4930;14263;4330;13213;291;960;3292;10013;3583;10973
293220;201510;5091;14840;4371;13563;1156;3624;1675;5330;2831;8954
293230;201510;3823;11652;3463;11090;497;1736;2360;7543;2857;9279
293240;201510;4400;11990;3515;10512;145;470;2599;7749;2744;8219
293245;201510;4188;12022;3802;11443;307;910;2887;8745;3194;9655
293250;201510;5715;15736;5137;14865;533;1599;3641;10481;4174;12080
293260;201510;4581;13579;3867;12528;280;950;2895;9475;3175;10425
293270;201510;5641;14967;5218;14514;424;1004;4509;12792;4933;13796
293280;201510;5299;14858;4500;13780;256;783;3544;10999;3800;11782
293290;201510;14933;49116;13802;46883;3299;11615;6463;22308;9762;33923
293300;201510;6839;16123;5708;14807;352;825;4448;11745;4800;12570
293305;201510;4843;11988;4090;10972;155;481;3438;9163;3593;9644
293310;201510;2509;6537;2023;5700;184;508;1392;3921;1576;4429
293315;201510;4208;10761;3590;9796;427;1117;2577;7128;3004;8245
293317;201510;2451;7119;2173;6600;211;641;1466;4489;1677;5130
293320;201510;7920;26258;7705;25979;738;2731;6185;20861;6923;23592
293325;201510;1836;5199;1493;4661;203;700;985;3071;1188;3771
293330;201510;51137;161761;45426;151550;9826;35032;22210;74572;32036;109604
293340;201510;2675;7515;2067;6454;319;1028;1122;3495;1441;4523
293345;201510;3338;9796;2886;9178;267;722;2209;7350;2476;8072
293350;201510;6651;18993;6264;18538;310;721;5570;16982;5880;17703
293360;201510;12934;39523;11665;37906;976;3585;9769;31634;10745;35219
310010;201510;998;2708;764;2335;133;504;331;934;464;1438
310020;201510;3171;9801;2547;8507;574;2107;414;1227;988;3334
310030;201510;2337;7265;1910;6513;433;1644;992;3312;1425;4956
310040;201510;1027;2683;841;2433;68;239;643;1820;711;2059
310050;201510;1904;6462;1702;6000;330;1305;695;2383;1025;3688
310060;201510;3227;10193;2813;9658;376;1351;1989;6849;2365;8200
310070;201510;336;960;262;823;26;111;153;441;179;552
310080;201510;730;2180;581;1919;113;476;210;626;323;1102
310090;201510;4673;13806;3984;12577;515;1805;2477;7729;2992;9534
310100;201510;3347;10131;2778;9160;207;800;2121;6961;2328;7761
310110;201510;4831;13522;4110;12334;690;2338;2269;6576;2959;8914
310120;201510;612;1859;481;1582;133;550;185;491;318;1041
310130;201510;422;1261;376;1188;92;343;189;542;281;885
310140;201510;200;665;163;599;53;240;42;122;95;362
310150;201510;4650;14204;4002;12932;986;3494;1530;4803;2516;8297
310160;201510;7559;23462;6110;20788;1794;6629;1349;4416;3143;11045
310163;201510;987;3149;815;2801;216;782;230;776;446;1558
310170;201510;9033;25462;8056;24036;1250;3903;5170;15687;6420;19590
310180;201510;1625;4655;1358;4234;307;1065;635;1891;942;2956
310190;201510;2753;9111;2503;8702;703;2660;365;1261;1068;3921
310200;201510;1883;6083;1563;5418;350;1356;538;1835;888;3191
310205;201510;1125;3227;867;2812;157;518;464;1527;621;2045
310210;201510;2714;7902;2435;7486;230;774;1879;5790;2109;6564
310220;201510;1062;3252;970;3096;186;681;556;1716;742;2397
310230;201510;2546;7910;2116;6962;404;1557;1038;3206;1442;4763
310240;201510;922;3325;821;3118;132;558;432;1690;564;2248
310250;201510;851;2788;818;2727;148;610;483;1489;631;2099
310260;201510;3328;10469;2548;8796;640;2514;679;2090;1319;4604
310270;201510;2525;7211;2104;6603;183;682;1603;4981;1786;5663
310280;201510;2289;6095;1897;5502;249;911;1006;2727;1255;3638
310285;201510;2061;7315;1926;7107;252;1081;1422;5271;1674;6352
310290;201510;1151;3480;1080;3375;260;921;527;1490;787;2411
310300;201510;1733;5802;1631;5610;453;1774;807;2638;1260;4412
310310;201510;376;1021;268;811;39;114;124;384;163;498
310320;201510;386;1224;317;1083;46;217;149;483;195;700
310330;201510;509;1274;340;956;34;114;144;348;178;462
310340;201510;8378;25082;6867;22463;1341;4482;3465;11745;4806;16227
310350;201510;14210;37445;10129;30527;2523;8513;2853;8214;5376;16727
310360;201510;439;1322;413;1285;40;165;287;834;327;999
310370;201510;1394;4645;1278;4438;360;1272;640;2252;1000;3524
310375;201510;1248;3321;784;2461;114;413;301;916;415;1329
310380;201510;375;1007;268;843;92;317;92;258;184;575
310390;201510;460;1607;387;1452;88;365;70;223;158;588
310400;201510;10378;28877;7647;24039;1841;6296;1850;5773;3691;12069
310410;201510;809;2621;543;2140;121;531;114;426;235;957
310420;201510;5719;16000;3512;11213;630;2204;558;1534;1188;3738
310430;201510;1371;4481;1036;3769;266;1067;173;573;439;1640
310440;201510;577;1638;441;1389;86;316;181;532;267;848
310445;201510;1219;3998;1010;3591;145;552;635;2245;780;2797
310450;201510;4613;12932;3688;11596;461;1520;2441;7775;2902;9295
310460;201510;1534;4609;1265;4181;364;1323;279;971;643;2294
310470;201510;3610;8940;3038;8236;290;721;2460;6814;2750;7535
310480;201510;1231;3594;911;2946;181;647;375;1121;556;1768
310490;201510;2917;9434;2473;8541;626;2517;942;3113;1568;5630
310500;201510;1300;4340;1144;3998;266;1045;433;1431;699;2476
310510;201510;2137;6662;1641;5541;411;1507;283;908;694;2415
310520;201510;1411;3667;1073;3132;84;245;717;2099;801;2344
310530;201510;923;2803;502;1705;68;253;65;188;133;441
310540;201510;2959;9647;2663;9095;664;2355;1135;3903;1799;6258
310550;201510;1210;3425;963;3011;217;819;448;1283;665;2102
310560;201510;15509;47042;12951;41967;3526;12753;3897;11749;7423;24502
310570;201510;1171;3486;989;3169;156;596;648;2031;804;2627
310590;201510;4330;12496;3400;10738;630;2121;1307;4000;1937;6121
310600;201510;1381;4539;1223;4195;299;1190;443;1374;742;2564
310610;201510;488;1629;416;1467;85;376;128;388;213;764
310620;201510;146547;444990;122818;399226;28859;105237;47265;142732;76124;247969
310630;201510;3958;12013;3654;11488;376;1360;2681;8342;3057;9702
310640;201510;1313;3927;1026;3404;323;1168;250;743;573;1911
310650;201510;2673;8494;2137;7550;362;1361;1171;4146;1533;5507
310660;201510;1370;4118;1197;3876;135;449;844;2701;979;3150
310665;201510;1259;3808;1117;3598;110;397;859;2800;969;3197
310670;201510;43015;130217;37540;118537;9680;32371;13576;41431;23256;73802
310680;201510;683;1957;618;1859;118;386;372;1093;490;1479
310690;201510;1428;4591;1141;4074;263;1088;361;1205;624;2293
310700;201510;591;1473;456;1292;91;299;263;707;354;1006
310710;201510;6412;20820;4937;18245;1049;4604;865;2825;1914;7429
310720;201510;765;2300;688;2164;109;402;403;1222;512;1624
310730;201510;9373;28930;8300;27134;1592;5655;4701;15223;6293;20878
310740;201510;4976;15776;3928;13672;969;3720;857;2825;1826;6545
310750;201510;1509;3712;1141;3220;207;618;592;1578;799;2196
310760;201510;626;1868;514;1679;108;381;199;646;307;1027
310770;201510;873;2728;668;2401;154;629;270;894;424;1523
310780;201510;3725;10326;3129;9265;505;1506;1866;5514;2371;7020
310790;201510;1919;6122;1712;5742;423;1490;785;2746;1208;4236
310800;201510;2817;8875;2135;7523;649;2630;198;619;847;3249
310810;201510;1216;3369;1072;3114;189;608;578;1588;767;2196
310820;201510;1297;3682;931;2991;230;809;246;758;476;1567
310825;201510;2503;8401;1957;7421;135;705;1408;5274;1543;5979
310830;201510;1326;4265;1021;3649;307;1183;256;848;563;2031
310840;201510;2172;6607;1672;5689;376;1379;447;1410;823;2789
310850;201510;1573;4591;1305;4243;202;689;874;2851;1076;3540
310855;201510;2904;9116;2479;8444;427;1589;1561;5350;1988;6939
310860;201510;7546;23032;6297;20767;878;3097;3621;12105;4499;15202
310870;201510;1021;2820;812;2489;151;504;414;1268;565;1772
310880;201510;1196;3598;890;3014;155;618;439;1459;594;2077
310890;201510;2689;8171;2055;7041;496;1923;452;1382;948;3305
310900;201510;4008;12650;3121;10725;707;2698;976;3092;1683;5790
310910;201510;2020;5695;1283;4212;257;959;192;518;449;1477
310920;201510;1891;5529;1468;4878;345;1309;620;2011;965;3320
310925;201510;913;2982;819;2814;309;1167;281;923;590;2090
310930;201510;6049;17057;4802;15176;858;2904;2694;8735;3552;11639
310940;201510;6253;17612;5169;15924;915;2890;2688;8252;3603;11142
310945;201510;1206;3451;1034;3194;143;524;628;1855;771;2379
310950;201510;2038;6441;1488;5219;392;1600;376;1140;768;2740
310960;201510;400;1285;326;1145;89;358;104;359;193;717
310970;201510;1481;4938;1039;3853;263;1087;131;389;394;1476
310980;201510;463;1123;284;818;37;127;135;337;172;464
310990;201510;1193;3879;959;3378;223;898;269;861;492;1759
311000;201510;3644;12297;3225;11439;877;3537;1109;3623;1986;7160
311010;201510;752;2470;693;2358;220;823;320;1054;540;1877
311020;201510;903;2679;707;2327;152;561;296;908;448;1469
311030;201510;1634;4452;1127;3520;288;1031;378;1045;666;2076
311040;201510;484;1632;420;1469;89;324;96;318;185;642
311050;201510;2065;6445;1797;6012;490;1811;788;2624;1278;4435
311060;201510;2260;6768;1683;5498;348;1271;443;1315;791;2586
311070;201510;1418;4861;1232;4493;290;1203;476;1699;766;2902
311080;201510;875;2612;751;2374;141;503;357;1027;498;1530
311090;201510;1523;5654;1288;5166;394;1752;237;932;631;2684
311100;201510;2075;6921;1668;6035;604;2364;293;1029;897;3393
311110;201510;3706;8740;2601;7156;388;1153;1383;3770;1771;4923
311115;201510;1208;3530;1000;3214;109;451;652;2040;761;2491
311120;201510;7855;22045;5978;18631;1448;5021;1521;4342;2969;9363
311130;201510;1950;6100;1629;5620;347;1456;698;2241;1045;3697
311140;201510;1380;3655;1111;3292;108;382;777;2253;885;2635
311150;201510;1834;6192;1672;5930;287;1138;1026;3623;1313;4761
311160;201510;4250;14055;3460;12602;1173;4698;874;3071;2047;7769
311170;201510;783;2356;612;2038;75;263;300;1029;375;1292
311180;201510;1335;3747;1012;3119;288;964;246;685;534;1649
311190;201510;1032;3018;873;2705;183;659;267;727;450;1386
311200;201510;2103;6356;1682;5464;463;1671;332;926;795;2597
311205;201510;1031;3382;870;3047;134;526;383;1351;517;1877
311210;201510;942;3025;865;2916;160;534;592;2060;752;2594
311220;201510;896;2798;703;2374;163;591;218;707;381;1298
311230;201510;8418;26115;6601;22451;1335;4850;2435;8551;3770;13401
311240;201510;1101;3264;844;2818;203;739;234;727;437;1466
311250;201510;838;2707;742;2553;212;841;248;725;460;1566
311260;201510;2550;6720;1874;5594;473;1562;605;1767;1078;3329
311265;201510;1270;3506;996;3053;179;623;530;1598;709;2221
311270;201510;3338;10536;2889;9883;359;1614;1917;6273;2276;7887
311280;201510;1308;3591;830;2595;168;621;240;684;408;1305
311290;201510;2001;6701;1861;6379;399;1385;1056;3660;1455;5045
311300;201510;4451;14711;3976;13836;492;1990;2684;9279;3176;11269
311310;201510;555;1880;498;1777;90;385;202;663;292;1048
311320;201510;4058;13319;3533;12143;692;2695;1173;3768;1865;6463
311330;201510;4877;14434;4139;13186;1143;4055;1713;5392;2856;9447
311340;201510;12138;37977;10493;34789;3125;11144;2891;9410;6016;20554
311350;201510;2299;6519;1781;5529;311;1141;785;2217;1096;3358
311360;201510;1187;3243;898;2866;334;1108;176;573;510;1681
311370;201510;3804;11325;3178;10197;695;2691;1332;3883;2027;6574
311380;201510;402;1319;349;1219;96;373;113;376;209;749
311390;201510;1822;6569;1659;6321;689;3020;493;1700;1182;4720
311400;201510;1476;4636;1213;4120;224;913;506;1540;730;2453
311410;201510;1805;6140;1618;5888;440;1792;785;2893;1225;4685
311420;201510;1952;6274;1287;4584;276;1055;210;567;486;1622
311430;201510;3964;11777;2672;8894;495;1799;317;958;812;2757
311440;201510;2371;7540;1741;6346;532;2278;299;1026;831;3304
311450;201510;1982;6789;1642;6007;441;1781;343;1156;784;2937
311455;201510;1215;3229;969;2819;231;731;453;1217;684;1948
311460;201510;705;2266;536;1915;112;481;125;418;237;899
311470;201510;519;1669;408;1423;102;437;108;318;210;755
311480;201510;773;2045;719;1975;184;494;423;1153;607;1647
311490;201510;238;872;209;787;61;249;74;258;135;507
311500;201510;469;1339;368;1150;86;314;148;453;234;767
311510;201510;3157;9691;2550;8518;796;3118;563;1725;1359;4843
311520;201510;632;2063;578;1947;186;689;222;701;408;1390
311530;201510;11784;30195;8210;24253;1886;6634;2219;6288;4105;12922
311535;201510;828;2391;522;1764;123;484;74;229;197;713
311540;201510;630;2184;585;2117;219;792;234;833;453;1625
311545;201510;2078;6391;1879;6137;196;732;1331;4279;1527;5011
311547;201510;1544;4303;1279;3868;100;331;848;2569;948;2900
311550;201510;2902;9176;2398;8129;452;1730;822;2724;1274;4454
311560;201510;257;667;214;612;38;123;121;326;159;449
311570;201510;2177;5356;1659;4678;122;387;1238;3542;1360;3929
311580;201510;2406;4900;1830;4233;517;1098;971;2394;1488;3492
311590;201510;452;1369;382;1261;101;385;138;451;239;836
311600;201510;1203;3632;1019;3385;190;621;624;2120;814;2741
311610;201510;3087;10686;2747;10077;893;3236;1104;4268;1997;7504
311615;201510;3087;9462;2534;8569;273;1070;1732;5830;2005;6900
311620;201510;422;1310;367;1215;74;275;201;656;275;931
311630;201510;1392;4029;1145;3602;270;819;626;1991;896;2810
311640;201510;821;2594;673;2336;133;504;371;1252;504;1756
311650;201510;2269;6576;1892;5944;275;922;1043;3341;1318;4263
311660;201510;2441;8074;1907;6791;365;1411;230;649;595;2060
311670;201510;1606;4704;1298;4166;418;1478;403;1244;821;2722
311680;201510;2071;6459;1740;5895;392;1404;913;3084;1305;4488
311690;201510;501;1297;419;1195;43;132;332;950;375;1082
311700;201510;2197;5931;1810;5398;135;471;1371;4003;1506;4474
311710;201510;1696;5093;1235;4207;444;1671;308;985;752;2656
311720;201510;397;1304;349;1201;66;248;165;547;231;795
311730;201510;5881;14562;3338;10056;932;3268;859;2031;1791;5299
311740;201510;853;2487;784;2401;280;829;409;1293;689;2122
311750;201510;4007;12973;3458;12080;699;2744;1755;5991;2454;8735
311760;201510;812;2705;716;2475;177;723;238;715;415;1438
311770;201510;2331;7299;1874;6416;437;1683;564;1815;1001;3498
311780;201510;1103;3906;914;3463;268;1183;206;694;474;1877
311783;201510;1965;6406;1657;5802;108;529;1212;4191;1320;4720
311787;201510;578;1978;411;1475;75;298;91;270;166;568
311790;201510;1447;4267;1046;3483;236;888;323;1023;559;1911
311800;201510;4306;14451;3450;12073;696;2615;191;520;887;3135
311810;201510;1054;3420;935;3188;72;326;626;2092;698;2418
311820;201510;607;1900;490;1613;124;453;239;743;363;1196
311830;201510;8347;27774;6663;23568;2149;8213;820;2556;2969;10769
311840;201510;3143;9234;2724;8627;735;2636;1251;3830;1986;6466
311850;201510;292;862;249;788;61;214;107;326;168;540
311860;201510;49359;145316;41424;130814;9001;31151;19207;58331;28208;89482
311870;201510;2193;6376;1623;5270;344;1276;493;1451;837;2727
311880;201510;6874;19683;6045;18664;797;2323;4248;13611;5045;15934
311890;201510;1431;4264;1145;3702;286;1021;457;1439;743;2460
311900;201510;769;2326;681;2202;117;398;407;1358;524;1756
311910;201510;4307;12535;3483;11308;837;2951;1462;4710;2299;7661
311920;201510;1924;6272;1669;5802;225;868;997;3440;1222;4308
311930;201510;3643;10372;3072;9448;1135;3681;898;2702;2033;6383
311940;201510;12028;35944;9582;30845;2465;8598;1929;5735;4394;14333
311950;201510;2238;6501;1847;5938;159;576;1293;4102;1452;4678
311960;201510;367;1147;323;1045;74;276;123;335;197;611
311970;201510;357;1236;292;1089;61;268;75;258;136;526
311980;201510;653;1796;432;1389;78;262;153;496;231;758
311990;201510;430;1265;357;1143;129;456;120;353;249;809
311995;201510;1182;3589;710;2427;58;211;80;204;138;415
312000;201510;627;1877;559;1772;76;268;345;1099;421;1367
312010;201510;934;3006;784;2665;135;503;316;1041;451;1544
312015;201510;1426;4523;1260;4222;157;640;798;2626;955;3266
312020;201510;971;3047;843;2839;171;623;411;1387;582;2010
312030;201510;1758;5195;1573;4965;121;462;1287;4016;1408;4478
312040;201510;719;2649;608;2343;163;709;129;466;292;1175
312050;201510;1393;4755;1162;4224;278;1133;154;477;432;1610
312060;201510;757;2272;653;2109;250;864;234;699;484;1563
312070;201510;1030;3156;665;2359;156;591;221;782;377;1373
312080;201510;2632;7315;2077;6438;325;1183;1090;3184;1415;4367
312083;201510;912;2587;784;2394;100;342;534;1598;634;1940
312087;201510;2178;6632;1930;6268;247;859;1332;4397;1579;5256
312090;201510;8888;27493;7658;25332;2222;7806;2828;9128;5050;16934
312100;201510;1378;4615;1145;4239;253;1058;507;1849;760;2907
312110;201510;1098;3813;950;3485;301;1275;169;525;470;1800
312120;201510;765;2478;643;2230;148;615;221;659;369;1274
312125;201510;1191;3734;1038;3452;240;813;531;1825;771;2638
312130;201510;842;2401;632;1969;95;340;235;680;330;1020
312140;201510;842;2660;708;2335;146;540;217;610;363;1150
312150;201510;538;1545;454;1363;24;88;295;842;319;930
312160;201510;7420;24991;6553;23159;1762;6823;2317;8025;4079;14848
312170;201510;964;2732;805;2460;83;282;485;1462;568;1744
312180;201510;1371;4165;1184;3791;265;913;456;1375;721;2288
312190;201510;589;1884;448;1601;147;578;88;297;235;875
312200;201510;4803;13787;4007;12496;560;1780;2509;7795;3069;9575
312210;201510;1028;2760;786;2399;218;734;316;899;534;1633
312220;201510;1874;6236;1714;6050;213;710;1367;5038;1580;5748
312230;201510;13204;40156;10015;33798;3254;12151;1556;4941;4810;17092
312235;201510;1589;4730;1370;4400;170;675;917;2867;1087;3542
312240;201510;955;3133;759;2714;174;676;229;759;403;1435
312245;201510;2215;6484;1958;6143;121;417;1589;4964;1710;5381
312247;201510;839;2484;647;2144;174;629;278;921;452;1550
312250;201510;1203;3306;921;2833;163;575;365;1042;528;1617
312260;201510;904;2856;742;2582;134;543;453;1514;587;2057
312270;201510;662;1986;550;1770;78;325;245;708;323;1033
312280;201510;404;1359;357;1254;120;453;49;162;169;615
312290;201510;754;2454;692;2360;192;766;223;739;415;1505
312300;201510;870;2870;673;2389;157;611;78;207;235;818
312310;201510;910;3379;829;3185;239;1011;298;1100;537;2111
312320;201510;1956;5565;1445;4501;324;1075;241;578;565;1653
312330;201510;986;2884;817;2627;141;538;571;1803;712;2341
312340;201510;322;845;276;769;37;138;192;488;229;626
312350;201510;307;760;274;721;26;80;229;582;255;662
312352;201510;1621;5130;1439;4845;371;1290;847;2925;1218;4215
312360;201510;2964;9492;2416;8343;543;2079;692;2342;1235;4421
312370;201510;1720;5400;1545;5118;532;1984;494;1525;1026;3509
312380;201510;1908;5323;1690;5017;106;336;1371;4168;1477;4504
312385;201510;1298;3814;1118;3523;109;436;774;2356;883;2792
312390;201510;2125;6845;1694;5937;445;1689;284;887;729;2576
312400;201510;3182;10126;2663;9111;928;3300;763;2686;1691;5986
312410;201510;9909;32186;8666;29729;1950;7318;3549;11812;5499;19130
312420;201510;3984;12145;3741;11834;552;1766;2599;8370;3151;10136
312430;201510;7819;23226;6707;21204;1234;3971;3935;12534;5169;16505
312440;201510;690;2175;601;2022;158;587;287;1003;445;1590
312450;201510;1105;3634;850;3090;284;1092;254;942;538;2034
312460;201510;360;1078;320;1031;87;320;152;478;239;798
312470;201510;683;1853;435;1366;79;285;142;426;221;711
312480;201510;1253;3331;961;3001;228;798;495;1449;723;2247
312490;201510;2037;5318;1564;4620;232;771;870;2458;1102;3229
312500;201510;684;2067;598;1929;105;406;230;698;335;1104
312510;201510;3236;9419;2499;7870;422;1518;1203;3496;1625;5014
312520;201510;269;908;216;806;58;236;72;271;130;507
312530;201510;596;1782;526;1676;78;314;340;1037;418;1351
312540;201510;1466;4588;1128;3911;242;901;535;1836;777;2737
312550;201510;680;2081;576;1851;121;401;257;776;378;1177
312560;201510;2027;5359;1689;4917;103;362;1359;3908;1462;4270
312570;201510;2491;7279;2041;6493;596;2040;591;1804;1187;3844
312580;201510;532;1745;441;1546;75;323;159;525;234;848
312590;201510;1718;5680;1478;5158;284;1198;612;1959;896;3157
312595;201510;2012;6708;1785;6176;398;1446;919;3166;1317;4612
312600;201510;812;2616;625;2231;101;468;303;977;404;1445
312610;201510;7082;19796;5119;16150;1182;4168;1203;3532;2385;7700
312620;201510;2078;6110;1621;5482;168;654;1187;4082;1355;4736
312630;201510;356;1150;310;1060;78;307;126;402;204;709
312640;201510;548;1753;433;1510;91;350;138;441;229;791
312650;201510;2149;6312;1547;5106;155;560;897;2949;1052;3509
312660;201510;1345;3623;1101;3261;113;391;743;2149;856;2540
312670;201510;5655;16749;4801;15525;1314;4691;1685;5271;2999;9962
312675;201510;1268;4045;1054;3584;131;513;645;2141;776;2654
312680;201510;1467;4504;1289;4238;214;808;737;2301;951;3109
312690;201510;2189;5839;1764;5236;292;963;1063;3023;1355;3986
312695;201510;819;2916;778;2856;170;609;490;1869;660;2478
312700;201510;1929;5701;1466;4743;206;756;729;2300;935;3056
312705;201510;1271;3620;1068;3261;104;355;753;2263;857;2618
312707;201510;1647;5088;1268;4346;185;734;656;2157;841;2891
312710;201510;7191;18242;4626;13939;1238;4256;952;2615;2190;6871
312720;201510;756;2568;655;2355;153;610;238;800;391;1410
312730;201510;1894;4480;1307;3780;188;591;714;2068;902;2659
312733;201510;1675;4425;1237;3608;74;273;834;2309;908;2582
312735;201510;827;2305;716;2156;172;584;391;1127;563;1711
312737;201510;859;2147;613;1793;193;567;227;685;420;1252
312738;201510;540;1616;388;1297;99;394;127;366;226;760
312740;201510;406;1066;257;890;80;310;66;220;146;530
312750;201510;1247;4389;1180;4259;252;1101;560;1901;812;3002
312760;201510;2081;6583;1580;5549;380;1471;356;1219;736;2690
312770;201510;41239;112792;31719;96654;8257;27189;8872;26001;17129;53190
312780;201510;2695;9326;2392;8808;436;1772;1255;4698;1691;6470
312790;201510;332;845;189;590;40;157;54;124;94;281
312800;201510;4992;16188;4026;14191;1236;4698;1041;3641;2277;8339
312810;201510;2169;6534;1459;5131;354;1343;262;839;616;2182
312820;201510;1920;5506;1700;5142;115;416;1145;3373;1260;3789
312825;201510;1373;3700;1174;3443;113;369;890;2590;1003;2959
312830;201510;2599;7965;1775;6268;435;1655;299;1013;734;2668
312840;201510;1252;3992;1030;3576;156;670;412;1309;568;1979
312850;201510;645;2038;516;1790;85;355;159;534;244;889
312860;201510;1123;3256;867;2806;214;797;247;681;461;1478
312870;201510;5481;16944;3765;13229;735;2852;774;2618;1509;5470
312880;201510;1269;3750;1095;3471;159;550;646;2097;805;2647
312890;201510;1644;4873;1098;3682;290;1086;349;1157;639;2243
312900;201510;1221;3586;1072;3376;151;501;750;2419;901;2920
312910;201510;1627;3281;996;2460;162;465;511;1132;673;1597
312920;201510;869;2734;716;2461;195;767;277;881;472;1648
312930;201510;2229;6353;1903;5869;423;1370;895;2813;1318;4183
312940;201510;905;2933;779;2714;211;842;207;665;418;1507
312950;201510;3274;9070;2490;7860;822;2818;651;1989;1473;4807
312960;201510;1952;5608;1689;5264;251;745;1251;4018;1502;4763
312965;201510;1790;5653;1507;5135;202;812;898;3035;1100;3847
312970;201510;990;3347;823;3046;249;1066;143;482;392;1548
312980;201510;17173;57125;15988;54539;5071;19007;6155;20013;11226;39020
312990;201510;454;1357;330;1136;104;405;95;319;199;724
313000;201510;506;1652;407;1454;99;463;163;497;262;960
313005;201510;2586;8264;2257;7637;510;1670;1164;4041;1674;5711
313010;201510;3790;11983;3171;10893;817;3053;1314;4427;2131;7480
313020;201510;981;3182;778;2675;167;664;195;561;362;1225
313030;201510;1511;4025;1114;3469;239;934;464;1328;703;2262
313040;201510;857;2829;718;2475;121;494;274;854;395;1348
313050;201510;1801;5544;1344;4848;312;1272;340;1090;652;2362
313055;201510;1577;5031;1437;4835;107;382;1108;3767;1215;4149
313060;201510;708;2291;546;1890;158;564;66;213;224;777
313065;201510;1946;6249;1659;5784;345;1332;1080;3747;1425;5079
313070;201510;1117;3209;904;2824;209;762;398;1136;607;1898
313080;201510;471;1475;352;1224;85;348;117;350;202;698
313090;201510;5263;15053;4519;13839;1025;3338;2306;7086;3331;10424
313100;201510;1082;3328;967;3135;111;378;727;2374;838;2752
313110;201510;1755;4929;1289;4010;221;781;547;1578;768;2359
313115;201510;2439;8164;2280;7831;540;2081;1025;3288;1565;5369
313120;201510;3493;9258;2915;8465;813;2660;1418;3887;2231;6547
313130;201510;24823;74750;21102;66969;4936;17306;7855;23230;12791;40536
313140;201510;676;1703;503;1446;35;124;347;975;382;1099
313150;201510;1359;4259;1134;3827;474;1748;253;806;727;2554
313160;201510;1027;3076;885;2805;148;550;506;1541;654;2091
313170;201510;7817;26462;6189;22554;1547;6020;1231;4378;2778;10398
313180;201510;2411;6554;1898;5807;511;1721;689;2013;1200;3734
313190;201510;3167;10830;2479;9018;537;2131;665;2210;1202;4341
313200;201510;1205;3896;1041;3585;143;557;685;2303;828;2860
313210;201510;4314;13207;3578;12110;827;3030;1554;5048;2381;8078
313220;201510;1392;4188;1011;3339;242;880;222;627;464;1507
313230;201510;2282;8085;2096;7812;331;1328;1409;5247;1740;6575
313240;201510;7580;23222;5944;20154;1243;4816;2201;7066;3444;11882
313250;201510;7088;22008;6178;20420;895;3031;3548;11807;4443;14838
313260;201510;611;1801;439;1438;71;262;108;326;179;588
313270;201510;5441;16121;4552;14585;850;2923;2464;7778;3314;10701
313280;201510;380;1255;293;1055;51;217;75;232;126;449
313290;201510;862;2979;687;2638;238;1007;107;350;345;1357
313300;201510;1837;6075;1485;5214;419;1602;213;633;632;2235
313310;201510;1094;3747;964;3476;237;960;180;581;417;1541
313320;201510;2367;6800;1788;5837;347;1258;754;2435;1101;3693
313330;201510;3939;12205;3261;10987;408;1621;1844;6053;2252;7674
313340;201510;1979;4836;1528;4164;303;840;827;2228;1130;3068
313350;201510;3152;9576;2398;7948;510;1872;466;1376;976;3248
313360;201510;1216;3492;901;2975;244;954;440;1354;684;2308
313370;201510;1146;3900;1048;3628;160;663;531;1697;691;2360
313375;201510;2259;5852;1500;4699;276;1074;481;1415;757;2489
313380;201510;4973;15376;4068;13492;1027;3724;1320;4107;2347;7831
313390;201510;869;2984;828;2926;92;373;559;1968;651;2341
313400;201510;3725;10202;3307;9726;279;782;2769;8330;3048;9112
313410;201510;1262;3541;1047;3221;248;849;559;1673;807;2522
313420;201510;20296;47974;11920;33613;2283;7198;2181;5898;4464;13096
313430;201510;1079;3335;816;2767;158;639;320;995;478;1634
313440;201510;6276;14171;4307;11861;286;878;2861;7874;3147;8752
313450;201510;651;1895;512;1609;103;392;177;498;280;890
313460;201510;2206;7432;1884;6877;500;2084;572;1906;1072;3990
313470;201510;3160;8699;2858;8298;384;1149;2035;5838;2419;6987
313480;201510;1105;3148;852;2711;122;457;341;994;463;1451
313490;201510;1425;4230;844;3257;251;1062;124;451;375;1513
313500;201510;399;1242;341;1104;62;232;132;395;194;627
313505;201510;9022;26418;8305;25593;418;1015;7482;23542;7900;24557
313507;201510;1341;3746;1175;3515;134;442;755;2273;889;2715
313510;201510;15450;44019;13348;40877;2144;6803;7530;23170;9674;29973
313520;201510;14278;43837;11946;39523;1414;5333;7540;24622;8954;29955
313530;201510;612;1898;494;1669;48;196;167;531;215;727
313535;201510;2430;7289;2169;6809;200;690;1551;4796;1751;5486
313540;201510;1066;3329;792;2607;209;760;180;526;389;1286
313545;201510;1282;4688;1149;4408;163;778;663;2384;826;3162
313550;201510;1843;5880;1602;5389;417;1476;713;2316;1130;3792
313560;201510;2175;5185;1809;4772;333;814;1184;3272;1517;4086
313570;201510;880;3064;744;2805;244;985;210;779;454;1764
313580;201510;5879;16624;4742;14978;791;2675;2768;8803;3559;11478
313590;201510;990;2799;756;2476;365;1319;181;550;546;1869
313600;201510;3830;11493;3297;10643;471;1664;2127;6872;2598;8536
313610;201510;992;2969;840;2671;178;624;398;1230;576;1854
313620;201510;5526;16944;4705;15424;1298;4542;1628;5266;2926;9808
313630;201510;8053;22565;6081;19615;1182;4346;2587;8635;3769;12981
313640;201510;779;2264;590;1967;173;651;186;590;359;1241
313650;201510;2069;6659;1789;6199;304;1218;1148;3879;1452;5097
313652;201510;964;3410;887;3268;150;624;525;1885;675;2509
313655;201510;937;3003;777;2727;119;506;452;1531;571;2037
313657;201510;1275;3883;1072;3560;116;540;764;2319;880;2859
313660;201510;830;2712;735;2538;161;657;339;1095;500;1752
313665;201510;3496;11255;3031;10271;645;2435;1379;4486;2024;6921
313670;201510;50356;139084;33245;109148;8161;29428;9719;31037;17880;60465
313680;201510;1066;3162;930;2935;163;590;547;1655;710;2245
313690;201510;847;3047;738;2788;196;769;265;1001;461;1770
313695;201510;1374;4446;1175;4086;115;457;818;2837;933;3294
313700;201510;3774;12529;3178;11757;511;1963;2125;8063;2636;10026
313710;201510;1294;3491;1005;3047;209;689;487;1428;696;2117
313720;201510;5178;16608;4077;14121;841;3213;1255;4000;2096;7213
313730;201510;1268;3442;966;3059;173;620;526;1649;699;2269
313740;201510;2129;7556;1779;6699;503;2151;163;523;666;2674
313750;201510;2257;6767;1873;6035;484;1696;600;1776;1084;3472
313753;201510;1841;5328;1444;4635;346;1237;570;1783;916;3020
313760;201510;4347;14058;3541;12398;981;3754;924;2998;1905;6752
313770;201510;3307;10723;2935;10093;892;3323;1199;4008;2091;7331
313780;201510;3802;10387;2979;9174;454;1722;1265;3867;1719;5589
313790;201510;496;1708;467;1654;103;369;259;949;362;1318
313800;201510;1236;3381;1074;3127;128;417;702;2061;830;2478
313810;201510;1495;4311;1416;4203;68;192;1232;3745;1300;3937
313820;201510;13087;34723;10552;30625;1819;6206;4940;13584;6759;19790
313830;201510;422;1388;355;1257;96;389;117;409;213;798
313835;201510;917;3044;848;2930;159;642;467;1530;626;2172
313840;201510;7551;21495;5798;18477;1445;5082;1479;4582;2924;9664
313850;201510;1198;3230;1027;2924;207;705;502;1294;709;1999
313860;201510;2785;8407;2098;6888;502;1779;453;1402;955;3181
313862;201510;1216;3038;827;2398;118;336;423;1304;541;1640
313865;201510;2226;6854;2007;6526;242;914;1438;4603;1680;5517
313867;201510;1116;3802;934;3381;290;1121;265;995;555;2116
313868;201510;1578;5442;1365;5000;134;592;905;3266;1039;3858
313870;201510;798;2480;724;2358;201;751;216;618;417;1369
313880;201510;1511;4604;1293;4260;235;916;716;2208;951;3124
313890;201510;1860;5056;1550;4641;363;1026;912;2910;1275;3936
313900;201510;4026;14450;3560;13366;1044;4447;1008;3597;2052;8044
313910;201510;762;2533;623;2245;222;863;77;255;299;1118
313920;201510;3403;11172;2924;10259;494;1819;1652;5913;2146;7732
313925;201510;1921;5152;1385;4143;83;279;850;2524;933;2803
313930;201510;5237;16988;4284;15244;805;3036;2161;7785;2966;10821
313940;201510;8371;27736;6972;25454;2046;8281;2256;8587;4302;16868
313950;201510;4102;11650;3187;10113;982;3618;1029;2888;2011;6506
313960;201510;5591;14251;4042;12079;1144;3752;1080;2983;2224;6735
313970;201510;1433;4084;1240;3868;151;524;756;2467;907;2991
313980;201510;1269;3975;977;3457;270;1103;393;1370;663;2473
313990;201510;1842;6755;1544;6025;496;2138;313;1068;809;3206
314000;201510;7672;24558;6885;23020;1263;5072;3836;12168;5099;17240
314010;201510;1107;3103;907;2840;105;384;565;1709;670;2093
314015;201510;1190;4101;1004;3746;255;1055;377;1329;632;2384
314020;201510;522;1578;381;1280;92;355;88;257;180;612
314030;201510;868;2773;674;2334;97;364;244;829;341;1193
314040;201510;680;1924;564;1722;247;778;150;481;397;1259
314050;201510;1777;5456;1388;4668;303;1200;459;1366;762;2566
314053;201510;1538;4857;1369;4641;191;648;912;3238;1103;3886
314055;201510;2136;6375;1879;5984;88;375;1451;4627;1539;5002
314060;201510;1144;3509;894;3079;71;309;561;1882;632;2191
314070;201510;4002;12307;3056;10423;791;2905;713;2297;1504;5202
314080;201510;1979;6050;1306;4461;229;878;288;842;517;1720
314085;201510;1976;6590;1703;6198;446;1809;620;2229;1066;4038
314090;201510;3317;11354;2890;10493;725;2937;981;3598;1706;6535
314100;201510;3285;8445;2869;7881;210;477;2405;6834;2615;7311
314110;201510;4121;12945;3538;11713;655;2549;1434;4295;2089;6844
314120;201510;1005;2432;512;1632;115;406;136;418;251;824
314130;201510;726;2074;377;1272;57;205;71;232;128;437
314140;201510;4953;15262;4098;13545;912;3217;1659;5405;2571;8622
314150;201510;1596;4362;1288;3826;211;714;663;1933;874;2647
314160;201510;2534;6503;1981;5768;193;611;1211;3692;1404;4303
314170;201510;1084;3239;877;2787;117;411;461;1410;578;1821
314180;201510;5420;17248;4787;16202;1266;4655;2033;6957;3299;11612
314190;201510;730;2089;572;1845;127;513;226;639;353;1152
314200;201510;2989;9302;2576;8538;311;1235;1715;5541;2026;6776
314210;201510;1956;5741;1723;5323;259;946;1030;3015;1289;3961
314220;201510;1667;5162;1282;4404;372;1419;247;716;619;2135
314225;201510;1326;3846;1182;3651;88;282;983;3073;1071;3355
314230;201510;655;2146;591;2030;131;508;266;884;397;1392
314240;201510;1130;3380;940;3089;144;489;539;1860;683;2349
314250;201510;561;1663;422;1374;96;347;128;364;224;711
314260;201510;1094;3871;979;3609;263;1056;304;1057;567;2113
314270;201510;2906;9345;2425;8480;240;934;1593;5612;1833;6546
314280;201510;3215;8882;2144;6786;498;1844;670;1830;1168;3674
314290;201510;4876;13396;4159;12206;1135;3459;2080;6011;3215;9470
314300;201510;1562;5170;1329;4619;367;1350;412;1360;779;2710
314310;201510;5328;15883;4517;14343;1292;4427;1524;4616;2816;9043
314315;201510;869;3324;795;3177;91;437;517;2046;608;2483
314320;201510;3107;8535;2232;7344;608;2230;1068;3546;1676;5776
314330;201510;53313;160592;45927;148308;12694;44183;16156;51284;28850;95467
314340;201510;2871;7803;1581;5211;345;1235;124;259;469;1494
314345;201510;1237;4168;1106;3949;264;987;627;2238;891;3225
314350;201510;1363;3921;1062;3416;362;1272;225;677;587;1949
314360;201510;690;2185;455;1618;97;400;100;332;197;732
314370;201510;531;1836;489;1772;134;537;292;1042;426;1579
314380;201510;1280;3808;864;2970;235;868;135;449;370;1317
314390;201510;14328;40979;10605;33948;2557;8893;2630;7713;5187;16606
314400;201510;4531;13253;3813;12227;1343;4526;1306;4279;2649;8805
314410;201510;2635;8170;2168;7242;641;2445;662;2055;1303;4500
314420;201510;752;2143;584;1893;37;186;386;1177;423;1363
314430;201510;6601;19527;5685;17781;1643;5582;1659;5214;3302;10796
314435;201510;1312;4171;1150;3885;120;517;720;2399;840;2916
314437;201510;1141;2932;949;2639;45;135;745;2051;790;2186
314440;201510;665;1932;504;1694;162;604;86;250;248;854
314450;201510;1601;4664;1323;4246;331;1223;569;1692;900;2915
314460;201510;4301;14333;3439;12438;830;3340;639;2175;1469;5515
314465;201510;2287;7129;2093;6801;124;556;1599;5049;1723;5605
314467;201510;1067;2974;889;2655;88;245;625;1904;713;2149
314470;201510;2475;7755;2016;6769;404;1604;632;1874;1036;3478
314480;201510;6095;20059;4058;14561;627;2466;445;1326;1072;3792
314490;201510;957;2798;742;2363;182;638;309;933;491;1571
314500;201510;2109;5873;1541;4887;392;1319;630;1952;1022;3271
314505;201510;1788;5256;1641;5045;260;873;1062;3287;1322;4160
314510;201510;1911;5155;1273;4247;401;1482;316;1018;717;2500
314520;201510;3115;11130;2336;9197;520;2342;333;1065;853;3407
314530;201510;6251;21966;5894;21334;1139;4030;3432;12887;4571;16917
314535;201510;2739;7661;2326;7082;224;763;1761;5328;1985;6091
314537;201510;1180;3695;933;3245;139;584;535;1813;674;2397
314540;201510;419;1249;340;1079;77;282;103;287;180;569
314545;201510;1383;4212;1190;3926;172;649;808;2668;980;3317
314550;201510;631;1710;462;1473;78;331;192;553;270;884
314560;201510;4664;15903;3855;13882;737;3011;1107;3775;1844;6786
314570;201510;307;898;231;739;63;219;99;306;162;525
314580;201510;516;1719;399;1448;99;430;63;191;162;621
314585;201510;840;2734;600;2203;140;589;149;519;289;1108
314587;201510;1894;5844;1630;5371;373;1176;753;2567;1126;3743
314590;201510;3316;11141;2297;8390;399;1649;284;893;683;2542
314600;201510;1862;6018;1336;4920;333;1372;194;632;527;2004
314610;201510;7024;23689;6229;21834;1431;5653;2539;8330;3970;13983
314620;201510;1626;4817;1456;4572;187;598;1030;3243;1217;3841
314625;201510;1465;5012;1366;4825;191;821;962;3243;1153;4064
314630;201510;4910;14496;4263;13477;326;1238;3111;9780;3437;11018
314640;201510;580;1575;443;1333;109;358;127;315;236;673
314650;201510;1163;3197;805;2560;130;492;297;836;427;1328
314655;201510;1597;4739;1172;3888;291;940;426;1430;717;2370
314660;201510;271;732;196;580;22;73;96;261;118;334
314670;201510;1636;4381;1234;3688;204;687;680;1996;884;2683
314675;201510;1787;5446;1522;4971;161;611;1023;3322;1184;3933
314690;201510;2403;7568;1934;6698;533;2121;473;1521;1006;3642
314700;201510;8669;29798;6392;24514;1912;8226;1028;3751;2940;11977
314710;201510;9138;27617;6100;20793;1152;4357;901;2790;2053;7147
314720;201510;2390;7820;1986;6919;512;1995;687;2352;1199;4347
314730;201510;2307;6812;1845;6114;512;1887;643;2020;1155;3907
314740;201510;2997;9462;2576;8634;487;1857;1161;3699;1648;5556
314750;201510;343;1069;271;902;47;192;126;384;173;576
314760;201510;1754;5846;1304;4727;223;935;266;824;489;1759
314770;201510;1140;3548;653;2209;79;313;94;224;173;537
314780;201510;299;764;202;634;55;207;83;250;138;457
314790;201510;12090;35176;8771;29290;3314;12569;1026;2921;4340;15490
314795;201510;1665;4756;1398;4331;124;502;1021;3008;1145;3510
314800;201510;11831;34046;8231;26752;2332;8226;1183;3591;3515;11817
314810;201510;12434;36018;9507;30792;2724;9754;1997;6372;4721;16126
314820;201510;948;2559;628;2029;165;596;212;646;377;1242
314830;201510;1666;5524;1447;5142;441;1739;568;1992;1009;3731
314840;201510;974;3469;787;3176;147;743;457;1770;604;2513
314850;201510;1962;5678;1561;4944;231;910;953;2868;1184;3778
314860;201510;3251;10787;2883;10113;692;2641;1331;4619;2023;7260
314870;201510;5484;17292;4745;16297;537;2301;3365;11460;3902;13761
314875;201510;1721;5704;1631;5569;321;1049;1171;4104;1492;5153
314880;201510;866;2370;727;2192;47;137;533;1688;580;1825
314890;201510;607;1808;405;1365;81;335;137;405;218;740
314900;201510;493;1500;393;1339;93;333;190;635;283;968
314910;201510;1666;5439;1340;4876;402;1673;409;1393;811;3066
314915;201510;2507;7896;2196;7397;186;776;1576;5152;1762;5928
314920;201510;553;1525;388;1271;43;173;207;620;250;793
314930;201510;4683;15570;3968;13931;1048;3977;959;3221;2007;7198
314940;201510;404;1170;369;1106;68;228;193;540;261;768
314950;201510;348;1039;261;895;48;177;74;239;122;416
314960;201510;756;2321;576;1945;140;537;168;493;308;1030
314970;201510;554;1855;452;1654;99;424;120;421;219;845
314980;201510;1651;5087;1378;4593;402;1516;155;438;557;1954
314990;201510;2685;8403;2007;6889;557;2206;378;1073;935;3279
314995;201510;1595;4837;1382;4503;147;577;886;2801;1033;3378
315000;201510;1074;3113;879;2795;116;424;537;1689;653;2113
315010;201510;460;1420;360;1212;91;365;115;334;206;699
315015;201510;2049;6249;1820;5978;247;833;1320;4535;1567;5368
315020;201510;825;2563;617;2098;101;400;273;867;374;1267
315030;201510;741;2204;596;1938;170;601;136;420;306;1021
315040;201510;861;2680;805;2572;150;498;489;1544;639;2042
315050;201510;1435;4092;1137;3619;246;907;472;1454;718;2361
315053;201510;1081;3203;949;2974;164;641;422;1322;586;1963
315057;201510;1728;5905;1501;5545;295;1094;808;3089;1103;4183
315060;201510;860;2795;620;2256;144;586;128;451;272;1037
315070;201510;779;2319;672;2158;178;621;318;966;496;1587
315080;201510;2863;9594;2515;8835;612;2340;1126;3890;1738;6230
315090;201510;779;2771;672;2521;171;718;168;612;339;1330
315100;201510;1224;4097;880;3273;212;912;213;706;425;1618
315110;201510;1394;4258;1184;3834;276;964;454;1437;730;2401
315120;201510;14399;33467;9701;27362;1530;4512;4938;14684;6468;19196
315130;201510;1432;4690;1279;4384;351;1357;399;1296;750;2653
315140;201510;2672;8542;2198;7524;504;1999;734;2272;1238;4271
315150;201510;4905;13150;3601;10932;736;2515;1290;3789;2026;6304
315160;201510;1245;3548;1013;3087;200;660;464;1352;664;2012
315170;201510;1468;4340;1191;3896;241;845;504;1771;745;2616
315180;201510;17243;48526;9786;32367;1809;6799;1732;5108;3541;11907
315190;201510;2121;5490;1771;4953;484;1388;880;2472;1364;3860
315200;201510;3939;13117;3195;11451;953;3731;728;2472;1681;6203
315210;201510;7842;22872;6145;19379;1366;4817;2104;6303;3470;11120
315213;201510;1090;3484;1022;3388;62;233;825;2723;887;2956
315217;201510;2511;8545;2084;7783;280;1245;1177;4350;1457;5595
315220;201510;10048;28735;8322;25999;2442;7518;3430;11206;5872;18724
315230;201510;2901;7583;2587;7213;203;306;2166;6541;2369;6847
315240;201510;3041;9397;2631;8748;650;2406;1347;4291;1997;6697
315250;201510;10165;30695;7373;25251;1862;7076;2150;7289;4012;14365
315260;201510;975;3035;679;2360;157;606;120;364;277;970
315270;201510;768;2444;580;2067;123;484;136;439;259;923
315280;201510;3157;8969;2006;6465;466;1625;416;1154;882;2779
315290;201510;1420;3952;1031;3310;331;1157;169;514;500;1671
315300;201510;548;1415;370;1192;167;564;129;415;296;979
315310;201510;1266;4061;1059;3676;137;580;664;2188;801;2768
315320;201510;792;2403;634;2192;115;459;300;1060;415;1519
315330;201510;696;2510;435;1801;112;518;44;193;156;711
315340;201510;3722;10610;3016;9503;655;2283;1205;3653;1860;5936
315350;201510;1824;5034;1344;4317;279;940;711;2341;990;3281
315360;201510;1680;5541;1338;4664;253;975;435;1396;688;2371
315370;201510;495;1467;422;1355;94;326;225;733;319;1059
315380;201510;202;690;155;574;40;173;32;91;72;264
315390;201510;1351;4484;984;3584;238;989;181;584;419;1573
315400;201510;4370;13079;3541;11450;725;2610;1574;4959;2299;7569
315410;201510;2038;5405;1699;4924;222;757;1098;3175;1320;3932
315415;201510;1027;3376;933;3231;340;1204;427;1541;767;2745
315420;201510;1260;3983;931;3276;227;840;140;462;367;1302
315430;201510;3831;10362;2847;8704;748;2555;641;1856;1389;4411
315440;201510;901;2785;769;2562;149;561;330;1054;479;1615
315445;201510;2123;5914;1685;5240;191;683;1169;3580;1360;4263
315450;201510;2414;7624;2167;7241;482;1508;1234;4287;1716;5795
315460;201510;34637;112674;30173;103149;9969;36487;5884;18966;15853;55453
315470;201510;512;1515;411;1324;52;209;215;652;267;861
315480;201510;1780;5353;1100;3791;199;762;180;587;379;1349
315490;201510;3146;8407;2427;7416;350;1252;1030;2975;1380;4227
315500;201510;481;1452;314;1066;43;166;112;327;155;493
315510;201510;1432;4057;1200;3691;93;329;859;2583;952;2912
315520;201510;1112;3216;844;2805;109;408;537;1719;646;2127
315530;201510;574;1955;488;1747;188;725;129;423;317;1148
315540;201510;1110;3446;907;3051;177;717;319;1049;496;1766
315550;201510;1753;4911;1352;4342;399;1416;427;1315;826;2731
315560;201510;6507;21590;5859;20674;657;2596;3948;14014;4605;16610
315570;201510;2031;6327;1868;6052;342;1258;998;3130;1340;4388
315580;201510;2555;7429;1963;6333;487;1819;529;1546;1016;3365
315590;201510;912;2650;802;2472;150;502;409;1238;559;1740
315600;201510;2515;8832;2018;7876;363;1493;1054;4252;1417;5745
315610;201510;999;2847;800;2433;161;634;297;742;458;1376
315620;201510;313;1094;296;1064;94;327;157;592;251;919
315630;201510;875;2758;726;2458;182;669;188;592;370;1261
315640;201510;566;1622;458;1441;97;365;204;578;301;943
315645;201510;886;2695;734;2373;264;927;173;524;437;1451
315650;201510;1919;5268;1530;4714;93;392;1134;3449;1227;3841
315660;201510;2567;6720;2129;6028;409;1181;1269;3573;1678;4754
315670;201510;10200;33759;8891;31175;2657;10047;2948;10058;5605;20105
315680;201510;3072;10221;2371;8763;833;3253;393;1433;1226;4686
315690;201510;3489;9851;2400;7870;615;2231;476;1573;1091;3804
315700;201510;7239;22524;6063;20152;1118;4157;2767;8768;3885;12925
315710;201510;1841;5364;1489;4791;133;529;941;2928;1074;3457
315720;201510;3484;10905;3067;10147;572;2192;1553;4883;2125;7075
315725;201510;1432;4568;1276;4320;338;1180;692;2386;1030;3566
315727;201510;628;1930;519;1701;109;394;205;624;314;1018
315730;201510;845;2573;759;2411;126;462;419;1289;545;1751
315733;201510;975;2938;862;2721;265;908;257;755;522;1663
315737;201510;1310;3963;994;3373;86;360;633;2178;719;2538
315740;201510;1025;3137;845;2777;163;644;411;1256;574;1900
315750;201510;1116;3460;1018;3279;83;316;728;2322;811;2638
315760;201510;1028;2763;983;2707;30;96;880;2406;910;2502
315765;201510;1415;4389;1271;4191;69;256;1035;3438;1104;3694
315770;201510;1579;5014;1359;4587;355;1351;395;1270;750;2621
315780;201510;22178;71999;19778;66640;5269;18971;5632;18622;10901;37593
315790;201510;3467;11640;3025;10733;321;1079;2002;7336;2323;8415
315800;201510;1520;5809;1179;4801;280;1273;199;759;479;2032
315810;201510;1392;3773;1180;3446;151;445;812;2349;963;2794
315820;201510;2585;8632;2258;8054;730;2706;911;3329;1641;6035
315830;201510;1207;4031;1021;3597;129;562;313;961;442;1523
315840;201510;840;2200;594;1765;97;319;169;470;266;789
315850;201510;1029;3686;992;3607;244;936;485;1723;729;2659
315860;201510;544;1852;401;1539;98;441;65;212;163;653
315870;201510;475;1393;389;1254;113;402;137;408;250;810
315880;201510;1207;3112;946;2777;210;757;333;887;543;1644
315890;201510;1529;5147;1320;4807;469;1816;540;1940;1009;3756
315895;201510;5169;15969;4505;14511;1013;3619;1714;5196;2727;8815
315900;201510;741;2276;709;2217;88;358;531;1545;619;1903
315910;201510;528;1779;490;1713;162;623;263;885;425;1508
315920;201510;1580;4337;923;2935;207;717;180;470;387;1187
315930;201510;1108;3012;830;2518;211;708;206;586;417;1294
315935;201510;980;3209;871;2963;238;897;237;769;475;1666
315940;201510;642;1998;555;1820;134;518;250;769;384;1287
315950;201510;1169;3581;1049;3346;217;658;639;2086;856;2744
315960;201510;3335;10522;2260;8282;851;3568;98;229;949;3797
315970;201510;759;2048;576;1787;53;149;408;1328;461;1477
315980;201510;4115;9935;2477;7144;641;2120;604;1415;1245;3535
315990;201510;3965;11478;3335;10468;579;2203;1666;5036;2245;7239
316000;201510;536;1611;455;1503;148;582;168;532;316;1114
316010;201510;591;1977;470;1726;78;332;174;572;252;904
316020;201510;1120;3506;922;3186;144;584;538;1832;682;2416
316030;201510;3345;9690;2451;8089;252;945;1404;4716;1656;5661
316040;201510;3777;11824;2762;9622;440;1765;471;1295;911;3060
316045;201510;2089;6488;1901;6177;286;903;1309;4385;1595;5288
316050;201510;343;1084;267;957;52;201;116;388;168;589
316060;201510;740;2187;585;1957;82;368;335;1034;417;1402
316070;201510;5987;18851;5107;16864;1183;4377;2029;6343;3212;10720
316080;201510;748;2710;652;2459;145;625;88;317;233;942
316090;201510;584;1731;377;1275;76;290;92;277;168;567
316095;201510;1434;4568;1229;4200;233;808;728;2512;961;3320
316100;201510;2809;9239;2058;7317;496;2011;381;1212;877;3223
316105;201510;972;2715;717;2286;189;644;270;871;459;1515
316110;201510;12291;41825;10887;39363;1370;5367;7133;26424;8503;31791
316120;201510;1138;3685;915;3114;227;836;258;766;485;1602
316130;201510;1477;3305;896;2472;151;487;411;1054;562;1541
316140;201510;961;2800;737;2427;99;326;411;1383;510;1709
316150;201510;1475;4115;1302;3819;234;794;728;2093;962;2887
316160;201510;1242;3691;952;3119;159;602;436;1406;595;2008
316165;201510;938;2527;782;2300;165;560;410;1184;575;1744
316170;201510;1394;4001;1035;3358;163;599;429;1274;592;1873
316180;201510;1371;4281;944;3327;210;826;172;508;382;1334
316190;201510;2825;8728;1406;4927;262;962;201;594;463;1556
316200;201510;3979;12645;3059;10791;697;2852;819;2747;1516;5599
316210;201510;4834;15274;4059;13723;1598;5730;647;2049;2245;7779
316220;201510;784;2410;546;1929;116;474;67;242;183;716
316225;201510;1176;3293;990;2981;132;449;637;1854;769;2303
316230;201510;447;1230;340;1046;54;183;168;544;222;727
316240;201510;6534;19999;5656;18818;643;2182;4073;13674;4716;15856
316245;201510;3210;11041;2962;10616;223;1098;2270;7877;2493;8975
316250;201510;10361;30173;8068;25605;2217;7636;2126;6341;4343;13977
316255;201510;2538;7720;2222;7326;420;1493;1402;4607;1822;6100
316257;201510;1369;3798;1029;3172;193;677;393;1139;586;1816
316260;201510;1781;5072;1382;4485;108;403;806;2753;914;3156
316265;201510;1322;3691;956;2964;107;410;552;1639;659;2049
316270;201510;4173;13778;3797;12987;1005;3709;1513;4999;2518;8708
316280;201510;3276;10549;2926;9874;484;1845;1578;5241;2062;7086
316290;201510;3320;10342;2796;9318;548;2162;1151;3618;1699;5780
316292;201510;3410;10870;3021;10185;641;2418;1571;5025;2212;7443
316294;201510;887;2825;622;2230;127;540;47;159;174;699
316295;201510;1782;5992;1627;5680;247;1056;989;3289;1236;4345
316300;201510;1000;3079;838;2807;71;258;545;1849;616;2107
316310;201510;724;2066;472;1583;93;364;136;422;229;786
316320;201510;614;1954;484;1723;86;374;97;313;183;687
316330;201510;942;2874;726;2380;91;326;446;1423;537;1749
316340;201510;973;3098;791;2718;189;774;329;1039;518;1813
316350;201510;1326;4202;1179;3951;202;695;665;2289;867;2984
316360;201510;730;1917;571;1679;67;207;403;1194;470;1401
316370;201510;4433;14355;3777;12960;1055;3977;610;2062;1665;6039
316380;201510;1581;4223;1243;3747;92;312;868;2614;960;2926
316390;201510;911;2653;747;2375;196;680;307;993;503;1673
316400;201510;1259;3959;991;3447;209;776;393;1316;602;2092
316410;201510;1074;3539;986;3403;219;794;587;2027;806;2821
316420;201510;1859;6116;1657;5842;155;694;1134;3870;1289;4564
316430;201510;951;2903;700;2390;164;603;172;514;336;1117
316440;201510;678;2208;554;2001;200;836;115;393;315;1229
316443;201510;704;2069;573;1821;131;473;214;633;345;1106
316447;201510;1600;4825;1445;4609;102;344;1231;3947;1333;4291
316450;201510;2143;7190;1824;6561;253;1027;1172;4242;1425;5269
316460;201510;739;2264;664;2129;171;614;358;1087;529;1701
316470;201510;7415;23750;5782;20213;1450;5876;1626;5380;3076;11256
316480;201510;195;653;168;595;35;127;55;183;90;310
316490;201510;299;916;252;801;52;168;99;289;151;457
316500;201510;1131;4030;754;2869;137;559;38;131;175;690
316510;201510;796;2905;703;2710;231;953;181;660;412;1613
316520;201510;1143;3438;922;3085;169;628;306;910;475;1538
316530;201510;1093;3512;906;3131;205;883;319;906;524;1789
316540;201510;888;2826;774;2631;124;517;258;819;382;1336
316550;201510;1166;3881;1084;3736;216;869;651;2213;867;3082
316553;201510;1874;6484;1459;5480;402;1656;331;1216;733;2872
316555;201510;2827;9722;2496;9310;191;798;1827;6879;2018;7677
316556;201510;610;1612;484;1399;56;202;317;852;373;1054
316557;201510;756;2723;717;2660;281;1101;156;525;437;1626
316560;201510;332;1141;278;1022;65;298;64;194;129;492
316570;201510;1268;4017;1097;3665;139;507;561;1873;700;2380
316580;201510;293;847;190;626;48;184;50;151;98;335
316590;201510;1496;4055;1060;3317;275;905;440;1274;715;2179
316600;201510;1044;3360;913;3092;277;1011;298;974;575;1985
316610;201510;580;2088;504;1933;102;443;300;1132;402;1575
316620;201510;2138;6543;1816;5950;330;1285;1032;3276;1362;4561
316630;201510;1457;4804;1232;4317;499;1834;319;1123;818;2957
316640;201510;182;574;158;523;33;140;70;196;103;336
316650;201510;907;3310;793;3122;132;537;479;1955;611;2492
316660;201510;201;520;98;298;12;50;27;60;39;110
316670;201510;1832;5262;1471;4612;573;1955;291;819;864;2774
316680;201510;1920;5179;1540;4640;216;690;1070;3217;1286;3907
316690;201510;1188;3944;1048;3635;299;1174;337;1125;636;2299
316695;201510;1102;3459;941;3136;116;414;562;1865;678;2279
316700;201510;349;1085;310;1012;45;188;184;549;229;737
316710;201510;3160;11729;2702;10708;939;3947;661;2778;1600;6725
316720;201510;15865;50668;12752;43810;3678;13452;2681;8827;6359;22279
316730;201510;366;1131;312;1020;73;269;144;427;217;696
316740;201510;681;2260;603;2117;156;642;270;901;426;1543
316750;201510;415;1376;344;1211;70;288;107;332;177;620
316760;201510;3401;11365;2930;10743;1595;5988;786;2963;2381;8951
316770;201510;1246;3539;1131;3390;115;428;859;2556;974;2984
316780;201510;580;1928;505;1778;142;570;112;347;254;917
316790;201510;863;2453;622;2035;151;541;195;630;346;1171
316800;201510;5276;17291;4699;16164;904;3513;2305;7482;3209;10995
316805;201510;845;2186;799;2127;78;200;666;1841;744;2041
316810;201510;613;1877;505;1651;148;539;189;571;337;1110
316820;201510;393;1014;220;704;43;165;39;105;82;270
316830;201510;597;2035;565;1972;171;656;229;769;400;1425
316840;201510;2914;8846;2542;8138;598;2203;1070;3222;1668;5425
316850;201510;2084;6131;1755;5556;265;953;954;2993;1219;3946
316860;201510;17697;55623;15064;50591;3471;13487;6271;19963;9742;33450
316870;201510;5821;18730;4616;15864;1345;5076;738;2394;2083;7470
316880;201510;790;2492;713;2354;201;769;249;768;450;1537
316890;201510;1299;3186;1031;2838;318;1022;531;1354;849;2376
316900;201510;2539;7628;1992;6463;469;1701;585;1679;1054;3380
316905;201510;459;1526;396;1386;133;495;129;443;262;938
316910;201510;809;2572;578;2090;166;646;106;381;272;1027
316920;201510;1559;4338;1158;3770;325;1200;392;1205;717;2405
316930;201510;8714;29314;6748;24786;1486;6008;935;3064;2421;9072
316935;201510;5104;14801;3268;11030;844;3189;557;1678;1401;4867
316940;201510;7049;22966;5673;19939;1306;4897;1189;4003;2495;8900
316950;201510;1483;4220;1272;3915;122;460;890;2692;1012;3152
316960;201510;4990;12500;3900;11032;737;2285;2132;5915;2869;8200
316970;201510;3263;10367;3055;10017;708;2687;1154;3475;1862;6162
316980;201510;1040;3121;743;2561;244;943;147;489;391;1432
316990;201510;9639;30818;8000;26924;2518;9197;710;2242;3228;11439
317000;201510;2751;9405;2648;9289;319;1041;1946;7659;2265;8700
317005;201510;2592;7947;2288;7485;450;1502;1299;4291;1749;5793
317010;201510;31158;77444;18568;57105;4606;15918;3918;12447;8524;28365
317020;201510;59044;164249;34806;113397;7387;26358;7099;21055;14486;47413
317030;201510;762;2174;621;1950;71;282;375;1135;446;1417
317040;201510;10353;29955;8254;26142;2148;7352;3085;9661;5233;17013
317043;201510;747;2043;634;1896;85;245;404;1228;489;1473
317047;201510;1149;3022;827;2484;125;421;395;1168;520;1589
317050;201510;1521;5189;1171;4327;243;981;446;1533;689;2514
317052;201510;2320;7463;2104;7123;184;734;1525;5086;1709;5820
317057;201510;1746;4842;1314;4080;130;490;744;2235;874;2725
317060;201510;410;1181;280;885;57;213;85;227;142;440
317065;201510;1243;4077;1125;3881;129;569;809;2688;938;3257
317070;201510;9825;30358;6430;22505;1366;5380;1000;3307;2366;8687
317075;201510;1081;3248;866;2793;218;771;237;684;455;1455
317080;201510;6051;16603;5100;14974;1494;4598;1632;4618;3126;9216
317090;201510;4895;16176;4522;15559;676;2337;3027;10633;3703;12970
317100;201510;3057;8403;2308;7118;713;2410;781;2269;1494;4679
317103;201510;2015;6889;1680;6202;272;1263;811;2869;1083;4132
317107;201510;1319;4022;1120;3609;193;739;673;2027;866;2766
317110;201510;672;1689;390;1195;77;290;150;447;227;737
317115;201510;1155;3639;983;3281;133;445;643;2180;776;2625
317120;201510;11113;36323;8891;31062;2159;8345;3132;10563;5291;18908
317130;201510;7596;22669;6341;20364;1339;4845;2704;8470;4043;13315
317140;201510;572;1865;541;1810;81;295;347;1159;428;1454
317150;201510;973;2690;838;2535;99;351;591;1737;690;2088
317160;201510;3522;9285;2667;8151;236;765;1821;5538;2057;6303
317170;201510;1820;5022;1471;4454;87;347;883;2493;970;2840
317180;201510;1811;6005;1422;5141;390;1539;372;1292;762;2831
317190;201510;1388;3952;1109;3559;125;441;745;2359;870;2800
317200;201510;4447;13849;3791;12510;1005;3663;1184;3719;2189;7382
317210;201510;1042;3122;857;2864;167;679;454;1485;621;2164
317220;201510;298;1031;283;1007;82;320;122;414;204;734
320010;201510;5091;15896;4364;14329;808;2808;2212;7159;3020;9967
320013;201510;1933;5791;1377;4629;212;723;613;2113;825;2836
320016;201510;3184;8963;2744;8295;387;1127;1878;5705;2265;6832
320020;201510;3849;11920;3243;10656;950;3387;1075;3462;2025;6849
320030;201510;1653;5289;1306;4513;398;1443;404;1348;802;2791
320035;201510;1783;5240;1541;4854;474;1669;582;1688;1056;3357
320040;201510;3310;10649;2645;9204;603;2312;766;2538;1369;4850
320050;201510;1787;4817;1509;4304;344;1065;654;1742;998;2807
320060;201510;12086;38030;9116;31120;2174;8099;2590;8256;4764;16355
320070;201510;1483;4751;1180;4046;268;1029;305;911;573;1940
320080;201510;5432;15381;4038;12521;1091;3549;992;3011;2083;6560
320090;201510;8358;24221;6535;20477;1772;5907;2461;7336;4233;13243
320100;201510;2968;9033;2361;7785;632;2216;844;2676;1476;4892
320110;201510;1292;3827;1122;3486;257;829;379;1162;636;1991
320115;201510;1824;6426;1641;6076;845;3287;433;1598;1278;4885
320120;201510;16364;49808;12543;42158;3316;12193;3606;12005;6922;24198
320130;201510;36611;117097;32944;109471;7095;26255;15368;49097;22463;75352
320140;201510;4046;12694;2807;9776;678;2624;315;1006;993;3630
320150;201510;16703;45850;11652;36000;2820;9452;1826;5319;4646;14771
320160;201510;4839;15238;4168;13801;1074;4011;1417;4236;2491;8247
320170;201510;1754;5590;1414;4822;373;1356;535;1810;908;3166
320180;201510;807;2641;697;2452;283;1044;182;647;465;1691
320190;201510;3788;12858;2946;10717;849;3277;629;2155;1478;5432
320200;201510;1079;3308;901;2987;228;818;328;1114;556;1932
320210;201510;4922;13634;4136;12141;894;2950;1946;5289;2840;8239
320220;201510;2589;7960;2082;6952;542;1976;786;2639;1328;4615
320225;201510;1435;4872;1125;4108;389;1516;197;728;586;2244
320230;201510;4240;13741;3665;12738;1180;4412;1269;4441;2449;8853
320240;201510;12226;35996;9440;30746;2573;9128;2373;7561;4946;16689
320245;201510;3667;12421;3354;11642;1110;4119;952;3130;2062;7249
320250;201510;1835;5561;1296;4313;344;1340;242;666;586;2006
320255;201510;1806;6024;1550;5575;624;2448;547;2023;1171;4471
320260;201510;1051;3225;786;2586;207;738;189;512;396;1250
320265;201510;2393;7472;2081;7039;414;1460;1272;4412;1686;5872
320270;201510;2739;8157;2025;6725;485;1762;807;2645;1292;4407
320280;201510;6895;20755;6002;18965;1412;4914;2424;7196;3836;12110
320290;201510;1484;4816;1067;3748;344;1298;189;602;533;1900
320300;201510;4314;14278;3798;13130;1184;4340;921;3109;2105;7449
320305;201510;4523;14491;3903;13057;938;3448;1662;5272;2600;8720
320310;201510;1983;5878;1672;5237;427;1405;650;1960;1077;3365
320313;201510;2262;6602;1521;4874;368;1400;273;735;641;2135
320316;201510;1755;5269;1426;4584;462;1567;509;1550;971;3117
320320;201510;19968;61475;15982;53778;4452;16477;5291;17178;9743;33655
320330;201510;3073;9075;2604;8280;646;2023;1247;4179;1893;6202
320332;201510;4935;16363;4264;15051;1516;5668;1250;4426;2766;10094
320334;201510;1938;6226;1352;4884;391;1575;225;745;616;2320
320335;201510;2386;6970;1505;4956;382;1413;218;579;600;1992
320340;201510;5950;16094;4812;14151;1091;3479;2017;5960;3108;9439
320350;201510;5163;13780;3827;11317;870;2751;1485;4313;2355;7064
320360;201510;1763;4625;1278;3667;237;749;517;1351;754;2100
320370;201510;3227;10389;2590;8953;744;2650;832;2813;1576;5463
320380;201510;2373;6920;2072;6376;358;1246;1233;3689;1591;4935
320390;201510;7761;23103;6157;19673;1749;6091;1670;4969;3419;11060
320400;201510;3721;11216;3256;10397;969;3464;1174;3419;2143;6883
320405;201510;4083;11946;3577;11143;907;3037;1750;5262;2657;8299
320410;201510;5612;14593;4089;12590;1032;3426;1822;5529;2854;8955
320420;201510;1943;5892;1439;4968;431;1641;294;1001;725;2642
320425;201510;1954;5228;1656;4718;237;742;991;2736;1228;3478
320430;201510;2344;6586;2030;5946;428;1348;1067;2989;1495;4337
320435;201510;2845;9311;2348;8280;1060;3915;636;2338;1696;6253
320440;201510;1151;3800;994;3378;237;911;347;1092;584;2003
320450;201510;2047;6371;1655;5548;458;1709;694;2210;1152;3919
320455;201510;4300;14157;3073;11078;868;3340;765;2679;1633;6019
320460;201510;2794;8934;2173;7528;557;2109;649;2103;1206;4212
320465;201510;1633;5083;1238;4170;242;896;529;1726;771;2622
320470;201510;4471;13405;2936;9848;796;2942;490;1446;1286;4388
320480;201510;1904;5781;1634;5262;414;1468;576;1784;990;3252
320490;201510;15890;48803;13038;43264;4015;14563;3635;11920;7650;26483
320495;201510;1265;3832;886;2983;315;1107;108;385;423;1492
320500;201510;46623;140703;40014;128329;10041;34985;18194;56696;28235;91681
320501;201510;4303;13367;3664;12365;1219;4664;1286;4065;2505;8729
320503;201510;1937;6490;1550;5632;597;2376;396;1234;993;3610
320506;201510;3869;12048;2615;8921;824;2990;199;593;1023;3583
320510;201510;8215;25594;6963;23061;1781;6336;3037;9851;4818;16187
320515;201510;1987;5640;1595;4787;439;1359;357;987;796;2346
320517;201510;2189;7020;1748;6093;597;2293;371;1175;968;3468
320520;201510;36608;109623;29188;95359;7924;28467;10372;33264;18296;61731
320530;201510;27261;82307;22343;72509;4799;18012;10339;31142;15138;49154
330010;201510;19942;60696;17723;56279;3630;12539;9578;29655;13208;42194
330015;201510;1716;4720;1464;4245;252;859;611;1696;863;2555
330020;201510;17143;50367;15485;47611;3067;10309;8858;26639;11925;36948
330022;201510;1810;5445;1522;4956;301;1129;773;2397;1074;3526
330023;201510;3312;10197;2884;9437;812;2891;952;2945;1764;5836
330025;201510;4384;11837;3442;10294;827;2724;1748;5091;2575;7815
330030;201510;7879;26292;6879;24210;1515;5898;3175;10654;4690;16552
330040;201510;12139;35212;10392;32017;2384;7863;5057;15041;7441;22904
330045;201510;68558;189692;59657;176492;7920;25099;39967;116206;47887;141305
330050;201510;2575;7977;2254;7325;669;2402;658;1947;1327;4349
330060;201510;5743;16578;4959;15400;1223;4271;2446;7488;3669;11759
330070;201510;23067;69225;20219;64140;4572;15601;9172;28875;13744;44476
330080;201510;7914;22579;7373;21736;969;2811;5116;15314;6085;18125
330090;201510;2672;7272;2412;6837;455;1448;1311;3596;1766;5044
330093;201510;2057;6071;1680;5341;400;1329;608;1940;1008;3269
330095;201510;1035;3508;897;3193;246;999;207;681;453;1680
330100;201510;54956;175073;49630;165799;8921;33498;26147;86966;35068;120464
330110;201510;2358;7474;2086;6959;531;1900;630;2035;1161;3935
330115;201510;2046;5833;1785;5418;337;1154;919;2690;1256;3844
330120;201510;2492;6998;2177;6519;533;1779;1096;3131;1629;4910
330130;201510;3561;11418;3108;10570;815;3013;1380;4585;2195;7598
330140;201510;2965;9238;2679;8798;633;2275;1300;4232;1933;6507
330150;201510;2400;6984;1809;5771;406;1425;433;1343;839;2768
330160;201510;1110;3641;996;3432;292;1132;432;1411;724;2543
330170;201510;102106;305387;92794;290144;16058;53357;56508;175184;72566;228541
330180;201510;2017;5899;1668;5246;165;644;997;2932;1162;3576
330185;201510;7777;24359;6751;22293;1541;5571;3453;11119;4994;16690
330187;201510;3914;11122;3327;10116;509;1742;2165;6440;2674;8182
330190;201510;25773;73379;23809;70182;4657;14491;15106;44139;19763;58630
330200;201510;13841;43735;12192;40726;3139;10845;5732;19343;8871;30188
330205;201510;2254;6087;1932;5528;377;1204;1021;2796;1398;4000
330210;201510;4111;11031;3139;9191;875;2715;723;2061;1598;4776
330220;201510;10157;30851;8751;27804;2386;8202;2284;6637;4670;14839
330225;201510;3964;12116;3569;11428;476;1796;2226;7045;2702;8841
330227;201510;17637;50420;15695;47491;4059;12598;7992;24457;12051;37055
330230;201510;1390;4134;1248;3884;311;1093;519;1512;830;2605
330240;201510;17133;52893;14576;47747;4985;17707;3200;9832;8185;27539
330245;201510;1281;3965;991;3396;255;965;189;604;444;1569
330250;201510;35923;104576;32388;98469;9816;30139;13067;40645;22883;70784
330260;201510;3684;11534;3184;10478;636;2321;1347;4184;1983;6505
330270;201510;15833;40652;11581;34476;3081;9995;4148;12185;7229;22180
330280;201510;2170;6443;1775;5642;314;1105;800;2330;1114;3435
330285;201510;18455;52872;16531;49982;2874;9382;10184;30469;13058;39851
330290;201510;3578;9952;3123;9267;533;1811;1835;5186;2368;6997
330300;201510;3344;10800;3030;10206;447;1730;1777;5814;2224;7544
330310;201510;2376;6744;2039;6162;348;1128;1093;3224;1441;4352
330320;201510;13188;39289;12250;37836;1880;6340;8727;26692;10607;33032
330330;201510;27286;75955;24005;70627;4155;13791;14691;41631;18846;55422
330340;201510;14494;42348;11114;35813;2934;10009;3265;10332;6199;20341
330350;201510;87114;260742;80460;250635;12154;39555;56180;175045;68334;214600
330360;201510;5648;17026;5438;16720;352;1209;4576;13992;4928;15201
330370;201510;3464;12261;3118;11477;1076;4125;1004;3712;2080;7837
330380;201510;4935;15831;4125;14216;930;3518;1695;5647;2625;9165
330385;201510;4094;14074;3711;13293;1173;4509;1352;4788;2525;9297
330390;201510;23209;75713;20378;69808;4900;18371;8995;29911;13895;48282
330395;201510;3004;8814;2694;8272;280;1012;1800;5357;2080;6369
330400;201510;2499;7948;2233;7465;344;1393;1272;3916;1616;5309
330410;201510;2798;8672;2317;7723;469;1699;1087;3541;1556;5240
330411;201510;2336;7254;1992;6503;248;976;1136;3523;1384;4499
330412;201510;1342;4541;1094;4037;257;1107;428;1447;685;2554
330414;201510;24881;69811;21497;64963;4240;12852;12736;38762;16976;51614
330415;201510;3577;10877;3054;9895;802;2686;1128;3655;1930;6341
330420;201510;9416;27490;6267;21318;1482;5435;1085;3566;2567;9001
330430;201510;7594;22343;6686;20603;1432;4771;3133;9370;4565;14141
330440;201510;1793;5925;1501;5269;461;1796;302;912;763;2708
330450;201510;1403;4651;1251;4370;283;1182;617;2059;900;3241
330452;201510;13505;39598;10445;33517;2714;9515;3683;11275;6397;20790
330455;201510;485209;1349471;398944;1209940;96495;309815;190576;570574;287071;880389
330460;201510;1228;3969;1093;3725;228;900;507;1667;735;2567
330470;201510;4358;13233;3829;12230;936;3277;1679;5183;2615;8460
330475;201510;7864;24334;6870;22583;1960;7070;2600;8290;4560;15360
330480;201510;5834;17189;5310;16404;1122;3748;2875;8728;3997;12476
330490;201510;107187;284747;96028;268209;9933;28757;71750;200788;81683;229545
330500;201510;5491;16961;5210;16427;632;2227;3634;11285;4266;13512
330510;201510;37967;116420;33952;109753;10556;34673;14930;49019;25486;83692
330513;201510;1517;4539;1365;4256;411;1284;506;1609;917;2893
330515;201510;3036;9371;2645;8615;812;2674;810;2610;1622;5284
330520;201510;11616;34471;10218;31930;2184;7223;4941;15190;7125;22413
330530;201510;1525;4550;1332;4174;349;1168;507;1545;856;2713
330540;201510;3071;9017;2543;8077;606;2106;1058;3211;1664;5317
330550;201510;8035;26762;6981;24676;3011;11074;1138;4013;4149;15087
330555;201510;10393;30640;9163;28820;1772;5662;5505;17695;7277;23357
330560;201510;4191;12649;3792;11902;781;2724;1920;5773;2701;8497
330570;201510;3641;10520;3075;9548;831;2691;1444;4489;2275;7180
330575;201510;5200;15015;4610;13934;790;2683;2853;8239;3643;10922
330580;201510;14621;45726;12298;40867;3275;11460;4842;16110;8117;27570
330590;201510;1653;5022;1526;4801;316;1072;909;2806;1225;3878
330600;201510;10777;30619;8492;26828;1233;4469;4568;14025;5801;18494
330610;201510;9016;28185;8139;26541;1499;5570;4514;14333;6013;19903
330615;201510;1678;5843;1498;5433;660;2581;293;1028;953;3609
330620;201510;3607;12378;3211;11625;1117;4417;795;2908;1912;7325
330630;201510;22517;66428;18266;58635;3401;12383;9429;28903;12830;41286
350010;201510;2104;6225;1407;4741;340;1250;228;659;568;1909
350020;201510;462;1203;310;910;54;175;166;469;220;644
350030;201510;4431;13771;3434;11690;1241;4649;739;2271;1980;6920
350040;201510;501;1711;380;1426;86;356;100;322;186;678
350050;201510;1049;3128;821;2712;196;754;285;839;481;1593
350055;201510;670;1961;576;1806;131;444;313;950;444;1394
350060;201510;104;301;81;265;23;89;35;106;58;195
350070;201510;3488;10670;2237;7857;474;1816;409;1255;883;3071
350075;201510;439;1468;344;1302;113;451;84;294;197;745
350080;201510;551;1535;377;1193;75;265;146;437;221;702
350090;201510;599;1584;407;1241;81;258;139;399;220;657
350100;201510;1828;5729;1288;4542;284;1105;359;1168;643;2273
350110;201510;466;1373;347;1106;49;185;171;520;220;705
350115;201510;1283;3937;1124;3586;217;824;582;1677;799;2501
350120;201510;575;1502;284;872;56;183;45;129;101;312
350130;201510;3305;9676;2898;8883;449;1578;1547;4430;1996;6008
350140;201510;592;1909;507;1754;92;362;231;769;323;1131
350150;201510;383;1292;338;1195;121;456;86;298;207;754
350160;201510;6877;20908;4977;16775;1284;4849;1896;5784;3180;10633
350170;201510;1758;6009;1490;5328;399;1555;358;1180;757;2735
350180;201510;1116;3037;760;2265;153;467;341;985;494;1452
350190;201510;3151;9759;2561;8551;547;2189;1231;3644;1778;5833
350200;201510;348;1111;292;1005;48;181;148;510;196;691
350210;201510;5181;13689;3812;11413;1073;3570;1510;4291;2583;7861
350220;201510;2601;8194;2256;7472;585;2269;785;2331;1370;4600
350230;201510;623;2050;567;1950;135;519;235;780;370;1299
350240;201510;439;1372;380;1221;78;265;221;684;299;949
350250;201510;2137;7722;2005;7451;719;2846;692;2536;1411;5382
350260;201510;956;2545;667;2023;123;405;284;805;407;1210
350270;201510;5043;15350;4193;13457;809;2740;1755;5418;2564;8158
350275;201510;1989;6603;1771;6203;485;1819;649;2151;1134;3970
350280;201510;21931;54068;13046;38541;2884;9019;2737;7929;5621;16948
350290;201510;1697;5506;1316;4697;293;1158;321;1052;614;2210
350300;201510;357;1060;311;977;67;217;177;556;244;773
350310;201510;866;2832;742;2538;117;454;336;1110;453;1564
350315;201510;528;1653;408;1397;70;285;106;331;176;616
350320;201510;11433;35399;9840;32239;2741;9581;1480;4916;4221;14497
350330;201510;13619;38460;8833;27285;1842;5706;2871;8421;4713;14127
350335;201510;370;1144;319;1039;38;122;195;639;233;761
350340;201510;1130;3348;774;2610;153;588;244;766;397;1354
350350;201510;730;2257;618;2060;114;451;234;752;348;1203
350360;201510;791;2675;665;2405;181;685;244;900;425;1585
350370;201510;708;2113;497;1641;89;320;98;280;187;600
350380;201510;3358;10335;2558;8913;817;3136;620;1914;1437;5050
350390;201510;8659;27074;7639;25128;2277;7844;2909;9326;5186;17170
350395;201510;348;975;177;607;25;96;36;120;61;216
350400;201510;7942;22535;6265;19440;1464;5069;2446;7170;3910;12239
350410;201510;8096;26975;6085;22587;1654;6780;1015;3479;2669;10259
350420;201510;565;1678;389;1353;71;298;36;104;107;402
350430;201510;740;2281;597;2012;116;450;281;895;397;1345
350440;201510;1220;3805;1091;3545;279;929;504;1613;783;2542
350450;201510;7702;22893;5798;19016;1390;4927;1393;4261;2783;9188
350460;201510;1358;3819;894;2836;191;674;270;764;461;1438
350470;201510;247;674;199;586;38;136;113;306;151;442
350480;201510;801;2441;532;1830;77;294;86;247;163;541
350490;201510;1783;5307;1520;4902;373;1341;594;1751;967;3092
350500;201510;573;1662;488;1515;109;365;226;685;335;1050
350510;201510;1027;3091;792;2570;140;534;324;950;464;1484
350520;201510;1280;4690;980;3890;250;1095;171;626;421;1721
350530;201510;2402;7031;1938;6077;562;1877;568;1617;1130;3494
350535;201510;1323;4126;1227;3938;142;577;853;2590;995;3167
350540;201510;1923;5327;1506;4566;410;1317;513;1528;923;2845
350550;201510;11622;30818;7762;24274;1651;5784;2666;7888;4317;13672
350560;201510;3405;11122;3038;10328;461;1678;1611;5510;2072;7188
350570;201510;18204;60720;16186;56185;4786;17843;5785;19027;10571;36870
350580;201510;1670;5153;1168;3997;245;930;161;459;406;1389
350590;201510;4121;12683;3066;10481;814;3118;988;3038;1802;6156
350600;201510;40419;99001;26325;74949;4323;13304;12328;33184;16651;46488
350610;201510;7691;21968;5858;18696;1188;4257;2567;7882;3755;12139
350620;201510;397;1109;298;954;60;228;138;407;198;635
350630;201510;1561;4636;1186;3926;268;1039;317;923;585;1962
350635;201510;5889;17581;4427;14859;1080;3896;1688;5572;2768;9468
350640;201510;740;2303;497;1687;92;347;120;371;212;718
350650;201510;7207;21906;4002;14006;973;3767;417;1341;1390;5108
350660;201510;4331;12880;3642;11706;772;2699;1900;5952;2672;8651
350670;201510;1716;5263;1578;4993;309;1043;941;2890;1250;3933
350680;201510;1135;3422;878;2896;193;741;368;1172;561;1913
350690;201510;877;2851;702;2492;165;656;219;697;384;1353
350700;201510;4135;12286;2656;9419;780;2960;621;1933;1401;4893
350710;201510;2504;7807;2214;7295;353;1296;1355;4397;1708;5693
350715;201510;870;2622;756;2412;240;833;243;681;483;1514
350720;201510;135;393;121;370;38;123;44;127;82;250
350730;201510;390;1453;367;1392;99;425;138;503;237;928
350740;201510;1924;5902;1446;4730;274;977;515;1532;789;2509
350745;201510;361;1103;267;878;44;162;122;355;166;517
350750;201510;10110;30280;7670;25312;1826;6612;1669;5005;3495;11617
350760;201510;13049;38176;10307;33117;2610;9281;3491;10318;6101;19599
350770;201510;729;2060;481;1565;72;270;218;674;290;944
350775;201510;552;1506;458;1357;72;266;263;744;335;1010
350780;201510;1997;6048;1475;4959;432;1613;200;618;632;2231
350790;201510;2012;6266;1471;5133;375;1409;316;964;691;2373
350800;201510;2988;9860;2799;9543;463;1818;1731;5757;2194;7575
350810;201510;2040;5703;1662;5140;493;1649;615;1868;1108;3517
350820;201510;559;1504;401;1189;71;257;177;472;248;729
350830;201510;881;2708;588;2007;89;329;145;396;234;725
350840;201510;2494;8720;2020;7528;597;2434;364;1135;961;3569
350850;201510;6193;20421;5062;17850;1610;6009;1136;3863;2746;9872
350860;201510;3140;9727;2997;9511;246;988;2325;7286;2571;8274
350870;201510;2621;8337;2195;7657;572;2260;1218;4227;1790;6487
350880;201510;1304;4261;1064;3746;260;988;242;814;502;1802
350890;201510;674;1909;436;1391;65;239;101;242;166;481
350900;201510;3866;12606;2917;10381;752;2944;419;1329;1171;4273
350910;201510;841;2488;726;2248;242;785;262;769;504;1554
350920;201510;9910;28424;8842;26494;1162;3867;5931;17087;7093;20954
350925;201510;4829;14706;3947;12878;985;3428;1496;4449;2481;7877
350930;201510;1586;4292;1263;3711;146;480;813;2283;959;2763
350940;201510;1925;6289;1754;6024;322;1316;1075;3571;1397;4887
350945;201510;900;2868;756;2571;130;534;401;1295;531;1829
350950;201510;68037;206014;53953;176523;12923;46348;21579;66916;34502;113264
350960;201510;4364;14524;3657;12994;654;2619;2026;6907;2680;9526
350970;201510;4354;14948;3618;13156;1149;4544;777;2456;1926;7000
350980;201510;600;1954;538;1848;226;833;185;626;411;1459
350990;201510;1730;5881;1460;5340;447;1762;386;1356;833;3118
350995;201510;773;2673;737;2598;120;537;447;1488;567;2025
351000;201510;3226;9557;2652;8447;376;1355;1296;3879;1672;5234
351010;201510;353;1001;224;724;56;202;77;252;133;454
351015;201510;857;2838;728;2592;180;716;307;1041;487;1757
351020;201510;7906;24720;6832;23004;1707;6073;3064;10404;4771;16477
351030;201510;1625;5788;1437;5315;324;1387;454;1549;778;2936
351040;201510;3321;10047;2994;9474;490;1778;1886;5718;2376;7496
351050;201510;13549;39073;9322;31200;2414;8848;2491;8137;4905;16985
351060;201510;33010;97432;26613;85486;6125;21488;11409;35478;17534;56966
351070;201510;1587;4401;1054;3411;296;1063;148;386;444;1449
351080;201510;2646;7620;2013;6806;515;1925;867;2785;1382;4710
351090;201510;388;1299;293;1088;61;261;60;212;121;473
351100;201510;2053;6210;1605;5293;495;1681;412;1421;907;3102
351110;201510;7485;18576;3913;12461;875;3164;879;2518;1754;5682
351120;201510;630;1810;502;1543;57;210;258;689;315;899
351130;201510;1012;2820;538;1831;89;345;100;316;189;661
351140;201510;1694;5726;1436;5141;438;1717;369;1204;807;2921
351150;201510;1710;5844;1250;4631;215;882;269;836;484;1718
351160;201510;1313;4436;1143;4036;300;1204;394;1272;694;2476
351170;201510;1480;4673;1174;3995;228;857;516;1643;744;2500
351190;201510;747;2357;585;1939;109;365;133;410;242;775
351200;201510;2118;6191;1731;5396;339;1200;612;1711;951;2911
351210;201510;1051;3115;786;2566;175;652;267;765;442;1417
351220;201510;3287;10908;2897;10091;588;2267;1363;4638;1951;6905
351230;201510;1744;5393;1468;4891;297;1187;754;2379;1051;3566
351240;201510;1070;3378;778;2725;207;786;180;540;387;1326
351250;201510;908;2585;612;1955;127;438;216;640;343;1078
351260;201510;917;2662;778;2369;172;551;330;945;502;1496
351270;201510;358;1218;319;1138;68;286;141;448;209;734
351280;201510;5141;15010;3796;12122;841;2865;1338;3985;2179;6850
351290;201510;996;2815;740;2309;166;536;294;883;460;1419
351300;201510;12410;40724;9135;33416;2315;9330;2798;9944;5113;19274
351310;201510;3204;9675;2545;8432;491;1896;1185;3610;1676;5506
351320;201510;904;3002;769;2695;170;695;238;720;408;1415
351330;201510;288;798;238;715;96;295;57;161;153;456
351340;201510;5764;19143;4943;17457;1406;5266;1883;6603;3289;11869
351350;201510;7306;23442;6205;21048;1814;6407;1925;6113;3739;12520
351360;201510;4140;12784;3740;11970;906;3197;1292;3780;2198;6977
351370;201510;2273;6957;1769;5894;394;1475;647;1961;1041;3436
351380;201510;36772;107668;32976;100330;6542;21684;14740;43433;21282;65117
351385;201510;199;612;185;586;42;142;84;248;126;390
351390;201510;1125;3632;940;3249;255;1007;355;1082;610;2089
351400;201510;879;2921;828;2795;330;1179;257;833;587;2012
351410;201510;2670;7958;2316;7304;392;1306;1320;4038;1712;5344
351420;201510;357;1002;231;751;50;169;61;183;111;352
351430;201510;851;2608;774;2479;96;332;550;1752;646;2084
351440;201510;3718;10824;2818;8832;679;2186;542;1458;1221;3644
351450;201510;1672;4638;1379;4182;348;1093;586;1866;934;2959
351460;201510;731;2182;610;1977;299;1005;167;515;466;1520
351470;201510;1039;3060;892;2773;209;738;363;1065;572;1803
351480;201510;2785;9001;2531;8570;450;1903;1371;4402;1821;6305
351490;201510;1785;5841;1569;5370;215;896;925;2991;1140;3887
351492;201510;206;642;159;533;18;71;88;286;106;357
351495;201510;162;522;127;423;30;120;46;133;76;253
351500;201510;23258;67038;17774;56504;4565;15973;6923;20837;11488;36810
351510;201510;8498;26355;6910;23090;1637;5947;3270;10677;4907;16624
351512;201510;418;1198;334;1030;55;165;196;622;251;787
351515;201510;2249;7013;1571;5475;389;1453;415;1289;804;2742
351518;201510;2024;6357;1377;5111;336;1428;391;1308;727;2736
351519;201510;788;2288;597;1875;111;427;206;499;317;926
351520;201510;827;2275;417;1464;63;256;62;197;125;453
351530;201510;385;1175;270;892;39;131;76;216;115;347
351535;201510;2343;5993;1796;5173;183;618;1149;3174;1332;3792
351540;201510;1774;5308;1421;4638;444;1592;234;712;678;2304
351550;201510;4877;14223;3417;11172;741;2751;1184;3683;1925;6434
351560;201510;366;1162;306;1030;65;261;53;158;118;419
351565;201510;180;590;163;543;32;120;74;233;106;353
351570;201510;11388;34851;9586;31147;2193;7687;4920;15493;7113;23180
351580;201510;339;884;206;597;51;143;60;162;111;305
351590;201510;415;1098;301;886;32;96;124;343;156;439
351600;201510;1702;4696;1458;4281;261;846;672;1853;933;2699
351610;201510;661;1809;503;1534;58;213;234;645;292;858
351620;201510;18789;59947;13979;49866;3096;12246;3210;10120;6306;22366
351630;201510;18325;58066;16430;54817;3753;13350;8993;29607;12746;42957
351640;201510;10810;33247;8905;29716;1771;6480;4787;15627;6558;22107
351650;201510;450;1353;217;748;40;156;35;101;75;257
351660;201510;771;2440;543;1839;114;407;119;351;233;758
351670;201510;3935;12095;3179;10438;577;2166;1467;4506;2044;6672
351680;201510;644;1954;391;1334;65;233;84;272;149;505
351685;201510;423;1235;341;1100;86;277;150;493;236;770
351690;201510;1068;3115;732;2350;143;513;217;594;360;1107
351700;201510;1192;3443;1018;3110;257;780;415;1235;672;2015
351710;201510;639;2058;514;1784;89;311;197;635;286;946
351720;201510;1636;4912;1095;3571;221;759;336;983;557;1742
351730;201510;1049;2988;838;2684;278;1017;299;908;577;1925
351740;201510;4041;10999;3153;9217;655;2027;1086;3015;1741;5042
351750;201510;1172;3689;806;2823;185;741;228;709;413;1450
351760;201510;3687;11422;3028;9955;815;2887;1031;3121;1846;6008
351770;201510;2295;7114;1906;6427;548;1945;796;2554;1344;4499
351780;201510;1547;4297;880;2794;154;530;230;667;384;1197
351790;201510;1015;2923;875;2711;265;812;383;1230;648;2042
351800;201510;468;1022;311;801;38;102;169;429;207;531
351810;201510;1027;2882;928;2750;135;417;680;2020;815;2437
351820;201510;2257;7182;1725;6071;451;1667;153;497;604;2164
351830;201510;3955;12351;3068;10296;542;2050;1474;4642;2016;6692
351840;201510;7191;23698;6124;21562;1636;6245;2165;7343;3801;13588
351850;201510;1808;5068;1304;4147;191;766;596;1673;787;2439
351860;201510;3384;10724;2925;9745;774;2782;1168;3660;1942;6442
351870;201510;29658;88527;24966;79723;6767;22912;11135;34875;17902;57787
351880;201510;108805;342872;92095;307200;27083;95629;27254;87085;54337;182714
351885;201510;569;1999;525;1903;140;527;228;811;368;1338
351890;201510;673;2008;509;1656;119;439;108;299;227;738
351900;201510;1264;3799;1061;3463;286;996;326;1040;612;2036
351905;201510;460;1455;373;1288;57;237;198;629;255;866
351907;201510;16888;49942;13871;44257;1940;7333;8222;25169;10162;32502
351910;201510;964;2968;834;2703;175;646;384;1170;559;1816
351920;201510;1021;2802;884;2586;129;448;548;1546;677;1994
351925;201510;916;2814;765;2502;128;456;379;1154;507;1610
351930;201510;2652;8562;2491;8242;499;2048;1617;4955;2116;7003
351940;201510;944;2818;781;2487;176;603;340;1028;516;1631
351950;201510;1418;3874;1004;3094;143;474;525;1577;668;2051
351960;201510;3970;11364;2769;9091;625;2246;1084;3469;1709;5715
351970;201510;5287;19014;4636;17662;1392;5710;1595;5895;2987;11605
351980;201510;902;2686;679;2218;140;507;252;715;392;1222
351990;201510;1536;4321;1205;3672;269;954;254;636;523;1590
352000;201510;2198;7035;1963;6524;436;1560;907;2824;1343;4384
352010;201510;1766;5864;1515;5290;377;1446;343;1137;720;2583
352020;201510;1385;4303;1171;3897;278;1020;431;1333;709;2353
352030;201510;4858;14153;4009;12879;974;3244;2045;6611;3019;9855
352040;201510;1978;6503;1605;5657;354;1363;381;1232;735;2595
352042;201510;3126;8673;2020;6244;421;1422;929;2751;1350;4173
352044;201510;1304;4308;974;3543;193;764;156;496;349;1260
352050;201510;9175;27860;5839;20281;1360;5209;1090;3348;2450;8557
352060;201510;723;2102;591;1857;125;469;249;702;374;1171
352070;201510;771;1998;602;1705;154;456;214;591;368;1047
352080;201510;426;1207;301;956;57;199;118;339;175;538
352090;201510;1535;5050;1195;4257;239;955;236;734;475;1689
352100;201510;2551;7712;1849;6348;488;1864;608;1872;1096;3736
352110;201510;494;1725;416;1541;111;440;159;555;270;995
352115;201510;427;1342;361;1199;73;259;156;481;229;740
352120;201510;935;2854;782;2582;154;588;393;1222;547;1810
352130;201510;1836;5244;1227;3990;344;1179;302;877;646;2056
352140;201510;1765;5090;1015;3427;168;605;370;1182;538;1787
352150;201510;737;2247;568;1906;147;510;240;792;387;1302
352160;201510;1029;2820;805;2399;163;531;282;734;445;1265
352170;201510;2671;7989;2378;7395;480;1626;1239;3594;1719;5220
352180;201510;3371;9546;2802;8427;689;2255;996;2808;1685;5063
352190;201510;1133;3392;936;2985;178;672;337;889;515;1561
352200;201510;377;1319;303;1155;49;217;143;518;192;735
352210;201510;17021;45081;13345;39666;2540;7914;7516;22654;10056;30568
352215;201510;534;1674;493;1618;65;238;283;905;348;1143
352220;201510;12254;39533;10411;35607;3344;12331;3007;9952;6351;22283
352230;201510;12366;41205;10529;37644;3002;11737;3786;13015;6788;24752
352240;201510;11799;34280;8913;28982;2669;9703;2603;7596;5272;17299
352250;201510;22294;71372;19183;64797;5495;19904;6159;20402;11654;40306
352260;201510;5295;14925;3248;10635;638;2344;1109;3322;1747;5666
352265;201510;861;2741;734;2506;76;339;436;1382;512;1721
352270;201510;1897;6410;1558;5640;440;1695;394;1355;834;3050
352280;201510;2112;6407;1724;5720;453;1726;610;1897;1063;3623
352290;201510;1147;3578;971;3183;224;876;341;970;565;1846
352300;201510;945;2769;736;2378;178;621;303;906;481;1527
352310;201510;36615;109682;30186;98465;7753;26689;15657;50929;23410;77618
352320;201510;5650;17250;4799;15594;1349;4694;1492;4355;2841;9049
352330;201510;2011;6356;1698;5902;545;1988;484;1656;1029;3644
352340;201510;5695;18205;4241;15115;1135;4386;734;2341;1869;6727
352350;201510;1574;5364;1401;4986;280;1152;540;1785;820;2937
352360;201510;1124;3435;979;3143;195;784;590;1762;785;2546
352370;201510;825;2827;740;2623;134;540;354;1202;488;1742
352380;201510;981;3097;834;2825;272;1068;211;651;483;1719
352390;201510;17956;48572;11638;36215;2097;7510;5455;15648;7552;23158
352400;201510;3951;11025;2436;8025;673;2341;689;2075;1362;4416
352410;201510;2935;8770;2429;7904;636;2172;838;2622;1474;4794
352420;201510;936;2639;795;2364;210;680;355;997;565;1677
352430;201510;6381;19061;5208;17060;1758;6307;1500;4720;3258;11027
352440;201510;15711;47650;12430;41154;3115;10990;4354;13919;7469;24909
352450;201510;677;1956;437;1484;91;340;113;339;204;679
352460;201510;2371;7643;1957;6848;580;2234;504;1567;1084;3801
352470;201510;4217;11521;2441;7923;410;1463;774;2347;1184;3810
352480;201510;4613;12486;3522;10435;692;2371;1377;3699;2069;6070
352490;201510;718;2436;558;2023;96;399;127;409;223;808
352500;201510;8041;23613;7071;22100;3347;11265;1840;4992;5187;16257
352510;201510;3080;9773;2401;8415;733;2818;586;1963;1319;4781
352520;201510;2079;7220;1813;6567;465;1831;800;2808;1265;4639
352530;201510;7902;25177;5837;20463;1578;5884;830;2535;2408;8419
352540;201510;502;1531;369;1234;68;260;102;299;170;559
352550;201510;865;2857;586;2164;141;605;111;357;252;962
352560;201510;664;1954;468;1513;88;281;146;408;234;689
352570;201510;1790;5891;1325;4782;265;1107;269;841;534;1948
352580;201510;879;2525;739;2300;164;558;385;1168;549;1726
352585;201510;209;675;162;578;56;212;32;118;88;330
352590;201510;12454;37952;9722;32369;2483;8989;4196;13171;6679;22160
352600;201510;1567;4751;1370;4380;353;1242;593;1778;946;3020
352610;201510;3308;10030;2719;8991;808;2980;791;2392;1599;5372
352620;201510;5185;15850;4757;15189;1014;3499;2681;8331;3695;11830
352630;201510;613;1969;571;1859;127;494;241;712;368;1206
352640;201510;2793;8531;2247;7377;317;1187;1195;3788;1512;4975
352650;201510;829;2446;599;1942;133;453;173;517;306;970
352660;201510;1015;3424;780;2856;154;621;186;656;340;1277
352670;201510;10241;30810;6064;21355;1510;5742;683;2170;2193;7912
352680;201510;2917;9876;2189;8105;502;2058;596;1981;1098;4039
352690;201510;30101;82703;20443;62995;3715;12499;9463;27774;13178;40273
352700;201510;712;2124;573;1900;166;619;255;807;421;1426
352710;201510;5666;16487;4166;13419;994;3558;1462;4410;2456;7968
352720;201510;7485;24051;6615;22133;2005;6762;2198;7290;4203;14052
352725;201510;401;1122;239;783;35;142;92;271;127;413
352730;201510;2226;7338;1943;6579;396;1460;692;2041;1088;3501
352740;201510;1928;5380;1521;4684;253;933;879;2540;1132;3473
352750;201510;462;1317;241;799;41;151;60;168;101;319
352760;201510;1110;3795;954;3421;295;1119;359;1222;654;2341
352770;201510;728;2271;623;2058;141;520;262;821;403;1341
352780;201510;615;2009;500;1743;99;399;154;472;253;871
352790;201510;636;1824;457;1480;97;327;95;299;192;626
352800;201510;955;3398;683;2647;159;691;191;626;350;1317
352810;201510;1146;2988;736;2185;141;462;224;636;365;1098
352820;201510;588;1637;424;1374;110;406;104;323;214;729
352830;201510;520;1481;320;1022;50;186;49;112;99;298
352840;201510;3818;12880;3319;11775;1023;3814;1034;3573;2057;7387
352850;201510;8465;26274;7129;23892;1876;6766;2534;8237;4410;15003
352860;201510;809;2634;731;2453;174;619;267;836;441;1455
352870;201510;959;2393;697;1896;75;289;409;996;484;1285
352880;201510;2326;6541;1653;5133;328;1049;544;1563;872;2612
352885;201510;228;758;215;727;27;99;128;413;155;512
352890;201510;674;1786;487;1404;70;237;232;590;302;827
352900;201510;19345;56440;13756;44935;2910;10394;5038;15648;7948;26042
352910;201510;308;950;193;664;22;82;29;85;51;167
352920;201510;2431;7221;1910;6229;447;1648;762;2230;1209;3878
352930;201510;5656;17457;4327;14477;1134;4073;980;3058;2114;7131
352940;201510;23619;76680;19608;67201;6480;23690;2701;8582;9181;32272
352950;201510;282;807;178;613;45;179;40;112;85;291
352960;201510;612;1879;384;1338;68;271;56;175;124;446
352965;201510;292;876;229;732;54;186;38;97;92;283
352970;201510;2942;7426;2335;6502;301;887;1507;4225;1808;5112
352980;201510;1225;3666;1026;3365;236;762;559;1949;795;2711
352990;201510;4013;12704;3506;11809;978;3663;1334;4234;2312;7897
353000;201510;476;1309;257;796;38;122;47;124;85;246
353010;201510;2993;8333;2164;6687;524;1831;604;1610;1128;3441
353020;201510;4278;11582;2683;8077;384;1340;1029;2731;1413;4071
353030;201510;3945;11448;3196;10033;902;3067;727;2095;1629;5162
353040;201510;616;1708;515;1544;146;496;168;459;314;955
353050;201510;4894;16236;4043;14478;1160;4459;1463;4981;2623;9440
353060;201510;34797;106128;31974;101529;3790;14442;22988;70080;26778;84522
353070;201510;9393;29964;6774;24125;1825;6891;1677;5954;3502;12845
353080;201510;5249;16533;3476;12461;765;3018;796;2568;1561;5586
353090;201510;518;1707;464;1590;46;189;263;829;309;1018
353100;201510;248;665;121;387;25;85;25;70;50;155
353110;201510;7664;23175;6457;21080;1613;5566;3271;10745;4884;16311
353120;201510;707;2094;439;1464;95;369;116;326;211;695
353130;201510;2513;7242;2027;6451;659;2256;644;1965;1303;4221
353140;201510;2341;6320;1760;5162;439;1404;712;1923;1151;3327
353150;201510;1694;5113;1364;4515;384;1345;373;1230;757;2575
353160;201510;680;1910;426;1348;94;319;68;144;162;463
353170;201510;468;1536;420;1455;115;514;186;576;301;1090
353180;201510;7799;22325;6034;19032;1077;3752;3054;9297;4131;13049
353190;201510;3583;10881;2931;9449;550;2008;1435;4274;1985;6282
353200;201510;918;3067;733;2629;219;864;192;639;411;1503
353205;201510;404;1288;350;1181;78;275;136;450;214;725
353210;201510;974;2496;728;2061;41;161;478;1307;519;1468
353215;201510;411;1295;361;1184;59;224;136;393;195;617
353220;201510;672;2067;530;1742;132;473;130;371;262;844
353230;201510;849;2696;759;2522;195;732;208;614;403;1346
353240;201510;2004;6374;1788;5943;411;1560;918;2868;1329;4428
353250;201510;1060;2842;817;2402;127;395;403;1151;530;1546
353260;201510;939;2544;677;2073;115;397;269;773;384;1170
353270;201510;629;1862;539;1685;148;501;185;538;333;1039
353280;201510;579;1858;474;1627;117;443;115;374;232;817
353282;201510;1654;5278;1546;5074;213;799;989;3104;1202;3903
353284;201510;341;921;198;620;36;111;50;158;86;269
353286;201510;144;428;100;328;16;47;16;56;32;103
353290;201510;554;1751;438;1538;86;361;234;767;320;1128
353300;201510;1438;4448;1186;3879;283;1059;432;1251;715;2310
353310;201510;203;602;171;539;48;171;66;183;114;354
353320;201510;526;1511;461;1399;80;269;250;727;330;996
353325;201510;585;1906;482;1693;94;369;89;249;183;618
353330;201510;624;1782;409;1275;78;281;187;534;265;815
353340;201510;2919;8231;1858;6153;512;1803;550;1719;1062;3522
353350;201510;3210;9513;2592;8339;777;2676;1001;3025;1778;5701
353360;201510;380;1221;332;1116;46;186;207;665;253;851
353370;201510;643;2076;548;1842;73;286;309;988;382;1274
353380;201510;331;1062;267;928;48;203;99;300;147;503
353390;201510;5886;15832;4069;12497;792;2681;1463;4117;2255;6798
353400;201510;495;1466;407;1284;105;372;108;272;213;644
353410;201510;605;1734;485;1530;99;341;264;820;363;1161
353420;201510;584;1612;405;1207;113;335;125;342;238;677
353430;201510;2210;7530;1583;5827;377;1469;197;640;574;2109
353440;201510;57988;183989;48243;161506;13169;46196;16481;53056;29650;99252
353450;201510;431;1288;355;1131;77;279;138;411;215;690
353460;201510;3494;9762;2960;8852;471;1556;1413;4265;1884;5821
353470;201510;9059;26965;6346;21323;1396;5199;1476;4489;2872;9688
353475;201510;1649;4595;1098;3397;209;682;318;881;527;1563
353480;201510;1411;4198;1245;3878;224;754;714;2166;938;2920
353490;201510;979;2740;775;2339;167;549;283;785;450;1334
353500;201510;993;2645;811;2325;266;766;332;942;598;1708
353510;201510;1025;3206;765;2556;170;623;183;520;353;1143
353520;201510;1105;3183;840;2717;163;610;333;1035;496;1645
353530;201510;2548;7515;2205;6867;396;1442;1147;3413;1543;4855
353540;201510;1900;5741;1633;5282;415;1428;669;2090;1084;3518
353550;201510;5939;16264;5063;14897;600;2115;3185;8903;3785;11018
353560;201510;2082;6862;1703;6152;434;1772;452;1495;886;3267
353570;201510;418;1281;350;1141;61;208;204;634;265;842
353580;201510;2201;6796;1998;6452;376;1400;1255;3955;1631;5355
353590;201510;721;2058;533;1689;153;520;160;503;313;1023
353600;201510;1677;4648;1497;4337;234;754;783;2190;1017;2944
353610;201510;571;1894;425;1573;79;360;89;273;168;633
353620;201510;2136;6918;1778;6177;478;1781;541;1727;1019;3508
353625;201510;303;826;189;613;42;146;49;158;91;304
353630;201510;1613;5519;1222;4495;225;891;149;445;374;1336
353640;201510;1354;3933;1076;3335;150;490;564;1692;714;2182
353650;201510;7136;21122;5213;17010;1054;3584;1811;5691;2865;9275
353657;201510;304;958;267;881;50;186;89;274;139;460
353660;201510;1173;2975;838;2408;318;982;134;266;452;1248
353670;201510;3686;11742;3077;10378;951;3618;977;2922;1928;6540
353680;201510;673;2203;580;2029;226;869;195;626;421;1495
353690;201510;530;1413;294;947;52;188;88;226;140;414
353700;201510;2122;6509;1800;5840;335;1179;717;2205;1052;3384
353710;201510;2991;7237;1342;4427;310;1047;262;826;572;1873
353715;201510;459;1308;313;993;28;109;84;242;112;351
353720;201510;1999;6213;1708;5727;339;1320;879;2777;1218;4097
353730;201510;4414;13296;3354;10974;704;2507;944;2788;1648;5295
353740;201510;1988;5870;1517;4908;422;1438;412;1263;834;2701
353750;201510;815;2699;612;2205;125;509;165;583;290;1092
353760;201510;9467;26696;7546;23617;1489;5194;4035;12332;5524;17526
353770;201510;814;2457;452;1548;71;237;29;50;100;287
353780;201510;4269;14510;3629;13188;1203;4647;973;3446;2176;8093
353790;201510;1956;6669;1586;5873;430;1805;304;1094;734;2899
353800;201510;15611;47918;12031;41092;3210;11880;4077;13484;7287;25364
353810;201510;1057;3291;794;2712;167;644;263;851;430;1495
353820;201510;1239;4177;1112;3875;248;1019;569;1795;817;2814
353830;201510;671;1805;520;1549;102;336;252;738;354;1074
353850;201510;1646;5153;1440;4744;309;1065;629;2014;938;3079
353860;201510;2464;8172;2028;7154;531;2018;546;1822;1077;3840
353870;201510;27116;78455;18085;60300;3867;14129;5203;15573;9070;29702
353880;201510;2459;7724;2033;6945;286;1168;1093;3646;1379;4814
353890;201510;2756;6740;1866;5277;343;1054;881;2320;1224;3374
353900;201510;1033;3187;744;2566;159;615;205;654;364;1269
353910;201510;1233;4403;1190;4310;341;1292;669;2386;1010;3678
353920;201510;2263;6669;1517;5009;326;1167;253;730;579;1897
353930;201510;4482;13470;2952;10497;754;2890;624;2163;1378;5053
353940;201510;1203;3775;929;3151;161;602;359;1123;520;1725
353950;201510;3359;10589;2986;9865;460;1742;1806;5720;2266;7462
353960;201510;595;1857;449;1529;92;337;100;269;192;606
353970;201510;551;1590;478;1491;48;166;339;1051;387;1217
353980;201510;12451;37491;10638;33920;2367;8082;5213;16063;7580;24145
353990;201510;347;1073;309;993;52;204;145;432;197;636
354000;201510;2084;5961;1335;4372;255;895;134;386;389;1281
354010;201510;353;1059;296;969;74;246;159;535;233;781
354020;201510;4431;13678;3832;12309;1013;3494;1351;3969;2364;7463
354025;201510;886;2457;633;1982;132;443;193;568;325;1011
354030;201510;510;1398;351;1109;56;208;161;467;217;675
354040;201510;766;2054;541;1620;59;210;283;765;342;975
354050;201510;948;3015;794;2698;220;825;223;703;443;1528
354060;201510;5069;15516;3439;11850;833;3080;998;3250;1831;6330
354070;201510;2822;9262;2379;8242;598;2226;484;1576;1082;3802
354075;201510;1933;7233;1815;6989;473;2023;798;3010;1271;5033
354080;201510;1568;4781;1062;3584;219;774;244;722;463;1496
354085;201510;310;791;275;740;17;60;222;585;239;645
354090;201510;1299;3807;1224;3682;127;424;879;2664;1006;3088
354100;201510;14864;49407;12150;43926;3099;11947;5183;18343;8282;30290
354105;201510;894;2730;780;2512;129;474;461;1431;590;1905
354110;201510;757;2072;599;1845;201;704;137;329;338;1033
354120;201510;1972;5377;1503;4488;270;893;637;1745;907;2638
354130;201510;6055;17471;4604;14559;1748;5852;650;1697;2398;7549
354140;201510;25369;63860;15237;45208;3193;10168;4791;13025;7984;23193
354150;201510;3983;10695;2987;8872;532;1765;1416;4011;1948;5776
354160;201510;3357;10812;2742;9366;734;2726;1050;3395;1784;6121
354165;201510;357;1299;306;1175;87;369;103;374;190;743
354170;201510;1393;4269;1081;3560;205;774;409;1183;614;1957
354180;201510;465;1361;412;1247;57;207;233;630;290;837
354190;201510;1504;4772;1225;4156;345;1299;387;1220;732;2519
354200;201510;1042;2954;829;2560;134;475;346;970;480;1445
354210;201510;660;2153;569;1979;86;368;298;957;384;1325
354220;201510;2868;8401;2433;7572;581;1977;1085;3260;1666;5237
354230;201510;630;2057;565;1930;105;401;243;791;348;1192
354240;201510;1191;3840;864;3064;146;580;188;600;334;1180
354250;201510;677;1945;451;1540;163;611;118;396;281;1007
354260;201510;7985;23330;6567;20879;1851;6357;2151;6669;4002;13026
354270;201510;1124;3829;940;3377;217;879;326;1097;543;1976
354280;201510;674;2039;618;1938;82;316;434;1299;516;1615
354290;201510;972;3272;870;3070;206;813;367;1272;573;2085
354300;201510;3395;11240;3261;10973;878;3055;1554;5133;2432;8188
354310;201510;880;2698;670;2265;153;558;269;888;422;1446
354320;201510;748;2196;617;1942;146;535;209;576;355;1111
354323;201510;417;1173;318;992;73;251;101;274;174;525
354325;201510;1212;4009;1014;3510;195;778;386;1231;581;2009
354330;201510;6540;19666;5307;17171;1104;3981;2519;7635;3623;11616
354340;201510;24587;75791;19666;66757;6063;22261;6757;22069;12820;44330
354350;201510;1076;3155;992;2995;291;975;472;1307;763;2282
354360;201510;469;1487;306;1099;48;180;24;86;72;266
354370;201510;1196;3958;1035;3627;125;536;617;2078;742;2614
354380;201510;925;2713;730;2360;217;829;128;320;345;1149
354390;201510;12332;37058;8430;28962;1831;6821;1819;5930;3650;12751
354400;201510;1582;5399;1248;4591;267;1094;356;1229;623;2323
354410;201510;5322;16220;4343;14398;1041;3664;1911;6257;2952;9921
354420;201510;1148;3414;856;2724;210;739;322;937;532;1676
354425;201510;2513;7038;2088;6251;648;2069;487;1360;1135;3429
354430;201510;1263;4098;1151;3862;252;961;500;1615;752;2576
354440;201510;514;1518;387;1256;50;191;178;538;228;729
354450;201510;423;1197;237;787;34;140;48;126;82;266
354460;201510;870;2388;642;1998;181;614;261;786;442;1400
354470;201510;560;1550;435;1291;49;189;218;573;267;762
354480;201510;679;1888;572;1718;92;319;329;944;421;1263
354490;201510;725;2378;539;1922;99;379;171;562;270;941
354500;201510;2027;6740;1768;6249;666;2696;286;888;952;3584
354510;201510;703;2015;630;1886;104;307;397;1213;501;1520
354515;201510;304;1007;227;821;41;176;78;253;119;429
354520;201510;6956;22477;3940;13741;791;3113;1532;4956;2323;8069
354530;201510;2848;9822;2526;9101;665;2622;1069;3728;1734;6350
354540;201510;1232;3720;1005;3302;354;1284;158;451;512;1735
354550;201510;458;1366;382;1204;70;237;193;581;263;818
354560;201510;1585;4531;1041;3305;206;642;397;1194;603;1836
354570;201510;806;2358;520;1674;93;313;81;226;174;539
354580;201510;9885;28480;7512;23818;1481;5102;3151;9426;4632;14528
354600;201510;1529;5031;1332;4632;301;1256;637;2069;938;3325
354610;201510;381;1102;221;716;30;84;47;141;77;225
354620;201510;386;1258;304;1111;79;354;135;458;214;812
354625;201510;276;890;200;713;39;145;55;184;94;329
354630;201510;2019;6785;1777;6241;717;2600;328;1073;1045;3673
354640;201510;3576;11613;2769;9788;610;2447;612;1935;1222;4382
354650;201510;903;2695;797;2489;101;349;516;1564;617;1913
354660;201510;2438;7077;1875;6063;326;1187;991;3143;1317;4330
354670;201510;1566;5057;1248;4268;319;1190;289;845;608;2035
354680;201510;4409;14414;3928;13394;1042;3837;1632;5399;2674;9236
354690;201510;775;2479;491;1740;93;336;145;485;238;821
354700;201510;1227;3436;804;2523;152;564;330;885;482;1449
354710;201510;540;1608;433;1368;63;221;190;534;253;755
354720;201510;211;574;146;444;51;147;40;123;91;270
354730;201510;7702;25184;5891;21285;1423;5612;2354;8160;3777;13772
354740;201510;240;739;142;508;25;102;29;96;54;198
354750;201510;2441;7354;1835;6230;520;1977;647;2090;1167;4067
354760;201510;1950;6183;1541;5277;452;1677;252;804;704;2481
354765;201510;231;640;136;440;12;46;16;38;28;84
354770;201510;2250;6237;1716;5323;634;2080;452;1318;1086;3398
354780;201510;45423;129194;38982;115093;7216;23909;20605;56945;27821;80854
354790;201510;793;2514;665;2279;130;505;328;1053;458;1558
354800;201510;1993;5848;1748;5500;442;1549;863;2661;1305;4210
354805;201510;941;2819;660;2188;64;226;141;432;205;658
354810;201510;589;1899;361;1308;59;257;71;194;130;451
354820;201510;968;3296;816;2964;175;757;234;750;409;1507
354830;201510;391;1094;293;914;75;247;136;382;211;629
354840;201510;655;1868;525;1631;114;384;253;762;367;1146
354850;201510;16588;51137;12144;41881;2753;10602;4609;14425;7362;25027
354860;201510;1359;4241;1146;3864;236;911;463;1461;699;2372
354870;201510;41697;125877;37087;116012;9098;30245;16044;49013;25142;79258
354880;201510;4106;11303;2314;7516;386;1462;666;1757;1052;3219
354890;201510;15903;46436;12909;40766;3228;10936;4566;13866;7794;24802
354900;201510;438;1280;322;1033;75;260;90;273;165;533
354910;201510;6526;19406;3580;12783;617;2433;220;710;837;3143
354920;201510;435;1267;296;988;62;238;74;233;136;471
354925;201510;347;1000;204;696;29;115;28;77;57;192
354930;201510;216;571;159;477;39;124;75;215;114;339
354940;201510;2030;7121;1568;5892;568;2277;197;674;765;2951
354950;201510;1475;4679;1264;4332;140;583;735;2439;875;3022
354960;201510;760;2366;656;2194;137;525;276;886;413;1411
354970;201510;4032;13047;3477;11888;633;2501;1864;6107;2497;8608
354980;201510;33356;82555;19623;59364;3766;12757;6707;18820;10473;31577
354990;201510;46882;139699;37064;119675;7062;24742;18061;56169;25123;80911
354995;201510;1719;5203;1489;4843;351;1190;774;2503;1125;3693
355000;201510;1455;4649;1257;4283;396;1548;249;717;645;2265
355010;201510;3537;10760;2763;9056;725;2525;1027;3371;1752;5896
355020;201510;2844;9514;2185;8115;897;3625;472;1657;1369;5282
355030;201510;992143;2774654;844558;2479201;197214;627397;369488;1037109;566702;1664506
355040;201510;2594;7911;2269;7340;567;1992;1180;3715;1747;5707
355050;201510;1128;3462;898;2998;296;1024;139;462;435;1486
355060;201510;4845;16167;3852;13995;913;3732;999;3258;1912;6990
355070;201510;6485;19935;5718;18666;1212;4569;2988;9128;4200;13697
355080;201510;1088;3701;781;2951;139;624;105;299;244;923
355090;201510;1135;3888;921;3394;179;710;372;1340;551;2050
355100;201510;18873;58252;15698;52877;4396;16277;6838;22393;11234;38670
355110;201510;1260;4093;1070;3701;310;1176;285;943;595;2119
355120;201510;602;1896;499;1682;111;449;181;544;292;993
355130;201510;600;1516;291;843;54;160;103;265;157;425
355140;201510;1090;3599;1021;3479;229;871;545;1876;774;2747
355150;201510;3283;9593;2731;8678;613;2054;1401;4454;2014;6508
355160;201510;1593;5052;1348;4668;446;1763;418;1321;864;3084
355170;201510;9455;25836;6657;20944;2030;6851;1597;5073;3627;11924
355180;201510;2848;8716;2319;7707;607;2392;743;2179;1350;4571
355190;201510;1253;4202;1052;3756;374;1438;345;1167;719;2605
355200;201510;735;2623;673;2489;279;1114;142;485;421;1599
355210;201510;2445;7844;2130;7166;429;1649;1055;3352;1484;5001
355220;201510;31094;94751;25069;82536;8507;29490;6207;19316;14714;48806
355230;201510;1391;3867;746;2423;132;441;181;523;313;964
355240;201510;26201;74753;17921;57718;3893;13582;6195;18865;10088;32447
355250;201510;24633;79557;21277;73029;6045;22192;8626;28967;14671;51159
355255;201510;810;2235;542;1665;98;319;147;413;245;732
355260;201510;1405;3958;1185;3576;275;955;492;1305;767;2260
355270;201510;1503;4449;1431;4342;106;399;1185;3531;1291;3930
355280;201510;23630;68975;19209;60217;3804;13406;8414;24911;12218;38317
355290;201510;867;2720;708;2347;141;505;272;814;413;1319
355300;201510;1103;3577;898;3136;185;705;319;1033;504;1738
355310;201510;986;2989;812;2635;144;505;411;1323;555;1828
355320;201510;607;1854;514;1643;82;325;207;551;289;876
355330;201510;1759;5440;1227;4346;272;1080;459;1546;731;2626
355340;201510;2469;6481;2214;6040;391;1113;1315;3498;1706;4611
355350;201510;1311;4426;1063;3845;264;1064;313;1037;577;2101
355360;201510;1077;3447;977;3248;158;542;666;2279;824;2821
355365;201510;237;750;184;643;40;168;53;172;93;340
355370;201510;7582;18560;5397;15810;1468;4647;2177;6606;3645;11253
355380;201510;3332;10023;2526;8152;585;2086;534;1403;1119;3489
355385;201510;841;2642;777;2544;292;1033;213;620;505;1653
355390;201510;848;2360;638;1941;135;462;267;698;402;1160
355395;201510;1880;5621;1385;4482;224;782;572;1699;796;2481
355400;201510;8712;28503;7429;25801;2234;8387;2262;7462;4496;15849
355410;201510;15364;51019;12370;44710;4009;15779;2540;9104;6549;24883
355420;201510;762;2651;695;2505;223;892;195;675;418;1567
355430;201510;3508;9810;2892;8715;562;1866;1492;4309;2054;6175
355440;201510;920;2845;692;2319;123;437;205;614;328;1051
355450;201510;3590;10261;1991;6594;380;1303;607;1858;987;3161
355460;201510;637;1719;431;1338;79;308;130;309;209;617
355465;201510;373;1155;307;1027;66;237;76;242;142;479
355470;201510;773;2402;634;2133;139;518;285;907;424;1425
355475;201510;143;508;129;469;28;106;66;234;94;340
355480;201510;2900;10204;2655;9709;714;2778;1208;4313;1922;7091
355490;201510;964;2753;623;2042;112;379;131;399;243;778
355495;201510;690;2290;608;2111;122;467;226;741;348;1208
355500;201510;7806;22269;4864;15798;827;2966;972;2800;1799;5766
355510;201510;2041;5419;1157;3609;175;657;363;987;538;1644
355520;201510;451;1087;244;678;34;122;103;252;137;374
355530;201510;388;918;156;485;19;68;29;77;48;145
355535;201510;667;2033;516;1730;153;588;120;320;273;908
355540;201510;8176;25755;7628;24811;1958;6773;3915;12338;5873;19111
355550;201510;749;2235;634;2054;141;544;291;900;432;1444
355560;201510;1272;3756;812;2707;154;599;127;296;281;895
355570;201510;198;606;131;450;18;68;21;58;39;126
355580;201510;1200;3286;832;2559;163;585;319;946;482;1531
355590;201510;223;585;180;501;25;73;103;282;128;355
355600;201510;1106;3400;912;2992;308;1090;250;770;558;1860
355610;201510;1401;3887;1176;3516;226;756;548;1561;774;2317
355620;201510;4010;12482;3140;10509;561;2144;1387;4284;1948;6428
355630;201510;3241;9235;1940;6517;379;1374;488;1538;867;2912
355635;201510;914;2969;781;2743;95;393;526;1840;621;2233
355640;201510;3031;9618;2186;7772;392;1561;305;956;697;2517
355645;201510;3144;10814;2818;10240;470;1896;1667;6017;2137;7913
355650;201510;6389;19335;5389;17405;832;3127;3232;9795;4064;12922
355660;201510;1215;3812;958;3276;195;815;384;1211;579;2026
355670;201510;2502;7768;1729;5950;333;1343;702;2124;1035;3467
355680;201510;1599;5230;1134;4060;336;1308;221;708;557;2016
355690;201510;406;1268;295;1074;185;723;25;65;210;788
355695;201510;307;937;175;576;13;40;18;34;31;74
355700;201510;5390;17812;4503;15751;1142;4218;1727;5769;2869;9987
355710;201510;10736;26395;6255;18161;1563;4851;1559;4181;3122;9032
355715;201510;263;781;162;551;36;130;31;92;67;222
355720;201510;1503;4935;1224;4288;332;1263;356;1096;688;2359
355730;201510;780;2577;640;2253;211;757;145;508;356;1265
410010;201510;1454;4486;1240;4031;267;938;294;924;561;1862
410020;201510;1183;3854;1025;3503;282;1023;394;1316;676;2339
410030;201510;1135;3847;923;3294;219;852;154;527;373;1379
410040;201510;9903;32326;8576;29668;2265;8771;2517;8345;4782;17116
410045;201510;976;2761;661;2133;157;543;160;475;317;1018
410050;201510;2449;6771;1488;4797;384;1309;133;349;517;1658
410060;201510;2204;6781;1932;6256;472;1644;805;2616;1277;4260
410070;201510;1728;4834;1306;4005;406;1358;283;771;689;2129
410080;201510;1279;3749;1028;3269;177;632;447;1319;624;1951
410090;201510;1012;3180;916;2971;233;837;303;943;536;1780
410100;201510;2623;8002;1867;6218;446;1640;196;591;642;2231
410105;201510;394;1224;248;867;46;191;36;102;82;293
410110;201510;2539;7484;2010;6418;342;1209;640;1985;982;3194
410115;201510;522;1421;400;1185;52;170;157;424;209;594
410120;201510;2416;8264;2230;7923;694;2649;907;3200;1601;5849
410130;201510;1075;3437;968;3174;369;1253;238;736;607;1989
410140;201510;16618;43553;10821;32897;2357;7894;2947;8545;5304;16439
410150;201510;17709;44047;8565;25605;1709;5543;1407;3689;3116;9232
410160;201510;2920;8944;2610;8409;702;2513;933;3004;1635;5517
410165;201510;745;2154;593;1825;138;442;239;681;377;1123
410170;201510;2152;6244;1670;5192;474;1650;321;932;795;2582
410180;201510;9826;31249;8308;27804;2096;7602;3024;9394;5120;16996
410185;201510;565;1555;444;1329;105;324;127;331;232;655
410190;201510;2027;5957;1558;4863;328;1123;291;809;619;1932
410200;201510;3857;10749;2735;8473;608;2080;338;942;946;3022
410210;201510;2524;7450;1838;5943;314;1196;414;1100;728;2296
410220;201510;639;1791;455;1422;82;306;133;380;215;686
410230;201510;1394;4356;1193;3967;314;1197;461;1440;775;2637
410240;201510;4332;13094;3871;12126;1130;4062;940;2759;2070;6821
410250;201510;2559;7091;1756;5414;444;1486;319;877;763;2363
410260;201510;1552;4684;1300;4197;318;1112;491;1527;809;2639
410270;201510;541;1512;400;1221;64;219;149;417;213;636
410275;201510;875;2614;601;2008;86;314;279;918;365;1232
410280;201510;2291;6637;1668;5335;359;1336;468;1386;827;2722
410290;201510;3417;10215;2860;9125;690;2332;1136;3633;1826;5965
410300;201510;680;1913;576;1695;91;294;249;660;340;954
410302;201510;372;998;247;792;31;105;142;460;173;565
410304;201510;1228;3923;1100;3644;304;1049;428;1455;732;2504
410305;201510;1892;4992;1533;4415;375;1177;802;2309;1177;3486
410310;201510;2205;7126;1974;6692;434;1647;757;2541;1191;4188
410315;201510;634;1833;384;1310;71;250;109;343;180;593
410320;201510;1193;3593;695;2382;94;373;59;179;153;552
410322;201510;546;1598;339;1122;68;230;87;263;155;493
410330;201510;1381;3754;1123;3261;250;777;316;885;566;1662
410335;201510;965;2831;823;2568;164;540;311;918;475;1458
410337;201510;802;2101;579;1671;80;285;225;565;305;850
410340;201510;490;1451;323;998;44;155;131;359;175;514
410345;201510;1680;4796;1157;3673;264;885;332;1005;596;1890
410347;201510;714;1936;467;1464;69;256;149;446;218;702
410350;201510;990;2977;693;2353;148;550;105;308;253;858
410360;201510;3438;9593;2739;8352;474;1649;1244;3641;1718;5290
410370;201510;12075;34771;8470;26380;1620;5714;2404;6474;4024;12188
410380;201510;1221;3642;1072;3316;154;570;546;1602;700;2172
410390;201510;2661;7681;2029;6423;630;2145;520;1470;1150;3615
410395;201510;880;2896;771;2663;194;767;326;1092;520;1859
410400;201510;4320;13366;3627;11994;815;3064;1327;4152;2142;7216
410405;201510;923;2663;723;2266;167;591;255;785;422;1376
410410;201510;1255;4001;1195;3909;357;1387;472;1407;829;2794
410420;201510;7131;22886;5779;19718;1513;5547;947;2779;2460;8326
410425;201510;3132;9812;2156;7551;386;1442;234;739;620;2181
410430;201510;14527;39013;10331;31051;2135;7043;3079;8816;5214;15859
410440;201510;2933;9270;2590;8591;697;2572;1044;3318;1741;5890
410442;201510;2676;8913;2334;8113;723;2608;657;2271;1380;4879
410445;201510;2294;7559;1973;6938;517;2060;624;2211;1141;4271
410450;201510;2184;6155;1642;5073;458;1483;189;475;647;1958
410460;201510;2057;6025;1604;5090;407;1360;430;1265;837;2625
410465;201510;1921;6385;1575;5613;366;1429;575;1901;941;3330
410470;201510;1631;5247;1303;4483;290;1149;330;1096;620;2245
410480;201510;29359;83000;18856;60363;4209;14426;2757;7595;6966;22021
410490;201510;10670;33493;8052;27723;1998;7673;2001;6208;3999;13881
410500;201510;1548;4815;1243;4131;448;1651;290;919;738;2570
410510;201510;2475;6543;1723;5006;320;968;666;1746;986;2714
410520;201510;3124;10797;2928;10377;887;3368;1084;3838;1971;7206
410530;201510;1636;4488;1185;3534;223;756;383;1022;606;1778
410540;201510;3048;8947;2056;6804;444;1535;614;1955;1058;3490
410550;201510;6339;18123;4153;13254;790;2813;630;1748;1420;4561
410560;201510;1211;3600;914;2947;218;813;265;708;483;1521
410570;201510;2625;8291;2325;7749;642;2338;793;2834;1435;5172
410580;201510;21860;66182;17565;57364;4540;16425;4896;14645;9436;31070
410590;201510;1330;4151;780;2620;114;384;152;455;266;839
410600;201510;1834;5337;1454;4572;348;1104;553;1730;901;2834
410610;201510;757;2157;586;1813;87;300;213;632;300;932
410620;201510;1640;5638;1194;4471;337;1363;133;473;470;1836
410630;201510;2493;7296;1769;5671;433;1503;298;783;731;2286
410640;201510;4315;11959;3137;9665;816;2907;540;1517;1356;4424
410645;201510;1140;3957;1079;3865;496;1914;253;900;749;2814
410650;201510;2239;6826;1749;5763;566;1970;272;800;838;2770
410655;201510;834;2401;640;2015;132;486;210;627;342;1113
410657;201510;716;2001;486;1509;87;313;179;479;266;792
410660;201510;2546;7392;1447;4832;309;1111;164;468;473;1579
410670;201510;940;2572;624;1895;116;384;186;494;302;878
410680;201510;2758;9124;2215;7764;636;2178;679;2540;1315;4718
410685;201510;632;1812;549;1671;48;151;389;1197;437;1348
410690;201510;115433;332421;77555;251451;16943;60217;16142;45776;33085;105993
410700;201510;2243;6821;2039;6420;545;1867;838;2495;1383;4362
410710;201510;905;2680;611;2000;140;492;162;450;302;942
410712;201510;816;2466;687;2214;236;818;188;624;424;1442
410715;201510;974;3017;729;2441;140;518;247;747;387;1265
410720;201510;3310;9724;2363;7696;510;1888;536;1565;1046;3453
410725;201510;1041;2952;708;2268;111;344;109;303;220;647
410730;201510;514;1416;412;1243;125;418;106;322;231;740
410740;201510;893;2648;621;2081;102;393;268;887;370;1280
410750;201510;1805;5247;1452;4480;307;1040;461;1318;768;2358
410752;201510;296;822;166;545;34;136;58;158;92;294
410753;201510;430;1237;261;839;35;130;89;253;124;383
410754;201510;1040;3153;886;2885;75;250;575;1943;650;2193
410755;201510;803;2028;619;1732;91;292;341;916;432;1208
410760;201510;2280;6924;1969;6340;546;1938;575;1776;1121;3714
410765;201510;15634;46225;10996;36694;1965;7355;1062;3149;3027;10504
410770;201510;922;2545;671;2040;194;657;131;355;325;1012
410773;201510;1299;3726;1096;3404;212;754;599;1788;811;2542
410775;201510;1504;4262;1395;4101;328;1067;578;1631;906;2698
410780;201510;517;1433;356;1126;90;286;122;436;212;722
410785;201510;719;2299;579;1948;213;765;128;417;341;1182
410790;201510;388;1235;326;1079;64;232;56;125;120;357
410800;201510;2821;6974;2123;5812;415;1313;796;1971;1211;3284
410810;201510;328;1005;262;859;50;187;103;338;153;525
410820;201510;859;2559;637;2039;159;560;106;294;265;854
410830;201510;31548;89846;24824;77793;7218;25083;8007;23894;15225;48977
410832;201510;994;2898;858;2629;103;389;478;1370;581;1759
410840;201510;6780;19916;4229;14219;951;3440;366;1000;1317;4440
410845;201510;1264;3708;1058;3277;204;712;442;1291;646;2003
410850;201510;2758;7997;2430;7479;531;1844;1080;3317;1611;5161
410855;201510;594;1627;425;1264;82;267;156;415;238;682
410860;201510;3765;10509;2944;8919;550;1776;1083;3173;1633;4949
410865;201510;1519;5195;1436;5030;396;1530;755;2669;1151;4199
410870;201510;1152;3536;1065;3398;323;1103;552;1744;875;2847
410880;201510;3967;12141;3125;10466;673;2473;627;1919;1300;4392
410890;201510;940;3035;724;2564;173;696;71;216;244;912
410895;201510;1102;3801;965;3468;325;1255;224;746;549;2001
410900;201510;879;2417;619;1948;107;401;204;578;311;979
410910;201510;406;1078;335;957;45;147;189;526;234;673
410920;201510;825;2298;646;1973;163;566;230;670;393;1236
410930;201510;1744;5099;1470;4572;353;1304;528;1576;881;2880
410940;201510;20510;66047;17338;59985;5194;19525;4742;16456;9936;35981
410950;201510;1726;5685;1596;5436;258;923;1048;3578;1306;4501
410960;201510;7159;19695;4447;14467;1335;4730;919;2770;2254;7500
410965;201510;1051;3166;893;2864;253;865;373;1156;626;2021
410970;201510;4470;13199;3454;11147;974;3624;670;2037;1644;5661
410975;201510;1594;4558;1253;3901;226;829;461;1365;687;2194
410980;201510;5807;16235;3436;11305;690;2515;542;1667;1232;4182
410990;201510;894;2563;532;1741;168;618;73;164;241;782
411000;201510;475;1427;345;1130;69;257;68;178;137;435
411005;201510;500;1469;299;971;76;268;33;84;109;352
411007;201510;2252;7060;1913;6295;556;1945;586;1853;1142;3798
411010;201510;3863;13131;3385;11987;876;3470;541;1703;1417;5173
411020;201510;2501;7715;2191;7182;684;2512;680;2139;1364;4651
411030;201510;677;1826;485;1439;93;313;131;339;224;652
411040;201510;628;1827;296;976;49;180;72;240;121;420
411050;201510;2086;7214;1833;6632;515;2065;281;884;796;2949
411060;201510;1546;4705;1239;4023;248;901;181;508;429;1409
411065;201510;362;1074;274;894;53;180;91;284;144;464
411070;201510;5690;17009;4220;13923;1163;4231;780;2282;1943;6513
411080;201510;2155;6435;1891;5929;496;1779;488;1400;984;3179
411090;201510;795;1945;555;1574;75;269;126;322;201;591
411095;201510;1421;4084;1053;3276;175;640;267;715;442;1355
411100;201510;1353;3929;958;3099;159;619;154;418;313;1037
411110;201510;567;1671;306;1036;38;143;38;96;76;239
411120;201510;1649;4913;1198;3909;307;1126;379;1133;686;2259
411125;201510;4193;13639;3957;13137;1149;4052;1531;4939;2680;8991
411130;201510;709;2094;526;1686;124;420;151;506;275;926
411140;201510;2094;7316;1774;6539;559;2149;545;2069;1104;4218
411150;201510;4388;12152;3304;9916;765;2538;593;1450;1358;3988
411155;201510;952;2586;714;2116;117;409;330;906;447;1315
411160;201510;222;643;180;558;39;131;44;116;83;247
411170;201510;661;2105;544;1828;131;495;181;572;312;1067
411180;201510;5608;16700;4529;14622;1065;3829;1491;4710;2556;8539
411190;201510;1474;4190;1193;3624;295;1034;319;829;614;1863
411200;201510;4241;12462;3363;10908;843;3088;1124;3444;1967;6532
411210;201510;2042;5850;1567;4924;450;1532;199;560;649;2092
411220;201510;1160;3275;896;2752;223;802;323;855;546;1657
411230;201510;1241;3428;767;2452;181;623;213;612;394;1235
411240;201510;1357;3268;715;2142;133;402;217;600;350;1002
411250;201510;2301;6697;1875;5898;513;1773;494;1490;1007;3263
411260;201510;304;840;204;661;29;104;80;242;109;346
411270;201510;1768;5529;1550;5103;300;1142;700;2184;1000;3326
411275;201510;1364;4041;1110;3449;277;914;250;703;527;1617
411280;201510;1500;4402;1031;3370;180;657;203;594;383;1251
411290;201510;782;2240;588;1804;152;499;177;501;329;1000
411295;201510;963;2712;859;2501;162;494;335;1004;497;1498
411300;201510;1336;3389;925;2583;103;324;362;922;465;1246
411310;201510;847;2328;655;1992;82;291;216;647;298;938
411320;201510;5579;16080;4009;12936;1041;3547;752;2197;1793;5744
411325;201510;1523;4769;1322;4345;282;997;679;2216;961;3213
411330;201510;3234;9929;2718;8916;895;3285;712;2263;1607;5548
411340;201510;921;2700;573;1864;73;275;203;610;276;885
411342;201510;722;2033;583;1753;153;495;191;508;344;1003
411345;201510;973;3000;863;2786;229;824;377;1188;606;2012
411350;201510;2743;8030;1902;6288;494;1820;222;663;716;2483
411360;201510;554;1387;365;1051;43;157;169;419;212;576
411370;201510;46738;130858;35012;108728;6214;22236;13346;38105;19560;60341
411373;201510;1476;4581;1227;4074;272;1011;286;931;558;1942
411375;201510;1104;3027;787;2391;159;493;196;552;355;1045
411380;201510;1279;3442;729;2193;116;361;211;578;327;939
411390;201510;1810;5334;1488;4670;303;1054;470;1352;773;2406
411400;201510;2045;5865;1471;4596;264;921;374;1076;638;1997
411410;201510;2089;6241;1568;5005;348;1260;411;1078;759;2338
411420;201510;4084;11684;2789;8701;462;1626;476;1180;938;2806
411430;201510;3091;9443;2555;8504;697;2543;1109;3598;1806;6141
411435;201510;442;1434;360;1220;82;312;147;473;229;785
411440;201510;2671;8568;2369;7938;775;2756;576;2008;1351;4764
411450;201510;2242;6800;2007;6346;413;1338;1037;3363;1450;4701
411460;201510;3132;9171;1599;5562;295;1115;88;295;383;1410
411470;201510;853;2531;554;1799;79;270;94;254;173;524
411480;201510;4445;13202;3267;10881;868;3205;556;1675;1424;4880
411490;201510;1472;4405;1214;3930;279;1005;298;827;577;1832
411500;201510;1854;4945;1283;3911;265;885;345;1001;610;1886
411510;201510;2040;6057;1644;5237;460;1623;314;840;774;2463
411520;201510;26001;70522;15082;47230;2920;9919;3128;8964;6048;18883
411530;201510;1024;2872;699;2260;168;609;113;302;281;911
411535;201510;516;1542;245;887;34;140;27;78;61;218
411540;201510;3045;8175;2199;6487;433;1480;832;2215;1265;3695
411545;201510;953;3175;860;2997;156;590;544;1918;700;2508
411550;201510;790;2128;629;1873;229;754;126;357;355;1111
411560;201510;2456;7255;1765;5623;316;1112;274;707;590;1819
411570;201510;6646;17762;4794;14676;1199;4152;1047;3210;2246;7362
411573;201510;871;2585;817;2490;147;474;494;1514;641;1988
411575;201510;1510;4673;1254;4108;241;840;459;1460;700;2300
411580;201510;3987;11293;2589;8356;388;1454;401;1088;789;2542
411585;201510;688;2230;370;1298;80;297;62;194;142;491
411590;201510;385;1130;327;1035;58;207;139;403;197;610
411600;201510;304;876;211;716;47;184;81;274;128;458
411605;201510;1935;5119;1252;3754;197;680;484;1365;681;2045
411610;201510;2135;5868;1790;5297;339;1095;961;2737;1300;3832
411620;201510;2683;8440;2451;8037;691;2452;1082;3582;1773;6034
411630;201510;473;1224;283;926;54;218;44;122;98;340
411640;201510;494;1453;371;1184;59;195;125;348;184;543
411650;201510;200;645;158;561;36;153;43;131;79;284
411660;201510;819;2244;628;1870;118;385;270;784;388;1169
411670;201510;1223;3373;988;2870;219;704;355;960;574;1664
411680;201510;1415;4297;1260;4010;201;672;788;2585;989;3257
411690;201510;3253;9521;2527;8099;655;2222;532;1714;1187;3936
411695;201510;789;2548;631;2200;145;553;192;666;337;1219
411700;201510;1766;5083;1210;3907;230;826;228;635;458;1461
411705;201510;2029;6908;1770;6378;394;1396;907;3426;1301;4822
411710;201510;1741;5041;1345;4199;327;1101;283;823;610;1924
411720;201510;835;2368;622;1908;92;305;179;494;271;799
411721;201510;701;2093;590;1876;165;572;74;208;239;780
411722;201510;646;1891;435;1411;86;324;119;314;205;638
411725;201510;1376;4407;840;2996;190;717;158;539;348;1256
411727;201510;1894;5476;1435;4475;342;1165;394;1110;736;2275
411729;201510;552;1479;392;1182;127;388;65;174;192;562
411730;201510;5507;15775;4534;13873;1733;5389;1109;3345;2842;8734
411740;201510;636;1810;416;1299;71;241;142;421;213;662
411745;201510;880;2543;709;2193;141;466;230;696;371;1162
411750;201510;4613;13743;3425;10979;775;2745;855;2579;1630;5324
411760;201510;7859;22708;6673;20583;2122;7117;1749;5218;3871;12335
411770;201510;3374;11207;2742;9678;839;3199;509;1703;1348;4902
411780;201510;2598;8192;2436;7944;314;1133;1579;5310;1893;6443
411790;201510;3129;8848;2211;6940;591;2100;564;1671;1155;3771
411800;201510;1223;3493;802;2599;118;437;148;397;266;834
411810;201510;1586;4603;1309;4052;274;942;439;1229;713;2171
411820;201510;13972;44473;11522;39398;4026;14270;2781;9630;6807;23900
411830;201510;494;1295;378;1102;131;410;11;43;142;453
411840;201510;10303;29454;7425;23746;1755;6119;1475;4522;3230;10641
411845;201510;526;1598;328;1089;55;195;62;173;117;368
411850;201510;6810;20325;5474;17511;1395;4801;1442;4510;2837;9311
411860;201510;874;2701;695;2316;175;616;219;694;394;1310
411870;201510;843;2787;567;2016;109;454;112;341;221;795
411880;201510;2254;6473;1808;5661;433;1569;448;1261;881;2830
411885;201510;903;2427;721;2084;137;503;247;616;384;1119
411890;201510;1080;3255;659;2196;101;387;86;214;187;601
411900;201510;966;3055;673;2317;169;594;93;315;262;909
411910;201510;1255;4117;980;3444;285;1084;244;769;529;1853
411915;201510;15189;41938;9517;30220;1863;6401;2044;5863;3907;12264
411920;201510;855;2874;728;2554;189;804;108;279;297;1083
411925;201510;595;1667;381;1248;94;308;90;267;184;575
411930;201510;5981;19359;5199;17825;2172;7921;1024;3387;3196;11308
411940;201510;3229;10730;2771;9717;693;2554;644;2158;1337;4712
411950;201510;11583;36570;9579;32597;2387;8712;4147;13851;6534;22563
411960;201510;5235;15576;4771;14692;1141;3900;1940;5802;3081;9702
411965;201510;606;1721;438;1427;83;326;150;496;233;822
411970;201510;745;2073;598;1841;191;643;195;622;386;1265
411980;201510;1615;4872;1367;4361;285;960;467;1491;752;2451
411990;201510;28428;91750;23380;80717;6223;23693;6459;21387;12682;45080
411995;201510;2548;7771;2148;6988;685;2497;496;1458;1181;3955
412000;201510;2249;5827;1755;4967;266;897;860;2178;1126;3075
412010;201510;705;2399;556;2045;100;383;121;419;221;802
412015;201510;658;1952;514;1639;111;381;237;752;348;1133
412020;201510;395;1127;266;842;53;188;98;276;151;464
412030;201510;710;2234;478;1670;78;307;119;374;197;681
412033;201510;736;2158;490;1558;78;281;125;361;203;642
412035;201510;1007;2781;677;2158;151;516;241;741;392;1257
412040;201510;592;1850;465;1562;94;338;142;442;236;780
412050;201510;1664;4817;1252;3989;225;816;286;853;511;1669
412060;201510;6817;23268;6106;21737;1947;7474;1749;6125;3696;13599
412065;201510;887;2613;679;2150;146;510;197;547;343;1057
412070;201510;1204;3270;948;2744;159;497;325;912;484;1409
412080;201510;1361;4221;778;2800;108;443;32;73;140;516
412085;201510;402;1171;137;480;36;133;27;80;63;213
412090;201510;4156;13270;3891;12773;662;2409;2309;7597;2971;10006
412100;201510;1896;5930;1581;5249;448;1626;423;1348;871;2974
412110;201510;1078;3055;708;2248;157;538;163;496;320;1034
412120;201510;1831;6146;1566;5511;421;1667;545;1707;966;3374
412125;201510;697;2192;610;2020;127;462;243;762;370;1224
412130;201510;601;1783;433;1394;106;372;73;209;179;581
412135;201510;496;1384;330;1047;75;255;113;331;188;586
412140;201510;1564;4674;1256;4015;298;1000;254;763;552;1763
412150;201510;2819;8166;2404;7331;298;1061;1463;4331;1761;5392
412160;201510;1106;3521;675;2404;168;638;83;249;251;887
412170;201510;4430;13651;3528;11829;941;3441;1235;3894;2176;7335
412175;201510;1345;4556;1145;4090;291;1140;450;1589;741;2729
412180;201510;1639;5064;1199;4179;291;1154;319;1043;610;2197
412190;201510;3149;8970;2336;7486;551;1932;660;2203;1211;4135
412200;201510;2229;7088;1520;5229;309;1155;472;1601;781;2756
412210;201510;725;1978;405;1296;60;212;46;122;106;334
412215;201510;3724;11368;3350;10692;723;2325;1888;6203;2611;8528
412217;201510;1097;3108;968;2875;119;444;642;1770;761;2214
412220;201510;5530;18140;5232;17546;1543;5314;2543;8525;4086;13839
412230;201510;2746;8983;2338;8151;513;2014;663;2131;1176;4145
412240;201510;9468;24380;5225;16200;941;3264;954;2581;1895;5845
412250;201510;1906;5557;1608;4938;406;1362;314;829;720;2191
412260;201510;1338;3672;826;2547;115;413;292;802;407;1215
412265;201510;1045;3189;921;2973;223;842;408;1293;631;2135
412270;201510;806;2539;524;1808;104;399;140;447;244;846
412280;201510;619;1930;443;1540;189;706;40;127;229;833
412290;201510;1017;2912;779;2426;152;509;255;721;407;1230
412300;201510;1889;5681;1542;4973;415;1492;334;1014;749;2506
412310;201510;1050;3005;919;2802;130;462;477;1479;607;1941
412320;201510;812;2188;564;1739;114;410;184;545;298;955
412330;201510;1557;4402;1179;3606;194;667;586;1739;780;2406
412340;201510;915;2845;577;1952;74;273;86;247;160;520
412350;201510;2287;7105;1806;5987;390;1394;171;448;561;1842
412360;201510;287;854;178;574;22;85;60;162;82;247
412370;201510;908;2666;682;2244;166;608;161;493;327;1101
412380;201510;1585;5014;1304;4315;311;1107;369;1152;680;2259
412382;201510;674;1908;455;1437;89;292;100;270;189;562
412385;201510;2414;7504;2100;6778;679;2311;454;1392;1133;3703
412390;201510;2117;6071;1899;5702;479;1582;727;2222;1206;3804
412395;201510;847;2401;667;2089;89;313;383;1162;472;1475
412400;201510;933;2933;797;2633;226;793;197;651;423;1444
412402;201510;1922;5726;1523;4863;364;1307;339;932;703;2239
412405;201510;3678;10607;2198;7208;369;1388;209;572;578;1960
412410;201510;4593;14174;3808;12608;1114;4317;737;2192;1851;6509
412420;201510;366;1044;248;773;42;139;88;223;130;362
412430;201510;550;1533;402;1234;61;207;156;441;217;648
412440;201510;3389;10162;2712;8929;610;2215;885;2869;1495;5084
412450;201510;321;1027;238;811;39;126;20;44;59;170
412460;201510;797;2381;600;1955;143;530;128;365;271;895
412470;201510;1872;6397;1594;5659;530;1993;390;1427;920;3420
412480;201510;1310;3816;867;2825;158;534;110;275;268;809
412490;201510;872;2560;735;2270;145;464;215;626;360;1090
412500;201510;1959;5628;1605;4915;318;1094;396;1038;714;2132
412510;201510;2245;7337;1863;6391;529;1934;687;2327;1216;4261
412520;201510;1483;4179;1094;3331;254;829;243;669;497;1498
412530;201510;642;1858;487;1491;101;319;118;319;219;638
412535;201510;653;1918;409;1324;90;314;85;251;175;565
412540;201510;1211;3505;938;2945;142;516;273;837;415;1353
412545;201510;804;2292;597;1800;90;316;195;495;285;811
412550;201510;28244;84210;18565;62028;4577;16301;3410;10510;7987;26811
412555;201510;302;905;203;674;39;145;45;127;84;272
412560;201510;5146;15878;3918;13219;877;3426;933;2890;1810;6316
412570;201510;4368;12815;2927;9565;673;2462;551;1726;1224;4188
412575;201510;866;2638;658;2123;147;529;171;492;318;1021
412580;201510;1249;3433;870;2697;168;542;257;744;425;1286
412590;201510;409;1190;267;872;56;214;78;239;134;453
412600;201510;1441;4307;1093;3534;227;826;322;947;549;1773
412610;201510;719;2122;475;1501;110;386;138;387;248;773
412620;201510;1198;3810;929;3206;225;873;137;403;362;1276
412625;201510;10737;29928;7850;24232;1754;5856;1329;3659;3083;9515
412627;201510;927;2858;633;2167;174;636;66;194;240;830
412630;201510;3307;10455;2665;9026;575;1985;788;2537;1363;4522
412635;201510;472;1414;306;1031;79;271;13;30;92;301
412640;201510;895;2656;575;1891;90;298;53;147;143;445
412650;201510;1799;5277;1474;4619;316;1159;459;1217;775;2376
412660;201510;2843;8223;2147;6740;414;1433;403;1130;817;2563
412665;201510;638;1659;342;1072;90;287;66;197;156;484
412667;201510;1610;4737;1246;3988;307;1071;222;635;529;1706
412670;201510;546;1700;388;1323;103;403;69;192;172;595
412680;201510;1350;4037;834;2841;140;521;203;598;343;1119
412690;201510;762;2323;553;1849;168;589;107;349;275;938
412700;201510;1860;5681;1548;5188;514;1952;415;1341;929;3293
412710;201510;7560;23309;6053;20105;1321;4933;1375;4154;2696;9087
412720;201510;1417;4356;951;3148;161;580;179;479;340;1059
412730;201510;2194;6448;1303;4360;261;969;160;388;421;1357
412740;201510;1448;4523;1072;3689;250;963;196;672;446;1635
412750;201510;3873;11943;3410;11136;545;2153;1995;6262;2540;8415
412760;201510;2253;7290;2119;7049;467;1794;1117;3541;1584;5335
412770;201510;11222;30755;6153;19654;939;3307;1108;3031;2047;6338
412780;201510;1292;4063;1101;3656;257;928;390;1225;647;2153
412785;201510;2332;6669;1709;5367;460;1530;717;2231;1177;3761
412788;201510;1395;4414;1211;4016;257;992;416;1214;673;2206
412790;201510;1157;3404;850;2764;171;629;181;486;352;1115
412795;201510;907;2518;734;2186;171;530;257;752;428;1282
412796;201510;2726;8399;2468;7871;624;2230;909;2672;1533;4902
412800;201510;3101;8827;2323;7185;408;1408;784;2294;1192;3702
412810;201510;10907;29712;5955;18742;856;2970;1270;3297;2126;6267
412820;201510;7059;20646;5043;16602;1170;4103;1088;3627;2258;7730
412830;201510;350;1075;272;889;43;165;84;237;127;402
412840;201510;1858;5284;1470;4474;267;898;307;852;574;1750
412850;201510;2754;8121;2267;7283;459;1732;852;2532;1311;4264
412853;201510;1672;4770;1463;4346;154;558;807;2205;961;2763
412855;201510;1490;4257;1136;3473;255;859;298;786;553;1645
412860;201510;1228;3498;994;3059;250;860;399;1182;649;2042
412862;201510;766;1981;509;1477;81;254;170;445;251;699
412863;201510;1184;3998;1142;3926;176;664;771;2600;947;3264
412865;201510;682;2073;502;1655;121;415;170;577;291;992
412870;201510;899;2511;701;2167;251;855;117;309;368;1164
412880;201510;961;2708;727;2265;173;573;157;424;330;997
420005;201510;546;1621;341;1138;56;198;128;415;184;613
420010;201510;3124;8935;2550;8109;380;1249;1731;5598;2111;6847
420020;201510;744;2410;393;1465;41;191;32;100;73;291
420030;201510;527;1387;262;874;53;211;44;133;97;344
420040;201510;761;2363;470;1727;105;418;58;141;163;559
420050;201510;674;1998;459;1529;140;493;156;504;296;997
420055;201510;218;656;124;432;21;84;24;68;45;152
420060;201510;220;747;148;555;30;129;27;84;57;213
420070;201510;1431;4476;1071;3596;176;665;462;1530;638;2195
420075;201510;191;530;97;317;20;70;24;68;44;138
420080;201510;606;1889;469;1612;152;557;114;387;266;944
420090;201510;509;1710;346;1329;86;354;56;225;142;579
420100;201510;1215;3812;1084;3631;242;852;624;2093;866;2945
420110;201510;360;1196;315;1090;75;275;125;424;200;699
420120;201510;289;991;239;882;79;323;47;158;126;481
420125;201510;266;1003;240;943;71;294;93;327;164;621
420127;201510;553;1635;211;772;57;219;30;101;87;320
420130;201510;1849;6129;1484;5367;351;1402;392;1233;743;2635
420140;201510;4870;14247;3290;11095;771;2881;545;1609;1316;4490
420150;201510;764;2113;450;1473;94;336;152;453;246;789
420160;201510;292;808;178;576;26;87;52;162;78;249
420165;201510;210;653;121;420;23;85;26;75;49;160
420170;201510;206;628;132;470;48;204;16;35;64;239
420180;201510;425;1302;231;838;41;159;43;151;84;310
420190;201510;478;1388;233;819;39;155;35;101;74;256
420195;201510;1356;3908;1059;3403;259;870;361;1141;620;2011
420200;201510;2943;9391;1777;6625;453;1916;270;877;723;2793
420205;201510;945;3048;811;2817;191;709;401;1398;592;2107
420207;201510;1553;4555;1060;3503;300;1123;234;697;534;1820
420208;201510;571;1594;317;1122;105;399;98;343;203;742
420209;201510;327;1008;201;703;38;153;71;234;109;387
420210;201510;1633;4981;1053;3951;258;1156;301;1057;559;2213
420213;201510;811;2887;762;2763;156;606;457;1669;613;2275
420215;201510;390;1265;255;923;67;269;38;121;105;390
420220;201510;179;603;148;539;34;143;50;146;84;289
420230;201510;4280;12464;3062;10202;611;2430;1303;4097;1914;6527
420240;201510;11646;31686;7128;23176;1147;4551;3024;8709;4171;13260
420243;201510;620;1884;487;1607;101;375;167;519;268;894
420245;201510;1143;3420;757;2585;144;543;210;634;354;1177
420250;201510;591;1867;543;1782;155;620;227;685;382;1305
420253;201510;542;1438;425;1276;71;224;235;728;306;952
420257;201510;336;955;215;726;40;141;106;353;146;494
420260;201510;1281;4020;1064;3624;228;876;452;1516;680;2392
420270;201510;556;1704;169;612;29;119;41;133;70;252
420280;201510;2362;6290;1406;4521;286;1064;488;1405;774;2469
420285;201510;146;427;59;216;7;26;4;17;11;43
420287;201510;553;1630;455;1460;137;440;144;468;281;908
420290;201510;6721;19745;4239;14007;827;2974;1200;3601;2027;6575
420300;201510;6660;20068;4199;14671;909;3451;716;2424;1625;5875
420310;201510;791;2198;714;2080;116;368;491;1386;607;1754
420315;201510;985;3120;769;2670;215;836;267;881;482;1717
420320;201510;4920;15009;3926;13170;1048;3836;1533;5035;2581;8871
420325;201510;276;908;253;850;53;211;106;329;159;540
420330;201510;1020;3500;744;2766;180;767;191;588;371;1355
420340;201510;1483;4544;1085;3618;235;873;154;413;389;1286
420350;201510;1512;4486;1134;3741;285;1010;412;1310;697;2320
420360;201510;3248;9789;2011;7004;455;1796;239;647;694;2443
420370;201510;1955;5429;1510;4612;169;532;1118;3361;1287;3893
420380;201510;5276;16444;3559;12375;858;3275;822;2742;1680;6017
420390;201510;1644;4598;832;2836;155;622;174;454;329;1076
420395;201510;1536;4690;1016;3476;158;617;173;484;331;1101
420400;201510;1332;3819;899;2949;231;891;219;618;450;1509
420410;201510;787;2099;536;1681;125;437;296;904;421;1341
420415;201510;472;1480;340;1156;100;355;94;301;194;656
420417;201510;744;2364;613;2039;98;342;322;1072;420;1414
420419;201510;404;1226;252;908;96;384;33;113;129;497
420420;201510;11068;33081;8600;28124;2749;9996;2169;6331;4918;16327
420425;201510;1340;3625;840;2611;84;329;358;1018;442;1347
420430;201510;3357;10105;2110;7215;460;1723;696;2335;1156;4058
420435;201510;306;903;182;627;39;152;71;226;110;378
420440;201510;991;3030;579;1971;225;821;101;319;326;1140
420445;201510;377;1125;267;859;52;165;116;375;168;540
420450;201510;864;2580;534;1829;120;437;124;364;244;801
420455;201510;1989;5910;1692;5382;310;1203;786;2348;1096;3551
420460;201510;8803;25520;6427;21220;1441;5514;2433;7546;3874;13060
420470;201510;1131;3047;699;2189;159;567;191;527;350;1094
420475;201510;126;371;63;218;19;66;11;32;30;98
420480;201510;4764;13853;3478;11326;1091;3942;578;1764;1669;5706
420490;201510;708;1847;380;1272;97;356;97;299;194;655
420500;201510;1690;5285;1274;4452;384;1515;484;1590;868;3105
420510;201510;109;428;95;398;37;157;35;137;72;294
420515;201510;118;400;95;353;15;67;16;59;31;126
420517;201510;924;2822;785;2561;126;465;407;1263;533;1728
420519;201510;546;1428;374;1118;62;198;108;300;170;498
420520;201510;677;1678;422;1311;87;293;154;402;241;695
420530;201510;1095;3572;800;2859;186;762;197;578;383;1340
420535;201510;259;750;127;452;30;121;8;23;38;144
420540;201510;21276;60707;14741;46458;3700;12792;3994;11019;7694;23811
420543;201510;413;1078;304;897;27;91;195;616;222;707
420545;201510;1610;5032;1269;4273;292;1099;410;1253;702;2352
420550;201510;4227;13351;3079;10809;739;3089;636;1888;1375;4977
420555;201510;406;1232;313;1036;86;315;107;329;193;644
420560;201510;551;1581;437;1366;76;260;211;636;287;896
420570;201510;2090;6658;1588;5473;419;1655;498;1563;917;3218
420580;201510;1354;4189;1060;3663;260;1019;438;1460;698;2479
420590;201510;3320;9999;2120;7165;432;1588;336;971;768;2559
420600;201510;831;2711;747;2533;124;451;399;1397;523;1848
420610;201510;534;1644;295;1087;80;334;70;244;150;578
420620;201510;774;2297;637;2048;189;648;184;576;373;1224
420630;201510;1047;3207;710;2413;156;564;223;659;379;1223
420640;201510;764;2326;361;1337;80;326;25;78;105;404
420650;201510;2548;7348;1498;5082;266;1032;333;968;599;2000
420660;201510;486;1405;381;1199;66;238;175;529;241;767
420665;201510;730;2030;449;1471;75;263;130;371;205;634
420670;201510;1674;4968;1136;3797;222;873;272;784;494;1657
420675;201510;212;650;144;490;28;103;48;148;76;251
420680;201510;515;1212;296;876;49;167;95;253;144;420
420690;201510;904;3095;631;2318;108;427;144;487;252;914
420700;201510;3742;10696;2781;8737;598;2183;856;2493;1454;4676
420710;201510;588;1947;449;1662;129;531;143;495;272;1026
420720;201510;1701;4869;1321;4345;333;1169;726;2389;1059;3558
420730;201510;3378;10033;2705;8791;679;2434;1052;3237;1731;5671
420740;201510;861;2631;696;2311;213;760;294;919;507;1679
420750;201510;2425;7656;1624;5723;285;1189;491;1491;776;2680
420757;201510;105;257;49;167;7;31;24;81;31;112
420760;201510;368;1130;216;709;46;179;56;149;102;328
420765;201510;588;1824;292;1073;58;245;54;170;112;415
420768;201510;1154;4008;881;3388;292;1172;285;1080;577;2252
420770;201510;678;1940;351;1235;79;329;82;263;161;592
420775;201510;673;2037;386;1317;92;335;74;223;166;558
420780;201510;1588;4755;933;3114;207;730;170;505;377;1235
420785;201510;313;934;222;702;34;118;57;155;91;273
420790;201510;1291;4388;993;3667;283;1161;369;1270;652;2431
420800;201510;837;2390;423;1408;107;409;102;308;209;717
420810;201510;2202;7437;1681;6192;511;2146;382;1266;893;3412
420820;201510;8267;24749;5565;19953;1448;5942;1427;4908;2875;10850
420830;201510;2664;8417;2182;7502;698;2616;737;2464;1435;5080
420840;201510;1090;3243;562;2034;132;536;115;353;247;889
420845;201510;1330;4004;937;3261;259;1056;223;683;482;1739
420850;201510;1679;5231;962;3645;236;1029;95;318;331;1347
420860;201510;473;1305;288;946;75;291;102;316;177;607
420870;201510;1163;3231;891;2785;292;1061;257;687;549;1748
420880;201510;1069;3492;795;2778;173;674;170;515;343;1189
420890;201510;13174;32359;5590;17861;966;3423;1383;3681;2349;7104
420895;201510;246;675;126;411;38;120;12;35;50;155
420900;201510;2106;5816;1217;4056;254;990;300;882;554;1872
420910;201510;22869;67996;14650;50822;2910;11424;4070;12976;6980;24400
420915;201510;575;2231;419;1754;98;437;190;746;288;1183
420917;201510;470;1435;215;691;47;184;87;227;134;411
420920;201510;187;515;74;251;15;55;15;49;30;104
420930;201510;18977;54052;14537;46354;3435;12163;5051;15419;8486;27582
420940;201510;3258;9717;2491;8076;673;2470;387;956;1060;3426
420945;201510;212;672;135;490;25;114;36;121;61;235
420950;201510;624;1752;279;1038;41;198;40;123;81;321
420960;201510;977;2725;771;2359;164;574;347;979;511;1553
420970;201510;2571;7981;2101;7097;607;2322;632;2006;1239;4328
420980;201510;469;1359;340;1142;112;408;119;443;231;851
420985;201510;513;1464;244;874;52;225;58;178;110;403
420990;201510;924;2519;506;1716;99;379;129;371;228;750
421000;201510;609;2055;382;1449;81;324;69;215;150;539
421003;201510;713;1934;258;854;28;90;43;90;71;180
421005;201510;193;585;149;510;33;123;81;276;114;399
421010;201510;5816;16557;3943;13077;1034;3882;906;2635;1940;6517
421020;201510;481;1495;359;1258;48;172;191;695;239;867
421030;201510;816;2966;749;2793;215;868;145;516;360;1384
421040;201510;747;2079;567;1778;120;424;280;836;400;1260
421050;201510;1679;4688;977;3187;203;744;226;605;429;1349
421055;201510;223;644;124;402;28;98;33;86;61;184
421060;201510;504;1738;342;1267;77;319;116;411;193;730
421070;201510;753;2376;467;1662;103;424;100;317;203;741
421080;201510;540;1600;458;1469;94;307;280;897;374;1204
421085;201510;577;1514;295;1002;64;246;81;288;145;534
421090;201510;402;1121;212;699;34;122;83;235;117;357
421100;201510;862;2410;480;1554;141;466;81;236;222;702
421105;201510;1498;4565;1219;4064;282;1014;446;1502;728;2516
421110;201510;1051;3769;950;3524;335;1324;218;727;553;2051
421120;201510;1453;4581;956;3330;165;677;283;846;448;1523
421125;201510;422;1178;305;968;85;314;98;270;183;584
421130;201510;3335;10759;2752;9673;884;3493;928;3194;1812;6687
421140;201510;356;1039;262;828;52;168;90;258;142;426
421145;201510;569;1789;367;1235;54;206;127;399;181;605
421150;201510;537;1621;381;1336;75;292;153;526;228;818
421160;201510;1269;3533;612;2046;113;427;219;698;332;1125
421165;201510;291;997;222;789;33;119;105;374;138;493
421170;201510;1411;4107;1121;3619;229;803;657;2103;886;2906
421175;201510;1244;3488;900;2916;205;828;313;878;518;1706
421180;201510;606;1668;311;1038;69;264;72;203;141;467
421185;201510;407;1123;278;873;54;155;133;438;187;593
421187;201510;294;881;215;710;37;131;98;304;135;435
421189;201510;425;1295;364;1173;71;245;127;377;198;622
421190;201510;11843;33962;6967;23734;1531;5723;1273;3936;2804;9659
421200;201510;942;3080;785;2732;176;680;228;708;404;1388
421205;201510;257;783;183;637;40;163;40;111;80;274
421210;201510;1669;5012;1209;3885;311;1061;310;942;621;2003
421220;201510;2061;6903;1750;6197;514;2036;355;1126;869;3162
421223;201510;627;1923;468;1604;118;438;165;531;283;969
421225;201510;1117;3497;921;3098;214;814;333;1085;547;1899
421227;201510;870;2795;764;2622;162;609;457;1535;619;2144
421230;201510;487;1552;428;1437;105;403;204;635;309;1038
421240;201510;458;1469;255;903;37;163;43;123;80;286
421250;201510;1841;5273;1146;3993;314;1193;270;891;584;2084
421260;201510;369;1034;95;350;20;72;24;81;44;153
421265;201510;638;2021;547;1849;124;442;221;733;345;1175
421270;201510;816;2190;399;1325;90;317;85;308;175;625
421280;201510;1613;5020;1269;4443;382;1497;422;1419;804;2916
421290;201510;1599;4194;793;2576;152;533;141;396;293;929
421300;201510;308;932;241;789;67;251;95;291;162;542
421310;201510;274;856;213;703;45;154;79;243;124;397
421315;201510;396;1173;218;786;45;169;20;70;65;239
421320;201510;570;1828;358;1269;59;220;45;104;104;324
421330;201510;573;1862;435;1595;139;590;77;261;216;851
421335;201510;566;1842;445;1597;106;426;85;309;191;735
421340;201510;1780;5081;1421;4498;206;810;842;2593;1048;3403
421350;201510;957;3116;760;2680;159;658;292;938;451;1596
421360;201510;3160;9023;1949;6641;400;1563;546;1668;946;3231
421370;201510;770;2532;596;2141;167;680;185;618;352;1298
421380;201510;1005;2837;791;2416;145;510;374;1107;519;1617
421390;201510;144;423;75;259;11;35;35;128;46;163
421400;201510;252;877;187;729;46;189;61;220;107;409
421410;201510;320;915;215;700;32;106;104;329;136;435
421415;201510;365;1197;161;589;40;163;35;105;75;268
421420;201510;927;2790;649;2144;131;468;189;551;320;1019
421430;201510;244;753;178;621;35;135;38;128;73;263
421440;201510;882;2507;563;1919;138;532;232;752;370;1284
421450;201510;493;1518;301;1112;71;294;34;121;105;415
421460;201510;634;1708;309;1084;51;216;70;227;121;443
421470;201510;452;1519;357;1302;99;388;123;434;222;822
421480;201510;2974;8454;1757;6131;393;1607;344;1002;737;2609
421490;201510;287;865;124;465;31;129;25;79;56;208
421500;201510;2340;7862;1907;6901;633;2595;338;1102;971;3697
421505;201510;379;1251;331;1143;70;261;158;533;228;794
421507;201510;573;1726;357;1239;72;261;111;387;183;648
421510;201510;188;611;160;561;29;134;81;237;110;371
421520;201510;861;2282;552;1643;52;190;258;680;310;870
421530;201510;409;1253;234;857;36;166;75;264;111;430
421535;201510;719;2109;398;1427;72;298;168;548;240;846
421540;201510;372;1015;297;876;62;198;120;329;182;527
421545;201510;926;3000;661;2452;169;714;170;591;339;1305
421550;201510;1972;6292;1634;5658;470;1845;443;1389;913;3234
421555;201510;339;1019;119;433;18;70;17;58;35;128
421560;201510;204;615;85;295;21;81;19;65;40;146
421565;201510;967;2836;845;2649;298;1053;337;1016;635;2069
421567;201510;771;2792;666;2539;333;1321;144;529;477;1850
421568;201510;521;1618;350;1213;78;267;80;285;158;552
421569;201510;233;698;110;399;26;105;24;74;50;179
421570;201510;1363;4116;704;2484;193;763;123;396;316;1159
421575;201510;477;1555;411;1420;68;251;256;881;324;1132
421580;201510;3490;10824;2568;8747;647;2542;619;1795;1266;4337
421590;201510;232;723;183;625;26;89;95;320;121;409
421600;201510;596;1775;445;1457;117;416;92;263;209;679
421605;201510;623;1876;442;1519;80;316;114;354;194;670
421610;201510;1471;3950;1132;3372;171;588;623;1769;794;2357
421620;201510;4699;14118;3106;10716;893;3287;915;3100;1808;6387
421625;201510;390;1100;156;538;26;94;27;89;53;183
421630;201510;2926;8716;1554;5349;363;1388;207;603;570;1991
421635;201510;269;802;155;512;27;109;72;210;99;319
421640;201510;1063;3169;797;2618;164;561;329;1031;493;1592
421650;201510;2103;6780;1640;5726;491;1964;256;735;747;2699
421660;201510;8036;25809;6370;22285;1620;6413;2013;6424;3633;12837
421670;201510;1103;3390;751;2585;221;844;198;646;419;1490
421680;201510;1239;3990;1020;3498;327;1196;199;625;526;1821
421690;201510;1807;5831;1330;4670;286;1108;181;526;467;1634
421700;201510;536;1653;300;1030;50;207;90;223;140;430
421710;201510;240;799;120;438;35;132;34;114;69;246
421715;201510;277;743;146;467;39;144;44;118;83;262
421720;201510;1863;5544;1163;4092;322;1254;232;722;554;1976
421725;201510;110;362;95;325;28;100;24;77;52;177
421730;201510;592;1712;270;935;52;198;53;140;105;338
421740;201510;739;2333;490;1725;104;444;97;248;201;692
421750;201510;959;2627;601;1898;121;412;263;773;384;1185
421755;201510;357;1025;214;673;47;171;70;200;117;371
421760;201510;684;2185;358;1294;71;280;112;386;183;666
421770;201510;3125;9290;2311;7619;650;2289;735;2395;1385;4684
421775;201510;574;1674;384;1318;79;290;109;350;188;640
421780;201510;1350;4428;997;3617;259;1064;357;1196;616;2260
421790;201510;896;2380;491;1685;121;482;147;447;268;929
421795;201510;350;1028;215;687;35;131;62;191;97;322
421800;201510;2675;7984;1976;6620;424;1625;792;2436;1216;4061
421810;201510;645;2027;455;1625;119;456;55;182;174;638
421820;201510;1126;3258;688;2332;121;450;155;462;276;912
421825;201510;1433;4602;1321;4336;197;777;786;2443;983;3220
421830;201510;2502;8465;2244;7953;523;2127;1009;3397;1532;5524
421835;201510;148;433;105;369;23;106;61;200;84;306
421840;201510;356;1142;270;942;70;284;88;273;158;557
421850;201510;417;1285;250;875;52;219;63;208;115;427
421860;201510;356;1068;222;778;38;141;48;140;86;281
421870;201510;4474;12606;2998;9579;870;3007;553;1672;1423;4679
421875;201510;441;1305;189;698;40;164;28;93;68;257
421880;201510;921;2831;681;2306;150;573;173;534;323;1107
421885;201510;320;1008;251;872;84;329;86;273;170;602
421890;201510;952;3173;796;2855;243;1000;254;849;497;1849
421895;201510;369;1202;322;1116;81;281;169;603;250;884
421900;201510;973;2729;608;1957;162;567;164;451;326;1018
421910;201510;542;1722;367;1318;75;316;83;247;158;563
421915;201510;559;1671;352;1163;70;233;98;284;168;517
421917;201510;578;1702;419;1436;128;521;121;380;249;901
421920;201510;815;2266;529;1868;254;959;139;456;393;1415
421930;201510;3360;8915;1897;6271;441;1629;336;964;777;2593
421935;201510;724;2369;518;1899;108;466;185;630;293;1096
421940;201510;276;930;134;499;23;97;21;57;44;154
421950;201510;3857;10646;1857;6345;455;1670;284;946;739;2616
421960;201510;225;680;173;565;44;161;41;109;85;270
421970;201510;2281;6450;1417;4599;467;1612;327;948;794;2560
421985;201510;524;1342;279;839;47;178;80;241;127;419
422000;201510;1029;3081;845;2729;212;745;334;1107;546;1852
430003;201510;851;2485;650;2125;176;650;189;580;365;1230
430005;201510;313;951;233;795;46;169;106;340;152;509
430010;201510;2150;5806;1563;4779;403;1305;629;1931;1032;3236
430020;201510;757;1897;626;1712;74;220;425;1125;499;1345
430030;201510;1085;2824;788;2284;256;812;148;382;404;1194
430040;201510;11696;30182;8926;25350;2549;7750;1956;5199;4505;12949
430045;201510;750;2016;577;1662;116;345;271;759;387;1104
430047;201510;291;708;162;483;24;67;72;217;96;284
430050;201510;1239;3333;696;2209;131;444;181;529;312;973
430055;201510;307;828;166;517;28;100;68;194;96;294
430057;201510;72;160;25;65;3;7;6;7;9;14
430060;201510;16244;51894;13891;47614;3847;13989;5961;20658;9808;34647
430063;201510;1001;2930;800;2506;200;663;403;1276;603;1939
430064;201510;1533;4484;1228;3918;303;981;505;1621;808;2602
430066;201510;170;410;121;330;11;37;67;172;78;209
430070;201510;618;1653;216;686;41;151;49;120;90;271
430080;201510;711;2028;434;1474;86;326;125;369;211;695
430085;201510;839;2185;544;1666;115;387;194;594;309;981
430087;201510;1052;3156;975;3026;137;490;638;1880;775;2370
430090;201510;893;2368;326;1086;36;139;49;169;85;308
430100;201510;898;2362;505;1541;126;418;153;401;279;819
430105;201510;959;2838;639;2212;174;676;194;656;368;1332
430107;201510;270;885;192;662;38;143;53;166;91;309
430110;201510;1914;5447;1545;4837;440;1417;614;1887;1054;3304
430120;201510;1728;5095;1281;4144;262;886;629;1990;891;2876
430130;201510;3876;10069;3322;9245;736;2220;1455;3946;2191;6166
430140;201510;1242;3742;844;2861;236;820;255;849;491;1669
430150;201510;833;2205;543;1653;130;428;144;424;274;852
430155;201510;443;1259;254;857;39;144;90;292;129;436
430160;201510;16766;48755;14832;45446;3065;10294;7029;21454;10094;31748
430163;201510;1900;5575;1535;4895;269;952;736;2325;1005;3277
430165;201510;464;1140;132;432;21;71;31;92;52;163
430170;201510;943;2647;352;1259;53;189;36;111;89;300
430175;201510;951;2959;760;2499;202;616;309;1096;511;1712
430180;201510;900;2433;723;2130;166;547;380;1062;546;1609
430185;201510;688;1725;351;1070;51;166;110;284;161;450
430187;201510;681;2005;512;1635;116;432;186;547;302;979
430190;201510;1754;5179;1503;4686;290;1020;838;2564;1128;3584
430192;201510;200;607;89;283;6;19;21;59;27;78
430195;201510;338;1025;82;278;8;28;5;16;13;44
430200;201510;1531;4835;1276;4280;380;1348;303;978;683;2326
430205;201510;553;1590;418;1346;45;180;298;941;343;1121
430210;201510;6589;17562;3514;11029;665;2263;771;2184;1436;4447
430215;201510;379;1039;251;762;47;143;98;278;145;421
430220;201510;769;1933;289;959;45;165;55;172;100;337
430222;201510;306;900;233;735;36;144;107;310;143;454
430223;201510;352;1003;302;929;69;213;176;563;245;776
430225;201510;40;106;20;63;5;13;7;18;12;31
430230;201510;1816;5221;1688;5090;208;486;1439;4526;1647;5012
430235;201510;289;940;224;778;53;205;61;187;114;392
430237;201510;551;1415;395;1146;45;152;247;694;292;846
430240;201510;1012;2631;657;2010;134;486;272;774;406;1260
430245;201510;921;2821;698;2352;182;626;318;1101;500;1727
430250;201510;1285;3621;1097;3285;405;1289;224;643;629;1932
430258;201510;169;475;122;389;11;37;54;179;65;216
430260;201510;847;2382;571;1825;60;199;302;1004;362;1203
430265;201510;320;969;242;803;51;163;21;59;72;222
430270;201510;2946;8208;2505;7464;379;1333;1422;4023;1801;5356
430280;201510;4760;12873;3790;11122;921;2790;1610;4714;2531;7504
430290;201510;2454;6403;2238;6101;172;497;1909;5240;2081;5737
430300;201510;9428;27608;7606;24079;1981;6721;3100;9973;5081;16694
430310;201510;6628;19946;5157;17082;1299;4741;1899;5820;3198;10561
430320;201510;869;2502;548;1828;103;293;266;946;369;1239
430330;201510;746;1972;571;1634;158;455;237;628;395;1083
430340;201510;772;1932;419;1369;74;271;203;658;277;929
430350;201510;6304;19290;5261;17047;1841;6186;1656;5250;3497;11436
430355;201510;380;952;142;438;27;89;18;47;45;136
430360;201510;1093;2847;896;2480;178;568;399;999;577;1567
430367;201510;267;703;168;523;44;163;59;173;103;336
430370;201510;524;1489;385;1217;112;392;93;261;205;653
430380;201510;881;2251;456;1459;129;454;132;410;261;864
430390;201510;4327;12204;2870;9184;633;2151;581;1739;1214;3890
430400;201510;1450;3444;992;2718;316;922;340;863;656;1785
430410;201510;700;1860;504;1524;108;353;231;682;339;1035
430420;201510;3900;11137;2967;9075;778;2454;1195;3573;1973;6027
430430;201510;778;2070;466;1487;133;459;117;358;250;817
430435;201510;2071;5560;1537;4589;359;1142;660;1931;1019;3073
430440;201510;4124;12854;3170;10674;686;2444;1432;4941;2118;7385
430450;201510;7853;21682;6060;18162;2062;6525;1353;4020;3415;10545
430460;201510;29395;85946;21964;72303;6008;21753;6699;21519;12707;43272
430461;201510;528;1413;158;504;23;75;32;93;55;168
430462;201510;318;906;231;749;81;291;54;151;135;442
430463;201510;4122;13019;3517;11867;775;2822;1657;5653;2432;8475
430465;201510;642;1719;529;1522;165;523;250;687;415;1210
430466;201510;3647;9997;3193;9275;608;1937;1812;5118;2420;7055
430467;201510;561;1641;481;1499;96;331;210;614;306;945
430468;201510;1449;4046;1241;3727;361;1168;447;1302;808;2470
430469;201510;354;970;63;226;7;32;9;25;16;57
430470;201510;7703;20516;5312;16360;1561;5229;905;2623;2466;7852
430471;201510;673;2192;588;2007;179;630;148;519;327;1149
430480;201510;1077;2795;526;1666;83;304;132;365;215;669
430485;201510;227;647;105;352;17;60;34;112;51;172
430490;201510;394;1084;248;798;53;191;104;336;157;527
430495;201510;403;1180;249;859;49;186;53;159;102;345
430500;201510;1280;3532;1034;3110;300;1007;430;1243;730;2250
430510;201510;20689;60637;16511;52585;5596;19554;4574;13430;10170;32984
430511;201510;419;1283;171;603;20;81;24;63;44;144
430512;201510;1207;3101;1018;2763;259;730;350;996;609;1726
430513;201510;764;2052;474;1426;98;301;180;528;278;829
430515;201510;506;1477;365;1173;63;216;179;584;242;800
430517;201510;1253;3911;1034;3459;212;725;574;1927;786;2652
430520;201510;1654;4564;1140;3496;290;968;365;1016;655;1984
430530;201510;1088;2981;534;1715;72;263;134;393;206;656
430535;201510;2225;6699;1659;5527;359;1328;603;1918;962;3246
430537;201510;494;1557;420;1403;53;173;293;992;346;1165
430540;201510;782;1726;512;1355;93;258;294;770;387;1028
430543;201510;519;1339;454;1272;85;251;317;906;402;1157
430544;201510;690;2170;571;1918;113;401;292;954;405;1355
430545;201510;1321;4193;1125;3948;374;1391;464;1673;838;3064
430550;201510;683;1961;431;1412;89;320;130;410;219;730
430558;201510;83;242;42;146;11;50;8;20;19;70
430560;201510;426;1056;243;736;26;88;80;228;106;316
430570;201510;1181;3015;745;2143;190;646;280;663;470;1309
430580;201510;1326;3363;754;2373;175;604;262;820;437;1424
430583;201510;170;472;55;185;3;15;5;17;8;32
430585;201510;359;933;224;644;58;197;95;233;153;430
430587;201510;218;659;187;601;57;194;57;185;114;379
430590;201510;1303;3640;1220;3502;180;551;833;2354;1013;2905
430593;201510;29;111;26;100;7;35;11;36;18;71
430595;201510;257;701;85;291;13;55;9;23;22;78
430597;201510;350;1021;233;738;28;98;68;183;96;281
430600;201510;2193;5894;1234;3757;238;780;402;1152;640;1932
430605;201510;1381;4142;1076;3520;241;897;418;1384;659;2281
430607;201510;775;1905;561;1580;86;258;344;987;430;1245
430610;201510;8598;22734;6399;19194;1769;5734;1913;5634;3682;11368
430613;201510;274;664;112;333;27;75;21;49;48;124
430620;201510;766;2192;595;1830;151;489;226;651;377;1140
430630;201510;471;1441;226;749;39;128;31;83;70;211
430632;201510;743;2039;403;1251;70;253;163;438;233;691
430635;201510;715;1952;508;1549;108;363;240;715;348;1078
430637;201510;513;1455;445;1317;67;234;273;760;340;994
430640;201510;1762;4628;766;2464;79;256;88;171;167;427
430642;201510;492;1301;298;936;59;202;111;331;170;533
430645;201510;268;645;101;294;17;47;23;72;40;119
430650;201510;1890;6091;1597;5503;344;1201;885;3119;1229;4320
430655;201510;173;476;144;417;30;102;68;168;98;270
430660;201510;5769;16182;4484;13896;1148;3873;1763;5384;2911;9257
430670;201510;500;1450;450;1352;39;116;342;1064;381;1180
430673;201510;745;1768;349;1051;74;226;128;376;202;602
430675;201510;275;795;110;355;17;60;46;145;63;205
430676;201510;3619;10814;2966;9609;805;2821;982;3156;1787;5977
430680;201510;1244;3558;762;2482;145;500;205;575;350;1075
430690;201510;4409;12349;3423;10383;1067;3310;928;2833;1995;6143
430692;201510;297;974;214;802;23;93;135;502;158;595
430693;201510;1383;3806;889;2775;166;606;239;664;405;1270
430695;201510;578;1614;387;1223;79;285;149;422;228;707
430697;201510;490;1366;369;1154;96;293;134;440;230;733
430700;201510;10074;25928;4652;15227;836;3073;300;907;1136;3980
430705;201510;287;867;244;784;84;298;64;186;148;484
430710;201510;1850;4655;1353;3810;303;932;517;1469;820;2401
430720;201510;923;2252;605;1789;141;445;201;585;342;1030
430730;201510;1722;4512;1164;3582;309;937;433;1392;742;2329
430740;201510;584;1613;329;1091;93;330;58;180;151;510
430745;201510;516;1462;254;805;44;156;40;109;84;265
430750;201510;1698;4615;1323;3960;265;880;646;1836;911;2716
430755;201510;581;1526;366;1062;37;126;164;426;201;552
430760;201510;3228;7848;2207;6333;469;1577;924;2710;1393;4287
430770;201510;6831;19537;5201;16473;1002;3457;2613;8173;3615;11630
430780;201510;2530;6698;1448;4580;290;989;440;1327;730;2316
430781;201510;597;1716;401;1317;85;283;123;386;208;669
430783;201510;541;1332;329;975;63;205;148;399;211;604
430786;201510;81;263;54;190;10;39;23;75;33;114
430790;201510;4788;12991;3197;9755;742;2523;1143;3169;1885;5692
430800;201510;895;2574;588;1857;126;434;196;582;322;1016
430805;201510;547;1497;351;1105;45;141;174;560;219;701
430807;201510;434;1243;286;900;59;211;81;241;140;452
430810;201510;802;2134;363;1169;57;205;74;199;131;404
430820;201510;1305;3974;852;2862;178;654;229;718;407;1372
430825;201510;416;1090;171;519;34;103;45;115;79;218
430830;201510;2078;6223;1900;5948;272;916;1264;3937;1536;4853
430840;201510;982;2997;884;2810;226;729;417;1372;643;2101
430843;201510;103;296;50;163;10;39;17;51;27;90
430845;201510;346;1039;279;899;110;377;23;61;133;438
430850;201510;2663;7750;2210;6883;511;1741;871;2612;1382;4353
430860;201510;1040;2790;530;1727;145;549;165;493;310;1042
430865;201510;683;1780;611;1667;212;610;280;731;492;1341
430870;201510;713;1989;383;1258;97;321;72;197;169;518
430880;201510;1299;3646;930;2911;266;899;247;791;513;1690
430885;201510;248;611;144;452;18;62;91;284;109;346
430890;201510;1834;4797;1241;3665;169;608;382;1005;551;1613
430900;201510;2945;7732;2423;6819;531;1769;1149;2968;1680;4737
430905;201510;1066;3001;646;2085;155;540;149;455;304;995
430910;201510;1594;4660;1110;3617;255;924;438;1311;693;2235
430912;201510;506;1420;394;1220;58;206;240;727;298;933
430915;201510;568;1775;376;1385;121;472;89;346;210;818
430920;201510;15768;47704;13856;44048;3004;10550;7821;24060;10825;34610
430925;201510;107;258;56;164;16;53;23;62;39;115
430930;201510;9675;27712;6600;21661;1804;6384;1713;5665;3517;12049
430940;201510;1232;3727;730;2465;139;525;141;403;280;928
430950;201510;1124;3084;734;2261;168;587;276;755;444;1342
430955;201510;144;432;65;210;15;54;19;61;34;115
430957;201510;271;885;217;782;54;197;100;375;154;572
430960;201510;1410;3799;1149;3329;292;941;514;1514;806;2455
430965;201510;1521;4357;1286;3951;94;350;983;2954;1077;3304
430970;201510;544;1511;315;1019;61;211;87;270;148;481
430975;201510;630;2011;475;1640;81;305;231;799;312;1104
430980;201510;451;1133;270;852;64;216;93;271;157;487
430990;201510;630;1987;449;1535;106;379;95;304;201;683
430995;201510;642;1875;515;1611;176;579;166;485;342;1064
431000;201510;1745;4413;846;2592;147;521;93;232;240;753
431010;201510;2756;7675;1600;5287;304;1110;343;964;647;2074
431020;201510;12296;30053;7640;21606;1924;5583;2021;5646;3945;11229
431030;201510;368;1062;171;602;44;179;31;105;75;284
431033;201510;2443;7069;2139;6617;556;1861;1021;3213;1577;5074
431036;201510;209;532;80;272;15;53;17;46;32;99
431040;201510;989;2785;775;2425;173;615;365;1098;538;1713
431041;201510;547;1479;491;1401;163;475;190;559;353;1034
431043;201510;413;1266;271;950;113;435;66;192;179;627
431046;201510;119;338;81;253;12;47;27;76;39;123
431050;201510;1798;4483;1353;3734;283;871;743;1992;1026;2863
431053;201510;626;1993;500;1717;145;545;120;416;265;961
431055;201510;680;1838;630;1753;57;165;472;1318;529;1483
431057;201510;402;1177;242;831;53;189;64;209;117;398
431060;201510;5789;16803;5226;15983;1610;4851;2379;7588;3989;12439
431065;201510;557;1576;414;1279;74;263;185;527;259;790
431070;201510;749;2160;433;1424;95;320;75;207;170;527
431075;201510;297;900;206;704;34;123;58;208;92;331
431080;201510;665;2063;524;1750;101;374;135;429;236;803
431085;201510;903;2423;688;1983;109;331;376;1065;485;1396
431087;201510;620;1742;533;1570;67;194;359;1071;426;1265
431090;201510;546;1321;246;747;64;193;55;166;119;359
431100;201510;3831;10579;3025;9152;780;2551;1009;3021;1789;5572
431110;201510;1589;4179;1164;3323;257;770;471;1249;728;2019
431112;201510;607;1926;558;1829;147;485;253;809;400;1294
431113;201510;528;1539;405;1287;115;381;115;380;230;761
431115;201510;1432;4082;1234;3739;238;752;707;2148;945;2900
431120;201510;2724;8337;2115;7101;642;2479;683;2050;1325;4529
431123;201510;499;1433;348;1145;73;255;190;630;263;885
431125;201510;1378;4162;999;3345;309;1027;242;877;551;1904
431127;201510;259;687;51;164;5;12;7;19;12;31
431130;201510;3539;9958;2549;8103;524;1866;872;2682;1396;4548
431140;201510;4688;11542;2462;7668;404;1369;589;1570;993;2939
431142;201510;492;1448;440;1352;40;125;310;974;350;1099
431150;201510;1173;3472;883;2890;192;708;327;1053;519;1761
431160;201510;986;2860;828;2538;145;438;409;1352;554;1790
431162;201510;534;1391;239;806;34;146;25;51;59;197
431164;201510;171;465;42;151;7;27;3;12;10;39
431170;201510;799;2184;543;1705;146;496;157;468;303;964
431171;201510;842;2465;707;2194;237;781;194;566;431;1347
431173;201510;493;1420;424;1301;113;375;230;696;343;1071
431175;201510;1088;3017;922;2745;274;861;309;891;583;1752
431177;201510;915;2907;740;2558;237;935;305;1002;542;1937
431179;201510;372;813;88;257;12;42;23;56;35;98
431180;201510;2323;6660;1581;5107;390;1333;372;1074;762;2407
431190;201510;739;1904;362;1161;61;224;82;246;143;470
431198;201510;383;1261;334;1162;135;487;85;313;220;800
431200;201510;394;1099;106;361;18;52;4;12;22;64
431205;201510;305;913;146;492;33;102;45;156;78;258
431210;201510;770;2076;644;1858;180;513;323;961;503;1474
431213;201510;252;763;198;658;40;156;90;290;130;446
431215;201510;334;975;168;567;26;82;12;26;38;108
431217;201510;200;611;150;499;42;146;50;167;92;313
431220;201510;968;2589;580;1770;74;239;264;743;338;982
431225;201510;1367;3794;1074;3267;227;733;530;1577;757;2310
431230;201510;891;2546;652;2054;84;280;335;1020;419;1300
431235;201510;110;313;32;101;6;21;6;14;12;35
431237;201510;513;1500;401;1329;99;393;201;646;300;1039
431238;201510;46;150;37;129;8;32;13;46;21;78
431240;201510;3018;9001;2629;8379;861;2940;809;2555;1670;5495
431242;201510;385;1206;335;1104;98;329;106;369;204;698
431244;201510;416;980;252;702;42;142;126;315;168;457
431245;201510;1167;3037;825;2406;131;404;447;1269;578;1673
431247;201510;200;571;143;452;45;150;28;79;73;229
431250;201510;1587;4958;1357;4616;368;1345;570;1941;938;3286
431260;201510;362;1009;179;616;34;135;58;182;92;317
431261;201510;247;854;213;775;37;175;75;238;112;413
431262;201510;418;1131;184;601;21;87;82;265;103;352
431265;201510;1498;3884;803;2442;150;492;200;492;350;984
431267;201510;173;477;135;410;30;110;74;208;104;318
431270;201510;2789;6994;1831;5419;481;1597;622;1790;1103;3387
431275;201510;228;696;117;434;35;133;11;36;46;169
431280;201510;329;910;128;424;16;58;30;76;46;134
431290;201510;333;1020;249;824;61;235;51;141;112;376
431295;201510;102;273;54;159;2;7;25;67;27;74
431300;201510;379;947;48;182;5;20;0;0;5;20
431301;201510;271;829;122;411;27;97;22;62;49;159
431303;201510;770;2030;437;1331;70;257;134;366;204;623
431306;201510;2349;6097;1514;4580;180;652;480;1265;660;1917
431308;201510;45;153;40;136;23;83;12;39;35;122
431310;201510;821;2438;487;1666;96;332;143;508;239;840
431320;201510;934;2522;483;1576;90;310;112;334;202;644
431330;201510;2842;6982;1292;4099;330;1185;105;282;435;1467
431333;201510;454;1221;193;595;26;92;50;131;76;223
431335;201510;63;190;47;155;13;42;11;25;24;67
431337;201510;2451;7436;1789;6051;425;1522;325;1016;750;2538
431339;201510;659;1786;451;1361;77;248;205;598;282;846
431340;201510;26066;68758;18516;55442;4328;14049;5086;14696;9414;28745
431342;201510;549;1413;439;1226;147;448;210;546;357;994
431344;201510;363;1004;265;826;13;40;199;629;212;669
431346;201510;329;838;135;406;25;79;24;67;49;146
431349;201510;728;2077;483;1490;98;305;149;437;247;742
431350;201510;4106;11988;3344;10571;700;2505;1340;3975;2040;6480
431360;201510;709;1796;457;1360;116;364;137;410;253;774
431365;201510;1260;3680;1062;3343;280;951;507;1621;787;2572
431370;201510;5010;14031;3871;12022;1077;3618;1186;3675;2263;7293
431380;201510;951;2926;869;2737;134;477;535;1630;669;2107
431390;201510;3306;8673;1968;6072;385;1343;557;1507;942;2850
431395;201510;1277;3752;1065;3392;239;844;515;1593;754;2437
431400;201510;333;1044;163;557;35;135;25;68;60;203
431402;201510;1309;3055;733;2028;148;436;352;920;500;1356
431403;201510;276;795;193;645;52;188;33;111;85;299
431405;201510;4226;11633;3339;10318;663;2318;1686;5054;2349;7372
431406;201510;797;2426;580;1949;164;592;255;833;419;1425
431407;201510;563;1617;363;1202;84;279;104;307;188;586
431410;201510;14342;41083;9599;31642;2820;10444;1234;3880;4054;14324
431413;201510;231;568;107;335;9;30;36;104;45;134
431415;201510;763;2110;555;1727;129;477;211;579;340;1056
431417;201510;651;1584;519;1393;68;189;306;831;374;1020
431420;201510;1423;3875;1228;3567;264;805;558;1705;822;2510
431430;201510;536;1392;323;966;67;218;109;278;176;496
431440;201510;23599;65709;18998;58127;5518;17874;6415;20479;11933;38353
431442;201510;148;417;92;277;15;52;13;24;28;76
431445;201510;519;1465;224;712;32;97;86;262;118;359
431446;201510;475;1373;326;1058;78;264;107;336;185;600
431447;201510;705;1981;507;1577;110;351;209;654;319;1005
431449;201510;828;2306;645;1969;71;225;382;1166;453;1391
431450;201510;2187;5447;1920;5045;314;900;1331;3401;1645;4301
431454;201510;65;237;56;214;16;65;21;85;37;150
431455;201510;728;1844;376;1074;101;282;94;248;195;530
431460;201510;3490;9624;2927;8533;790;2335;946;2854;1736;5189
431470;201510;1850;5427;1384;4375;335;1054;474;1502;809;2556
431475;201510;184;537;43;168;6;24;1;4;7;28
431477;201510;751;1952;500;1448;60;194;270;741;330;935
431478;201510;272;697;100;298;16;48;21;54;37;102
431480;201510;3112;8553;2269;7014;595;2024;791;2320;1386;4344
431490;201510;113013;304083;95445;277423;12151;41643;65290;184325;77441;225968
431500;201510;723;1960;549;1624;121;359;267;767;388;1126
431505;201510;509;1221;349;991;27;67;239;696;266;763
431507;201510;362;874;224;606;42;106;130;344;172;450
431510;201510;2108;5714;1594;4719;359;1141;601;1621;960;2762
431513;201510;303;820;139;439;19;61;70;217;89;278
431514;201510;104;271;37;129;4;19;2;5;6;24
431515;201510;746;2140;508;1559;113;396;198;508;311;904
431517;201510;82;260;72;234;17;56;22;59;39;115
431520;201510;504;1376;258;830;35;135;43;123;78;258
431530;201510;4323;10217;3243;8926;1114;3290;941;2717;2055;6007
431531;201510;290;821;186;606;38;124;61;197;99;321
431532;201510;521;1450;440;1271;118;368;172;482;290;850
431535;201510;405;1045;179;542;30;100;59;153;89;253
431540;201510;2139;6972;1866;6559;226;806;1185;4369;1411;5175
431545;201510;320;872;48;165;6;20;7;26;13;46
431550;201510;2324;6772;2033;6237;397;1388;931;2731;1328;4119
431555;201510;728;1833;561;1567;91;257;336;943;427;1200
431560;201510;19944;59461;14043;47705;3531;13322;3305;11606;6836;24928
431570;201510;5366;14750;4671;13612;1309;3889;2065;6125;3374;10014
431575;201510;434;1095;300;869;46;155;78;194;124;349
431580;201510;684;1919;424;1339;86;306;143;408;229;714
431590;201510;1007;2738;607;1897;93;283;232;731;325;1014
431595;201510;481;1359;373;1133;60;179;201;620;261;799
431600;201510;2050;5691;1411;4480;320;1219;339;955;659;2174
431610;201510;1491;4326;1091;3533;213;713;447;1443;660;2156
431620;201510;464;1373;230;740;57;197;92;265;149;462
431630;201510;1488;3958;954;2858;263;835;317;897;580;1732
431640;201510;6174;17556;5494;16521;1188;3965;2978;8865;4166;12830
431642;201510;531;1422;417;1221;63;206;202;571;265;777
431643;201510;222;555;149;398;23;65;59;136;82;201
431645;201510;1827;5172;1562;4727;307;1003;863;2586;1170;3589
431647;201510;179;513;113;355;22;76;21;54;43;130
431650;201510;317;969;218;764;33;130;52;155;85;285
431660;201510;1205;3351;727;2337;150;526;172;477;322;1003
431670;201510;1349;3537;990;2884;219;733;409;1083;628;1816
431673;201510;231;638;121;393;25;87;19;52;44;139
431675;201510;644;1731;179;597;29;102;35;92;64;194
431680;201510;10341;27734;7478;22461;2012;6472;1934;5794;3946;12266
431690;201510;24489;67621;18829;58116;5222;17187;6424;20250;11646;37437
431695;201510;137;409;90;289;20;64;19;43;39;107
431697;201510;456;1295;399;1184;100;299;188;575;288;874
431700;201510;1609;4546;1346;4028;238;760;720;2083;958;2843
431710;201510;13010;37215;10382;32802;3308;11225;2504;8339;5812;19564
431720;201510;7359;20118;5525;16531;1202;3939;2031;5868;3233;9807
431725;201510;22;64;12;39;2;5;4;11;6;16
431730;201510;3965;11542;3067;9890;833;2932;796;2629;1629;5561
431740;201510;5367;14874;4198;12695;1360;4531;771;2083;2131;6614
431750;201510;9612;26911;8169;24535;1868;6107;3853;11677;5721;17784
431755;201510;332;911;73;257;12;41;13;42;25;83
431760;201510;4001;11446;3134;9833;713;2440;1094;3246;1807;5686
431770;201510;2113;5593;1733;4986;335;1003;967;2732;1302;3735
431775;201510;217;584;146;448;49;156;18;47;67;203
431780;201510;2479;6645;1845;5442;477;1498;409;1099;886;2597
431790;201510;1276;3907;1055;3469;183;653;593;1970;776;2623
431795;201510;396;1083;242;740;38;126;87;257;125;383
431800;201510;8960;26283;6974;22406;2130;7383;1309;3966;3439;11349
431805;201510;328;791;96;322;16;62;15;48;31;110
431810;201510;3453;9492;2647;7858;512;1649;1139;3286;1651;4935
431820;201510;2700;8346;2304;7562;481;1718;945;2984;1426;4702
431830;201510;10984;26902;8451;23114;2388;7069;3223;8856;5611;15925
431840;201510;2777;8195;2365;7474;597;2044;1027;3242;1624;5286
431842;201510;820;2048;343;1040;48;161;83;209;131;370
431843;201510;357;1040;291;916;38;140;150;454;188;594
431844;201510;263;712;105;340;21;77;23;58;44;135
431845;201510;524;1519;416;1284;35;116;262;817;297;933
431846;201510;375;1124;329;1053;38;147;225;697;263;844
431848;201510;239;644;125;411;14;47;26;78;40;125
431849;201510;450;1102;91;276;19;60;17;38;36;98
431850;201510;4984;14355;4313;13057;1026;3313;1667;4988;2693;8301
431860;201510;807;2102;593;1742;120;391;283;773;403;1164
431861;201510;102;303;53;187;6;21;8;27;14;48
431862;201510;481;1560;382;1361;111;442;95;296;206;738
431870;201510;18984;53584;14527;45664;3691;12631;4660;14481;8351;27112
431880;201510;4426;13030;3431;10914;797;2826;1257;3767;2054;6593
431890;201510;5345;14290;3874;11595;1189;3769;1010;3038;2199;6807
431900;201510;1103;3124;718;2326;190;695;286;833;476;1528
431910;201510;1040;2470;463;1342;77;221;145;383;222;604
431912;201510;622;1758;477;1485;140;416;152;499;292;915
431915;201510;1370;3672;1031;3067;236;736;393;1158;629;1894
431920;201510;1355;3748;1177;3465;131;386;867;2544;998;2930
431930;201510;1278;3479;905;2844;237;727;408;1345;645;2072
431935;201510;64;198;51;170;12;49;19;52;31;101
431936;201510;404;1183;302;959;61;191;139;461;200;652
431937;201510;346;890;192;575;48;155;35;88;83;243
431940;201510;2680;7241;1702;5286;398;1318;444;1335;842;2653
431950;201510;1682;5089;1443;4662;275;995;664;2045;939;3040
431960;201510;3034;8756;2634;7957;681;2174;856;2516;1537;4690
431970;201510;501;1354;247;791;39;150;59;163;98;313
431971;201510;109;306;75;239;7;22;29;79;36;101
431973;201510;497;1701;427;1547;59;213;254;965;313;1178
431975;201510;102;237;18;74;5;25;2;5;7;30
431980;201510;1438;4169;1166;3610;276;916;370;1074;646;1990
431990;201510;7993;21917;5903;18335;1070;3836;1900;5471;2970;9307
432000;201510;10522;28998;8096;24730;2497;8022;2685;8032;5182;16054
432010;201510;2321;6521;1880;5714;409;1326;872;2617;1281;3943
432020;201510;2376;5821;1812;5032;261;789;1202;3285;1463;4074
432023;201510;550;1564;353;1134;69;233;106;317;175;550
432026;201510;1276;3814;920;3032;154;494;478;1573;632;2067
432030;201510;412;1193;307;961;60;191;144;430;204;621
432032;201510;600;1552;390;1165;69;214;177;491;246;705
432035;201510;848;2577;747;2382;285;959;243;785;528;1744
432040;201510;1022;2407;470;1463;100;346;126;356;226;702
432045;201510;240;690;140;487;27;105;52;179;79;284
432050;201510;672;1849;567;1654;97;284;327;988;424;1272
432055;201510;863;2569;685;2225;128;457;383;1201;511;1658
432057;201510;437;1083;326;897;48;132;209;553;257;685
432060;201510;525;1387;196;659;40;150;41;123;81;273
432065;201510;216;614;165;523;40;142;60;177;100;319
432067;201510;1002;3072;718;2443;144;522;350;1190;494;1712
432070;201510;2426;6630;1546;4796;344;1165;351;972;695;2137
432080;201510;3742;10622;3149;9561;1003;3248;1011;3016;2014;6264
432085;201510;322;895;210;709;49;173;96;328;145;501
432090;201510;1509;4306;1171;3607;360;1196;432;1240;792;2436
432100;201510;1355;3895;659;2235;122;419;79;203;201;622
432110;201510;2734;8137;1999;6585;495;1848;266;739;761;2587
432120;201510;5116;14920;4239;13374;1550;5216;1174;3579;2724;8795
432130;201510;2641;7337;2106;6622;733;2556;724;2206;1457;4762
432132;201510;436;1227;206;707;26;104;65;207;91;311
432135;201510;709;2168;668;2088;86;296;495;1520;581;1816
432140;201510;2037;6399;1602;5547;377;1367;669;2406;1046;3773
432143;201510;1429;4152;1186;3729;229;733;562;1839;791;2572
432145;201510;1199;3661;698;2448;135;529;121;378;256;907
432146;201510;209;656;136;480;33;130;32;105;65;235
432147;201510;665;2065;491;1683;136;492;146;506;282;998
432149;201510;374;1053;228;708;48;152;89;279;137;431
432150;201510;3826;10573;2778;8627;615;2137;853;2494;1468;4631
432160;201510;4543;14151;3895;13022;1211;4211;1350;4674;2561;8885
432162;201510;396;953;72;229;11;39;14;35;25;74
432163;201510;406;1073;92;293;5;17;6;20;11;37
432166;201510;729;2135;590;1849;88;328;291;871;379;1199
432170;201510;1066;3311;675;2438;135;503;119;413;254;916
432180;201510;2975;7858;1950;5950;482;1551;487;1436;969;2987
432183;201510;435;1340;340;1138;142;506;63;193;205;699
432185;201510;936;2505;569;1804;114;373;238;753;352;1126
432190;201510;3462;9400;2281;6782;549;1736;655;1783;1204;3519
432195;201510;1246;3358;983;2935;139;446;584;1684;723;2130
432200;201510;3275;9724;2563;8475;639;2327;1121;3719;1760;6046
432210;201510;436;1193;316;992;79;285;126;356;205;641
432215;201510;877;2686;742;2466;137;412;435;1545;572;1957
432218;201510;299;779;202;583;37;108;77;195;114;303
432220;201510;4316;11300;3474;9972;393;1335;2144;5951;2537;7286
432225;201510;70;220;60;203;22;79;19;59;41;138
432230;201510;1101;2938;644;1937;144;474;173;416;317;890
432232;201510;562;1611;434;1361;88;286;163;509;251;795
432234;201510;418;1137;272;803;59;172;89;250;148;422
432235;201510;83;228;38;134;10;42;3;7;13;49
432237;201510;479;1305;438;1240;21;81;332;910;353;991
432240;201510;14210;44600;11851;41344;2008;8199;6818;24385;8826;32584
432250;201510;4933;16640;4418;15592;1507;5826;1375;4796;2882;10622
432252;201510;396;1113;282;921;55;192;152;501;207;693
432253;201510;1347;4221;844;2921;222;838;155;513;377;1351
432254;201510;837;2265;226;748;58;206;31;88;89;294
432255;201510;245;625;128;422;30;104;36;112;66;216
432260;201510;7741;19186;5240;15035;1233;3618;2020;6017;3253;9635
432270;201510;2608;7677;2146;6855;621;2027;786;2597;1407;4624
432280;201510;1385;3775;698;2248;120;418;163;459;283;877
432285;201510;195;609;45;153;8;33;7;18;15;51
432290;201510;579;1706;363;1204;84;290;112;358;196;648
432300;201510;23569;69528;20445;64056;4066;13789;11389;35200;15455;48989
432310;201510;867;2516;691;2218;147;521;364;1133;511;1654
432320;201510;254;644;125;385;27;83;24;59;51;142
432330;201510;316;824;122;405;14;48;8;22;22;70
432335;201510;206;593;86;298;19;67;11;37;30;104
432340;201510;380;917;177;534;32;103;58;166;90;269
432345;201510;681;1887;621;1789;93;342;368;966;461;1308
432350;201510;400;1080;203;669;33;106;57;178;90;284
432360;201510;178;549;36;134;11;48;9;27;20;75
432370;201510;434;1199;339;1008;41;115;214;644;255;759
432375;201510;804;2004;613;1693;82;225;355;988;437;1213
432377;201510;201;651;50;167;9;30;14;33;23;63
432380;201510;866;2881;761;2687;285;1114;286;945;571;2059
500020;201510;2282;6768;1703;5699;375;1490;677;2116;1052;3606
500025;201510;1325;3066;811;2175;94;267;480;1251;574;1518
500060;201510;6838;20109;5408;17687;695;2366;3437;11643;4132;14009
500070;201510;4238;12211;3471;10867;718;2526;1501;4608;2219;7134
500080;201510;1554;4538;1127;3734;308;1130;377;1237;685;2367
500085;201510;2281;5898;1616;4898;184;595;938;2747;1122;3342
500090;201510;2390;6778;1711;5535;357;1193;772;2547;1129;3740
500100;201510;2553;7423;2160;6711;490;1773;922;2670;1412;4443
500110;201510;8730;25202;6846;22245;1121;3958;3485;11871;4606;15829
500124;201510;2034;6495;1739;5999;347;1116;915;3497;1262;4613
500150;201510;1441;3563;998;2830;191;650;425;1003;616;1653
500190;201510;4934;12700;3813;11198;738;2326;2098;6254;2836;8580
500200;201510;2519;6283;1863;5119;387;1155;758;1952;1145;3107
500210;201510;4833;14291;3987;12910;895;3073;1880;6116;2775;9189
500215;201510;1618;4913;1255;4164;215;790;482;1529;697;2319
500220;201510;2957;9197;2414;8234;502;1831;962;3353;1464;5184
500230;201510;2799;6998;1965;5671;478;1510;853;2472;1331;3982
500240;201510;4746;14629;3323;11652;536;2030;1135;4201;1671;6231
500260;201510;2746;7010;2001;5843;320;1049;969;2683;1289;3732
500270;201510;121972;310522;74484;227044;17933;58865;16706;49605;34639;108470
500280;201510;1407;3613;1176;3308;106;326;882;2505;988;2831
500290;201510;4374;10071;2531;7302;527;1723;864;2312;1391;4035
500295;201510;2665;7832;1707;5594;299;1083;415;1137;714;2220
500310;201510;834;2141;686;1923;149;492;333;875;482;1367
500315;201510;3169;9751;2603;8837;399;1402;1588;5576;1987;6978
500320;201510;16877;53551;13185;46490;3822;14657;3903;14318;7725;28975
500325;201510;4093;10384;2924;8542;610;1942;1507;4375;2117;6317
500330;201510;6532;17297;4756;14032;904;2930;2145;6183;3049;9113
500345;201510;2210;5726;1693;4902;334;1056;867;2459;1201;3515
500348;201510;2387;6730;2069;6223;149;539;1511;4479;1660;5018
500350;201510;1262;3759;727;2487;99;369;236;834;335;1203
500370;201510;23359;70041;17310;58664;3887;14789;5122;17155;9009;31944
500375;201510;2925;7965;2129;6438;475;1523;602;1740;1077;3263
500380;201510;3038;8434;2405;7293;672;2128;899;2719;1571;4847
500390;201510;599;1286;355;920;41;128;223;527;264;655
500400;201510;1309;3933;953;3084;227;813;245;689;472;1502
500410;201510;2274;6319;1811;5625;476;1639;812;2509;1288;4148
500430;201510;2501;7091;1933;6255;417;1524;804;2649;1221;4173
500440;201510;1544;4025;1022;3116;181;618;471;1371;652;1989
500450;201510;1751;5224;1267;4250;267;1008;252;719;519;1727
500460;201510;3681;10992;2760;9140;733;2670;642;2003;1375;4673
500470;201510;3078;8925;2069;6727;534;1930;322;918;856;2848
500480;201510;2158;6621;1989;6399;221;694;1469;5048;1690;5742
500490;201510;988;2700;746;2269;212;740;212;626;424;1366
500500;201510;3705;11401;2862;10075;1129;4548;722;2466;1851;7014
500510;201510;855;2205;532;1627;74;248;222;621;296;869
500515;201510;1855;4927;1515;4469;262;814;848;2698;1110;3512
500520;201510;3039;10300;2698;9783;434;1708;1688;6238;2122;7946
500525;201510;1178;3730;935;3253;184;711;413;1477;597;2188
500540;201510;6247;17064;3507;11748;940;3681;513;1449;1453;5130
500560;201510;4674;15188;4225;14489;557;2104;2975;10226;3532;12330
500568;201510;3975;10102;2785;8270;578;2016;1036;2835;1614;4851
500570;201510;7696;20381;4918;15066;1295;4245;1057;3044;2352;7289
500580;201510;3729;10480;2949;9197;302;978;2053;6480;2355;7458
500600;201510;3914;10299;2487;7588;578;1912;800;2349;1378;4261
500620;201510;7762;21910;5713;18023;1137;3944;2498;7838;3635;11782
500625;201510;797;2332;423;1451;89;331;125;419;214;750
500627;201510;525;1537;410;1331;83;277;108;370;191;647
500630;201510;6150;16608;4344;13508;1083;3742;1326;3968;2409;7710
500635;201510;2754;10157;2199;9260;324;1311;1387;6404;1711;7715
500640;201510;1635;3932;1232;3352;95;308;877;2332;972;2640
500660;201510;19114;54319;14566;46855;4278;15569;4407;13874;8685;29443
500690;201510;2817;8001;2217;7223;909;3084;689;2426;1598;5510
500710;201510;3711;10916;3107;9890;692;2500;1390;4307;2082;6807
500720;201510;6092;16063;3760;11885;1019;3527;947;2822;1966;6349
500730;201510;992;2733;684;2108;159;554;213;611;372;1165
500740;201510;4037;11054;3294;9647;427;1544;1506;4479;1933;6023
500750;201510;889;2430;763;2249;136;426;423;1242;559;1668
500755;201510;1229;3555;832;2705;177;638;211;551;388;1189
500769;201510;5125;13521;2970;9003;514;1755;662;1664;1176;3419
500770;201510;1730;5030;1250;4131;312;1118;342;1144;654;2262
500780;201510;1128;3236;900;2799;236;787;281;809;517;1596
500790;201510;9366;25686;7709;22842;1371;4668;4243;12144;5614;16812
500793;201510;2289;6507;1739;5539;447;1547;491;1389;938;2936
500795;201510;2478;7253;2086;6700;266;729;1473;5035;1739;5764
500797;201510;862;2304;595;1833;103;334;222;643;325;977
500800;201510;2762;7445;2134;6554;812;2835;605;1843;1417;4678
500830;201510;18897;50690;12715;38807;2583;8671;4143;11881;6726;20552
500840;201510;1320;3661;897;2801;114;383;379;1118;493;1501
510010;201510;1262;3746;1039;3379;278;916;497;1642;775;2558
510020;201510;3451;9805;2130;7077;472;1695;567;1741;1039;3436
510025;201510;8021;23085;6303;19904;1490;5168;2192;6329;3682;11497
510030;201510;1748;4705;1412;4169;300;999;666;1859;966;2858
510035;201510;863;2418;674;2152;135;437;375;1225;510;1662
510040;201510;1734;4683;1316;4053;222;754;696;2151;918;2905
510050;201510;1881;5408;1317;4333;349;1246;378;1209;727;2455
510060;201510;1631;4614;1184;3751;229;765;470;1436;699;2201
510080;201510;1144;3548;882;3027;269;1043;168;497;437;1540
510100;201510;676;1803;474;1393;57;188;213;582;270;770
510120;201510;316;669;198;518;20;56;121;318;141;374
510125;201510;3147;8234;2377;6849;414;1441;988;2565;1402;4006
510130;201510;1879;5080;1495;4432;404;1257;512;1504;916;2761
510140;201510;2943;9340;2327;8369;954;3852;520;1608;1474;5460
510160;201510;1362;4505;1243;4334;177;691;846;2924;1023;3615
510170;201510;5425;16146;4397;14340;834;3031;2061;6440;2895;9471
510180;201510;12203;31654;8459;25725;2418;7719;2650;8899;5068;16618
510185;201510;1372;3985;1109;3633;153;477;733;2624;886;3101
510190;201510;2263;6587;1541;5474;342;1327;699;2574;1041;3901
510250;201510;14100;42471;11853;39128;3505;12549;4499;15203;8004;27752
510260;201510;2243;8979;1918;8284;542;2413;826;4015;1368;6428
510263;201510;4288;11293;3036;9194;740;2379;886;2519;1626;4898
510267;201510;5873;16845;4114;13089;939;3251;1159;3450;2098;6701
510268;201510;849;2490;722;2292;150;511;406;1276;556;1787
510269;201510;1010;3082;747;2562;242;866;190;655;432;1521
510270;201510;2689;8639;2255;7740;400;1398;1003;3419;1403;4817
510279;201510;1982;6053;1603;5194;430;1516;466;1325;896;2841
510285;201510;1343;3923;1039;3384;284;1003;348;1078;632;2081
510300;201510;3327;9686;2747;8843;210;794;2074;6697;2284;7491
510305;201510;1571;4774;1202;4054;301;1102;403;1308;704;2410
510310;201510;839;2508;709;2259;222;753;233;694;455;1447
510320;201510;3444;9888;2654;8387;679;2507;707;2053;1386;4560
510325;201510;5286;16564;4447;15410;1216;4348;2585;9253;3801;13601
510330;201510;2796;8706;2207;7648;569;2189;748;2551;1317;4740
510335;201510;4848;14533;3939;13366;538;1771;2785;10019;3323;11790
510336;201510;597;1795;452;1517;82;298;227;749;309;1047
510337;201510;2174;7055;1730;6157;674;2524;308;1080;982;3604
510340;201510;75741;202526;52081;165315;17650;61942;9928;32459;27578;94401
510343;201510;1120;3213;929;2900;102;345;682;2161;784;2506
510345;201510;1671;4886;1336;4280;348;1189;472;1454;820;2643
510350;201510;3378;9125;2564;7951;635;2091;1143;3662;1778;5753
510360;201510;1788;4381;1141;3578;130;495;783;2387;913;2882
510370;201510;1162;3859;986;3568;207;766;589;2220;796;2986
510380;201510;564;1690;376;1308;131;495;47;135;178;630
510385;201510;985;3671;727;3080;98;443;338;1555;436;1998
510390;201510;1128;3455;1029;3324;280;723;637;2328;917;3051
510395;201510;747;1842;544;1555;87;265;230;758;317;1023
510410;201510;3818;12347;3367;11436;825;2950;1720;5910;2545;8860
510420;201510;2426;6127;1749;4996;204;731;898;2504;1102;3235
510450;201510;644;1662;448;1368;103;353;151;442;254;795
510452;201510;631;2029;447;1606;96;391;201;688;297;1079
510454;201510;851;2684;726;2436;116;419;455;1556;571;1975
510455;201510;976;2988;716;2443;140;545;230;744;370;1289
510460;201510;2262;5916;1721;5137;228;829;985;2768;1213;3597
510480;201510;4619;12138;3188;9483;725;2267;761;2107;1486;4374
510490;201510;1627;5050;1353;4616;279;1074;736;2423;1015;3497
510500;201510;1524;4518;1035;3534;252;991;404;1301;656;2292
510510;201510;2722;9373;2334;8657;743;3005;759;2753;1502;5758
510515;201510;6183;18677;4513;14967;1008;3693;1071;3307;2079;7000
510517;201510;1722;5098;1397;4478;446;1494;412;1270;858;2764
510520;201510;2145;4997;1537;4222;75;226;1067;3098;1142;3324
510523;201510;1027;3022;894;2806;143;451;599;1937;742;2388
510525;201510;8023;20609;5246;16094;1098;3486;1954;5934;3052;9420
510530;201510;518;1447;429;1319;52;228;263;760;315;988
510550;201510;2602;8548;2160;7702;618;2363;719;2522;1337;4885
510558;201510;1965;5578;1630;5091;338;1157;803;2569;1141;3726
510560;201510;1670;5092;1083;4066;313;1286;232;861;545;2147
510562;201510;5414;15878;4181;13390;1196;4219;1110;3529;2306;7748
510590;201510;3097;8208;2528;7473;554;1658;1336;4094;1890;5752
510600;201510;1574;4064;1043;3173;188;604;420;1208;608;1812
510610;201510;2854;8160;2371;7426;174;626;1738;5414;1912;6040
510615;201510;2272;6805;1891;6177;549;1921;863;2840;1412;4761
510617;201510;602;1812;494;1620;40;120;392;1338;432;1458
510618;201510;1438;4196;1021;3365;185;705;450;1429;635;2134
510619;201510;838;2296;484;1612;67;246;61;157;128;403
510620;201510;1497;3656;797;2554;202;726;119;348;321;1074
510621;201510;901;3153;795;2926;208;849;250;873;458;1722
510622;201510;3881;11691;2619;8951;701;2593;345;948;1046;3541
510623;201510;3470;9818;2745;8472;728;2450;1049;3037;1777;5487
510624;201510;1406;4198;963;3254;204;783;269;790;473;1573
510625;201510;2175;6132;1642;5219;435;1527;356;1085;791;2612
510626;201510;1542;4110;997;3331;310;1171;290;956;600;2127
510627;201510;746;2103;486;1549;118;416;105;312;223;728
510628;201510;1618;3949;1135;3298;110;347;809;2348;919;2695
510629;201510;1783;5670;1433;4914;432;1671;444;1418;876;3089
510630;201510;2545;8575;1863;7106;471;2006;358;1350;829;3356
510631;201510;380;1071;338;1007;41;117;253;751;294;868
510637;201510;2710;7865;2320;7228;668;2229;918;2843;1586;5072
510642;201510;4678;15295;4019;14335;1187;4649;1758;6448;2945;11097
510645;201510;973;2191;598;1667;184;496;172;518;356;1014
510650;201510;6282;20889;5639;20105;1378;5166;3440;12708;4818;17874
510665;201510;1390;3742;911;2837;222;727;300;913;522;1640
510670;201510;399;895;209;621;21;83;103;287;124;370
510675;201510;6415;19985;5076;17298;1432;5524;1232;3968;2664;9492
510677;201510;2085;5459;1650;4902;200;605;1219;3785;1419;4390
510680;201510;762;2266;584;1898;128;456;182;526;310;982
510682;201510;2243;6975;1710;5954;451;1798;350;1081;801;2879
510685;201510;950;2539;774;2301;98;331;503;1467;601;1798
510700;201510;4322;11162;2911;9127;634;2077;1432;4595;2066;6672
510704;201510;9295;24669;7557;21912;1493;4819;3873;10921;5366;15740
510706;201510;1952;5766;1363;4851;311;1140;701;2599;1012;3739
510710;201510;3458;9539;2388;7333;569;1844;575;1553;1144;3397
510715;201510;709;1741;445;1263;96;297;161;421;257;718
510718;201510;2289;5689;1506;4776;708;2328;396;1372;1104;3700
510719;201510;438;1002;276;789;30;124;133;356;163;480
510720;201510;1154;2737;889;2393;234;699;403;991;637;1690
510724;201510;774;2304;628;2031;147;534;294;880;441;1414
510726;201510;620;1605;463;1343;97;297;182;488;279;785
510729;201510;758;1885;445;1318;97;322;165;471;262;793
510730;201510;2661;7781;2087;6747;550;1955;668;2044;1218;3999
510735;201510;1094;3594;849;3184;191;811;415;1548;606;2359
510740;201510;1107;2722;802;2263;196;520;408;1209;604;1729
510757;201510;683;2300;558;2040;198;735;177;660;375;1395
510760;201510;29991;77793;20102;61003;5791;19058;5020;14708;10811;33766
510770;201510;4345;11165;3688;10385;368;1013;2461;7667;2829;8680
510774;201510;414;1138;350;1033;72;249;166;507;238;756
510775;201510;738;2136;604;1908;193;675;163;470;356;1145
510776;201510;550;1525;416;1241;88;293;188;543;276;836
510777;201510;1602;4749;1208;4198;172;638;907;3190;1079;3828
510779;201510;682;1998;503;1656;77;264;243;816;320;1080
510780;201510;3640;10894;2995;9852;765;2633;1251;4290;2016;6923
510785;201510;1846;5254;1375;4441;451;1522;324;1038;775;2560
510787;201510;2229;6683;1741;5819;636;2246;371;1182;1007;3428
510788;201510;540;1400;382;1165;168;528;92;298;260;826
510790;201510;15866;45670;10420;35079;2296;8847;1251;3966;3547;12813
510792;201510;7853;23383;5246;18175;1104;4314;886;2747;1990;7061
510794;201510;1204;3790;983;3367;342;1290;289;907;631;2197
510795;201510;8385;24839;6017;20304;1580;5832;1374;4712;2954;10544
510800;201510;1637;4573;1313;4094;304;1052;551;1566;855;2618
510805;201510;1924;5319;1528;4727;238;790;985;3052;1223;3842
510810;201510;682;1659;516;1432;149;423;228;608;377;1031
510820;201510;767;1821;515;1436;96;311;200;487;296;798
510830;201510;693;2159;580;1981;158;596;282;1024;440;1620
510835;201510;647;1951;481;1615;123;458;178;548;301;1006
510840;201510;49574;120988;38205;106181;9204;26931;18035;51373;27239;78304
510850;201510;1527;4323;1099;3552;332;1192;184;476;516;1668
510860;201510;2543;8122;1845;6670;743;2921;98;308;841;3229
510880;201510;667;2179;566;2003;181;701;223;802;404;1503
510885;201510;635;1769;505;1592;102;361;196;605;298;966
510890;201510;891;2752;721;2481;214;830;287;904;501;1734
510895;201510;1107;3413;928;3063;238;898;366;1123;604;2021
520005;201510;1377;4386;1220;4153;332;1191;580;2008;912;3199
520010;201510;1666;5559;1344;4881;516;2170;267;827;783;2997
520013;201510;3558;9815;2594;8012;593;1930;920;2800;1513;4730
520015;201510;444;1289;360;1155;85;293;139;446;224;739
520017;201510;1095;3247;910;2938;237;856;358;1068;595;1924
520020;201510;415;1092;319;956;66;211;144;412;210;623
520025;201510;25551;79218;24224;77603;2689;9312;19378;61948;22067;71260
520030;201510;4572;14164;3820;12900;781;2912;1816;6140;2597;9052
520050;201510;387;982;265;778;22;58;177;536;199;594
520055;201510;730;2208;634;2008;115;359;333;1078;448;1437
520060;201510;1385;4269;1178;3848;255;956;458;1419;713;2375
520080;201510;1774;5248;1511;4879;320;1017;845;2898;1165;3915
520082;201510;1001;2820;886;2631;143;393;573;1786;716;2179
520085;201510;993;2971;830;2647;190;602;266;840;456;1442
520090;201510;982;2243;712;1903;164;410;362;1050;526;1460
520110;201510;41878;120747;32089;105556;11576;43119;6043;18944;17619;62063
520120;201510;198;554;132;434;33;134;32;101;65;235
520130;201510;3433;9645;3104;9142;791;2568;1453;4235;2244;6803
520140;201510;38821;124530;33047;113444;11170;42061;6734;21829;17904;63890
520145;201510;378;994;278;824;66;205;110;312;176;517
520150;201510;507;1326;398;1199;60;204;249;748;309;952
520160;201510;801;2249;649;2019;206;669;190;592;396;1261
520170;201510;4167;9633;3262;8605;298;831;2588;6926;2886;7757
520180;201510;2047;5977;1663;5355;356;1352;706;2182;1062;3534
520215;201510;1896;4880;1576;4372;207;595;979;2730;1186;3325
520235;201510;708;1829;521;1552;112;377;217;607;329;984
520250;201510;1365;4115;1047;3552;271;1041;284;897;555;1938
520260;201510;790;2007;522;1503;78;244;215;584;293;828
520280;201510;505;1501;460;1440;164;541;164;579;328;1120
520310;201510;1202;2851;851;2295;230;664;301;855;531;1519
520320;201510;1787;5562;1462;4926;153;547;916;3145;1069;3692
520330;201510;2627;8104;1957;6880;517;1966;333;1082;850;3048
520340;201510;1849;4588;1436;4074;226;565;944;2874;1170;3439
520350;201510;3093;8442;2385;7132;597;2003;975;2752;1572;4755
520355;201510;1050;3513;941;3336;311;1209;355;1196;666;2405
520357;201510;803;2134;666;1918;49;159;481;1366;530;1525
520360;201510;682;1950;587;1794;132;433;253;780;385;1213
520380;201510;1308;3492;861;2629;146;479;346;1028;492;1507
520390;201510;1030;2436;616;1888;176;626;214;580;390;1206
520393;201510;495;1240;387;1083;55;166;235;639;290;805
520396;201510;737;2343;618;2112;75;299;389;1298;464;1597
520400;201510;1708;4833;1446;4460;234;771;909;2759;1143;3530
520410;201510;1387;3447;1044;2973;213;664;581;1640;794;2304
520420;201510;320;892;227;688;46;147;65;175;111;322
520425;201510;1121;3051;935;2728;255;785;451;1306;706;2091
520430;201510;2022;5272;1268;3867;281;943;400;1092;681;2035
520440;201510;3713;9473;2455;7255;736;2363;532;1539;1268;3902
520450;201510;10385;28841;7119;22679;1600;5544;833;2363;2433;7907
520455;201510;688;2028;549;1784;158;558;171;548;329;1106
520460;201510;863;2464;703;2190;133;481;358;1062;491;1543
520465;201510;798;2235;688;2102;115;375;414;1263;529;1638
520470;201510;1740;5591;1556;5297;373;1290;939;3352;1312;4642
520480;201510;973;2789;721;2356;128;459;333;1009;461;1468
520485;201510;1230;3901;1057;3609;280;1079;567;1906;847;2985
520490;201510;3875;12118;3082;10855;927;3388;1328;4822;2255;8210
520495;201510;1257;3434;1097;3226;97;293;899;2689;996;2982
520500;201510;1406;3888;1162;3530;318;1044;478;1420;796;2464
520505;201510;829;2269;682;2052;161;491;344;1038;505;1529
520510;201510;9586;26802;6662;21974;1724;6247;1999;6708;3723;12955
520520;201510;1083;2998;849;2651;266;867;279;874;545;1741
520530;201510;1998;6520;1677;5952;581;2073;521;1958;1102;4031
520540;201510;2904;8143;2177;6794;571;1891;496;1500;1067;3391
520545;201510;1111;3325;906;2909;194;672;293;879;487;1551
520547;201510;709;2242;611;2055;214;744;194;606;408;1350
520549;201510;9730;28130;8007;25846;2347;7945;3740;12196;6087;20141
520551;201510;3467;10498;3187;10097;893;3116;1836;5738;2729;8854
520552;201510;776;2312;697;2202;102;350;477;1527;579;1877
520570;201510;539;1538;385;1269;155;544;84;253;239;797
520580;201510;3264;8122;2191;6562;624;2100;868;2515;1492;4615
520590;201510;1423;3973;1101;3408;250;797;266;747;516;1544
520620;201510;7233;22443;6538;21422;1623;5585;3598;11907;5221;17492
520630;201510;761;1972;557;1672;129;388;249;751;378;1139
520640;201510;2835;7837;2298;6933;647;2015;886;2724;1533;4739
520650;201510;843;2265;631;1866;146;475;301;872;447;1347
520660;201510;348;992;272;880;95;335;89;287;184;622
520670;201510;869;2591;785;2472;49;173;664;2094;713;2267
520680;201510;647;1761;515;1574;132;405;229;714;361;1119
520690;201510;373;967;262;805;59;157;116;384;175;541
520710;201510;543;1396;326;957;6;15;198;572;204;587
520725;201510;1626;4114;1217;3467;231;712;712;2006;943;2718
520735;201510;766;2163;555;1750;137;488;169;503;306;991
520740;201510;1625;4539;1304;4113;248;870;677;2095;925;2965
520750;201510;601;1614;476;1423;94;273;247;773;341;1046
520753;201510;1302;3665;1193;3504;149;419;837;2585;986;3004
520760;201510;862;2317;748;2159;104;313;527;1570;631;1883
520780;201510;1924;4651;1542;4134;176;443;1040;2799;1216;3242
520790;201510;2709;7132;2182;6371;251;715;1540;4645;1791;5360
520800;201510;15579;45081;13518;42595;2873;8718;8179;27536;11052;36254
520810;201510;1039;2575;831;2324;139;382;579;1719;718;2101
520815;201510;568;1818;419;1509;161;656;17;46;178;702
520830;201510;1534;4087;1265;3800;47;147;1063;3196;1110;3343
520840;201510;1472;4739;1206;4250;392;1545;245;872;637;2417
520850;201510;606;1844;453;1562;110;423;174;572;284;995
520860;201510;6642;19043;4825;16044;1231;4378;1685;5673;2916;10051
520870;201510;110675;292492;73742;229980;20266;69854;17367;50945;37633;120799
520880;201510;7198;20465;5244;17447;1666;6241;769;2451;2435;8692
520890;201510;3764;10616;3042;9410;641;2157;1465;4527;2106;6684
520910;201510;3814;11100;2745;8985;900;3145;505;1589;1405;4734
520915;201510;761;2176;589;1857;132;437;254;773;386;1210
520920;201510;3339;9022;2312;7334;526;1794;767;2493;1293;4287
520929;201510;518;1427;390;1229;77;239;222;723;299;962
520940;201510;1036;3026;855;2754;95;357;602;1919;697;2276
520945;201510;734;1720;574;1448;183;412;243;621;426;1033
520960;201510;929;2750;735;2371;83;272;355;1173;438;1445
520970;201510;3187;9431;2627;8408;636;2248;785;2401;1421;4649
520980;201510;768;2207;690;2097;248;815;308;914;556;1729
520990;201510;2923;9460;2751;9210;473;1666;1849;6405;2322;8071
520993;201510;1019;2612;816;2312;64;196;573;1633;637;1829
520995;201510;2408;6388;2109;6024;368;1013;1430;4188;1798;5201
521000;201510;6899;20772;5714;18633;1491;5447;1839;5650;3330;11097
521010;201510;3974;11537;3048;9796;733;2495;1066;3469;1799;5964
521015;201510;671;1854;564;1680;148;422;257;777;405;1199
521020;201510;3544;10056;2310;7515;632;2178;272;831;904;3009
521030;201510;703;1751;539;1465;110;289;238;668;348;957
521040;201510;5856;15812;4931;14424;1763;5300;1853;5729;3616;11029
521056;201510;867;2645;721;2397;246;867;258;904;504;1771
521060;201510;1307;3439;1044;3039;238;667;464;1426;702;2093
521080;201510;1227;2895;734;2078;95;342;283;648;378;990
521090;201510;2942;7855;2262;6961;681;2184;721;2278;1402;4462
521100;201510;1872;4159;1465;3722;284;647;955;2613;1239;3260
521120;201510;4372;12007;3540;10829;901;2968;1443;4429;2344;7397
521130;201510;1025;2771;776;2299;122;434;437;1252;559;1686
521140;201510;1016;3116;833;2753;233;808;265;876;498;1684
521150;201510;13002;33067;8039;23737;2771;8703;1822;5309;4593;14012
521160;201510;842;1988;509;1411;104;300;217;581;321;881
521170;201510;1215;2907;910;2468;192;557;505;1319;697;1876
521180;201510;6493;21246;5807;19973;1914;7024;1640;5664;3554;12688
521190;201510;9558;27025;6311;21094;1667;5973;1503;4985;3170;10958
521200;201510;753;1989;624;1779;79;254;379;1043;458;1297
521205;201510;576;1639;437;1387;45;159;241;752;286;911
521210;201510;944;2595;617;1941;196;717;155;375;351;1092
521220;201510;4055;10683;3064;9324;911;3007;1145;3461;2056;6468
521225;201510;367;902;296;823;33;80;213;629;246;709
521230;201510;1192;3747;1085;3533;347;1220;535;1691;882;2911
521250;201510;27724;88412;24600;83516;10210;36951;6866;23373;17076;60324
521260;201510;712;1738;582;1547;92;316;362;882;454;1198
521270;201510;1849;5469;1693;5246;145;362;1317;4284;1462;4646
521280;201510;1870;5655;1502;4926;441;1523;426;1352;867;2875
521290;201510;501;1412;378;1219;102;374;154;476;256;850
521295;201510;1114;2849;954;2626;128;375;714;2005;842;2380
521300;201510;1993;5525;1666;4990;267;775;960;2943;1227;3718
521305;201510;781;2179;630;1933;119;339;347;1109;466;1448
521308;201510;4496;13184;3501;11204;921;3021;1353;4265;2274;7286
521310;201510;7699;22763;5550;18542;1428;5220;1172;3606;2600;8826
521340;201510;261;699;238;665;17;45;186;520;203;565
521350;201510;1909;5242;1588;4749;232;677;1046;3247;1278;3924
521370;201510;959;2825;742;2444;235;844;186;589;421;1433
521375;201510;1261;3746;1041;3326;231;817;472;1401;703;2218
521377;201510;1078;2738;999;2653;77;151;867;2385;944;2536
521380;201510;5181;14700;3690;11853;676;2330;830;2740;1506;5070
521385;201510;493;1354;439;1284;107;338;237;684;344;1022
521390;201510;902;2432;693;2151;177;637;217;648;394;1285
521400;201510;2132;5943;1925;5684;245;807;1475;4370;1720;5177
521405;201510;1378;3864;1066;3296;282;938;472;1458;754;2396
521410;201510;702;2142;641;2044;233;707;283;983;516;1690
521440;201510;1372;3925;1200;3540;171;568;625;1623;796;2191
521450;201510;4140;13117;3299;11463;1072;3986;638;2104;1710;6090
521460;201510;6492;18903;5447;17106;1380;4691;2564;7913;3944;12604
521470;201510;707;1999;516;1620;109;373;87;256;196;629
521480;201510;409;1212;280;918;63;210;100;318;163;528
521483;201510;2846;7418;2174;6259;587;1740;645;1794;1232;3534
521486;201510;1549;3951;1289;3571;115;322;963;2672;1078;2994
521487;201510;624;1595;429;1267;128;393;75;212;203;605
521490;201510;774;2268;629;2026;65;289;402;1237;467;1526
521500;201510;1335;4222;1026;3529;198;765;296;873;494;1638
521520;201510;897;2117;676;1821;184;508;307;880;491;1388
521523;201510;12611;45920;11894;44600;4325;17642;1573;6576;5898;24218
521525;201510;1045;2715;902;2522;121;399;594;1601;715;2000
521530;201510;1668;4722;1002;3348;232;820;165;504;397;1324
521540;201510;945;2524;635;1989;149;552;203;589;352;1141
521550;201510;1166;2972;901;2466;224;660;432;1140;656;1800
521560;201510;3845;12648;3269;11807;1242;4944;1086;3804;2328;8748
521565;201510;641;1596;536;1467;86;208;350;983;436;1191
521570;201510;4559;12606;2952;9363;699;2445;708;2168;1407;4613
521580;201510;578;1323;381;1044;98;284;122;308;220;592
521590;201510;692;1916;563;1704;170;561;121;358;291;919
521600;201510;531;1438;381;1179;103;336;97;268;200;604
521630;201510;1437;3590;1019;2977;251;861;200;486;451;1347
521640;201510;2021;5165;1549;4513;450;1350;626;1899;1076;3249
521645;201510;599;1752;456;1427;77;263;169;481;246;744
521680;201510;1456;4617;1217;4132;574;2107;192;588;766;2695
521690;201510;570;1662;498;1536;121;437;224;620;345;1057
521710;201510;2643;8137;2213;7258;486;1661;900;2946;1386;4607
521720;201510;1861;5242;1513;4634;324;984;824;2461;1148;3445
521730;201510;3673;11995;3197;11032;1178;4510;709;2148;1887;6658
521740;201510;3502;9493;2709;8373;768;2568;1135;3710;1903;6278
521760;201510;12782;41681;11223;38923;2781;10569;4877;16929;7658;27498
521770;201510;2705;7828;2153;6777;779;2624;556;1638;1335;4262
521800;201510;7303;21735;6271;19982;1922;6568;2307;7533;4229;14101
521805;201510;893;2033;638;1662;153;359;344;975;497;1334
521810;201510;868;2191;631;1835;141;440;274;813;415;1253
521830;201510;5203;16472;4645;15641;798;2943;3008;10085;3806;13028
521839;201510;729;1994;545;1651;102;334;185;535;287;869
521850;201510;6871;18524;5218;15541;1284;4020;1602;4359;2886;8379
521860;201510;1906;5234;1454;4497;337;1146;435;1303;772;2449
521870;201510;524;1732;427;1508;115;433;115;378;230;811
521878;201510;737;2138;521;1685;89;324;222;680;311;1004
521880;201510;25074;63433;16089;48650;4155;13488;4980;15174;9135;28662
521890;201510;3503;10364;2707;8801;803;2821;596;1841;1399;4662
521900;201510;1380;3643;1005;3103;246;810;355;995;601;1805
521910;201510;967;2638;861;2510;145;445;520;1577;665;2022
521920;201510;329;987;277;890;92;338;68;182;160;520
521925;201510;658;2003;546;1794;104;382;203;614;307;996
521930;201510;3706;11879;3181;10820;1002;3579;657;2220;1659;5799
521935;201510;617;1764;539;1622;156;467;240;714;396;1181
521940;201510;1033;2843;832;2524;206;680;382;1123;588;1803
521945;201510;657;2121;596;2032;109;367;370;1352;479;1719
521950;201510;617;1647;492;1457;77;244;291;877;368;1121
521960;201510;717;2130;580;1872;121;434;252;790;373;1224
521970;201510;2516;6835;2143;6367;241;681;1620;4998;1861;5679
521971;201510;1079;2862;758;2257;150;455;197;545;347;1000
521973;201510;919;2859;752;2541;165;603;279;915;444;1518
521975;201510;12464;33995;11471;32812;2020;6073;7952;22651;9972;28724
521980;201510;1935;5531;1681;5223;262;712;1287;4173;1549;4885
521990;201510;1100;3123;915;2839;103;356;594;1867;697;2223
522000;201510;2339;6339;1686;5507;239;862;946;3194;1185;4056
522005;201510;395;963;262;751;81;222;87;264;168;486
522010;201510;3251;9376;2690;8426;939;3057;608;1893;1547;4950
522015;201510;900;2666;752;2427;175;564;377;1226;552;1790
522020;201510;5191;13486;4088;11857;951;2827;2089;6021;3040;8848
522026;201510;618;1662;443;1447;118;429;151;506;269;935
522028;201510;521;1508;425;1292;71;221;259;780;330;1001
522040;201510;2445;5927;1847;5174;405;1167;1066;2998;1471;4165
522045;201510;15016;48856;12258;43012;3588;13789;2268;7663;5856;21452
522050;201510;1129;3193;843;2655;217;729;265;734;482;1463
522060;201510;2704;8005;2091;7053;596;2240;942;3106;1538;5346
522068;201510;1627;5121;1486;4959;157;461;1160;4074;1317;4535
522070;201510;766;2291;686;2165;83;325;480;1506;563;1831
522100;201510;590;1728;515;1615;189;668;203;596;392;1264
522108;201510;894;2719;750;2500;67;275;562;1834;629;2109
522119;201510;1373;4206;1155;3854;270;963;533;1809;803;2772
522130;201510;364;1025;301;954;93;313;176;556;269;869
522140;201510;17841;48926;14296;42897;4137;13344;4387;12474;8524;25818
522145;201510;795;2224;702;2074;288;878;216;666;504;1544
522150;201510;882;2461;761;2257;214;644;283;821;497;1465
522155;201510;798;2253;695;2093;132;360;444;1404;576;1764
522157;201510;693;1928;588;1775;50;182;462;1382;512;1564
522160;201510;5955;16857;4194;13571;1275;4615;449;1309;1724;5924
522170;201510;3059;8553;2465;7549;811;2574;599;1863;1410;4437
522180;201510;320;919;247;793;78;271;77;253;155;524
522185;201510;15219;43760;12625;40378;3275;11070;6836;21991;10111;33061
522190;201510;931;2299;702;1964;108;320;366;1052;474;1372
522200;201510;1660;5277;1373;4669;369;1378;387;1230;756;2608
522205;201510;1433;4049;1156;3593;271;902;544;1645;815;2547
522220;201510;1356;3644;1079;3301;268;814;535;1797;803;2611
522230;201510;1206;3412;1030;3132;118;414;651;1961;769;2375
530010;201510;231897;724237;203401;672151;55856;204475;68463;219089;124319;423564
110001;201509;3842;12101;3168;11043;701;2581;1634;5712;2335;8293
110002;201509;13131;39088;10440;34244;3059;10956;3695;11790;6754;22746
110003;201509;797;2530;705;2361;202;710;178;553;380;1263
110004;201509;10096;31722;8186;27738;2602;9529;1853;6198;4455;15727
110005;201509;1811;5765;1597;5353;533;1844;651;2163;1184;4007
110006;201509;2025;6111;1368;4812;405;1557;225;656;630;2213
110007;201509;1358;4124;1266;3982;339;1152;548;1923;887;3075
110008;201509;2400;8071;2254;7858;390;1264;1595;5823;1985;7087
110009;201509;4623;13883;3700;12377;1047;3868;1329;4289;2376;8157
110010;201509;7678;22556;6688;21258;1726;5355;3500;12161;5226;17516
110011;201509;8025;24520;6745;22044;2183;7562;2408;7692;4591;15254
110012;201509;14170;42464;11746;37963;3625;12294;3597;11620;7222;23914
110013;201509;5340;16791;4420;15202;1568;5589;1376;4898;2944;10487
110014;201509;4192;12234;3590;11261;890;2917;1902;5966;2792;8883
110015;201509;4990;14873;3643;12344;1090;4035;903;2950;1993;6985
110018;201509;4268;11921;3222;10452;844;3101;1269;3887;2113;6988
110020;201509;59403;165653;44975;145773;10032;34372;21966;72977;31998;107349
110025;201509;4359;12556;3556;11069;653;2147;2154;6640;2807;8787
110026;201509;650;2002;599;1926;147;475;349;1134;496;1609
110028;201509;7535;21579;5325;17536;1414;5107;809;2483;2223;7590
110029;201509;1343;3978;1130;3605;335;1108;452;1458;787;2566
110030;201509;10512;28444;7939;24817;2027;6914;3386;10665;5413;17579
110032;201509;4019;12632;3499;11575;1110;3800;1161;3782;2271;7582
110033;201509;5377;17055;4850;16157;1510;5026;2029;7103;3539;12129
110034;201509;3441;9214;2925;8544;721;2117;1814;5298;2535;7415
110037;201509;2049;6830;1715;6161;447;1723;774;2728;1221;4451
110040;201509;3506;10955;3028;10066;909;3257;1261;4054;2170;7311
110045;201509;5141;16666;4443;15776;1392;5359;2244;7923;3636;13282
110050;201509;1677;5363;1428;4917;428;1536;678;2340;1106;3876
110060;201509;823;2702;678;2405;228;917;178;587;406;1504
110070;201509;1996;6630;1869;6364;521;1948;938;3090;1459;5038
110080;201509;4053;11428;3600;10898;543;1578;2661;8347;3204;9925
110090;201509;758;2244;606;1967;154;574;270;806;424;1380
110092;201509;1314;4374;1223;4262;197;735;817;2910;1014;3645
110094;201509;3494;10585;3132;10064;1000;3394;1389;4452;2389;7846
110100;201509;2221;7009;1990;6585;645;2239;909;2958;1554;5197
110110;201509;1661;5278;1504;5065;614;2126;452;1562;1066;3688
110120;201509;1816;5801;1410;4893;424;1530;313;1063;737;2593
110130;201509;2541;7330;1906;6232;638;2223;448;1411;1086;3634
110140;201509;2461;8080;2099;7370;509;1920;888;3059;1397;4979
110143;201509;1273;4007;987;3506;293;1079;433;1551;726;2630
110145;201509;1032;2953;840;2636;211;730;445;1363;656;2093
110146;201509;420;1288;365;1205;72;238;210;713;282;951
110147;201509;782;2249;612;1950;160;535;225;644;385;1179
110148;201509;1264;3798;921;3058;264;924;173;535;437;1459
110149;201509;3367;10106;2718;9011;858;2860;1221;4188;2079;7048
110150;201509;2451;7182;2093;6640;579;1948;801;2569;1380;4517
110155;201509;853;2624;758;2387;191;648;358;1069;549;1717
110160;201509;2003;6317;1650;5634;588;2070;582;1954;1170;4024
110170;201509;2960;8285;2158;6800;467;1535;1106;3424;1573;4959
110175;201509;1714;5141;1321;4630;217;813;758;2755;975;3568
110180;201509;1416;4137;1173;3765;273;875;683;2234;956;3109
120001;201509;2779;9646;2586;9316;511;1940;1621;5977;2132;7917
120005;201509;1530;6334;1441;6162;154;737;1095;4799;1249;5536
120010;201509;4495;15524;4257;15146;642;2228;3118;11419;3760;13647
120013;201509;1754;6968;1675;6849;392;1559;1013;4393;1405;5952
120017;201509;2026;7287;1875;7010;516;1978;860;3512;1376;5490
120020;201509;13969;62217;13487;61247;2097;9661;9518;44700;11615;54361
120025;201509;2487;8624;2392;8485;458;1735;1548;5547;2006;7282
120030;201509;6013;23778;5882;23629;266;1161;5310;21501;5576;22662
120032;201509;1442;6941;1379;6787;182;1066;993;4900;1175;5966
120033;201509;3529;14041;3449;13896;331;1325;2946;12069;3277;13394
120034;201509;1995;8286;1924;8167;171;892;1574;6615;1745;7507
120035;201509;2915;13560;2860;13446;228;1197;2413;11453;2641;12650
120038;201509;2675;9708;2543;9452;635;2404;1369;5225;2004;7629
120039;201509;1601;8188;1563;8098;166;957;1195;6274;1361;7231
120040;201509;44843;159736;40516;151168;10086;40548;19770;74762;29856;115310
120042;201509;2851;12306;2697;11951;380;1828;1897;8544;2277;10372
120043;201509;886;4249;856;4196;67;299;712;3630;779;3929
120045;201509;4224;14423;4132;14305;624;2266;3268;11380;3892;13646
120050;201509;7900;32892;7537;32072;1271;5550;4978;22058;6249;27608
120060;201509;7304;33215;7167;32933;663;3511;5807;26907;6470;30418
120070;201509;2616;9902;2542;9732;437;1626;1678;6659;2115;8285
120080;201509;3524;13374;3329;13051;597;2436;2334;9341;2931;11777
130002;201509;3028;12565;2850;12266;203;1023;2369;10228;2572;11251
130006;201509;1940;8230;1701;7783;256;1323;1168;5389;1424;6712
130008;201509;2098;8407;1986;8199;209;880;1558;6536;1767;7416
130010;201509;2858;9563;2480;9123;205;822;2117;7828;2322;8650
130014;201509;3173;10390;2809;9805;450;1700;1834;6435;2284;8135
130020;201509;2668;9708;2596;9578;63;319;2295;8373;2358;8692
130030;201509;7248;27487;6971;27162;566;1959;5957;23938;6523;25897
130040;201509;3794;11603;3389;11059;273;978;2766;9133;3039;10111
130050;201509;6084;24625;5594;23887;488;2067;4451;19803;4939;21870
130060;201509;5594;26258;5344;25810;527;3017;4173;20095;4700;23112
130063;201509;3593;15922;3520;15828;312;1473;2981;13596;3293;15069
130068;201509;3069;12878;2774;12257;378;1793;1810;8085;2188;9878
130070;201509;6705;21693;5945;20750;649;2284;4561;16288;5210;18572
130080;201509;4965;22331;4733;21952;787;3898;3261;15458;4048;19356
130083;201509;2170;8634;2047;8448;314;1450;1405;5813;1719;7263
130090;201509;2576;9311;2485;9165;129;608;2164;7922;2293;8530
130100;201509;5578;20863;5420;20656;194;860;5021;19147;5215;20007
130110;201509;6526;21152;6129;20653;758;2376;4817;16766;5575;19142
130115;201509;4315;15292;4042;14858;199;770;3504;12943;3703;13713
130120;201509;14106;53903;13364;52941;1437;5788;10789;43667;12226;49455
130130;201509;3708;15395;3642;15263;269;1344;3058;12808;3327;14152
130140;201509;6226;24136;6126;24022;175;726;5759;22607;5934;23333
130150;201509;3370;13194;3298;13105;188;1005;2890;11302;3078;12307
130160;201509;4156;17323;4017;17122;516;2593;3230;13600;3746;16193
130165;201509;2841;11765;2714;11549;300;1390;2108;9048;2408;10438
130170;201509;8873;32279;7885;31028;1078;4507;5833;23408;6911;27915
130180;201509;3466;11290;3373;11160;140;336;3103;10426;3243;10762
130185;201509;11070;35609;9965;34339;906;2893;8167;29285;9073;32178
130190;201509;16912;58045;14826;55300;2745;10275;9662;37558;12407;47833
130195;201509;1930;8057;1862;7956;122;544;1620;7003;1742;7547
130200;201509;1970;7036;1820;6796;470;1752;1091;4186;1561;5938
130210;201509;1183;4682;1117;4592;112;551;915;3746;1027;4297
130220;201509;1945;8040;1767;7696;319;1615;969;4201;1288;5816
130230;201509;3627;16404;3372;15955;405;2004;2487;12222;2892;14226
130240;201509;8396;31969;7740;30995;435;2259;6637;26568;7072;28827
130250;201509;19470;68007;18348;66539;2766;9993;13382;50438;16148;60431
130255;201509;4119;14552;3885;14154;168;623;3449;12704;3617;13327
130260;201509;243033;797298;217547;752593;62822;229601;96096;335545;158918;565146
130270;201509;6947;29402;6399;28516;900;4175;4614;21238;5514;25413
130280;201509;3213;13227;3113;13092;176;797;2777;11842;2953;12639
130290;201509;11245;39554;10797;39029;137;248;10394;38270;10531;38518
130300;201509;4230;16630;4045;16327;282;1343;3436;13858;3718;15201
130310;201509;5009;18984;4636;18509;363;1495;3835;15614;4198;17109
130320;201509;2888;10267;2632;9904;361;1432;1868;7166;2229;8598
130330;201509;3572;13037;3276;12659;233;1087;2701;10406;2934;11493
130340;201509;17318;66720;16141;65206;2873;11552;11733;48915;14606;60467
130350;201509;3243;13537;3161;13420;299;1630;2565;10748;2864;12378
130353;201509;5975;18268;5204;17253;1187;3862;3135;11114;4322;14976
130356;201509;4463;16070;4197;15675;397;1408;3315;12851;3712;14259
130360;201509;3190;9093;2865;8732;157;447;2580;7996;2737;8443
130370;201509;5237;20608;4458;19498;250;1443;3513;15336;3763;16779
130380;201509;7665;31838;7350;31388;532;2595;6253;26864;6785;29459
130390;201509;4828;21527;4475;20888;471;2461;3350;15871;3821;18332
130395;201509;2076;7454;1830;6935;289;1159;1168;4373;1457;5532
130400;201509;2077;7932;1990;7813;148;706;1741;6794;1889;7500
130406;201509;10534;39957;9469;38366;2214;9299;5757;24002;7971;33301
130410;201509;3868;14845;3490;14132;1061;4566;1555;6516;2616;11082
130420;201509;10412;44061;9936;43304;2640;11141;6192;28447;8832;39588
130423;201509;3219;12530;3017;12242;265;1304;2500;10073;2765;11377
130426;201509;2116;9294;2053;9181;293;1371;1513;6905;1806;8276
130430;201509;3293;11811;3164;11612;372;1446;2430;9000;2802;10446
130440;201509;3483;12758;3328;12580;254;998;2863;10905;3117;11903
140002;201509;1624;5296;1509;5133;154;538;1089;3771;1243;4309
140005;201509;3006;8920;2863;8760;112;302;2692;8300;2804;8602
140010;201509;53011;156926;43852;142686;10837;37611;19762;66237;30599;103848
140015;201509;2936;9403;2743;9159;315;899;2191;7625;2506;8524
140017;201509;3241;10124;2923;9720;302;962;2227;7662;2529;8624
140020;201509;4406;15062;4055;14551;614;2391;2852;10203;3466;12594
140023;201509;2131;7241;1862;6821;257;1024;1273;4713;1530;5737
140028;201509;2102;5829;1971;5644;245;764;1444;3971;1689;4735
140030;201509;3723;11725;3508;11420;499;1335;2572;8745;3071;10080
140040;201509;1687;7829;1635;7708;104;593;1353;6382;1457;6975
140045;201509;2468;9114;2245;8785;452;1619;1457;6191;1909;7810
140047;201509;5382;15169;4765;14333;1388;4287;2274;7210;3662;11497
140050;201509;1470;4625;1322;4435;308;1044;760;2604;1068;3648
140060;201509;1503;4597;1344;4352;293;1006;830;2709;1123;3715
140070;201509;1426;7671;1380;7505;102;675;1130;6140;1232;6815
150010;201509;34059;105296;32107;102654;2074;7123;26338;84552;28412;91675
150013;201509;1671;4904;1530;4740;171;512;1193;3779;1364;4291
150020;201509;12311;41171;11887;40582;1068;3493;10004;34754;11072;38247
150030;201509;6791;29147;6565;28798;708;2793;5360;24385;6068;27178
150034;201509;4223;11743;3992;11449;244;696;3443;9891;3687;10587
150040;201509;12662;41126;10812;38890;2120;7001;7333;28423;9453;35424
150050;201509;5712;22127;5486;21727;334;1586;4664;18491;4998;20077
150060;201509;16866;53020;15373;50666;2683;8612;10187;34654;12870;43266
150070;201509;5890;24120;5272;23458;350;1719;4640;20802;4990;22521
150080;201509;67873;178190;57768;164504;10897;29859;34592;102703;45489;132562
150085;201509;5189;17741;4929;17393;519;1571;4023;14782;4542;16353
150090;201509;9988;38384;9469;37628;973;3873;7374;29952;8347;33825
150095;201509;5201;17266;4739;16569;422;1373;3755;13599;4177;14972
150100;201509;3284;12245;3091;11904;193;939;2473;9354;2666;10293
150110;201509;3282;16335;3270;16306;234;1125;2867;14511;3101;15636
150120;201509;6124;23335;5983;23090;643;2384;4808;18937;5451;21321
150125;201509;747;2172;657;2061;118;409;433;1329;551;1738
150130;201509;21706;65920;20090;63633;2244;6838;15231;49453;17475;56291
150140;201509;152124;432597;143733;421518;16008;46047;112470;334399;128478;380446
150145;201509;4476;14367;4072;13846;616;2168;3008;10435;3624;12603
150150;201509;11585;35574;10591;34034;1790;5996;7049;22908;8839;28904
150157;201509;3104;9338;2692;8748;370;1339;1899;6242;2269;7581
150160;201509;3016;9763;2813;9466;882;3012;1439;5016;2321;8028
150170;201509;21476;79406;20231;77332;3310;12846;14036;54627;17346;67473
150172;201509;3037;10437;2673;9817;456;1680;1795;6773;2251;8453
150175;201509;1962;5902;1843;5765;161;499;1499;4849;1660;5348
150178;201509;9941;31110;8847;29822;1090;3877;6388;22142;7478;26019
150180;201509;18060;72351;17344;71398;1474;6671;14376;59688;15850;66359
150190;201509;6969;23367;6659;22929;319;1119;5899;20569;6218;21688
150195;201509;5034;16821;4673;16234;313;1176;3925;13732;4238;14908
150200;201509;5255;16769;5023;16501;132;426;4667;15499;4799;15925
150210;201509;24144;91758;23297;90551;2364;8906;18706;75008;21070;83914
150215;201509;6506;20605;5653;19209;1569;5592;2425;8348;3994;13940
150220;201509;12125;37712;10762;35534;2404;8168;5603;18853;8007;27021
150230;201509;11034;36461;9884;34752;1305;5049;6897;24359;8202;29408
150240;201509;34963;103722;30423;95815;9982;32470;9974;32591;19956;65061
150250;201509;4073;16618;3924;16393;552;2379;2911;12516;3463;14895
150260;201509;2037;8172;1929;7965;378;1558;1194;5086;1572;6644
150270;201509;8503;26255;6813;24112;1726;6381;3831;13843;5557;20224
150275;201509;5827;21248;5529;20751;721;2720;4019;15363;4740;18083
150276;201509;2066;6246;1845;5939;429;1472;1211;3867;1640;5339
150277;201509;4835;15002;4193;14200;797;2804;2791;9689;3588;12493
150280;201509;5759;25719;5574;25300;1110;5073;3678;17198;4788;22271
150285;201509;2720;10835;2560;10534;528;2235;1539;6609;2067;8844
150290;201509;9626;28316;9184;27810;727;1819;7785;24375;8512;26194
150293;201509;9688;26543;7338;23211;2218;7470;2608;8900;4826;16370
150295;201509;6985;21241;5809;19824;1439;5003;3272;11858;4711;16861
150300;201509;1801;6323;1716;6216;156;621;1331;4886;1487;5507
150304;201509;3984;12631;3499;11908;596;2045;2272;7972;2868;10017
150307;201509;6477;21835;6000;21160;419;1472;4950;17588;5369;19060
150309;201509;6129;21208;5603;20456;1241;4497;3509;13429;4750;17926
150310;201509;5896;26027;5690;25705;676;3220;4431;20319;5107;23539
150320;201509;9254;22108;8547;21361;542;1071;7403;18928;7945;19999
150330;201509;13471;46435;12572;45116;1647;5857;9424;34838;11071;40695
150340;201509;2363;7683;2182;7407;287;1014;1554;5312;1841;6326
150345;201509;6512;21766;6093;21201;609;2105;4879;17344;5488;19449
150350;201509;7538;23946;7038;23276;1192;3380;5079;17609;6271;20989
150360;201509;20830;65133;18249;61732;3010;10268;12222;42849;15232;53117
150370;201509;9679;35624;9109;34853;1284;4707;6949;27574;8233;32281
150375;201509;2798;12299;2729;12210;256;1111;2319;10581;2575;11692
150380;201509;9762;28454;8614;26840;649;2092;7046;22234;7695;24326
150390;201509;7737;33318;7240;32369;1352;5902;4652;21640;6004;27542
150400;201509;5717;22816;5470;22307;516;2105;4308;17975;4824;20080
150405;201509;8119;24593;7230;23490;1389;3740;4845;17263;6234;21003
150410;201509;1559;6057;1463;5854;209;933;941;3804;1150;4737
150420;201509;35442;120465;30074;111436;8985;36071;11148;42909;20133;78980
150430;201509;7108;24083;6766;23531;954;3176;4905;17566;5859;20742
150440;201509;5386;18814;5163;18501;959;3297;3622;13443;4581;16740
150442;201509;20249;59720;18178;56530;3402;10698;11288;35959;14690;46657
150445;201509;5049;17626;4687;16996;676;2432;3371;12486;4047;14918
150450;201509;4315;20782;4162;20548;358;1784;3458;17442;3816;19226
150460;201509;6433;24962;5922;24350;377;1954;5021;20865;5398;22819
150470;201509;17092;52410;16435;51633;506;1302;15356;48894;15862;50196
150475;201509;2665;9259;2448;8975;250;912;1968;7384;2218;8296
150480;201509;13597;46465;12620;44993;1292;4853;10023;36181;11315;41034
150490;201509;6801;26269;6648;26038;295;1263;5857;23137;6152;24400
150495;201509;4863;18169;4746;18010;248;1004;4290;16348;4538;17352
150497;201509;2768;10133;2513;9616;796;3220;1156;4425;1952;7645
150500;201509;3109;8627;2885;8313;312;885;2201;6340;2513;7225
150503;201509;3721;11535;3216;10900;1124;3920;1608;5687;2732;9607
150506;201509;11354;39594;10268;38023;2433;8590;6387;25223;8820;33813
150510;201509;9452;37167;8673;35634;1406;5928;5725;24359;7131;30287
150520;201509;6634;26006;6516;25843;286;1129;6010;24039;6296;25168
150530;201509;11973;41196;10751;39325;1173;4094;8190;30622;9363;34716
150540;201509;4579;14119;4115;13456;303;1026;3386;11096;3689;12122
150543;201509;5475;17072;4892;16201;1024;3508;3023;10245;4047;13753
150548;201509;8967;28697;8395;27964;535;1751;7456;25073;7991;26824
150549;201509;2092;6690;1921;6492;87;307;1720;5876;1807;6183
150550;201509;19762;62362;17166;57886;5218;18096;6750;23400;11968;41496
150553;201509;22956;78791;18986;70380;6978;27656;4661;17341;11639;44997
150555;201509;1635;5006;1425;4655;96;360;1099;3586;1195;3946
150560;201509;1955;6315;1831;6050;272;888;1197;3955;1469;4843
150563;201509;2847;9226;2624;8837;637;2326;1436;4821;2073;7147
150565;201509;3727;12868;3390;12347;223;994;2758;10118;2981;11112
150570;201509;5593;20847;5451;20598;413;1819;4373;16586;4786;18405
150580;201509;9472;39660;9237;39382;635;2590;8081;35242;8716;37832
150590;201509;5653;22813;5488;22606;129;509;5157;21428;5286;21937
150600;201509;7818;30256;7519;29814;404;1676;6648;26641;7052;28317
150610;201509;2351;8045;2149;7622;249;995;1488;5200;1737;6195
150611;201509;2649;9317;2476;8977;209;818;1957;7134;2166;7952
150613;201509;11933;36239;10030;33363;3321;11576;4105;14005;7426;25581
150616;201509;3014;9196;2333;8078;570;2173;863;2849;1433;5022
150618;201509;6347;21873;5816;20895;1625;5977;2936;10765;4561;16742
150619;201509;5173;17661;4805;17073;607;2343;3424;12190;4031;14533
150620;201509;6297;22636;5758;21930;751;2868;4438;17319;5189;20187
150630;201509;5684;17153;5388;16799;567;1820;4393;13958;4960;15778
150635;201509;3961;13029;3587;12287;807;2872;1836;6377;2643;9249
150640;201509;1740;5312;1677;5232;254;748;1298;4268;1552;5016
150650;201509;12341;37239;10905;34726;2945;9510;4877;16074;7822;25584
150655;201509;4893;16494;4627;16004;648;2279;3374;11838;4022;14117
150658;201509;4156;13035;3745;12441;930;3397;2186;7283;3116;10680
150660;201509;5506;17471;5009;16744;1215;4005;2736;9489;3951;13494
150670;201509;6648;18238;5600;16910;865;2728;4142;12806;5007;15534
150680;201509;54780;196573;48277;185155;14806;58900;19883;81445;34689;140345
150690;201509;2006;6234;1803;5907;329;1015;1133;3841;1462;4856
150700;201509;6160;19045;5620;18347;1039;3462;3665;12282;4704;15744
150710;201509;4250;14282;3804;13546;447;1643;2757;10022;3204;11665
150715;201509;4942;15528;4286;14518;540;2022;3132;10660;3672;12682
150720;201509;6383;26039;6006;25352;848;3697;4250;18546;5098;22243
150730;201509;9472;32438;8880;31460;984;3481;7071;25617;8055;29098
150740;201509;3696;11785;3301;11067;623;2205;1866;6261;2489;8466
150745;201509;5281;16656;4793;15967;1147;3997;2934;9766;4081;13763
150746;201509;1375;4514;1313;4404;172;620;933;3139;1105;3759
150747;201509;5362;16716;4706;15901;418;1195;3635;13120;4053;14315
150750;201509;3113;10365;2899;10093;216;843;2380;8317;2596;9160
150760;201509;10851;35447;10118;34445;2169;7484;6233;21773;8402;29257
150770;201509;5707;21877;5349;21178;493;1849;4416;18430;4909;20279
150775;201509;1150;3484;1003;3222;211;824;534;1637;745;2461
150780;201509;3166;10399;3088;10302;80;265;2881;9660;2961;9925
150790;201509;4929;16006;4559;15557;376;1366;3691;13162;4067;14528
150795;201509;15459;48040;13817;45613;2905;9600;8404;28660;11309;38260
150796;201509;2943;8801;2679;8495;404;1261;1956;6376;2360;7637
150797;201509;3626;12320;3362;11895;128;544;2915;10290;3043;10834
150800;201509;13684;45339;12585;43990;2710;8968;8374;30922;11084;39890
150803;201509;6509;23621;6106;22963;677;2681;4530;17245;5207;19926
150805;201509;2612;9310;2444;9030;340;1234;1757;6623;2097;7857
150808;201509;5592;18833;4677;17098;1876;7368;788;2909;2664;10277
150810;201509;18834;58565;15896;54932;2284;7570;10795;39347;13079;46917
150812;201509;5193;16324;4756;15573;507;1962;3391;10700;3898;12662
150815;201509;8382;27386;7548;26340;772;2670;6092;21737;6864;24407
150820;201509;11279;32221;10006;30799;704;1626;8333;26441;9037;28067
150830;201509;12828;48174;11794;46636;712;3398;9840;39891;10552;43289
150835;201509;2049;7201;1889;6890;463;1717;893;3346;1356;5063
150840;201509;6720;20519;5550;18570;1298;4741;2660;8808;3958;13549
160005;201509;677;2464;635;2380;63;285;495;1822;558;2107
160010;201509;1374;4571;1370;4566;68;144;1274;4358;1342;4502
160015;201509;1662;6162;1622;6104;95;321;1447;5579;1542;5900
160020;201509;2013;7122;1867;6920;239;908;1378;5238;1617;6146
160021;201509;954;4109;920;4045;148;753;631;2774;779;3527
160023;201509;1033;4107;1020;4083;100;387;860;3492;960;3879
160025;201509;1277;3924;1260;3906;31;119;1214;3741;1245;3860
160027;201509;8136;24387;7515;23693;2641;7858;3828;13144;6469;21002
160030;201509;44239;157590;39263;148409;9415;35644;21547;85827;30962;121471
160040;201509;4125;16322;4026;16170;198;1092;3639;14390;3837;15482
160050;201509;3139;11856;2830;11419;1310;5205;1103;4775;2413;9980
160053;201509;2714;10449;2644;10345;526;2170;1782;7061;2308;9231
160055;201509;634;2473;624;2461;79;342;483;1906;562;2248
160060;201509;15391;52125;14402;51000;3002;10028;9645;35602;12647;45630
160070;201509;2459;9710;2320;9461;194;945;1931;7805;2125;8750
160080;201509;2569;9643;2534;9596;108;537;2349;8803;2457;9340
170025;201509;521;1724;475;1652;136;471;233;854;369;1325
170030;201509;1166;3807;1025;3548;312;1111;358;1253;670;2364
170035;201509;1515;4393;1204;3819;331;1164;426;1319;757;2483
170040;201509;1878;6026;1649;5717;247;976;1022;3688;1269;4664
170070;201509;1803;4788;1419;4272;320;1033;742;2195;1062;3228
170100;201509;2452;7203;2133;6695;245;807;1629;5110;1874;5917
170105;201509;767;2381;597;2030;121;477;305;982;426;1459
170110;201509;1049;3276;889;3005;203;737;407;1375;610;2112
170130;201509;1358;4266;1146;3868;313;1088;529;1825;842;2913
170190;201509;1579;4615;1188;3975;490;1585;240;921;730;2506
170200;201509;1634;4572;1061;3464;266;957;293;890;559;1847
170210;201509;31606;89778;25068;78995;7179;24369;7301;23889;14480;48258
170215;201509;1181;3680;999;3397;84;345;735;2467;819;2812
170220;201509;5617;19367;5183;18502;1171;4417;2845;10211;4016;14628
170230;201509;1436;4587;1182;4089;249;1007;533;1744;782;2751
170240;201509;2665;8125;2225;7441;304;1206;1484;4909;1788;6115
170255;201509;3333;10680;2781;9723;852;3015;1167;4254;2019;7269
170270;201509;1028;2570;718;2147;82;264;479;1418;561;1682
170290;201509;2721;8419;2509;8167;174;451;2160;7307;2334;7758
170300;201509;1953;6010;1617;5451;220;831;1029;3471;1249;4302
170305;201509;773;2311;621;2029;119;424;307;1003;426;1427
170307;201509;1084;3799;897;3440;185;814;435;1705;620;2519
170310;201509;1615;4453;1211;3760;316;1050;529;1658;845;2708
170320;201509;1110;3234;812;2706;205;720;281;955;486;1675
170330;201509;745;2447;678;2340;89;348;489;1651;578;1999
170360;201509;453;1457;374;1316;85;318;165;566;250;884
170370;201509;1370;3908;1087;3450;219;781;559;1760;778;2541
170380;201509;1787;5722;1432;5136;253;1048;763;2671;1016;3719
170382;201509;541;1796;464;1668;109;440;245;863;354;1303
170384;201509;1531;6244;1416;6031;326;1513;789;3349;1115;4862
170386;201509;920;2734;792;2542;183;659;359;1124;542;1783
170388;201509;645;1922;520;1714;108;425;201;632;309;1057
170389;201509;920;3085;832;2939;88;354;600;2097;688;2451
170390;201509;1280;3722;1115;3513;112;385;841;2694;953;3079
170410;201509;545;1709;460;1558;43;177;294;979;337;1156
170460;201509;497;1349;342;1084;81;286;116;357;197;643
170510;201509;789;2638;644;2363;82;357;333;1184;415;1541
170550;201509;6625;18953;4923;15939;1566;5547;780;2459;2346;8006
170555;201509;1340;3846;1047;3391;232;813;504;1651;736;2464
170560;201509;1002;3361;793;3075;176;742;437;1759;613;2501
170600;201509;1317;3822;1175;3629;261;798;741;2370;1002;3168
170610;201509;1578;4859;1254;4331;134;542;782;2693;916;3235
170625;201509;427;1320;332;1137;65;226;93;328;158;554
170650;201509;1243;4001;1061;3666;248;927;447;1591;695;2518
170700;201509;4082;12887;3295;11544;681;2642;1442;5194;2123;7836
170710;201509;1813;5352;1470;4726;228;784;883;2863;1111;3647
170720;201509;1824;4939;1525;4453;328;865;937;2898;1265;3763
170730;201509;994;2866;808;2577;215;735;357;1135;572;1870
170740;201509;2185;7764;1915;7282;295;1225;1253;4800;1548;6025
170755;201509;804;2490;654;2168;136;516;241;771;377;1287
170765;201509;1349;3650;1038;3130;291;928;414;1264;705;2192
170770;201509;1730;5856;1577;5580;267;1008;962;3406;1229;4414
170820;201509;3612;11481;3217;10827;752;2676;1536;5245;2288;7921
170825;201509;741;2199;590;1902;109;371;253;793;362;1164
170830;201509;1396;4065;1225;3813;44;90;1095;3494;1139;3584
170900;201509;2577;9111;2437;8873;230;859;1939;7181;2169;8040
170930;201509;3627;11152;3136;10284;959;3327;1135;3827;2094;7154
170950;201509;13947;40191;10244;33563;3163;11769;1954;6154;5117;17923
170980;201509;500;1499;376;1284;89;349;151;477;240;826
171050;201509;1473;5004;1323;4719;98;441;1051;3701;1149;4142
171070;201509;1509;4731;1376;4530;357;1177;730;2483;1087;3660
171090;201509;1013;2784;841;2539;67;197;615;1856;682;2053
171110;201509;599;1752;445;1466;122;438;187;580;309;1018
171150;201509;850;2434;616;2021;105;376;360;1189;465;1565
171180;201509;690;2082;479;1645;115;418;183;671;298;1089
171190;201509;1642;6002;1439;5570;293;1206;717;2865;1010;4071
171195;201509;820;2919;710;2698;97;407;412;1593;509;2000
171200;201509;677;2154;548;1905;162;616;195;616;357;1232
171215;201509;453;1355;350;1149;62;221;147;497;209;718
171240;201509;729;2594;670;2477;90;390;433;1640;523;2030
171245;201509;635;2088;514;1793;111;447;168;538;279;985
171250;201509;1086;3133;865;2756;145;526;502;1519;647;2045
171270;201509;416;1706;391;1652;132;534;149;711;281;1245
171280;201509;869;2640;726;2404;188;595;320;1161;508;1756
171320;201509;3856;11658;3275;10629;899;2923;1455;4828;2354;7751
171330;201509;2894;8411;2346;7548;627;2155;1026;3262;1653;5417
171360;201509;1414;4584;1245;4316;208;736;787;2773;995;3509
171370;201509;670;1919;575;1785;133;458;307;929;440;1387
171380;201509;1325;4260;1112;3863;419;1465;361;1302;780;2767
171395;201509;877;2655;688;2300;150;595;316;1008;466;1603
171420;201509;2258;6776;1715;5783;431;1540;622;2055;1053;3595
171430;201509;1040;3186;864;2899;203;698;444;1483;647;2181
171488;201509;2467;7514;2140;7034;496;1639;1154;3914;1650;5553
171500;201509;776;2377;673;2197;102;330;445;1484;547;1814
171510;201509;899;3149;807;2991;77;334;576;2154;653;2488
171515;201509;493;1411;388;1228;62;199;205;638;267;837
171525;201509;617;2024;522;1854;100;398;263;896;363;1294
171550;201509;303;1018;233;883;82;344;39;153;121;497
171570;201509;1240;3916;1081;3599;205;693;708;2369;913;3062
171575;201509;1900;5369;1443;4521;282;915;658;2080;940;2995
171610;201509;5358;17117;4473;15535;1222;4696;1548;5304;2770;10000
171620;201509;2548;7510;2230;7065;116;440;1868;5932;1984;6372
171630;201509;900;2831;735;2557;238;900;288;978;526;1878
171650;201509;2191;6759;1704;5778;452;1657;605;2021;1057;3678
171660;201509;2468;6824;1896;5795;241;825;1124;3415;1365;4240
171665;201509;1490;4380;1207;3933;189;669;695;2348;884;3017
171670;201509;1940;5515;1617;4978;438;1519;688;1994;1126;3513
171700;201509;1086;3551;940;3269;141;562;597;2045;738;2607
171720;201509;722;2118;599;1907;209;664;228;756;437;1420
171750;201509;1173;3637;932;3148;261;918;304;1034;565;1952
171780;201509;1147;3171;876;2778;108;377;513;1662;621;2039
171790;201509;1464;4935;1282;4653;227;805;836;3189;1063;3994
171800;201509;643;2033;571;1937;74;282;413;1427;487;1709
171820;201509;10009;29448;8457;27237;1673;5901;4671;15032;6344;20933
171830;201509;1413;5254;1277;4943;332;1285;577;2258;909;3543
171840;201509;797;2206;683;2043;48;147;560;1690;608;1837
171845;201509;730;1995;563;1714;100;334;285;863;385;1197
171850;201509;953;3385;842;3160;105;443;517;1926;622;2369
171855;201509;1130;3532;1021;3327;91;363;754;2387;845;2750
171865;201509;468;1506;399;1389;89;340;192;651;281;991
171870;201509;729;2174;584;1918;134;482;225;777;359;1259
171875;201509;1325;4175;1101;3810;118;494;747;2531;865;3025
171880;201509;817;3051;795;3015;84;336;632;2440;716;2776
171884;201509;979;2706;701;2293;159;588;200;758;359;1346
171886;201509;1440;4694;1153;4071;350;1359;304;1018;654;2377
171888;201509;677;2067;543;1808;61;216;303;1034;364;1250
171889;201509;488;1571;450;1504;97;349;252;851;349;1200
171890;201509;1197;3709;993;3396;158;594;548;1860;706;2454
171900;201509;489;1835;432;1722;115;468;203;817;318;1285
172000;201509;560;1845;482;1694;76;296;272;939;348;1235
172010;201509;1188;4133;1100;3984;132;573;793;2848;925;3421
172015;201509;335;1300;276;1186;58;238;153;692;211;930
172020;201509;2233;7473;2066;7203;270;973;1436;5085;1706;6058
172025;201509;721;2089;549;1797;86;318;299;987;385;1305
172030;201509;1137;3738;1003;3508;78;345;740;2549;818;2894
172049;201509;1324;3513;994;2943;163;480;727;2205;890;2685
172065;201509;1277;3499;1079;3273;66;209;972;2984;1038;3193
172080;201509;2498;7713;2101;7001;234;915;1353;4442;1587;5357
172085;201509;529;1435;373;1131;53;152;111;330;164;482
172090;201509;3234;9652;2652;8739;273;971;1947;6537;2220;7508
172093;201509;597;1830;468;1614;138;565;206;688;344;1253
172097;201509;664;1970;530;1755;127;419;213;739;340;1158
172100;201509;30735;93607;23928;81092;7045;26553;6526;21766;13571;48319
172110;201509;1676;6226;1493;5932;186;795;1066;4357;1252;5152
172120;201509;5129;15774;4278;14623;587;2126;2912;10108;3499;12234
172125;201509;265;824;223;746;37;142;106;352;143;494
172130;201509;545;1518;436;1341;43;162;291;906;334;1068
172208;201509;2092;6282;1882;5960;335;1120;1068;3414;1403;4534
172210;201509;2475;7637;2190;7194;514;1814;1154;3721;1668;5535
210005;201509;21619;67172;18170;61815;5651;20561;7021;24003;12672;44564
210010;201509;1572;5701;1407;5403;134;560;1057;4125;1191;4685
210015;201509;3293;10435;2951;9917;216;576;2477;8572;2693;9148
210020;201509;6876;16941;6482;16461;227;611;5910;14981;6137;15592
210030;201509;5509;18325;5160;17846;344;1529;4251;14586;4595;16115
210040;201509;1841;5208;1694;5039;117;356;1430;4270;1547;4626
210043;201509;6431;18459;5595;17381;546;1591;4156;13520;4702;15111
210047;201509;6305;24415;5800;23523;674;3025;4174;17038;4848;20063
210050;201509;2318;8499;1913;7717;681;2827;650;2777;1331;5604
210055;201509;1704;5826;1560;5623;166;621;1191;4352;1357;4973
210060;201509;7233;27762;6709;26796;916;3847;4573;18644;5489;22491
210070;201509;6867;20465;6342;19807;177;717;5657;17664;5834;18381
210080;201509;3656;12601;3562;12474;53;254;3344;11683;3397;11937
210083;201509;4279;14955;3974;14628;129;518;3735;13844;3864;14362
210087;201509;2853;8510;2599;8185;297;966;2040;6511;2337;7477
210090;201509;9685;31758;9205;30986;406;1593;8054;27125;8460;28718
210095;201509;5871;21561;5665;21261;423;1665;4681;17815;5104;19480
210100;201509;7135;21516;6556;20798;901;3009;4889;15440;5790;18449
210110;201509;2849;9961;2759;9835;120;556;2471;8757;2591;9313
210120;201509;25895;70976;22138;66552;2697;6876;16566;52788;19263;59664
210125;201509;3515;11185;3371;11034;237;637;2932;9854;3169;10491
210130;201509;4073;12115;3816;11755;265;852;3199;9856;3464;10708
210135;201509;1682;4940;1474;4650;111;360;1186;3766;1297;4126
210140;201509;16859;53889;14603;50753;2724;9853;9063;32581;11787;42434
210150;201509;4487;11094;4022;10516;70;177;3767;9859;3837;10036
210160;201509;17306;54841;16262;53294;1549;4575;13065;44140;14614;48715
210170;201509;13756;49003;13390;48528;754;2687;11908;43775;12662;46462
210173;201509;1916;7966;1854;7845;124;718;1580;6517;1704;7235
210177;201509;3019;9403;2861;9217;173;604;2519;8144;2692;8748
210180;201509;1475;4521;1374;4365;61;235;1169;3662;1230;3897
210190;201509;4783;15247;4415;14563;229;1008;3451;11129;3680;12137
210193;201509;1387;4374;1252;4150;75;265;1041;3499;1116;3764
210197;201509;2092;6918;1929;6733;246;830;1482;5339;1728;6169
210200;201509;8484;28355;7857;27444;1075;3501;5815;21183;6890;24684
210203;201509;6395;20750;6089;20341;412;1205;5244;17789;5656;18994
210207;201509;2962;9749;2773;9396;383;1183;1997;7010;2380;8193
210210;201509;8474;28414;8042;27859;107;465;7431;26093;7538;26558
210215;201509;1246;5077;1190;4987;103;497;965;4062;1068;4559
210220;201509;5981;22990;5690;22509;430;1859;4667;18649;5097;20508
210230;201509;4948;16525;4659;16058;293;1076;3944;13697;4237;14773
210232;201509;12329;40268;10318;37797;1559;5887;6965;27030;8524;32917
210235;201509;3478;10997;3136;10548;203;816;2629;8845;2832;9661
210237;201509;2324;9063;2271;8982;97;569;2050;7952;2147;8521
210240;201509;3000;9460;2816;9204;180;561;2333;7689;2513;8250
210250;201509;5017;16210;4727;15826;139;662;4270;14151;4409;14813
210255;201509;2485;8009;2268;7611;358;1244;1583;5370;1941;6614
210260;201509;5218;16799;4734;16085;647;2134;3445;12061;4092;14195
210270;201509;5371;15215;4708;14293;128;578;4149;12476;4277;13054
210275;201509;3597;8728;3388;8503;58;91;3281;8329;3339;8420
210280;201509;5544;16684;4836;15732;319;1314;3733;11922;4052;13236
210290;201509;5577;18555;5152;18028;370;1291;4336;15373;4706;16664
210300;201509;37048;104297;30423;96109;2175;7219;23297;76304;25472;83523
210310;201509;2870;8122;2646;7826;83;196;2333;6953;2416;7149
210312;201509;2160;6910;2060;6771;74;345;1821;5925;1895;6270
210315;201509;2501;8471;2326;8224;175;720;1956;6939;2131;7659
210317;201509;4228;12844;4021;12582;234;810;3550;11122;3784;11932
210320;201509;18782;60146;17404;58447;972;3461;14851;50340;15823;53801
210325;201509;3530;11133;3155;10563;298;1112;2345;7871;2643;8983
210330;201509;36539;87940;28181;79025;3977;9171;19124;60360;23101;69531
210340;201509;11586;35160;10522;33786;1262;3455;7670;26394;8932;29849
210350;201509;9945;30993;9030;29709;629;2101;7272;24192;7901;26293
210355;201509;3860;14118;3566;13691;224;886;3047;11924;3271;12810
210360;201509;16108;48844;14685;46830;1142;3870;11721;37628;12863;41498
210370;201509;9235;22272;7803;20733;278;534;6955;19084;7233;19618
210375;201509;3017;9257;2574;8674;746;2578;1250;4346;1996;6924
210380;201509;6028;16869;5316;15875;415;1138;4376;13278;4791;14416
210390;201509;2811;9978;2555;9557;130;674;2177;8111;2307;8785
210400;201509;4838;15245;4656;15028;149;456;4326;14098;4475;14554
210405;201509;8229;22667;6613;20374;2068;6347;2599;8898;4667;15245
210407;201509;2038;7241;1767;6783;198;746;1290;5090;1488;5836
210408;201509;2359;9177;2205;8988;140;656;1882;7894;2022;8550
210409;201509;3714;13572;3498;13240;204;935;2901;11024;3105;11959
210410;201509;3463;11581;3350;11443;331;997;2764;9812;3095;10809
210420;201509;3995;13166;3654;12570;272;917;2932;10250;3204;11167
210430;201509;2172;6703;2095;6610;121;398;1814;5733;1935;6131
210440;201509;3979;12505;3865;12350;204;610;3491;11285;3695;11895
210450;201509;2833;8904;2525;8451;166;609;2030;6741;2196;7350
210455;201509;4091;11912;3596;11153;571;1782;2487;7986;3058;9768
210460;201509;3619;11940;3384;11570;170;692;2845;9707;3015;10399
210462;201509;1493;5418;1389;5220;95;432;1106;4158;1201;4590
210465;201509;2545;8467;2364;8205;273;755;1915;6920;2188;7675
210467;201509;6182;20450;5752;19934;418;1381;4784;16840;5202;18221
210470;201509;2044;5568;1558;4867;75;233;1206;3817;1281;4050
210480;201509;13798;45172;12103;42942;2691;9344;7527;28461;10218;37805
210490;201509;3527;9998;3111;9405;165;556;2594;7787;2759;8343
210500;201509;6322;25958;6083;25527;743;3032;4533;19599;5276;22631
210510;201509;6453;22049;6144;21673;376;1187;5215;18874;5591;20061
210515;201509;3567;11690;3414;11514;106;337;3183;10848;3289;11185
210520;201509;2543;7929;2323;7622;91;301;2088;6906;2179;7207
210530;201509;35851;110929;28940;100376;7349;28696;12591;44542;19940;73238
210535;201509;3185;11008;3051;10813;119;424;2737;9804;2856;10228
210540;201509;13188;43949;11569;41548;2653;9196;6508;25312;9161;34508
210542;201509;5721;16565;5264;16073;330;784;4530;14256;4860;15040
210545;201509;2265;7443;2148;7248;67;332;1863;6224;1930;6556
210547;201509;3771;13289;3512;12852;286;974;2788;10458;3074;11432
210550;201509;6028;18003;5548;17506;271;664;5069;16408;5340;17072
210560;201509;4131;12899;3687;12157;214;808;3099;10168;3313;10976
210565;201509;1477;5247;1269;4922;115;584;928;3590;1043;4174
210570;201509;12356;34895;11158;33526;841;1851;9515;29694;10356;31545
210580;201509;3141;9455;2819;9051;339;859;2122;7401;2461;8260
210590;201509;4068;12733;3790;12399;301;1060;3184;10409;3485;11469
210592;201509;2408;7584;2319;7439;48;210;2060;6596;2108;6806
210594;201509;2679;7514;2196;6817;119;351;1735;5512;1854;5863
210596;201509;2678;9999;2542;9743;263;1047;1937;7550;2200;8597
210598;201509;1901;5848;1754;5663;105;385;1506;4802;1611;5187
210600;201509;3199;9331;2815;8803;189;630;2272;7091;2461;7721
210610;201509;2492;8234;2323;8017;140;595;2007;6833;2147;7428
210620;201509;1904;6148;1782;5988;54;162;1626;5538;1680;5700
210630;201509;3668;13007;3223;12248;377;1608;2143;8255;2520;9863
210632;201509;4484;15719;4198;15287;421;1622;3277;12010;3698;13632
210635;201509;1886;6646;1792;6502;86;311;1600;5886;1686;6197
210637;201509;2705;9098;2498;8814;149;571;2075;7386;2224;7957
210640;201509;4208;15261;4130;15175;13;57;4029;14921;4042;14978
210650;201509;6819;20905;6635;20672;278;886;6186;19304;6464;20190
210660;201509;7785;23519;7200;22652;252;898;6628;20771;6880;21669
210663;201509;2672;7928;2506;7723;189;655;2075;6405;2264;7060
210667;201509;1788;6281;1693;6135;91;394;1448;5270;1539;5664
210670;201509;4365;16342;4169;16019;238;1075;3459;13401;3697;14476
210675;201509;4999;13915;4603;13429;350;919;3855;11514;4205;12433
210680;201509;4068;11355;3652;10844;195;511;3141;9434;3336;9945
210690;201509;7111;23974;6826;23661;279;882;6091;21713;6370;22595
210700;201509;2568;7748;2396;7561;407;992;1677;6026;2084;7018
210710;201509;4739;15605;4480;15192;205;843;3813;12911;4018;13754
210720;201509;2511;9195;2362;8977;158;732;2053;7717;2211;8449
210725;201509;1074;4061;951;3839;136;588;582;2362;718;2950
210730;201509;1107;3530;998;3371;102;293;755;2611;857;2904
210735;201509;4107;14334;3756;13736;680;2511;2491;9444;3171;11955
210740;201509;4930;14566;4671;14297;185;736;4191;12560;4376;13296
210745;201509;3844;11495;3591;11161;252;639;3049;9640;3301;10279
210750;201509;20443;54950;17855;52011;2077;6009;13691;40760;15768;46769
210760;201509;5869;16403;5475;15985;50;190;5315;15496;5365;15686
210770;201509;5845;16049;5110;15209;145;551;4641;13769;4786;14320
210780;201509;8382;27766;7647;26463;853;3060;5523;19499;6376;22559
210790;201509;4600;14536;4158;14010;297;775;3428;12146;3725;12921
210800;201509;4716;13475;4276;12939;168;487;3772;11547;3940;12034
210805;201509;3650;15363;3520;15128;176;924;3021;13062;3197;13986
210810;201509;5326;16405;4964;15952;397;808;4217;14234;4614;15042
210820;201509;7824;22546;7129;21553;1232;3599;4740;14691;5972;18290
210825;201509;5658;19423;5377;19027;626;2109;4163;15129;4789;17238
210830;201509;8240;24577;7840;24100;765;2041;6443;20438;7208;22479
210840;201509;3653;10055;3275;9487;194;499;2679;7780;2873;8279
210845;201509;5647;17464;5447;17246;129;289;5163;16644;5292;16933
210850;201509;5998;21496;5472;20573;806;3383;3648;13680;4454;17063
210860;201509;17351;52133;15665;49841;1416;4588;12387;39958;13803;44546
210870;201509;5904;19711;5389;19086;568;1915;4204;15193;4772;17108
210880;201509;4250;13796;4066;13546;345;1222;3310;11063;3655;12285
210890;201509;5290;15514;4805;14954;551;1589;3858;12442;4409;14031
210900;201509;4931;14823;4032;13330;1407;4852;1169;4109;2576;8961
210905;201509;1833;5753;1668;5518;149;375;1300;4478;1449;4853
210910;201509;8648;27379;7829;26056;1254;4456;5254;17548;6508;22004
210920;201509;2981;10572;2858;10374;157;665;2446;8880;2603;9545
210923;201509;1515;5209;1393;5026;164;657;936;3468;1100;4125
210927;201509;4773;15200;4550;14959;56;252;4394;14439;4450;14691
210930;201509;2452;8944;2326;8766;148;814;1966;7225;2114;8039
210940;201509;2810;10939;2750;10829;194;802;2330;9230;2524;10032
210945;201509;5823;17609;5635;17408;256;346;5275;16754;5531;17100
210950;201509;5297;16286;4608;15179;446;1492;3452;11591;3898;13083
210955;201509;1895;6127;1668;5791;203;691;1148;4170;1351;4861
210960;201509;8665;28395;8275;27858;2255;7397;4709;16817;6964;24214
210970;201509;1346;4806;1190;4558;155;705;825;3139;980;3844
210975;201509;1723;5836;1640;5690;137;525;1287;4480;1424;5005
210980;201509;9838;23446;9537;23132;927;1826;8133;20450;9060;22276
210990;201509;16545;49990;13391;45701;2930;10520;7190;25247;10120;35767
211000;201509;15418;49765;13723;47706;828;3386;11435;40127;12263;43513
211003;201509;4721;16811;4301;16186;338;1515;3236;12411;3574;13926
211010;201509;6533;23578;6290;23299;88;369;6029;22451;6117;22820
211020;201509;7310;23659;7086;23294;549;1941;5861;19151;6410;21092
211023;201509;2247;7621;2170;7488;169;659;1795;6196;1964;6855
211027;201509;2872;11218;2788;11086;286;1121;2245;9116;2531;10237
211030;201509;3875;11920;3617;11648;582;1383;2756;9621;3338;11004
211040;201509;4240;16162;4085;15907;158;821;3549;13880;3707;14701
211050;201509;10086;26313;9805;26003;326;757;9069;24134;9395;24891
211060;201509;5946;21237;5772;20982;482;1814;4909;18040;5391;19854
211065;201509;1846;6160;1683;5951;87;305;1513;5421;1600;5726
211070;201509;8100;27725;7454;26651;451;1731;6202;22403;6653;24134
211080;201509;1377;4165;1149;3831;92;432;884;2840;976;3272
211085;201509;1864;6417;1684;6101;321;1198;1049;3852;1370;5050
211090;201509;3487;10318;3268;10018;123;525;2821;8496;2944;9021
211100;201509;6626;17078;6463;16902;42;148;6310;16495;6352;16643
211102;201509;3050;11342;2882;11108;244;919;2424;9524;2668;10443
211105;201509;2661;8546;2279;7971;195;764;1751;6068;1946;6832
211107;201509;4469;14220;4031;13630;225;770;3376;11683;3601;12453
211110;201509;6287;18778;5052;16883;1018;3319;2969;10425;3987;13744
211120;201509;34675;95367;30633;90505;5187;14717;21075;64688;26262;79405
211125;201509;2080;6683;1857;6334;122;445;1543;5278;1665;5723
211130;201509;132664;370725;119955;354577;22142;65353;77185;232715;99327;298068
211140;201509;5293;16883;4919;16305;201;783;4196;13835;4397;14618
211150;201509;9667;28209;8794;27124;484;1724;7373;22701;7857;24425
211153;201509;2812;8654;2627;8412;417;1270;1912;6280;2329;7550
211157;201509;1206;3873;1036;3616;93;417;694;2477;787;2894
211160;201509;4056;13512;3453;12495;290;1395;2387;8422;2677;9817
211163;201509;1631;5446;1551;5330;45;144;1403;4915;1448;5059
211167;201509;1479;4939;1413;4846;44;206;1312;4486;1356;4692
211170;201509;6369;16863;6081;16521;109;342;5627;15203;5736;15545
211172;201509;2409;7105;2170;6756;148;621;1809;5496;1957;6117
211174;201509;2804;8160;2540;7828;75;359;2271;6877;2346;7236
211176;201509;4421;13722;3840;12965;458;1619;2740;9388;3198;11007
211178;201509;3703;9965;3526;9766;76;218;3335;9207;3411;9425
211180;201509;4233;14882;3984;14499;313;1294;3274;12011;3587;13305
211190;201509;2783;9381;2579;9087;91;440;2235;7880;2326;8320
211195;201509;1469;4500;1216;4183;75;233;1010;3602;1085;3835
211200;201509;2123;7098;1865;6750;329;1114;1249;4813;1578;5927
211210;201509;6807;20790;6484;20353;419;1215;5547;17640;5966;18855
211220;201509;33314;97073;28885;91419;5679;18455;18290;59248;23969;77703
211223;201509;5033;14936;4598;14231;627;1980;3218;10078;3845;12058
211227;201509;1569;5746;1448;5558;128;562;1144;4423;1272;4985
211230;201509;8355;27498;7575;26204;904;3247;5654;19874;6558;23121
211240;201509;8106;27777;7694;27255;286;1187;6892;24274;7178;25461
211245;201509;5386;15892;5346;15850;160;274;5118;15427;5278;15701
211250;201509;12754;43120;11976;42218;1573;4318;9304;35131;10877;39449
211260;201509;8527;26409;8176;25934;582;1998;7136;22562;7718;24560
211270;201509;10268;35302;9161;33884;548;2434;7319;27438;7867;29872
211280;201509;12631;37455;11839;36494;1154;2983;9704;31059;10858;34042
211285;201509;1725;6281;1519;5826;283;1179;780;3083;1063;4262
211290;201509;7168;23633;6906;23294;593;1747;5766;19953;6359;21700
211300;201509;8217;24788;7690;24075;180;534;7121;22479;7301;23013
211400;201509;11507;36028;10259;34328;2696;9054;5059;18597;7755;27651
220005;201509;1823;5259;1664;5018;72;293;1371;4006;1443;4299
220010;201509;1387;4020;1218;3762;73;276;945;2862;1018;3138
220020;201509;3273;10318;3083;9996;587;1928;1958;6340;2545;8268
220025;201509;2179;5401;1966;5073;32;102;1678;4258;1710;4360
220027;201509;1370;3718;1236;3541;67;190;1019;2939;1086;3129
220030;201509;3224;9006;3155;8899;168;567;2767;7721;2935;8288
220040;201509;7514;23543;7004;22639;1419;4645;4411;14253;5830;18898
220045;201509;1392;4522;1263;4273;65;271;958;3180;1023;3451
220050;201509;4434;13285;3891;12358;243;959;3092;9670;3335;10629
220060;201509;1934;4989;1829;4864;54;107;1658;4422;1712;4529
220070;201509;2407;7129;2199;6800;150;481;1774;5477;1924;5958
220080;201509;706;2161;660;2088;60;255;538;1641;598;1896
220090;201509;1803;4570;1529;4212;68;223;1311;3545;1379;3768
220095;201509;729;1975;676;1899;19;82;616;1691;635;1773
220100;201509;1356;4106;1138;3738;103;372;824;2702;927;3074
220105;201509;2208;7100;1967;6642;172;590;1446;4907;1618;5497
220110;201509;3387;9953;3177;9613;141;554;2730;8115;2871;8669
220115;201509;2379;8351;2283;8199;163;684;1975;7036;2138;7720
220117;201509;1312;3507;1080;3157;81;236;874;2562;955;2798
220120;201509;12223;35273;11332;34170;176;771;10639;31921;10815;32692
220130;201509;896;3049;776;2875;68;271;635;2353;703;2624
220140;201509;1627;4411;1440;4181;222;514;1123;3401;1345;3915
220150;201509;7000;21587;6597;21005;202;838;5799;18260;6001;19098
220155;201509;1112;3423;897;3011;57;236;584;1911;641;2147
220157;201509;1046;2663;931;2485;20;65;820;2163;840;2228
220160;201509;2667;7997;2357;7455;117;488;1876;5819;1993;6307
220170;201509;1352;4191;1173;3892;53;247;944;3084;997;3331
220173;201509;2042;6168;1656;5410;54;265;1347;4274;1401;4539
220177;201509;1769;5201;1734;5145;65;234;1608;4745;1673;4979
220180;201509;1140;3102;938;2728;28;101;657;1826;685;1927
220190;201509;4415;14841;4116;14386;617;2189;3052;10722;3669;12911
220191;201509;1397;4709;1326;4587;203;701;918;3173;1121;3874
220192;201509;1817;5118;1429;4422;116;383;1000;3085;1116;3468
220194;201509;1640;4959;1469;4661;123;443;1094;3380;1217;3823
220196;201509;1957;5819;1799;5557;186;615;1361;4202;1547;4817
220198;201509;1338;3778;1044;3393;16;48;968;3193;984;3241
220200;201509;4327;14646;4085;14292;626;2243;2875;10135;3501;12378
220202;201509;2078;6441;1856;6040;49;234;1608;5110;1657;5344
220205;201509;2775;7261;2484;6847;49;200;2217;6019;2266;6219
220207;201509;878;2704;756;2486;77;302;552;1791;629;2093
220208;201509;1797;5829;1547;5377;225;905;966;3299;1191;4204
220209;201509;1499;4594;1361;4373;53;235;1099;3489;1152;3724
220210;201509;1713;4643;1506;4319;40;168;1260;3527;1300;3695
220211;201509;1618;4683;1537;4579;81;327;1319;3843;1400;4170
220213;201509;1712;4896;1573;4638;41;156;1288;3699;1329;3855
220217;201509;1920;6234;1847;6146;43;162;1707;5738;1750;5900
220220;201509;10913;30364;9818;28709;852;2185;7121;21382;7973;23567
220225;201509;1075;3148;923;2942;30;126;773;2424;803;2550
220230;201509;5263;14627;4769;13908;168;496;4191;12237;4359;12733
220240;201509;2832;8851;2627;8479;165;618;2058;6609;2223;7227
220245;201509;1502;4018;1309;3747;40;135;1144;3298;1184;3433
220250;201509;3167;9043;2904;8645;78;307;2568;7593;2646;7900
220253;201509;1655;5018;1420;4594;156;576;1024;3268;1180;3844
220255;201509;1736;4933;1503;4532;71;291;1191;3418;1262;3709
220260;201509;4799;15295;4208;14194;345;1216;3122;10588;3467;11804
220265;201509;1327;4623;1203;4420;124;512;786;2934;910;3446
220270;201509;6634;21493;6381;21019;346;1645;5419;17258;5765;18903
220271;201509;1471;4118;1347;3924;87;226;1127;3330;1214;3556
220272;201509;1753;5353;1588;5058;63;269;1267;3958;1330;4227
220273;201509;1214;3530;1067;3263;101;318;769;2332;870;2650
220275;201509;2090;5369;1737;4937;32;134;1575;4401;1607;4535
220277;201509;2270;6363;2019;5966;96;311;1615;4730;1711;5041
220280;201509;1608;4306;1412;3969;101;368;1109;3015;1210;3383
220285;201509;1588;4301;1342;3955;27;115;1197;3534;1224;3649
220290;201509;5981;20181;5223;19127;491;2072;3916;14374;4407;16446
220300;201509;1921;6306;1721;6031;83;416;1389;4798;1472;5214
220310;201509;2374;8194;2220;8019;87;347;1920;7079;2007;7426
220320;201509;3218;9669;2743;8800;314;1112;1953;6247;2267;7359
220323;201509;1458;5218;1281;4957;144;597;970;3794;1114;4391
220325;201509;1167;3778;1013;3462;92;384;727;2463;819;2847
220327;201509;1315;4237;1204;4049;40;214;986;3229;1026;3443
220330;201509;3584;9821;3322;9492;141;405;2977;8557;3118;8962
220335;201509;1873;5671;1701;5467;54;170;1554;5049;1608;5219
220340;201509;1906;5286;1634;4875;126;397;1236;3664;1362;4061
220342;201509;1102;3698;1033;3591;74;321;820;2833;894;3154
220345;201509;2901;7532;2546;6982;70;165;2291;6300;2361;6465
220350;201509;3969;10537;3428;9675;210;621;2673;7506;2883;8127
220360;201509;1279;3583;1102;3297;107;355;836;2464;943;2819
220370;201509;9125;26263;8302;25165;397;1375;7307;22001;7704;23376
220375;201509;1534;4774;1429;4646;26;82;1357;4454;1383;4536
220380;201509;1382;3734;1167;3442;55;189;947;2745;1002;2934
220385;201509;837;2152;675;1891;20;74;544;1494;564;1568
220390;201509;9441;29240;8421;27364;2152;7305;3298;10835;5450;18140
220400;201509;1522;3581;1227;3126;40;139;1023;2508;1063;2647
220410;201509;1407;3973;1163;3613;98;379;883;2665;981;3044
220415;201509;872;2376;772;2246;57;170;559;1596;616;1766
220420;201509;2161;6267;1838;5621;93;284;1452;4433;1545;4717
220430;201509;2540;7298;2469;7202;154;499;2135;6182;2289;6681
220435;201509;1602;4795;1474;4574;47;178;1214;3736;1261;3914
220440;201509;2381;7919;2205;7683;140;526;1843;6345;1983;6871
220450;201509;2138;6582;1815;6110;404;1433;1060;3576;1464;5009
220455;201509;1309;4177;1218;4049;61;225;1087;3620;1148;3845
220460;201509;903;2448;836;2368;46;137;736;2061;782;2198
220465;201509;2343;7741;2116;7396;575;2133;1140;4019;1715;6152
220470;201509;3860;11486;3508;10898;206;683;2720;8329;2926;9012
220480;201509;2508;7131;2198;6674;159;460;1719;5223;1878;5683
220490;201509;2320;6632;2134;6391;73;276;1870;5526;1943;5802
220500;201509;3252;8798;2755;7949;109;475;2238;6266;2347;6741
220510;201509;2724;7913;2180;6969;101;402;1598;5030;1699;5432
220515;201509;1989;4824;1707;4453;169;405;1340;3536;1509;3941
220520;201509;5137;14098;4688;13488;144;439;4174;12043;4318;12482
220525;201509;1308;3696;1222;3565;51;171;1047;3036;1098;3207
220527;201509;1404;4308;1242;3973;146;493;893;2896;1039;3389
220530;201509;1235;3579;1098;3380;57;238;947;2835;1004;3073
220535;201509;890;2678;842;2617;88;289;626;1929;714;2218
220540;201509;3429;11171;3277;10934;149;654;2813;9265;2962;9919
220545;201509;1389;4665;1325;4543;174;662;950;3217;1124;3879
220550;201509;9160;29492;8531;28442;1049;3741;6084;20142;7133;23883
220551;201509;1430;4659;1309;4465;72;333;1049;3512;1121;3845
220552;201509;1590;4988;1376;4571;69;339;1042;3329;1111;3668
220553;201509;1613;4685;1320;4238;54;213;1017;3308;1071;3521
220554;201509;814;2360;715;2206;66;217;550;1698;616;1915
220555;201509;2296;6838;2133;6618;60;247;1924;5922;1984;6169
220556;201509;1448;4496;1289;4193;63;258;980;3102;1043;3360
220557;201509;1557;5075;1395;4757;167;597;929;3174;1096;3771
220558;201509;1053;3273;956;3102;63;283;727;2272;790;2555
220559;201509;1506;4279;1365;4034;33;107;1172;3449;1205;3556
220560;201509;1682;4168;1389;3762;71;189;1151;3077;1222;3266
220570;201509;7210;23332;6785;22569;1288;4268;4313;14712;5601;18980
220580;201509;6461;20664;6269;20394;309;996;5625;18318;5934;19314
220585;201509;2004;7123;1894;6920;179;703;1495;5467;1674;6170
220590;201509;1325;3974;1197;3795;208;694;790;2555;998;3249
220595;201509;2312;6832;2151;6617;46;203;1935;5887;1981;6090
220600;201509;1289;3124;1046;2822;175;321;755;2200;930;2521
220605;201509;1962;5740;1680;5281;84;279;1349;4193;1433;4472
220610;201509;2688;8148;2580;7994;71;275;2332;7187;2403;7462
220620;201509;7530;25238;7296;24910;321;1483;6474;21852;6795;23335
220630;201509;401;1235;338;1117;55;184;182;610;237;794
220635;201509;1689;5970;1528;5618;95;451;1084;3911;1179;4362
220640;201509;2666;7765;2418;7415;127;442;2013;6115;2140;6557
220650;201509;2262;6559;2003;6099;126;444;1564;4700;1690;5144
220660;201509;2529;8081;2262;7718;168;778;1851;6124;2019;6902
220665;201509;1185;4069;1110;3933;29;153;991;3479;1020;3632
220667;201509;1731;5689;1631;5541;71;252;1380;4701;1451;4953
220669;201509;1859;6085;1746;5883;271;1096;1159;3814;1430;4910
220670;201509;2034;6024;1824;5753;149;381;1496;4870;1645;5251
220672;201509;2527;7222;2382;7051;239;702;1961;5857;2200;6559
220675;201509;1278;3686;1195;3540;80;212;941;2799;1021;3011
220680;201509;2264;7314;2132;7132;170;563;1764;5957;1934;6520
220690;201509;1680;4684;1457;4318;100;313;1159;3471;1259;3784
220695;201509;909;2587;831;2459;41;130;655;1920;696;2050
220700;201509;8602;24604;7516;22904;545;1896;5778;17471;6323;19367
220710;201509;818;2399;681;2160;41;126;497;1578;538;1704
220720;201509;2010;5416;1917;5298;55;167;1702;4679;1757;4846
220730;201509;1396;3940;1188;3615;30;140;1005;3004;1035;3144
220735;201509;1013;2613;821;2273;42;145;662;1789;704;1934
220740;201509;1357;4405;1192;4175;104;352;961;3439;1065;3791
220750;201509;3980;11447;3689;10997;409;996;2861;8807;3270;9803
220755;201509;1232;3446;1109;3240;53;184;891;2553;944;2737
220760;201509;2657;9211;2466;8951;147;714;2043;7303;2190;8017
220770;201509;22242;73381;19733;68561;6500;23622;6811;24556;13311;48178
220775;201509;1244;3327;1205;3282;16;47;1167;3173;1183;3220
220777;201509;1627;4492;1439;4218;82;222;1130;3287;1212;3509
220779;201509;1327;3547;1274;3468;44;171;1138;3007;1182;3178
220780;201509;5983;15944;5279;14895;391;1081;4257;12065;4648;13146
220785;201509;1252;3336;1182;3212;46;118;1062;2861;1108;2979
220790;201509;9969;30798;9250;29666;858;2989;7267;23153;8125;26142
220793;201509;841;2388;767;2275;46;176;630;1838;676;2014
220795;201509;1464;4139;1407;4056;70;210;1276;3679;1346;3889
220800;201509;16233;44635;14651;42362;988;3374;11180;31770;12168;35144
220810;201509;3325;9637;2863;8842;137;555;2263;6886;2400;7441
220820;201509;5332;14689;4892;14063;198;661;4348;12386;4546;13047
220830;201509;7515;21191;6982;20317;678;2025;5433;15857;6111;17882
220840;201509;14255;45061;12612;41725;2969;9984;5864;19750;8833;29734
220850;201509;2866;9844;2717;9658;123;503;2401;8586;2524;9089
220855;201509;633;1923;551;1780;38;151;405;1279;443;1430
220860;201509;961;2596;853;2426;38;139;705;1975;743;2114
220865;201509;2627;7262;2119;6375;84;399;1681;4866;1765;5265
220870;201509;2271;7602;2027;7265;98;438;1796;6383;1894;6821
220880;201509;4748;12853;4434;12479;117;329;4133;11678;4250;12007
220885;201509;1308;4693;1147;4393;101;473;851;3232;952;3705
220887;201509;1419;3500;1214;3212;20;72;1125;2950;1145;3022
220890;201509;1620;5649;1446;5306;126;461;1104;4137;1230;4598
220900;201509;1866;5331;1644;4926;57;158;1399;4190;1456;4348
220910;201509;1628;4875;1427;4577;52;162;1240;4035;1292;4197
220915;201509;1014;2871;871;2600;38;163;673;1947;711;2110
220920;201509;1345;4817;1223;4640;104;509;916;3391;1020;3900
220930;201509;1362;4543;1300;4450;60;260;1075;3662;1135;3922
220935;201509;1082;3300;945;3009;44;187;648;1970;692;2157
220937;201509;1544;4217;1299;3789;64;236;1006;2855;1070;3091
220940;201509;1376;4307;1270;4087;81;345;940;2957;1021;3302
220945;201509;437;1603;399;1530;37;162;284;1067;321;1229
220950;201509;1336;3330;966;2734;30;121;696;1907;726;2028
220955;201509;1472;4234;1283;3910;84;262;954;2880;1038;3142
220960;201509;892;2325;705;2013;16;52;555;1566;571;1618
220965;201509;1706;5061;1591;4886;66;312;1333;3967;1399;4279
220970;201509;2186;5784;1615;4863;149;465;1098;3330;1247;3795
220975;201509;662;2172;615;2104;30;153;559;1865;589;2018
220980;201509;1289;3914;1127;3637;89;326;825;2667;914;2993
220985;201509;1213;3555;1145;3455;94;354;866;2524;960;2878
220987;201509;1493;4735;1337;4468;79;348;1029;3334;1108;3682
220990;201509;1836;5284;1582;4865;42;208;1227;3680;1269;3888
220995;201509;1325;3827;968;3255;106;382;679;2330;785;2712
220997;201509;2216;6926;2094;6742;61;261;1931;6161;1992;6422
221000;201509;4273;13084;3965;12546;362;1325;3023;9451;3385;10776
221005;201509;1455;4554;1328;4311;501;1520;549;1915;1050;3435
221010;201509;1142;3083;969;2859;50;145;818;2397;868;2542
221020;201509;1789;5545;1662;5313;78;329;1224;3820;1302;4149
221030;201509;1505;4456;1352;4193;67;284;1117;3410;1184;3694
221035;201509;1441;3996;1351;3878;50;113;1250;3648;1300;3761
221037;201509;629;1862;561;1749;15;57;408;1214;423;1271
221038;201509;612;1712;496;1509;44;134;316;967;360;1101
221039;201509;909;2597;828;2478;49;202;684;1979;733;2181
221040;201509;4631;14262;4339;13780;214;758;3540;11273;3754;12031
221050;201509;3484;10662;3286;10390;178;654;2819;8851;2997;9505
221060;201509;8202;23743;7210;22141;707;2364;5307;16229;6014;18593
221062;201509;1287;4526;1191;4332;56;296;1005;3595;1061;3891
221063;201509;1045;3465;963;3301;235;766;538;1968;773;2734
221065;201509;2780;7652;2498;7190;155;444;2036;5798;2191;6242
221070;201509;3886;12239;3419;11447;171;677;2750;9207;2921;9884
221080;201509;3492;9085;2983;8391;122;375;2530;7096;2652;7471
221090;201509;1395;3835;1189;3499;39;176;979;2804;1018;2980
221093;201509;1655;4942;1558;4732;271;875;878;2589;1149;3464
221095;201509;953;2579;859;2441;22;56;732;2079;754;2135
221097;201509;792;2236;643;1970;43;168;445;1309;488;1477
221100;201509;115946;336699;105271;318630;20473;65515;62483;185949;82956;251464
221110;201509;10113;32119;9482;31324;438;1838;7981;26006;8419;27844
221120;201509;3960;12956;3739;12566;744;2625;2396;8064;3140;10689
221130;201509;4591;13270;3858;11767;1171;3578;1671;5140;2842;8718
221135;201509;1516;4674;1396;4501;120;447;1148;3647;1268;4094
221140;201509;1335;3295;1209;3126;44;110;1051;2691;1095;2801
221150;201509;1210;3104;983;2707;29;127;776;2079;805;2206
221160;201509;830;2187;777;2104;39;108;615;1672;654;1780
221170;201509;1148;3556;1061;3409;56;193;855;2738;911;2931
230010;201509;3267;9063;2726;8140;259;928;2020;5867;2279;6795
230015;201509;2910;10034;2718;9609;399;1608;1641;5683;2040;7291
230020;201509;13743;44906;13306;44144;735;2772;11259;37294;11994;40066
230030;201509;11995;34631;10872;32876;534;1857;8889;26659;9423;28516
230040;201509;4615;12647;3886;11411;332;1155;2764;7971;3096;9126
230050;201509;2636;9028;2069;7507;434;1636;775;2819;1209;4455
230060;201509;2172;6274;1867;5715;85;314;1395;4202;1480;4516
230070;201509;4367;11994;3712;10937;349;1179;2516;7432;2865;8611
230075;201509;8760;31449;8181;30266;611;3157;6290;22585;6901;25742
230080;201509;2414;6321;1958;5652;108;366;1603;4604;1711;4970
230090;201509;3784;11081;3348;10325;448;1570;2312;7075;2760;8645
230100;201509;16713;49738;15265;47094;2607;8702;9045;28042;11652;36744
230110;201509;13161;41934;12036;39502;2307;7924;6546;21248;8853;29172
230120;201509;7964;21963;6826;20280;788;2279;4584;14363;5372;16642
230125;201509;3021;8767;2472;7742;173;598;1785;5538;1958;6136
230130;201509;5924;19233;4961;17180;450;1796;3381;11509;3831;13305
230140;201509;3583;11388;3036;10393;370;1368;2014;6956;2384;8324
230150;201509;1701;5347;1462;4852;295;1072;793;2568;1088;3640
230160;201509;6260;18729;5567;17652;345;1379;4399;13759;4744;15138
230170;201509;6405;20006;5453;18178;362;1403;3851;12631;4213;14034
230180;201509;1768;5188;1554;4757;104;427;1111;3244;1215;3671
230185;201509;4042;13208;3653;12479;587;2098;2253;7888;2840;9986
230190;201509;12839;40883;11227;37545;2266;8302;5378;17703;7644;26005
230195;201509;5169;15813;4551;14775;329;1367;3492;10971;3821;12338
230200;201509;5274;15129;4732;14079;341;1098;3620;10673;3961;11771
230205;201509;4241;13545;3782;12744;258;1126;2716;9018;2974;10144
230210;201509;8983;25826;7767;23897;1586;4927;4342;13674;5928;18601
230220;201509;13118;37550;11782;35217;1177;3973;8397;24574;9574;28547
230230;201509;7460;24005;6739;22566;973;3284;4271;14497;5244;17781
230240;201509;13727;38804;12052;35927;614;2277;9403;27407;10017;29684
230250;201509;9866;30619;9730;30402;583;2192;7603;23360;8186;25552
230260;201509;14473;48424;13402;46224;2322;8572;7458;26161;9780;34733
230270;201509;7489;22151;6454;20362;736;2591;4243;13467;4979;16058
230280;201509;19662;58331;17529;54668;1896;6064;12526;39137;14422;45201
230290;201509;4834;14698;4110;13218;562;1790;2709;8732;3271;10522
230300;201509;4364;13282;4160;12988;282;1059;3367;10377;3649;11436
230310;201509;4834;14395;4221;13351;253;1055;3068;9495;3321;10550
230320;201509;6969;22043;6371;20964;460;1840;4707;15303;5167;17143
230330;201509;4762;13977;4072;12618;337;1145;2860;8727;3197;9872
230340;201509;3294;11175;2998;10519;375;1479;1930;6603;2305;8082
230350;201509;18115;55035;16373;52042;2090;7449;9522;30639;11612;38088
230360;201509;3290;9386;2671;8230;258;892;1736;5251;1994;6143
230365;201509;2989;8118;2615;7489;130;478;2081;5862;2211;6340
230370;201509;53857;172531;48014;162247;12758;45518;21396;74177;34154;119695
230380;201509;6491;19087;5491;17242;340;1165;3906;12212;4246;13377
230390;201509;3509;11066;3097;10342;254;1112;2170;7081;2424;8193
230393;201509;3287;10769;2781;9733;221;1057;1962;6589;2183;7646
230395;201509;5527;16374;4923;15298;791;2487;2949;9400;3740;11887
230400;201509;5386;16464;4691;15346;294;1296;3585;11455;3879;12751
230410;201509;14285;45639;12453;41716;1799;6449;7565;25343;9364;31792
230420;201509;24017;77808;21783;73226;5008;18113;10046;33522;15054;51635
230423;201509;4187;13806;3855;13129;264;1108;2884;9702;3148;10810
230425;201509;5625;18571;5117;17414;716;2525;3274;11166;3990;13691
230426;201509;2722;7595;2169;6539;87;360;1590;4650;1677;5010
230427;201509;1838;5460;1364;4405;191;620;769;2414;960;3034
230428;201509;8629;26918;8188;26089;1317;4655;4864;15271;6181;19926
230430;201509;4523;14433;4167;13749;332;1347;2979;9576;3311;10923
230435;201509;4816;15510;4327;14594;796;3080;2287;7532;3083;10612
230440;201509;349188;1038826;317364;982351;75400;245044;146900;456959;222300;702003
230445;201509;4539;12254;3810;11159;274;831;2713;7947;2987;8778
230450;201509;3521;11206;3039;10296;364;1529;1954;6444;2318;7973
230460;201509;1888;6254;1649;5810;172;706;1123;3898;1295;4604
230465;201509;4103;12251;3441;11039;260;1078;2253;7005;2513;8083
230470;201509;10751;39323;9909;37536;1299;5387;6747;25537;8046;30924
230480;201509;1462;4626;1237;4200;167;638;801;2677;968;3315
230490;201509;2446;7392;2109;6737;373;1274;1024;3129;1397;4403
230495;201509;5794;19108;5159;17993;729;3037;2813;9675;3542;12712
230500;201509;9364;32850;8911;31970;634;2779;6756;24128;7390;26907
230510;201509;1502;5326;1161;4443;312;1292;357;1355;669;2647
230520;201509;4864;14919;4334;13932;458;1702;2807;8890;3265;10592
230523;201509;14557;47219;12604;42716;2946;10923;3170;10852;6116;21775
230526;201509;4167;12341;3514;11206;241;1001;2659;8310;2900;9311
230530;201509;5391;17417;4837;16667;1006;3531;3039;10800;4045;14331
230533;201509;3959;11136;3500;10272;280;820;2687;7932;2967;8752
230535;201509;5583;16451;4867;15165;750;2346;2875;9243;3625;11589
230540;201509;17728;51691;15937;48832;794;3030;12993;39243;13787;42273
230550;201509;19284;57765;17242;53812;3377;11373;8845;27013;12222;38386
230560;201509;6636;19190;5846;17758;250;1002;4494;13364;4744;14366
230565;201509;3439;9536;2781;8294;137;496;2028;5981;2165;6477
230570;201509;3672;10002;3250;9478;118;452;2732;7878;2850;8330
230580;201509;10027;30474;9319;29465;545;1954;8003;25232;8548;27186
230590;201509;8991;28066;7751;25696;589;2484;5506;17718;6095;20202
230600;201509;3741;10428;2898;8755;155;555;1895;5678;2050;6233
230610;201509;6039;19457;5583;18711;783;2716;3806;12907;4589;15623
230620;201509;2160;6158;1703;5167;204;674;961;2817;1165;3491
230625;201509;8021;25772;7115;23719;2032;7306;2097;6888;4129;14194
230630;201509;11278;35754;10212;33779;2654;8310;4736;16727;7390;25037
230640;201509;25899;84707;23866;81640;2653;9988;17907;61163;20560;71151
230650;201509;4974;15171;4463;14187;316;1266;3383;10463;3699;11729
230655;201509;9121;34331;8730;33628;806;3444;6860;26582;7666;30026
230660;201509;6177;19245;5252;17511;381;1675;3874;12583;4255;14258
230670;201509;6208;16486;4904;14246;193;685;3761;10569;3954;11254
230680;201509;2825;8273;2367;7395;375;1258;1365;4225;1740;5483
230690;201509;6323;20548;6165;20230;592;2287;4068;13059;4660;15346
230700;201509;9319;26353;8287;24535;725;2562;5775;16534;6500;19096
230710;201509;7495;24375;6488;22461;730;2591;4536;15783;5266;18374
230720;201509;1861;5871;1572;5269;213;763;924;3086;1137;3849
230725;201509;3723;12592;3189;11237;758;2710;1177;4117;1935;6827
230730;201509;57329;172515;47260;155464;12894;47277;12770;43220;25664;90497
230740;201509;5986;18069;5448;17155;253;1047;4302;13287;4555;14334
230750;201509;8467;24359;7219;22307;457;1660;5450;16600;5907;18260
230760;201509;10501;31269;9703;29662;1051;3782;6752;19842;7803;23624
230763;201509;4246;13117;3823;12307;204;962;2922;9059;3126;10021
230765;201509;38352;121244;34117;112670;8928;31782;10949;36325;19877;68107
230770;201509;24891;68985;22512;65629;2878;8881;14862;43230;17740;52111
230780;201509;5933;22935;5658;22299;1397;5710;2750;11291;4147;17001
230790;201509;2725;8785;2500;8395;263;987;1820;6116;2083;7103
230800;201509;7503;26642;6765;24985;1500;5945;2968;10809;4468;16754
230810;201509;11961;38890;11264;37673;919;3339;8777;29294;9696;32633
230820;201509;3334;11419;2898;10440;428;1772;1586;5599;2014;7371
230830;201509;7507;22857;6615;21192;555;2089;4750;15056;5305;17145
230835;201509;4009;10627;3282;9537;223;711;2492;7177;2715;7888
230837;201509;3178;10789;2751;9929;320;1376;1805;6348;2125;7724
230840;201509;9162;29791;8367;28407;746;2901;6214;21125;6960;24026
230850;201509;9749;30141;9018;28929;1050;3545;6227;19979;7277;23524
230860;201509;5163;14811;4546;13828;255;952;3646;10954;3901;11906
230870;201509;18888;49634;16270;45712;799;2577;12502;34815;13301;37392
230880;201509;1922;6569;1807;6335;173;768;1228;4210;1401;4978
230890;201509;3905;14293;3591;13581;466;2111;2247;8250;2713;10361
230900;201509;2944;9799;2481;8805;532;1837;1166;4238;1698;6075
230910;201509;3192;9337;2571;8215;211;916;1815;5612;2026;6528
230920;201509;4686;13617;4345;13179;285;1093;3576;10776;3861;11869
230930;201509;7400;22319;6490;20583;658;2211;4369;13899;5027;16110
230940;201509;7792;22218;6754;20598;359;1165;5364;16426;5723;17591
230945;201509;6202;18591;5326;17263;484;1766;3647;11990;4131;13756
230950;201509;6415;17719;5790;16870;269;780;4888;14503;5157;15283
230960;201509;14157;43487;12835;40950;2588;8689;5836;18746;8424;27435
230970;201509;13451;41211;11743;37961;2357;8404;5261;16651;7618;25055
230980;201509;2964;9323;2581;8614;724;2420;1191;4182;1915;6602
230990;201509;1733;5163;1439;4582;128;534;909;2772;1037;3306
231000;201509;2787;7542;2171;6344;166;570;1381;3893;1547;4463
231010;201509;3203;8695;2604;7691;266;866;1760;5048;2026;5914
231020;201509;7904;26427;7446;25444;1326;4558;4517;15715;5843;20273
231025;201509;8012;24484;7246;23184;1012;3371;4687;15226;5699;18597
231030;201509;7679;24976;6486;22481;1172;4381;3571;12341;4743;16722
231040;201509;3152;10102;2787;9367;189;807;1978;6464;2167;7271
231050;201509;12042;34099;10170;30736;821;2767;7481;22354;8302;25121
231060;201509;2410;7814;2212;7447;167;787;1555;5050;1722;5837
231070;201509;8782;27828;7967;26170;1305;4549;4593;15152;5898;19701
231080;201509;4072;12709;3690;12042;204;1016;2814;8774;3018;9790
231085;201509;4754;14791;4545;14501;725;2276;3076;10117;3801;12393
231090;201509;4136;11628;3300;9934;186;647;2295;6795;2481;7442
231095;201509;2311;7438;1971;6749;219;846;1296;4418;1515;5264
231100;201509;3211;9888;2664;8802;230;882;1875;6124;2105;7006
231110;201509;3598;11990;3533;11876;358;1387;2408;8022;2766;9409
231120;201509;2092;7027;1954;6727;299;1107;1250;4330;1549;5437
231123;201509;2106;5778;1789;5222;141;404;1386;4024;1527;4428
231126;201509;6277;17799;5267;16124;322;1255;3848;11563;4170;12818
231130;201509;19216;58922;17211;55536;3496;11576;9712;32707;13208;44283
231135;201509;4254;12651;3572;11435;287;1028;2503;7936;2790;8964
231140;201509;16674;52741;14684;48946;1311;5787;9614;30871;10925;36658
231150;201509;5903;16853;4937;15069;801;2614;2555;7712;3356;10326
231160;201509;5696;19044;5328;18321;887;3148;3363;11606;4250;14754
231170;201509;4230;13663;3796;12751;308;1300;2630;8564;2938;9864
231180;201509;14045;41996;12585;39078;2106;7037;7316;22308;9422;29345
231190;201509;4599;12937;3887;11840;265;957;2962;8812;3227;9769
231195;201509;4576;15417;3885;14002;431;1926;2645;9351;3076;11277
231200;201509;7749;26582;6745;24476;474;2384;4744;16725;5218;19109
231210;201509;5042;15622;4353;14654;301;1419;3360;11119;3661;12538
231220;201509;11955;34703;10559;32100;635;2421;7777;23128;8412;25549
231230;201509;9019;30406;8235;29168;794;3359;6079;21458;6873;24817
231240;201509;12237;38357;10925;35700;2290;7754;5198;17173;7488;24927
231250;201509;1968;5729;1352;4213;430;1306;284;884;714;2190
231260;201509;3551;10472;3187;9903;512;1576;1966;6218;2478;7794
231270;201509;7292;20138;6406;18726;350;1419;4791;13615;5141;15034
231280;201509;1746;5725;1619;5472;180;649;1107;3753;1287;4402
231290;201509;33801;115095;30434;107338;6457;25455;12463;42606;18920;68061
231300;201509;4589;13245;3694;11477;255;986;2534;7606;2789;8592
231310;201509;7434;21094;6110;18351;937;2891;3379;9945;4316;12836
231320;201509;6971;21355;5910;19253;327;1382;4201;13567;4528;14949
231325;201509;2709;8072;2367;7507;305;1009;1545;4998;1850;6007
231330;201509;12367;39107;10574;35524;1637;5537;6403;21757;8040;27294
231335;201509;5360;15319;4594;13912;216;892;3548;10454;3764;11346
231340;201509;17512;57466;16097;55288;1119;3902;12794;44712;13913;48614
231350;201509;13184;41641;12677;40893;1114;3475;10566;34547;11680;38022
231355;201509;4398;14096;4082;13563;300;1237;3032;9933;3332;11170
231360;201509;7747;24715;6897;23190;1366;4607;4065;14076;5431;18683
231370;201509;2471;6853;1930;5959;89;285;1425;4393;1514;4678
231375;201509;4157;14239;3866;13688;238;1116;3027;10530;3265;11646
231380;201509;5220;16640;4925;16236;622;2125;3381;11449;4003;13574
231390;201509;3424;10784;3149;10321;267;970;2217;7205;2484;8175
231395;201509;3870;12646;3493;11942;632;2184;1943;6698;2575;8882
231400;201509;9080;27906;8453;26649;569;2185;6221;19302;6790;21487
231410;201509;13855;47135;12729;45375;1290;4808;9606;34518;10896;39326
240010;201509;2443;7354;2033;6494;356;1258;977;3019;1333;4277
240020;201509;10709;33623;9476;31233;2105;7420;4534;14990;6639;22410
240030;201509;2421;7034;2351;6920;131;449;1976;5693;2107;6142
240040;201509;836;2474;690;2177;25;126;499;1482;524;1608
240050;201509;3451;9375;2935;8480;123;423;2339;6646;2462;7069
240060;201509;1395;4029;1242;3731;64;247;981;2828;1045;3075
240070;201509;2596;7516;2420;7173;387;1204;1595;4651;1982;5855
240080;201509;3060;8215;2627;7633;217;627;2002;5792;2219;6419
240090;201509;2310;6213;1889;5463;45;162;1458;4093;1503;4255
240100;201509;8230;23549;7370;21767;644;2111;5292;15233;5936;17344
240110;201509;4857;15103;4300;13980;670;2472;2378;7384;3048;9856
240120;201509;2696;9204;2570;8950;389;1492;1647;5663;2036;7155
240130;201509;2803;7552;2396;6929;131;478;1893;5325;2024;5803
240140;201509;2234;6684;1902;6076;322;1204;1041;3193;1363;4397
240145;201509;5792;18312;5215;17264;1411;4891;2489;8411;3900;13302
240150;201509;975;2985;798;2608;82;336;512;1598;594;1934
240160;201509;1438;4630;1241;4280;165;622;755;2671;920;3293
240165;201509;892;2836;779;2596;121;366;477;1670;598;2036
240170;201509;2382;7143;2075;6579;503;1764;954;2944;1457;4708
240180;201509;2602;8264;2321;7698;473;1678;1270;4258;1743;5936
240185;201509;1420;4750;1350;4623;107;387;1053;3626;1160;4013
240190;201509;967;3004;868;2828;48;223;642;2040;690;2263
240200;201509;13797;35916;11381;32537;2557;7506;5198;15248;7755;22754
240210;201509;2875;8066;2600;7659;201;735;2071;5936;2272;6671
240220;201509;7326;24394;6860;23697;635;2893;5157;17328;5792;20221
240230;201509;5620;14990;4903;13855;173;572;4127;11572;4300;12144
240240;201509;1843;5582;1252;4120;272;1007;239;673;511;1680
240250;201509;2670;7791;2507;7574;127;426;2126;6377;2253;6803
240260;201509;12245;41257;11554;40094;1868;7267;7318;25270;9186;32537
240270;201509;2236;7178;2055;6876;199;687;1571;5318;1770;6005
240280;201509;1570;4391;1374;4092;84;303;1097;3228;1181;3531
240290;201509;1299;4120;1141;3812;71;359;743;2329;814;2688
240300;201509;2256;6265;1638;4939;362;1168;596;1736;958;2904
240310;201509;9587;27364;8682;25904;1266;4218;4770;14248;6036;18466
240320;201509;2048;6068;1606;5148;61;264;1172;3597;1233;3861
240325;201509;35069;96424;27441;84014;8484;27803;6708;20883;15192;48686
240330;201509;1499;4542;1255;4021;82;321;816;2509;898;2830
240340;201509;1979;5366;1681;4884;199;619;1185;3392;1384;4011
240350;201509;1929;5727;1800;5566;128;446;1542;4770;1670;5216
240360;201509;7120;21296;6209;19922;1205;4152;3399;11164;4604;15316
240370;201509;1972;5474;1594;4781;225;663;941;2848;1166;3511
240375;201509;846;2300;735;2116;119;396;450;1208;569;1604
240380;201509;2448;7310;1882;6025;259;861;948;2992;1207;3853
240390;201509;938;2588;782;2298;46;175;558;1576;604;1751
240400;201509;1333;3656;1099;3226;93;318;757;2144;850;2462
240410;201509;498;1636;459;1560;85;346;276;902;361;1248
240420;201509;4527;17353;4265;16756;951;4036;2286;9041;3237;13077
240430;201509;3259;9207;2976;8694;143;570;2354;6627;2497;7197
240440;201509;2531;6644;2250;6205;611;1702;1095;3010;1706;4712
240450;201509;3797;11289;3270;10270;311;1288;2049;6056;2360;7344
240460;201509;2893;8906;2733;8689;188;800;2234;6899;2422;7699
240470;201509;3632;11290;2885;9679;810;2605;1311;4496;2121;7101
240480;201509;523;1372;408;1144;39;117;223;601;262;718
240485;201509;2012;6275;1767;5809;308;1073;1012;3360;1320;4433
240490;201509;1657;4223;1393;3822;39;149;1160;3091;1199;3240
240500;201509;2105;6072;1904;5765;130;447;1480;4447;1610;4894
240510;201509;1785;5323;1651;5102;153;509;1289;3980;1442;4489
240520;201509;1245;3643;1121;3432;120;431;815;2421;935;2852
240530;201509;2033;6519;1851;6226;331;1174;1229;4122;1560;5296
240540;201509;1615;4994;1548;4884;121;430;1258;3938;1379;4368
240550;201509;821;2331;709;2143;43;151;539;1593;582;1744
240560;201509;3156;9296;2947;8969;347;1102;2200;6657;2547;7759
240570;201509;3087;8677;2321;6941;521;1688;831;2197;1352;3885
240580;201509;7537;23826;6994;22837;854;3099;5206;16753;6060;19852
240590;201509;783;2223;681;2030;35;138;510;1476;545;1614
240600;201509;1628;4799;1280;4060;162;591;703;2126;865;2717
240610;201509;4701;13406;4051;12169;500;1637;2539;7414;3039;9051
240615;201509;1035;3020;837;2641;161;531;456;1394;617;1925
240620;201509;1754;5490;1560;5167;195;628;1124;3779;1319;4407
240630;201509;1994;6112;1841;5845;177;483;1310;4293;1487;4776
240640;201509;915;2647;771;2402;60;279;528;1562;588;1841
240650;201509;3791;11383;3415;10837;202;739;2727;8607;2929;9346
240660;201509;2391;7674;2242;7458;218;782;1726;5738;1944;6520
240670;201509;2688;8015;2209;6991;292;975;1221;3797;1513;4772
240680;201509;1502;4415;1211;3880;107;369;758;2396;865;2765
240690;201509;935;2619;812;2408;58;217;658;1896;716;2113
240700;201509;2656;7924;2192;7036;89;412;1670;5224;1759;5636
240710;201509;18863;49149;16287;45362;3059;8427;9379;26539;12438;34966
240720;201509;5221;14888;4736;13984;1510;4617;2066;5845;3576;10462
240725;201509;1045;3170;829;2676;73;244;481;1515;554;1759
240730;201509;2161;6509;1854;5934;128;450;1373;4375;1501;4825
240740;201509;1981;5821;1759;5406;160;612;1243;3676;1403;4288
240750;201509;2166;8110;2000;7782;506;2149;947;3674;1453;5823
240760;201509;1324;3637;1117;3355;104;238;831;2676;935;2914
240770;201509;3137;9001;2801;8530;165;659;2296;6871;2461;7530
240780;201509;6307;17268;4941;15075;875;2706;2589;8014;3464;10720
240790;201509;886;2699;730;2425;41;153;491;1656;532;1809
240800;201509;35741;102516;31533;95275;7675;24037;13075;39880;20750;63917
240810;201509;85391;246635;78645;234874;20840;63921;37000;111913;57840;175834
240820;201509;6520;19700;5612;18227;1364;4789;2341;7851;3705;12640
240830;201509;8599;26830;8036;25982;429;1728;6742;21534;7171;23262
240840;201509;1255;3480;1044;3139;86;276;666;1937;752;2213
240850;201509;1292;3836;935;3009;150;512;445;1403;595;1915
240860;201509;1314;3731;1076;3303;58;214;809;2401;867;2615
240870;201509;1190;3260;960;2829;81;270;594;1665;675;1935
240880;201509;1137;3847;1070;3732;98;431;835;2818;933;3249
240890;201509;5081;14470;4261;12913;912;2942;1840;5408;2752;8350
240895;201509;2611;9030;2389;8622;270;1066;1677;6091;1947;7157
240910;201509;2789;8487;2469;7869;178;675;1852;5830;2030;6505
240920;201509;786;2546;679;2310;135;526;319;1044;454;1570
240930;201509;3448;9058;3046;8568;166;471;2473;7018;2639;7489
240933;201509;1373;3991;1230;3760;122;436;879;2609;1001;3045
240940;201509;6444;17508;5209;15349;935;2718;2852;8433;3787;11151
240950;201509;996;3236;942;3138;67;314;719;2308;786;2622
240960;201509;782;2446;687;2259;86;304;466;1534;552;1838
240970;201509;1944;5383;1631;4858;122;439;1213;3475;1335;3914
240980;201509;3035;9974;2791;9510;531;1907;1686;5729;2217;7636
240990;201509;2857;8459;2656;8039;452;1453;1583;4710;2035;6163
241000;201509;1057;2945;896;2655;46;168;625;1811;671;1979
241010;201509;2904;9727;2670;9259;343;1448;1826;6107;2169;7555
241020;201509;2062;5758;1659;4954;150;465;1059;3055;1209;3520
241025;201509;1634;4967;1454;4628;85;374;1022;3151;1107;3525
241030;201509;2492;8223;2235;7721;196;856;1622;5524;1818;6380
241040;201509;2248;7696;2052;7333;205;825;1419;5115;1624;5940
241050;201509;1241;3705;1090;3431;58;249;832;2537;890;2786
241060;201509;883;2542;793;2384;59;181;580;1732;639;1913
241070;201509;820;2343;734;2190;73;257;515;1472;588;1729
241080;201509;1169;3447;962;3044;43;187;703;2178;746;2365
241090;201509;2174;6364;1833;5752;135;601;1381;4213;1516;4814
241100;201509;1186;3545;1017;3139;99;314;662;2027;761;2341
241105;201509;1202;3633;1074;3394;239;785;532;1728;771;2513
241110;201509;823;2584;680;2275;47;210;432;1411;479;1621
241120;201509;7324;22379;6614;21235;1432;4577;3792;12559;5224;17136
241140;201509;3389;9348;2916;8392;325;915;1994;5662;2319;6577
241142;201509;715;2156;524;1720;139;527;178;540;317;1067
241150;201509;5458;16173;4858;15135;586;1911;3243;10086;3829;11997
241160;201509;983;2869;894;2706;142;441;562;1692;704;2133
241170;201509;1149;3417;1063;3265;98;290;808;2491;906;2781
241180;201509;931;2624;762;2303;98;315;393;1145;491;1460
241190;201509;1207;3321;966;2839;69;251;591;1649;660;1900
241200;201509;19174;55876;16907;52198;4028;13307;7499;23364;11527;36671
241210;201509;1470;4126;1171;3500;182;629;618;1767;800;2396
241220;201509;7708;25618;7183;24600;1652;5944;3775;13078;5427;19022
241230;201509;3005;8831;2736;8424;164;658;2279;6859;2443;7517
241240;201509;1197;3523;813;2606;104;363;336;1079;440;1442
241250;201509;5945;18449;4998;16604;237;1237;3843;12332;4080;13569
241255;201509;1655;6375;1530;6075;353;1516;754;3008;1107;4524
241260;201509;5075;13741;4088;12191;218;892;2996;8704;3214;9596
241270;201509;1831;5676;1610;5221;146;543;1058;3379;1204;3922
241280;201509;1862;5403;1695;5078;214;651;1182;3523;1396;4174
241290;201509;3054;8610;2560;7735;290;924;1690;5052;1980;5976
241300;201509;1450;4156;1252;3802;59;192;891;2707;950;2899
241310;201509;1590;4815;1461;4587;140;493;1070;3317;1210;3810
241320;201509;919;3140;833;2954;123;486;506;1776;629;2262
241330;201509;1446;4502;1338;4356;108;462;1097;3480;1205;3942
241335;201509;2700;8230;2489;7844;152;535;2048;6395;2200;6930
241340;201509;1845;5731;1575;5136;369;1314;689;2156;1058;3470
241350;201509;1926;6103;1737;5748;148;630;1285;4095;1433;4725
241355;201509;1393;3936;1140;3508;59;211;931;2836;990;3047
241360;201509;2027;5535;1686;4879;76;218;1238;3475;1314;3693
241370;201509;1347;4091;1096;3576;145;536;613;1931;758;2467
241380;201509;665;1887;558;1671;90;279;322;954;412;1233
241390;201509;2718;9016;2536;8687;318;1253;1832;6216;2150;7469
241400;201509;3752;10938;3429;10506;402;1322;2524;7750;2926;9072
241410;201509;2544;7661;2280;7267;509;1720;1221;3863;1730;5583
241415;201509;1680;5053;1510;4777;99;380;1185;3674;1284;4054
241420;201509;2286;7904;1992;7393;622;2526;487;1744;1109;4270
241430;201509;577;1725;449;1426;49;171;251;757;300;928
241440;201509;6221;22430;5851;21807;1142;4397;3776;14308;4918;18705
241445;201509;1035;2993;983;2929;87;215;796;2523;883;2738
241450;201509;3165;8610;2754;8014;332;1057;1874;5382;2206;6439
241460;201509;3389;9931;2986;9120;265;932;2117;6290;2382;7222
241470;201509;1347;3808;1123;3509;155;526;716;2201;871;2727
241475;201509;1227;3732;1008;3272;42;183;766;2393;808;2576
241480;201509;2757;9192;2528;8799;989;3560;715;2663;1704;6223
241490;201509;663;1760;561;1612;37;102;345;969;382;1071
241500;201509;771;2438;658;2256;42;185;471;1565;513;1750
250010;201509;2726;8549;2331;7664;143;606;1719;5503;1862;6109
250020;201509;1656;4767;1267;4049;82;337;834;2546;916;2883
250030;201509;6894;20193;6484;19604;521;1653;5261;15848;5782;17501
250040;201509;4227;14118;3885;13371;639;2291;2384;8204;3023;10495
250050;201509;3413;10815;3222;10533;456;1577;2199;7126;2655;8703
250053;201509;1236;3713;1136;3576;149;492;779;2486;928;2978
250057;201509;635;2637;625;2627;13;25;593;2570;606;2595
250060;201509;5037;15178;4716;14698;415;1492;3725;11441;4140;12933
250070;201509;3940;12289;3662;11814;171;798;2871;8929;3042;9727
250073;201509;752;2316;664;2160;46;184;529;1690;575;1874
250077;201509;2130;6253;1795;5712;185;623;1159;3721;1344;4344
250080;201509;4121;12078;3965;11824;397;1230;2997;8755;3394;9985
250090;201509;2522;7390;2410;7202;95;304;1995;5881;2090;6185
250100;201509;3854;12764;3643;12376;359;1337;2773;9292;3132;10629
250110;201509;5233;15659;4953;15253;485;1746;3886;11768;4371;13514
250115;201509;529;1709;461;1560;31;160;302;949;333;1109
250120;201509;1979;5958;1718;5438;104;376;1313;4113;1417;4489
250130;201509;5296;16594;4928;15993;227;908;4091;13196;4318;14104
250135;201509;1057;3267;965;3102;74;275;711;2277;785;2552
250140;201509;1992;6694;1907;6556;170;695;1469;5059;1639;5754
250150;201509;5000;16821;4538;15946;343;1498;3304;11412;3647;12910
250153;201509;1425;3918;1257;3669;43;190;1071;3045;1114;3235
250157;201509;1709;5676;1573;5396;173;686;1141;3892;1314;4578
250160;201509;3201;9775;3090;9604;142;538;2792;8632;2934;9170
250170;201509;1491;4513;1362;4312;221;734;923;2939;1144;3673
250180;201509;15545;46127;14707;44805;1431;5210;10868;32175;12299;37385
250190;201509;4149;12016;3775;11411;633;1952;2267;6727;2900;8679
250200;201509;2022;5900;1697;5423;114;442;1379;4360;1493;4802
250205;201509;877;3024;820;2915;53;266;609;2127;662;2393
250210;201509;1469;4912;1371;4763;120;478;1020;3475;1140;3953
250215;201509;1375;4538;1303;4426;108;439;867;2918;975;3357
250220;201509;739;2206;658;2099;39;151;556;1756;595;1907
250230;201509;1563;3982;1326;3587;82;255;1061;2756;1143;3011
250240;201509;2299;7760;2177;7530;130;521;1736;5990;1866;6511
250250;201509;4239;12894;3920;12465;201;681;3367;10756;3568;11437
250260;201509;1680;5181;1481;4871;84;338;1158;3796;1242;4134
250270;201509;1229;3885;1118;3745;103;343;853;2946;956;3289
250280;201509;3590;10716;3175;10051;428;1355;2270;7247;2698;8602
250290;201509;1947;5154;1651;4773;42;169;1473;4244;1515;4413
250300;201509;5436;15879;5141;15522;602;2524;4117;11775;4719;14299
250310;201509;1160;3549;1026;3334;98;368;786;2514;884;2882
250320;201509;7920;24288;7531;23563;942;3314;5191;15801;6133;19115
250330;201509;2450;7682;2116;7186;158;658;1619;5411;1777;6069
250340;201509;1090;3264;982;3083;40;148;827;2569;867;2717
250350;201509;4185;11680;3735;11133;155;541;3215;9597;3370;10138
250355;201509;1879;6026;1735;5817;88;451;1474;4797;1562;5248
250360;201509;1833;5477;1726;5321;67;192;1482;4606;1549;4798
250370;201509;11508;33888;10431;32698;887;2893;8911;28077;9798;30970
250375;201509;1086;3353;1007;3237;39;147;865;2779;904;2926
250380;201509;1687;4820;1588;4695;97;380;1358;3932;1455;4312
250390;201509;1920;5151;1536;4501;178;511;1035;3032;1213;3543
250400;201509;68420;184783;55433;163728;13892;43082;23571;70156;37463;113238
250403;201509;1511;4952;1402;4803;228;878;852;2827;1080;3705
250407;201509;1184;3378;1032;3128;77;244;738;2178;815;2422
250410;201509;544;1798;507;1724;32;160;400;1317;432;1477
250415;201509;1753;5413;1587;5116;108;368;1181;3763;1289;4131
250420;201509;1231;3716;1132;3569;35;139;999;3106;1034;3245
250430;201509;6037;16707;5664;16147;302;1027;4714;13182;5016;14209
250435;201509;1339;4135;1217;3916;147;538;834;2653;981;3191
250440;201509;4351;12741;4034;12286;184;551;3366;10236;3550;10787
250450;201509;1964;5616;1771;5351;70;243;1514;4507;1584;4750
250460;201509;6369;19208;5931;18595;622;2020;4528;14360;5150;16380
250470;201509;1519;4193;1299;3885;144;494;860;2442;1004;2936
250480;201509;3694;11271;3451;10922;107;464;3044;9552;3151;10016
250485;201509;676;1687;552;1494;30;98;443;1156;473;1254
250490;201509;3743;11973;3652;11842;822;2702;2336;7625;3158;10327
250500;201509;1752;5299;1561;4989;314;947;974;3222;1288;4169
250510;201509;4645;13415;4169;12713;179;633;3609;10980;3788;11613
250520;201509;1703;5218;1596;5032;242;818;958;2955;1200;3773
250523;201509;1568;5073;1514;4989;238;864;1028;3347;1266;4211
250527;201509;1382;4188;1314;4105;25;121;1207;3712;1232;3833
250530;201509;621;1914;532;1803;26;82;466;1607;492;1689
250535;201509;1294;4068;1227;3931;52;221;986;3088;1038;3309
250540;201509;2358;6937;2211;6766;51;230;1958;5871;2009;6101
250550;201509;886;2970;800;2833;52;243;625;2174;677;2417
250560;201509;1656;5209;1606;5136;99;401;1396;4393;1495;4794
250570;201509;2629;8356;2300;7711;161;676;1726;5664;1887;6340
250580;201509;1120;3015;951;2743;93;341;730;2020;823;2361
250590;201509;882;2769;829;2705;86;346;669;2121;755;2467
250600;201509;7192;20984;6735;20331;634;1825;5266;16014;5900;17839
250610;201509;3059;9060;2824;8699;296;962;2080;6423;2376;7385
250620;201509;691;2027;610;1864;115;364;348;1047;463;1411
250625;201509;2350;7569;2302;7508;138;384;2112;6994;2250;7378
250630;201509;9218;28964;8528;27578;2030;6626;4321;14076;6351;20702
250640;201509;3441;10568;3290;10387;166;712;2857;8859;3023;9571
250650;201509;781;2305;700;2172;52;214;510;1515;562;1729
250660;201509;1895;5042;1722;4818;32;78;1619;4563;1651;4641
250670;201509;2374;8084;2266;7886;147;669;1864;6365;2011;7034
250680;201509;4688;13563;4472;13288;202;772;3904;11475;4106;12247
250690;201509;5943;15597;5673;15269;449;1195;4965;13343;5414;14538
250700;201509;4932;14519;4475;13832;730;2323;2923;8993;3653;11316
250710;201509;4148;13360;3894;12997;561;1991;2649;8940;3210;10931
250720;201509;2578;7591;2450;7387;102;435;2133;6324;2235;6759
250730;201509;3497;10718;3286;10410;306;1046;2417;7505;2723;8551
250740;201509;1876;5548;1677;5232;151;582;1257;3790;1408;4372
250750;201509;98405;279520;90899;268330;12980;41826;61213;178024;74193;219850
250760;201509;2202;6354;1978;6032;131;473;1610;4836;1741;5309
250770;201509;3762;12841;3567;12583;568;2197;2327;8176;2895;10373
250780;201509;1813;5327;1562;4865;183;681;1001;2986;1184;3667
250790;201509;2396;7836;2267;7620;512;1727;1283;4422;1795;6149
250800;201509;2629;7433;2333;6946;102;334;1922;5619;2024;5953
250810;201509;1299;3803;1131;3552;86;356;882;2705;968;3061
250820;201509;1812;5693;1740;5599;66;290;1585;5048;1651;5338
250830;201509;5665;18230;5248;17378;633;2302;3488;11326;4121;13628
250840;201509;904;2921;769;2622;55;219;517;1752;572;1971
250850;201509;1957;6046;1780;5754;100;466;1383;4362;1483;4828
250855;201509;1045;3181;963;3059;66;283;734;2249;800;2532
250860;201509;3074;10108;2670;9354;664;2502;849;2972;1513;5474
250870;201509;1051;3081;966;2925;42;176;749;2191;791;2367
250880;201509;1377;3909;1209;3669;171;520;858;2616;1029;3136
250890;201509;9116;27971;8533;27147;1127;4419;5938;18163;7065;22582
250900;201509;2806;9130;2465;8451;266;876;1779;6150;2045;7026
250905;201509;1963;6324;1883;6215;305;985;1355;4545;1660;5530
250910;201509;4910;14277;4651;13896;287;956;3798;11249;4085;12205
250915;201509;1411;4354;1379;4300;121;345;1155;3673;1276;4018
250920;201509;3288;9492;3076;9159;412;1161;2122;6406;2534;7567
250930;201509;1967;6128;1846;5925;206;812;1294;4032;1500;4844
250933;201509;1109;3638;1051;3520;89;347;746;2453;835;2800
250937;201509;663;2100;613;1996;64;266;433;1371;497;1637
250939;201509;1536;4833;1446;4673;148;508;1010;3244;1158;3752
250940;201509;3686;11060;3465;10700;141;537;2915;8977;3056;9514
250950;201509;1254;3858;1108;3668;43;172;894;2934;937;3106
250960;201509;1097;3600;1044;3522;89;347;829;2786;918;3133
250970;201509;8354;23217;7270;21544;873;2633;5040;14912;5913;17545
250980;201509;2534;7542;2312;7138;131;528;1676;4959;1807;5487
250990;201509;1936;6625;1736;6181;253;1018;1060;3664;1313;4682
251000;201509;2126;6429;1943;6138;77;328;1613;5044;1690;5372
251010;201509;2788;8123;2503;7678;95;329;2145;6594;2240;6923
251020;201509;1574;4616;1451;4454;86;273;1284;3951;1370;4224
251030;201509;1112;3142;1008;2953;68;235;736;2118;804;2353
251040;201509;1797;5688;1620;5387;119;537;1183;3774;1302;4311
251050;201509;1063;3112;927;2868;102;336;604;1842;706;2178
251060;201509;999;2350;776;2051;50;163;604;1564;654;1727
251065;201509;463;1413;410;1327;28;104;276;834;304;938
251070;201509;629;1763;565;1677;48;192;438;1224;486;1416
251080;201509;19637;55465;17763;52296;4542;13894;8498;25525;13040;39419
251090;201509;2944;9206;2619;8559;214;793;1877;6030;2091;6823
251100;201509;942;2999;835;2809;93;376;535;1732;628;2108
251110;201509;1978;5804;1729;5321;162;497;1165;3572;1327;4069
251120;201509;6052;20602;5779;20112;714;2916;4186;14306;4900;17222
251130;201509;4014;10422;3658;10042;17;39;3595;9898;3612;9937
251140;201509;4136;12744;3889;12351;130;573;3266;10310;3396;10883
251150;201509;2501;8170;2337;7923;218;953;1731;5686;1949;6639
251160;201509;1747;5799;1686;5719;61;246;1532;5199;1593;5445
251170;201509;1418;4315;1343;4226;100;405;1110;3399;1210;3804
251180;201509;2534;7757;2325;7440;429;1333;1384;4458;1813;5791
251190;201509;4287;11984;4127;11803;185;540;3807;10882;3992;11422
251200;201509;3788;12326;3665;12175;89;381;3360;11097;3449;11478
251203;201509;1033;3458;1000;3394;56;283;786;2610;842;2893
251207;201509;1109;3481;960;3214;69;330;657;2092;726;2422
251210;201509;7892;22462;6754;20964;753;2277;5144;16419;5897;18696
251220;201509;1101;2965;916;2687;95;288;682;2003;777;2291
251230;201509;4434;13566;4116;13191;232;923;3671;11654;3903;12577
251240;201509;3157;9796;2982;9567;407;1295;2203;7095;2610;8390
251250;201509;10213;30334;9438;29136;995;3574;7011;21156;8006;24730
251260;201509;506;1600;460;1533;21;82;345;1138;366;1220
251270;201509;4189;13493;3911;13151;159;737;3451;11540;3610;12277
251272;201509;1337;3983;1285;3909;83;270;1124;3421;1207;3691
251274;201509;870;2780;792;2637;83;338;561;1823;644;2161
251275;201509;1216;3590;1159;3498;79;337;861;2442;940;2779
251276;201509;1188;3701;1108;3552;81;327;813;2535;894;2862
251278;201509;556;1799;496;1679;63;261;323;1079;386;1340
251280;201509;2282;7009;2157;6799;143;538;1684;5139;1827;5677
251290;201509;5551;15408;5240;15035;597;2125;4065;11277;4662;13402
251300;201509;740;2515;691;2435;43;185;538;1877;581;2062
251310;201509;3002;8912;2769;8574;121;502;2264;6835;2385;7337
251315;201509;1593;5554;1517;5420;197;710;1021;3687;1218;4397
251320;201509;1854;5207;1462;4551;62;233;1072;3296;1134;3529
251330;201509;1812;4884;1572;4560;87;367;1337;3727;1424;4094
251335;201509;1017;3486;942;3353;93;425;651;2250;744;2675
251340;201509;3449;9715;2987;9014;228;893;2229;6491;2457;7384
251350;201509;1321;4204;1228;4048;103;396;925;2960;1028;3356
251360;201509;1769;5679;1611;5478;68;305;1398;4732;1466;5037
251365;201509;813;2382;648;2029;27;109;459;1397;486;1506
251370;201509;21551;68252;20979;67438;1867;7462;16561;51608;18428;59070
251380;201509;1342;4181;1151;3852;46;240;946;3034;992;3274
251385;201509;817;2242;712;2067;84;232;448;1250;532;1482
251390;201509;5771;19895;5264;19002;1218;4546;2967;10832;4185;15378
251392;201509;1023;3043;930;2903;73;249;698;2155;771;2404
251394;201509;608;1883;498;1668;37;135;351;1159;388;1294
251396;201509;833;2378;726;2196;108;333;470;1398;578;1731
251398;201509;983;2882;847;2613;53;204;566;1711;619;1915
251400;201509;1173;3316;1012;3097;92;356;742;2189;834;2545
251410;201509;1340;3612;1232;3437;67;268;1023;2776;1090;3044
251420;201509;1976;5771;1762;5510;230;728;1238;3840;1468;4568
251430;201509;1701;5937;1546;5672;92;462;1274;4569;1366;5031
251440;201509;1290;3803;1058;3351;69;243;773;2426;842;2669
251445;201509;1515;4629;1439;4519;79;345;1194;3629;1273;3974
251450;201509;4434;14387;4168;14024;138;651;3538;11797;3676;12448
251455;201509;1086;3501;978;3301;92;345;669;2257;761;2602
251460;201509;814;2520;763;2438;85;243;597;1959;682;2202
251465;201509;439;1399;384;1277;19;85;283;916;302;1001
251470;201509;1168;3449;966;3058;90;313;587;1850;677;2163
251480;201509;959;2694;855;2513;29;139;699;1982;728;2121
251490;201509;1708;5196;1548;4946;176;653;1059;3342;1235;3995
251500;201509;1685;5508;1637;5417;145;560;1247;4031;1392;4591
251510;201509;2573;8446;2321;7923;432;1524;1279;4351;1711;5875
251520;201509;907;2538;808;2377;119;358;493;1437;612;1795
251530;201509;11599;32902;11009;32082;395;1691;9435;26747;9830;28438
251540;201509;2821;9153;2602;8715;198;832;2059;6803;2257;7635
251550;201509;3491;9060;3007;8418;84;335;2553;7006;2637;7341
251560;201509;702;2185;649;2086;88;333;389;1171;477;1504
251570;201509;998;2973;805;2580;50;216;552;1686;602;1902
251580;201509;1909;5400;1768;5202;383;987;1116;3449;1499;4436
251590;201509;1549;5055;1488;4977;67;285;1248;4142;1315;4427
251593;201509;986;3097;916;3001;132;485;580;1851;712;2336
251597;201509;1893;5843;1827;5759;78;332;1582;4890;1660;5222
251600;201509;6529;19215;6084;18503;377;1280;4917;14839;5294;16119
251610;201509;3196;9726;2957;9353;313;990;2140;6784;2453;7774
251615;201509;1134;3300;923;2940;80;324;636;1966;716;2290
251620;201509;15016;42213;13180;39954;965;2998;10714;33038;11679;36036
251630;201509;4520;11806;3927;10971;255;762;3149;8695;3404;9457
251640;201509;2553;7472;2126;6732;138;545;1586;4963;1724;5508
251650;201509;3868;11297;3578;10902;237;794;3061;9270;3298;10064
251660;201509;3397;11109;3150;10674;132;660;2611;8577;2743;9237
251670;201509;4392;13000;3773;12196;61;199;3468;11336;3529;11535
251675;201509;712;2285;653;2202;138;496;359;1183;497;1679
251680;201509;2670;7689;2205;6953;113;489;1726;5310;1839;5799
251690;201509;3225;9827;3007;9394;170;611;2334;7156;2504;7767
251700;201509;1946;6303;1822;6138;121;528;1534;5101;1655;5629
251710;201509;924;2395;670;1914;79;266;380;1040;459;1306
251720;201509;1376;4258;1212;3970;87;419;914;2870;1001;3289
251740;201509;772;2199;611;1919;72;236;373;1169;445;1405
260005;201509;25249;61523;21372;56047;4651;12143;11669;30773;16320;42916
260010;201509;9844;26500;8019;24171;1297;3870;4753;14936;6050;18806
260020;201509;5596;16313;4761;15045;313;1088;3661;11689;3974;12777
260030;201509;5843;17095;5302;16261;402;1381;4086;12474;4488;13855
260040;201509;10119;24420;8317;22351;764;1896;6314;17561;7078;19457
260050;201509;11181;34786;10428;33902;582;2098;9006;29536;9588;31634
260060;201509;3882;10993;3443;10226;331;981;2519;7541;2850;8522
260070;201509;9685;28159;8934;26959;1457;4720;5651;16781;7108;21501
260080;201509;5476;14902;4840;13976;612;1835;3380;9690;3992;11525
260090;201509;5084;14240;4763;13770;971;2688;3102;9162;4073;11850
260100;201509;3302;9098;2868;8480;178;706;2352;6856;2530;7562
260105;201509;4689;13526;4450;13084;387;1316;3448;9920;3835;11236
260110;201509;20763;59046;19172;57118;911;2793;16890;50462;17801;53255
260120;201509;11421;34999;10312;33030;2550;8327;5235;17415;7785;25742
260130;201509;3238;9132;3016;8781;470;1310;2062;6091;2532;7401
260140;201509;13231;32922;11267;30517;879;2626;8895;24217;9774;26843
260150;201509;3107;8826;2764;8356;204;777;2151;6434;2355;7211
260160;201509;5606;17734;4992;16931;332;1412;4015;13524;4347;14936
260170;201509;16175;45762;15499;44777;1172;3579;12740;36643;13912;40222
260180;201509;3233;9968;2952;9563;202;743;2426;7820;2628;8563
260190;201509;15866;37302;14538;35642;521;1364;12653;30746;13174;32110
260200;201509;10538;29290;9722;28174;719;2346;8070;23434;8789;25780
260210;201509;11296;34530;10213;32907;632;2443;8317;26724;8949;29167
260220;201509;9337;27368;9016;26932;478;1851;7908;23216;8386;25067
260230;201509;9440;27310;8689;26258;451;1553;7079;21514;7530;23067
260240;201509;2968;8995;2577;8422;378;1341;1772;5825;2150;7166
260250;201509;2273;6314;2043;6010;101;308;1753;5168;1854;5476
260260;201509;12082;34066;11031;32606;1743;5442;7789;23333;9532;28775
260270;201509;3598;10445;3327;10038;285;1153;2468;7061;2753;8214
260280;201509;12758;41411;11716;39806;700;2543;9826;33667;10526;36210
260290;201509;29567;89171;27848;86050;4778;15865;17236;52293;22014;68158
260300;201509;8491;25919;7528;24451;455;1901;5841;18951;6296;20852
260310;201509;4660;13740;4254;13127;1261;3589;2211;7388;3472;10977
260320;201509;6932;22676;6423;21856;414;1590;5249;17909;5663;19499
260330;201509;2602;8396;2417;8066;143;615;1885;6175;2028;6790
260340;201509;1867;5517;1729;5292;71;257;1506;4560;1577;4817
260345;201509;22922;71430;21382;68352;5598;19774;8400;25450;13998;45224
260350;201509;4661;12746;4369;12306;240;835;3634;10081;3874;10916
260360;201509;2273;6723;2062;6354;185;703;1401;4250;1586;4953
260370;201509;5831;18117;5136;16839;522;2021;3628;11831;4150;13852
260380;201509;4775;15754;4363;15129;318;1319;3291;11340;3609;12659
260390;201509;4362;13896;3823;12827;345;1319;2702;8890;3047;10209
260392;201509;3519;11086;3234;10723;207;896;2774;9025;2981;9921
260400;201509;13448;38428;12713;37191;1767;5789;8690;24809;10457;30598
260410;201509;60470;172696;52493;159752;15169;48615;20423;63306;35592;111921
260415;201509;3854;12191;3294;11058;340;1413;2035;6549;2375;7962
260420;201509;11894;27230;10610;25845;278;823;9559;23019;9837;23842
260430;201509;2759;9099;2454;8551;250;927;1686;5852;1936;6779
260440;201509;3228;9736;2862;8980;410;1438;1724;5241;2134;6679
260450;201509;4893;14546;4667;14212;201;710;4098;12507;4299;13217
260460;201509;5538;17164;5070;16299;898;3140;2968;9329;3866;12469
260470;201509;4553;13704;4257;13319;276;874;3663;11659;3939;12533
260480;201509;4037;11573;3546;10882;597;2064;2262;6928;2859;8992
260490;201509;5013;13384;4364;12273;312;1009;3463;9531;3775;10540
260500;201509;5935;16968;5274;15910;745;2267;3522;10596;4267;12863
260510;201509;8623;23140;8004;22343;380;1177;7053;19578;7433;20755
260515;201509;4723;14410;3651;12222;260;1011;2301;7670;2561;8681
260520;201509;15749;41510;15087;40596;2331;6244;10801;29162;13132;35406
260530;201509;9671;29510;8606;27909;445;1617;7242;23541;7687;25158
260540;201509;6008;14874;5463;14290;764;1487;4255;11681;5019;13168
260545;201509;70;250;39;155;8;33;11;38;19;71
260550;201509;2747;9006;2350;8161;489;1873;959;3290;1448;5163
260560;201509;6261;16418;5658;15531;179;646;4967;13407;5146;14053
260570;201509;6737;22407;6207;21515;723;2847;4392;15136;5115;17983
260580;201509;3700;10406;3412;9921;191;675;2825;7990;3016;8665
260590;201509;6099;15311;5749;14895;291;794;4997;12912;5288;13706
260600;201509;26703;79270;24068;74777;2365;8549;17124;52550;19489;61099
260610;201509;6632;19829;6258;19255;957;3086;4310;13112;5267;16198
260620;201509;15844;47881;15081;46496;2584;8692;9373;28351;11957;37043
260630;201509;2162;6502;1930;6103;151;610;1510;4632;1661;5242
260640;201509;17079;47180;15971;45608;2514;7466;10413;29658;12927;37124
260650;201509;5295;16958;4729;15963;455;1627;3519;12023;3974;13650
260660;201509;7983;22182;7158;21130;366;1254;6103;17870;6469;19124
260670;201509;2361;6376;1909;5734;175;579;1343;4039;1518;4618
260680;201509;21520;60205;19565;56731;4203;12406;9483;27411;13686;39817
260690;201509;3666;9967;3112;9052;139;523;2569;7344;2708;7867
260700;201509;5584;16670;5438;16518;48;134;5324;16282;5372;16416
260710;201509;1256;3754;1151;3605;88;328;893;2777;981;3105
260720;201509;15703;51587;14852;50060;3497;12246;7880;26720;11377;38966
260730;201509;6622;22310;6183;21560;1021;3695;4234;14770;5255;18465
260740;201509;1261;3840;1104;3567;129;464;742;2393;871;2857
260750;201509;6613;20571;5989;19728;561;1778;4830;16147;5391;17925
260760;201509;4668;12567;4345;12135;253;776;3602;10083;3855;10859
260765;201509;7651;25974;7276;25364;1087;4798;4925;16409;6012;21207
260770;201509;3731;9875;3446;9461;121;423;2878;7760;2999;8183
260775;201509;5042;14569;4746;14098;464;1651;3403;9823;3867;11474
260780;201509;3617;11685;3376;11203;666;2484;1780;5625;2446;8109
260790;201509;109927;277489;101778;265108;20437;54661;59849;155086;80286;209747
260795;201509;2988;9149;2689;8685;309;1114;1822;5886;2131;7000
260800;201509;4781;12926;4429;12436;167;656;3934;10702;4101;11358
260805;201509;3926;11382;3444;10636;405;1424;2306;6949;2711;8373
260810;201509;6685;19015;6489;18781;322;977;5690;16406;6012;17383
260820;201509;4268;12005;3860;11407;950;2897;2005;5816;2955;8713
260825;201509;2852;9151;2569;8687;207;760;1980;6724;2187;7484
260830;201509;3676;11871;3296;11118;764;2474;1871;6573;2635;9047
260840;201509;4227;12106;3765;11421;256;981;3030;8991;3286;9972
260845;201509;4173;12112;3900;11612;519;1627;2745;8197;3264;9824
260850;201509;4916;16052;4330;14744;842;3236;2069;6798;2911;10034
260860;201509;3296;10446;2952;9743;188;722;2261;7429;2449;8151
260870;201509;4152;11537;3690;10945;483;1304;2722;8248;3205;9552
260875;201509;6468;17817;5744;16718;893;2624;3776;11036;4669;13660
260880;201509;9267;28684;8515;27430;765;2488;6553;21257;7318;23745
260890;201509;13200;37770;12299;36366;896;3035;9334;27320;10230;30355
260900;201509;5881;18088;5007;16399;564;2220;3104;9964;3668;12184
260910;201509;2966;8964;2699;8551;194;710;2069;6548;2263;7258
260915;201509;4452;15060;4244;14763;79;369;3913;13597;3992;13966
260920;201509;3224;9859;3010;9553;357;1352;2240;7046;2597;8398
260930;201509;3936;12770;3469;12007;396;1452;2455;8533;2851;9985
260940;201509;13645;36611;12385;34516;1529;4967;8310;22427;9839;27394
260950;201509;6194;19167;5651;18084;843;3155;3081;9349;3924;12504
260960;201509;56113;155987;51305;147954;10124;30921;27721;79256;37845;110177
260970;201509;4746;14968;4362;14432;271;1138;3477;11397;3748;12535
260980;201509;3822;12378;3592;12085;124;545;3220;10778;3344;11323
260990;201509;16804;52951;15278;50878;1169;4327;12139;40637;13308;44964
261000;201509;16166;43834;12980;38839;2456;7726;6589;20285;9045;28011
261010;201509;2544;7180;2339;6926;160;374;2027;6172;2187;6546
261020;201509;5896;17487;5303;16545;472;1758;4072;12280;4544;14038
261030;201509;3401;10998;3138;10518;219;902;2481;8181;2700;9083
261040;201509;5113;16573;4478;15324;393;1570;3256;11034;3649;12604
261050;201509;7947;23244;7410;22261;1021;3040;4946;14902;5967;17942
261060;201509;11955;35340;11078;33730;1113;3951;8038;23815;9151;27766
261070;201509;50119;123430;43802;114389;6820;18167;27469;71939;34289;90106
261080;201509;5767;16826;5405;16271;375;1045;4579;14022;4954;15067
261090;201509;16427;45193;15101;43377;1438;4045;11726;34035;13164;38080
261100;201509;7845;24920;6981;23359;1354;4798;3818;12984;5172;17782
261110;201509;60043;177270;53186;166636;12166;40051;27697;88140;39863;128191
261120;201509;3640;9721;3198;9186;92;324;2859;8210;2951;8534
261130;201509;6969;17850;6504;17321;214;659;5898;15567;6112;16226
261140;201509;3268;9160;2949;8673;416;1403;1777;5045;2193;6448
261150;201509;5244;15533;4836;14869;447;1626;3788;11560;4235;13186
261153;201509;2071;6029;1678;5415;72;304;1253;4037;1325;4341
261160;201509;198509;518342;183285;496066;42474;118501;93127;255239;135601;373740
261170;201509;5820;15957;5273;15146;608;1785;3935;11410;4543;13195
261180;201509;9551;26577;8927;25693;909;2879;6301;17913;7210;20792
261190;201509;5073;15752;4720;15311;556;2336;3243;10045;3799;12381
261200;201509;3644;9164;3281;8722;434;1128;2528;6865;2962;7993
261210;201509;1887;5006;1785;4877;121;320;1575;4335;1696;4655
261220;201509;13024;40771;10819;35922;1930;6943;5345;17615;7275;24558
261230;201509;4314;13078;3973;12647;163;636;3443;10980;3606;11616
261240;201509;4752;14163;4403;13568;660;1944;2974;9371;3634;11315
261245;201509;3497;10953;3000;10039;170;798;2369;7730;2539;8528
261247;201509;3301;10093;2786;9139;228;891;1994;6548;2222;7439
261250;201509;19731;52415;18539;50822;3573;9427;12724;35756;16297;45183
261255;201509;3951;12350;3595;11732;214;844;2950;9537;3164;10381
261260;201509;11923;33787;10695;32279;615;1949;8919;26967;9534;28916
261270;201509;3602;10681;3249;10091;403;1386;2166;6584;2569;7970
261280;201509;2454;7556;2256;7261;142;508;1833;5855;1975;6363
261290;201509;2902;8362;2641;8022;173;670;2127;6415;2300;7085
261300;201509;10534;34298;9243;31927;1524;6030;5525;18752;7049;24782
261310;201509;7300;22422;6859;21606;1632;5275;3837;12097;5469;17372
261320;201509;5510;17440;5101;16682;245;976;4107;13339;4352;14315
261330;201509;5394;15880;5111;15490;479;1492;3997;12067;4476;13559
261340;201509;4022;13372;3805;13010;417;1795;2528;8478;2945;10273
261350;201509;8024;26525;7496;25599;319;1551;6043;20151;6362;21702
261360;201509;8063;21325;7213;20118;616;1862;5671;15525;6287;17387
261370;201509;19533;57598;18175;55433;3688;11754;10531;32099;14219;43853
261380;201509;4080;14013;3754;13305;592;2317;2352;8311;2944;10628
261390;201509;15571;47707;14087;45156;2139;7482;8609;27438;10748;34920
261400;201509;4739;16322;4234;15257;407;1717;2950;10580;3357;12297
261410;201509;8534;23985;7721;22729;984;2949;5616;16691;6600;19640
261420;201509;7294;24657;6967;24196;1653;6490;4075;13818;5728;20308
261430;201509;3388;10646;2974;10034;265;903;2256;7719;2521;8622
261440;201509;1581;5118;1429;4887;54;273;1121;3746;1175;4019
261450;201509;13910;39409;13436;38832;388;1397;12162;34897;12550;36294
261460;201509;7095;20946;6662;20381;447;1256;5725;17850;6172;19106
261470;201509;3900;10650;3524;10156;152;494;3185;9143;3337;9637
261480;201509;3527;12755;3244;12216;334;1404;2308;8549;2642;9953
261485;201509;4957;15212;4487;14365;774;2877;2605;8118;3379;10995
261500;201509;5668;15731;5016;14854;483;1331;3775;11531;4258;12862
261510;201509;1930;6170;1783;5938;129;471;1384;4613;1513;5084
261520;201509;2636;8564;2438;8186;148;589;1669;5786;1817;6375
261530;201509;11901;38079;10437;35222;2220;8306;4392;14700;6612;23006
261540;201509;7256;23357;6854;22643;1495;4918;4094;13842;5589;18760
261550;201509;3397;9665;3199;9374;260;1003;2519;7151;2779;8154
261560;201509;7112;23148;6403;22199;986;3683;4407;15458;5393;19141
261570;201509;3393;10362;2978;9679;425;1434;1886;6101;2311;7535
261580;201509;5628;17808;5042;16851;368;1474;4102;13656;4470;15130
261590;201509;2388;6826;2127;6432;187;581;1586;4823;1773;5404
261600;201509;5171;14146;4467;13157;351;1081;3469;10277;3820;11358
261610;201509;2458;7077;2091;6546;117;486;1640;5022;1757;5508
261618;201509;2469;6959;2251;6677;205;664;1699;4926;1904;5590
261620;201509;4071;12636;3789;12150;607;2034;2551;8244;3158;10278
261630;201509;7708;22500;6449;20125;912;3306;3558;10763;4470;14069
261640;201509;32569;82317;30199;79393;2181;5593;24257;65658;26438;71251
261650;201509;3621;11185;3351;10799;419;1486;2354;7601;2773;9087
270010;201509;4401;16633;4035;15911;478;2237;2688;10583;3166;12820
270020;201509;3790;10891;3540;10524;373;1212;2724;7984;3097;9196
270030;201509;39763;119105;37060;114709;9077;28856;20225;63134;29302;91990
270040;201509;10584;32354;9775;31278;2267;7129;5395;17989;7662;25118
270050;201509;4236;12002;3879;11546;403;1357;2988;8834;3391;10191
270060;201509;1681;5289;1564;5136;271;979;1031;3400;1302;4379
270070;201509;4207;13119;3873;12671;191;918;3287;10474;3478;11392
270080;201509;1247;3977;1091;3651;162;617;678;2193;840;2810
270090;201509;2127;6580;1960;6230;55;273;1656;5086;1711;5359
270100;201509;5717;17758;5377;17130;941;3181;3358;10561;4299;13742
270110;201509;3200;8793;2841;8395;401;1192;1864;5896;2265;7088
270120;201509;3068;8796;2740;8383;107;406;2443;7489;2550;7895
270130;201509;4973;15254;4662;14897;619;1964;3615;11824;4234;13788
270135;201509;1734;4643;1619;4501;172;357;1373;3966;1545;4323
270140;201509;10239;24909;8836;23135;753;2898;6869;16698;7622;19596
270150;201509;2697;8971;2625;8877;92;317;2446;8308;2538;8625
270160;201509;5039;16814;4621;16286;234;1029;3932;13749;4166;14778
270170;201509;3810;12325;3494;11880;617;2402;2024;6774;2641;9176
270180;201509;2192;7331;2007;7073;121;627;1632;5617;1753;6244
270190;201509;1770;5839;1686;5728;105;432;1406;4781;1511;5213
270200;201509;2559;8599;2394;8361;203;888;1820;6241;2023;7129
270210;201509;4522;13918;4266;13546;322;1311;3456;10705;3778;12016
270220;201509;1394;4537;1300;4359;241;887;742;2445;983;3332
270230;201509;10820;34307;9469;32084;1296;5397;5872;19152;7168;24549
270235;201509;6311;20446;5898;19764;384;1651;4844;16011;5228;17662
270240;201509;9406;28362;7946;26420;1872;6541;3986;13390;5858;19931
270250;201509;3268;8565;2991;8224;408;1081;2346;6416;2754;7497
270255;201509;4969;14983;3938;13113;278;1158;2797;9129;3075;10287
270260;201509;5701;18713;5518;18448;455;1909;4595;15060;5050;16969
270270;201509;1177;3375;1075;3223;196;618;620;1822;816;2440
270280;201509;3566;10187;3209;9672;379;1188;2297;6850;2676;8038
270290;201509;8197;28557;7667;27621;732;3156;5870;20844;6602;24000
270300;201509;3562;11686;3209;11280;325;1283;2334;8130;2659;9413
270310;201509;7338;22332;6421;20889;290;1438;5358;16993;5648;18431
270320;201509;5744;18521;5515;18137;867;3375;3787;12098;4654;15473
270330;201509;4330;14652;4076;14295;376;1469;3260;11449;3636;12918
270340;201509;1734;5354;1527;5080;128;443;1197;3978;1325;4421
270350;201509;1873;5194;1691;4975;155;541;1240;3613;1395;4154
270360;201509;2002;6226;1932;6144;188;546;1594;5200;1782;5746
270370;201509;1555;5144;1411;4886;139;575;1003;3459;1142;4034
270375;201509;2798;7935;2505;7519;244;864;1876;5461;2120;6325
270380;201509;5707;17660;5358;17167;561;1834;4078;13309;4639;15143
270390;201509;1240;3465;1091;3248;79;279;814;2323;893;2602
270400;201509;6267;18807;5637;17912;432;1619;3990;12345;4422;13964
270410;201509;4790;14895;4414;14172;463;1645;3100;9812;3563;11457
270420;201509;5709;18388;5499;18092;271;1249;4496;14425;4767;15674
270430;201509;132913;386005;122539;370303;32128;101674;57707;177500;89835;279174
270440;201509;4703;14222;4325;13687;232;892;3515;11134;3747;12026
270450;201509;6262;19342;6005;19015;348;1459;4940;15382;5288;16841
270460;201509;3455;9220;3083;8734;212;693;2604;7270;2816;7963
270470;201509;10246;32967;9465;31676;1282;4448;6175;21022;7457;25470
270480;201509;2914;9049;2571;8424;238;963;1765;5545;2003;6508
270490;201509;946;3060;890;2970;43;185;715;2346;758;2531
270500;201509;4877;16682;4605;16343;358;1509;3764;13318;4122;14827
270510;201509;5953;17811;5337;16961;713;2872;3841;11660;4554;14532
270520;201509;3602;11459;3295;10926;959;3472;1256;4209;2215;7681
270530;201509;1419;4321;1304;4148;163;531;862;2824;1025;3355
270540;201509;2017;6839;1843;6586;131;660;1471;5077;1602;5737
270550;201509;7114;20819;6184;19603;878;2930;4113;13285;4991;16215
270560;201509;3031;9192;2822;8876;334;1255;2025;6181;2359;7436
270570;201509;3938;12753;3601;12179;357;1518;2728;9012;3085;10530
270580;201509;1957;6348;1863;6221;196;673;1428;4855;1624;5528
270590;201509;1371;4540;1303;4423;25;114;1242;4201;1267;4315
270600;201509;2776;9292;2502;8833;170;844;1912;6581;2082;7425
270610;201509;3180;10051;2936;9694;222;829;2372;7751;2594;8580
270620;201509;1360;4644;1286;4525;99;484;1021;3435;1120;3919
270630;201509;16842;48408;15538;46266;2311;6769;10667;32469;12978;39238
270640;201509;5691;17554;5128;16759;340;1438;4109;13127;4449;14565
270642;201509;2254;7957;2112;7746;262;1185;1528;5500;1790;6685
270644;201509;2620;7633;2331;7275;247;690;1789;5726;2036;6416
270650;201509;3663;11672;3489;11419;514;2173;2329;7177;2843;9350
270660;201509;2463;6210;1914;5426;96;363;1352;3771;1448;4134
270670;201509;16242;42238;13938;39578;1823;4888;10193;30060;12016;34948
270680;201509;4243;12673;4066;12472;160;419;3718;11547;3878;11966
270690;201509;8718;24258;7878;23294;2488;7077;3975;12408;6463;19485
270700;201509;663;2060;600;1948;81;328;408;1259;489;1587
270710;201509;5890;18990;5609;18626;474;1789;4597;15160;5071;16949
270720;201509;3291;11138;3000;10619;161;849;2433;8413;2594;9262
270730;201509;6190;18623;5886;18289;665;2239;4716;14690;5381;16929
270740;201509;2305;6590;2171;6399;266;891;1613;4659;1879;5550
270750;201509;4838;15418;4513;14903;597;2118;3229;10578;3826;12696
270760;201509;3350;10156;3005;9574;214;795;2334;7393;2548;8188
270770;201509;18996;49747;15695;45708;3265;9513;8907;27082;12172;36595
270780;201509;1797;5929;1694;5755;217;854;1178;3973;1395;4827
270790;201509;1558;4845;1423;4636;340;1195;735;2331;1075;3526
270800;201509;11266;33360;10458;32293;809;2941;8539;26031;9348;28972
270810;201509;3344;10104;2590;8720;282;1148;1605;5373;1887;6521
270820;201509;1756;5897;1590;5612;255;979;976;3448;1231;4427
270830;201509;5513;15305;4985;14649;436;1440;3913;11669;4349;13109
270840;201509;7778;25371;7198;24625;356;1786;6224;20852;6580;22638
270850;201509;7278;23172;7031;22856;1195;4688;4741;14577;5936;19265
270860;201509;11320;31556;9582;29281;1139;4095;6501;19375;7640;23470
270870;201509;2190;6594;1805;5781;271;902;1107;3508;1378;4410
270880;201509;8077;25910;7527;25091;541;2190;5953;19514;6494;21704
270890;201509;2393;7274;2243;7002;262;991;1619;4891;1881;5882
270895;201509;2847;10603;2725;10431;178;815;2327;8906;2505;9721
270900;201509;1948;5259;1570;4710;84;300;1184;3473;1268;3773
270910;201509;3463;11474;3242;11067;263;1180;2508;8309;2771;9489
270915;201509;9642;32209;8645;30396;1481;6022;4924;16863;6405;22885
270920;201509;6020;19149;5791;18827;227;1186;5182;16364;5409;17550
270930;201509;17470;46376;14304;42468;2759;8339;8349;25677;11108;34016
270940;201509;5702;18919;5418;18609;536;2325;4260;14433;4796;16758
280010;201509;644;1943;552;1772;55;246;339;1001;394;1247
280020;201509;4706;13762;4019;12562;723;2421;2429;7488;3152;9909
280030;201509;73482;192522;63072;176848;17589;51411;25855;73601;43444;125012
280040;201509;3123;9618;2774;9087;269;1001;2032;6618;2301;7619
280050;201509;3723;12000;3438;11498;1140;4034;1292;4433;2432;8467
280060;201509;4363;14281;3998;13616;821;2988;2132;7382;2953;10370
280067;201509;7347;20785;6292;19211;862;2663;4099;12634;4961;15297
280070;201509;1832;6200;1741;6066;289;1029;1202;4229;1491;5258
280100;201509;3795;11809;3392;11087;725;2508;1868;6140;2593;8648
280110;201509;1404;4281;1291;4112;77;340;1066;3315;1143;3655
280120;201509;7726;24450;7122;23479;1143;3517;4822;16578;5965;20095
280130;201509;7220;20503;6574;19551;1168;3707;4159;12424;5327;16131
280140;201509;5450;14929;4949;14211;486;1428;3827;11039;4313;12467
280150;201509;3347;10085;3092;9641;338;1188;2150;6492;2488;7680
280160;201509;1358;3956;1197;3694;142;464;816;2476;958;2940
280170;201509;4788;14160;4293;13421;474;1474;3188;10147;3662;11621
280190;201509;1077;3008;962;2813;64;223;732;2081;796;2304
280200;201509;1144;3434;1042;3279;129;508;729;2198;858;2706
280210;201509;13065;39692;11765;37831;2242;7530;6950;22678;9192;30208
280220;201509;1527;4706;1432;4554;90;349;1182;3685;1272;4034
280230;201509;3439;10274;3056;9653;396;1351;1967;6248;2363;7599
280240;201509;3418;10060;3102;9548;286;861;2377;7345;2663;8206
280250;201509;817;2157;670;1922;115;400;350;888;465;1288
280260;201509;2005;5376;1853;5187;82;253;1658;4666;1740;4919
280270;201509;2284;7049;1996;6607;125;503;1544;5012;1669;5515
280280;201509;4157;13537;3777;12891;838;2378;2116;8098;2954;10476
280290;201509;17002;52111;15304;49405;2228;7819;9510;30942;11738;38761
280300;201509;9478;28821;8808;28004;959;3224;6772;21955;7731;25179
280310;201509;1341;3784;1187;3541;73;301;845;2456;918;2757
280320;201509;8383;26992;7641;25675;1526;5648;3798;12552;5324;18200
280330;201509;4475;12556;4060;11885;381;1340;3148;8892;3529;10232
280340;201509;3704;10656;3480;10344;356;1207;2694;7981;3050;9188
280350;201509;21605;61026;19229;57401;2853;8819;12518;37599;15371;46418
280360;201509;5658;17776;5289;17161;1018;3787;2976;9367;3994;13154
280370;201509;1845;5175;1604;4770;147;468;1124;3299;1271;3767
280380;201509;1033;3109;941;2974;96;369;694;2134;790;2503
280390;201509;3087;9156;2638;8309;427;1405;1643;5149;2070;6554
280400;201509;4104;11818;3704;11229;1171;3477;1736;5545;2907;9022
280410;201509;2156;6841;1833;6211;252;971;1056;3427;1308;4398
280420;201509;4049;11889;3765;11438;227;740;3187;9651;3414;10391
280430;201509;2222;5684;2010;5389;105;339;1566;4099;1671;4438
280440;201509;4690;13904;4388;13540;369;1210;3580;10968;3949;12178
280445;201509;2452;6938;2273;6634;74;300;1827;5228;1901;5528
280450;201509;8662;23598;8081;22861;564;1387;6808;19765;7372;21152
280460;201509;6922;18306;6210;17286;867;2554;4369;12271;5236;14825
280470;201509;1791;5449;1621;5156;190;602;1155;3712;1345;4314
280480;201509;29945;87921;28379;85596;4616;15846;18540;54403;23156;70249
280490;201509;3771;11304;3293;10469;266;1023;2405;7468;2671;8491
280500;201509;913;2437;828;2325;54;174;678;1836;732;2010
280510;201509;2706;7801;2336;7313;227;804;1717;5378;1944;6182
280520;201509;1751;4867;1591;4666;154;437;1275;3794;1429;4231
280530;201509;2253;6439;2093;6236;152;461;1698;5097;1850;5558
280540;201509;9167;25159;8531;24281;239;1018;7464;20721;7703;21739
280550;201509;6852;18147;5794;16505;631;1828;4026;11504;4657;13332
280560;201509;7404;21998;7013;21414;394;1398;5872;17628;6266;19026
280570;201509;6373;17322;5578;16245;651;2131;3732;10642;4383;12773
280580;201509;5578;17228;4713;15706;842;2834;2734;9346;3576;12180
280590;201509;2332;7098;2169;6891;241;1054;1491;4547;1732;5601
280600;201509;3745;11445;3497;11073;343;1241;2626;8203;2969;9444
280610;201509;2450;6868;2244;6563;221;792;1599;4523;1820;5315
280620;201509;5167;15375;4487;14141;615;1837;2987;9726;3602;11563
280630;201509;3774;12225;3563;11908;376;1177;2825;9749;3201;10926
280640;201509;2201;6601;2094;6481;93;246;1934;6073;2027;6319
280650;201509;1113;3461;1000;3272;113;421;683;2222;796;2643
280660;201509;2627;7467;2513;7320;419;1136;1925;5717;2344;6853
280670;201509;15832;41580;14586;39858;2754;7888;9092;24612;11846;32500
280680;201509;2735;7393;2425;6907;212;698;1899;5314;2111;6012
280690;201509;944;2698;840;2551;125;390;576;1744;701;2134
280700;201509;1081;3194;949;2991;68;222;693;2192;761;2414
280710;201509;11573;30734;10596;29614;773;2043;8888;25260;9661;27303
280720;201509;2235;6152;2029;5909;265;792;1418;4206;1683;4998
280730;201509;920;2754;860;2669;89;310;689;2103;778;2413
280740;201509;12996;35365;11216;32644;1607;4648;7176;21209;8783;25857
280750;201509;3524;10704;3209;10154;342;1189;2222;7029;2564;8218
280760;201509;5596;17090;5061;16311;739;2517;3215;10596;3954;13113
290010;201509;3002;6762;2145;5436;54;227;1697;4080;1751;4307
290020;201509;4360;14594;4287;14489;406;1143;3531;12165;3937;13308
290030;201509;3108;9754;2930;9479;529;1663;1972;6476;2501;8139
290035;201509;4653;11889;3999;11020;240;809;3140;8873;3380;9682
290040;201509;3858;10636;3340;10043;212;843;2661;7847;2873;8690
290050;201509;2496;8085;2202;7598;165;680;1650;5647;1815;6327
290060;201509;1303;3364;1107;3129;201;645;778;2124;979;2769
290070;201509;32643;81764;27665;75506;6066;16333;13477;39052;19543;55385
290080;201509;6124;18127;5197;16908;649;2115;3761;12590;4410;14705
290090;201509;2151;4672;1697;4188;172;387;1395;3511;1567;3898
290100;201509;9692;27585;8447;25614;1152;3628;5342;16551;6494;20179
290110;201509;4812;14305;4551;13844;694;2295;2960;8820;3654;11115
290115;201509;4766;14366;4204;13610;249;833;3414;11277;3663;12110
290120;201509;6817;17735;5671;16359;282;950;4719;13469;5001;14419
290130;201509;4575;12020;3815;11078;211;788;3055;8587;3266;9375
290135;201509;4535;11517;3881;10501;275;918;2847;7343;3122;8261
290140;201509;4085;12743;3532;11982;281;1087;2878;9764;3159;10851
290150;201509;2135;6408;2022;6219;255;840;1531;4651;1786;5491
290160;201509;3339;8867;3217;8717;285;594;2708;7418;2993;8012
290170;201509;2720;9041;2465;8644;190;904;2033;6953;2223;7857
290180;201509;2880;8423;2522;7863;199;741;1926;5948;2125;6689
290190;201509;3723;12480;3569;12231;226;950;2737;9250;2963;10200
290195;201509;2167;5920;1844;5425;104;396;1466;4257;1570;4653
290200;201509;3797;11871;3373;11189;289;967;2624;8779;2913;9746
290205;201509;3101;9189;2754;8649;300;1122;1937;5939;2237;7061
290210;201509;14935;42061;13708;40482;2597;6879;8959;28424;11556;35303
290220;201509;2208;6600;2083;6403;146;606;1621;4812;1767;5418
290225;201509;2868;7504;2623;7229;161;440;2344;6484;2505;6924
290230;201509;2266;7382;2181;7278;138;552;1800;5988;1938;6540
290240;201509;3645;9825;3325;9343;312;905;2473;6842;2785;7747
290250;201509;3684;11815;3252;11169;184;652;2680;9391;2864;10043
290260;201509;4777;13937;4114;12895;337;1198;3127;9743;3464;10941
290265;201509;3271;10328;2923;9683;160;682;2281;7486;2441;8168
290270;201509;11943;43382;11307;42364;1518;5970;8112;30828;9630;36798
290280;201509;5201;17072;4834;16469;410;1566;3671;12520;4081;14086
290290;201509;9580;30372;8573;28694;1359;4674;5638;19243;6997;23917
290300;201509;4595;13051;3265;10553;282;889;2135;7171;2417;8060
290310;201509;1494;4437;1318;4159;250;869;731;2277;981;3146
290320;201509;27781;80645;23544;74899;5680;19149;11435;37263;17115;56412
290323;201509;3797;10283;3331;9758;174;544;2776;8118;2950;8662
290327;201509;4311;13203;3704;12070;574;1929;2312;7501;2886;9430
290330;201509;1796;4492;1665;4349;145;401;1434;3747;1579;4148
290340;201509;4748;14949;4446;14548;1309;4294;2369;7856;3678;12150
290350;201509;4311;13475;3766;12649;424;1447;2606;8999;3030;10446
290360;201509;4475;13649;3881;12847;176;674;3228;10748;3404;11422
290370;201509;4698;13180;4041;12316;434;1210;3170;9857;3604;11067
290380;201509;5540;16061;4829;14993;364;1319;3771;11721;4135;13040
290390;201509;14429;44565;13138;42618;2420;7989;7883;26642;10303;34631
290395;201509;2619;8470;2316;7913;145;636;1725;5879;1870;6515
290400;201509;3492;10400;3031;9735;294;983;2176;6954;2470;7937
290405;201509;4591;14551;3836;13079;588;2021;2286;7977;2874;9998
290410;201509;5990;17619;4864;15830;482;1839;3395;10726;3877;12565
290420;201509;3268;9443;2726;8675;219;756;2112;6688;2331;7444
290430;201509;3023;9593;2741;9083;475;1687;1695;5651;2170;7338
290440;201509;2946;7861;2420;7118;179;630;1850;5451;2029;6081
290450;201509;3289;9495;2829;8836;327;1102;1958;6096;2285;7198
290460;201509;12757;37043;11378;34730;2968;9301;4942;15145;7910;24446
290470;201509;4509;12363;3423;10736;747;2570;1592;5107;2339;7677
290475;201509;5000;16963;4490;15968;354;1608;3326;11647;3680;13255
290480;201509;2476;6573;2255;6282;320;922;1525;4420;1845;5342
290485;201509;4780;15117;4163;14197;322;1531;3272;10870;3594;12401
290490;201509;7922;20940;7530;20402;645;1839;6083;16317;6728;18156
290500;201509;4179;13054;3379;11454;532;1964;1783;5997;2315;7961
290510;201509;3327;9569;2892;8958;171;639;2402;7446;2573;8085
290515;201509;3253;9470;2775;8822;270;882;2162;6979;2432;7861
290520;201509;12070;36931;9705;32456;830;3365;6019;19907;6849;23272
290530;201509;5061;14868;4417;13876;340;1055;3472;10981;3812;12036
290540;201509;3876;11243;3674;10992;423;1232;2865;8715;3288;9947
290550;201509;4450;11951;3937;11352;151;465;3572;10340;3723;10805
290560;201509;6104;17964;5378;16883;1295;4128;2945;9458;4240;13586
290570;201509;42497;116324;38288;110254;4318;12723;26931;77464;31249;90187
290580;201509;6953;23653;6536;22999;844;3097;4680;16819;5524;19916
290590;201509;7359;23323;6285;21385;325;1354;5003;16958;5328;18312
290600;201509;17190;52153;15852;50145;2369;7231;11284;36858;13653;44089
290610;201509;2476;8302;2043;7441;150;709;1427;5104;1577;5813
290620;201509;6461;19511;5884;18604;401;1301;4785;15091;5186;16392
290630;201509;7926;20857;7024;19866;619;1796;5797;16519;6416;18315
290640;201509;2671;7737;2119;6822;152;606;1597;5054;1749;5660
290650;201509;11117;31527;10327;30426;2159;6254;6374;19345;8533;25599
290660;201509;3612;10066;3109;9329;150;510;2381;7340;2531;7850
290670;201509;6847;20941;6153;19806;698;2286;4358;14281;5056;16567
290680;201509;10196;30325;9195;29086;449;1714;7631;23997;8080;25711
290682;201509;4433;12750;3956;12063;163;617;3383;10192;3546;10809
290685;201509;3694;8836;2425;7012;288;869;1470;4353;1758;5222
290687;201509;7611;21130;5932;18622;1409;4517;2906;9466;4315;13983
290689;201509;3135;9086;2715;8422;254;837;2063;6555;2317;7392
290690;201509;5481;15655;4869;14832;735;2302;3264;9964;3999;12266
290700;201509;2349;7328;2213;7125;181;665;1688;5424;1869;6089
290710;201509;7676;24318;7210;23607;362;1233;6146;20216;6508;21449
290720;201509;18504;54143;16778;51973;1396;4136;13591;43042;14987;47178
290730;201509;7123;19715;6366;18721;1043;2969;4181;12458;5224;15427
290740;201509;927;2754;770;2477;85;296;511;1652;596;1948
290750;201509;9889;27529;8275;24546;1479;4846;4396;12535;5875;17381
290755;201509;2353;6607;1920;5887;97;336;1413;4301;1510;4637
290760;201509;4242;12732;3447;11298;436;1313;2172;7321;2608;8634
290770;201509;2506;8831;2376;8649;102;484;1909;6952;2011;7436
290780;201509;8880;22438;7654;20665;807;1669;5814;16395;6621;18064
290790;201509;4249;12883;3954;12457;254;822;3320;10502;3574;11324
290800;201509;7311;15531;5808;13917;681;1364;4280;10919;4961;12283
290810;201509;5071;15735;4273;14445;220;830;3232;11024;3452;11854
290820;201509;5634;15691;4971;14801;458;1559;3775;11268;4233;12827
290830;201509;4283;11479;3902;10918;237;793;2959;8068;3196;8861
290840;201509;17526;49367;15443;46250;2528;7341;9967;31048;12495;38389
290850;201509;6205;17903;5975;17622;723;1917;4770;14609;5493;16526
290860;201509;4966;16830;4611;16394;501;1873;3529;12833;4030;14706
290870;201509;4614;13622;3756;12199;274;1106;2732;8778;3006;9884
290880;201509;1420;3858;1116;3360;92;268;753;2281;845;2549
290890;201509;6930;18151;5927;17025;684;1860;4590;13383;5274;15243
290900;201509;2630;7386;1926;6197;284;964;963;3119;1247;4083
290910;201509;4586;12451;3874;11409;126;466;3338;9704;3464;10170
290920;201509;4633;13529;4241;12968;321;910;3427;10600;3748;11510
290930;201509;7678;23841;6776;22269;445;1871;5216;16900;5661;18771
290940;201509;3447;10926;3175;10554;152;531;2714;9184;2866;9715
290950;201509;1531;4274;1349;4004;166;471;892;2700;1058;3171
290960;201509;5735;16255;5212;15573;195;701;4383;13140;4578;13841
290970;201509;3610;11447;3140;10637;324;1112;2130;7321;2454;8433
290980;201509;10453;29892;8823;26839;2410;7506;2902;8824;5312;16330
290990;201509;9001;26967;7820;25002;851;2823;5657;17959;6508;20782
291000;201509;2893;8866;2636;8546;189;696;2262;7351;2451;8047
291005;201509;14129;37128;12385;34751;1806;5150;8348;23793;10154;28943
291010;201509;3288;10178;2554;8594;277;957;1606;5472;1883;6429
291020;201509;1381;3634;1046;3033;126;398;585;1605;711;2003
291030;201509;2265;6174;1645;4947;168;539;992;2907;1160;3446
291040;201509;5451;16384;4850;15531;395;1467;3753;11992;4148;13459
291050;201509;7642;24940;6909;23540;1708;6523;3466;11393;5174;17916
291060;201509;5964;21887;5611;21306;905;3847;3593;13438;4498;17285
291070;201509;16034;46096;14011;43146;1154;3867;10645;32822;11799;36689
291072;201509;22751;66691;18229;57671;4629;15833;6362;20285;10991;36118
291075;201509;5051;14283;4469;13465;264;666;3505;10870;3769;11536
291077;201509;1482;4180;1180;3685;92;303;773;2413;865;2716
291080;201509;77585;239924;68506;221818;23277;76653;16890;53951;40167;130604
291085;201509;5589;14714;4828;13698;458;1349;3843;10906;4301;12255
291090;201509;1463;3640;1324;3473;61;186;1162;3035;1223;3221
291100;201509;2603;6662;2120;6140;103;402;1677;4780;1780;5182
291110;201509;4675;17143;4282;16522;541;2396;2969;11253;3510;13649
291120;201509;7339;19711;6740;18810;869;2464;4736;13306;5605;15770
291125;201509;1873;3752;1411;3258;101;247;1109;2605;1210;2852
291130;201509;2844;8817;2397;8030;131;575;1781;5801;1912;6376
291140;201509;4162;12321;3661;11388;510;1558;2364;7406;2874;8964
291150;201509;1942;5136;1839;5015;120;379;1503;4028;1623;4407
291160;201509;5340;16528;4653;15376;1135;3734;2357;7847;3492;11581
291165;201509;2513;7052;1931;5951;57;228;1400;4203;1457;4431
291170;201509;21368;55457;18211;51244;1285;4030;12796;35889;14081;39919
291180;201509;6301;16487;5088;14650;475;1508;3592;10336;4067;11844
291185;201509;3754;10185;3355;9587;301;875;2669;7568;2970;8443
291190;201509;7047;19353;6211;18186;508;1706;4931;14315;5439;16021
291200;201509;2889;8578;2311;7498;158;524;1575;5201;1733;5725
291210;201509;6897;16580;5803;15315;306;945;4518;11894;4824;12839
291220;201509;4125;12822;3764;12242;496;1852;2555;8192;3051;10044
291230;201509;4002;10192;3625;9767;85;172;3392;9270;3477;9442
291240;201509;4578;12405;3932;11216;152;479;3178;8910;3330;9389
291250;201509;3548;10830;2798;9459;300;1024;1865;6389;2165;7413
291260;201509;1053;3099;963;2978;65;259;797;2398;862;2657
291270;201509;4486;14359;4066;13558;1355;4683;1841;6213;3196;10896
291280;201509;2217;6114;1716;5330;396;1334;820;2427;1216;3761
291290;201509;5502;15248;4773;14304;855;2558;2788;8490;3643;11048
291300;201509;4364;12397;3397;10717;229;837;2493;7732;2722;8569
291310;201509;5365;15320;4671;14044;320;1020;3575;10703;3895;11723
291320;201509;6006;18942;4968;16940;1140;4146;2429;8202;3569;12348
291330;201509;1582;4754;1404;4462;134;487;983;3063;1117;3550
291340;201509;3892;11125;3225;10179;156;534;2578;8094;2734;8628
291345;201509;3496;11025;3242;10719;227;748;2744;9280;2971;10028
291350;201509;5652;16575;4938;15343;299;1008;3863;12124;4162;13132
291360;201509;32746;90843;29475;86208;7287;21315;16482;49641;23769;70956
291370;201509;8368;23920;7855;23276;563;1787;6133;18345;6696;20132
291380;201509;3654;11071;3125;10209;225;817;2248;7469;2473;8286
291390;201509;9955;27202;9209;26291;1406;3800;6578;19060;7984;22860
291400;201509;16036;42067;13138;38011;2496;6722;7693;23783;10189;30505
291410;201509;3210;8440;2396;7172;150;631;1746;5026;1896;5657
291420;201509;2077;5719;1815;5397;99;354;1507;4411;1606;4765
291430;201509;3246;9521;2898;9058;144;689;2345;7093;2489;7782
291440;201509;6521;19854;5498;18095;546;1906;4021;13344;4567;15250
291450;201509;8240;24174;7242;22763;365;1152;5720;18687;6085;19839
291460;201509;13052;39340;11668;37123;1788;6209;7159;22810;8947;29019
291465;201509;7961;22576;7040;21520;494;1718;5697;17300;6191;19018
291470;201509;15667;42225;13710;39843;1172;3289;10288;30870;11460;34159
291480;201509;33762;87398;28609;80190;3880;11942;17249;48079;21129;60021
291490;201509;4336;13960;4134;13688;435;1486;3164;10618;3599;12104
291500;201509;4285;12227;3622;11253;239;886;2837;8748;3076;9634
291510;201509;3545;10711;3245;10314;83;281;2933;9394;3016;9675
291520;201509;3879;10520;3344;9784;355;1105;2273;6670;2628;7775
291530;201509;2131;5930;1716;5304;417;1303;852;2785;1269;4088
291535;201509;3819;11495;3434;10903;226;787;2678;8539;2904;9326
291540;201509;2159;5096;1804;4725;144;257;1563;4246;1707;4503
291550;201509;5176;14012;4495;13051;998;2771;2493;7464;3491;10235
291560;201509;18341;43491;13125;37416;1156;3272;9791;28836;10947;32108
291570;201509;2210;5931;2029;5705;161;365;1718;4995;1879;5360
291580;201509;5551;16801;4892;15820;542;2143;3499;11189;4041;13332
291590;201509;1756;5564;1586;5282;175;624;1157;3895;1332;4519
291600;201509;5732;15454;4153;12990;1124;3681;1656;5068;2780;8749
291610;201509;4812;15246;4649;15052;189;687;4180;13595;4369;14282
291620;201509;2972;6984;2333;6309;138;390;1868;5173;2006;5563
291630;201509;3160;7641;2631;7026;276;708;1987;5383;2263;6091
291640;201509;17084;46209;13694;41234;3362;10669;4547;14021;7909;24690
291650;201509;7889;23593;7292;22866;660;1717;6015;19457;6675;21174
291660;201509;2200;5779;1822;5194;163;566;1189;3222;1352;3788
291670;201509;1782;5019;1613;4777;103;299;1294;3882;1397;4181
291680;201509;4098;11904;3531;10942;666;2220;2017;6221;2683;8441
291685;201509;4710;11830;3890;10737;669;1768;2506;7149;3175;8917
291690;201509;4030;10719;3150;9276;223;620;2246;6612;2469;7232
291700;201509;9047;28158;8050;26406;960;3134;5830;19392;6790;22526
291710;201509;5166;13474;4201;12264;375;1167;3051;8936;3426;10103
291720;201509;4322;14274;3686;12963;357;1432;2515;8709;2872;10141
291730;201509;5946;17830;5393;17074;575;1920;4110;13219;4685;15139
291733;201509;2561;7423;2189;6922;222;761;1451;4679;1673;5440
291735;201509;2773;7727;2298;7022;127;464;1838;5566;1965;6030
291740;201509;3576;10620;3075;9888;250;931;2400;7650;2650;8581
291750;201509;22335;57201;17167;49141;3908;11508;8339;24370;12247;35878
291760;201509;11074;35162;9738;32813;3903;14489;2673;8918;6576;23407
291770;201509;7574;21827;6425;19731;907;2948;4074;12320;4981;15268
291780;201509;4446;13436;4142;12916;305;992;3339;10380;3644;11372
291790;201509;2641;8089;2494;7887;93;405;2114;6572;2207;6977
291800;201509;29849;81585;26086;76280;4277;12557;16113;48637;20390;61194
291810;201509;10512;29085;8836;27018;433;1585;7158;21787;7591;23372
291820;201509;3682;10880;3303;10320;233;793;2518;7885;2751;8678
291830;201509;4110;10962;3784;10492;518;1483;2723;7602;3241;9085
291835;201509;6276;19556;4997;17270;1414;5246;2351;8166;3765;13412
291840;201509;47098;131578;41357;125014;6147;18125;29206;90951;35353;109076
291845;201509;2677;7873;2497;7643;171;446;2205;6915;2376;7361
291850;201509;4598;13095;3757;11757;379;1080;2751;8883;3130;9963
291855;201509;1796;4548;1542;4225;173;601;1113;2915;1286;3516
291860;201509;2135;6082;1745;5333;99;364;1148;3432;1247;3796
291870;201509;1420;3778;1026;3045;75;278;653;1866;728;2144
291875;201509;2811;8857;2545;8446;130;539;1840;5966;1970;6505
291880;201509;4874;15594;4553;15048;425;1409;3461;11589;3886;12998
291890;201509;1269;3304;1083;3074;288;795;628;1886;916;2681
291900;201509;1275;3463;1053;3106;71;254;817;2385;888;2639
291905;201509;2730;7350;2092;6231;130;447;1518;4350;1648;4797
291910;201509;2740;7277;2291;6740;128;488;1921;5557;2049;6045
291915;201509;7027;21285;5866;19162;333;1163;4600;15112;4933;16275
291920;201509;28652;82821;25962;78960;4487;14070;15605;47933;20092;62003
291930;201509;2616;7675;2302;7164;197;722;1653;5018;1850;5740
291940;201509;3333;9479;2435;7825;324;1164;1380;4286;1704;5450
291950;201509;8604;28782;7808;27275;1236;4353;4588;16479;5824;20832
291955;201509;9985;29390;9313;28538;2146;6554;5462;17551;7608;24105
291960;201509;3154;9205;2563;8306;249;817;1852;6205;2101;7022
291970;201509;3847;11977;3568;11528;430;1566;2375;7671;2805;9237
291980;201509;11909;33766;9052;29618;1089;3654;5998;20128;7087;23782
291990;201509;2195;6651;1982;6369;91;297;1655;5464;1746;5761
291992;201509;2752;8363;2679;8223;368;1180;2009;6132;2377;7312
291995;201509;1949;5747;1739;5431;114;424;1465;4565;1579;4989
292000;201509;2384;6696;2118;6326;259;894;1472;4386;1731;5280
292010;201509;6351;16062;4901;13955;485;1321;3618;10426;4103;11747
292020;201509;3978;13779;3756;13387;629;2346;2668;9492;3297;11838
292030;201509;2027;6223;1798;5890;229;798;1035;3367;1264;4165
292040;201509;4389;11897;3749;11220;295;662;3155;9968;3450;10630
292045;201509;2977;9907;2801;9660;109;430;2569;8776;2678;9206
292050;201509;6267;19089;5362;17245;454;1714;3522;11174;3976;12888
292060;201509;11454;30804;10579;29678;1149;2889;8173;23129;9322;26018
292070;201509;4665;14357;4401;14048;424;1285;3632;11759;4056;13044
292080;201509;3518;9162;2937;8431;194;594;2464;7109;2658;7703
292090;201509;3956;10389;3412;9748;213;722;2870;8225;3083;8947
292100;201509;11165;29893;9299;27284;2511;7617;4137;12740;6648;20357
292105;201509;3006;9322;2682;8802;136;555;2152;7044;2288;7599
292110;201509;6531;17384;5069;15038;1342;3976;2477;7532;3819;11508
292120;201509;7700;21567;6431;19151;1330;3900;3436;10564;4766;14464
292130;201509;2958;8002;2525;7375;474;1284;1534;4650;2008;5934
292140;201509;4951;12878;4110;11695;838;2151;2596;7640;3434;9791
292145;201509;2434;7426;2165;6960;304;949;1439;4809;1743;5758
292150;201509;12783;38866;11724;37132;645;2296;9340;29652;9985;31948
292160;201509;2522;7243;2136;6744;120;465;1822;5686;1942;6151
292170;201509;8666;24749;7142;22066;886;3098;4582;13997;5468;17095
292180;201509;2951;8658;2384;7657;353;1094;1439;4728;1792;5822
292190;201509;3432;9585;2850;8722;592;1903;1605;4979;2197;6882
292200;201509;6644;20571;5644;18739;1662;5940;2011;6636;3673;12576
292205;201509;3781;11640;3356;10979;181;817;2687;8506;2868;9323
292210;201509;6454;17521;5383;16101;359;1281;4362;12982;4721;14263
292220;201509;1883;5192;1679;4880;536;1451;713;2125;1249;3576
292225;201509;3203;9832;2908;9401;179;712;2347;7536;2526;8248
292230;201509;6396;18814;6042;18228;364;1499;4657;13505;5021;15004
292240;201509;4767;14279;4242;13209;491;1603;2939;9048;3430;10651
292250;201509;5039;15463;4613;14665;1147;3726;2039;6572;3186;10298
292260;201509;3129;9275;2920;8986;206;656;2427;7489;2633;8145
292265;201509;3088;9482;2664;8749;145;642;1994;6412;2139;7054
292270;201509;4076;10359;3211;9356;173;572;2655;7782;2828;8354
292273;201509;2740;6338;2062;5501;202;501;1524;4268;1726;4769
292275;201509;1659;4461;1465;4172;190;568;1062;3054;1252;3622
292280;201509;2062;5984;1782;5665;178;512;1342;4540;1520;5052
292285;201509;2504;6777;2086;6164;121;438;1634;4744;1755;5182
292290;201509;7118;21211;5903;19563;403;1559;4553;15203;4956;16762
292300;201509;8029;24115;6996;22828;1717;5848;3893;13047;5610;18895
292303;201509;2814;8602;2560;8256;105;444;2181;6890;2286;7334
292305;201509;2914;7900;2737;7642;67;256;2489;6857;2556;7113
292310;201509;5844;17214;5408;16567;204;694;4479;13691;4683;14385
292320;201509;6490;18455;5509;16793;458;1480;4166;12618;4624;14098
292330;201509;2153;5820;1979;5572;177;581;1563;4327;1740;4908
292335;201509;5083;13310;4533;12581;441;1198;3681;10361;4122;11559
292340;201509;6228;17819;5295;16258;538;1636;3722;11488;4260;13124
292350;201509;2250;6653;1972;6250;185;676;1526;4809;1711;5485
292360;201509;5183;13684;4934;13194;223;466;4120;11542;4343;12008
292370;201509;8010;23507;7287;22509;715;1911;5676;17914;6391;19825
292380;201509;7229;21317;6579;20277;546;1564;5191;16199;5737;17763
292390;201509;3430;7853;2925;7307;93;204;2683;6758;2776;6962
292400;201509;20537;61876;19348;60011;2394;7559;14180;44192;16574;51751
292405;201509;4486;11244;3597;10091;199;509;2899;8196;3098;8705
292410;201509;1934;5176;1808;5034;132;376;1526;4225;1658;4601
292420;201509;3711;12064;3517;11779;228;831;2960;9961;3188;10792
292430;201509;5591;16525;4208;14507;297;1197;3041;10454;3338;11651
292440;201509;8415;27809;7774;26845;234;970;6931;24116;7165;25086
292450;201509;3988;11876;3270;10698;327;1086;2296;7607;2623;8693
292460;201509;5162;15313;4433;14054;629;2098;2892;9161;3521;11259
292465;201509;2385;7084;1980;6412;196;722;1294;4253;1490;4975
292467;201509;1903;6084;1807;5930;295;1033;1208;4031;1503;5064
292470;201509;2864;7690;2366;6843;110;390;1872;5349;1982;5739
292480;201509;6017;16168;5190;15062;164;618;4628;13333;4792;13951
292490;201509;2357;6474;1944;5853;150;500;1496;4470;1646;4970
292500;201509;6465;19198;5483;17426;674;2225;3601;11566;4275;13791
292510;201509;12831;36174;11082;33677;844;2923;8527;26064;9371;28987
292520;201509;5412;15670;4719;14584;1141;3540;2430;7625;3571;11165
292525;201509;5204;13701;4464;12822;201;642;3776;10851;3977;11493
292530;201509;27192;76439;23336;71157;6128;19325;10880;34122;17008;53447
292540;201509;2810;7772;2483;7347;264;899;1903;5581;2167;6480
292550;201509;6391;19728;5562;18638;638;2276;4196;14417;4834;16693
292560;201509;3986;11088;3463;10323;180;707;2690;7860;2870;8567
292570;201509;4030;11831;3737;11525;77;177;3529;11137;3606;11314
292575;201509;6193;20600;5981;20259;716;2470;4679;15976;5395;18446
292580;201509;6754;19948;6348;19383;408;1307;5300;16183;5708;17490
292590;201509;7177;21557;6640;20751;513;1629;5441;16917;5954;18546
292593;201509;3005;7863;2488;7046;202;513;1922;5456;2124;5969
292595;201509;5781;15980;5083;15074;402;1267;3932;11697;4334;12964
292600;201509;10557;29701;9496;28339;944;2267;7264;22522;8208;24789
292610;201509;4542;12782;3682;11342;325;1023;2249;7210;2574;8233
292620;201509;5863;17249;5203;16476;133;449;4796;15255;4929;15704
292630;201509;9309;23380;7711;20913;836;2200;5343;14800;6179;17000
292640;201509;7695;25033;7092;24117;468;1750;5394;18540;5862;20290
292650;201509;4745;12711;4447;12318;385;876;3734;10521;4119;11397
292660;201509;10569;31771;9723;30531;1045;3382;7318;23258;8363;26640
292665;201509;2554;7843;2452;7710;50;108;2297;7322;2347;7430
292670;201509;3684;10397;2855;8910;197;677;1839;5714;2036;6391
292680;201509;3585;10759;3265;10226;417;1260;2343;7350;2760;8610
292690;201509;2860;7828;2118;6652;181;600;1473;4732;1654;5332
292700;201509;9184;27296;8064;25621;1143;3421;5256;17475;6399;20896
292710;201509;2062;6733;1943;6577;74;296;1720;5821;1794;6117
292720;201509;9200;23389;7899;21931;360;1162;6769;18863;7129;20025
292730;201509;3547;10615;3404;10401;312;975;2611;8001;2923;8976
292740;201509;319812;854078;297589;820767;52475;153311;187693;512917;240168;666228
292750;201509;6390;17142;5467;15853;291;949;4424;12825;4715;13774
292760;201509;3992;12469;3603;11755;426;1483;2405;7880;2831;9363
292770;201509;6006;17486;5286;16466;986;3190;3183;10196;4169;13386
292780;201509;1886;4477;1436;3890;137;451;1012;2641;1149;3092
292790;201509;3213;7951;3075;7807;94;179;2907;7472;3001;7651
292800;201509;8914;26414;8214;25239;511;1724;6588;20134;7099;21858
292805;201509;2917;8252;2586;7783;325;1068;1896;5674;2221;6742
292810;201509;9325;28059;7825;25954;930;3188;5475;18542;6405;21730
292820;201509;6998;20411;5463;18178;299;1199;4253;14118;4552;15317
292830;201509;1773;5130;1590;4866;76;324;1367;4112;1443;4436
292840;201509;7607;23598;7093;22899;314;1297;6231;19793;6545;21090
292850;201509;3180;8344;2578;7415;351;1030;1573;4432;1924;5462
292860;201509;14735;38433;13470;36748;1182;3338;10429;28325;11611;31663
292870;201509;18923;51630;16387;47579;2153;6883;9607;27415;11760;34298
292880;201509;12585;35678;11114;33568;1210;4039;7683;22842;8893;26881
292890;201509;5292;17845;4765;16897;692;2603;3084;11062;3776;13665
292895;201509;2718;6656;2113;5734;264;664;1457;3993;1721;4657
292900;201509;2760;8545;2618;8316;191;852;1930;5833;2121;6685
292905;201509;4046;11903;3358;10844;218;770;2519;8142;2737;8912
292910;201509;4977;14803;4494;13906;626;2050;2716;8393;3342;10443
292920;201509;8993;26328;8470;25526;569;2047;6909;20230;7478;22277
292925;201509;5043;15375;4524;14609;421;1378;3398;11009;3819;12387
292930;201509;6425;20569;6078;19945;480;2059;4381;13961;4861;16020
292935;201509;2088;6001;1752;5636;115;411;1446;4795;1561;5206
292937;201509;3173;8073;2624;7394;251;775;2013;5616;2264;6391
292940;201509;3256;8893;2541;7888;294;916;1702;5493;1996;6409
292950;201509;7877;23061;7284;22040;571;2084;5321;15643;5892;17727
292960;201509;5146;13327;4409;12316;323;976;3231;8939;3554;9915
292970;201509;4228;12674;3718;11975;159;689;3056;9784;3215;10473
292975;201509;3426;9198;3225;8938;357;914;2696;7604;3053;8518
292980;201509;3255;8785;2518;7736;231;811;1801;5493;2032;6304
292990;201509;11766;33787;10322;31570;442;1588;8469;25722;8911;27310
293000;201509;2779;7267;2505;6935;63;206;2079;5983;2142;6189
293010;201509;17852;49331;15083;44824;2485;7842;8870;26088;11355;33930
293015;201509;7317;25122;6478;23442;817;3378;4144;14832;4961;18210
293020;201509;9105;30227;8514;29404;354;1563;7287;25037;7641;26600
293030;201509;5360;15546;4268;13826;318;1045;3014;10153;3332;11198
293040;201509;3645;12006;3474;11675;191;661;3034;10185;3225;10846
293050;201509;19866;54719;17427;51615;2850;8665;10270;31510;13120;40175
293060;201509;3807;9944;3096;8768;266;818;2253;6278;2519;7096
293070;201509;21277;61117;18523;56810;4551;14003;9043;28645;13594;42648
293075;201509;3259;11016;2992;10614;236;969;2319;8238;2555;9207
293076;201509;3740;10323;3370;9821;202;560;2828;8409;3030;8969
293077;201509;4692;14811;4232;14134;1028;3599;2243;7671;3271;11270
293080;201509;4497;14245;4106;13607;205;963;3377;10956;3582;11919
293090;201509;3244;10443;2686;9592;287;1054;1882;6826;2169;7880
293100;201509;5749;16984;4764;15221;450;1535;3461;11159;3911;12694
293105;201509;3974;13078;3449;12043;551;1885;2154;7734;2705;9619
293110;201509;1990;5715;1757;5354;63;222;1468;4477;1531;4699
293120;201509;3704;12275;3508;11961;339;1061;2728;9535;3067;10596
293130;201509;4056;11446;3436;10763;154;549;3056;9663;3210;10212
293135;201509;31247;78461;23359;67234;4828;15611;9453;26841;14281;42452
293140;201509;1956;5579;1860;5443;144;522;1485;4199;1629;4721
293150;201509;5454;17993;4667;16411;801;2872;2786;10032;3587;12904
293160;201509;3746;9569;3433;9202;595;1197;2427;7052;3022;8249
293170;201509;3299;9804;3016;9391;322;1159;2123;6633;2445;7792
293180;201509;5203;14594;4140;12848;178;742;3212;9724;3390;10466
293190;201509;13760;41439;12707;39829;443;2097;10921;33521;11364;35618
293200;201509;6972;19316;6043;18109;216;793;4841;14560;5057;15353
293210;201509;4903;14224;4327;13214;294;994;3306;10042;3600;11036
293220;201509;5083;14878;4384;13642;1144;3613;1735;5517;2879;9130
293230;201509;3816;11640;3466;11091;497;1721;2369;7584;2866;9305
293240;201509;4402;11982;3518;10505;145;476;2612;7771;2757;8247
293245;201509;4170;12009;3804;11458;319;962;2909;8832;3228;9794
293250;201509;5699;15745;5129;14888;534;1606;3643;10533;4177;12139
293260;201509;4553;13576;3860;12562;274;940;2928;9619;3202;10559
293270;201509;5607;14916;5195;14478;408;932;4513;12869;4921;13801
293280;201509;5276;14796;4490;13737;262;791;3547;11010;3809;11801
293290;201509;14921;49185;13826;47024;3311;11703;6552;22642;9863;34345
293300;201509;6809;16107;5688;14803;347;817;4482;11870;4829;12687
293305;201509;4811;11933;4075;10936;159;497;3426;9131;3585;9628
293310;201509;2495;6509;2016;5684;185;511;1396;3928;1581;4439
293315;201509;4175;10698;3563;9741;427;1131;2574;7129;3001;8260
293317;201509;2450;7141;2177;6636;207;635;1480;4552;1687;5187
293320;201509;7920;26346;7718;26089;686;2586;6337;21424;7023;24010
293325;201509;1832;5201;1497;4681;204;722;996;3102;1200;3824
293330;201509;51091;161637;45424;151580;9831;35093;22317;74961;32148;110054
293340;201509;2683;7538;2072;6470;321;1038;1131;3515;1452;4553
293345;201509;3333;9802;2885;9188;266;729;2217;7373;2483;8102
293350;201509;6640;18908;6251;18447;322;747;5529;16804;5851;17551
293360;201509;12913;39544;11665;37953;911;3327;9835;31916;10746;35243
310010;201509;993;2699;759;2326;132;505;333;945;465;1450
310020;201509;3156;9756;2534;8466;570;2075;426;1287;996;3362
310030;201509;2321;7243;1901;6504;429;1637;997;3338;1426;4975
310040;201509;1024;2677;839;2428;68;238;642;1819;710;2057
310050;201509;1901;6471;1695;5997;318;1259;709;2449;1027;3708
310060;201509;3222;10203;2811;9672;366;1315;1998;6905;2364;8220
310070;201509;334;951;261;817;26;111;151;431;177;542
310080;201509;726;2175;580;1919;116;488;210;621;326;1109
310090;201509;4657;13788;3980;12583;532;1876;2462;7689;2994;9565
310100;201509;3326;10088;2762;9122;197;775;2131;7005;2328;7780
310110;201509;4818;13513;4104;12344;671;2273;2311;6748;2982;9021
310120;201509;604;1835;473;1561;132;550;183;486;315;1036
310130;201509;422;1262;376;1189;90;337;191;549;281;886
310140;201509;196;653;160;588;55;245;39;110;94;355
310150;201509;4633;14168;3998;12920;970;3455;1560;4894;2530;8349
310160;201509;7525;23377;6091;20731;1773;6554;1411;4644;3184;11198
310163;201509;984;3140;809;2784;207;750;239;805;446;1555
310170;201509;8996;25387;8048;24016;1224;3785;5182;15751;6406;19536
310180;201509;1618;4663;1350;4240;310;1077;619;1851;929;2928
310190;201509;2747;9097;2497;8686;692;2614;369;1277;1061;3891
310200;201509;1874;6065;1556;5404;347;1350;538;1836;885;3186
310205;201509;1119;3222;864;2810;158;516;461;1524;619;2040
310210;201509;2701;7879;2428;7472;233;793;1867;5750;2100;6543
310220;201509;1061;3244;971;3091;187;682;557;1710;744;2392
310230;201509;2539;7919;2112;6979;426;1646;1011;3122;1437;4768
310240;201509;919;3322;818;3115;128;540;433;1703;561;2243
310250;201509;847;2790;814;2729;142;591;484;1506;626;2097
310260;201509;3314;10428;2548;8798;639;2508;704;2181;1343;4689
310270;201509;2507;7190;2103;6603;185;694;1598;4961;1783;5655
310280;201509;2277;6096;1890;5508;265;971;998;2718;1263;3689
310285;201509;2057;7312;1927;7110;252;1087;1428;5284;1680;6371
310290;201509;1207;3641;1127;3524;272;980;547;1540;819;2520
310300;201509;1729;5802;1627;5611;445;1742;831;2748;1276;4490
310310;201509;376;1021;268;811;40;119;124;384;164;503
310320;201509;386;1227;317;1086;46;217;150;492;196;709
310330;201509;516;1284;350;978;35;119;153;371;188;490
310340;201509;8346;25084;6851;22483;1326;4467;3502;11879;4828;16346
310350;201509;14096;37213;10067;30413;2519;8507;2849;8271;5368;16778
310360;201509;437;1317;411;1280;40;165;285;826;325;991
310370;201509;1391;4651;1281;4455;360;1278;648;2286;1008;3564
310375;201509;1250;3327;792;2481;116;417;307;932;423;1349
310380;201509;375;1009;270;850;93;321;93;261;186;582
310390;201509;459;1608;387;1457;87;364;73;231;160;595
310400;201509;10258;28605;7569;23840;1825;6243;1840;5754;3665;11997
310410;201509;805;2614;540;2131;125;545;112;422;237;967
310420;201509;5675;15883;3472;11102;601;2130;565;1564;1166;3694
310430;201509;1372;4494;1036;3778;262;1056;180;601;442;1657
310440;201509;576;1634;441;1391;86;320;180;527;266;847
310445;201509;1216;4000;1010;3599;149;575;633;2239;782;2814
310450;201509;4582;12893;3681;11586;487;1616;2421;7729;2908;9345
310460;201509;1528;4609;1261;4186;362;1323;275;962;637;2285
310470;201509;3584;8906;3023;8213;284;709;2455;6811;2739;7520
310480;201509;1228;3588;914;2955;172;641;392;1164;564;1805
310490;201509;2902;9398;2466;8525;626;2502;944;3143;1570;5645
310500;201509;1294;4338;1140;4002;264;1044;441;1474;705;2518
310510;201509;2134;6660;1639;5547;413;1510;287;930;700;2440
310520;201509;1403;3662;1071;3135;84;245;717;2110;801;2355
310530;201509;897;2742;495;1691;65;240;66;192;131;432
310540;201509;2933;9585;2638;9033;658;2340;1136;3903;1794;6243
310550;201509;1198;3403;954;2994;216;818;443;1273;659;2091
310560;201509;15468;46968;12922;41911;3521;12758;3923;11841;7444;24599
310570;201509;1168;3477;990;3166;157;600;659;2054;816;2654
310590;201509;4321;12492;3400;10746;629;2122;1322;4045;1951;6167
310600;201509;1376;4528;1219;4187;297;1178;438;1362;735;2540
310610;201509;486;1627;416;1473;85;375;131;399;216;774
310620;201509;145446;442549;122169;397797;28710;105023;47437;143724;76147;248747
310630;201509;3950;11991;3656;11489;385;1392;2682;8336;3067;9728
310640;201509;1307;3907;1020;3388;322;1166;252;751;574;1917
310650;201509;2669;8500;2136;7557;363;1374;1168;4139;1531;5513
310660;201509;1364;4112;1192;3871;136;458;841;2700;977;3158
310665;201509;1255;3814;1114;3605;113;408;850;2787;963;3195
310670;201509;42683;129324;37350;117985;9586;32112;13638;41615;23224;73727
310680;201509;682;1952;617;1854;118;386;371;1089;489;1475
310690;201509;1413;4535;1128;4019;259;1067;354;1174;613;2241
310700;201509;589;1472;454;1291;91;301;261;704;352;1005
310710;201509;6375;20766;4924;18220;1057;4648;878;2875;1935;7523
310720;201509;758;2282;681;2146;113;413;392;1192;505;1605
310730;201509;9302;28741;8240;26961;1553;5495;4719;15325;6272;20820
310740;201509;4933;15684;3905;13623;972;3750;875;2888;1847;6638
310750;201509;1503;3703;1136;3210;203;607;604;1611;807;2218
310760;201509;627;1882;515;1693;110;388;202;664;312;1052
310770;201509;868;2714;668;2394;156;632;271;898;427;1530
310780;201509;3689;10265;3106;9222;495;1482;1848;5468;2343;6950
310790;201509;1916;6103;1711;5730;427;1497;786;2745;1213;4242
310800;201509;2809;8849;2130;7505;652;2640;200;625;852;3265
310810;201509;1214;3379;1071;3125;190;613;581;1604;771;2217
310820;201509;1297;3692;934;3006;229;809;251;770;480;1579
310825;201509;2494;8376;1953;7408;133;696;1401;5246;1534;5942
310830;201509;1318;4239;1015;3627;308;1175;247;823;555;1998
310840;201509;2154;6585;1672;5706;386;1419;450;1434;836;2853
310850;201509;1566;4581;1299;4234;202;699;868;2832;1070;3531
310855;201509;2889;9089;2474;8438;427;1600;1561;5358;1988;6958
310860;201509;7535;23015;6297;20769;884;3117;3632;12123;4516;15240
310870;201509;1016;2812;806;2478;150;500;407;1251;557;1751
310880;201509;1190;3583;885;3002;158;638;437;1447;595;2085
310890;201509;2676;8142;2046;7019;495;1922;457;1394;952;3316
310900;201509;3972;12534;3099;10637;708;2692;972;3065;1680;5757
310910;201509;2018;5694;1285;4225;262;977;191;511;453;1488
310920;201509;1881;5516;1461;4875;351;1335;617;2010;968;3345
310925;201509;907;2979;813;2812;307;1169;287;951;594;2120
310930;201509;6033;17054;4796;15189;866;2936;2702;8782;3568;11718
310940;201509;6241;17673;5165;15991;927;2956;2663;8209;3590;11165
310945;201509;1190;3414;1020;3159;143;519;619;1843;762;2362
310950;201509;2011;6373;1474;5178;391;1585;366;1108;757;2693
310960;201509;397;1270;324;1134;89;355;105;362;194;717
310970;201509;1479;4948;1038;3862;261;1089;132;398;393;1487
310980;201509;463;1120;285;819;38;130;137;340;175;470
310990;201509;1180;3851;955;3370;218;874;274;886;492;1760
311000;201509;3628;12281;3208;11415;876;3555;1099;3605;1975;7160
311010;201509;746;2446;687;2334;223;831;316;1036;539;1867
311020;201509;901;2674;706;2323;151;556;294;903;445;1459
311030;201509;1615;4381;1116;3466;281;1008;385;1060;666;2068
311040;201509;484;1630;420;1467;91;333;96;316;187;649
311050;201509;2056;6437;1795;6016;493;1829;791;2641;1284;4470
311060;201509;2227;6669;1658;5422;346;1273;437;1305;783;2578
311070;201509;1409;4836;1222;4465;296;1232;474;1698;770;2930
311080;201509;871;2597;748;2361;138;493;362;1043;500;1536
311090;201509;1519;5644;1284;5155;392;1746;235;930;627;2676
311100;201509;2065;6906;1675;6056;615;2401;303;1065;918;3466
311110;201509;3703;8761;2597;7176;388;1156;1382;3794;1770;4950
311115;201509;1203;3528;1000;3219;110;459;653;2043;763;2502
311120;201509;7821;21961;5986;18639;1465;5078;1523;4324;2988;9402
311130;201509;1943;6092;1623;5616;354;1488;699;2255;1053;3743
311140;201509;1367;3640;1103;3283;111;395;772;2248;883;2643
311150;201509;1830;6187;1669;5926;283;1124;1023;3618;1306;4742
311160;201509;4232;14022;3448;12579;1175;4710;870;3066;2045;7776
311170;201509;779;2366;613;2057;76;269;300;1041;376;1310
311180;201509;1316;3696;1001;3085;287;964;244;679;531;1643
311190;201509;1022;3000;866;2693;188;682;269;731;457;1413
311200;201509;2096;6341;1678;5455;475;1719;334;935;809;2654
311205;201509;1029;3367;867;3028;138;545;381;1337;519;1882
311210;201509;935;3004;859;2896;156;521;594;2062;750;2583
311220;201509;893;2788;702;2366;164;594;220;710;384;1304
311230;201509;8475;26223;6693;22656;1327;4817;2572;8941;3899;13758
311240;201509;1097;3271;841;2818;196;721;237;736;433;1457
311250;201509;839;2714;745;2564;212;846;250;730;462;1576
311260;201509;2532;6680;1867;5575;473;1552;605;1769;1078;3321
311265;201509;1268;3493;996;3044;173;610;545;1633;718;2243
311270;201509;3322;10515;2883;9879;352;1565;1924;6312;2276;7877
311280;201509;1292;3564;834;2613;167;615;244;708;411;1323
311290;201509;1991;6682;1854;6365;398;1385;1056;3656;1454;5041
311300;201509;4437;14710;3969;13847;500;2021;2675;9290;3175;11311
311310;201509;550;1870;494;1768;90;385;201;659;291;1044
311320;201509;4050;13330;3533;12169;699;2720;1176;3792;1875;6512
311330;201509;4859;14405;4124;13163;1143;4062;1698;5356;2841;9418
311340;201509;12116;37951;10495;34820;3133;11190;2923;9550;6056;20740
311350;201509;2286;6509;1777;5532;317;1159;790;2235;1107;3394
311360;201509;1178;3225;894;2851;330;1096;181;579;511;1675
311370;201509;3793;11324;3172;10207;697;2702;1328;3898;2025;6600
311380;201509;402;1321;349;1221;97;375;113;378;210;753
311390;201509;1819;6566;1658;6320;688;3003;496;1723;1184;4726
311400;201509;1468;4609;1212;4111;221;900;514;1566;735;2466
311410;201509;1799;6123;1615;5876;442;1796;789;2901;1231;4697
311420;201509;1941;6236;1287;4581;282;1088;216;579;498;1667
311430;201509;3952;11739;2661;8860;494;1792;312;945;806;2737
311440;201509;2363;7534;1740;6350;526;2253;299;1034;825;3287
311450;201509;1975;6765;1635;5978;437;1761;344;1155;781;2916
311455;201509;1210;3212;969;2811;225;708;468;1262;693;1970
311460;201509;700;2254;533;1907;113;486;123;411;236;897
311470;201509;518;1659;408;1416;104;442;117;350;221;792
311480;201509;768;2029;719;1968;188;502;421;1143;609;1645
311490;201509;239;881;211;800;60;249;76;266;136;515
311500;201509;468;1339;368;1151;84;306;156;475;240;781
311510;201509;3157;9701;2554;8534;803;3161;559;1699;1362;4860
311520;201509;629;2057;576;1942;189;704;217;683;406;1387
311530;201509;11747;30141;8185;24221;1880;6630;2226;6342;4106;12972
311535;201509;828;2395;525;1779;122;477;74;235;196;712
311540;201509;628;2191;586;2127;221;805;236;841;457;1646
311545;201509;2073;6396;1880;6152;194;729;1333;4289;1527;5018
311547;201509;1538;4292;1278;3871;100;333;848;2572;948;2905
311550;201509;2893;9163;2389;8115;458;1766;814;2709;1272;4475
311560;201509;260;672;217;617;39;125;122;327;161;452
311570;201509;2181;5378;1673;4712;124;386;1251;3571;1375;3957
311580;201509;2394;4881;1820;4218;514;1096;968;2394;1482;3490
311590;201509;452;1381;383;1276;103;396;137;455;240;851
311600;201509;1195;3606;1013;3361;185;609;626;2116;811;2725
311610;201509;3079;10677;2744;10076;889;3210;1119;4336;2008;7546
311615;201509;3078;9441;2530;8553;267;1036;1732;5846;1999;6882
311620;201509;423;1313;368;1218;74;270;202;667;276;937
311630;201509;1388;4017;1143;3595;268;819;629;1997;897;2816
311640;201509;819;2590;671;2328;133;504;373;1258;506;1762
311650;201509;2266;6579;1894;5952;272;913;1042;3337;1314;4250
311660;201509;2419;8013;1899;6768;371;1439;233;664;604;2103
311670;201509;1592;4679;1289;4143;415;1469;405;1259;820;2728
311680;201509;2067;6463;1738;5904;397;1422;910;3087;1307;4509
311690;201509;502;1301;420;1199;43;132;334;955;377;1087
311700;201509;2193;5933;1814;5409;133;468;1386;4035;1519;4503
311710;201509;1686;5061;1226;4181;448;1697;306;982;754;2679
311720;201509;396;1304;349;1203;64;242;166;552;230;794
311730;201509;5859;14527;3345;10084;931;3273;879;2088;1810;5361
311740;201509;853;2490;785;2406;282;834;409;1296;691;2130
311750;201509;3988;12932;3440;12039;690;2690;1748;5994;2438;8684
311760;201509;809;2703;714;2475;173;709;241;723;414;1432
311770;201509;2324;7286;1868;6409;439;1695;567;1830;1006;3525
311780;201509;1078;3847;892;3405;263;1154;200;692;463;1846
311783;201509;1953;6395;1647;5795;110;540;1206;4192;1316;4732
311787;201509;579;1983;414;1487;74;296;91;268;165;564
311790;201509;1433;4228;1034;3449;236;892;316;1001;552;1893
311800;201509;4267;14340;3411;11944;639;2377;186;518;825;2895
311810;201509;1039;3395;941;3197;69;313;639;2135;708;2448
311820;201509;604;1910;488;1624;124;452;235;743;359;1195
311830;201509;8244;27490;6608;23395;2146;8205;821;2561;2967;10766
311840;201509;3123;9197;2706;8592;727;2621;1245;3818;1972;6439
311850;201509;291;862;249;789;63;222;108;327;171;549
311860;201509;49370;145480;41528;131176;9078;31478;19257;58460;28335;89938
311870;201509;2185;6360;1620;5267;340;1260;496;1459;836;2719
311880;201509;6858;19642;6034;18629;809;2363;4240;13593;5049;15956
311890;201509;1421;4232;1135;3669;278;996;453;1419;731;2415
311900;201509;768;2357;685;2246;112;377;435;1494;547;1871
311910;201509;4285;12492;3477;11297;835;2920;1467;4743;2302;7663
311920;201509;1919;6274;1666;5807;215;829;1015;3513;1230;4342
311930;201509;3634;10352;3065;9433;1125;3654;919;2768;2044;6422
311940;201509;11921;35654;9537;30687;2475;8644;1894;5642;4369;14286
311950;201509;2232;6489;1844;5934;157;566;1292;4104;1449;4670
311960;201509;363;1127;320;1032;73;272;124;337;197;609
311970;201509;352;1224;291;1086;63;278;77;267;140;545
311980;201509;648;1793;428;1389;74;256;154;496;228;752
311990;201509;427;1257;354;1135;130;459;119;350;249;809
311995;201509;1168;3556;703;2409;56;199;81;208;137;407
312000;201509;623;1864;555;1759;77;272;344;1093;421;1365
312010;201509;926;2981;778;2647;136;507;319;1060;455;1567
312015;201509;1417;4513;1255;4220;162;662;795;2625;957;3287
312020;201509;970;3035;843;2829;171;627;418;1393;589;2020
312030;201509;1759;5195;1575;4964;119;454;1285;3996;1404;4450
312040;201509;721;2656;610;2350;164;712;129;466;293;1178
312050;201509;1425;4876;1199;4373;289;1179;161;507;450;1686
312060;201509;754;2267;651;2104;256;886;227;674;483;1560
312070;201509;1027;3140;662;2341;157;595;219;769;376;1364
312080;201509;2623;7308;2072;6430;328;1190;1087;3171;1415;4361
312083;201509;909;2585;781;2391;100;341;532;1597;632;1938
312087;201509;2173;6628;1926;6263;247;857;1322;4370;1569;5227
312090;201509;8839;27392;7630;25263;2185;7713;2878;9284;5063;16997
312100;201509;1372;4597;1143;4230;252;1049;524;1913;776;2962
312110;201509;1096;3807;948;3481;303;1284;169;526;472;1810
312120;201509;754;2453;642;2225;148;615;221;661;369;1276
312125;201509;1181;3713;1032;3439;240;822;520;1787;760;2609
312130;201509;836;2392;629;1966;95;345;240;695;335;1040
312140;201509;855;2700;716;2367;149;552;218;612;367;1164
312150;201509;538;1541;454;1359;23;85;298;847;321;932
312160;201509;7383;24896;6528;23093;1751;6780;2327;8083;4078;14863
312170;201509;962;2731;808;2467;84;282;491;1483;575;1765
312180;201509;1364;4142;1181;3777;261;903;458;1385;719;2288
312190;201509;588;1885;447;1602;147;583;87;293;234;876
312200;201509;4795;13770;4013;12509;548;1746;2544;7900;3092;9646
312210;201509;1014;2741;775;2384;210;707;298;854;508;1561
312220;201509;1874;6235;1714;6049;220;750;1354;4979;1574;5729
312230;201509;13105;39875;9949;33595;3270;12231;1562;4977;4832;17208
312235;201509;1585;4718;1368;4393;165;654;917;2869;1082;3523
312240;201509;948;3108;757;2698;176;683;227;750;403;1433
312245;201509;2224;6530;1967;6190;124;424;1595;5005;1719;5429
312247;201509;834;2481;646;2148;170;621;284;944;454;1565
312250;201509;1200;3312;925;2851;162;573;366;1053;528;1626
312260;201509;896;2834;737;2569;133;540;449;1504;582;2044
312270;201509;661;1981;548;1763;78;327;244;702;322;1029
312280;201509;401;1350;355;1248;119;448;50;166;169;614
312290;201509;751;2443;689;2349;194;773;220;728;414;1501
312300;201509;867;2862;672;2384;156;606;81;214;237;820
312310;201509;907;3380;827;3189;239;1014;299;1110;538;2124
312320;201509;1951;5561;1448;4514;332;1099;249;607;581;1706
312330;201509;987;2890;819;2636;142;545;574;1813;716;2358
312340;201509;312;813;270;754;36;136;195;496;231;632
312350;201509;306;763;274;725;23;71;232;595;255;666
312352;201509;1614;5120;1434;4839;373;1290;846;2932;1219;4222
312360;201509;2928;9403;2384;8259;527;2029;695;2350;1222;4379
312370;201509;1711;5387;1536;5104;536;1997;489;1514;1025;3511
312380;201509;1898;5307;1681;5002;109;346;1363;4149;1472;4495
312385;201509;1289;3794;1111;3506;111;445;770;2348;881;2793
312390;201509;2136;6905;1713;6013;457;1728;290;912;747;2640
312400;201509;3174;10099;2672;9133;920;3265;779;2741;1699;6006
312410;201509;9843;32029;8631;29646;1957;7343;3521;11751;5478;19094
312420;201509;3973;12149;3731;11840;542;1749;2614;8441;3156;10190
312430;201509;7788;23168;6696;21180;1247;4026;3944;12560;5191;16586
312440;201509;684;2167;602;2028;153;566;292;1027;445;1593
312450;201509;1105;3655;856;3120;289;1114;260;961;549;2075
312460;201509;359;1081;320;1036;89;333;153;480;242;813
312470;201509;683;1849;434;1361;80;287;141;421;221;708
312480;201509;1235;3306;950;2980;225;784;494;1463;719;2247
312490;201509;2033;5320;1564;4629;236;785;862;2431;1098;3216
312500;201509;682;2071;596;1937;99;395;256;785;355;1180
312510;201509;3202;9324;2469;7787;426;1538;1188;3457;1614;4995
312520;201509;268;908;216;807;59;239;71;269;130;508
312530;201509;589;1763;523;1663;76;307;336;1020;412;1327
312540;201509;1466;4587;1132;3915;242;895;540;1844;782;2739
312550;201509;679;2075;574;1842;121;401;255;770;376;1171
312560;201509;2007;5337;1687;4920;106;367;1353;3903;1459;4270
312570;201509;2484;7276;2039;6505;599;2044;589;1806;1188;3850
312580;201509;530;1744;439;1548;80;346;160;528;240;874
312590;201509;1719;5690;1484;5184;295;1235;609;1952;904;3187
312595;201509;2002;6700;1776;6171;409;1497;901;3118;1310;4615
312600;201509;805;2594;619;2213;100;465;304;979;404;1444
312610;201509;6996;19592;5095;16080;1178;4154;1201;3515;2379;7669
312620;201509;2069;6088;1619;5469;166;646;1181;4052;1347;4698
312630;201509;353;1145;308;1059;77;299;127;408;204;707
312640;201509;545;1742;432;1506;89;344;141;444;230;788
312650;201509;2137;6290;1545;5107;159;563;893;2947;1052;3510
312660;201509;1345;3624;1106;3268;112;389;749;2160;861;2549
312670;201509;5616;16707;4777;15509;1306;4673;1703;5355;3009;10028
312675;201509;1264;4045;1050;3582;132;523;638;2123;770;2646
312680;201509;1462;4500;1284;4234;217;819;726;2271;943;3090
312690;201509;2177;5800;1754;5200;291;961;1052;2984;1343;3945
312695;201509;813;2911;776;2856;165;593;496;1891;661;2484
312700;201509;1914;5670;1461;4733;205;752;719;2268;924;3020
312705;201509;1269;3611;1066;3252;102;352;757;2266;859;2618
312707;201509;1650;5097;1276;4363;189;751;662;2166;851;2917
312710;201509;7121;18095;4585;13831;1213;4186;955;2633;2168;6819
312720;201509;757;2571;656;2358;151;602;238;800;389;1402
312730;201509;1890;4475;1309;3788;186;583;724;2103;910;2686
312733;201509;1672;4427;1233;3603;79;295;837;2324;916;2619
312735;201509;826;2311;715;2160;175;602;401;1165;576;1767
312737;201509;857;2143;612;1791;191;556;229;694;420;1250
312738;201509;541;1624;390;1304;98;396;128;367;226;763
312740;201509;400;1059;256;888;83;321;65;219;148;540
312750;201509;1244;4395;1182;4273;248;1088;567;1930;815;3018
312760;201509;2079;6590;1580;5560;380;1472;358;1230;738;2702
312770;201509;40958;112316;31636;96539;8255;27229;8981;26443;17236;53672
312780;201509;2695;9347;2395;8835;440;1789;1250;4692;1690;6481
312790;201509;330;840;187;585;43;167;51;118;94;285
312800;201509;4979;16184;4026;14208;1236;4705;1056;3707;2292;8412
312810;201509;2164;6529;1461;5145;355;1349;263;848;618;2197
312820;201509;1916;5496;1701;5140;121;435;1147;3380;1268;3815
312825;201509;1365;3681;1172;3430;109;353;888;2573;997;2926
312830;201509;2628;8089;1798;6376;450;1717;294;1006;744;2723
312840;201509;1236;3959;1023;3554;155;662;417;1335;572;1997
312850;201509;641;2030;514;1785;85;353;163;544;248;897
312860;201509;1105;3211;856;2768;208;774;244;669;452;1443
312870;201509;5473;16920;3762;13216;734;2867;786;2650;1520;5517
312880;201509;1261;3731;1087;3452;160;557;637;2067;797;2624
312890;201509;1639;4854;1100;3683;291;1096;357;1171;648;2267
312900;201509;1222;3597;1073;3387;152;505;749;2422;901;2927
312910;201509;1615;3273;1000;2469;165;474;520;1155;685;1629
312920;201509;864;2722;715;2459;194;767;279;887;473;1654
312930;201509;2225;6343;1901;5863;424;1369;895;2814;1319;4183
312940;201509;896;2917;771;2701;211;848;206;667;417;1515
312950;201509;3268;9065;2490;7867;819;2805;658;2030;1477;4835
312960;201509;1942;5586;1686;5252;252;751;1247;4001;1499;4752
312965;201509;1784;5652;1504;5140;208;826;885;3005;1093;3831
312970;201509;981;3325;817;3030;251;1075;141;468;392;1543
312980;201509;17029;56753;15870;54234;5054;18972;6164;20091;11218;39063
312990;201509;449;1343;326;1123;103;401;93;313;196;714
313000;201509;506;1652;407;1454;98;458;163;499;261;957
313005;201509;2581;8264;2254;7639;505;1657;1177;4084;1682;5741
313010;201509;3765;11907;3152;10825;834;3105;1294;4360;2128;7465
313020;201509;966;3110;776;2648;169;666;211;617;380;1283
313030;201509;1498;4006;1106;3455;240;933;462;1333;702;2266
313040;201509;848;2815;712;2468;124;505;267;839;391;1344
313050;201509;1785;5503;1341;4825;316;1285;345;1100;661;2385
313055;201509;1566;5034;1425;4838;111;402;1102;3781;1213;4183
313060;201509;704;2280;543;1880;156;557;65;206;221;763
313065;201509;1941;6246;1656;5783;336;1299;1090;3789;1426;5088
313070;201509;1112;3199;902;2820;209;760;400;1141;609;1901
313080;201509;472;1473;354;1224;83;332;120;357;203;689
313090;201509;5254;15039;4516;13838;1003;3268;2347;7214;3350;10482
313100;201509;1080;3326;967;3136;111;379;733;2395;844;2774
313110;201509;1744;4895;1285;4000;233;828;533;1533;766;2361
313115;201509;2429;8148;2280;7840;546;2128;1054;3374;1600;5502
313120;201509;3471;9222;2891;8426;785;2526;1402;3869;2187;6395
313130;201509;24620;74255;20925;66519;4922;17245;7742;22953;12664;40198
313140;201509;677;1707;508;1454;33;119;358;1004;391;1123
313150;201509;1354;4255;1133;3833;470;1737;259;831;729;2568
313160;201509;1023;3074;884;2807;151;562;503;1534;654;2096
313170;201509;7832;26467;6217;22594;1565;6086;1250;4402;2815;10488
313180;201509;2408;6564;1901;5825;517;1740;688;2017;1205;3757
313190;201509;3104;10691;2453;8964;524;2095;671;2255;1195;4350
313200;201509;1231;3991;1069;3682;149;580;707;2383;856;2963
313210;201509;4311;13206;3592;12151;836;3075;1574;5117;2410;8192
313220;201509;1385;4166;1003;3321;240;878;219;620;459;1498
313230;201509;2268;8075;2084;7804;324;1312;1403;5253;1727;6565
313240;201509;7497;23057;5910;20091;1243;4843;2222;7170;3465;12013
313250;201509;7069;22025;6181;20483;913;3105;3554;11879;4467;14984
313260;201509;609;1806;445;1461;71;266;107;319;178;585
313270;201509;5422;16073;4546;14567;836;2869;2485;7867;3321;10736
313280;201509;381;1265;297;1074;48;213;77;239;125;452
313290;201509;864;2993;692;2662;232;974;114;372;346;1346
313300;201509;1821;6038;1470;5179;412;1577;216;653;628;2230
313310;201509;1091;3746;961;3475;234;950;181;596;415;1546
313320;201509;2356;6799;1790;5860;344;1259;764;2466;1108;3725
313330;201509;3929;12181;3252;10967;411;1626;1841;6043;2252;7669
313340;201509;1961;4800;1518;4143;295;818;835;2251;1130;3069
313350;201509;3145;9563;2389;7928;508;1871;461;1359;969;3230
313360;201509;1209;3488;898;2978;237;932;454;1399;691;2331
313370;201509;1142;3868;1042;3588;163;673;533;1695;696;2368
313375;201509;2241;5801;1491;4663;277;1081;481;1414;758;2495
313380;201509;4931;15292;4037;13435;1017;3719;1331;4163;2348;7882
313390;201509;861;2958;820;2900;91;368;555;1955;646;2323
313400;201509;3713;10178;3298;9705;254;721;2786;8369;3040;9090
313410;201509;1259;3548;1043;3227;239;830;570;1716;809;2546
313420;201509;20240;47915;11924;33667;2298;7257;2214;5977;4512;13234
313430;201509;1074;3326;816;2768;160;655;323;1009;483;1664
313440;201509;6209;14059;4257;11768;299;929;2824;7799;3123;8728
313450;201509;644;1875;509;1596;107;412;175;487;282;899
313460;201509;2167;7349;1867;6817;500;2084;568;1895;1068;3979
313470;201509;3140;8714;2860;8343;377;1103;2059;5966;2436;7069
313480;201509;1104;3143;854;2714;124;466;342;992;466;1458
313490;201509;1411;4203;837;3237;250;1061;124;450;374;1511
313500;201509;396;1237;338;1100;59;223;128;381;187;604
313505;201509;9001;26445;8299;25640;428;1024;7477;23609;7905;24633
313507;201509;1333;3741;1172;3518;144;485;753;2265;897;2750
313510;201509;15402;43946;13341;40895;2123;6731;7607;23489;9730;30220
313520;201509;14265;43859;11964;39600;1429;5394;7555;24686;8984;30080
313530;201509;610;1890;492;1661;47;192;169;535;216;727
313535;201509;2417;7260;2158;6786;200;685;1549;4797;1749;5482
313540;201509;1061;3325;794;2621;212;774;183;529;395;1303
313545;201509;1276;4673;1144;4393;153;735;669;2420;822;3155
313550;201509;1842;5895;1608;5424;413;1470;732;2385;1145;3855
313560;201509;2154;5199;1797;4792;329;816;1179;3287;1508;4103
313570;201509;875;3052;738;2786;242;981;210;779;452;1760
313580;201509;5878;16603;4779;15047;790;2655;2851;9034;3641;11689
313590;201509;990;2807;761;2497;369;1330;186;569;555;1899
313600;201509;3822;11479;3293;10634;488;1730;2103;6802;2591;8532
313610;201509;990;2971;841;2681;180;635;398;1234;578;1869
313620;201509;5473;16797;4663;15305;1289;4513;1637;5305;2926;9818
313630;201509;7979;22418;6045;19522;1154;4247;2585;8629;3739;12876
313640;201509;779;2279;590;1983;172;648;185;597;357;1245
313650;201509;2066;6662;1791;6211;298;1196;1159;3913;1457;5109
313652;201509;964;3426;889;3290;149;626;536;1930;685;2556
313655;201509;933;2997;774;2723;121;521;446;1511;567;2032
313657;201509;1277;3883;1079;3569;111;515;772;2337;883;2852
313660;201509;818;2698;730;2540;161;663;338;1109;499;1772
313665;201509;3452;11116;2999;10164;640;2430;1370;4431;2010;6861
313670;201509;49946;138073;33042;108617;8158;29444;9708;31059;17866;60503
313680;201509;1060;3159;928;2939;161;585;557;1691;718;2276
313690;201509;841;3019;733;2762;193;755;268;1011;461;1766
313695;201509;1359;4423;1162;4062;120;473;801;2796;921;3269
313700;201509;3749;12466;3162;11703;506;1945;2116;8043;2622;9988
313710;201509;1285;3470;998;3030;209;689;487;1437;696;2126
313720;201509;5123;16468;4045;14046;836;3197;1263;4044;2099;7241
313730;201509;1267;3431;964;3048;175;620;524;1642;699;2262
313740;201509;2127;7559;1779;6704;511;2188;164;527;675;2715
313750;201509;2242;6748;1862;6027;483;1690;599;1793;1082;3483
313753;201509;1822;5299;1431;4617;348;1241;554;1743;902;2984
313760;201509;4352;14064;3553;12424;982;3756;944;3057;1926;6813
313770;201509;3287;10687;2930;10076;907;3363;1177;3938;2084;7301
313780;201509;3724;10244;2939;9090;462;1749;1256;3845;1718;5594
313790;201509;493;1704;466;1656;104;369;260;957;364;1326
313800;201509;1228;3361;1064;3106;131;427;692;2033;823;2460
313810;201509;1491;4310;1418;4211;70;197;1232;3745;1302;3942
313820;201509;13033;34615;10522;30563;1792;6113;4957;13684;6749;19797
313830;201509;416;1373;351;1245;96;389;115;406;211;795
313835;201509;917;3042;850;2935;159;645;473;1548;632;2193
313840;201509;7515;21407;5783;18426;1438;5068;1492;4604;2930;9672
313850;201509;1197;3231;1026;2925;206;703;505;1316;711;2019
313860;201509;2775;8388;2098;6891;493;1742;457;1413;950;3155
313862;201509;1200;2999;808;2348;113;315;408;1260;521;1575
313865;201509;2223;6845;2009;6524;246;925;1438;4596;1684;5521
313867;201509;1105;3762;927;3352;297;1158;282;1051;579;2209
313868;201509;1576;5437;1362;4991;130;572;907;3274;1037;3846
313870;201509;792;2467;718;2345;202;755;211;606;413;1361
313880;201509;1500;4579;1280;4232;230;899;717;2214;947;3113
313890;201509;1845;5035;1544;4632;334;940;938;2994;1272;3934
313900;201509;3981;14363;3537;13314;1048;4461;1014;3629;2062;8090
313910;201509;760;2530;624;2248;220;856;80;262;300;1118
313920;201509;3398;11158;2921;10249;487;1791;1666;5964;2153;7755
313925;201509;1906;5101;1373;4102;83;279;848;2512;931;2791
313930;201509;5218;16964;4273;15242;785;2957;2170;7839;2955;10796
313940;201509;8294;27563;6909;25302;2030;8227;2265;8649;4295;16876
313950;201509;4074;11600;3183;10109;976;3594;1029;2893;2005;6487
313960;201509;5552;14170;4007;12006;1152;3801;1089;3028;2241;6829
313970;201509;1435;4084;1240;3866;143;492;759;2474;902;2966
313980;201509;1259;3954;975;3447;279;1134;390;1363;669;2497
313990;201509;1842;6767;1547;6045;496;2134;314;1082;810;3216
314000;201509;7630;24449;6852;22924;1261;5040;3818;12115;5079;17155
314010;201509;1102;3107;904;2846;112;404;557;1701;669;2105
314015;201509;1172;4046;990;3700;263;1082;367;1296;630;2378
314020;201509;523;1589;385;1297;93;362;92;272;185;634
314030;201509;867;2769;672;2326;98;375;242;815;340;1190
314040;201509;681;1931;566;1730;257;818;159;497;416;1315
314050;201509;1767;5427;1381;4646;299;1172;456;1368;755;2540
314053;201509;1526;4841;1364;4633;186;637;916;3249;1102;3886
314055;201509;2133;6381;1880;5996;87;366;1453;4638;1540;5004
314060;201509;1138;3486;891;3059;71;306;558;1870;629;2176
314070;201509;3976;12228;3037;10360;784;2880;711;2291;1495;5171
314080;201509;1968;6018;1292;4422;231;885;280;819;511;1704
314085;201509;1965;6570;1696;6185;446;1812;620;2233;1066;4045
314090;201509;3310;11366;2893;10528;739;2991;992;3654;1731;6645
314100;201509;3266;8435;2852;7873;208;479;2393;6827;2601;7306
314110;201509;4085;12859;3513;11655;655;2552;1427;4288;2082;6840
314120;201509;1004;2431;510;1626;117;413;135;414;252;827
314130;201509;717;2047;372;1257;55;198;69;224;124;422
314140;201509;4939;15253;4097;13559;894;3138;1644;5358;2538;8496
314150;201509;1600;4372;1294;3846;209;710;672;1959;881;2669
314160;201509;2532;6487;1977;5747;188;593;1216;3695;1404;4288
314170;201509;1081;3230;874;2779;118;415;461;1406;579;1821
314180;201509;5401;17270;4779;16245;1241;4609;2064;7071;3305;11680
314190;201509;721;2078;566;1835;123;499;228;650;351;1149
314200;201509;2969;9270;2574;8539;308;1233;1719;5553;2027;6786
314210;201509;1945;5722;1715;5310;256;938;1035;3044;1291;3982
314220;201509;1659;5150;1280;4403;372;1431;254;744;626;2175
314225;201509;1314;3834;1174;3644;87;279;979;3083;1066;3362
314230;201509;649;2129;586;2015;133;515;252;834;385;1349
314240;201509;1125;3379;935;3088;142;476;540;1872;682;2348
314250;201509;561;1669;423;1381;95;349;130;370;225;719
314260;201509;1093;3878;977;3608;264;1058;305;1070;569;2128
314270;201509;2900;9327;2423;8471;240;932;1598;5633;1838;6565
314280;201509;3206;8850;2140;6761;489;1806;679;1855;1168;3661
314290;201509;4857;13373;4147;12187;1129;3434;2096;6071;3225;9505
314300;201509;1558;5155;1328;4614;365;1342;422;1393;787;2735
314310;201509;5288;15804;4478;14262;1284;4429;1494;4541;2778;8970
314315;201509;867;3338;795;3195;102;492;514;2049;616;2541
314320;201509;3088;8481;2230;7330;609;2239;1083;3584;1692;5823
314330;201509;52924;159790;45782;147960;12603;43909;16457;52267;29060;96176
314340;201509;2848;7761;1568;5190;340;1226;121;256;461;1482
314345;201509;1227;4150;1097;3932;265;993;619;2221;884;3214
314350;201509;1359;3904;1061;3407;367;1299;238;719;605;2018
314360;201509;689;2174;455;1612;95;391;100;331;195;722
314370;201509;529;1835;487;1768;143;574;281;1003;424;1577
314380;201509;1269;3783;862;2964;235;869;134;448;369;1317
314390;201509;14301;40982;10608;34035;2558;8927;2672;7870;5230;16797
314400;201509;4547;13329;3839;12319;1345;4550;1383;4522;2728;9072
314410;201509;2616;8138;2161;7231;628;2416;675;2096;1303;4512
314420;201509;752;2150;587;1906;38;188;388;1187;426;1375
314430;201509;6579;19507;5679;17799;1669;5696;1665;5256;3334;10952
314435;201509;1312;4180;1153;3899;115;492;732;2445;847;2937
314437;201509;1141;2943;950;2654;46;137;743;2053;789;2190
314440;201509;660;1916;497;1673;157;584;85;252;242;836
314450;201509;1597;4653;1320;4237;333;1238;570;1692;903;2930
314460;201509;4290;14304;3433;12424;840;3393;647;2205;1487;5598
314465;201509;2279;7121;2087;6796;120;543;1602;5066;1722;5609
314467;201509;1065;2971;886;2650;91;254;620;1889;711;2143
314470;201509;2461;7714;2000;6720;405;1597;618;1841;1023;3438
314480;201509;6050;19934;4029;14478;607;2400;443;1328;1050;3728
314490;201509;955;2795;743;2368;185;648;308;928;493;1576
314500;201509;2112;5895;1542;4900;396;1338;628;1945;1024;3283
314505;201509;1780;5237;1635;5031;261;886;1056;3258;1317;4144
314510;201509;1903;5136;1268;4234;405;1501;311;997;716;2498
314520;201509;3099;11086;2325;9162;527;2376;334;1072;861;3448
314530;201509;6236;21978;5890;21370;1128;4013;3468;13027;4596;17040
314535;201509;2730;7639;2324;7067;224;766;1770;5352;1994;6118
314537;201509;1175;3682;932;3240;140;589;532;1802;672;2391
314540;201509;416;1247;338;1079;76;277;105;298;181;575
314545;201509;1377;4208;1187;3925;176;662;799;2645;975;3307
314550;201509;632;1714;463;1477;76;321;195;563;271;884
314560;201509;4638;15845;3843;13860;740;3035;1115;3817;1855;6852
314570;201509;307;898;232;743;62;217;101;312;163;529
314580;201509;513;1710;399;1446;100;435;67;203;167;638
314585;201509;836;2724;594;2185;141;588;145;513;286;1101
314587;201509;1881;5825;1619;5354;368;1168;751;2562;1119;3730
314590;201509;3296;11080;2281;8337;399;1645;280;886;679;2531
314600;201509;1885;6109;1360;5006;356;1467;200;647;556;2114
314610;201509;6982;23583;6199;21763;1436;5678;2522;8304;3958;13982
314620;201509;1621;4802;1457;4566;187;588;1037;3271;1224;3859
314625;201509;1464;5002;1370;4827;190;805;961;3241;1151;4046
314630;201509;4895;14491;4255;13478;317;1202;3120;9827;3437;11029
314640;201509;579;1572;442;1330;109;358;125;308;234;666
314650;201509;1159;3194;805;2564;130;498;303;861;433;1359
314655;201509;1607;4761;1178;3906;291;941;428;1432;719;2373
314660;201509;270;733;196;583;22;73;96;265;118;338
314670;201509;1637;4382;1248;3722;210;706;695;2043;905;2749
314675;201509;1788;5467;1525;4997;158;604;1032;3357;1190;3961
314690;201509;2405;7571;1945;6727;535;2134;487;1556;1022;3690
314700;201509;8522;29504;6349;24482;1941;8384;1028;3795;2969;12179
314710;201509;9041;27357;6050;20657;1143;4339;910;2840;2053;7179
314720;201509;2371;7777;1974;6887;498;1949;706;2427;1204;4376
314730;201509;2294;6787;1834;6094;498;1830;626;1973;1124;3803
314740;201509;2947;9354;2553;8585;498;1902;1134;3625;1632;5527
314750;201509;342;1067;273;908;44;175;127;389;171;564
314760;201509;1754;5847;1304;4728;223;935;266;825;489;1760
314770;201509;1162;3639;658;2238;77;308;96;233;173;541
314780;201509;298;758;202;629;53;189;85;258;138;447
314790;201509;12015;35024;8726;29200;3556;13581;1127;3208;4683;16789
314795;201509;1662;4735;1397;4320;132;529;1014;2979;1146;3508
314800;201509;11749;33874;8207;26695;2332;8240;1203;3658;3535;11898
314810;201509;12389;35948;9492;30789;2734;9830;2025;6468;4759;16298
314820;201509;941;2537;624;2017;164;590;212;649;376;1239
314830;201509;1664;5519;1445;5137;450;1767;563;1981;1013;3748
314840;201509;970;3489;789;3207;157;773;450;1764;607;2537
314850;201509;1948;5680;1556;4957;227;902;954;2888;1181;3790
314860;201509;3231;10761;2868;10094;687;2624;1344;4702;2031;7326
314870;201509;5472;17308;4746;16330;542;2318;3371;11515;3913;13833
314875;201509;1725;5719;1633;5579;316;1043;1180;4125;1496;5168
314880;201509;860;2357;723;2181;45;134;533;1683;578;1817
314890;201509;604;1798;403;1358;83;343;137;401;220;744
314900;201509;493;1496;393;1337;96;345;185;617;281;962
314910;201509;1649;5408;1332;4863;397;1661;406;1379;803;3040
314915;201509;2497;7877;2191;7388;188;777;1574;5154;1762;5931
314920;201509;552;1521;387;1267;44;174;207;623;251;797
314930;201509;4643;15449;3942;13846;1038;3959;973;3286;2011;7245
314940;201509;404;1171;370;1112;68;228;197;548;265;776
314950;201509;344;1033;261;894;51;186;72;231;123;417
314960;201509;753;2325;578;1966;147;562;170;510;317;1072
314970;201509;551;1849;451;1655;98;420;121;425;219;845
314980;201509;1645;5082;1376;4597;406;1533;157;452;563;1985
314990;201509;2662;8341;2006;6896;561;2226;384;1092;945;3318
314995;201509;1586;4824;1379;4499;144;569;889;2811;1033;3380
315000;201509;1067;3110;874;2793;114;415;533;1690;647;2105
315010;201509;455;1409;355;1197;89;353;117;341;206;694
315015;201509;2046;6257;1819;5988;251;854;1318;4526;1569;5380
315020;201509;821;2555;616;2097;102;409;280;889;382;1298
315030;201509;728;2184;587;1924;174;618;135;426;309;1044
315040;201509;855;2660;799;2552;153;501;485;1532;638;2033
315050;201509;1432;4087;1135;3615;250;920;467;1440;717;2360
315053;201509;1082;3207;949;2976;161;632;426;1331;587;1963
315057;201509;1720;5899;1496;5546;287;1068;811;3111;1098;4179
315060;201509;858;2796;626;2283;152;612;143;516;295;1128
315070;201509;769;2287;664;2127;178;621;314;948;492;1569
315080;201509;2875;9677;2533;8932;610;2344;1156;4008;1766;6352
315090;201509;778;2766;672;2517;167;701;172;629;339;1330
315100;201509;1214;4066;871;3244;210;905;210;688;420;1593
315110;201509;1373;4223;1178;3824;276;969;474;1503;750;2472
315120;201509;14289;33293;9652;27282;1521;4479;4964;14818;6485;19297
315130;201509;1427;4672;1275;4370;354;1372;400;1297;754;2669
315140;201509;2652;8491;2179;7475;496;1979;732;2271;1228;4250
315150;201509;4896;13139;3603;10945;734;2508;1299;3812;2033;6320
315160;201509;1239;3519;1020;3091;201;658;481;1391;682;2049
315170;201509;1464;4326;1195;3901;233;811;529;1865;762;2676
315180;201509;17173;48368;9834;32506;1819;6838;1727;5097;3546;11935
315190;201509;2120;5508;1773;4974;488;1402;880;2481;1368;3883
315200;201509;3938;13112;3199;11464;955;3751;745;2514;1700;6265
315210;201509;7803;22786;6131;19353;1381;4836;2093;6284;3474;11120
315213;201509;1089;3483;1023;3389;61;226;833;2751;894;2977
315217;201509;2504;8540;2081;7788;280;1242;1191;4415;1471;5657
315220;201509;10005;28689;8292;25980;2418;7451;3449;11282;5867;18733
315230;201509;2875;7520;2561;7150;201;313;2134;6454;2335;6767
315240;201509;3029;9390;2623;8746;635;2350;1381;4444;2016;6794
315250;201509;10061;30428;7307;25048;1852;7068;2136;7249;3988;14317
315260;201509;976;3039;686;2383;158;605;122;375;280;980
315270;201509;753;2407;571;2047;123;493;133;425;256;918
315280;201509;3130;8889;1990;6410;462;1628;415;1138;877;2766
315290;201509;1411;3926;1030;3300;333;1171;166;501;499;1672
315300;201509;548;1413;369;1189;170;574;126;405;296;979
315310;201509;1260;4040;1053;3653;136;576;665;2193;801;2769
315320;201509;790;2402;632;2191;116;465;301;1065;417;1530
315330;201509;696;2509;433;1791;113;521;44;193;157;714
315340;201509;3718;10609;3016;9508;650;2263;1210;3671;1860;5934
315350;201509;1803;5005;1331;4303;263;886;708;2356;971;3242
315360;201509;1674;5521;1330;4642;253;969;431;1391;684;2360
315370;201509;482;1434;410;1322;94;332;221;720;315;1052
315380;201509;202;691;158;587;41;178;33;94;74;272
315390;201509;1315;4417;974;3587;239;1007;181;592;420;1599
315400;201509;4349;13064;3528;11446;738;2655;1550;4903;2288;7558
315410;201509;2019;5354;1688;4886;217;743;1099;3178;1316;3921
315415;201509;1022;3364;929;3220;338;1193;424;1536;762;2729
315420;201509;1246;3947;922;3251;229;851;142;466;371;1317
315430;201509;3807;10319;2832;8662;738;2521;643;1866;1381;4387
315440;201509;902;2785;770;2562;142;534;337;1076;479;1610
315445;201509;2117;5903;1681;5231;190;675;1174;3597;1364;4272
315450;201509;2407;7622;2169;7256;472;1474;1245;4326;1717;5800
315460;201509;34476;112318;30091;102978;9919;36303;5995;19417;15914;55720
315470;201509;510;1511;412;1330;51;204;217;661;268;865
315480;201509;1766;5323;1090;3767;205;794;176;574;381;1368
315490;201509;3138;8415;2419;7421;345;1234;1040;3043;1385;4277
315500;201509;487;1470;317;1077;45;172;110;318;155;490
315510;201509;1430;4054;1200;3693;94;332;871;2632;965;2964
315520;201509;1108;3206;840;2795;111;417;533;1709;644;2126
315530;201509;566;1928;485;1735;189;723;128;422;317;1145
315540;201509;1096;3416;896;3025;173;714;315;1031;488;1745
315550;201509;1746;4901;1350;4343;401;1429;419;1289;820;2718
315560;201509;6508;21603;5860;20683;662;2621;3974;14114;4636;16735
315570;201509;2020;6322;1862;6057;341;1264;1001;3162;1342;4426
315580;201509;2552;7443;1966;6358;495;1846;535;1572;1030;3418
315590;201509;912;2660;802;2482;149;504;424;1286;573;1790
315600;201509;2504;8831;2017;7894;367;1526;1058;4272;1425;5798
315610;201509;996;2846;799;2438;161;635;297;743;458;1378
315620;201509;310;1086;293;1056;91;313;157;596;248;909
315630;201509;864;2732;722;2449;181;666;189;602;370;1268
315640;201509;564;1612;456;1431;95;358;207;590;302;948
315645;201509;876;2673;729;2363;263;933;175;528;438;1461
315650;201509;1918;5262;1534;4715;93;394;1139;3445;1232;3839
315660;201509;2565;6712;2133;6029;414;1195;1271;3571;1685;4766
315670;201509;10159;33674;8861;31113;2637;9970;2927;10023;5564;19993
315680;201509;3035;10137;2360;8731;830;3233;391;1429;1221;4662
315690;201509;3485;9838;2402;7877;621;2238;480;1590;1101;3828
315700;201509;7200;22414;6035;20063;1122;4173;2758;8738;3880;12911
315710;201509;1836;5365;1490;4800;139;553;945;2940;1084;3493
315720;201509;3485;10904;3069;10146;603;2327;1552;4866;2155;7193
315725;201509;1414;4539;1268;4310;346;1211;668;2319;1014;3530
315727;201509;625;1920;515;1689;109;397;206;631;315;1028
315730;201509;846;2575;761;2415;129;465;422;1305;551;1770
315733;201509;959;2903;850;2696;268;919;253;749;521;1668
315737;201509;1308;3961;991;3361;87;366;636;2188;723;2554
315740;201509;1017;3127;838;2765;157;631;416;1274;573;1905
315750;201509;1114;3460;1020;3287;80;301;737;2350;817;2651
315760;201509;1020;2758;976;2703;30;100;877;2412;907;2512
315765;201509;1394;4369;1256;4178;69;257;1024;3429;1093;3686
315770;201509;1579;5026;1362;4604;359;1369;397;1276;756;2645
315780;201509;22079;71736;19717;66484;5300;19106;5615;18605;10915;37711
315790;201509;3459;11611;3021;10710;328;1107;1997;7305;2325;8412
315800;201509;1516;5802;1185;4820;285;1301;204;779;489;2080
315810;201509;1390;3793;1182;3474;149;445;820;2385;969;2830
315820;201509;2593;8664;2268;8090;720;2673;940;3429;1660;6102
315830;201509;1202;4013;1018;3584;128;556;316;971;444;1527
315840;201509;834;2185;591;1760;95;314;177;494;272;808
315850;201509;1029;3686;992;3607;244;936;485;1723;729;2659
315860;201509;541;1845;400;1535;96;434;67;223;163;657
315870;201509;471;1384;388;1249;111;395;137;403;248;798
315880;201509;1204;3111;944;2777;207;741;333;894;540;1635
315890;201509;1517;5125;1313;4795;472;1833;541;1956;1013;3789
315895;201509;5141;15848;4509;14485;992;3522;1768;5387;2760;8909
315900;201509;741;2281;710;2225;87;358;533;1553;620;1911
315910;201509;529;1789;491;1723;162;623;265;897;427;1520
315920;201509;1575;4343;927;2965;202;703;186;488;388;1191
315930;201509;1105;3015;832;2529;211;715;210;598;421;1313
315935;201509;980;3221;875;2983;236;889;246;805;482;1694
315940;201509;645;2007;558;1830;136;527;249;765;385;1292
315950;201509;1160;3558;1045;3334;212;643;646;2109;858;2752
315960;201509;3257;10290;2230;8184;841;3545;98;222;939;3767
315970;201509;760;2053;577;1792;53;149;409;1333;462;1482
315980;201509;4090;9882;2471;7126;639;2110;605;1422;1244;3532
315990;201509;3964;11498;3336;10488;577;2185;1675;5084;2252;7269
316000;201509;537;1620;457;1513;149;590;171;544;320;1134
316010;201509;575;1939;465;1710;77;325;167;546;244;871
316020;201509;1122;3526;923;3203;143;569;539;1856;682;2425
316030;201509;3336;9683;2448;8099;264;980;1397;4730;1661;5710
316040;201509;3758;11765;2749;9575;439;1758;466;1275;905;3033
316045;201509;2090;6498;1902;6186;288;910;1313;4401;1601;5311
316050;201509;344;1086;268;959;51;198;118;394;169;592
316060;201509;740;2184;585;1954;83;377;337;1046;420;1423
316070;201509;5954;18773;5094;16839;1169;4350;2042;6371;3211;10721
316080;201509;741;2691;646;2443;143;617;88;321;231;938
316090;201509;585;1732;378;1269;73;277;93;271;166;548
316095;201509;1430;4564;1228;4200;242;843;721;2492;963;3335
316100;201509;2799;9229;2055;7327;495;2005;380;1220;875;3225
316105;201509;969;2703;716;2281;187;638;271;873;458;1511
316110;201509;12255;41795;10877;39370;1372;5384;7141;26471;8513;31855
316120;201509;1129;3663;906;3094;224;830;258;773;482;1603
316130;201509;1472;3303;891;2465;143;450;413;1067;556;1517
316140;201509;956;2796;735;2426;97;323;412;1382;509;1705
316150;201509;1457;4098;1305;3830;239;812;737;2121;976;2933
316160;201509;1239;3682;946;3104;155;592;437;1409;592;2001
316165;201509;936;2529;783;2306;158;545;416;1196;574;1741
316170;201509;1396;4002;1036;3365;166;611;430;1279;596;1890
316180;201509;1352;4226;931;3280;207;814;174;510;381;1324
316190;201509;2816;8730;1408;4928;265;973;197;586;462;1559
316200;201509;3957;12587;3043;10747;699;2861;821;2758;1520;5619
316210;201509;4813;15212;4041;13669;1580;5661;645;2039;2225;7700
316220;201509;781;2406;547;1936;116;481;68;245;184;726
316225;201509;1175;3301;994;2996;130;443;642;1874;772;2317
316230;201509;446;1232;339;1048;55;187;168;548;223;735
316240;201509;6515;19997;5648;18831;627;2123;4082;13721;4709;15844
316245;201509;3184;10992;2940;10575;223;1091;2256;7871;2479;8962
316250;201509;10030;29544;7977;25422;2230;7706;2144;6449;4374;14155
316255;201509;2523;7691;2210;7298;419;1486;1401;4608;1820;6094
316257;201509;1361;3786;1030;3180;199;697;390;1130;589;1827
316260;201509;1771;5046;1372;4460;108;402;799;2731;907;3133
316265;201509;1320;3677;958;2955;105;406;556;1638;661;2044
316270;201509;4170;13822;3804;13055;987;3671;1563;5205;2550;8876
316280;201509;3270;10558;2922;9887;478;1825;1590;5302;2068;7127
316290;201509;3302;10297;2785;9286;549;2159;1146;3600;1695;5759
316292;201509;3374;10797;3003;10146;647;2446;1549;4968;2196;7414
316294;201509;891;2837;625;2243;129;548;50;165;179;713
316295;201509;1766;5959;1615;5655;250;1074;970;3226;1220;4300
316300;201509;1000;3083;838;2811;75;273;545;1847;620;2120
316310;201509;721;2059;470;1578;88;345;140;440;228;785
316320;201509;611;1944;483;1720;87;374;95;308;182;682
316330;201509;939;2870;723;2374;91;331;446;1425;537;1756
316340;201509;968;3098;791;2728;188;775;321;1014;509;1789
316350;201509;1316;4180;1172;3933;195;674;660;2274;855;2948
316360;201509;726;1900;569;1664;66;205;402;1182;468;1387
316370;201509;4403;14264;3762;12908;1038;3904;621;2105;1659;6009
316380;201509;1574;4215;1246;3754;105;353;867;2616;972;2969
316390;201509;902;2643;741;2368;193;678;307;994;500;1672
316400;201509;1256;3962;997;3468;212;794;404;1354;616;2148
316410;201509;1071;3532;984;3397;222;808;585;2011;807;2819
316420;201509;1852;6114;1657;5848;157;698;1134;3876;1291;4574
316430;201509;935;2842;688;2336;170;630;171;507;341;1137
316440;201509;677;2210;555;2006;201;844;117;401;318;1245
316443;201509;697;2046;567;1800;131;469;209;618;340;1087
316447;201509;1599;4823;1445;4608;99;339;1236;3952;1335;4291
316450;201509;2131;7170;1817;6547;257;1036;1163;4222;1420;5258
316460;201509;732;2250;660;2121;163;581;363;1118;526;1699
316470;201509;7384;23724;5767;20219;1444;5859;1628;5388;3072;11247
316480;201509;195;658;170;604;38;145;56;189;94;334
316490;201509;293;906;252;804;51;170;100;290;151;460
316500;201509;1124;4026;757;2903;137;565;36;124;173;689
316510;201509;795;2903;702;2708;229;942;176;642;405;1584
316520;201509;1140;3422;925;3091;168;621;319;948;487;1569
316530;201509;1089;3499;902;3118;200;861;324;929;524;1790
316540;201509;883;2810;769;2617;121;505;265;851;386;1356
316550;201509;1165;3881;1083;3736;219;873;654;2226;873;3099
316553;201509;1846;6403;1436;5419;409;1700;324;1192;733;2892
316555;201509;2822;9713;2491;9300;185;777;1811;6821;1996;7598
316556;201509;604;1604;479;1392;53;189;316;855;369;1044
316557;201509;750;2713;712;2653;281;1109;154;525;435;1634
316560;201509;334;1150;281;1033;66;303;66;203;132;506
316570;201509;1268;4019;1097;3667;139;505;565;1890;704;2395
316580;201509;293;850;193;636;49;188;52;157;101;345
316590;201509;1494;4054;1061;3323;276;911;445;1285;721;2196
316600;201509;1040;3351;911;3088;283;1026;279;908;562;1934
316610;201509;575;2077;500;1923;101;445;298;1128;399;1573
316620;201509;2125;6526;1805;5932;338;1308;1012;3218;1350;4526
316630;201509;1456;4807;1234;4328;503;1859;322;1132;825;2991
316640;201509;182;574;158;523;33;140;69;192;102;332
316650;201509;902;3301;790;3118;133;539;474;1939;607;2478
316660;201509;202;525;100;305;12;50;28;65;40;115
316670;201509;1829;5263;1470;4615;570;1951;286;796;856;2747
316680;201509;1911;5162;1536;4628;222;700;1059;3187;1281;3887
316690;201509;1180;3922;1040;3613;296;1168;336;1120;632;2288
316695;201509;1097;3452;940;3142;105;382;579;1930;684;2312
316700;201509;346;1079;308;1008;46;190;182;544;228;734
316710;201509;3145;11702;2706;10727;939;3954;667;2797;1606;6751
316720;201509;15852;50633;12781;43874;3705;13572;2700;8869;6405;22441
316730;201509;366;1126;309;1007;72;265;144;427;216;692
316740;201509;669;2238;592;2096;161;664;245;823;406;1487
316750;201509;415;1382;349;1231;67;275;112;350;179;625
316760;201509;3382;11333;2913;10718;1586;5943;795;3037;2381;8980
316770;201509;1235;3520;1122;3374;120;442;841;2508;961;2950
316780;201509;577;1922;504;1777;141;566;112;344;253;910
316790;201509;862;2455;623;2039;154;555;202;651;356;1206
316800;201509;5291;17346;4701;16199;907;3563;2327;7550;3234;11113
316805;201509;832;2187;786;2128;76;199;660;1851;736;2050
316810;201509;614;1871;508;1653;145;517;195;596;340;1113
316820;201509;393;1017;223;714;45;171;40;110;85;281
316830;201509;598;2036;566;1973;165;631;236;795;401;1426
316840;201509;2903;8838;2531;8128;610;2243;1047;3165;1657;5408
316850;201509;2079;6138;1756;5570;265;957;954;2998;1219;3955
316860;201509;17614;55463;15006;50491;3484;13536;6280;20072;9764;33608
316870;201509;5823;18727;4643;15940;1360;5120;746;2418;2106;7538
316880;201509;790;2491;715;2359;199;758;254;784;453;1542
316890;201509;1292;3178;1029;2837;314;1014;534;1363;848;2377
316900;201509;2521;7592;1984;6445;466;1690;570;1633;1036;3323
316905;201509;458;1526;395;1386;128;478;131;451;259;929
316910;201509;787;2519;573;2077;165;641;108;393;273;1034
316920;201509;1537;4296;1153;3756;323;1193;391;1204;714;2397
316930;201509;8668;29202;6722;24720;1486;6035;936;3085;2422;9120
316935;201509;5085;14770;3267;11033;847;3209;567;1707;1414;4916
316940;201509;7031;22968;5671;19986;1314;4958;1201;4048;2515;9006
316950;201509;1474;4229;1269;3936;125;468;887;2706;1012;3174
316960;201509;4968;12469;3880;11000;725;2239;2130;5927;2855;8166
316970;201509;3252;10337;3047;9998;742;2803;1125;3390;1867;6193
316980;201509;1039;3131;744;2577;251;970;149;506;400;1476
316990;201509;9600;30737;7974;26879;2523;9235;715;2271;3238;11506
317000;201509;2747;9403;2644;9287;282;922;1984;7796;2266;8718
317005;201509;2580;7911;2278;7453;452;1507;1293;4271;1745;5778
317010;201509;30893;76806;18476;56791;4594;15876;3946;12563;8540;28439
317020;201509;58357;162555;34587;112801;7387;26444;7132;21202;14519;47646
317030;201509;765;2184;625;1961;73;287;380;1152;453;1439
317040;201509;10271;29784;8186;25989;2141;7355;3075;9669;5216;17024
317043;201509;741;2037;634;1896;86;245;400;1216;486;1461
317047;201509;1145;3013;825;2478;124;412;391;1161;515;1573
317050;201509;1516;5170;1169;4318;236;954;462;1590;698;2544
317052;201509;2326;7470;2114;7139;187;741;1536;5112;1723;5853
317057;201509;1747;4854;1313;4086;133;501;739;2220;872;2721
317060;201509;405;1169;279;881;57;215;86;227;143;442
317065;201509;1226;4067;1117;3884;125;548;805;2713;930;3261
317070;201509;9759;30164;6414;22453;1367;5385;1001;3340;2368;8725
317075;201509;1073;3244;866;2813;222;781;245;726;467;1507
317080;201509;6011;16562;5078;14965;1495;4644;1629;4610;3124;9254
317090;201509;4882;16167;4517;15561;661;2280;3046;10696;3707;12976
317100;201509;3028;8358;2308;7129;715;2417;792;2314;1507;4731
317103;201509;2012;6908;1680;6226;275;1290;803;2854;1078;4144
317107;201509;1317;4010;1119;3596;192;738;677;2036;869;2774
317110;201509;669;1687;388;1192;75;281;149;447;224;728
317115;201509;1152;3629;982;3274;133;447;639;2162;772;2609
317120;201509;11037;36130;8826;30887;2150;8318;3110;10509;5260;18827
317130;201509;7544;22575;6319;20322;1332;4843;2747;8645;4079;13488
317140;201509;567;1859;539;1813;75;280;360;1217;435;1497
317150;201509;980;2724;845;2569;99;352;595;1762;694;2114
317160;201509;3490;9259;2659;8153;236;778;1824;5568;2060;6346
317170;201509;1819;5034;1480;4482;78;316;932;2648;1010;2964
317180;201509;1807;5991;1422;5140;388;1525;371;1284;759;2809
317190;201509;1389;3958;1114;3571;127;447;749;2364;876;2811
317200;201509;4433;13822;3799;12537;974;3546;1241;3910;2215;7456
317210;201509;1042;3122;856;2861;168;681;452;1477;620;2158
317220;201509;298;1032;282;1003;83;325;124;422;207;747
320010;201509;5045;15847;4363;14368;804;2795;2225;7246;3029;10041
320013;201509;1934;5794;1379;4635;211;725;617;2124;828;2849
320016;201509;3174;8981;2742;8329;382;1117;1889;5768;2271;6885
320020;201509;3841;11904;3243;10661;948;3386;1092;3528;2040;6914
320030;201509;1649;5285;1308;4520;401;1457;413;1379;814;2836
320035;201509;1765;5221;1540;4868;443;1589;628;1823;1071;3412
320040;201509;3312;10726;2629;9170;605;2311;754;2522;1359;4833
320050;201509;1782;4798;1501;4278;339;1039;657;1749;996;2788
320060;201509;12033;37914;9081;31056;2173;8134;2622;8384;4795;16518
320070;201509;1470;4725;1178;4037;269;1041;305;910;574;1951
320080;201509;5405;15313;4026;12483;1112;3625;979;2972;2091;6597
320090;201509;8250;23994;6445;20305;1743;5843;2452;7360;4195;13203
320100;201509;2965;9038;2360;7802;613;2160;869;2760;1482;4920
320110;201509;1282;3798;1122;3482;258;822;387;1189;645;2011
320115;201509;1820;6424;1639;6079;841;3281;435;1615;1276;4896
320120;201509;16228;49472;12498;42057;3342;12294;3602;12039;6944;24333
320130;201509;36385;116523;32764;109009;7123;26445;15271;48882;22394;75327
320140;201509;4034;12667;2802;9764;673;2606;300;954;973;3560
320150;201509;16666;45774;11652;36014;2837;9515;1836;5352;4673;14867
320160;201509;4784;15107;4138;13722;1061;3994;1399;4176;2460;8170
320170;201509;1747;5567;1405;4796;373;1354;526;1783;899;3137
320180;201509;806;2638;697;2450;280;1027;185;659;465;1686
320190;201509;3785;12864;2954;10765;851;3299;653;2251;1504;5550
320200;201509;1077;3323;902;3007;231;828;339;1160;570;1988
320210;201509;4915;13608;4141;12136;897;2948;1967;5369;2864;8317
320220;201509;2583;7945;2085;6961;544;1977;796;2678;1340;4655
320225;201509;1427;4851;1121;4094;381;1490;205;755;586;2245
320230;201509;4228;13730;3659;12740;1189;4453;1263;4429;2452;8882
320240;201509;12172;35837;9407;30635;2586;9160;2378;7592;4964;16752
320245;201509;3672;12445;3368;11694;1121;4164;972;3206;2093;7370
320250;201509;1822;5527;1284;4283;345;1337;243;672;588;2009
320255;201509;1810;6039;1554;5590;622;2439;554;2050;1176;4489
320260;201509;1052;3228;787;2589;209;746;192;520;401;1266
320265;201509;2387;7445;2077;7017;395;1383;1294;4494;1689;5877
320270;201509;2734;8143;2022;6718;478;1747;808;2642;1286;4389
320280;201509;6827;20587;5967;18871;1374;4776;2498;7478;3872;12254
320290;201509;1469;4781;1065;3747;352;1316;191;625;543;1941
320300;201509;4303;14253;3790;13107;1179;4335;917;3099;2096;7434
320305;201509;4489;14395;3881;12989;930;3416;1661;5272;2591;8688
320310;201509;1982;5881;1674;5252;430;1433;668;2020;1098;3453
320313;201509;2244;6554;1513;4851;368;1403;273;736;641;2139
320316;201509;1751;5283;1426;4608;454;1548;530;1629;984;3177
320320;201509;19863;61272;15950;53753;4437;16447;5331;17376;9768;33823
320330;201509;3070;9055;2608;8272;639;1997;1276;4251;1915;6248
320332;201509;4913;16348;4249;15048;1513;5675;1272;4534;2785;10209
320334;201509;1916;6163;1339;4842;398;1606;227;753;625;2359
320335;201509;2355;6912;1480;4907;379;1410;220;598;599;2008
320340;201509;5925;16042;4784;14095;1090;3475;2020;5982;3110;9457
320350;201509;5145;13743;3821;11300;873;2784;1468;4240;2341;7024
320360;201509;1754;4610;1273;3657;230;729;531;1389;761;2118
320370;201509;3214;10366;2587;8955;745;2664;847;2875;1592;5539
320380;201509;2375;6935;2078;6397;345;1204;1258;3770;1603;4974
320390;201509;7730;23018;6138;19618;1763;6152;1641;4875;3404;11027
320400;201509;3714;11191;3251;10383;973;3493;1185;3443;2158;6936
320405;201509;4026;11764;3531;10990;902;3016;1719;5160;2621;8176
320410;201509;5594;14534;4069;12532;1019;3407;1829;5532;2848;8939
320420;201509;1910;5811;1415;4901;425;1619;285;975;710;2594
320425;201509;1955;5236;1662;4740;232;718;998;2765;1230;3483
320430;201509;2333;6570;2022;5941;426;1345;1073;3033;1499;4378
320435;201509;2820;9273;2333;8260;1065;3932;637;2376;1702;6308
320440;201509;1151;3800;996;3381;242;935;347;1085;589;2020
320450;201509;2040;6345;1649;5524;465;1740;689;2187;1154;3927
320455;201509;4265;14065;3059;11039;876;3376;759;2663;1635;6039
320460;201509;2787;8941;2178;7563;566;2152;667;2171;1233;4323
320465;201509;1627;5061;1234;4154;247;912;516;1673;763;2585
320470;201509;4444;13345;2922;9821;798;2952;475;1417;1273;4369
320480;201509;1917;5796;1638;5263;414;1465;593;1829;1007;3294
320490;201509;15783;48554;12951;43049;3994;14509;3657;12054;7651;26563
320495;201509;1254;3803;880;2970;314;1108;108;384;422;1492
320500;201509;46211;139612;39681;127404;9997;34855;18154;56730;28151;91585
320501;201509;4204;13132;3611;12198;1157;4429;1326;4228;2483;8657
320503;201509;1927;6466;1545;5619;594;2367;401;1251;995;3618
320506;201509;3854;12014;2609;8910;818;2980;205;609;1023;3589
320510;201509;8143;25381;6899;22862;1769;6285;3003;9750;4772;16035
320515;201509;1973;5602;1594;4789;447;1383;367;1024;814;2407
320517;201509;2177;6983;1741;6074;603;2318;367;1156;970;3474
320520;201509;36414;109287;29101;95243;7942;28559;10398;33454;18340;62013
320530;201509;27162;82138;22303;72491;4822;18155;10367;31297;15189;49452
330010;201509;19858;60471;17728;56236;3508;12186;9842;30425;13350;42611
330015;201509;1711;4711;1462;4245;254;865;614;1708;868;2573
330020;201509;17042;50090;15420;47408;3072;10371;8868;26627;11940;36998
330022;201509;1795;5410;1516;4939;289;1090;781;2434;1070;3524
330023;201509;3265;10098;2865;9377;791;2830;965;2981;1756;5811
330025;201509;4292;11619;3393;10153;808;2651;1743;5085;2551;7736
330030;201509;7861;26242;6867;24180;1526;5933;3191;10742;4717;16675
330040;201509;12044;34913;10318;31765;2389;7862;5021;14915;7410;22777
330045;201509;67700;187966;59179;175342;7717;24580;39990;116515;47707;141095
330050;201509;2572;7970;2251;7314;663;2391;669;1979;1332;4370
330060;201509;5712;16540;4946;15392;1184;4140;2470;7594;3654;11734
330070;201509;23028;69204;20209;64174;4557;15572;9223;29063;13780;44635
330080;201509;7894;22530;7363;21704;960;2795;5128;15352;6088;18147
330090;201509;2666;7281;2411;6849;466;1496;1314;3609;1780;5105
330093;201509;2049;6051;1677;5329;399;1327;607;1940;1006;3267
330095;201509;1030;3488;894;3178;250;1020;197;640;447;1660
330100;201509;54451;173798;49240;164736;8856;33318;25992;86642;34848;119960
330110;201509;2350;7452;2082;6940;531;1900;642;2078;1173;3978
330115;201509;2047;5853;1790;5444;340;1162;930;2737;1270;3899
330120;201509;2478;6974;2169;6508;539;1804;1087;3110;1626;4914
330130;201509;3524;11315;3080;10491;812;3032;1380;4579;2192;7611
330140;201509;2965;9238;2683;8804;634;2262;1308;4275;1942;6537
330150;201509;2390;6968;1802;5763;409;1446;432;1334;841;2780
330160;201509;1088;3592;985;3403;289;1126;430;1408;719;2534
330170;201509;101864;304963;92876;290357;15642;52077;57550;178544;73192;230621
330180;201509;2006;5893;1666;5254;159;637;1012;2988;1171;3625
330185;201509;7730;24235;6721;22210;1535;5545;3456;11149;4991;16694
330187;201509;3882;11053;3306;10068;488;1665;2175;6509;2663;8174
330190;201509;25695;73199;23759;70054;4628;14410;15130;44238;19758;58648
330200;201509;13761;43564;12147;40616;3056;10550;5824;19700;8880;30250
330205;201509;2244;6086;1927;5540;373;1201;1035;2858;1408;4059
330210;201509;4175;11159;3152;9226;882;2730;715;2049;1597;4779
330220;201509;10118;30759;8752;27821;2375;8196;2340;6815;4715;15011
330225;201509;3959;12114;3575;11451;460;1740;2271;7214;2731;8954
330227;201509;17617;50386;15691;47480;4061;12636;8002;24470;12063;37106
330230;201509;1394;4155;1256;3912;317;1119;526;1531;843;2650
330240;201509;16753;52045;14398;47238;4945;17565;3167;9767;8112;27332
330245;201509;1268;3936;993;3388;257;969;185;590;442;1559
330250;201509;35808;104337;32363;98406;9753;29982;13245;41152;22998;71134
330260;201509;3665;11471;3169;10427;637;2322;1339;4142;1976;6464
330270;201509;15408;39980;11426;34178;3033;9869;4153;12279;7186;22148
330280;201509;2124;6354;1742;5581;308;1091;786;2316;1094;3407
330285;201509;18314;52533;16442;49744;2841;9271;10201;30591;13042;39862
330290;201509;3570;9934;3117;9253;526;1793;1841;5203;2367;6996
330300;201509;3339;10791;3035;10221;449;1751;1796;5875;2245;7626
330310;201509;2363;6730;2032;6162;351;1137;1086;3217;1437;4354
330320;201509;13131;39128;12203;37695;1859;6286;8719;26662;10578;32948
330330;201509;27194;75795;23982;70594;4123;13756;14814;41991;18937;55747
330340;201509;14388;42114;11066;35689;2932;10017;3261;10349;6193;20366
330350;201509;85863;258205;79663;248819;11868;38667;56191;175673;68059;214340
330360;201509;5620;16945;5412;16642;356;1225;4548;13895;4904;15120
330370;201509;3446;12210;3105;11433;1066;4110;1013;3727;2079;7837
330380;201509;4907;15755;4123;14208;927;3528;1739;5780;2666;9308
330385;201509;4088;14058;3714;13303;1171;4488;1360;4807;2531;9295
330390;201509;23146;75555;20339;69699;4891;18348;9020;30029;13911;48377
330395;201509;3009;8832;2701;8292;281;1018;1810;5385;2091;6403
330400;201509;2481;7907;2215;7424;337;1373;1268;3922;1605;5295
330410;201509;2803;8666;2326;7730;475;1709;1100;3586;1575;5295
330411;201509;2321;7208;1983;6474;249;989;1131;3500;1380;4489
330412;201509;1333;4529;1087;4022;256;1105;415;1402;671;2507
330414;201509;24802;69631;21467;64877;4138;12601;12914;39277;17052;51878
330415;201509;3563;10835;3050;9879;788;2657;1152;3730;1940;6387
330420;201509;9372;27388;6250;21273;1514;5557;1071;3506;2585;9063
330430;201509;7564;22276;6674;20578;1414;4730;3179;9532;4593;14262
330440;201509;1789;5921;1497;5265;460;1793;301;908;761;2701
330450;201509;1404;4655;1254;4383;283;1179;627;2101;910;3280
330452;201509;13409;39387;10383;33369;2708;9514;3670;11244;6378;20758
330455;201509;481716;1341880;396992;1205198;96172;309416;190609;571662;286781;881078
330460;201509;1224;3948;1090;3706;230;894;504;1661;734;2555
330470;201509;4333;13165;3818;12196;954;3353;1663;5140;2617;8493
330475;201509;7847;24323;6871;22602;1955;7059;2616;8352;4571;15411
330480;201509;5828;17192;5306;16409;1127;3774;2863;8688;3990;12462
330490;201509;106640;283812;95762;267708;9693;28086;72165;202261;81858;230347
330500;201509;5473;16941;5199;16420;618;2175;3660;11403;4278;13578
330510;201509;37812;116103;33886;109616;10387;34098;15241;50132;25628;84230
330513;201509;1513;4528;1362;4248;418;1307;498;1583;916;2890
330515;201509;3015;9310;2630;8570;810;2674;809;2593;1619;5267
330520;201509;11558;34314;10191;31846;2172;7194;4975;15311;7147;22505
330530;201509;1517;4535;1329;4169;341;1134;515;1575;856;2709
330540;201509;3060;8989;2544;8073;609;2117;1068;3244;1677;5361
330550;201509;7992;26669;6964;24657;3012;11121;1180;4157;4192;15278
330555;201509;10364;30571;9144;28768;1756;5622;5518;17728;7274;23350
330560;201509;4174;12612;3788;11896;780;2721;1932;5819;2712;8540
330570;201509;3630;10502;3074;9554;811;2624;1470;4577;2281;7201
330575;201509;5194;15022;4614;13977;795;2707;2864;8306;3659;11013
330580;201509;14578;45655;12281;40850;3272;11473;4849;16154;8121;27627
330590;201509;1652;5028;1526;4808;316;1074;910;2812;1226;3886
330600;201509;10743;30534;8473;26775;1217;4407;4570;14045;5787;18452
330610;201509;8959;28063;8107;26472;1497;5557;4504;14353;6001;19910
330615;201509;1675;5849;1504;5459;651;2506;336;1232;987;3738
330620;201509;3603;12369;3208;11618;1102;4350;799;2923;1901;7273
330630;201509;22232;65777;18079;58186;3402;12450;9328;28667;12730;41117
350010;201509;2073;6135;1388;4689;336;1242;237;683;573;1925
350020;201509;465;1209;313;916;55;177;168;473;223;650
350030;201509;4393;13667;3407;11605;1214;4536;733;2259;1947;6795
350040;201509;493;1680;375;1400;86;358;99;318;185;676
350050;201509;1050;3134;822;2718;195;751;287;844;482;1595
350055;201509;654;1938;568;1795;133;456;304;927;437;1383
350060;201509;105;305;82;269;24;93;35;106;59;199
350070;201509;3415;10494;2207;7772;469;1807;399;1223;868;3030
350075;201509;478;1585;375;1401;110;438;94;323;204;761
350080;201509;540;1498;373;1172;69;241;148;448;217;689
350090;201509;579;1539;393;1211;78;254;135;396;213;650
350100;201509;1824;5713;1285;4530;285;1107;354;1154;639;2261
350110;201509;459;1350;341;1085;50;188;166;502;216;690
350115;201509;1273;3913;1117;3568;226;854;565;1625;791;2479
350120;201509;577;1502;285;872;56;183;44;125;100;308
350130;201509;3239;9499;2860;8768;469;1641;1511;4324;1980;5965
350140;201509;584;1890;503;1741;91;355;228;761;319;1116
350150;201509;382;1287;338;1191;121;455;87;301;208;756
350160;201509;6841;20813;4959;16733;1283;4857;1887;5762;3170;10619
350170;201509;1734;5935;1474;5281;399;1560;347;1141;746;2701
350180;201509;1111;3022;760;2264;156;478;338;971;494;1449
350190;201509;3123;9687;2550;8523;538;2157;1259;3764;1797;5921
350200;201509;348;1113;293;1010;50;192;147;503;197;695
350210;201509;5173;13680;3814;11418;1071;3565;1514;4310;2585;7875
350220;201509;2550;8010;2225;7361;573;2223;785;2331;1358;4554
350230;201509;616;2033;560;1933;130;504;239;804;369;1308
350240;201509;406;1282;359;1172;80;270;203;646;283;916
350250;201509;2116;7671;1986;7404;714;2845;686;2512;1400;5357
350260;201509;947;2516;665;2015;117;390;291;830;408;1220
350270;201509;5041;15362;4201;13493;809;2752;1767;5452;2576;8204
350275;201509;1967;6545;1755;6154;482;1818;636;2097;1118;3915
350280;201509;21713;53671;12997;38427;2865;8974;2733;7924;5598;16898
350290;201509;1680;5454;1298;4645;291;1158;320;1058;611;2216
350300;201509;350;1046;306;970;51;164;183;575;234;739
350310;201509;868;2842;748;2554;117;455;343;1128;460;1583
350315;201509;528;1651;408;1392;70;289;109;340;179;629
350320;201509;11393;35290;9799;32126;2721;9533;1479;4919;4200;14452
350330;201509;13518;38264;8781;27192;1859;5771;2865;8410;4724;14181
350335;201509;366;1132;317;1033;37;121;192;627;229;748
350340;201509;1127;3339;772;2605;152;585;245;768;397;1353
350350;201509;729;2257;617;2060;113;446;235;756;348;1202
350360;201509;785;2654;659;2384;181;688;241;890;422;1578
350370;201509;701;2091;494;1629;90;328;97;278;187;606
350380;201509;3329;10262;2541;8868;823;3166;614;1905;1437;5071
350390;201509;8579;26890;7589;25007;2246;7735;2941;9478;5187;17213
350395;201509;349;980;178;612;25;96;36;120;61;216
350400;201509;7884;22339;6221;19274;1447;5009;2459;7205;3906;12214
350410;201509;7901;26444;5980;22261;1664;6870;1029;3533;2693;10403
350420;201509;549;1601;377;1289;71;296;35;90;106;386
350430;201509;735;2271;598;2013;115;445;287;914;402;1359
350440;201509;1216;3793;1092;3542;282;936;511;1630;793;2566
350450;201509;7621;22658;5765;18887;1401;4939;1391;4257;2792;9196
350460;201509;1344;3761;883;2786;183;647;269;753;452;1400
350470;201509;247;668;200;588;39;140;113;304;152;444
350480;201509;798;2431;535;1837;78;297;81;228;159;525
350490;201509;1775;5290;1512;4886;367;1325;606;1806;973;3131
350500;201509;573;1663;489;1517;106;356;227;683;333;1039
350510;201509;1017;3062;783;2546;136;524;319;941;455;1465
350520;201509;1196;4399;918;3682;242;1070;159;580;401;1650
350530;201509;2386;6983;1934;6050;562;1870;562;1588;1124;3458
350535;201509;1330;4146;1230;3948;136;552;866;2634;1002;3186
350540;201509;1921;5325;1505;4569;410;1317;510;1519;920;2836
350550;201509;11610;30799;7782;24331;1647;5785;2749;8169;4396;13954
350560;201509;3387;11083;3031;10328;462;1696;1602;5486;2064;7182
350570;201509;18079;60450;16101;56009;4749;17747;5819;19259;10568;37006
350580;201509;1658;5117;1162;3977;244;926;160;458;404;1384
350590;201509;4105;12658;3054;10467;812;3120;971;2994;1783;6114
350600;201509;40166;98485;26209;74707;4273;13204;12329;33251;16602;46455
350610;201509;7647;21856;5818;18592;1159;4170;2582;7945;3741;12115
350620;201509;393;1102;297;952;60;232;138;407;198;639
350630;201509;1557;4633;1186;3931;278;1080;312;906;590;1986
350635;201509;5823;17401;4381;14725;1074;3886;1664;5495;2738;9381
350640;201509;733;2281;491;1670;89;337;120;372;209;709
350650;201509;7166;21797;3983;13954;971;3757;412;1339;1383;5096
350660;201509;4231;12706;3603;11638;760;2669;1900;6005;2660;8674
350670;201509;1715;5271;1579;5004;311;1057;941;2887;1252;3944
350680;201509;1126;3409;870;2881;197;760;363;1163;560;1923
350690;201509;871;2827;695;2463;164;649;216;685;380;1334
350700;201509;4013;12045;2640;9363;803;3064;640;1987;1443;5051
350710;201509;2474;7745;2197;7264;338;1226;1354;4416;1692;5642
350715;201509;862;2605;750;2399;229;803;249;697;478;1500
350720;201509;135;393;121;370;38;123;44;127;82;250
350730;201509;390;1462;367;1401;101;435;137;502;238;937
350740;201509;1918;5902;1458;4786;267;952;537;1631;804;2583
350745;201509;361;1116;269;893;45;168;123;364;168;532
350750;201509;10054;30104;7628;25170;1817;6598;1670;5002;3487;11600
350760;201509;12947;37969;10278;33049;2574;9151;3595;10681;6169;19832
350770;201509;728;2066;480;1567;71;272;219;678;290;950
350775;201509;548;1494;455;1347;70;250;269;771;339;1021
350780;201509;1994;6037;1475;4957;433;1619;198;617;631;2236
350790;201509;1985;6176;1463;5097;379;1430;318;969;697;2399
350800;201509;2992;9884;2804;9568;468;1834;1744;5811;2212;7645
350810;201509;2022;5662;1647;5102;493;1654;607;1850;1100;3504
350820;201509;558;1497;401;1185;70;251;177;470;247;721
350830;201509;874;2701;587;2013;91;332;142;389;233;721
350840;201509;2455;8599;1986;7422;579;2382;355;1101;934;3483
350850;201509;6106;20193;5005;17714;1593;5959;1125;3851;2718;9810
350860;201509;3124;9711;2982;9496;252;1019;2326;7296;2578;8315
350870;201509;2595;8278;2184;7632;576;2281;1212;4215;1788;6496
350880;201509;1286;4212;1051;3711;255;979;242;816;497;1795
350890;201509;665;1883;427;1368;67;250;101;252;168;502
350900;201509;3831;12503;2895;10319;741;2909;416;1318;1157;4227
350910;201509;830;2460;720;2233;242;785;253;743;495;1528
350920;201509;9838;28272;8792;26384;1175;3910;5878;16983;7053;20893
350925;201509;4780;14559;3929;12804;989;3434;1504;4478;2493;7912
350930;201509;1587;4292;1269;3725;141;460;826;2335;967;2795
350940;201509;1926;6292;1755;6027;323;1323;1076;3572;1399;4895
350945;201509;858;2778;731;2514;129;534;384;1249;513;1783
350950;201509;67142;203790;53403;175078;12842;46163;21454;66793;34296;112956
350960;201509;4275;14223;3583;12745;625;2529;1998;6816;2623;9345
350970;201509;4334;14908;3610;13153;1147;4539;800;2546;1947;7085
350980;201509;594;1935;533;1830;223;824;183;617;406;1441
350990;201509;1722;5857;1457;5329;453;1787;383;1336;836;3123
350995;201509;775;2674;739;2599;118;533;450;1492;568;2025
351000;201509;3222;9544;2654;8446;365;1313;1322;3967;1687;5280
351010;201509;352;994;222;715;55;198;77;250;132;448
351015;201509;856;2834;729;2591;181;722;305;1032;486;1754
351020;201509;7901;24744;6835;23047;1716;6110;3071;10438;4787;16548
351030;201509;1603;5726;1420;5264;326;1403;449;1527;775;2930
351040;201509;3293;9979;2980;9436;495;1811;1884;5707;2379;7518
351050;201509;13119;38067;9122;30609;2410;8883;2506;8212;4916;17095
351060;201509;32668;96690;26413;84996;6106;21526;11304;35203;17410;56729
351070;201509;1584;4399;1056;3421;301;1079;151;401;452;1480
351080;201509;2633;7595;2008;6800;506;1899;877;2822;1383;4721
351090;201509;385;1289;290;1078;59;249;60;215;119;464
351100;201509;2028;6157;1602;5302;489;1669;491;1694;980;3363
351110;201509;7441;18447;3873;12340;860;3107;869;2486;1729;5593
351120;201509;623;1790;498;1533;56;206;259;698;315;904
351130;201509;1020;2834;545;1843;89;344;104;317;193;661
351140;201509;1640;5589;1424;5101;429;1676;375;1241;804;2917
351150;201509;1705;5853;1255;4664;224;923;272;857;496;1780
351160;201509;1305;4407;1136;4011;299;1195;392;1272;691;2467
351170;201509;1465;4632;1163;3966;232;872;512;1633;744;2505
351190;201509;734;2318;582;1929;108;361;133;411;241;772
351200;201509;2116;6193;1731;5400;337;1196;616;1723;953;2919
351210;201509;1042;3090;786;2559;175;648;270;782;445;1430
351220;201509;3269;10864;2881;10055;587;2260;1360;4654;1947;6914
351230;201509;1736;5385;1465;4892;297;1196;779;2469;1076;3665
351240;201509;1078;3417;784;2752;204;782;178;528;382;1310
351250;201509;909;2589;613;1959;127;438;217;644;344;1082
351260;201509;911;2655;779;2375;174;567;333;949;507;1516
351270;201509;356;1213;319;1139;67;285;145;463;212;748
351280;201509;5108;14942;3766;12057;838;2868;1329;3947;2167;6815
351290;201509;992;2792;736;2290;170;548;291;871;461;1419
351300;201509;12232;40230;9044;33138;2300;9308;2793;9953;5093;19261
351310;201509;3191;9639;2545;8432;484;1882;1203;3655;1687;5537
351320;201509;896;2983;764;2680;171;700;232;698;403;1398
351330;201509;290;805;241;723;98;300;59;166;157;466
351340;201509;5741;19072;4925;17399;1392;5218;1902;6687;3294;11905
351350;201509;7234;23240;6170;20945;1812;6438;1928;6117;3740;12555
351360;201509;4111;12726;3733;11973;921;3274;1352;3993;2273;7267
351370;201509;2241;6857;1753;5834;390;1461;645;1957;1035;3418
351380;201509;36486;107026;32803;99943;6467;21464;14815;43778;21282;65242
351385;201509;197;609;183;583;45;153;86;257;131;410
351390;201509;1122;3629;938;3248;254;1001;355;1087;609;2088
351400;201509;876;2909;823;2778;324;1155;261;860;585;2015
351410;201509;2666;7962;2313;7307;394;1322;1321;4042;1715;5364
351420;201509;354;996;228;746;48;163;61;188;109;351
351430;201509;844;2599;767;2469;84;282;543;1738;627;2020
351440;201509;3702;10796;2808;8821;680;2203;542;1462;1222;3665
351450;201509;1659;4610;1370;4167;347;1089;583;1859;930;2948
351460;201509;725;2165;605;1961;295;993;172;529;467;1522
351470;201509;1035;3050;891;2769;214;758;360;1054;574;1812
351480;201509;2758;8940;2505;8512;447;1872;1345;4346;1792;6218
351490;201509;1773;5807;1560;5345;214;892;919;2977;1133;3869
351492;201509;202;632;155;523;19;78;84;270;103;348
351495;201509;144;475;115;400;29;117;37;114;66;231
351500;201509;22607;65446;17411;55487;4513;15873;6806;20586;11319;36459
351510;201509;8391;26117;6857;22970;1619;5875;3276;10763;4895;16638
351512;201509;415;1191;331;1023;52;162;192;608;244;770
351515;201509;2230;6942;1560;5431;389;1440;418;1306;807;2746
351518;201509;2007;6315;1371;5088;334;1422;383;1281;717;2703
351519;201509;782;2275;595;1869;112;438;208;499;320;937
351520;201509;829;2282;417;1466;63;256;62;201;125;457
351530;201509;384;1175;269;892;39;132;77;220;116;352
351535;201509;2331;5974;1785;5154;187;639;1130;3115;1317;3754
351540;201509;1740;5220;1403;4589;448;1618;226;681;674;2299
351550;201509;4815;14044;3399;11115;751;2791;1171;3644;1922;6435
351560;201509;365;1153;303;1017;64;250;56;171;120;421
351565;201509;180;589;163;542;33;124;76;237;109;361
351570;201509;11300;34637;9541;31027;2189;7679;4924;15526;7113;23205
351580;201509;340;884;206;595;51;144;60;160;111;304
351590;201509;396;1055;297;869;32;95;119;329;151;424
351600;201509;1688;4649;1460;4280;253;826;692;1900;945;2726
351610;201509;660;1809;502;1534;60;222;233;645;293;867
351620;201509;18590;59368;13868;49488;3080;12247;3210;10081;6290;22328
351630;201509;18183;57802;16334;54644;3727;13267;9013;29824;12740;43091
351640;201509;10491;32472;8689;29178;1743;6416;4669;15337;6412;21753
351650;201509;445;1332;214;736;40;157;35;101;75;258
351660;201509;751;2362;535;1808;117;416;122;360;239;776
351670;201509;3923;12064;3171;10418;578;2181;1466;4493;2044;6674
351680;201509;644;1945;390;1324;70;246;84;270;154;516
351685;201509;421;1229;340;1095;85;271;151;497;236;768
351690;201509;1046;3065;718;2310;140;504;202;544;342;1048
351700;201509;1196;3459;1023;3130;259;788;416;1239;675;2027
351710;201509;630;2035;510;1773;89;317;193;621;282;938
351720;201509;1627;4908;1095;3581;222;772;339;992;561;1764
351730;201509;1038;2950;830;2655;276;1016;297;898;573;1914
351740;201509;4031;10966;3147;9193;663;2057;1074;2979;1737;5036
351750;201509;1171;3696;813;2849;190;763;239;750;429;1513
351760;201509;3670;11387;3021;9944;809;2862;1046;3185;1855;6047
351770;201509;2290;7118;1905;6440;551;1960;799;2576;1350;4536
351780;201509;1546;4289;883;2795;160;555;225;649;385;1204
351790;201509;998;2880;862;2672;264;817;380;1217;644;2034
351800;201509;443;974;307;787;38;105;171;428;209;533
351810;201509;1030;2903;932;2774;140;433;681;2037;821;2470
351820;201509;2238;7118;1717;6031;469;1719;161;521;630;2240
351830;201509;3944;12336;3063;10291;547;2076;1476;4657;2023;6733
351840;201509;7132;23504;6085;21419;1641;6257;2169;7387;3810;13644
351850;201509;1773;4982;1288;4097;198;797;588;1648;786;2445
351860;201509;3377;10698;2924;9731;783;2812;1171;3666;1954;6478
351870;201509;29481;88129;24918;79575;6644;22540;11377;35626;18021;58166
351880;201509;107815;340395;91562;305742;26858;94887;27506;88171;54364;183058
351885;201509;538;1911;499;1825;131;502;218;778;349;1280
351890;201509;669;1998;504;1644;117;432;109;306;226;738
351900;201509;1266;3812;1065;3479;288;1008;327;1037;615;2045
351905;201509;454;1442;371;1286;58;246;200;642;258;888
351907;201509;16679;49390;13709;43817;1953;7367;8079;24789;10032;32156
351910;201509;937;2863;819;2647;171;631;383;1160;554;1791
351920;201509;1018;2798;887;2589;124;434;555;1559;679;1993
351925;201509;913;2802;767;2505;129;461;382;1161;511;1622
351930;201509;2612;8462;2456;8152;507;2071;1572;4834;2079;6905
351940;201509;943;2819;786;2499;172;589;357;1090;529;1679
351950;201509;1411;3867;1003;3098;145;484;521;1561;666;2045
351960;201509;3945;11270;2751;9040;606;2167;1094;3501;1700;5668
351970;201509;5266;18920;4623;17590;1387;5674;1599;5911;2986;11585
351980;201509;893;2654;673;2196;138;500;253;717;391;1217
351990;201509;1522;4291;1199;3666;270;961;251;630;521;1591
352000;201509;2179;6991;1946;6489;421;1513;904;2825;1325;4338
352010;201509;1754;5811;1509;5255;374;1432;349;1154;723;2586
352020;201509;1385;4313;1173;3910;275;1011;437;1358;712;2369
352030;201509;4829;14108;3983;12840;977;3241;2032;6610;3009;9851
352040;201509;1959;6454;1596;5634;352;1363;380;1233;732;2596
352042;201509;3094;8604;2008;6208;414;1414;931;2755;1345;4169
352044;201509;1303;4313;969;3536;188;739;155;500;343;1239
352050;201509;8874;26951;5645;19645;1356;5186;1051;3244;2407;8430
352060;201509;703;2022;588;1827;121;447;256;714;377;1161
352070;201509;772;2004;601;1702;152;448;216;599;368;1047
352080;201509;423;1195;300;949;57;199;118;339;175;538
352090;201509;1600;5230;1250;4420;257;1020;243;743;500;1763
352100;201509;2496;7551;1804;6209;476;1823;580;1792;1056;3615
352110;201509;485;1694;409;1512;110;442;155;539;265;981
352115;201509;424;1333;358;1190;72;255;152;470;224;725
352120;201509;930;2840;777;2577;159;609;387;1215;546;1824
352130;201509;1840;5251;1237;4015;342;1176;316;920;658;2096
352140;201509;1670;4903;999;3392;165;590;375;1224;540;1814
352150;201509;725;2212;557;1872;140;484;238;789;378;1273
352160;201509;1029;2821;809;2406;163;532;285;738;448;1270
352170;201509;2661;7966;2371;7381;484;1646;1232;3574;1716;5220
352180;201509;3343;9466;2778;8358;679;2240;993;2819;1672;5059
352190;201509;1119;3359;936;2972;176;668;354;945;530;1613
352200;201509;369;1289;299;1140;47;203;145;535;192;738
352210;201509;16975;44995;13331;39640;2528;7899;7537;22699;10065;30598
352215;201509;530;1657;489;1601;67;249;283;900;350;1149
352220;201509;12110;39159;10359;35453;3297;12175;3081;10230;6378;22405
352230;201509;12320;41131;10509;37629;3011;11775;3821;13191;6832;24966
352240;201509;11701;34029;8849;28815;2650;9661;2625;7708;5275;17369
352250;201509;22240;71288;19191;64850;5493;19931;6259;20760;11752;40691
352260;201509;5255;14825;3217;10563;626;2314;1103;3319;1729;5633
352265;201509;858;2741;731;2506;77;345;434;1386;511;1731
352270;201509;1889;6375;1557;5630;441;1704;396;1356;837;3060
352280;201509;2180;6570;1778;5861;461;1735;628;1957;1089;3692
352290;201509;1126;3515;961;3156;218;852;337;968;555;1820
352300;201509;931;2741;731;2365;176;613;304;911;480;1524
352310;201509;35844;107713;29765;97197;7603;26171;15668;51101;23271;77272
352320;201509;5619;17174;4786;15563;1359;4734;1488;4342;2847;9076
352330;201509;1993;6337;1688;5900;541;1993;479;1648;1020;3641
352340;201509;5536;17902;4198;14999;1132;4375;724;2318;1856;6693
352350;201509;1544;5282;1374;4912;280;1148;541;1807;821;2955
352360;201509;1116;3421;971;3129;187;754;592;1786;779;2540
352370;201509;818;2811;738;2623;130;524;356;1212;486;1736
352380;201509;971;3059;832;2807;271;1060;218;672;489;1732
352390;201509;17833;48306;11588;36112;2073;7422;5454;15691;7527;23113
352400;201509;3920;10943;2403;7940;662;2331;677;2035;1339;4366
352410;201509;2925;8744;2420;7875;633;2156;832;2609;1465;4765
352420;201509;931;2628;792;2357;211;688;355;999;566;1687
352430;201509;6352;18974;5196;17023;1724;6188;1517;4769;3241;10957
352440;201509;15498;46982;12291;40683;3085;10877;4322;13845;7407;24722
352450;201509;676;1953;435;1480;93;351;108;322;201;673
352460;201509;2363;7639;1959;6868;583;2259;511;1598;1094;3857
352470;201509;4273;11722;2415;7835;405;1453;767;2318;1172;3771
352480;201509;4577;12384;3499;10363;686;2359;1375;3692;2061;6051
352490;201509;709;2411;554;2009;98;404;126;408;224;812
352500;201509;7827;23194;6963;21829;3293;11129;1824;4997;5117;16126
352510;201509;3016;9601;2368;8291;723;2788;589;1972;1312;4760
352520;201509;2081;7225;1818;6586;464;1821;821;2892;1285;4713
352530;201509;7841;25034;5791;20357;1584;5915;829;2558;2413;8473
352540;201509;493;1519;364;1231;66;265;92;274;158;539
352550;201509;859;2848;576;2141;143;616;107;339;250;955
352560;201509;664;1954;466;1504;89;284;147;417;236;701
352570;201509;1781;5866;1319;4769;267;1103;267;846;534;1949
352580;201509;872;2508;734;2286;159;538;386;1171;545;1709
352585;201509;209;675;162;578;56;212;32;118;88;330
352590;201509;12360;37702;9675;32219;2421;8780;4271;13445;6692;22225
352600;201509;1555;4719;1364;4361;353;1242;587;1762;940;3004
352610;201509;3300;10033;2717;9004;811;2989;798;2427;1609;5416
352620;201509;5136;15741;4729;15122;980;3408;2716;8477;3696;11885
352630;201509;611;1957;569;1847;130;503;241;711;371;1214
352640;201509;2777;8495;2238;7348;322;1206;1180;3734;1502;4940
352650;201509;831;2446;603;1948;136;464;177;525;313;989
352660;201509;1008;3398;776;2841;154;626;176;606;330;1232
352670;201509;10190;30689;6026;21256;1489;5668;696;2221;2185;7889
352680;201509;2995;10153;2264;8366;515;2122;629;2068;1144;4190
352690;201509;29803;81969;20194;62367;3712;12523;9255;27231;12967;39754
352700;201509;707;2121;570;1901;164;618;259;820;423;1438
352710;201509;5637;16402;4151;13373;1004;3614;1453;4382;2457;7996
352720;201509;7370;23676;6544;21876;1966;6642;2238;7413;4204;14055
352725;201509;403;1127;241;788;36;144;93;274;129;418
352730;201509;2250;7426;1975;6697;408;1505;700;2080;1108;3585
352740;201509;1910;5350;1507;4658;257;951;867;2516;1124;3467
352750;201509;458;1307;240;797;43;163;59;165;102;328
352760;201509;1101;3773;950;3413;287;1094;367;1254;654;2348
352770;201509;723;2257;620;2047;140;513;257;804;397;1317
352780;201509;613;2006;499;1744;100;399;159;501;259;900
352790;201509;637;1822;458;1478;97;329;97;306;194;635
352800;201509;928;3307;660;2567;155;684;178;573;333;1257
352810;201509;1140;2974;730;2171;139;458;221;628;360;1086
352820;201509;569;1596;414;1353;112;417;101;319;213;736
352830;201509;517;1474;320;1025;49;180;48;110;97;290
352840;201509;3776;12775;3281;11681;1028;3856;1021;3553;2049;7409
352850;201509;8414;26181;7107;23842;1860;6697;2552;8337;4412;15034
352860;201509;798;2596;721;2419;175;625;263;822;438;1447
352870;201509;951;2368;694;1885;76;291;407;988;483;1279
352880;201509;2307;6505;1645;5118;327;1041;536;1543;863;2584
352885;201509;224;747;212;719;28;102;127;412;155;514
352890;201509;674;1785;487;1403;69;236;234;594;303;830
352900;201509;19664;57258;14154;45928;3001;10681;5289;16272;8290;26953
352910;201509;290;906;188;654;21;83;29;88;50;171
352920;201509;2408;7159;1890;6172;452;1682;750;2189;1202;3871
352930;201509;5605;17339;4299;14398;1132;4081;971;3031;2103;7112
352940;201509;23371;75965;19396;66574;6425;23518;2739;8686;9164;32204
352950;201509;275;784;173;594;43;176;46;124;89;300
352960;201509;605;1859;379;1324;69;274;53;166;122;440
352965;201509;277;830;229;726;61;212;42;118;103;330
352970;201509;2910;7355;2317;6451;297;874;1499;4205;1796;5079
352980;201509;1219;3647;1021;3349;235;765;559;1946;794;2711
352990;201509;3983;12655;3489;11783;982;3691;1297;4119;2279;7810
353000;201509;471;1296;256;796;38;123;44;117;82;240
353010;201509;2976;8306;2160;6687;520;1819;613;1659;1133;3478
353020;201509;4264;11566;2694;8117;382;1337;1036;2748;1418;4085
353030;201509;3906;11356;3167;9964;892;3024;733;2135;1625;5159
353040;201509;622;1725;522;1563;147;501;176;479;323;980
353050;201509;4876;16181;4030;14432;1156;4448;1463;4970;2619;9418
353060;201509;34225;105084;31668;100925;3729;14303;22847;69911;26576;84214
353070;201509;9303;29721;6734;23998;1811;6862;1666;5910;3477;12772
353080;201509;5215;16484;3472;12480;755;2982;795;2580;1550;5562
353090;201509;520;1713;467;1600;50;200;261;825;311;1025
353100;201509;246;657;119;379;25;85;26;72;51;157
353110;201509;7563;22970;6415;20967;1604;5548;3260;10709;4864;16257
353120;201509;704;2094;439;1469;101;391;114;318;215;709
353130;201509;2487;7168;2005;6381;645;2206;643;1967;1288;4173
353140;201509;2271;6115;1710;5010;431;1372;681;1840;1112;3212
353150;201509;1679;5079;1357;4505;387;1370;367;1205;754;2575
353160;201509;675;1900;423;1344;92;309;68;151;160;460
353170;201509;468;1536;420;1455;117;521;185;570;302;1091
353180;201509;7747;22215;6009;18966;1046;3663;3076;9340;4122;13003
353190;201509;3563;10822;2938;9471;559;2031;1443;4300;2002;6331
353200;201509;917;3063;730;2618;217;859;192;641;409;1500
353205;201509;406;1292;352;1185;79;277;137;452;216;729
353210;201509;974;2494;728;2057;43;169;477;1303;520;1472
353215;201509;406;1280;355;1167;61;231;133;384;194;615
353220;201509;671;2067;531;1749;129;459;130;374;259;833
353230;201509;848;2689;764;2533;191;708;216;647;407;1355
353240;201509;1993;6342;1781;5924;416;1579;920;2877;1336;4456
353250;201509;1046;2806;806;2370;127;395;392;1120;519;1515
353260;201509;924;2497;672;2051;112;387;271;774;383;1161
353270;201509;628;1861;539;1687;149;504;186;540;335;1044
353280;201509;580;1865;475;1632;117;441;119;392;236;833
353282;201509;1637;5223;1531;5024;209;775;973;3059;1182;3834
353284;201509;339;921;198;626;38;118;51;165;89;283
353286;201509;143;424;99;324;15;44;15;53;30;97
353290;201509;546;1732;433;1523;85;350;231;770;316;1120
353300;201509;1421;4396;1172;3832;285;1068;424;1219;709;2287
353310;201509;202;598;170;535;47;169;65;178;112;347
353320;201509;521;1497;456;1385;81;271;246;716;327;987
353325;201509;579;1894;479;1689;93;368;88;245;181;613
353330;201509;619;1780;408;1279;78;281;186;535;264;816
353340;201509;2905;8180;1851;6123;500;1767;560;1739;1060;3506
353350;201509;3193;9493;2597;8374;771;2664;1024;3108;1795;5772
353360;201509;379;1224;331;1119;46;192;208;666;254;858
353370;201509;645;2085;550;1851;73;286;311;993;384;1279
353380;201509;331;1062;266;924;49;206;101;311;150;517
353390;201509;5849;15693;4051;12403;784;2647;1472;4143;2256;6790
353400;201509;493;1463;405;1281;106;378;110;282;216;660
353410;201509;602;1728;484;1528;102;353;262;810;364;1163
353420;201509;578;1587;405;1199;113;329;126;343;239;672
353430;201509;2192;7489;1577;5822;374;1458;193;630;567;2088
353440;201509;57056;182063;47707;160451;13114;46163;16328;52984;29442;99147
353450;201509;430;1282;356;1133;78;282;139;409;217;691
353460;201509;3479;9708;2948;8802;465;1532;1418;4274;1883;5806
353470;201509;9049;26957;6374;21410;1409;5276;1504;4581;2913;9857
353475;201509;1642;4591;1100;3410;203;670;319;883;522;1553
353480;201509;1417;4211;1251;3891;226;758;718;2174;944;2932
353490;201509;981;2754;782;2360;166;550;295;818;461;1368
353500;201509;975;2617;802;2310;254;740;334;947;588;1687
353510;201509;1008;3160;755;2525;165;604;179;503;344;1107
353520;201509;1098;3171;838;2717;164;613;333;1047;497;1660
353530;201509;2539;7495;2199;6851;400;1454;1147;3424;1547;4878
353540;201509;1897;5730;1631;5278;420;1447;674;2109;1094;3556
353550;201509;5911;16180;5050;14844;606;2141;3210;8972;3816;11113
353560;201509;2079;6859;1700;6145;431;1770;462;1532;893;3302
353570;201509;419;1283;352;1145;61;210;206;634;267;844
353580;201509;2183;6774;1988;6444;370;1376;1257;3986;1627;5362
353590;201509;711;2024;532;1681;149;505;162;504;311;1009
353600;201509;1674;4637;1497;4331;233;755;789;2205;1022;2960
353610;201509;566;1869;422;1553;80;358;89;271;169;629
353620;201509;2113;6845;1762;6124;478;1785;544;1732;1022;3517
353625;201509;287;776;184;595;42;147;48;152;90;299
353630;201509;1611;5512;1217;4473;223;888;148;442;371;1330
353640;201509;1340;3889;1067;3304;151;491;554;1654;705;2145
353650;201509;7011;20785;5149;16825;1043;3569;1786;5624;2829;9193
353657;201509;305;958;269;883;47;170;95;293;142;463
353660;201509;1181;3002;848;2439;324;1003;136;271;460;1274
353670;201509;3662;11669;3058;10320;941;3602;981;2938;1922;6540
353680;201509;664;2178;576;2012;228;880;193;623;421;1503
353690;201509;524;1393;294;943;51;186;91;233;142;419
353700;201509;2108;6473;1797;5825;334;1168;708;2179;1042;3347
353710;201509;2972;7181;1329;4392;302;1027;261;823;563;1850
353715;201509;458;1305;312;990;27;106;84;242;111;348
353720;201509;2000;6226;1712;5751;327;1263;899;2863;1226;4126
353730;201509;4375;13211;3327;10917;706;2510;930;2761;1636;5271
353740;201509;1973;5842;1506;4885;419;1433;412;1268;831;2701
353750;201509;807;2674;604;2184;126;515;161;572;287;1087
353760;201509;9351;26453;7466;23431;1493;5236;3967;12157;5460;17393
353770;201509;811;2448;449;1537;70;234;28;47;98;281
353780;201509;4239;14399;3608;13101;1206;4657;964;3424;2170;8081
353790;201509;1928;6576;1564;5791;414;1745;298;1063;712;2808
353800;201509;15410;47400;11896;40728;3154;11687;4055;13433;7209;25120
353810;201509;1039;3225;779;2654;170;653;257;823;427;1476
353820;201509;1224;4127;1098;3826;245;1011;560;1762;805;2773
353830;201509;670;1804;520;1550;100;324;248;725;348;1049
353850;201509;1634;5135;1441;4753;309;1072;640;2047;949;3119
353860;201509;2450;8130;2019;7125;510;1915;570;1938;1080;3853
353870;201509;26903;77994;17985;60081;3859;14088;5182;15576;9041;29664
353880;201509;2453;7677;2028;6899;282;1143;1098;3641;1380;4784
353890;201509;2743;6705;1861;5263;348;1070;876;2305;1224;3375
353900;201509;1027;3180;738;2561;161;617;199;639;360;1256
353910;201509;1214;4376;1175;4290;336;1278;658;2377;994;3655
353920;201509;2234;6582;1515;4986;319;1137;257;735;576;1872
353930;201509;4146;12787;2897;10377;742;2876;627;2185;1369;5061
353940;201509;1200;3778;929;3164;164;624;364;1142;528;1766
353950;201509;3343;10554;2981;9863;451;1725;1840;5832;2291;7557
353960;201509;593;1855;448;1531;91;337;103;279;194;616
353970;201509;551;1596;479;1499;46;160;341;1060;387;1220
353980;201509;12372;37265;10611;33804;2361;8070;5262;16217;7623;24287
353990;201509;343;1055;307;978;53;206;143;421;196;627
354000;201509;2064;5907;1326;4349;261;932;135;390;396;1322
354010;201509;353;1058;296;968;74;247;158;531;232;778
354020;201509;4412;13622;3832;12302;1003;3477;1379;4060;2382;7537
354025;201509;853;2376;622;1949;126;420;196;578;322;998
354030;201509;496;1357;343;1087;57;211;165;480;222;691
354040;201509;745;2001;538;1615;60;220;282;774;342;994
354050;201509;949;3030;796;2715;221;840;234;753;455;1593
354060;201509;5054;15487;3457;11911;836;3085;1017;3307;1853;6392
354070;201509;2793;9182;2370;8207;600;2241;489;1588;1089;3829
354075;201509;1925;7211;1811;6981;473;2013;802;3039;1275;5052
354080;201509;1538;4674;1046;3516;220;785;238;689;458;1474
354085;201509;309;787;275;738;17;60;223;587;240;647
354090;201509;1293;3793;1222;3678;122;405;890;2699;1012;3104
354100;201509;14809;49235;12131;43844;3088;11940;5250;18600;8338;30540
354105;201509;884;2703;772;2488;131;482;455;1412;586;1894
354110;201509;752;2052;601;1840;210;735;144;355;354;1090
354120;201509;1961;5356;1496;4473;272;909;630;1724;902;2633
354130;201509;5983;17300;4580;14507;1758;5906;689;1817;2447;7723
354140;201509;25087;63275;15189;45031;3172;10147;4817;13038;7989;23185
354150;201509;3950;10608;2982;8841;550;1820;1406;3973;1956;5793
354160;201509;3345;10780;2747;9400;726;2697;1077;3507;1803;6204
354165;201509;350;1283;300;1161;86;368;98;360;184;728
354170;201509;1386;4241;1075;3536;205;775;404;1157;609;1932
354180;201509;454;1329;406;1224;60;215;226;605;286;820
354190;201509;1490;4736;1211;4116;341;1284;392;1249;733;2533
354200;201509;1052;2976;838;2575;136;477;348;959;484;1436
354210;201509;660;2153;570;1981;85;364;301;966;386;1330
354220;201509;2847;8347;2423;7542;583;1991;1088;3257;1671;5248
354230;201509;627;2048;565;1928;103;390;250;818;353;1208
354240;201509;1188;3836;865;3067;146;584;189;599;335;1183
354250;201509;669;1926;446;1528;161;606;116;391;277;997
354260;201509;7997;23344;6596;20936;1851;6358;2188;6763;4039;13121
354270;201509;1111;3813;937;3385;222;903;331;1138;553;2041
354280;201509;672;2032;617;1932;83;323;433;1291;516;1614
354290;201509;960;3232;866;3050;201;788;368;1275;569;2063
354300;201509;3381;11213;3253;10970;874;3063;1563;5166;2437;8229
354310;201509;870;2684;660;2247;159;581;250;832;409;1413
354320;201509;743;2182;616;1937;146;526;205;564;351;1090
354323;201509;411;1162;316;990;73;252;100;274;173;526
354325;201509;1195;3964;1010;3499;194;775;383;1221;577;1996
354330;201509;6499;19597;5293;17168;1097;3966;2525;7686;3622;11652
354340;201509;24486;75617;19616;66710;6092;22388;6793;22264;12885;44652
354350;201509;1070;3149;986;2989;289;979;477;1332;766;2311
354360;201509;463;1475;307;1108;51;194;25;89;76;283
354370;201509;1187;3936;1025;3599;123;526;608;2052;731;2578
354380;201509;929;2722;732;2369;220;842;130;327;350;1169
354390;201509;12156;36658;8365;28805;1838;6878;1823;5947;3661;12825
354400;201509;1550;5304;1227;4523;264;1084;348;1206;612;2290
354410;201509;5275;16121;4331;14367;1023;3608;1937;6367;2960;9975
354420;201509;1143;3397;855;2714;212;740;328;957;540;1697
354425;201509;2493;6995;2084;6244;648;2075;494;1388;1142;3463
354430;201509;1249;4062;1143;3843;252;961;496;1604;748;2565
354440;201509;512;1514;384;1249;49;187;179;539;228;726
354450;201509;423;1197;236;784;31;127;47;126;78;253
354460;201509;862;2359;637;1979;181;614;250;749;431;1363
354470;201509;558;1547;433;1286;48;185;216;566;264;751
354480;201509;679;1882;572;1712;92;317;327;933;419;1250
354490;201509;708;2318;529;1885;99;382;168;549;267;931
354500;201509;2025;6768;1769;6281;665;2701;288;910;953;3611
354510;201509;702;2020;630;1893;103;307;397;1219;500;1526
354515;201509;292;964;221;795;43;185;75;237;118;422
354520;201509;6894;22314;3899;13630;784;3090;1513;4914;2297;8004
354530;201509;2805;9700;2504;9028;644;2555;1075;3759;1719;6314
354540;201509;1221;3684;995;3266;344;1249;164;466;508;1715
354550;201509;458;1368;382;1206;70;245;193;582;263;827
354560;201509;1591;4550;1061;3354;211;655;410;1218;621;1873
354570;201509;775;2287;517;1668;108;362;79;221;187;583
354580;201509;9807;28223;7475;23673;1477;5093;3169;9462;4646;14555
354600;201509;1508;4974;1323;4608;304;1277;634;2060;938;3337
354610;201509;382;1101;224;722;32;93;48;139;80;232
354620;201509;384;1254;303;1108;78;348;133;451;211;799
354625;201509;265;854;198;707;42;155;55;183;97;338
354630;201509;2003;6737;1769;6214;746;2697;356;1164;1102;3861
354640;201509;3562;11563;2761;9755;618;2488;604;1895;1222;4383
354650;201509;891;2663;787;2460;100;349;509;1541;609;1890
354660;201509;2370;6878;1830;5921;330;1210;968;3080;1298;4290
354670;201509;1547;5011;1248;4268;322;1198;293;860;615;2058
354680;201509;4366;14321;3894;13321;1018;3770;1629;5411;2647;9181
354690;201509;769;2453;492;1736;95;338;143;477;238;815
354700;201509;1220;3412;803;2512;152;563;328;871;480;1434
354710;201509;539;1603;446;1400;65;230;196;546;261;776
354720;201509;208;566;143;436;49;142;40;123;89;265
354730;201509;7630;24977;5842;21131;1410;5577;2348;8152;3758;13729
354740;201509;232;703;137;485;21;83;28;92;49;175
354750;201509;2434;7356;1834;6252;524;2004;649;2119;1173;4123
354760;201509;1937;6153;1544;5297;441;1627;259;831;700;2458
354765;201509;229;638;136;442;12;45;15;37;27;82
354770;201509;2231;6195;1707;5301;643;2115;446;1310;1089;3425
354780;201509;44015;126352;37908;112910;7120;23748;20094;55802;27214;79550
354790;201509;787;2504;660;2272;132;514;319;1025;451;1539
354800;201509;1974;5800;1729;5451;429;1506;863;2667;1292;4173
354805;201509;935;2807;659;2187;60;211;140;430;200;641
354810;201509;583;1883;353;1284;58;253;70;193;128;446
354820;201509;970;3301;819;2968;180;782;238;753;418;1535
354830;201509;385;1087;290;912;76;255;138;396;214;651
354840;201509;653;1871;526;1637;114;386;256;773;370;1159
354850;201509;16490;50964;12095;41817;2758;10589;4537;14280;7295;24869
354860;201509;1341;4199;1129;3828;228;892;465;1478;693;2370
354870;201509;41028;124146;36795;115153;9074;30242;16096;49250;25170;79492
354880;201509;4030;11095;2278;7417;390;1477;642;1681;1032;3158
354890;201509;15405;45323;12772;40322;3246;10984;4590;13949;7836;24933
354900;201509;440;1284;327;1047;81;287;94;287;175;574
354910;201509;6496;19332;3564;12734;608;2395;222;728;830;3123
354920;201509;430;1255;302;1004;66;250;82;259;148;509
354925;201509;346;997;204;695;28;110;29;79;57;189
354930;201509;214;567;159;479;39;124;75;217;114;341
354940;201509;2030;7113;1570;5894;578;2301;207;714;785;3015
354950;201509;1467;4656;1257;4313;141;591;737;2443;878;3034
354960;201509;759;2370;655;2198;134;512;275;892;409;1404
354970;201509;4015;12993;3464;11845;619;2451;1867;6112;2486;8563
354980;201509;33228;82201;19525;59099;3749;12685;6646;18645;10395;31330
354990;201509;46430;138643;36771;118933;7025;24659;17954;55942;24979;80601
354995;201509;1650;5046;1463;4765;341;1174;786;2540;1127;3714
355000;201509;1440;4619;1243;4258;389;1527;251;731;640;2258
355010;201509;3521;10732;2756;9051;724;2537;1038;3407;1762;5944
355020;201509;2813;9427;2173;8076;894;3613;466;1640;1360;5253
355030;201509;979680;2747031;837649;2462793;195515;623418;369177;1039103;564692;1662521
355040;201509;2565;7833;2246;7273;566;2005;1163;3665;1729;5670
355050;201509;1160;3541;923;3071;306;1078;156;495;462;1573
355060;201509;4820;16103;3837;13963;916;3758;993;3250;1909;7008
355070;201509;6486;19962;5724;18703;1213;4588;3014;9215;4227;13803
355080;201509;1087;3699;787;2972;141;627;108;309;249;936
355090;201509;1120;3842;909;3359;182;722;363;1306;545;2028
355100;201509;18685;57806;15583;52571;4382;16223;6812;22404;11194;38627
355110;201509;1223;4024;1055;3676;313;1191;286;956;599;2147
355120;201509;603;1908;503;1701;117;465;184;559;301;1024
355130;201509;599;1514;291;844;53;157;104;267;157;424
355140;201509;1071;3528;1007;3417;221;830;540;1862;761;2692
355150;201509;3249;9501;2705;8602;608;2037;1389;4414;1997;6451
355160;201509;1576;5012;1338;4641;453;1787;417;1322;870;3109
355170;201509;9413;25674;6623;20800;2016;6810;1591;5013;3607;11823
355180;201509;2840;8712;2318;7722;607;2396;744;2195;1351;4591
355190;201509;1228;4117;1031;3681;361;1381;329;1122;690;2503
355200;201509;736;2647;677;2519;282;1136;149;525;431;1661
355210;201509;2423;7782;2113;7118;434;1676;1048;3329;1482;5005
355220;201509;30534;93290;24675;81476;8405;29185;6138;19247;14543;48432
355230;201509;1392;3876;750;2441;132;437;182;529;314;966
355240;201509;26121;74617;17929;57803;3887;13618;6243;19014;10130;32632
355250;201509;24551;79401;21282;73055;6034;22162;8791;29572;14825;51734
355255;201509;805;2218;538;1648;98;318;143;403;241;721
355260;201509;1402;3955;1187;3583;273;945;493;1309;766;2254
355270;201509;1478;4398;1418;4312;96;361;1199;3589;1295;3950
355280;201509;23431;68499;19113;59983;3793;13410;8368;24814;12161;38224
355290;201509;867;2718;707;2342;138;488;276;831;414;1319
355300;201509;1098;3567;895;3129;184;702;319;1034;503;1736
355310;201509;980;2970;809;2625;140;491;411;1325;551;1816
355320;201509;598;1833;505;1623;84;335;200;534;284;869
355330;201509;1726;5345;1211;4300;266;1057;444;1501;710;2558
355340;201509;2405;6329;2156;5895;368;1053;1293;3445;1661;4498
355350;201509;1301;4403;1060;3840;265;1074;318;1054;583;2128
355360;201509;1078;3449;978;3250;158;540;667;2284;825;2824
355365;201509;225;723;182;634;42;174;54;175;96;349
355370;201509;7502;18389;5319;15646;1432;4560;2176;6623;3608;11183
355380;201509;3324;10015;2533;8175;588;2111;542;1422;1130;3533
355385;201509;841;2643;776;2540;295;1039;222;656;517;1695
355390;201509;846;2358;638;1947;134;461;268;703;402;1164
355395;201509;1868;5585;1373;4448;211;730;572;1709;783;2439
355400;201509;8658;28376;7398;25718;2197;8257;2307;7637;4504;15894
355410;201509;15111;50423;12248;44401;4031;15922;2577;9251;6608;25173
355420;201509;761;2656;694;2510;224;897;199;697;423;1594
355430;201509;3477;9725;2875;8657;550;1826;1519;4387;2069;6213
355440;201509;913;2839;689;2322;122;441;207;624;329;1065
355450;201509;3530;10134;1970;6541;382;1318;599;1827;981;3145
355460;201509;626;1686;428;1324;82;313;131;311;213;624
355465;201509;374;1161;308;1033;66;239;77;246;143;485
355470;201509;761;2367;626;2101;137;521;288;909;425;1430
355475;201509;131;476;119;443;26;99;58;213;84;312
355480;201509;2890;10197;2651;9715;707;2748;1221;4387;1928;7135
355490;201509;950;2715;623;2036;114;386;129;389;243;775
355495;201509;686;2289;605;2110;122;473;226;742;348;1215
355500;201509;7770;22221;4870;15851;828;2972;974;2821;1802;5793
355510;201509;2031;5414;1152;3611;177;666;356;980;533;1646
355520;201509;440;1062;242;674;34;122;101;245;135;367
355530;201509;382;907;154;485;18;63;30;87;48;150
355535;201509;666;2027;515;1723;148;568;125;335;273;903
355540;201509;8136;25680;7595;24750;1926;6689;3954;12486;5880;19175
355550;201509;740;2234;628;2056;141;541;290;909;431;1450
355560;201509;1264;3730;815;2718;156;607;127;296;283;903
355570;201509;194;600;131;455;17;63;22;63;39;126
355580;201509;1181;3238;825;2540;171;616;315;933;486;1549
355590;201509;221;580;180;502;22;63;106;292;128;355
355600;201509;1087;3356;899;2959;302;1079;244;747;546;1826
355610;201509;1393;3878;1177;3524;227;769;556;1587;783;2356
355620;201509;3982;12420;3132;10488;568;2165;1381;4279;1949;6444
355630;201509;3232;9211;1935;6507;374;1358;494;1557;868;2915
355635;201509;910;2969;778;2744;97;410;521;1822;618;2232
355640;201509;3018;9586;2179;7754;394;1570;305;957;699;2527
355645;201509;3106;10723;2804;10198;454;1825;1678;6071;2132;7896
355650;201509;6359;19253;5388;17383;810;3063;3285;9964;4095;13027
355660;201509;1212;3796;959;3268;196;818;382;1195;578;2013
355670;201509;2464;7662;1695;5854;329;1321;684;2090;1013;3411
355680;201509;1557;5065;1122;4001;340;1319;234;760;574;2079
355690;201509;407;1271;296;1077;186;726;26;68;212;794
355695;201509;305;927;178;585;13;40;18;34;31;74
355700;201509;5344;17682;4478;15684;1132;4173;1730;5803;2862;9976
355710;201509;10682;26346;6255;18214;1552;4854;1566;4221;3118;9075
355715;201509;263;779;162;549;37;135;30;86;67;221
355720;201509;1487;4886;1213;4262;330;1246;351;1093;681;2339
355730;201509;772;2557;637;2244;213;756;142;498;355;1254
410010;201509;1451;4492;1240;4046;269;947;304;956;573;1903
410020;201509;1172;3816;1018;3484;279;1011;395;1316;674;2327
410030;201509;1130;3827;918;3286;215;832;152;526;367;1358
410040;201509;9839;32178;8535;29559;2278;8843;2510;8341;4788;17184
410045;201509;969;2734;656;2109;152;515;166;496;318;1011
410050;201509;2422;6714;1477;4789;374;1280;139;376;513;1656
410060;201509;2204;6800;1936;6283;482;1685;807;2628;1289;4313
410070;201509;1704;4770;1287;3949;405;1352;280;761;685;2113
410080;201509;1267;3732;1025;3267;173;622;455;1348;628;1970
410090;201509;1010;3179;914;2970;233;845;301;939;534;1784
410100;201509;2619;7980;1869;6211;449;1644;197;584;646;2228
410105;201509;393;1228;248;874;46;193;37;106;83;299
410110;201509;2506;7399;1987;6364;339;1206;642;1994;981;3200
410115;201509;520;1413;398;1177;48;153;158;430;206;583
410120;201509;2407;8243;2230;7926;689;2615;929;3297;1618;5912
410130;201509;1069;3437;965;3177;364;1243;241;744;605;1987
410140;201509;16546;43364;10781;32797;2362;7928;2953;8581;5315;16509
410150;201509;17667;43926;8556;25557;1709;5562;1415;3695;3124;9257
410160;201509;2888;8884;2592;8382;696;2508;933;3020;1629;5528
410165;201509;741;2149;595;1835;138;440;236;674;374;1114
410170;201509;2127;6192;1654;5160;479;1662;326;950;805;2612
410180;201509;9728;30957;8241;27602;2070;7518;3018;9403;5088;16921
410185;201509;566;1552;448;1332;106;326;135;361;241;687
410190;201509;2014;5936;1561;4879;341;1168;288;798;629;1966
410200;201509;3832;10681;2723;8419;600;2045;341;953;941;2998
410210;201509;2491;7379;1826;5914;317;1200;414;1107;731;2307
410220;201509;635;1790;451;1421;78;278;129;375;207;653
410230;201509;1383;4325;1183;3938;319;1231;461;1431;780;2662
410240;201509;4327;13103;3877;12160;1120;4034;976;2900;2096;6934
410250;201509;2554;7078;1752;5410;446;1503;315;857;761;2360
410260;201509;1537;4666;1288;4190;318;1113;490;1543;808;2656
410270;201509;519;1453;396;1214;62;216;150;422;212;638
410275;201509;871;2610;601;2013;86;312;282;933;368;1245
410280;201509;2277;6607;1656;5316;366;1375;457;1350;823;2725
410290;201509;3388;10165;2845;9104;700;2376;1127;3623;1827;5999
410300;201509;670;1883;570;1675;89;285;248;658;337;943
410302;201509;365;989;246;789;31;106;142;460;173;566
410304;201509;1214;3896;1089;3622;304;1053;423;1447;727;2500
410305;201509;1883;4975;1530;4408;366;1137;812;2348;1178;3485
410310;201509;2175;7067;1948;6643;429;1641;749;2521;1178;4162
410315;201509;632;1826;389;1321;75;267;109;346;184;613
410320;201509;1212;3634;708;2420;90;348;62;199;152;547
410322;201509;537;1576;339;1129;62;208;90;275;152;483
410330;201509;1375;3730;1119;3241;251;779;321;898;572;1677
410335;201509;957;2804;813;2537;162;539;305;898;467;1437
410337;201509;793;2085;570;1652;80;283;222;557;302;840
410340;201509;488;1446;319;990;44;153;132;365;176;518
410345;201509;1666;4752;1148;3641;267;895;334;1016;601;1911
410347;201509;707;1915;459;1438;71;266;147;441;218;707
410350;201509;963;2909;678;2307;147;551;99;294;246;845
410360;201509;3401;9542;2713;8319;473;1641;1212;3573;1685;5214
410370;201509;11971;34456;8414;26208;1617;5737;2413;6520;4030;12257
410380;201509;1204;3603;1057;3282;152;563;537;1580;689;2143
410390;201509;2658;7674;2035;6442;648;2220;528;1482;1176;3702
410395;201509;872;2875;763;2642;193;775;322;1074;515;1849
410400;201509;4275;13261;3593;11914;828;3125;1309;4100;2137;7225
410405;201509;927;2677;731;2290;169;598;257;786;426;1384
410410;201509;1254;4008;1194;3916;355;1385;471;1411;826;2796
410420;201509;7093;22788;5778;19725;1533;5620;967;2856;2500;8476
410425;201509;3101;9732;2143;7517;392;1462;233;739;625;2201
410430;201509;14434;38839;10288;30973;2123;7029;3084;8821;5207;15850
410440;201509;2934;9278;2591;8599;689;2534;1054;3370;1743;5904
410442;201509;2666;8906;2334;8133;713;2575;668;2318;1381;4893
410445;201509;2275;7545;1956;6928;517;2079;625;2235;1142;4314
410450;201509;2177;6130;1645;5078;469;1534;205;518;674;2052
410460;201509;2057;6037;1612;5121;406;1363;446;1309;852;2672
410465;201509;1889;6301;1549;5541;356;1396;562;1861;918;3257
410470;201509;1623;5224;1295;4456;293;1167;331;1098;624;2265
410480;201509;29166;82467;18928;60522;4354;14929;2874;7973;7228;22902
410490;201509;10603;33362;8044;27746;2005;7736;2009;6262;4014;13998
410500;201509;1542;4808;1242;4144;451;1655;301;972;752;2627
410510;201509;2455;6492;1708;4971;324;985;656;1721;980;2706
410520;201509;3108;10771;2916;10364;895;3412;1076;3823;1971;7235
410530;201509;1617;4440;1172;3498;218;743;389;1043;607;1786
410540;201509;3031;8907;2046;6777;446;1550;601;1922;1047;3472
410550;201509;6296;18015;4125;13187;796;2867;623;1725;1419;4592
410560;201509;1200;3569;907;2936;218;818;262;692;480;1510
410570;201509;2616;8286;2325;7758;629;2278;807;2885;1436;5163
410580;201509;21688;65845;17477;57196;4565;16537;4860;14629;9425;31166
410590;201509;1326;4137;780;2616;114;387;148;443;262;830
410600;201509;1822;5306;1447;4554;339;1071;564;1773;903;2844
410610;201509;756;2163;587;1823;91;325;215;631;306;956
410620;201509;1629;5618;1189;4463;341;1375;136;491;477;1866
410630;201509;2481;7311;1776;5719;440;1525;311;833;751;2358
410640;201509;4286;11888;3122;9626;823;2937;555;1561;1378;4498
410645;201509;1128;3930;1067;3838;489;1892;251;901;740;2793
410650;201509;2235;6806;1747;5747;563;1939;275;817;838;2756
410655;201509;828;2385;632;1995;132;489;210;629;342;1118
410657;201509;717;1999;486;1504;89;318;179;473;268;791
410660;201509;2523;7320;1436;4787;306;1111;163;460;469;1571
410670;201509;940;2589;628;1920;118;391;187;498;305;889
410680;201509;2741;9106;2206;7751;628;2165;690;2591;1318;4756
410685;201509;633;1826;551;1686;47;147;391;1213;438;1360
410690;201509;114388;329856;77030;250157;16910;60202;16011;45546;32921;105748
410700;201509;2237;6824;2038;6431;552;1887;836;2509;1388;4396
410710;201509;897;2684;615;2019;144;509;160;445;304;954
410712;201509;808;2447;678;2189;236;819;188;624;424;1443
410715;201509;968;3004;729;2445;139;516;252;762;391;1278
410720;201509;3303;9711;2358;7689;505;1873;538;1577;1043;3450
410725;201509;1035;2924;703;2245;110;341;106;291;216;632
410730;201509;511;1418;411;1247;125;418;106;327;231;745
410740;201509;890;2644;620;2084;107;413;269;895;376;1308
410750;201509;1801;5251;1448;4482;305;1034;459;1329;764;2363
410752;201509;294;813;165;537;32;127;60;163;92;290
410753;201509;432;1244;262;845;37;137;88;252;125;389
410754;201509;1036;3140;883;2874;74;247;575;1945;649;2192
410755;201509;804;2031;621;1739;89;285;347;931;436;1216
410760;201509;2249;6830;1948;6265;552;1963;575;1767;1127;3730
410765;201509;15666;46305;11037;36815;1995;7462;1113;3319;3108;10781
410770;201509;909;2515;661;2015;191;651;132;358;323;1009
410773;201509;1298;3722;1102;3413;223;801;603;1792;826;2593
410775;201509;1503;4267;1394;4103;331;1066;585;1672;916;2738
410780;201509;514;1425;356;1126;90;286;122;436;212;722
410785;201509;719;2292;584;1961;216;771;133;427;349;1198
410790;201509;372;1184;312;1036;58;216;57;129;115;345
410800;201509;2804;6950;2115;5807;416;1319;793;1970;1209;3289
410810;201509;326;993;259;845;48;179;104;338;152;517
410820;201509;857;2555;636;2036;160;561;108;301;268;862
410830;201509;31384;89615;24752;77742;7227;25143;8054;24250;15281;49393
410832;201509;979;2851;847;2589;101;375;476;1361;577;1736
410840;201509;6828;20058;4296;14415;997;3624;416;1109;1413;4733
410845;201509;1264;3722;1060;3297;197;690;442;1300;639;1990
410850;201509;2753;7979;2430;7469;525;1819;1097;3357;1622;5176
410855;201509;588;1612;421;1253;82;265;151;400;233;665
410860;201509;3745;10481;2955;8966;559;1823;1129;3314;1688;5137
410865;201509;1518;5197;1436;5035;386;1495;766;2712;1152;4207
410870;201509;1147;3534;1058;3393;349;1191;511;1627;860;2818
410880;201509;3943;12070;3111;10420;673;2483;649;2004;1322;4487
410890;201509;939;3036;726;2571;175;704;67;199;242;903
410895;201509;1097;3778;965;3457;321;1235;225;740;546;1975
410900;201509;872;2394;621;1942;109;413;203;564;312;977
410910;201509;404;1076;340;966;47;154;196;540;243;694
410920;201509;824;2297;646;1973;167;577;232;676;399;1253
410930;201509;1738;5090;1471;4579;350;1297;536;1600;886;2897
410940;201509;20351;65732;17274;59885;5093;19223;4952;17240;10045;36463
410950;201509;1717;5684;1588;5436;260;930;1040;3573;1300;4503
410960;201509;7096;19582;4429;14445;1315;4688;929;2810;2244;7498
410965;201509;1038;3135;886;2847;254;866;368;1147;622;2013
410970;201509;4438;13139;3438;11133;972;3631;668;2053;1640;5684
410975;201509;1584;4540;1247;3892;218;804;467;1397;685;2201
410980;201509;5736;16079;3420;11257;689;2516;528;1629;1217;4145
410990;201509;888;2559;530;1746;166;613;74;169;240;782
411000;201509;493;1480;350;1150;67;254;69;179;136;433
411005;201509;492;1445;302;978;75;263;35;89;110;352
411007;201509;2238;7040;1911;6292;550;1926;602;1907;1152;3833
411010;201509;3827;13034;3359;11914;860;3420;553;1740;1413;5160
411020;201509;2476;7686;2186;7181;685;2525;682;2165;1367;4690
411030;201509;667;1797;486;1435;99;331;138;364;237;695
411040;201509;625;1812;293;962;50;180;70;231;120;411
411050;201509;2075;7197;1827;6630;512;2063;283;894;795;2957
411060;201509;1538;4706;1236;4043;251;917;181;513;432;1430
411065;201509;362;1077;273;896;52;179;94;293;146;472
411070;201509;5614;16829;4157;13769;1163;4246;760;2230;1923;6476
411080;201509;2153;6485;1900;6011;532;1887;536;1598;1068;3485
411090;201509;791;1933;558;1586;80;285;123;321;203;606
411095;201509;1406;4054;1040;3248;170;619;259;703;429;1322
411100;201509;1349;3911;962;3103;157;607;158;425;315;1032
411110;201509;579;1710;321;1088;40;148;40;104;80;252
411120;201509;1650;4930;1207;3944;310;1134;385;1155;695;2289
411125;201509;4168;13569;3940;13083;1151;4074;1539;4948;2690;9022
411130;201509;706;2096;529;1698;122;409;156;521;278;930
411140;201509;2082;7323;1770;6569;580;2234;529;2037;1109;4271
411150;201509;4356;12083;3286;9875;775;2566;601;1482;1376;4048
411155;201509;938;2543;706;2091;120;422;324;878;444;1300
411160;201509;221;642;178;555;39;131;43;113;82;244
411170;201509;656;2094;542;1827;132;498;182;579;314;1077
411180;201509;5556;16598;4502;14570;1064;3825;1478;4688;2542;8513
411190;201509;1455;4124;1184;3588;299;1055;317;821;616;1876
411200;201509;4221;12424;3354;10889;832;3028;1141;3506;1973;6534
411210;201509;2033;5834;1563;4925;452;1537;202;579;654;2116
411220;201509;1160;3274;901;2763;218;783;334;885;552;1668
411230;201509;1234;3406;762;2433;177;614;207;589;384;1203
411240;201509;1353;3249;718;2148;131;394;231;646;362;1040
411250;201509;2295;6694;1865;5886;510;1755;501;1529;1011;3284
411260;201509;304;838;205;660;31;109;87;265;118;374
411270;201509;1751;5510;1549;5117;314;1209;727;2286;1041;3495
411275;201509;1358;4023;1104;3433;275;908;250;701;525;1609
411280;201509;1489;4367;1027;3358;184;672;203;589;387;1261
411290;201509;782;2240;588;1805;150;494;182;519;332;1013
411295;201509;957;2698;854;2491;160;492;336;1008;496;1500
411300;201509;1328;3376;923;2584;103;331;364;928;467;1259
411310;201509;839;2312;649;1984;81;283;216;657;297;940
411320;201509;5566;16045;4003;12919;1045;3566;756;2219;1801;5785
411325;201509;1507;4745;1312;4329;276;973;684;2247;960;3220
411330;201509;3210;9883;2710;8915;895;3282;725;2310;1620;5592
411340;201509;916;2687;569;1856;77;291;197;599;274;890
411342;201509;715;2013;576;1732;150;487;186;491;336;978
411345;201509;973;3008;864;2796;226;815;383;1215;609;2030
411350;201509;2739;8029;1902;6297;491;1818;230;693;721;2511
411360;201509;552;1380;366;1054;45;167;173;431;218;598
411370;201509;46371;129956;34843;108267;6244;22380;13244;37883;19488;60263
411373;201509;1465;4549;1218;4043;274;1024;286;930;560;1954
411375;201509;1100;3019;784;2384;158;491;195;544;353;1035
411380;201509;1273;3436;728;2199;113;355;215;591;328;946
411390;201509;1793;5300;1477;4655;304;1055;459;1323;763;2378
411400;201509;2030;5826;1457;4554;264;918;368;1055;632;1973
411410;201509;2082;6216;1564;4988;347;1257;409;1070;756;2327
411420;201509;4039;11575;2781;8684;466;1635;474;1177;940;2812
411430;201509;3044;9338;2519;8417;698;2555;1090;3550;1788;6105
411435;201509;440;1427;357;1211;83;315;145;465;228;780
411440;201509;2645;8493;2354;7880;764;2728;581;2011;1345;4739
411450;201509;2224;6754;1993;6307;410;1328;1035;3357;1445;4685
411460;201509;3107;9127;1589;5540;287;1091;92;307;379;1398
411470;201509;850;2519;552;1794;80;271;90;240;170;511
411480;201509;4404;13083;3239;10795;869;3227;570;1720;1439;4947
411490;201509;1462;4378;1206;3908;279;1005;300;834;579;1839
411500;201509;1850;4942;1281;3905;268;893;344;998;612;1891
411510;201509;2028;6056;1634;5236;460;1626;320;861;780;2487
411520;201509;25812;70042;15056;47144;2918;9916;3143;9015;6061;18931
411530;201509;1017;2867;697;2264;168;608;110;296;278;904
411535;201509;518;1549;248;895;36;146;27;78;63;224
411540;201509;3034;8118;2195;6454;380;1281;937;2560;1317;3841
411545;201509;940;3142;851;2972;150;569;544;1926;694;2495
411550;201509;787;2131;626;1876;234;781;122;349;356;1130
411560;201509;2441;7221;1770;5635;325;1137;283;742;608;1879
411570;201509;6588;17673;4764;14631;1185;4130;1051;3242;2236;7372
411573;201509;869;2585;816;2491;149;481;493;1513;642;1994
411575;201509;1501;4656;1245;4087;238;831;462;1479;700;2310
411580;201509;3958;11194;2573;8290;390;1460;402;1072;792;2532
411585;201509;677;2208;371;1306;79;297;64;200;143;497
411590;201509;378;1117;321;1024;56;199;136;396;192;595
411600;201509;293;857;206;706;50;203;77;260;127;463
411605;201509;1926;5091;1243;3728;201;695;481;1345;682;2040
411610;201509;2123;5840;1783;5282;328;1057;988;2832;1316;3889
411620;201509;2661;8408;2436;8013;681;2410;1085;3618;1766;6028
411630;201509;472;1224;284;932;53;217;46;128;99;345
411640;201509;489;1432;368;1168;58;192;128;356;186;548
411650;201509;199;640;157;556;39;165;42;127;81;292
411660;201509;818;2249;626;1873;118;385;266;782;384;1167
411670;201509;1209;3334;977;2839;224;720;355;957;579;1677
411680;201509;1402;4274;1251;3996;200;655;781;2587;981;3242
411690;201509;3235;9483;2516;8069;648;2195;537;1733;1185;3928
411695;201509;781;2522;623;2171;144;549;187;650;331;1199
411700;201509;1760;5082;1209;3911;234;842;234;655;468;1497
411705;201509;2028;6913;1773;6389;398;1407;921;3477;1319;4884
411710;201509;1726;4991;1333;4157;326;1091;283;822;609;1913
411720;201509;826;2358;614;1897;89;301;176;491;265;792
411721;201509;698;2088;588;1877;162;566;76;220;238;786
411722;201509;639;1857;436;1405;86;325;120;321;206;646
411725;201509;1369;4386;834;2975;189;717;154;527;343;1244
411727;201509;1880;5444;1441;4505;343;1169;405;1158;748;2327
411729;201509;550;1476;390;1181;125;383;67;180;192;563
411730;201509;5488;15751;4528;13881;1740;5441;1125;3387;2865;8828
411740;201509;634;1800;414;1289;72;245;142;416;214;661
411745;201509;875;2540;705;2192;145;485;226;677;371;1162
411750;201509;4576;13625;3399;10887;778;2752;836;2531;1614;5283
411760;201509;7802;22602;6629;20501;2082;7003;1792;5356;3874;12359
411770;201509;3341;11152;2718;9647;829;3166;525;1779;1354;4945
411780;201509;2573;8130;2417;7898;296;1059;1606;5412;1902;6471
411790;201509;3108;8798;2211;6944;583;2092;583;1724;1166;3816
411800;201509;1215;3466;800;2590;119;441;148;398;267;839
411810;201509;1558;4530;1297;4019;274;958;443;1231;717;2189
411820;201509;13897;44262;11490;39324;4027;14305;2808;9760;6835;24065
411830;201509;486;1282;372;1096;120;373;14;49;134;422
411840;201509;10151;29162;7360;23648;1790;6265;1514;4667;3304;10932
411845;201509;516;1570;323;1074;53;194;64;180;117;374
411850;201509;6785;20234;5489;17553;1419;4875;1458;4568;2877;9443
411860;201509;872;2694;695;2312;175;615;221;698;396;1313
411870;201509;844;2792;570;2026;109;455;118;358;227;813
411880;201509;2239;6459;1805;5669;436;1582;453;1278;889;2860
411885;201509;899;2421;718;2079;136;493;241;602;377;1095
411890;201509;1071;3235;654;2194;101;386;88;219;189;605
411900;201509;966;3065;675;2330;171;596;92;318;263;914
411910;201509;1244;4089;969;3415;289;1088;244;785;533;1873
411915;201509;14964;41446;9418;29970;1835;6322;2049;5921;3884;12243
411920;201509;853;2878;727;2562;189;810;108;282;297;1092
411925;201509;597;1680;388;1277;95;316;90;269;185;585
411930;201509;5964;19324;5199;17844;2139;7791;1057;3518;3196;11309
411940;201509;3222;10726;2770;9731;710;2625;650;2181;1360;4806
411950;201509;11459;36249;9490;32342;2357;8666;4151;13883;6508;22549
411960;201509;5203;15501;4743;14629;1147;3928;1945;5824;3092;9752
411965;201509;598;1696;430;1403;82;320;147;484;229;804
411970;201509;744;2066;598;1835;191;642;200;631;391;1273
411980;201509;1609;4862;1366;4362;276;935;477;1526;753;2461
411990;201509;28090;90939;23171;80232;6198;23702;6423;21408;12621;45110
411995;201509;2513;7660;2120;6890;689;2511;494;1459;1183;3970
412000;201509;2232;5780;1747;4940;264;885;859;2176;1123;3061
412010;201509;698;2366;557;2034;103;399;122;415;225;814
412015;201509;654;1941;513;1634;104;349;235;749;339;1098
412020;201509;396;1134;268;853;56;205;103;297;159;502
412030;201509;701;2218;467;1647;79;302;111;355;190;657
412033;201509;732;2159;490;1562;78;281;122;350;200;631
412035;201509;1002;2768;674;2150;152;520;240;742;392;1262
412040;201509;585;1842;465;1567;94;336;145;459;239;795
412050;201509;1640;4768;1246;3981;230;832;278;831;508;1663
412060;201509;6780;23187;6071;21661;1938;7440;1792;6306;3730;13746
412065;201509;877;2594;671;2136;139;487;196;557;335;1044
412070;201509;1206;3280;950;2754;159;497;327;922;486;1419
412080;201509;1352;4177;772;2772;114;464;33;70;147;534
412085;201509;393;1151;138;479;35;129;28;82;63;211
412090;201509;4114;13183;3858;12701;637;2335;2334;7701;2971;10036
412100;201509;1886;5901;1574;5222;456;1652;426;1356;882;3008
412110;201509;1058;3011;700;2230;156;539;165;506;321;1045
412120;201509;1830;6144;1565;5513;412;1632;557;1757;969;3389
412125;201509;686;2167;604;2002;126;458;238;750;364;1208
412130;201509;600;1782;432;1396;103;362;74;213;177;575
412135;201509;492;1374;328;1043;74;252;119;348;193;600
412140;201509;1554;4650;1247;3997;300;1017;262;800;562;1817
412150;201509;2857;8258;2429;7398;308;1100;1465;4326;1773;5426
412160;201509;1100;3501;673;2400;161;614;89;268;250;882
412170;201509;4401;13609;3512;11811;942;3450;1226;3887;2168;7337
412175;201509;1341;4560;1143;4097;294;1157;444;1565;738;2722
412180;201509;1623;5019;1188;4147;290;1149;319;1043;609;2192
412190;201509;3126;8962;2318;7473;556;1966;650;2178;1206;4144
412200;201509;2217;7060;1514;5221;303;1140;471;1601;774;2741
412210;201509;721;1973;403;1291;61;217;44;118;105;335
412215;201509;3706;11357;3337;10684;706;2283;1906;6292;2612;8575
412217;201509;1084;3076;962;2861;120;454;642;1766;762;2220
412220;201509;5505;18122;5214;17548;1544;5347;2541;8539;4085;13886
412230;201509;2730;8937;2326;8119;519;2025;649;2086;1168;4111
412240;201509;9431;24298;5196;16139;951;3315;943;2564;1894;5879
412250;201509;1887;5524;1595;4912;406;1379;312;825;718;2204
412260;201509;1322;3646;821;2543;120;432;287;793;407;1225
412265;201509;1044;3190;920;2974;214;812;417;1326;631;2138
412270;201509;800;2522;519;1797;101;390;138;445;239;835
412280;201509;621;1943;448;1558;191;709;42;138;233;847
412290;201509;1012;2900;778;2423;156;523;257;726;413;1249
412300;201509;1887;5692;1553;5017;439;1577;350;1070;789;2647
412310;201509;1040;2990;910;2789;126;442;479;1513;605;1955
412320;201509;808;2181;563;1734;115;413;184;548;299;961
412330;201509;1549;4392;1177;3609;192;664;596;1776;788;2440
412340;201509;909;2824;574;1940;72;267;86;250;158;517
412350;201509;2281;7076;1800;5957;393;1407;177;468;570;1875
412360;201509;285;849;178;577;24;90;59;161;83;251
412370;201509;889;2605;665;2194;166;610;158;484;324;1094
412380;201509;1577;4993;1301;4311;308;1096;374;1170;682;2266
412382;201509;675;1909;456;1436;90;291;100;270;190;561
412385;201509;2415;7507;2101;6778;671;2283;456;1398;1127;3681
412390;201509;2108;6058;1889;5682;484;1605;716;2192;1200;3797
412395;201509;840;2384;665;2078;89;312;387;1174;476;1486
412400;201509;919;2901;786;2610;231;814;197;665;428;1479
412402;201509;1910;5696;1519;4856;361;1302;335;905;696;2207
412405;201509;3646;10524;2194;7191;363;1368;207;562;570;1930
412410;201509;4436;13824;3735;12450;1132;4421;744;2227;1876;6648
412420;201509;364;1048;247;777;46;152;87;224;133;376
412430;201509;546;1521;400;1224;61;209;154;428;215;637
412440;201509;3378;10138;2714;8933;603;2186;909;2959;1512;5145
412450;201509;318;1018;236;806;38;121;21;48;59;169
412460;201509;793;2369;598;1948;140;522;132;375;272;897
412470;201509;1866;6389;1589;5658;521;1959;411;1512;932;3471
412480;201509;1310;3824;870;2843;163;559;110;278;273;837
412490;201509;867;2557;731;2267;144;473;211;610;355;1083
412500;201509;1940;5595;1599;4910;320;1109;397;1045;717;2154
412510;201509;2234;7330;1870;6426;527;1941;713;2408;1240;4349
412520;201509;1475;4177;1092;3343;258;841;243;679;501;1520
412530;201509;645;1867;492;1506;102;320;126;351;228;671
412535;201509;640;1892;403;1322;88;303;85;254;173;557
412540;201509;1207;3486;934;2928;141;516;274;833;415;1349
412545;201509;801;2285;599;1805;91;321;200;506;291;827
412550;201509;28348;84493;18748;62530;4652;16552;3477;10643;8129;27195
412555;201509;301;900;203;672;39;143;45;127;84;270
412560;201509;5204;16132;3985;13502;935;3682;965;2979;1900;6661
412570;201509;4350;12802;2925;9575;672;2473;548;1718;1220;4191
412575;201509;862;2622;657;2121;153;549;170;487;323;1036
412580;201509;1229;3382;858;2674;163;529;248;721;411;1250
412590;201509;408;1186;267;872;59;223;75;232;134;455
412600;201509;1426;4293;1092;3546;228;832;321;955;549;1787
412610;201509;705;2092;472;1488;106;373;140;394;246;767
412620;201509;1199;3815;935;3225;230;893;137;407;367;1300
412625;201509;10679;29796;7845;24228;1782;5962;1341;3702;3123;9664
412627;201509;919;2834;626;2145;174;638;66;195;240;833
412630;201509;3286;10397;2659;9007;575;2007;792;2534;1367;4541
412635;201509;471;1408;306;1026;79;270;13;30;92;300
412640;201509;893;2643;575;1887;90;301;55;151;145;452
412650;201509;1802;5293;1477;4637;312;1146;462;1237;774;2383
412660;201509;2834;8214;2142;6744;413;1433;403;1136;816;2569
412665;201509;636;1652;339;1063;90;290;66;196;156;486
412667;201509;1595;4702;1235;3959;300;1054;224;652;524;1706
412670;201509;545;1704;388;1328;109;429;70;191;179;620
412680;201509;1347;4032;832;2839;142;534;203;599;345;1133
412690;201509;753;2297;549;1839;174;614;103;338;277;952
412700;201509;1850;5680;1545;5200;503;1922;427;1389;930;3311
412710;201509;7513;23197;6039;20088;1352;5058;1391;4230;2743;9288
412720;201509;1407;4329;943;3130;158;572;177;477;335;1049
412730;201509;2172;6402;1310;4381;267;996;164;399;431;1395
412740;201509;1431;4467;1059;3640;251;968;199;682;450;1650
412750;201509;3840;11903;3384;11107;535;2126;1980;6249;2515;8375
412760;201509;2232;7244;2105;7024;468;1797;1111;3535;1579;5332
412770;201509;11181;30660;6153;19656;934;3300;1117;3073;2051;6373
412780;201509;1278;4034;1095;3641;258;929;390;1226;648;2155
412785;201509;2318;6669;1701;5369;457;1563;722;2249;1179;3812
412788;201509;1394;4422;1214;4032;257;984;413;1196;670;2180
412790;201509;1113;3293;831;2706;170;618;194;541;364;1159
412795;201509;902;2512;732;2186;175;547;250;725;425;1272
412796;201509;2713;8386;2464;7879;623;2250;925;2724;1548;4974
412800;201509;3071;8755;2313;7148;416;1424;771;2260;1187;3684
412810;201509;10788;29443;5911;18625;866;3042;1252;3227;2118;6269
412820;201509;7013;20542;5017;16548;1184;4188;1071;3567;2255;7755
412830;201509;342;1047;267;872;44;177;82;226;126;403
412840;201509;1848;5269;1468;4488;273;916;308;853;581;1769
412850;201509;2716;8042;2242;7230;441;1676;875;2607;1316;4283
412853;201509;1646;4686;1447;4294;155;561;802;2191;957;2752
412855;201509;1486;4252;1136;3484;263;899;298;783;561;1682
412860;201509;1225;3493;994;3061;240;826;404;1199;644;2025
412862;201509;760;1963;509;1469;83;263;175;455;258;718
412863;201509;1178;3981;1138;3913;169;645;782;2645;951;3290
412865;201509;675;2060;501;1654;120;415;173;586;293;1001
412870;201509;896;2508;699;2167;234;796;127;348;361;1144
412880;201509;955;2682;721;2235;170;559;159;430;329;989
420005;201509;538;1601;342;1143;56;198;126;405;182;603
420010;201509;3108;8925;2546;8117;375;1241;1747;5655;2122;6896
420020;201509;791;2536;432;1579;53;238;47;130;100;368
420030;201509;523;1371;259;861;52;205;43;130;95;335
420040;201509;760;2364;471;1731;106;424;60;145;166;569
420050;201509;670;1993;456;1523;141;496;156;502;297;998
420055;201509;217;662;126;444;25;103;24;68;49;171
420060;201509;219;737;147;545;33;144;29;87;62;231
420070;201509;1431;4496;1082;3654;178;672;478;1602;656;2274
420075;201509;189;528;95;315;17;64;25;71;42;135
420080;201509;608;1894;471;1616;155;562;116;394;271;956
420090;201509;510;1711;347;1330;87;360;57;224;144;584
420100;201509;1208;3805;1081;3631;237;833;628;2116;865;2949
420110;201509;356;1183;311;1077;76;278;124;423;200;701
420120;201509;288;987;241;889;81;331;55;185;136;516
420125;201509;264;998;238;938;71;295;93;325;164;620
420127;201509;554;1641;212;776;59;227;29;97;88;324
420130;201509;1825;6063;1471;5335;352;1401;388;1235;740;2636
420140;201509;4861;14240;3303;11149;791;2967;550;1625;1341;4592
420150;201509;761;2103;447;1463;97;351;147;435;244;786
420160;201509;293;815;179;583;27;94;52;162;79;256
420165;201509;210;655;122;424;24;89;26;75;50;164
420170;201509;204;621;128;459;45;198;15;32;60;230
420180;201509;424;1299;232;841;41;159;44;155;85;314
420190;201509;474;1374;232;813;35;135;35;101;70;236
420195;201509;1348;3893;1053;3395;256;868;370;1170;626;2038
420200;201509;2936;9369;1779;6630;458;1942;270;872;728;2814
420205;201509;943;3046;810;2817;191;712;401;1398;592;2110
420207;201509;1543;4528;1052;3479;299;1116;235;699;534;1815
420208;201509;568;1577;317;1110;102;381;97;334;199;715
420209;201509;327;1004;201;699;38;150;71;233;109;383
420210;201509;1605;4913;1045;3917;249;1110;297;1041;546;2151
420213;201509;813;2902;767;2787;154;599;473;1734;627;2333
420215;201509;386;1255;255;922;69;278;38;121;107;399
420220;201509;176;593;146;531;33;142;52;155;85;297
420230;201509;4248;12386;3044;10156;609;2426;1300;4107;1909;6533
420240;201509;11580;31526;7089;23078;1135;4518;3002;8665;4137;13183
420243;201509;613;1860;480;1583;99;364;167;524;266;888
420245;201509;1133;3407;754;2580;147;559;206;619;353;1178
420250;201509;585;1859;540;1780;148;595;233;717;381;1312
420253;201509;542;1440;427;1280;69;219;236;730;305;949
420257;201509;334;944;213;715;40;141;105;347;145;488
420260;201509;1271;3990;1055;3597;234;903;451;1520;685;2423
420270;201509;556;1704;168;609;28;115;42;135;70;250
420280;201509;2349;6254;1396;4487;283;1052;485;1402;768;2454
420285;201509;145;423;58;211;6;19;4;17;10;36
420287;201509;552;1632;455;1461;135;434;147;477;282;911
420290;201509;6679;19633;4218;13944;834;3009;1196;3582;2030;6591
420300;201509;6610;19914;4195;14653;913;3465;725;2446;1638;5911
420310;201509;788;2207;714;2089;117;370;489;1384;606;1754
420315;201509;978;3112;761;2657;209;808;263;882;472;1690
420320;201509;5018;15339;4023;13502;1071;3914;1579;5198;2650;9112
420325;201509;276;909;254;854;53;211;107;333;160;544
420330;201509;1011;3478;738;2749;180;768;189;578;369;1346
420340;201509;1477;4541;1086;3629;238;883;166;460;404;1343
420350;201509;1497;4470;1133;3750;291;1039;411;1308;702;2347
420360;201509;3233;9749;2008;6998;465;1834;241;665;706;2499
420370;201509;1950;5434;1509;4624;162;507;1129;3412;1291;3919
420380;201509;5227;16323;3544;12321;861;3281;827;2763;1688;6044
420390;201509;1629;4555;822;2804;152;613;171;448;323;1061
420395;201509;1526;4657;1006;3441;160;628;163;450;323;1078
420400;201509;1334;3838;903;2971;232;901;225;637;457;1538
420410;201509;777;2079;528;1662;125;435;290;893;415;1328
420415;201509;471;1479;340;1158;100;358;95;304;195;662
420417;201509;741;2363;609;2035;98;340;323;1087;421;1427
420419;201509;404;1227;254;916;104;418;34;117;138;535
420420;201509;10994;32907;8549;27993;2730;9972;2223;6558;4953;16530
420425;201509;1340;3634;842;2625;85;328;358;1025;443;1353
420430;201509;3309;9965;2086;7148;455;1705;693;2345;1148;4050
420435;201509;306;906;184;636;41;166;75;236;116;402
420440;201509;993;3041;582;1988;227;834;99;314;326;1148
420445;201509;377;1129;270;872;52;166;117;379;169;545
420450;201509;849;2548;527;1817;115;414;121;363;236;777
420455;201509;1978;5890;1687;5375;317;1237;782;2344;1099;3581
420460;201509;8711;25267;6371;21042;1429;5488;2454;7662;3883;13150
420470;201509;1130;3062;699;2206;160;580;188;520;348;1100
420475;201509;126;371;63;218;19;66;11;32;30;98
420480;201509;4713;13744;3449;11264;1096;3988;558;1699;1654;5687
420490;201509;710;1858;382;1283;98;362;97;299;195;661
420500;201509;1695;5336;1286;4516;382;1503;501;1663;883;3166
420510;201509;108;425;94;395;36;152;34;134;70;286
420515;201509;118;400;95;353;15;67;16;59;31;126
420517;201509;924;2819;787;2563;128;469;408;1264;536;1733
420519;201509;539;1403;369;1095;59;184;108;300;167;484
420520;201509;679;1695;426;1333;89;304;159;429;248;733
420530;201509;1087;3539;793;2826;183;747;193;557;376;1304
420535;201509;281;827;149;529;36;146;8;23;44;169
420540;201509;21160;60472;14699;46389;3701;12821;3996;11083;7697;23904
420543;201509;414;1087;305;906;29;100;193;612;222;712
420545;201509;1593;4977;1255;4230;294;1114;415;1279;709;2393
420550;201509;4213;13354;3079;10837;738;3078;637;1892;1375;4970
420555;201509;408;1243;318;1057;90;335;103;312;193;647
420560;201509;545;1570;439;1369;75;253;215;650;290;903
420570;201509;2060;6594;1575;5436;416;1638;496;1568;912;3206
420580;201509;1347;4164;1056;3644;266;1043;437;1445;703;2488
420590;201509;3281;9880;2108;7124;427;1555;333;970;760;2525
420600;201509;825;2696;742;2520;130;469;388;1364;518;1833
420610;201509;534;1645;298;1098;83;343;70;243;153;586
420620;201509;774;2298;639;2057;192;659;195;614;387;1273
420630;201509;1036;3174;700;2381;158;572;217;640;375;1212
420640;201509;758;2306;358;1325;78;318;25;75;103;393
420650;201509;2541;7324;1490;5051;272;1056;322;921;594;1977
420660;201509;485;1399;382;1196;68;245;176;528;244;773
420665;201509;734;2048;453;1489;78;272;131;380;209;652
420670;201509;1652;4906;1119;3746;216;853;263;753;479;1606
420675;201509;212;650;144;490;28;103;48;148;76;251
420680;201509;514;1212;295;876;49;167;94;252;143;419
420690;201509;893;3056;629;2305;113;433;144;487;257;920
420700;201509;3727;10675;2788;8756;612;2233;851;2472;1463;4705
420710;201509;588;1949;450;1669;130;542;144;496;274;1038
420720;201509;1678;4830;1314;4331;323;1140;731;2413;1054;3553
420730;201509;3369;10012;2704;8785;678;2444;1062;3264;1740;5708
420740;201509;858;2624;693;2306;212;753;297;939;509;1692
420750;201509;2415;7622;1617;5702;285;1191;484;1468;769;2659
420757;201509;104;250;48;160;8;37;22;68;30;105
420760;201509;365;1118;216;709;46;179;56;149;102;328
420765;201509;583;1812;289;1066;55;234;51;160;106;394
420768;201509;1152;4008;880;3391;287;1161;288;1089;575;2250
420770;201509;673;1927;348;1226;72;299;83;270;155;569
420775;201509;672;2029;383;1298;96;346;69;207;165;553
420780;201509;1588;4761;942;3146;209;740;172;508;381;1248
420785;201509;313;937;223;707;33;116;59;160;92;276
420790;201509;1288;4386;992;3671;279;1147;378;1304;657;2451
420800;201509;825;2358;426;1417;109;420;101;304;210;724
420810;201509;2199;7451;1678;6201;510;2146;392;1320;902;3466
420820;201509;8186;24529;5527;19846;1448;5907;1442;5037;2890;10944
420830;201509;2605;8256;2145;7396;697;2613;725;2437;1422;5050
420840;201509;1066;3161;557;2014;133;540;112;340;245;880
420845;201509;1338;4048;945;3304;263;1075;225;700;488;1775
420850;201509;1732;5405;1010;3814;244;1057;133;452;377;1509
420860;201509;472;1316;288;958;79;313;102;314;181;627
420870;201509;1158;3227;887;2783;285;1040;268;727;553;1767
420880;201509;1069;3501;800;2801;173;674;175;531;348;1205
420890;201509;13256;32421;5627;17955;966;3423;1382;3652;2348;7075
420895;201509;244;669;123;403;34;108;12;35;46;143
420900;201509;2101;5808;1214;4050;252;985;295;861;547;1846
420910;201509;22706;67584;14554;50582;2905;11426;4031;12909;6936;24335
420915;201509;570;2209;421;1762;98;445;197;785;295;1230
420917;201509;469;1432;215;690;49;190;85;220;134;410
420920;201509;187;515;75;253;19;68;15;49;34;117
420930;201509;18861;53775;14486;46222;3436;12173;5047;15433;8483;27606
420940;201509;3250;9707;2489;8078;679;2496;391;968;1070;3464
420945;201509;208;660;131;477;25;114;34;113;59;227
420950;201509;624;1752;277;1030;38;179;40;124;78;303
420960;201509;979;2740;775;2376;164;579;357;1016;521;1595
420970;201509;2530;7916;2100;7116;599;2304;651;2091;1250;4395
420980;201509;467;1354;339;1140;109;399;120;447;229;846
420985;201509;513;1478;249;898;52;226;65;207;117;433
420990;201509;921;2512;507;1720;98;376;136;400;234;776
421000;201509;601;2029;377;1433;78;319;68;211;146;530
421003;201509;709;1931;258;854;28;90;42;86;70;176
421005;201509;194;587;150;512;34;124;81;277;115;401
421010;201509;5814;16566;3941;13083;1023;3846;913;2655;1936;6501
421020;201509;479;1493;358;1258;47;169;191;699;238;868
421030;201509;813;2967;750;2806;217;880;154;552;371;1432
421040;201509;732;2049;565;1769;122;430;279;833;401;1263
421050;201509;1665;4646;969;3159;204;750;225;600;429;1350
421055;201509;224;645;125;404;28;98;33;85;61;183
421060;201509;488;1675;332;1223;69;276;117;410;186;686
421070;201509;750;2374;467;1665;104;429;100;320;204;749
421080;201509;533;1589;452;1458;95;313;275;883;370;1196
421085;201509;575;1511;295;1003;62;239;82;292;144;531
421090;201509;401;1119;212;700;34;122;80;226;114;348
421100;201509;869;2424;498;1602;145;473;84;240;229;713
421105;201509;1495;4544;1219;4054;279;1002;452;1512;731;2514
421110;201509;1048;3773;950;3534;343;1360;218;744;561;2104
421120;201509;1445;4554;949;3309;164;671;287;869;451;1540
421125;201509;423;1186;306;975;87;318;97;271;184;589
421130;201509;3302;10680;2724;9606;879;3477;925;3202;1804;6679
421140;201509;351;1033;261;827;52;168;90;262;142;430
421145;201509;564;1777;366;1235;54;209;130;412;184;621
421150;201509;534;1617;380;1337;74;290;152;522;226;812
421160;201509;1262;3526;612;2050;107;412;221;707;328;1119
421165;201509;291;995;223;791;35;124;104;369;139;493
421170;201509;1409;4122;1123;3640;224;805;673;2154;897;2959
421175;201509;1239;3486;901;2927;208;845;320;909;528;1754
421180;201509;603;1657;310;1031;71;274;74;201;145;475
421185;201509;407;1127;278;877;53;152;135;448;188;600
421187;201509;294;876;215;705;38;132;98;303;136;435
421189;201509;423;1294;363;1174;71;256;128;380;199;636
421190;201509;11742;33749;6945;23679;1519;5663;1301;4052;2820;9715
421200;201509;945;3102;791;2761;175;676;231;724;406;1400
421205;201509;257;786;183;639;40;163;40;113;80;276
421210;201509;1656;4980;1208;3867;310;1063;312;931;622;1994
421220;201509;2058;6910;1755;6223;514;2022;379;1227;893;3249
421223;201509;622;1907;466;1594;118;435;166;541;284;976
421225;201509;1112;3476;917;3083;218;820;329;1075;547;1895
421227;201509;871;2813;766;2642;164;616;462;1559;626;2175
421230;201509;478;1524;419;1408;102;389;204;640;306;1029
421240;201509;458;1462;254;895;37;158;43;123;80;281
421250;201509;1785;5083;1098;3817;310;1191;254;823;564;2014
421260;201509;369;1033;95;349;21;75;24;80;45;155
421265;201509;635;2016;544;1844;125;447;214;708;339;1155
421270;201509;815;2182;398;1318;91;319;86;310;177;629
421280;201509;1602;5002;1263;4437;382;1508;420;1420;802;2928
421290;201509;1642;4264;831;2652;152;527;171;445;323;972
421300;201509;306;924;240;783;65;243;92;282;157;525
421310;201509;272;854;211;699;45;154;78;242;123;396
421315;201509;397;1176;219;789;42;157;22;78;64;235
421320;201509;558;1781;350;1234;58;220;45;104;103;324
421330;201509;566;1850;431;1591;144;613;72;248;216;861
421335;201509;563;1842;444;1601;105;425;88;322;193;747
421340;201509;1775;5082;1420;4503;201;789;852;2641;1053;3430
421350;201509;951;3115;755;2682;161;670;288;937;449;1607
421360;201509;3155;9031;1950;6663;398;1558;546;1678;944;3236
421370;201509;770;2532;597;2145;167;680;184;614;351;1294
421380;201509;1002;2832;791;2419;143;504;380;1125;523;1629
421390;201509;144;423;75;259;11;35;35;128;46;163
421400;201509;252;882;188;736;47;194;61;222;108;416
421410;201509;320;912;217;706;31;102;106;333;137;435
421415;201509;364;1197;159;583;39;160;35;107;74;267
421420;201509;926;2789;649;2144;133;475;183;529;316;1004
421430;201509;244;750;178;618;35;135;39;128;74;263
421440;201509;873;2477;556;1892;136;524;227;729;363;1253
421450;201509;493;1527;301;1119;70;284;38;140;108;424
421460;201509;634;1707;309;1083;49;205;72;235;121;440
421470;201509;451;1516;356;1299;95;370;126;447;221;817
421480;201509;2929;8342;1728;6044;380;1560;345;1011;725;2571
421490;201509;285;861;123;464;31;130;25;82;56;212
421500;201509;2333;7844;1907;6909;635;2602;343;1128;978;3730
421505;201509;377;1248;329;1140;69;259;159;537;228;796
421507;201509;573;1734;358;1249;69;259;115;406;184;665
421510;201509;189;614;161;564;30;139;81;237;111;376
421520;201509;861;2286;552;1647;52;190;258;684;310;874
421530;201509;406;1248;231;852;35;165;74;263;109;428
421535;201509;717;2105;398;1426;71;292;167;543;238;835
421540;201509;372;1022;297;883;61;197;121;337;182;534
421545;201509;919;2980;656;2438;172;735;169;583;341;1318
421550;201509;1957;6270;1623;5642;470;1857;433;1355;903;3212
421555;201509;340;1021;119;433;18;70;17;58;35;128
421560;201509;204;615;84;293;21;81;19;65;40;146
421565;201509;964;2832;844;2647;297;1051;338;1018;635;2069
421567;201509;772;2801;667;2548;334;1330;144;529;478;1859
421568;201509;519;1618;348;1213;79;271;85;306;164;577
421569;201509;190;591;109;401;26;108;25;75;51;183
421570;201509;1344;4067;690;2452;182;716;126;413;308;1129
421575;201509;479;1567;414;1438;70;266;262;906;332;1172
421580;201509;3501;10848;2587;8795;654;2563;612;1767;1266;4330
421590;201509;232;723;183;625;26;89;95;320;121;409
421600;201509;590;1760;442;1448;117;419;91;261;208;680
421605;201509;611;1851;432;1490;78;308;111;345;189;653
421610;201509;1466;3939;1131;3365;166;569;626;1771;792;2340
421620;201509;4665;14056;3102;10717;896;3307;914;3125;1810;6432
421625;201509;382;1090;158;546;28;101;27;89;55;190
421630;201509;2908;8669;1547;5331;356;1360;202;584;558;1944
421635;201509;269;803;156;516;26;107;74;216;100;323
421640;201509;1062;3164;798;2618;166;569;330;1030;496;1599
421650;201509;2079;6737;1631;5713;501;2004;254;732;755;2736
421660;201509;7992;25701;6351;22227;1628;6441;2021;6464;3649;12905
421670;201509;1097;3372;747;2570;221;840;196;638;417;1478
421680;201509;1233;3976;1017;3495;328;1190;200;635;528;1825
421690;201509;1801;5839;1332;4695;290;1126;184;555;474;1681
421700;201509;533;1643;299;1032;51;214;90;223;141;437
421710;201509;242;811;129;471;41;153;37;130;78;283
421715;201509;278;746;147;470;39;140;45;125;84;265
421720;201509;1846;5505;1161;4075;326;1249;230;721;556;1970
421725;201509;109;358;94;321;29;106;26;85;55;191
421730;201509;587;1697;266;923;48;185;54;141;102;326
421740;201509;738;2322;489;1715;106;451;99;255;205;706
421750;201509;954;2618;605;1905;118;401;272;796;390;1197
421755;201509;353;1013;214;677;48;177;69;195;117;372
421760;201509;679;2175;359;1295;70;275;115;397;185;672
421770;201509;3102;9224;2301;7585;652;2284;730;2392;1382;4676
421775;201509;574;1680;384;1324;80;295;110;359;190;654
421780;201509;1343;4398;994;3600;261;1074;366;1223;627;2297
421790;201509;897;2384;493;1692;124;494;145;439;269;933
421795;201509;348;1019;213;679;34;130;61;187;95;317
421800;201509;2656;7929;1964;6585;425;1642;789;2423;1214;4065
421810;201509;642;2015;454;1618;115;438;58;192;173;630
421820;201509;1118;3219;687;2312;117;439;158;467;275;906
421825;201509;1427;4593;1313;4321;195;770;773;2405;968;3175
421830;201509;2481;8409;2233;7919;508;2077;1034;3495;1542;5572
421835;201509;148;431;106;368;23;106;62;199;85;305
421840;201509;357;1145;270;941;70;283;88;273;158;556
421850;201509;422;1297;254;884;55;234;68;225;123;459
421860;201509;355;1066;219;771;37;136;47;142;84;278
421870;201509;4438;12504;2979;9518;839;2885;580;1761;1419;4646
421875;201509;440;1304;187;694;39;164;28;93;67;257
421880;201509;918;2825;683;2309;154;588;171;530;325;1118
421885;201509;315;995;248;862;83;320;83;268;166;588
421890;201509;945;3165;798;2870;252;1036;257;873;509;1909
421895;201509;366;1196;320;1111;77;266;172;621;249;887
421900;201509;930;2647;601;1944;160;564;161;442;321;1006
421910;201509;540;1716;365;1314;71;303;93;286;164;589
421915;201509;560;1674;357;1181;72;244;94;270;166;514
421917;201509;578;1704;418;1437;126;519;122;383;248;902
421920;201509;812;2260;527;1863;245;928;147;488;392;1416
421930;201509;3352;8907;1897;6271;449;1679;341;977;790;2656
421935;201509;720;2347;517;1890;104;447;185;627;289;1074
421940;201509;277;932;135;501;23;97;21;57;44;154
421950;201509;3891;10742;1894;6443;468;1701;305;1004;773;2705
421960;201509;225;679;172;563;44;161;40;107;84;268
421970;201509;2251;6385;1399;4553;470;1627;316;914;786;2541
421985;201509;520;1336;278;841;47;180;76;227;123;407
422000;201509;1018;3032;834;2683;204;715;334;1099;538;1814
430003;201509;843;2470;649;2123;177;660;190;590;367;1250
430005;201509;296;921;232;793;45;166;114;369;159;535
430010;201509;2144;5791;1561;4774;403;1304;624;1914;1027;3218
430020;201509;755;1890;624;1705;71;210;427;1129;498;1339
430030;201509;1070;2789;784;2270;256;823;152;391;408;1214
430040;201509;11697;30200;8975;25484;2579;7833;2030;5419;4609;13252
430045;201509;747;2009;575;1658;117;352;271;757;388;1109
430047;201509;285;702;162;488;24;67;69;209;93;276
430050;201509;1233;3320;692;2201;127;429;182;536;309;965
430055;201509;307;828;167;519;27;98;70;199;97;297
430057;201509;70;156;25;67;4;12;7;10;11;22
430060;201509;16140;51625;13820;47417;3804;13856;6019;20871;9823;34727
430063;201509;1001;2929;801;2509;201;667;403;1276;604;1943
430064;201509;1526;4457;1232;3925;305;987;515;1650;820;2637
430066;201509;171;413;122;333;11;37;67;172;78;209
430070;201509;612;1640;219;699;45;169;53;130;98;299
430080;201509;700;2005;427;1461;81;310;128;385;209;695
430085;201509;836;2189;542;1672;118;402;190;588;308;990
430087;201509;1051;3159;976;3032;134;476;643;1901;777;2377
430090;201509;889;2350;324;1074;35;131;48;164;83;295
430100;201509;887;2320;500;1514;121;406;156;405;277;811
430105;201509;952;2820;639;2210;177;685;187;626;364;1311
430107;201509;270;887;192;664;39;150;53;165;92;315
430110;201509;1903;5436;1544;4845;443;1425;611;1886;1054;3311
430120;201509;1720;5070;1286;4154;262;889;637;2007;899;2896
430130;201509;3871;10075;3325;9263;728;2206;1481;4012;2209;6218
430140;201509;1236;3732;841;2854;236;817;257;856;493;1673
430150;201509;831;2204;541;1652;131;434;144;424;275;858
430155;201509;444;1256;257;858;40;144;98;315;138;459
430160;201509;16627;48451;14790;45334;2979;10007;7270;22203;10249;32210
430163;201509;1881;5535;1525;4871;267;936;735;2335;1002;3271
430165;201509;462;1134;134;441;22;74;33;100;55;174
430170;201509;944;2645;359;1275;56;197;40;119;96;316
430175;201509;954;2976;764;2519;203;618;310;1107;513;1725
430180;201509;902;2435;726;2135;165;544;385;1075;550;1619
430185;201509;688;1724;350;1068;52;169;108;279;160;448
430187;201509;683;2009;514;1642;117;435;186;549;303;984
430190;201509;1756;5194;1507;4704;291;1026;847;2597;1138;3623
430192;201509;200;607;89;283;6;19;21;59;27;78
430195;201509;336;1019;82;280;9;33;5;16;14;49
430200;201509;1531;4848;1277;4296;383;1364;302;986;685;2350
430205;201509;551;1580;417;1337;46;179;296;934;342;1113
430210;201509;6574;17507;3506;11006;671;2291;763;2153;1434;4444
430215;201509;379;1043;251;766;47;143;97;277;144;420
430220;201509;769;1934;287;954;47;181;54;170;101;351
430222;201509;307;904;234;739;37;147;107;311;144;458
430223;201509;348;996;299;923;69;215;175;560;244;775
430225;201509;40;106;20;63;5;13;7;18;12;31
430230;201509;1813;5239;1686;5110;204;473;1445;4565;1649;5038
430235;201509;288;938;223;776;54;207;61;188;115;395
430237;201509;548;1408;392;1139;44;147;243;685;287;832
430240;201509;1009;2618;654;1997;133;480;266;750;399;1230
430245;201509;920;2845;697;2375;179;625;317;1111;496;1736
430250;201509;1285;3622;1102;3293;409;1293;234;671;643;1964
430258;201509;169;475;122;389;11;37;54;179;65;216
430260;201509;846;2381;570;1824;61;202;300;998;361;1200
430265;201509;319;966;241;800;51;163;21;59;72;222
430270;201509;2932;8168;2490;7430;383;1353;1409;3977;1792;5330
430280;201509;4735;12835;3768;11089;905;2749;1616;4740;2521;7489
430290;201509;2450;6414;2237;6118;167;482;1914;5274;2081;5756
430300;201509;9398;27554;7584;24034;1979;6708;3091;9989;5070;16697
430310;201509;6566;19773;5119;16966;1302;4752;1869;5742;3171;10494
430320;201509;867;2498;550;1837;103;289;268;956;371;1245
430330;201509;745;1970;571;1633;156;451;237;625;393;1076
430340;201509;773;1934;420;1374;72;265;207;673;279;938
430350;201509;6270;19212;5239;17007;1824;6146;1662;5279;3486;11425
430355;201509;377;946;142;438;29;95;18;47;47;142
430360;201509;1094;2848;897;2481;178;567;399;998;577;1565
430367;201509;264;694;164;513;44;163;58;172;102;335
430370;201509;518;1477;381;1206;109;385;91;255;200;640
430380;201509;876;2237;452;1447;127;448;127;392;254;840
430390;201509;4304;12132;2862;9145;640;2179;599;1797;1239;3976
430400;201509;1442;3436;987;2717;311;917;339;854;650;1771
430410;201509;700;1852;507;1525;105;333;235;695;340;1028
430420;201509;3883;11115;2952;9053;774;2455;1193;3578;1967;6033
430430;201509;777;2071;468;1495;135;468;117;361;252;829
430435;201509;2066;5556;1539;4594;352;1122;674;1967;1026;3089
430440;201509;4120;12855;3175;10695;668;2363;1433;4956;2101;7319
430450;201509;7834;21658;6045;18148;2059;6531;1341;4003;3400;10534
430460;201509;29230;85580;21898;72125;5959;21556;6820;21962;12779;43518
430461;201509;529;1413;159;506;24;78;31;88;55;166
430462;201509;317;903;231;747;79;282;56;159;135;441
430463;201509;4108;12980;3512;11841;770;2808;1677;5719;2447;8527
430465;201509;641;1716;528;1519;158;499;254;697;412;1196
430466;201509;3615;9933;3166;9221;596;1911;1812;5135;2408;7046
430467;201509;562;1645;483;1506;102;359;214;621;316;980
430468;201509;1446;4038;1241;3726;366;1190;442;1281;808;2471
430469;201509;332;930;64;228;7;32;9;25;16;57
430470;201509;7679;20439;5301;16315;1555;5192;915;2660;2470;7852
430471;201509;671;2186;588;2006;178;623;148;519;326;1142
430480;201509;1085;2822;542;1713;85;308;135;369;220;677
430485;201509;227;647;105;352;17;60;34;112;51;172
430490;201509;388;1064;245;787;52;189;102;326;154;515
430495;201509;402;1183;248;862;47;180;54;169;101;349
430500;201509;1275;3520;1032;3103;302;1018;433;1255;735;2273
430510;201509;20512;60121;16398;52218;5570;19482;4588;13501;10158;32983
430511;201509;433;1321;178;625;19;76;25;66;44;142
430512;201509;1205;3091;1021;2766;258;731;355;1006;613;1737
430513;201509;758;2045;468;1420;99;309;178;529;277;838
430515;201509;504;1476;364;1173;62;209;184;600;246;809
430517;201509;1252;3908;1032;3454;211;718;577;1938;788;2656
430520;201509;1650;4557;1144;3507;293;977;373;1042;666;2019
430530;201509;1083;2969;535;1717;77;280;132;385;209;665
430535;201509;2187;6609;1645;5486;362;1350;600;1913;962;3263
430537;201509;493;1565;419;1411;51;170;298;1016;349;1186
430540;201509;774;1719;511;1360;90;251;295;773;385;1024
430543;201509;520;1337;455;1270;85;252;319;905;404;1157
430544;201509;690;2168;572;1918;111;395;298;975;409;1370
430545;201509;1320;4212;1126;3969;378;1417;465;1680;843;3097
430550;201509;682;1953;428;1399;89;329;130;399;219;728
430558;201509;83;242;42;146;11;50;8;20;19;70
430560;201509;427;1056;244;736;27;91;79;224;106;315
430570;201509;1175;3008;738;2135;189;653;279;661;468;1314
430580;201509;1318;3352;751;2367;178;615;257;802;435;1417
430583;201509;169;468;56;188;3;15;5;17;8;32
430585;201509;359;932;225;646;57;191;96;238;153;429
430587;201509;218;659;187;601;57;194;57;185;114;379
430590;201509;1305;3661;1225;3529;179;546;849;2422;1028;2968
430593;201509;29;111;26;100;7;35;11;36;18;71
430595;201509;259;712;88;305;15;65;14;40;29;105
430597;201509;349;1017;235;738;30;106;69;181;99;287
430600;201509;2190;5889;1235;3763;235;769;401;1158;636;1927
430605;201509;1373;4134;1074;3527;239;901;419;1386;658;2287
430607;201509;768;1886;555;1562;81;248;347;994;428;1242
430610;201509;8588;22722;6405;19223;1759;5712;1978;5854;3737;11566
430613;201509;269;658;113;338;27;76;22;53;49;129
430620;201509;763;2181;592;1820;149;486;233;670;382;1156
430630;201509;471;1441;226;749;39;128;31;83;70;211
430632;201509;736;2018;409;1272;71;255;168;461;239;716
430635;201509;713;1948;507;1546;106;359;241;718;347;1077
430637;201509;513;1456;446;1320;65;229;278;777;343;1006
430640;201509;1755;4612;765;2467;78;253;86;169;164;422
430642;201509;489;1290;295;925;54;183;115;345;169;528
430645;201509;259;631;99;291;18;51;20;67;38;118
430650;201509;1880;6086;1600;5522;349;1221;884;3117;1233;4338
430655;201509;173;476;144;417;30;102;68;168;98;270
430660;201509;5751;16188;4478;13927;1142;3875;1777;5454;2919;9329
430670;201509;502;1462;452;1364;38;115;345;1077;383;1192
430673;201509;733;1744;349;1049;76;232;129;378;205;610
430675;201509;275;794;110;354;17;60;46;144;63;204
430676;201509;3599;10738;2958;9571;799;2794;982;3162;1781;5956
430680;201509;1247;3582;772;2520;149;524;215;608;364;1132
430690;201509;4400;12333;3420;10378;1073;3347;940;2863;2013;6210
430692;201509;295;969;212;795;22;91;134;498;156;589
430693;201509;1380;3807;891;2785;158;578;249;701;407;1279
430695;201509;551;1562;383;1210;77;282;150;422;227;704
430697;201509;485;1356;366;1145;98;299;129;425;227;724
430700;201509;10033;25827;4636;15191;831;3065;307;925;1138;3990
430705;201509;285;858;243;780;84;299;60;169;144;468
430710;201509;1844;4658;1356;3829;304;932;520;1486;824;2418
430720;201509;922;2252;604;1790;140;448;201;585;341;1033
430730;201509;1720;4522;1165;3602;311;947;434;1409;745;2356
430740;201509;581;1608;328;1088;91;322;58;183;149;505
430745;201509;517;1468;259;826;48;171;42;117;90;288
430750;201509;1700;4633;1326;3979;258;855;655;1875;913;2730
430755;201509;578;1518;364;1055;38;130;159;409;197;539
430760;201509;3216;7828;2203;6326;460;1543;945;2777;1405;4320
430770;201509;6798;19461;5175;16406;991;3429;2605;8140;3596;11569
430780;201509;2528;6689;1447;4576;289;982;441;1329;730;2311
430781;201509;595;1712;399;1311;85;286;120;374;205;660
430783;201509;540;1332;336;989;65;210;149;403;214;613
430786;201509;79;257;52;184;8;31;24;81;32;112
430790;201509;4766;12934;3188;9727;726;2475;1137;3144;1863;5619
430800;201509;885;2556;587;1853;126;435;197;586;323;1021
430805;201509;549;1506;357;1121;46;141;179;578;225;719
430807;201509;433;1237;286;898;61;219;79;235;140;454
430810;201509;800;2152;369;1202;58;209;77;220;135;429
430820;201509;1290;3950;848;2857;183;672;227;717;410;1389
430825;201509;416;1090;171;519;34;103;45;115;79;218
430830;201509;2078;6234;1902;5963;264;893;1275;3981;1539;4874
430840;201509;982;2997;884;2810;226;729;417;1372;643;2101
430843;201509;103;296;50;163;10;39;17;51;27;90
430845;201509;346;1037;278;896;108;371;23;61;131;432
430850;201509;2651;7731;2208;6886;512;1733;871;2632;1383;4365
430860;201509;1028;2745;521;1689;143;540;158;461;301;1001
430865;201509;681;1780;612;1671;215;616;280;736;495;1352
430870;201509;709;1984;381;1260;93;309;73;204;166;513
430880;201509;1296;3636;929;2910;268;902;245;791;513;1693
430885;201509;245;604;141;445;19;66;86;270;105;336
430890;201509;1835;4794;1250;3677;163;587;402;1051;565;1638
430900;201509;2932;7717;2425;6828;528;1761;1158;2988;1686;4749
430905;201509;1061;2980;642;2070;156;545;149;455;305;1000
430910;201509;1581;4641;1107;3634;262;958;432;1292;694;2250
430912;201509;503;1409;393;1214;58;207;240;724;298;931
430915;201509;561;1757;375;1382;116;451;91;355;207;806
430920;201509;15531;47054;13656;43479;2993;10513;7717;23814;10710;34327
430925;201509;105;254;54;160;15;50;24;69;39;119
430930;201509;9657;27677;6606;21687;1799;6357;1727;5735;3526;12092
430940;201509;1230;3720;735;2481;132;496;154;454;286;950
430950;201509;1124;3090;740;2281;170;596;281;767;451;1363
430955;201509;144;432;65;210;15;54;19;61;34;115
430957;201509;271;888;218;787;56;216;96;348;152;564
430960;201509;1396;3765;1138;3300;304;980;492;1459;796;2439
430965;201509;1521;4368;1287;3965;93;341;976;2949;1069;3290
430970;201509;544;1512;315;1020;64;223;85;264;149;487
430975;201509;635;2030;480;1659;82;311;235;814;317;1125
430980;201509;449;1124;269;844;62;208;95;276;157;484
430990;201509;628;1985;451;1542;109;389;99;317;208;706
430995;201509;643;1876;517;1618;182;597;165;484;347;1081
431000;201509;1730;4386;842;2587;149;528;92;228;241;756
431010;201509;2758;7693;1605;5316;307;1124;353;1000;660;2124
431020;201509;12278;30065;7662;21676;1936;5608;2057;5775;3993;11383
431030;201509;367;1063;174;611;45;185;32;109;77;294
431033;201509;2425;7042;2123;6592;537;1790;1029;3261;1566;5051
431036;201509;209;532;80;272;15;53;17;46;32;99
431040;201509;982;2781;771;2425;171;608;365;1106;536;1714
431041;201509;545;1476;490;1399;162;475;192;561;354;1036
431043;201509;406;1270;276;973;115;445;69;201;184;646
431046;201509;118;335;81;253;11;40;28;83;39;123
431050;201509;1795;4493;1360;3764;273;854;768;2060;1041;2914
431053;201509;625;1994;500;1719;144;543;120;416;264;959
431055;201509;681;1854;631;1769;55;167;475;1329;530;1496
431057;201509;399;1165;240;824;52;185;61;199;113;384
431060;201509;5772;16774;5228;15999;1618;4878;2413;7695;4031;12573
431065;201509;555;1576;414;1284;73;258;186;533;259;791
431070;201509;751;2164;433;1424;93;312;75;207;168;519
431075;201509;297;899;206;703;34;123;58;207;92;330
431080;201509;650;2015;514;1716;103;382;129;404;232;786
431085;201509;905;2429;691;1993;111;340;379;1076;490;1416
431087;201509;621;1749;535;1580;66;188;362;1086;428;1274
431090;201509;545;1320;247;749;66;197;55;166;121;363
431100;201509;3822;10570;3030;9174;772;2512;1042;3140;1814;5652
431110;201509;1586;4170;1165;3323;251;753;489;1299;740;2052
431112;201509;605;1916;557;1821;150;496;255;812;405;1308
431113;201509;528;1541;405;1289;112;375;114;378;226;753
431115;201509;1420;4059;1225;3724;237;752;705;2148;942;2900
431120;201509;2717;8340;2114;7115;633;2454;697;2103;1330;4557
431123;201509;499;1432;350;1148;75;261;189;631;264;892
431125;201509;1371;4148;995;3335;302;1008;248;895;550;1903
431127;201509;253;671;51;164;5;12;7;19;12;31
431130;201509;3531;9947;2558;8147;524;1869;901;2797;1425;4666
431140;201509;4646;11433;2452;7631;403;1369;583;1549;986;2918
431142;201509;488;1439;435;1340;41;133;307;961;348;1094
431150;201509;1171;3467;880;2881;191;696;326;1050;517;1746
431160;201509;984;2857;825;2535;141;427;413;1369;554;1796
431162;201509;529;1380;238;804;33;143;26;55;59;198
431164;201509;171;466;41;148;7;27;3;12;10;39
431170;201509;796;2176;540;1697;144;489;158;474;302;963
431171;201509;835;2454;700;2183;232;769;192;570;424;1339
431173;201509;494;1426;427;1312;107;352;240;734;347;1086
431175;201509;1087;3015;923;2748;274;863;316;911;590;1774
431177;201509;912;2909;736;2557;236;931;307;1016;543;1947
431179;201509;373;817;89;261;12;42;23;56;35;98
431180;201509;2313;6642;1589;5123;390;1325;382;1113;772;2438
431190;201509;738;1895;362;1156;61;223;85;254;146;477
431198;201509;379;1251;332;1158;136;494;85;313;221;807
431200;201509;394;1102;106;364;18;52;3;10;21;62
431205;201509;304;910;146;491;34;109;46;155;80;264
431210;201509;769;2074;643;1856;181;515;323;961;504;1476
431213;201509;255;768;203;670;39;157;92;288;131;445
431215;201509;334;976;168;568;26;82;12;26;38;108
431217;201509;200;611;150;499;42;146;50;167;92;313
431220;201509;959;2562;579;1767;74;243;265;741;339;984
431225;201509;1359;3808;1085;3314;230;746;550;1652;780;2398
431230;201509;889;2545;651;2057;82;275;336;1026;418;1301
431235;201509;109;308;31;96;5;16;6;14;11;30
431237;201509;513;1506;402;1338;101;403;200;642;301;1045
431238;201509;47;154;38;133;8;32;14;50;22;82
431240;201509;3026;9029;2634;8398;873;2998;807;2542;1680;5540
431242;201509;383;1203;334;1105;97;327;107;373;204;700
431244;201509;415;976;251;698;42;142;125;312;167;454
431245;201509;1166;3036;830;2422;131;408;456;1295;587;1703
431247;201509;197;561;141;447;44;146;29;83;73;229
431250;201509;1590;4965;1359;4624;369;1350;580;1974;949;3324
431260;201509;359;1001;177;610;32;128;58;182;90;310
431261;201509;246;851;212;772;36;166;73;236;109;402
431262;201509;415;1127;182;598;23;97;80;259;103;356
431265;201509;1493;3871;807;2450;155;512;201;489;356;1001
431267;201509;171;474;135;410;30;110;74;208;104;318
431270;201509;2778;6985;1829;5422;472;1562;631;1828;1103;3390
431275;201509;229;699;118;437;35;132;11;36;46;168
431280;201509;314;872;128;425;16;59;31;79;47;138
431290;201509;330;1015;249;825;62;242;53;147;115;389
431295;201509;102;271;54;158;4;14;26;69;30;83
431300;201509;379;949;49;185;5;20;2;9;7;29
431301;201509;269;826;122;412;27;97;24;70;51;167
431303;201509;766;2019;435;1326;70;257;132;363;202;620
431306;201509;2335;6067;1509;4563;171;620;478;1255;649;1875
431308;201509;45;154;40;137;23;84;12;39;35;123
431310;201509;820;2437;485;1662;99;340;141;506;240;846
431320;201509;932;2521;485;1583;93;328;113;334;206;662
431330;201509;2817;6905;1280;4047;328;1171;110;293;438;1464
431333;201509;454;1219;194;599;27;94;52;137;79;231
431335;201509;62;189;47;155;13;42;11;25;24;67
431337;201509;2439;7417;1779;6036;415;1475;331;1050;746;2525
431339;201509;661;1801;453;1376;76;245;206;610;282;855
431340;201509;25955;68535;18485;55394;4324;14064;5159;14935;9483;28999
431342;201509;548;1412;439;1226;144;431;211;556;355;987
431344;201509;358;989;261;812;13;40;197;621;210;661
431346;201509;330;842;136;408;26;83;24;67;50;150
431349;201509;724;2069;482;1486;99;308;142;421;241;729
431350;201509;4087;11933;3340;10546;697;2498;1362;4038;2059;6536
431360;201509;702;1791;462;1383;115;365;142;428;257;793
431365;201509;1196;3522;1012;3211;274;934;474;1533;748;2467
431370;201509;4988;14026;3869;12055;1075;3640;1204;3744;2279;7384
431380;201509;953;2939;872;2751;131;466;546;1669;677;2135
431390;201509;3294;8656;1963;6079;389;1368;559;1533;948;2901
431395;201509;1269;3733;1059;3375;238;857;515;1581;753;2438
431400;201509;326;1020;158;541;35;134;21;52;56;186
431402;201509;1310;3061;735;2037;149;443;356;935;505;1378
431403;201509;277;800;194;649;53;194;31;104;84;298
431405;201509;4213;11621;3333;10317;664;2335;1683;5055;2347;7390
431406;201509;797;2429;580;1952;167;604;252;823;419;1427
431407;201509;558;1605;359;1193;86;287;98;293;184;580
431410;201509;14270;40891;9592;31591;2851;10552;1250;3941;4101;14493
431413;201509;231;568;107;335;9;30;36;104;45;134
431415;201509;762;2111;556;1732;126;460;212;582;338;1042
431417;201509;650;1582;518;1393;67;187;305;828;372;1015
431420;201509;1418;3883;1225;3577;262;806;571;1759;833;2565
431430;201509;534;1385;321;959;64;208;108;276;172;484
431440;201509;23480;65478;18918;57977;5487;17833;6492;20711;11979;38544
431442;201509;145;407;93;280;16;55;13;23;29;78
431445;201509;521;1465;229;722;35;109;86;260;121;369
431446;201509;475;1378;326;1063;78;264;109;347;187;611
431447;201509;704;1978;505;1574;111;354;207;649;318;1003
431449;201509;828;2311;646;1974;67;211;387;1186;454;1397
431450;201509;2182;5452;1917;5056;317;915;1333;3425;1650;4340
431454;201509;66;242;57;219;16;65;22;90;38;155
431455;201509;728;1847;378;1083;100;281;96;254;196;535
431460;201509;3492;9637;2931;8555;796;2347;960;2904;1756;5251
431470;201509;1857;5468;1406;4445;347;1094;480;1519;827;2613
431475;201509;185;537;43;168;6;24;1;4;7;28
431477;201509;748;1942;498;1442;58;182;269;742;327;924
431478;201509;271;695;100;300;18;52;20;53;38;105
431480;201509;3081;8475;2248;6953;588;2010;794;2322;1382;4332
431490;201509;112400;302919;95092;276695;12061;41438;65340;184799;77401;226237
431500;201509;719;1948;546;1614;116;345;268;768;384;1113
431505;201509;510;1226;353;1000;28;70;242;702;270;772
431507;201509;358;867;224;607;41;104;131;345;172;449
431510;201509;2110;5751;1606;4776;357;1136;627;1724;984;2860
431513;201509;299;810;134;425;19;62;67;209;86;271
431514;201509;103;267;36;125;4;19;2;5;6;24
431515;201509;734;2110;500;1538;106;372;195;496;301;868
431517;201509;81;256;71;230;17;56;21;55;38;111
431520;201509;498;1365;255;822;34;132;40;115;74;247
431530;201509;4306;10204;3238;8927;1101;3263;961;2780;2062;6043
431531;201509;289;818;186;605;37;120;63;205;100;325
431532;201509;519;1442;438;1263;118;369;169;472;287;841
431535;201509;406;1048;180;545;29;94;60;159;89;253
431540;201509;2136;6965;1866;6558;224;789;1188;4391;1412;5180
431545;201509;316;867;48;167;5;18;8;30;13;48
431550;201509;2321;6772;2032;6237;389;1356;935;2748;1324;4104
431555;201509;728;1840;566;1583;97;271;343;966;440;1237
431560;201509;19476;58425;13870;47228;3490;13205;3338;11732;6828;24937
431570;201509;5341;14720;4662;13616;1301;3871;2112;6289;3413;10160
431575;201509;434;1095;300;869;46;155;78;194;124;349
431580;201509;684;1924;424;1343;87;309;144;416;231;725
431590;201509;1004;2727;606;1894;94;285;233;734;327;1019
431595;201509;477;1353;369;1128;59;180;194;600;253;780
431600;201509;2025;5620;1392;4418;311;1190;337;948;648;2138
431610;201509;1478;4320;1086;3538;219;729;439;1425;658;2154
431620;201509;464;1373;229;735;58;200;93;269;151;469
431630;201509;1482;3947;961;2878;257;791;334;967;591;1758
431640;201509;6163;17564;5483;16528;1186;3977;2974;8875;4160;12852
431642;201509;528;1415;415;1215;60;197;201;567;261;764
431643;201509;211;521;147;392;23;65;60;138;83;203
431645;201509;1820;5152;1563;4721;304;982;869;2609;1173;3591
431647;201509;179;513;113;355;22;76;21;54;43;130
431650;201509;312;961;214;757;32;126;51;157;83;283
431660;201509;1198;3334;722;2328;153;541;168;470;321;1011
431670;201509;1340;3515;987;2872;218;735;413;1099;631;1834
431673;201509;229;634;122;395;26;90;19;52;45;142
431675;201509;641;1721;178;594;30;106;33;86;63;192
431680;201509;10325;27735;7478;22499;2016;6502;1967;5918;3983;12420
431690;201509;24413;67426;18791;58001;5185;17080;6506;20514;11691;37594
431695;201509;137;408;91;293;19;61;18;39;37;100
431697;201509;456;1295;399;1184;99;296;189;578;288;874
431700;201509;1607;4546;1345;4032;243;781;722;2091;965;2872
431710;201509;12963;37161;10365;32796;3277;11232;2568;8491;5845;19723
431720;201509;7334;20089;5511;16539;1192;3931;2044;5912;3236;9843
431725;201509;22;64;12;39;2;5;4;11;6;16
431730;201509;3959;11540;3066;9895;838;2946;802;2655;1640;5601
431740;201509;5331;14806;4180;12656;1360;4527;783;2126;2143;6653
431750;201509;9590;26885;8158;24531;1816;5932;3914;11884;5730;17816
431755;201509;325;891;70;247;14;49;13;42;27;91
431760;201509;3966;11368;3113;9782;712;2434;1080;3214;1792;5648
431770;201509;2107;5581;1728;4975;331;991;972;2752;1303;3743
431775;201509;216;582;147;451;50;159;20;55;70;214
431780;201509;2473;6630;1847;5443;479;1493;420;1131;899;2624
431790;201509;1275;3906;1057;3473;185;655;588;1950;773;2605
431795;201509;394;1077;241;738;39;131;88;261;127;392
431800;201509;8942;26254;6976;22423;2129;7392;1328;4030;3457;11422
431805;201509;328;792;96;323;17;66;14;44;31;110
431810;201509;3450;9489;2646;7856;513;1651;1143;3287;1656;4938
431820;201509;2690;8318;2297;7540;481;1721;938;2964;1419;4685
431830;201509;10918;26831;8427;23102;2384;7067;3235;8911;5619;15978
431840;201509;2775;8201;2365;7482;591;2015;1036;3282;1627;5297
431842;201509;817;2041;349;1055;48;159;85;215;133;374
431843;201509;359;1042;294;919;41;147;151;452;192;599
431844;201509;255;688;106;341;21;80;26;66;47;146
431845;201509;526;1533;418;1298;37;125;268;845;305;970
431846;201509;375;1124;329;1053;38;147;224;695;262;842
431848;201509;239;644;125;411;14;47;26;78;40;125
431849;201509;443;1084;88;266;18;58;16;35;34;93
431850;201509;4971;14349;4316;13091;1028;3316;1716;5154;2744;8470
431860;201509;807;2103;593;1743;121;393;279;761;400;1154
431861;201509;101;300;53;190;6;21;8;27;14;48
431862;201509;478;1545;379;1347;105;419;94;290;199;709
431870;201509;18823;53199;14398;45340;3671;12599;4633;14446;8304;27045
431880;201509;4409;13005;3430;10934;794;2820;1305;3941;2099;6761
431890;201509;5326;14245;3868;11586;1190;3781;1024;3071;2214;6852
431900;201509;1095;3102;716;2324;188;688;286;835;474;1523
431910;201509;1029;2441;466;1345;75;214;149;395;224;609
431912;201509;621;1760;477;1488;142;425;151;497;293;922
431915;201509;1370;3674;1031;3069;235;731;395;1166;630;1897
431920;201509;1356;3758;1179;3479;128;382;878;2583;1006;2965
431930;201509;1270;3469;905;2847;234;717;411;1358;645;2075
431935;201509;64;195;52;169;12;49;20;51;32;100
431936;201509;399;1167;298;945;55;172;143;475;198;647
431937;201509;345;887;191;572;47;152;35;88;82;240
431940;201509;2673;7232;1707;5295;404;1332;447;1344;851;2676
431950;201509;1662;5025;1424;4599;274;994;653;2010;927;3004
431960;201509;3027;8746;2627;7946;672;2166;862;2526;1534;4692
431970;201509;501;1355;248;795;40;155;60;164;100;319
431971;201509;109;306;75;239;7;22;29;79;36;101
431973;201509;495;1697;426;1546;58;209;254;967;312;1176
431975;201509;96;219;16;65;5;25;2;4;7;29
431980;201509;1432;4146;1163;3593;274;911;373;1080;647;1991
431990;201509;7978;21906;5898;18340;1076;3875;1923;5555;2999;9430
432000;201509;10477;28939;8067;24690;2489;8010;2707;8133;5196;16143
432010;201509;2307;6500;1873;5704;402;1300;878;2646;1280;3946
432020;201509;2369;5794;1820;5048;243;735;1235;3373;1478;4108
432023;201509;544;1558;350;1134;70;239;103;308;173;547
432026;201509;1278;3818;923;3040;152;489;483;1586;635;2075
432030;201509;413;1195;308;963;60;192;145;431;205;623
432032;201509;599;1552;389;1163;68;211;177;491;245;702
432035;201509;843;2568;738;2366;279;947;246;798;525;1745
432040;201509;1017;2403;473;1473;101;352;130;369;231;721
432045;201509;234;680;139;491;27;105;53;191;80;296
432050;201509;670;1862;566;1668;98;290;328;998;426;1288
432055;201509;854;2535;677;2190;125;441;384;1202;509;1643
432057;201509;435;1078;324;892;47;130;208;550;255;680
432060;201509;521;1372;194;650;39;146;41;123;80;269
432065;201509;216;614;165;523;40;142;60;177;100;319
432067;201509;1000;3064;718;2439;147;534;350;1174;497;1708
432070;201509;2424;6616;1544;4781;350;1185;359;999;709;2184
432080;201509;3722;10579;3137;9532;991;3208;1022;3054;2013;6262
432085;201509;317;879;208;698;45;163;99;330;144;493
432090;201509;1502;4284;1166;3589;360;1195;427;1223;787;2418
432100;201509;1349;3882;661;2245;124;430;83;211;207;641
432110;201509;2723;8121;1998;6596;498;1861;266;745;764;2606
432120;201509;5111;14928;4238;13391;1557;5246;1182;3606;2739;8852
432130;201509;2637;7331;2100;6612;726;2539;725;2207;1451;4746
432132;201509;433;1223;206;704;26;107;67;211;93;318
432135;201509;708;2165;668;2089;87;300;493;1515;580;1815
432140;201509;2034;6401;1600;5552;376;1371;676;2433;1052;3804
432143;201509;1421;4143;1180;3723;229;733;568;1867;797;2600
432145;201509;1189;3638;695;2442;132;512;121;378;253;890
432146;201509;209;656;136;480;33;130;32;105;65;235
432147;201509;664;2063;490;1681;135;489;151;527;286;1016
432149;201509;372;1049;228;710;49;156;90;282;139;438
432150;201509;3803;10524;2767;8601;616;2136;856;2512;1472;4648
432160;201509;4521;14092;3890;13005;1189;4107;1379;4804;2568;8911
432162;201509;396;954;71;227;9;34;15;39;24;73
432163;201509;406;1073;92;293;5;17;6;20;11;37
432166;201509;734;2151;597;1872;89;332;302;904;391;1236
432170;201509;1059;3290;668;2420;135;505;117;408;252;913
432180;201509;2973;7868;1961;5991;484;1558;511;1520;995;3078
432183;201509;433;1334;341;1138;143;506;64;198;207;704
432185;201509;938;2516;572;1819;115;379;240;761;355;1140
432190;201509;3429;9359;2279;6782;553;1745;656;1788;1209;3533
432195;201509;1244;3357;988;2946;133;431;598;1722;731;2153
432200;201509;3277;9718;2565;8470;639;2310;1135;3775;1774;6085
432210;201509;435;1184;316;985;76;273;130;364;206;637
432215;201509;876;2689;741;2469;139;423;435;1547;574;1970
432218;201509;299;781;202;585;39;114;75;192;114;306
432220;201509;4316;11329;3482;10018;387;1307;2169;6053;2556;7360
432225;201509;71;223;61;206;23;84;20;62;43;146
432230;201509;1103;2944;645;1941;145;477;173;418;318;895
432232;201509;559;1612;432;1364;91;304;163;514;254;818
432234;201509;418;1138;273;806;59;172;89;250;148;422
432235;201509;81;225;38;133;9;39;4;9;13;48
432237;201509;477;1307;436;1242;22;86;329;906;351;992
432240;201509;14196;44610;11842;41354;2034;8307;6808;24379;8842;32686
432250;201509;4917;16612;4408;15579;1524;5891;1373;4812;2897;10703
432252;201509;396;1116;283;927;54;188;156;514;210;702
432253;201509;1333;4189;849;2940;220;833;156;515;376;1348
432254;201509;834;2263;227;757;56;201;29;84;85;285
432255;201509;243;618;127;418;30;103;36;112;66;215
432260;201509;7711;19136;5222;15005;1222;3591;2017;6021;3239;9612
432270;201509;2599;7659;2143;6851;602;1960;806;2668;1408;4628
432280;201509;1365;3727;690;2228;121;430;156;434;277;864
432285;201509;193;611;51;177;10;40;9;22;19;62
432290;201509;579;1710;362;1205;86;295;111;357;197;652
432300;201509;23438;69257;20384;63920;4045;13748;11418;35338;15463;49086
432310;201509;867;2524;691;2225;145;519;366;1140;511;1659
432320;201509;252;640;124;384;27;83;24;61;51;144
432330;201509;313;817;122;405;14;48;8;22;22;70
432335;201509;205;585;85;290;18;60;11;37;29;97
432340;201509;396;963;184;561;32;104;57;168;89;272
432345;201509;681;1889;621;1791;92;336;370;976;462;1312
432350;201509;402;1087;204;676;32;102;62;195;94;297
432360;201509;176;544;36;134;11;48;9;27;20;75
432370;201509;432;1198;338;1008;40;117;218;656;258;773
432375;201509;803;2008;613;1698;81;225;359;1004;440;1229
432377;201509;199;649;51;171;9;30;14;33;23;63
432380;201509;851;2853;753;2671;284;1118;281;932;565;2050
500020;201509;2274;6729;1698;5668;371;1460;690;2172;1061;3632
500025;201509;1310;3051;803;2168;97;281;467;1222;564;1503
500060;201509;6780;19972;5385;17643;705;2425;3424;11601;4129;14026
500070;201509;4198;12136;3449;10819;720;2528;1493;4599;2213;7127
500080;201509;1528;4491;1119;3725;304;1113;373;1239;677;2352
500085;201509;2254;5854;1604;4872;185;608;932;2724;1117;3332
500090;201509;2370;6746;1709;5539;354;1185;779;2571;1133;3756
500100;201509;2545;7389;2157;6682;479;1734;947;2727;1426;4461
500110;201509;8726;25229;6859;22302;1128;3999;3526;12018;4654;16017
500124;201509;2028;6485;1737;6004;343;1100;917;3508;1260;4608
500150;201509;1429;3546;1002;2852;195;664;431;1030;626;1694
500190;201509;4908;12650;3803;11179;743;2349;2125;6365;2868;8714
500200;201509;2503;6245;1845;5082;379;1135;749;1929;1128;3064
500210;201509;4820;14255;3978;12882;883;3017;1890;6154;2773;9171
500215;201509;1635;4958;1275;4219;216;796;496;1566;712;2362
500220;201509;2939;9151;2407;8211;506;1836;954;3340;1460;5176
500230;201509;2765;6933;1954;5654;475;1501;852;2466;1327;3967
500240;201509;4735;14615;3329;11675;541;2038;1171;4329;1712;6367
500260;201509;2737;6996;1994;5833;313;1025;966;2677;1279;3702
500270;201509;121003;308540;74124;226225;17858;58757;16765;49961;34623;108718
500280;201509;1404;3626;1172;3320;105;326;879;2515;984;2841
500290;201509;4338;10026;2522;7286;530;1731;848;2270;1378;4001
500295;201509;2628;7751;1703;5595;302;1090;412;1136;714;2226
500310;201509;833;2144;686;1930;151;499;331;873;482;1372
500315;201509;3142;9679;2594;8814;399;1409;1581;5560;1980;6969
500320;201509;16781;53301;13137;46326;3818;14610;3885;14287;7703;28897
500325;201509;4070;10334;2916;8515;611;1947;1498;4344;2109;6291
500330;201509;6503;17255;4759;14051;901;2909;2160;6224;3061;9133
500345;201509;2206;5715;1693;4892;311;983;892;2531;1203;3514
500348;201509;2381;6729;2066;6227;147;536;1519;4521;1666;5057
500350;201509;1247;3733;735;2519;99;364;230;816;329;1180
500370;201509;23258;69800;17277;58565;3868;14713;5180;17395;9048;32108
500375;201509;2927;7959;2127;6427;480;1518;623;1830;1103;3348
500380;201509;3003;8376;2395;7283;671;2103;891;2722;1562;4825
500390;201509;598;1284;354;918;41;128;222;525;263;653
500400;201509;1309;3935;955;3092;227;815;248;700;475;1515
500410;201509;2270;6314;1804;5616;471;1624;807;2490;1278;4114
500430;201509;2479;7044;1931;6243;402;1467;829;2730;1231;4197
500440;201509;1524;3967;1024;3108;186;632;475;1378;661;2010
500450;201509;1750;5240;1272;4282;271;1026;259;754;530;1780
500460;201509;3655;10931;2761;9141;735;2686;646;2015;1381;4701
500470;201509;3054;8878;2068;6713;531;1920;316;904;847;2824
500480;201509;2109;6535;1948;6321;192;630;1464;5014;1656;5644
500490;201509;981;2692;745;2276;215;751;213;633;428;1384
500500;201509;3692;11407;2857;10095;1127;4549;711;2435;1838;6984
500510;201509;850;2188;528;1610;71;239;223;621;294;860
500515;201509;1846;4909;1511;4457;260;796;857;2737;1117;3533
500520;201509;3032;10276;2692;9760;434;1705;1682;6216;2116;7921
500525;201509;1173;3711;937;3248;190;736;419;1482;609;2218
500540;201509;6214;17018;3488;11716;928;3652;516;1466;1444;5118
500560;201509;4654;15142;4213;14458;549;2095;2968;10201;3517;12296
500568;201509;3953;10075;2780;8267;578;2029;1046;2859;1624;4888
500570;201509;7600;20177;4908;15051;1296;4245;1083;3144;2379;7389
500580;201509;3709;10443;2935;9163;301;1001;2044;6436;2345;7437
500600;201509;3848;10185;2471;7554;575;1904;803;2378;1378;4282
500620;201509;7725;21876;5718;18066;1144;3969;2531;7974;3675;11943
500625;201509;783;2295;421;1448;90;338;122;410;212;748
500627;201509;524;1541;409;1335;83;276;110;383;193;659
500630;201509;6106;16505;4331;13465;1079;3730;1338;4000;2417;7730
500635;201509;2714;10102;2178;9229;317;1288;1363;6346;1680;7634
500640;201509;1636;3942;1234;3363;96;312;881;2344;977;2656
500660;201509;19030;54154;14531;46761;4235;15423;4451;14038;8686;29461
500690;201509;2811;7990;2209;7211;894;3023;702;2491;1596;5514
500710;201509;3687;10842;3088;9815;681;2462;1390;4286;2071;6748
500720;201509;6045;16005;3756;11897;1021;3530;970;2918;1991;6448
500730;201509;988;2733;684;2113;159;554;212;613;371;1167
500740;201509;3998;10968;3287;9631;426;1528;1494;4444;1920;5972
500750;201509;878;2416;758;2246;134;417;426;1261;560;1678
500755;201509;1229;3566;836;2724;174;628;213;562;387;1190
500769;201509;5082;13453;2959;8999;525;1809;663;1669;1188;3478
500770;201509;1727;5043;1259;4165;323;1157;351;1176;674;2333
500780;201509;1111;3195;888;2774;237;807;282;807;519;1614
500790;201509;9272;25469;7660;22697;1348;4610;4244;12134;5592;16744
500793;201509;2269;6462;1725;5502;436;1511;500;1422;936;2933
500795;201509;2477;7247;2086;6695;264;725;1480;5052;1744;5777
500797;201509;852;2284;594;1834;102;332;224;647;326;979
500800;201509;2732;7371;2119;6508;810;2834;615;1867;1425;4701
500830;201509;18729;50362;12617;38613;2576;8683;4097;11787;6673;20470
500840;201509;1318;3659;900;2814;115;384;379;1128;494;1512
510010;201509;1264;3754;1041;3389;279;917;498;1651;777;2568
510020;201509;3417;9714;2131;7076;465;1657;585;1826;1050;3483
510025;201509;7969;22975;6292;19888;1483;5157;2225;6469;3708;11626
510030;201509;1743;4719;1415;4193;302;1014;666;1858;968;2872
510035;201509;854;2400;669;2142;127;420;380;1234;507;1654
510040;201509;1715;4635;1304;4021;227;775;691;2127;918;2902
510050;201509;1873;5403;1316;4345;355;1270;377;1220;732;2490
510060;201509;1617;4586;1176;3729;227;769;465;1423;692;2192
510080;201509;1149;3551;886;3033;273;1057;171;510;444;1567
510100;201509;674;1797;471;1386;55;174;210;579;265;753
510120;201509;315;667;197;516;20;56;122;321;142;377
510125;201509;3121;8189;2366;6826;422;1482;986;2559;1408;4041
510130;201509;1870;5063;1491;4433;398;1244;522;1545;920;2789
510140;201509;2926;9319;2323;8363;935;3780;531;1659;1466;5439
510160;201509;1356;4508;1240;4343;167;648;866;3024;1033;3672
510170;201509;5423;16159;4402;14368;840;3046;2074;6498;2914;9544
510180;201509;12055;31355;8419;25581;2391;7616;2664;8951;5055;16567
510185;201509;1368;3980;1107;3632;154;478;733;2632;887;3110
510190;201509;2255;6564;1535;5458;339;1322;709;2604;1048;3926
510250;201509;14029;42363;11820;39082;3478;12501;4561;15422;8039;27923
510260;201509;2235;8930;1915;8244;566;2540;806;3881;1372;6421
510263;201509;4262;11261;3022;9186;733;2371;884;2531;1617;4902
510267;201509;5865;16811;4113;13076;939;3262;1173;3492;2112;6754
510268;201509;836;2448;711;2256;145;493;403;1258;548;1751
510269;201509;1028;3105;768;2598;245;857;201;679;446;1536
510270;201509;2686;8625;2267;7764;398;1394;1019;3463;1417;4857
510279;201509;1970;6051;1597;5197;436;1539;463;1326;899;2865
510285;201509;1361;3992;1052;3440;283;1004;356;1105;639;2109
510300;201509;3310;9663;2733;8820;207;781;2060;6668;2267;7449
510305;201509;1564;4753;1197;4039;296;1083;402;1300;698;2383
510310;201509;833;2498;703;2247;223;760;228;684;451;1444
510320;201509;3419;9845;2633;8349;693;2565;678;1980;1371;4545
510325;201509;5279;16597;4456;15463;1194;4265;2623;9399;3817;13664
510330;201509;2797;8717;2213;7672;573;2210;755;2573;1328;4783
510335;201509;4802;14437;3924;13311;527;1736;2793;10033;3320;11769
510336;201509;591;1779;448;1504;83;303;222;731;305;1034
510337;201509;2144;6968;1711;6094;661;2438;328;1206;989;3644
510340;201509;72841;197462;51522;163959;17750;62352;10049;33098;27799;95450
510343;201509;1103;3176;925;2891;96;328;687;2169;783;2497
510345;201509;1665;4869;1332;4269;341;1167;467;1435;808;2602
510350;201509;3384;9166;2571;7999;627;2072;1162;3737;1789;5809
510360;201509;1782;4372;1141;3578;132;493;778;2378;910;2871
510370;201509;1150;3828;986;3564;206;775;600;2228;806;3003
510380;201509;548;1651;369;1285;134;506;44;130;178;636
510385;201509;977;3635;722;3050;97;438;334;1532;431;1970
510390;201509;1121;3436;1027;3315;280;722;635;2318;915;3040
510395;201509;742;1838;547;1564;86;261;238;785;324;1046
510410;201509;3799;12306;3360;11419;821;2931;1724;5935;2545;8866
510420;201509;2415;6102;1743;4978;209;747;890;2479;1099;3226
510450;201509;589;1582;433;1343;105;361;147;435;252;796
510452;201509;630;2030;447;1610;96;391;202;693;298;1084
510454;201509;850;2673;725;2426;118;426;453;1540;571;1966
510455;201509;970;2979;715;2448;145;569;225;728;370;1297
510460;201509;2247;5873;1715;5104;227;830;987;2758;1214;3588
510480;201509;4535;12048;3170;9488;734;2307;762;2126;1496;4433
510490;201509;1624;5029;1353;4600;281;1076;736;2417;1017;3493
510500;201509;1498;4446;1025;3486;252;994;400;1287;652;2281
510510;201509;2705;9346;2332;8661;745;3024;780;2840;1525;5864
510515;201509;6101;18504;4526;15029;1019;3724;1089;3388;2108;7112
510517;201509;1723;5103;1407;4518;452;1507;432;1352;884;2859
510520;201509;2058;4868;1481;4132;64;211;1066;3088;1130;3299
510523;201509;1016;2997;886;2789;149;477;589;1902;738;2379
510525;201509;7954;20391;5198;15934;1092;3488;1924;5833;3016;9321
510530;201509;515;1438;428;1314;53;234;262;755;315;989
510550;201509;2601;8541;2153;7681;619;2354;702;2473;1321;4827
510558;201509;1950;5534;1613;5042;341;1168;791;2523;1132;3691
510560;201509;1662;5087;1086;4075;309;1242;242;917;551;2159
510562;201509;5392;15843;4177;13378;1184;4158;1118;3571;2302;7729
510590;201509;3070;8158;2506;7434;560;1682;1290;3963;1850;5645
510600;201509;1571;4057;1041;3170;186;607;423;1210;609;1817
510610;201509;2820;8065;2364;7393;169;598;1763;5516;1932;6114
510615;201509;2268;6814;1894;6204;557;1958;872;2876;1429;4834
510617;201509;599;1808;491;1616;40;119;387;1330;427;1449
510618;201509;1432;4178;1016;3347;182;698;446;1405;628;2103
510619;201509;821;2265;481;1616;71;255;62;167;133;422
510620;201509;1488;3645;793;2554;199;715;121;361;320;1076
510621;201509;903;3177;796;2942;209;855;251;885;460;1740
510622;201509;3841;11570;2589;8857;680;2517;349;969;1029;3486
510623;201509;3454;9806;2743;8486;725;2426;1064;3102;1789;5528
510624;201509;1384;4128;960;3253;203;788;264;772;467;1560
510625;201509;2160;6094;1634;5201;419;1481;371;1131;790;2612
510626;201509;1549;4128;1004;3351;308;1161;294;969;602;2130
510627;201509;741;2086;484;1541;119;422;108;324;227;746
510628;201509;1601;3928;1133;3294;114;366;809;2337;923;2703
510629;201509;1719;5496;1399;4794;420;1627;444;1413;864;3040
510630;201509;2536;8550;1869;7121;482;2059;360;1351;842;3410
510631;201509;379;1063;338;1001;41;112;253;750;294;862
510637;201509;2696;7835;2308;7200;648;2170;932;2886;1580;5056
510642;201509;4670;15281;4015;14328;1196;4686;1751;6429;2947;11115
510645;201509;955;2144;592;1642;182;486;172;512;354;998
510650;201509;6262;20864;5632;20095;1349;5048;3486;12881;4835;17929
510665;201509;1364;3700;896;2809;220;724;292;889;512;1613
510670;201509;395;883;205;609;21;83;98;273;119;356
510675;201509;6384;19973;5072;17337;1409;5462;1245;4030;2654;9492
510677;201509;2073;5438;1646;4892;198;598;1218;3786;1416;4384
510680;201509;755;2249;580;1891;127;457;185;533;312;990
510682;201509;2239;6963;1713;5956;445;1754;378;1200;823;2954
510685;201509;942;2515;765;2275;96;327;495;1443;591;1770
510700;201509;4318;11167;2914;9142;637;2086;1438;4626;2075;6712
510704;201509;9197;24437;7504;21759;1486;4793;3872;10933;5358;15726
510706;201509;1909;5707;1356;4833;305;1124;716;2645;1021;3769
510710;201509;3443;9491;2380;7305;569;1841;578;1575;1147;3416
510715;201509;702;1722;439;1245;94;289;159;414;253;703
510718;201509;2244;5623;1493;4751;692;2290;411;1423;1103;3713
510719;201509;439;1004;277;792;30;125;136;363;166;488
510720;201509;1156;2766;899;2435;230;690;422;1060;652;1750
510724;201509;776;2322;634;2057;142;515;314;957;456;1472
510726;201509;619;1609;461;1342;94;290;178;481;272;771
510729;201509;755;1868;443;1302;100;335;163;460;263;795
510730;201509;2642;7753;2088;6771;546;1951;677;2078;1223;4029
510735;201509;1089;3590;847;3183;192;818;410;1525;602;2343
510740;201509;1105;2723;802;2269;193;514;408;1210;601;1724
510757;201509;675;2284;551;2027;186;706;188;706;374;1412
510760;201509;29701;77219;20049;60866;5759;19001;5152;15132;10911;34133
510770;201509;4335;11156;3683;10382;366;998;2471;7715;2837;8713
510774;201509;414;1145;351;1041;73;254;166;510;239;764
510775;201509;738;2133;605;1908;200;702;160;462;360;1164
510776;201509;532;1498;408;1232;88;296;183;535;271;831
510777;201509;1606;4769;1212;4218;175;648;907;3198;1082;3846
510779;201509;674;1984;498;1649;75;258;241;817;316;1075
510780;201509;3624;10892;3006;9897;761;2618;1287;4409;2048;7027
510785;201509;1819;5203;1360;4410;441;1492;329;1060;770;2552
510787;201509;2198;6616;1723;5767;632;2229;375;1197;1007;3426
510788;201509;535;1398;381;1168;168;527;92;304;260;831
510790;201509;15805;45521;10428;35097;2326;8980;1259;3990;3585;12970
510792;201509;7715;23097;5201;18089;1099;4320;906;2834;2005;7154
510794;201509;1181;3731;980;3352;341;1286;294;923;635;2209
510795;201509;8302;24594;5955;20100;1568;5807;1378;4731;2946;10538
510800;201509;1638;4579;1314;4093;304;1053;556;1584;860;2637
510805;201509;1917;5322;1526;4741;233;771;1005;3135;1238;3906
510810;201509;679;1651;514;1426;142;398;231;621;373;1019
510820;201509;746;1778;506;1412;98;317;200;489;298;806
510830;201509;684;2146;577;1979;158;596;283;1033;441;1629
510835;201509;648;1958;482;1618;130;487;177;542;307;1029
510840;201509;49490;120739;38194;106103;9046;26498;18312;52153;27358;78651
510850;201509;1515;4294;1095;3538;330;1183;184;473;514;1656
510860;201509;2510;8035;1827;6611;728;2866;98;301;826;3167
510880;201509;663;2170;562;1995;171;669;236;850;407;1519
510885;201509;630;1748;500;1571;98;346;194;591;292;937
510890;201509;874;2708;706;2438;203;792;276;870;479;1662
510895;201509;1110;3417;932;3073;238;899;369;1129;607;2028
520005;201509;1362;4340;1210;4115;333;1194;570;1970;903;3164
520010;201509;1629;5462;1323;4815;508;2150;267;828;775;2978
520013;201509;3555;9801;2601;8021;596;1940;940;2862;1536;4802
520015;201509;444;1289;362;1161;85;289;137;443;222;732
520017;201509;1089;3228;905;2920;236;850;357;1064;593;1914
520020;201509;408;1078;317;948;68;215;144;415;212;630
520025;201509;25456;79011;24176;77448;2603;9019;19462;62223;22065;71242
520030;201509;4517;14060;3784;12829;783;2925;1797;6096;2580;9021
520050;201509;318;848;248;731;20;53;178;532;198;585
520055;201509;727;2205;630;2004;118;368;332;1081;450;1449
520060;201509;1378;4270;1175;3858;256;959;460;1434;716;2393
520080;201509;1753;5210;1495;4846;322;1033;839;2867;1161;3900
520082;201509;927;2666;824;2498;129;361;531;1705;660;2066
520085;201509;941;2858;794;2570;169;567;261;827;430;1394
520090;201509;975;2227;710;1892;162;399;360;1043;522;1442
520110;201509;41575;119972;31951;105079;11512;42897;6249;19705;17761;62602
520120;201509;197;548;132;431;33;134;34;103;67;237
520130;201509;3424;9643;3096;9137;785;2554;1451;4221;2236;6775
520140;201509;38772;124475;33055;113536;11206;42157;6948;22703;18154;64860
520145;201509;372;981;279;828;68;213;117;330;185;543
520150;201509;506;1325;397;1198;61;208;248;747;309;955
520160;201509;796;2246;650;2027;206;674;189;591;395;1265
520170;201509;4111;9574;3233;8573;297;830;2565;6912;2862;7742
520180;201509;2040;5953;1658;5332;355;1351;701;2155;1056;3506
520215;201509;1887;4858;1568;4347;208;594;975;2724;1183;3318
520235;201509;710;1840;523;1563;115;388;217;610;332;998
520250;201509;1364;4100;1046;3537;275;1043;311;998;586;2041
520260;201509;786;2003;526;1522;78;245;218;595;296;840
520280;201509;500;1489;457;1432;165;545;161;569;326;1114
520310;201509;1143;2726;832;2245;220;626;306;882;526;1508
520320;201509;1790;5570;1465;4934;152;542;917;3147;1069;3689
520330;201509;2621;8108;1959;6903;516;1984;343;1119;859;3103
520340;201509;1828;4542;1414;4026;217;544;944;2877;1161;3421
520350;201509;3084;8437;2385;7143;594;1995;986;2799;1580;4794
520355;201509;1042;3489;935;3315;316;1222;349;1176;665;2398
520357;201509;794;2127;662;1917;51;167;476;1356;527;1523
520360;201509;665;1917;580;1773;127;418;258;799;385;1217
520380;201509;1299;3464;854;2606;150;484;341;1014;491;1498
520390;201509;1010;2381;603;1841;166;595;218;593;384;1188
520393;201509;495;1241;388;1086;57;170;235;641;292;811
520396;201509;733;2330;614;2098;76;306;392;1313;468;1619
520400;201509;1698;4805;1445;4451;239;794;915;2787;1154;3581
520410;201509;1382;3439;1044;2970;215;669;577;1623;792;2292
520420;201509;321;894;228;690;46;147;64;172;110;319
520425;201509;1109;3013;927;2695;249;763;457;1320;706;2083
520430;201509;2002;5229;1255;3839;277;937;401;1098;678;2035
520440;201509;3683;9406;2452;7242;733;2349;542;1577;1275;3926
520450;201509;10347;28829;7156;22826;1635;5678;862;2463;2497;8141
520455;201509;680;2014;542;1769;157;559;165;533;322;1092
520460;201509;852;2439;694;2168;133;481;351;1045;484;1526
520465;201509;788;2217;680;2086;118;395;413;1262;531;1657
520470;201509;1738;5591;1555;5298;361;1238;959;3431;1320;4669
520480;201509;972;2778;722;2351;129;460;344;1048;473;1508
520485;201509;1226;3886;1054;3595;284;1092;561;1886;845;2978
520490;201509;3859;12075;3075;10827;931;3398;1329;4827;2260;8225
520495;201509;1245;3423;1086;3217;99;309;890;2671;989;2980
520500;201509;1382;3832;1145;3484;316;1029;473;1409;789;2438
520505;201509;823;2267;683;2063;161;491;348;1055;509;1546
520510;201509;9551;26728;6647;21936;1717;6226;1991;6688;3708;12914
520520;201509;1082;2993;849;2646;254;819;289;911;543;1730
520530;201509;1991;6513;1673;5954;575;2045;529;1999;1104;4044
520540;201509;2881;8103;2170;6776;569;1892;499;1504;1068;3396
520545;201509;1099;3287;901;2886;197;672;290;873;487;1545
520547;201509;697;2208;600;2023;215;750;194;610;409;1360
520549;201509;9646;27895;7945;25673;2313;7839;3762;12269;6075;20108
520551;201509;3454;10463;3176;10067;893;3121;1837;5737;2730;8858
520552;201509;774;2311;696;2202;101;349;480;1532;581;1881
520570;201509;533;1529;379;1259;151;534;79;240;230;774
520580;201509;3268;8149;2195;6589;623;2118;858;2492;1481;4610
520590;201509;1415;3950;1099;3400;256;825;268;758;524;1583
520620;201509;7197;22402;6511;21395;1584;5480;3619;12003;5203;17483
520630;201509;755;1950;550;1648;128;378;249;754;377;1132
520640;201509;2814;7806;2286;6917;649;2034;898;2773;1547;4807
520650;201509;842;2267;631;1871;143;463;300;868;443;1331
520660;201509;345;983;269;871;93;330;88;278;181;608
520670;201509;867;2591;784;2473;48;170;664;2098;712;2268
520680;201509;614;1698;491;1525;122;382;230;723;352;1105
520690;201509;371;966;260;804;58;156;118;392;176;548
520710;201509;542;1394;325;955;6;15;197;570;203;585
520725;201509;1612;4070;1208;3442;229;704;708;2000;937;2704
520735;201509;760;2150;551;1739;135;481;169;505;304;986
520740;201509;1614;4519;1297;4100;249;886;684;2121;933;3007
520750;201509;599;1607;474;1416;91;266;248;776;339;1042
520753;201509;1300;3662;1192;3503;152;429;835;2582;987;3011
520760;201509;853;2311;745;2161;101;316;529;1580;630;1896
520780;201509;1913;4631;1538;4124;167;418;1054;2840;1221;3258
520790;201509;2706;7127;2185;6377;256;725;1547;4664;1803;5389
520800;201509;15391;44737;13390;42328;2826;8625;8172;27565;10998;36190
520810;201509;1034;2563;829;2317;135;367;580;1723;715;2090
520815;201509;572;1832;425;1526;157;646;22;58;179;704
520830;201509;1525;4088;1263;3808;44;144;1068;3219;1112;3363
520840;201509;1400;4564;1159;4117;375;1480;246;883;621;2363
520850;201509;590;1810;446;1545;109;416;178;584;287;1000
520860;201509;6552;18715;4853;16041;1310;4651;1867;6300;3177;10951
520870;201509;109826;290730;73311;228926;20148;69644;17500;51537;37648;121181
520880;201509;7133;20300;5200;17319;1634;6140;771;2469;2405;8609
520890;201509;3739;10571;3033;9395;644;2164;1461;4525;2105;6689
520910;201509;3779;11045;2745;8995;893;3136;503;1563;1396;4699
520915;201509;763;2178;593;1863;129;423;262;798;391;1221
520920;201509;3329;9025;2307;7345;526;1794;753;2467;1279;4261
520929;201509;517;1425;389;1227;78;242;220;718;298;960
520940;201509;1029;3013;853;2749;92;349;607;1933;699;2282
520945;201509;732;1720;574;1454;180;410;242;615;422;1025
520960;201509;881;2625;700;2267;78;250;345;1152;423;1402
520970;201509;3175;9402;2625;8407;631;2229;801;2455;1432;4684
520980;201509;765;2194;688;2084;245;805;305;898;550;1703
520990;201509;2893;9400;2734;9168;473;1651;1850;6412;2323;8063
520993;201509;1020;2626;818;2327;63;195;576;1651;639;1846
520995;201509;2311;6285;2055;5962;325;966;1438;4226;1763;5192
521000;201509;6848;20685;5698;18614;1462;5341;1874;5777;3336;11118
521010;201509;3893;11400;3014;9740;734;2513;1060;3454;1794;5967
521015;201509;667;1838;560;1664;143;407;260;783;403;1190
521020;201509;3493;9965;2292;7476;623;2158;281;850;904;3008
521030;201509;613;1583;504;1405;101;277;245;696;346;973
521040;201509;5818;15748;4904;14373;1752;5260;1850;5753;3602;11013
521056;201509;867;2653;721;2405;245;867;258;908;503;1775
521060;201509;1306;3438;1047;3042;238;667;467;1426;705;2093
521080;201509;1221;2880;734;2074;95;339;283;652;378;991
521090;201509;2936;7848;2261;6963;676;2178;722;2279;1398;4457
521100;201509;1866;4162;1464;3731;286;652;955;2623;1241;3275
521120;201509;4365;12017;3547;10860;894;2945;1456;4478;2350;7423
521130;201509;1021;2768;775;2301;122;434;438;1261;560;1695
521140;201509;991;3059;810;2700;232;818;250;835;482;1653
521150;201509;12888;32923;7979;23605;2732;8628;1826;5314;4558;13942
521160;201509;843;1996;510;1416;103;298;221;592;324;890
521170;201509;1210;2893;910;2466;192;548;502;1317;694;1865
521180;201509;6491;21276;5811;20014;1921;7052;1644;5678;3565;12730
521190;201509;9510;26897;6301;21063;1666;5977;1525;5068;3191;11045
521200;201509;746;1964;620;1760;81;261;377;1031;458;1292
521205;201509;577;1649;440;1399;45;158;246;769;291;927
521210;201509;934;2571;618;1945;203;739;158;387;361;1126
521220;201509;4027;10641;3051;9301;905;3003;1145;3462;2050;6465
521225;201509;366;903;295;824;35;88;211;622;246;710
521230;201509;1185;3722;1079;3509;348;1226;528;1661;876;2887
521250;201509;27550;88037;24512;83280;10146;36807;6976;23725;17122;60532
521260;201509;713;1744;584;1554;92;314;365;894;457;1208
521270;201509;1845;5490;1693;5271;144;357;1322;4323;1466;4680
521280;201509;1863;5656;1499;4929;450;1559;430;1369;880;2928
521290;201509;480;1381;365;1197;99;363;143;460;242;823
521295;201509;1090;2806;936;2589;120;350;714;2007;834;2357
521300;201509;1970;5471;1650;4946;269;790;947;2904;1216;3694
521305;201509;780;2182;635;1953;122;345;350;1124;472;1469
521308;201509;4467;13137;3490;11200;912;2995;1374;4365;2286;7360
521310;201509;7628;22587;5517;18447;1424;5221;1164;3575;2588;8796
521340;201509;245;663;220;626;16;48;171;486;187;534
521350;201509;1899;5227;1581;4737;225;654;1052;3272;1277;3926
521370;201509;957;2814;742;2438;223;804;197;622;420;1426
521375;201509;1263;3763;1046;3349;235;832;475;1417;710;2249
521377;201509;1067;2735;994;2656;76;150;866;2393;942;2543
521380;201509;5140;14603;3681;11821;685;2358;816;2695;1501;5053
521385;201509;476;1334;426;1268;104;334;230;674;334;1008
521390;201509;902;2432;694;2150;180;639;221;661;401;1300
521400;201509;2120;5926;1918;5674;246;812;1480;4389;1726;5201
521405;201509;1373;3870;1065;3308;279;946;476;1471;755;2417
521410;201509;704;2149;643;2051;234;712;286;988;520;1700
521440;201509;1359;3873;1200;3520;157;518;673;1777;830;2295
521450;201509;4133;13106;3314;11516;1059;3981;679;2243;1738;6224
521460;201509;6431;18749;5420;17025;1357;4628;2584;7983;3941;12611
521470;201509;709;2003;520;1630;108;369;90;263;198;632
521480;201509;411;1218;282;924;62;205;104;332;166;537
521483;201509;2832;7382;2167;6234;590;1754;646;1794;1236;3548
521486;201509;1546;3946;1291;3572;119;333;962;2664;1081;2997
521487;201509;624;1603;431;1279;129;398;76;217;205;615
521490;201509;760;2240;622;2013;65;293;402;1254;467;1547
521500;201509;1327;4203;1019;3512;199;770;292;864;491;1634
521520;201509;896;2117;675;1821;182;499;309;888;491;1387
521523;201509;12510;45658;11507;43820;4312;17598;1595;6646;5907;24244
521525;201509;1040;2706;901;2518;118;389;601;1623;719;2012
521530;201509;1624;4633;991;3322;219;779;173;529;392;1308
521540;201509;946;2529;637;1997;148;550;204;592;352;1142
521550;201509;1103;2808;892;2428;217;632;431;1137;648;1769
521560;201509;3846;12682;3277;11853;1241;4944;1092;3837;2333;8781
521565;201509;640;1600;536;1473;85;205;353;998;438;1203
521570;201509;4458;12421;2925;9311;702;2450;727;2235;1429;4685
521580;201509;575;1322;381;1046;98;281;125;319;223;600
521590;201509;680;1899;550;1684;167;561;116;346;283;907
521600;201509;530;1437;381;1179;102;334;96;264;198;598
521630;201509;1422;3564;1008;2954;252;870;198;478;450;1348
521640;201509;1996;5119;1533;4479;443;1344;619;1874;1062;3218
521645;201509;597;1744;458;1427;76;255;172;490;248;745
521680;201509;1449;4593;1210;4107;586;2151;185;566;771;2717
521690;201509;569;1666;497;1540;120;436;222;616;342;1052
521710;201509;2638;8127;2211;7250;490;1684;911;2980;1401;4664
521720;201509;1825;5180;1481;4580;293;926;833;2489;1126;3415
521730;201509;3664;11980;3203;11061;1192;4557;712;2165;1904;6722
521740;201509;3483;9432;2690;8320;759;2534;1135;3712;1894;6246
521760;201509;12671;41499;11162;38833;2694;10295;5012;17460;7706;27755
521770;201509;2689;7783;2141;6740;772;2596;562;1657;1334;4253
521800;201509;7247;21576;6233;19867;1923;6564;2323;7588;4246;14152
521805;201509;894;2035;639;1664;153;357;347;987;500;1344
521810;201509;868;2193;633;1842;142;442;274;813;416;1255
521830;201509;5135;16301;4592;15497;797;2948;2976;10008;3773;12956
521839;201509;725;1983;542;1642;99;326;183;525;282;851
521850;201509;6835;18435;5203;15499;1262;3955;1627;4439;2889;8394
521860;201509;1833;5089;1416;4400;327;1124;440;1324;767;2448
521870;201509;514;1703;429;1511;116;432;116;383;232;815
521878;201509;737;2143;523;1694;92;336;228;705;320;1041
521880;201509;24630;62422;15885;48103;4113;13377;4945;15130;9058;28507
521890;201509;3496;10348;2707;8807;810;2843;600;1857;1410;4700
521900;201509;1372;3619;1002;3093;244;799;349;974;593;1773
521910;201509;963;2635;860;2510;147;454;519;1570;666;2024
521920;201509;334;1003;281;905;94;346;69;186;163;532
521925;201509;639;1955;535;1763;100;365;197;599;297;964
521930;201509;3662;11758;3167;10769;998;3562;693;2346;1691;5908
521935;201509;614;1764;536;1624;152;450;246;742;398;1192
521940;201509;1024;2827;825;2510;204;675;375;1105;579;1780
521945;201509;657;2133;599;2050;109;370;377;1379;486;1749
521950;201509;617;1649;492;1459;81;259;285;854;366;1113
521960;201509;719;2142;583;1886;123;445;251;782;374;1227
521970;201509;2459;6782;2138;6373;236;681;1621;4997;1857;5678
521971;201509;1069;2842;751;2243;155;474;194;539;349;1013
521973;201509;912;2857;747;2539;169;617;271;900;440;1517
521975;201509;12408;33921;11452;32777;1969;5893;8019;22887;9988;28780
521980;201509;1925;5529;1675;5226;254;697;1291;4198;1545;4895
521990;201509;1071;3068;892;2792;100;346;576;1828;676;2174
522000;201509;2317;6304;1677;5489;239;866;946;3190;1185;4056
522005;201509;396;966;262;752;81;224;87;263;168;487
522010;201509;3221;9312;2669;8387;929;3039;598;1862;1527;4901
522015;201509;893;2651;748;2416;175;565;373;1215;548;1780
522020;201509;5165;13450;4089;11877;941;2810;2140;6194;3081;9004
522026;201509;617;1657;445;1450;122;441;153;510;275;951
522028;201509;519;1510;425;1300;71;221;264;797;335;1018
522040;201509;2428;5917;1839;5175;410;1188;1059;2992;1469;4180
522045;201509;14820;48252;12169;42680;3566;13686;2272;7678;5838;21364
522050;201509;1120;3178;844;2671;216;730;273;768;489;1498
522060;201509;2696;7985;2085;7038;593;2232;952;3141;1545;5373
522068;201509;1611;5095;1475;4939;156;452;1153;4069;1309;4521
522070;201509;761;2290;682;2167;79;313;484;1527;563;1840
522100;201509;584;1716;510;1604;187;664;201;589;388;1253
522108;201509;889;2715;748;2505;65;262;567;1868;632;2130
522119;201509;1371;4217;1159;3875;265;938;543;1842;808;2780
522130;201509;361;1014;299;944;93;310;175;552;268;862
522140;201509;17603;48329;14197;42589;4097;13249;4483;12759;8580;26008
522145;201509;801;2241;708;2091;290;885;218;673;508;1558
522150;201509;872;2446;756;2248;213;642;287;836;500;1478
522155;201509;787;2241;688;2087;126;356;448;1417;574;1773
522157;201509;687;1934;584;1783;51;189;460;1390;511;1579
522160;201509;5936;16811;4186;13547;1284;4656;453;1312;1737;5968
522170;201509;3047;8540;2459;7549;806;2551;612;1912;1418;4463
522180;201509;316;918;244;793;76;269;78;260;154;529
522185;201509;15122;43574;12562;40239;3225;10927;6859;22118;10084;33045
522190;201509;927;2299;698;1961;106;316;365;1055;471;1371
522200;201509;1662;5290;1380;4697;371;1383;392;1252;763;2635
522205;201509;1425;4038;1154;3595;274;908;541;1636;815;2544
522220;201509;1355;3644;1080;3304;265;804;543;1823;808;2627
522230;201509;1198;3401;1024;3124;119;414;653;1982;772;2396
530010;201509;230910;722523;202946;671492;56010;205232;68423;219519;124433;424751
110001;201508;3842;12109;3173;11064;698;2572;1659;5807;2357;8379
110002;201508;13075;39067;10424;34318;3031;10899;3791;12213;6822;23112
110003;201508;797;2538;705;2369;203;713;181;566;384;1279
110004;201508;10055;31612;8165;27688;2607;9580;1890;6332;4497;15912
110005;201508;1786;5700;1583;5302;544;1883;641;2126;1185;4009
110006;201508;2024;6109;1377;4842;415;1589;230;683;645;2272
110007;201508;1350;4106;1260;3967;331;1126;553;1942;884;3068
110008;201508;2393;8066;2248;7854;394;1283;1590;5818;1984;7101
110009;201508;4613;13851;3701;12362;1042;3847;1359;4373;2401;8220
110010;201508;7684;22562;6701;21284;1689;5215;3580;12429;5269;17644
110011;201508;8006;24516;6740;22064;2171;7519;2453;7877;4624;15396
110012;201508;14076;42227;11692;37810;3608;12233;3615;11699;7223;23932
110013;201508;5294;16681;4391;15127;1551;5532;1396;4987;2947;10519
110014;201508;4176;12242;3596;11300;874;2877;1927;6048;2801;8925
110015;201508;4963;14804;3637;12326;1086;4040;931;3048;2017;7088
110018;201508;4253;11886;3225;10463;850;3126;1296;3988;2146;7114
110020;201508;58833;164384;44806;145228;9961;34101;22263;74008;32224;108109
110025;201508;4339;12533;3555;11094;643;2126;2169;6688;2812;8814
110026;201508;648;1996;598;1923;147;477;354;1149;501;1626
110028;201508;7526;21538;5327;17527;1424;5154;812;2481;2236;7635
110029;201508;1336;3963;1130;3601;334;1104;455;1465;789;2569
110030;201508;10421;28250;7901;24703;1966;6709;3440;10863;5406;17572
110032;201508;3997;12624;3506;11604;1117;3823;1170;3825;2287;7648
110033;201508;5374;17044;4862;16182;1501;4975;2098;7350;3599;12325
110034;201508;3438;9231;2936;8581;661;1923;1895;5562;2556;7485
110037;201508;2046;6824;1717;6164;444;1704;789;2790;1233;4494
110040;201508;3493;10941;3033;10090;915;3299;1290;4160;2205;7459
110045;201508;5142;16690;4450;15820;1397;5392;2264;7999;3661;13391
110050;201508;1675;5365;1431;4929;422;1512;689;2386;1111;3898
110060;201508;817;2698;676;2410;223;894;192;656;415;1550
110070;201508;1988;6601;1864;6344;500;1847;972;3237;1472;5084
110080;201508;4026;11363;3580;10841;533;1556;2659;8347;3192;9903
110090;201508;760;2252;608;1975;157;588;269;800;426;1388
110092;201508;1303;4375;1223;4278;191;714;829;2967;1020;3681
110094;201508;3468;10538;3127;10049;991;3335;1441;4657;2432;7992
110100;201508;2226;7047;1999;6627;623;2171;958;3136;1581;5307
110110;201508;1664;5271;1510;5068;625;2166;465;1606;1090;3772
110120;201508;1816;5824;1412;4919;425;1542;319;1090;744;2632
110130;201508;2541;7363;1919;6294;649;2259;472;1508;1121;3767
110140;201508;2461;8082;2105;7388;504;1897;922;3188;1426;5085
110143;201508;1274;4004;989;3505;291;1076;437;1550;728;2626
110145;201508;1026;2940;839;2632;206;707;454;1392;660;2099
110146;201508;420;1286;365;1203;73;242;211;715;284;957
110147;201508;779;2244;612;1949;163;548;225;640;388;1188
110148;201508;1258;3786;922;3066;265;927;175;540;440;1467
110149;201508;3347;10070;2714;9002;829;2778;1272;4354;2101;7132
110150;201508;2447;7192;2105;6681;590;1982;816;2624;1406;4606
110155;201508;848;2613;760;2405;193;656;372;1123;565;1779
110160;201508;2002;6331;1652;5654;587;2072;591;1994;1178;4066
110170;201508;2942;8270;2169;6866;476;1580;1131;3525;1607;5105
110175;201508;1702;5125;1316;4628;218;839;757;2751;975;3590
110180;201508;1428;4181;1186;3813;275;884;699;2295;974;3179
120001;201508;2739;9542;2560;9238;474;1825;1661;6118;2135;7943
120005;201508;1512;6273;1430;6122;145;675;1101;4841;1246;5516
120010;201508;4459;15489;4225;15117;648;2282;3115;11466;3763;13748
120013;201508;1742;6922;1667;6811;402;1585;1042;4525;1444;6110
120017;201508;2011;7247;1862;6970;516;1980;857;3507;1373;5487
120020;201508;13918;62026;13454;61103;2051;9381;9607;45143;11658;54524
120025;201508;2485;8634;2393;8502;457;1750;1554;5562;2011;7312
120030;201508;5987;23725;5862;23588;255;1083;5335;21654;5590;22737
120032;201508;1443;6931;1381;6780;186;1081;996;4912;1182;5993
120033;201508;3530;14037;3450;13892;307;1230;2968;12136;3275;13366
120034;201508;1984;8275;1916;8167;176;929;1564;6601;1740;7530
120035;201508;2902;13538;2850;13428;215;1126;2424;11539;2639;12665
120038;201508;2638;9618;2509;9368;628;2404;1369;5243;1997;7647
120039;201508;1602;8195;1564;8105;165;959;1202;6296;1367;7255
120040;201508;44744;159501;40428;150936;10093;40541;19817;75073;29910;115614
120042;201508;2836;12282;2689;11946;370;1797;1896;8555;2266;10352
120043;201508;887;4261;857;4208;66;294;718;3666;784;3960
120045;201508;4199;14346;4111;14233;633;2295;3239;11284;3872;13579
120050;201508;7885;32885;7527;32073;1240;5316;5005;22314;6245;27630
120060;201508;7300;33190;7170;32929;655;3442;5840;27075;6495;30517
120070;201508;2611;9901;2538;9733;441;1644;1679;6682;2120;8326
120080;201508;3525;13399;3334;13082;548;2200;2401;9660;2949;11860
130002;201508;3015;12523;2845;12244;203;1028;2374;10237;2577;11265
130006;201508;1919;8172;1685;7740;260;1345;1153;5342;1413;6687
130008;201508;2094;8398;1991;8215;185;788;1597;6688;1782;7476
130010;201508;2809;9449;2436;9017;201;823;2085;7741;2286;8564
130014;201508;3168;10396;2810;9824;453;1702;1842;6492;2295;8194
130020;201508;2649;9614;2581;9493;61;302;2305;8408;2366;8710
130030;201508;7213;27393;6946;27073;568;1961;5939;23890;6507;25851
130040;201508;3779;11525;3375;10987;265;948;2758;9076;3023;10024
130050;201508;6034;24472;5549;23741;481;2036;4426;19735;4907;21771
130060;201508;5593;26262;5344;25815;521;2947;4184;20195;4705;23142
130063;201508;3565;15815;3492;15720;303;1414;2964;13546;3267;14960
130068;201508;3069;12885;2775;12267;379;1792;1814;8122;2193;9914
130070;201508;6684;21657;5934;20724;651;2312;4567;16298;5218;18610
130080;201508;4930;22243;4705;21879;767;3804;3277;15567;4044;19371
130083;201508;2161;8618;2039;8433;313;1455;1410;5842;1723;7297
130090;201508;2575;9280;2484;9134;132;614;2168;7917;2300;8531
130100;201508;5536;20747;5377;20540;198;879;4977;19012;5175;19891
130110;201508;6491;21065;6097;20571;741;2333;4811;16758;5552;19091
130115;201508;4308;15287;4043;14867;181;683;3542;13100;3723;13783
130120;201508;14029;53665;13307;52727;1392;5562;10794;43718;12186;49280
130130;201508;3685;15319;3621;15191;269;1337;3028;12701;3297;14038
130140;201508;6195;24066;6107;23965;171;712;5746;22570;5917;23282
130150;201508;3372;13165;3300;13076;185;986;2901;11315;3086;12301
130160;201508;4156;17271;4018;17071;502;2501;3244;13633;3746;16134
130165;201508;2845;11781;2725;11574;303;1391;2132;9139;2435;10530
130170;201508;8849;32249;7907;31094;1061;4432;5956;23894;7017;28326
130180;201508;3471;11268;3382;11143;129;312;3121;10427;3250;10739
130185;201508;10961;35352;9886;34115;898;2887;8134;29164;9032;32051
130190;201508;16845;57875;14796;55201;2717;10163;9689;37670;12406;47833
130195;201508;1910;8004;1850;7918;110;482;1628;7063;1738;7545
130200;201508;1967;7045;1820;6808;474;1771;1090;4187;1564;5958
130210;201508;1182;4681;1117;4592;113;555;914;3741;1027;4296
130220;201508;1940;8036;1765;7695;304;1545;991;4312;1295;5857
130230;201508;3614;16341;3370;15908;411;2023;2477;12128;2888;14151
130240;201508;8369;31904;7726;30943;438;2266;6630;26540;7068;28806
130250;201508;19410;67857;18300;66401;2760;9991;13348;50341;16108;60332
130255;201508;4119;14577;3909;14236;160;582;3519;12966;3679;13548
130260;201508;241673;793578;216840;750160;62131;227038;97112;339339;159243;566377
130270;201508;6956;29488;6411;28605;890;4139;4686;21570;5576;25709
130280;201508;3199;13175;3113;13056;183;816;2770;11785;2953;12601
130290;201508;11190;39465;10753;38951;136;246;10350;38183;10486;38429
130300;201508;4214;16595;4033;16294;288;1371;3407;13747;3695;15118
130310;201508;5015;18998;4644;18525;361;1481;3852;15677;4213;17158
130320;201508;2883;10254;2631;9897;351;1380;1895;7271;2246;8651
130330;201508;3512;12919;3261;12593;232;1077;2695;10392;2927;11469
130340;201508;17261;66578;16098;65085;2903;11670;11651;48635;14554;60305
130350;201508;3234;13512;3155;13399;297;1617;2561;10738;2858;12355
130353;201508;5938;18175;5174;17169;1172;3818;3130;11107;4302;14925
130356;201508;4410;15868;4150;15481;380;1326;3303;12816;3683;14142
130360;201508;3187;9088;2880;8748;141;393;2614;8069;2755;8462
130370;201508;5244;20589;4469;19495;253;1450;3531;15391;3784;16841
130380;201508;7589;31601;7279;31160;534;2583;6213;26784;6747;29367
130390;201508;4829;21563;4481;20936;464;2406;3382;16056;3846;18462
130395;201508;2065;7432;1819;6917;288;1166;1167;4391;1455;5557
130400;201508;2044;7824;1959;7708;145;685;1724;6750;1869;7435
130406;201508;10480;39795;9429;38223;2192;9224;5743;23950;7935;33174
130410;201508;3862;14823;3497;14137;1061;4557;1567;6562;2628;11119
130420;201508;10300;43753;9869;43051;2620;11056;6161;28281;8781;39337
130423;201508;3203;12470;3004;12187;260;1280;2497;10066;2757;11346
130426;201508;2105;9244;2044;9133;303;1424;1497;6821;1800;8245
130430;201508;3275;11797;3149;11604;371;1450;2418;8995;2789;10445
130440;201508;3485;12748;3335;12575;239;958;2905;11019;3144;11977
140002;201508;1612;5254;1497;5089;154;544;1084;3751;1238;4295
140005;201508;2987;8848;2845;8690;112;299;2672;8230;2784;8529
140010;201508;52195;155754;43525;142222;10788;37650;19916;66970;30704;104620
140015;201508;2916;9378;2734;9147;327;929;2169;7579;2496;8508
140017;201508;3172;9887;2861;9489;291;919;2190;7507;2481;8426
140020;201508;4408;15108;4069;14609;588;2282;2905;10431;3493;12713
140023;201508;2124;7210;1861;6801;260;1032;1270;4694;1530;5726
140028;201508;2107;5837;1981;5654;169;528;1554;4270;1723;4798
140030;201508;3709;11683;3502;11390;481;1252;2605;8850;3086;10102
140040;201508;1668;7727;1618;7609;103;578;1335;6293;1438;6871
140045;201508;2441;9067;2224;8743;467;1659;1420;6104;1887;7763
140047;201508;5356;15027;4755;14224;1386;4244;2289;7255;3675;11499
140050;201508;1476;4641;1330;4454;289;987;802;2736;1091;3723
140060;201508;1500;4597;1347;4360;292;1006;834;2719;1126;3725
140070;201508;1424;7639;1378;7473;102;674;1136;6148;1238;6822
150010;201508;33973;105307;32074;102750;2042;6989;26560;85547;28602;92536
150013;201508;1666;4884;1528;4724;169;501;1197;3790;1366;4291
150020;201508;12263;41093;11853;40523;1032;3414;10040;34882;11072;38296
150030;201508;6703;28876;6483;28536;672;2644;5351;24414;6023;27058
150034;201508;4223;11773;4003;11493;240;680;3459;9949;3699;10629
150040;201508;12629;41158;10805;38954;2105;6978;7352;28542;9457;35520
150050;201508;5707;22101;5482;21702;335;1595;4672;18512;5007;20107
150060;201508;16632;52393;15203;50155;2615;8397;10244;34848;12859;43245
150070;201508;5865;24042;5254;23389;353;1750;4622;20727;4975;22477
150080;201508;67213;176937;57338;163583;10581;29039;34832;103505;45413;132544
150085;201508;5178;17746;4918;17398;528;1599;4022;14834;4550;16433
150090;201508;9940;38241;9430;37496;960;3810;7371;29968;8331;33778
150095;201508;5176;17255;4724;16574;415;1370;3760;13634;4175;15004
150100;201508;3245;12170;3057;11835;191;932;2449;9325;2640;10257
150110;201508;3281;16287;3270;16261;212;1044;2922;14694;3134;15738
150120;201508;6096;23301;5960;23062;647;2395;4790;18929;5437;21324
150125;201508;739;2160;653;2053;118;407;433;1332;551;1739
150130;201508;21582;65603;19997;63376;2059;6262;15439;50128;17498;56390
150140;201508;150817;429917;142788;419337;15444;44517;112841;335743;128285;380260
150145;201508;4460;14348;4065;13841;615;2170;3011;10442;3626;12612
150150;201508;11133;34633;10274;33312;1691;5734;7044;23052;8735;28786
150157;201508;3101;9332;2695;8750;361;1296;1929;6355;2290;7651
150160;201508;2988;9705;2788;9414;841;2869;1472;5160;2313;8029
150170;201508;21461;79390;20228;77340;3332;12902;14089;54862;17421;67764
150172;201508;2989;10314;2641;9723;441;1637;1794;6762;2235;8399
150175;201508;1956;5862;1836;5724;154;457;1500;4854;1654;5311
150178;201508;9931;31125;8867;29869;1017;3583;6533;22629;7550;26212
150180;201508;17979;72065;17268;71116;1457;6587;14323;59484;15780;66071
150190;201508;6940;23222;6641;22802;329;1132;5867;20418;6196;21550
150195;201508;5043;16855;4682;16268;313;1177;3932;13758;4245;14935
150200;201508;5251;16787;5022;16522;137;440;4662;15515;4799;15955
150210;201508;24088;91433;23256;90252;2345;8789;18761;75132;21106;83921
150215;201508;6396;20272;5558;18904;1551;5541;2397;8242;3948;13783
150220;201508;12111;37720;10765;35585;2396;8152;5635;18991;8031;27143
150230;201508;10910;36244;9814;34613;1250;4903;6947;24583;8197;29486
150240;201508;34900;103601;30405;95786;9966;32409;10082;32975;20048;65384
150250;201508;4074;16613;3927;16391;548;2368;2922;12543;3470;14911
150260;201508;2031;8189;1924;7984;372;1550;1202;5135;1574;6685
150270;201508;8457;26195;6791;24085;1645;6127;3924;14160;5569;20287
150275;201508;5826;21262;5533;20778;721;2719;4028;15420;4749;18139
150276;201508;2062;6252;1848;5953;421;1449;1233;3946;1654;5395
150277;201508;4825;14993;4194;14202;778;2706;2816;9811;3594;12517
150280;201508;5744;25690;5565;25278;1108;5043;3684;17254;4792;22297
150285;201508;2701;10780;2547;10493;528;2249;1535;6584;2063;8833
150290;201508;9580;28222;9149;27727;716;1756;7786;24437;8502;26193
150293;201508;9597;26336;7295;23082;2195;7401;2621;8956;4816;16357
150295;201508;6915;21074;5766;19692;1408;4907;3298;11948;4706;16855
150300;201508;1806;6345;1722;6240;156;621;1335;4903;1491;5524
150304;201508;3978;12615;3497;11899;585;2016;2291;8016;2876;10032
150307;201508;6475;21844;6001;21174;412;1445;4957;17634;5369;19079
150309;201508;6117;21217;5598;20477;1222;4444;3540;13540;4762;17984
150310;201508;5859;25973;5662;25668;677;3248;4424;20348;5101;23596
150320;201508;9191;21744;8491;21004;528;998;7394;18757;7922;19755
150330;201508;13392;46275;12503;44979;1570;5556;9502;35240;11072;40796
150340;201508;2355;7658;2175;7383;291;1023;1549;5308;1840;6331
150345;201508;6457;21695;6072;21176;607;2075;4894;17464;5501;19539
150350;201508;7529;23946;7045;23304;1153;3273;5161;17844;6314;21117
150360;201508;20685;64911;18152;61572;2914;10008;12264;43058;15178;53066
150370;201508;9643;35586;9090;34834;1276;4640;6976;27748;8252;32388
150375;201508;2777;12243;2711;12150;256;1127;2302;10510;2558;11637
150380;201508;9735;28398;8605;26817;630;2031;7077;22345;7707;24376
150390;201508;7706;33263;7233;32367;1353;5915;4679;21742;6032;27657
150400;201508;5712;22743;5472;22244;519;2076;4307;17948;4826;20024
150405;201508;8077;24517;7209;23439;1360;3672;4861;17305;6221;20977
150410;201508;1564;6091;1471;5898;215;953;955;3881;1170;4834
150420;201508;35449;120620;30111;111660;8976;36022;11288;43533;20264;79555
150430;201508;7057;24006;6723;23464;953;3184;4877;17520;5830;20704
150440;201508;5395;18836;5180;18538;954;3285;3647;13508;4601;16793
150442;201508;19967;59188;18038;56249;3314;10484;11360;36221;14674;46705
150445;201508;5022;17553;4664;16933;658;2334;3377;12555;4035;14889
150450;201508;4299;20754;4150;20525;357;1797;3458;17457;3815;19254
150460;201508;6403;24905;5894;24295;373;1900;5011;20885;5384;22785
150470;201508;17080;52303;16426;51530;518;1344;15344;48778;15862;50122
150475;201508;2559;8910;2352;8641;241;879;1900;7151;2141;8030
150480;201508;13531;46334;12588;44911;1249;4694;10079;36390;11328;41084
150490;201508;6762;26146;6612;25919;284;1227;5845;23086;6129;24313
150495;201508;4878;18169;4762;18011;250;1013;4307;16346;4557;17359
150497;201508;2762;10124;2518;9630;796;3239;1165;4435;1961;7674
150500;201508;3086;8569;2865;8260;308;869;2183;6289;2491;7158
150503;201508;3695;11466;3200;10850;1122;3923;1609;5694;2731;9617
150506;201508;11232;39366;10157;37817;2342;8285;6421;25499;8763;33784
150510;201508;9421;37136;8665;35670;1407;5935;5758;24531;7165;30466
150520;201508;6625;25935;6516;25783;300;1162;6011;24000;6311;25162
150530;201508;11893;41023;10693;39183;1152;4026;8173;30617;9325;34643
150540;201508;4567;14105;4112;13457;299;1011;3396;11156;3695;12167
150543;201508;5462;17060;4895;16212;1029;3531;3033;10274;4062;13805
150548;201508;8813;28404;8257;27692;451;1487;7410;25093;7861;26580
150549;201508;2095;6721;1930;6528;84;287;1731;5925;1815;6212
150550;201508;19640;62030;17090;57632;5191;17998;6782;23475;11973;41473
150553;201508;22729;78224;18873;70031;7000;27754;4670;17362;11670;45116
150555;201508;1615;4969;1415;4638;98;373;1091;3563;1189;3936
150560;201508;1947;6295;1828;6040;270;898;1207;3984;1477;4882
150563;201508;2841;9209;2623;8828;638;2325;1439;4828;2077;7153
150565;201508;3700;12785;3367;12271;224;996;2750;10092;2974;11088
150570;201508;5583;20837;5443;20589;413;1826;4378;16614;4791;18440
150580;201508;9472;39601;9244;39329;627;2556;8115;35288;8742;37844
150590;201508;5655;22866;5498;22667;105;347;5223;21765;5328;22112
150600;201508;7815;30258;7524;29828;402;1658;6670;26739;7072;28397
150610;201508;2337;8033;2134;7610;250;993;1480;5203;1730;6196
150611;201508;2641;9325;2470;8986;212;838;1950;7135;2162;7973
150613;201508;11845;36044;9974;33220;3288;11458;4148;14199;7436;25657
150616;201508;3001;9166;2328;8062;567;2172;883;2899;1450;5071
150618;201508;6246;21674;5772;20800;1606;5946;2940;10774;4546;16720
150619;201508;5135;17601;4783;17047;599;2322;3430;12254;4029;14576
150620;201508;6273;22616;5747;21928;756;2885;4448;17386;5204;20271
150630;201508;5637;17055;5356;16722;508;1662;4440;14094;4948;15756
150635;201508;3929;12960;3574;12253;777;2774;1894;6584;2671;9358
150640;201508;1739;5382;1680;5307;243;717;1312;4372;1555;5089
150650;201508;12316;37217;10896;34735;2928;9463;4928;16238;7856;25701
150655;201508;4882;16465;4619;15980;646;2280;3375;11841;4021;14121
150658;201508;4142;13021;3736;12436;925;3391;2198;7314;3123;10705
150660;201508;5492;17481;5004;16771;1221;4042;2742;9529;3963;13571
150670;201508;6537;17987;5510;16686;905;2872;4020;12457;4925;15329
150680;201508;54157;195502;47859;184455;14654;58491;20014;82440;34668;140931
150690;201508;2006;6242;1808;5920;326;1003;1144;3874;1470;4877
150700;201508;6160;19016;5628;18333;1034;3438;3688;12321;4722;15759
150710;201508;4245;14268;3804;13541;448;1644;2774;10078;3222;11722
150715;201508;4915;15498;4266;14494;535;1992;3134;10719;3669;12711
150720;201508;6377;26024;6001;25335;856;3733;4253;18564;5109;22297
150730;201508;9354;32208;8804;31298;955;3356;7083;25759;8038;29115
150740;201508;3689;11777;3301;11079;606;2167;1894;6348;2500;8515
150745;201508;5251;16607;4783;15955;1138;3966;2938;9784;4076;13750
150746;201508;1374;4509;1312;4399;172;620;931;3131;1103;3751
150747;201508;5348;16672;4694;15860;424;1219;3629;13077;4053;14296
150750;201508;3101;10354;2893;10088;211;831;2385;8337;2596;9168
150760;201508;10786;35287;10073;34311;2122;7310;6265;21902;8387;29212
150770;201508;5695;21789;5328;21060;515;1948;4366;18188;4881;20136
150775;201508;1144;3481;1000;3222;205;816;544;1666;749;2482
150780;201508;3157;10398;3086;10309;71;221;2900;9754;2971;9975
150790;201508;4921;15980;4556;15536;381;1374;3694;13137;4075;14511
150795;201508;15411;47926;13783;45532;2853;9437;8474;28919;11327;38356
150796;201508;2930;8781;2670;8481;394;1227;1954;6376;2348;7603
150797;201508;3621;12302;3362;11892;126;536;2932;10353;3058;10889
150800;201508;13633;45231;12558;43916;2657;8735;8436;31217;11093;39952
150803;201508;6518;23648;6118;22997;672;2666;4574;17422;5246;20088
150805;201508;2607;9299;2441;9025;335;1209;1754;6627;2089;7836
150808;201508;5556;18760;4660;17058;1882;7389;802;2951;2684;10340
150810;201508;18688;58328;15810;54758;2228;7383;10879;39690;13107;47073
150812;201508;5188;16330;4757;15594;497;1947;3418;10794;3915;12741
150815;201508;8371;27346;7549;26318;771;2652;6109;21772;6880;24424
150820;201508;11234;32145;9974;30742;705;1634;8323;26453;9028;28087
150830;201508;12828;48193;11794;46656;646;2992;9935;40403;10581;43395
150835;201508;2015;7104;1857;6796;455;1706;881;3306;1336;5012
150840;201508;6691;20447;5539;18537;1291;4700;2670;8859;3961;13559
160005;201508;662;2421;622;2345;64;293;481;1777;545;2070
160010;201508;1374;4571;1370;4566;68;144;1274;4358;1342;4502
160015;201508;1671;6214;1632;6157;92;322;1464;5641;1556;5963
160020;201508;2008;7119;1862;6917;236;911;1376;5232;1612;6143
160021;201508;954;4112;922;4053;146;739;633;2790;779;3529
160023;201508;1033;4111;1020;4087;100;387;860;3496;960;3883
160025;201508;1263;3889;1247;3872;26;99;1206;3726;1232;3825
160027;201508;8111;24343;7503;23665;2632;7850;3830;13142;6462;20992
160030;201508;43846;156505;38917;147385;9261;35073;21578;86101;30839;121174
160040;201508;4131;16339;4034;16188;187;1024;3655;14460;3842;15484
160050;201508;3104;11738;2810;11335;1268;5081;1149;4957;2417;10038
160053;201508;2685;10365;2617;10259;521;2143;1764;7020;2285;9163
160055;201508;635;2474;625;2462;77;330;486;1917;563;2247
160060;201508;15231;51727;14255;50632;2943;9877;9594;35505;12537;45382
160070;201508;2450;9677;2312;9431;187;916;1927;7787;2114;8703
160080;201508;2560;9610;2528;9567;111;556;2339;8753;2450;9309
170025;201508;517;1727;473;1660;138;488;240;884;378;1372
170030;201508;1167;3808;1027;3550;310;1097;357;1253;667;2350
170035;201508;1501;4368;1194;3798;343;1186;410;1297;753;2483
170040;201508;1872;6053;1642;5740;259;1040;1014;3669;1273;4709
170070;201508;1802;4798;1419;4286;323;1053;745;2207;1068;3260
170100;201508;2435;7157;2121;6658;243;806;1622;5084;1865;5890
170105;201508;750;2339;592;2017;116;455;307;996;423;1451
170110;201508;1046;3261;889;2996;202;741;410;1371;612;2112
170130;201508;1353;4271;1147;3885;303;1056;550;1913;853;2969
170190;201508;1578;4618;1192;3993;503;1621;239;927;742;2548
170200;201508;1627;4566;1064;3485;268;965;296;907;564;1872
170210;201508;31474;89471;24990;78789;7093;24104;7451;24400;14544;48504
170215;201508;1173;3662;997;3391;82;339;742;2498;824;2837
170220;201508;5619;19387;5188;18527;1163;4389;2864;10275;4027;14664
170230;201508;1435;4603;1189;4129;246;1007;551;1794;797;2801
170240;201508;2656;8121;2230;7458;300;1202;1497;4951;1797;6153
170255;201508;3325;10676;2789;9755;853;3017;1188;4339;2041;7356
170270;201508;1028;2569;718;2146;84;267;478;1415;562;1682
170290;201508;2691;8392;2493;8152;169;447;2157;7311;2326;7758
170300;201508;1949;5988;1614;5436;219;825;1029;3472;1248;4297
170305;201508;771;2340;620;2061;113;409;317;1052;430;1461
170307;201508;1084;3806;902;3460;178;783;447;1758;625;2541
170310;201508;1617;4463;1221;3796;315;1046;540;1698;855;2744
170320;201508;1105;3212;807;2678;207;729;284;967;491;1696
170330;201508;744;2443;679;2338;91;360;503;1694;594;2054
170360;201508;455;1466;376;1325;84;316;168;577;252;893
170370;201508;1368;3916;1091;3467;220;789;558;1762;778;2551
170380;201508;1777;5723;1429;5152;256;1077;767;2689;1023;3766
170382;201508;540;1805;463;1677;114;461;242;857;356;1318
170384;201508;1532;6270;1419;6059;326;1515;810;3464;1136;4979
170386;201508;912;2722;786;2533;174;619;368;1181;542;1800
170388;201508;647;1927;523;1720;109;426;204;639;313;1065
170389;201508;916;3069;832;2928;90;359;603;2104;693;2463
170390;201508;1269;3716;1107;3512;114;401;830;2672;944;3073
170410;201508;534;1689;456;1551;48;198;289;966;337;1164
170460;201508;496;1347;344;1088;83;295;117;359;200;654
170510;201508;788;2635;647;2372;84;371;341;1214;425;1585
170550;201508;6560;18829;4887;15869;1565;5585;786;2478;2351;8063
170555;201508;1331;3833;1041;3384;231;811;508;1670;739;2481
170560;201508;979;3328;789;3067;174;733;438;1771;612;2504
170600;201508;1294;3760;1159;3577;249;753;746;2393;995;3146
170610;201508;1574;4881;1254;4356;134;543;784;2723;918;3266
170625;201508;427;1324;332;1141;66;232;94;330;160;562
170650;201508;1231;3970;1050;3635;250;936;443;1580;693;2516
170700;201508;4073;12905;3297;11588;675;2617;1456;5268;2131;7885
170710;201508;1808;5352;1471;4733;236;815;881;2856;1117;3671
170720;201508;1819;4923;1520;4431;335;887;915;2823;1250;3710
170730;201508;993;2866;807;2573;218;748;361;1144;579;1892
170740;201508;2183;7795;1917;7318;269;1132;1297;4976;1566;6108
170755;201508;810;2509;664;2195;138;530;241;763;379;1293
170765;201508;1344;3651;1041;3143;293;933;414;1272;707;2205
170770;201508;1726;5840;1578;5571;266;1001;967;3416;1233;4417
170820;201508;3600;11463;3208;10819;765;2730;1536;5257;2301;7987
170825;201508;745;2217;595;1921;112;387;254;795;366;1182
170830;201508;1388;4043;1219;3796;25;52;1116;3530;1141;3582
170900;201508;2569;9093;2433;8859;229;840;1942;7208;2171;8048
170930;201508;3594;11088;3108;10232;966;3370;1110;3740;2076;7110
170950;201508;13927;40163;10250;33596;3180;11807;1984;6277;5164;18084
170980;201508;497;1501;375;1290;89;348;153;491;242;839
171050;201508;1466;4996;1319;4714;98;441;1053;3715;1151;4156
171070;201508;1509;4728;1376;4528;346;1142;750;2537;1096;3679
171090;201508;1008;2780;836;2535;68;207;610;1848;678;2055
171110;201508;599;1755;447;1472;124;448;187;578;311;1026
171150;201508;846;2413;611;1996;103;370;359;1181;462;1551
171180;201508;686;2077;478;1644;116;421;185;675;301;1096
171190;201508;1612;5930;1416;5519;289;1194;703;2837;992;4031
171195;201508;817;2905;709;2686;98;405;409;1580;507;1985
171200;201508;673;2153;548;1911;153;589;200;633;353;1222
171215;201508;455;1361;351;1152;64;228;147;496;211;724
171240;201508;726;2582;665;2459;88;377;433;1648;521;2025
171245;201508;631;2075;513;1792;108;438;167;534;275;972
171250;201508;1078;3121;861;2752;143;531;507;1536;650;2067
171270;201508;412;1696;387;1642;127;522;151;718;278;1240
171280;201508;862;2612;721;2380;178;562;333;1203;511;1765
171320;201508;3847;11681;3273;10666;887;2900;1494;4965;2381;7865
171330;201508;2881;8398;2343;7556;619;2135;1032;3282;1651;5417
171360;201508;1410;4586;1242;4323;209;732;785;2788;994;3520
171370;201508;674;1930;580;1798;132;457;315;951;447;1408
171380;201508;1322;4262;1114;3873;417;1457;370;1341;787;2798
171395;201508;873;2635;683;2280;149;590;315;999;464;1589
171420;201508;2252;6770;1717;5795;422;1512;634;2099;1056;3611
171430;201508;1035;3174;861;2892;197;661;449;1518;646;2179
171488;201508;2448;7487;2136;7027;489;1624;1165;3938;1654;5562
171500;201508;768;2350;667;2172;100;321;441;1470;541;1791
171510;201508;895;3136;804;2983;78;343;573;2140;651;2483
171515;201508;489;1406;387;1231;59;194;214;672;273;866
171525;201508;615;2013;522;1846;101;400;264;896;365;1296
171550;201508;303;1023;234;889;85;356;37;146;122;502
171570;201508;1236;3906;1079;3593;196;662;717;2401;913;3063
171575;201508;1882;5343;1435;4504;276;900;661;2103;937;3003
171610;201508;5282;16951;4421;15414;1220;4716;1550;5348;2770;10064
171620;201508;2541;7484;2226;7042;114;438;1868;5914;1982;6352
171630;201508;881;2785;721;2516;240;905;276;937;516;1842
171650;201508;2179;6747;1704;5795;451;1663;615;2068;1066;3731
171660;201508;2466;6821;1903;5809;246;830;1131;3438;1377;4268
171665;201508;1445;4286;1180;3862;175;617;704;2381;879;2998
171670;201508;1930;5512;1621;5002;426;1471;718;2104;1144;3575
171700;201508;1073;3525;933;3257;144;580;594;2044;738;2624
171720;201508;719;2125;598;1916;211;676;229;760;440;1436
171750;201508;1170;3636;934;3153;263;924;307;1044;570;1968
171780;201508;1141;3166;877;2782;106;369;514;1670;620;2039
171790;201508;1452;4907;1276;4643;220;786;847;3221;1067;4007
171800;201508;642;2027;571;1933;73;276;415;1433;488;1709
171820;201508;9918;29270;8417;27146;1649;5810;4716;15251;6365;21061
171830;201508;1417;5284;1282;4977;335;1312;582;2274;917;3586
171840;201508;801;2246;695;2100;47;147;574;1749;621;1896
171845;201508;735;2006;567;1729;102;341;287;866;389;1207
171850;201508;953;3381;843;3158;106;466;521;1928;627;2394
171855;201508;1130;3560;1024;3357;89;361;757;2410;846;2771
171865;201508;467;1505;400;1391;92;356;194;652;286;1008
171870;201508;712;2152;578;1916;135;486;227;785;362;1271
171875;201508;1325;4179;1105;3822;120;502;749;2533;869;3035
171880;201508;814;3046;792;3010;78;313;637;2468;715;2781
171884;201508;975;2685;697;2272;156;574;204;764;360;1338
171886;201508;1437;4695;1157;4085;351;1370;315;1052;666;2422
171888;201508;667;2048;545;1818;62;218;308;1055;370;1273
171889;201508;487;1574;449;1506;95;343;254;862;349;1205
171890;201508;1182;3708;985;3402;153;593;558;1920;711;2513
171900;201508;491;1844;436;1735;121;490;206;828;327;1318
172000;201508;559;1850;484;1702;73;282;277;962;350;1244
172010;201508;1179;4117;1096;3975;131;565;792;2854;923;3419
172015;201508;337;1302;278;1188;58;230;153;693;211;923
172020;201508;2228;7457;2063;7189;266;966;1448;5110;1714;6076
172025;201508;722;2089;551;1796;86;317;301;992;387;1309
172030;201508;1134;3747;1002;3520;79;351;738;2550;817;2901
172049;201508;1325;3514;997;2947;155;465;737;2221;892;2686
172065;201508;1273;3476;1077;3252;62;186;973;2981;1035;3167
172080;201508;2508;7744;2112;7033;235;913;1368;4482;1603;5395
172085;201508;519;1420;368;1125;55;163;109;327;164;490
172090;201508;3193;9614;2630;8732;296;1062;1891;6395;2187;7457
172093;201508;595;1835;466;1619;132;541;210;708;342;1249
172097;201508;664;1966;530;1751;125;413;212;731;337;1144
172100;201508;29738;91471;23445;79848;7075;26797;6485;21730;13560;48527
172110;201508;1680;6247;1499;5955;185;780;1073;4397;1258;5177
172120;201508;5103;15724;4271;14612;562;2050;2944;10219;3506;12269
172125;201508;263;815;221;737;36;138;105;346;141;484
172130;201508;543;1516;435;1340;44;167;287;894;331;1061
172208;201508;2077;6243;1870;5926;336;1126;1065;3409;1401;4535
172210;201508;2468;7633;2184;7192;508;1804;1169;3786;1677;5590
210005;201508;21558;67082;18139;61788;5549;20225;7228;24765;12777;44990
210010;201508;1565;5696;1402;5404;138;577;1053;4125;1191;4702
210015;201508;3281;10408;2941;9892;208;553;2483;8595;2691;9148
210020;201508;6838;16911;6449;16437;232;622;5886;14987;6118;15609
210030;201508;5512;18345;5167;17871;345;1518;4284;14720;4629;16238
210040;201508;1815;5173;1671;5007;112;341;1412;4242;1524;4583
210043;201508;6396;18420;5576;17357;534;1555;4224;13782;4758;15337
210047;201508;6305;24532;5805;23646;686;3077;4178;17119;4864;20196
210050;201508;2312;8499;1910;7724;672;2789;668;2853;1340;5642
210055;201508;1704;5828;1562;5630;164;610;1196;4372;1360;4982
210060;201508;7224;27786;6703;26829;874;3696;4657;19018;5531;22714
210070;201508;6870;20500;6351;19849;172;675;5669;17729;5841;18404
210080;201508;3652;12587;3567;12469;56;263;3349;11683;3405;11946
210083;201508;4278;15024;3980;14705;84;240;3806;14261;3890;14501
210087;201508;2830;8470;2583;8155;286;933;2043;6532;2329;7465
210090;201508;9696;31798;9221;31034;400;1567;8085;27250;8485;28817
210095;201508;5858;21589;5662;21305;427;1686;4693;17903;5120;19589
210100;201508;7133;21495;6557;20787;911;3044;4883;15413;5794;18457
210110;201508;2852;9986;2767;9870;116;545;2485;8804;2601;9349
210120;201508;25849;70994;22132;66614;2688;6859;16581;52876;19269;59735
210125;201508;3508;11151;3365;11001;238;642;2924;9809;3162;10451
210130;201508;4069;12133;3814;11778;259;825;3217;9949;3476;10774
210135;201508;1679;4939;1472;4650;108;343;1188;3787;1296;4130
210140;201508;16764;53706;14551;50621;2719;9814;9074;32682;11793;42496
210150;201508;4470;11077;4016;10514;74;188;3754;9835;3828;10023
210160;201508;17260;54863;16231;53347;1536;4530;13104;44396;14640;48926
210170;201508;13740;49096;13378;48625;758;2660;11920;43993;12678;46653
210173;201508;1910;7964;1851;7848;125;706;1586;6590;1711;7296
210177;201508;3005;9364;2851;9182;177;621;2499;8074;2676;8695
210180;201508;1474;4516;1375;4364;59;227;1173;3666;1232;3893
210190;201508;4776;15237;4424;14591;233;1035;3480;11230;3713;12265
210193;201508;1388;4385;1253;4161;71;253;1046;3521;1117;3774
210197;201508;2083;6889;1919;6703;245;823;1474;5310;1719;6133
210200;201508;8477;28407;7865;27521;1049;3438;5879;21422;6928;24860
210203;201508;6358;20716;6063;20322;394;1145;5255;17870;5649;19015
210207;201508;2948;9740;2762;9393;374;1171;2006;7059;2380;8230
210210;201508;8463;28434;8034;27885;109;475;7422;26109;7531;26584
210215;201508;1253;5103;1199;5018;103;497;975;4098;1078;4595
210220;201508;5978;23000;5699;22550;429;1841;4680;18720;5109;20561
210230;201508;4949;16579;4664;16116;301;1103;3951;13769;4252;14872
210232;201508;12213;40136;10266;37753;1586;5984;6961;27128;8547;33112
210235;201508;3466;10962;3138;10536;207;835;2645;8894;2852;9729
210237;201508;2319;9035;2270;8957;94;551;2052;7941;2146;8492
210240;201508;2993;9456;2810;9201;177;554;2332;7688;2509;8242
210250;201508;4998;16207;4719;15837;128;586;4289;14281;4417;14867
210255;201508;2481;7974;2268;7588;361;1246;1596;5403;1957;6649
210260;201508;5210;16773;4728;16064;645;2115;3446;12066;4091;14181
210270;201508;5371;15237;4713;14321;125;563;4154;12506;4279;13069
210275;201508;3594;8730;3384;8503;57;85;3278;8335;3335;8420
210280;201508;5519;16627;4832;15718;309;1253;3773;12066;4082;13319
210290;201508;5518;18412;5102;17896;364;1259;4305;15319;4669;16578
210300;201508;36809;103957;30274;95894;2148;7157;23282;76444;25430;83601
210310;201508;2869;8108;2646;7810;83;194;2336;6948;2419;7142
210312;201508;2153;6935;2065;6815;79;359;1837;6026;1916;6385
210315;201508;2461;8454;2307;8238;172;718;1945;6951;2117;7669
210317;201508;4215;12842;4015;12588;226;723;3570;11286;3796;12009
210320;201508;18750;60085;17381;58395;981;3480;14850;50366;15831;53846
210325;201508;3524;11127;3153;10561;305;1153;2342;7856;2647;9009
210330;201508;36516;87916;28235;79113;3860;8730;19541;61654;23401;70384
210340;201508;11525;35027;10487;33707;1268;3398;7680;26519;8948;29917
210350;201508;9933;31066;9042;29811;624;2068;7322;24430;7946;26498
210355;201508;3849;14096;3559;13676;198;743;3079;12100;3277;12843
210360;201508;16102;48883;14723;46957;1119;3709;11891;38314;13010;42023
210370;201508;9184;22235;7795;20744;263;496;6988;19191;7251;19687
210375;201508;2988;9188;2567;8649;744;2582;1303;4517;2047;7099
210380;201508;6028;16900;5322;15920;417;1151;4397;13365;4814;14516
210390;201508;2810;9969;2561;9563;119;602;2199;8204;2318;8806
210400;201508;4825;15238;4661;15042;147;445;4352;14181;4499;14626
210405;201508;8193;22609;6611;20380;2057;6353;2663;9098;4720;15451
210407;201508;2037;7244;1767;6788;198;742;1291;5101;1489;5843
210408;201508;2356;9162;2205;8980;134;612;1896;7950;2030;8562
210409;201508;3717;13604;3509;13286;199;892;2933;11173;3132;12065
210410;201508;3426;11555;3311;11418;296;826;2812;10115;3108;10941
210420;201508;3983;13129;3647;12543;274;923;2923;10217;3197;11140
210430;201508;2178;6730;2101;6637;121;403;1820;5755;1941;6158
210440;201508;3974;12500;3864;12349;203;610;3498;11304;3701;11914
210450;201508;2828;8896;2524;8449;167;614;2033;6753;2200;7367
210455;201508;4072;11885;3577;11131;562;1772;2481;7980;3043;9752
210460;201508;3617;11986;3396;11639;148;613;2913;9978;3061;10591
210462;201508;1496;5429;1392;5231;95;432;1112;4181;1207;4613
210465;201508;2549;8489;2369;8232;281;772;1916;6954;2197;7726
210467;201508;6161;20396;5746;19902;402;1313;4850;17107;5252;18420
210470;201508;2045;5579;1561;4880;77;239;1208;3824;1285;4063
210480;201508;13657;44959;12048;42830;2729;9454;7465;28283;10194;37737
210490;201508;3510;9966;3101;9381;164;552;2586;7768;2750;8320
210500;201508;6318;25968;6084;25547;738;3022;4553;19685;5291;22707
210510;201508;6440;22039;6143;21680;371;1152;5233;18964;5604;20116
210515;201508;3544;11658;3393;11484;107;339;3160;10808;3267;11147
210520;201508;2533;7919;2321;7626;88;282;2103;6986;2191;7268
210530;201508;35618;110419;28801;100059;7281;28486;12808;45402;20089;73888
210535;201508;3181;11023;3046;10827;119;425;2730;9800;2849;10225
210540;201508;13120;43825;11524;41454;2659;9238;6495;25350;9154;34588
210542;201508;5702;16553;5252;16068;319;753;4547;14337;4866;15090
210545;201508;2258;7412;2142;7217;66;327;1859;6200;1925;6527
210547;201508;3770;13279;3513;12844;282;960;2805;10510;3087;11470
210550;201508;5960;17732;5499;17253;270;656;5020;16150;5290;16806
210560;201508;4126;12904;3688;12179;212;801;3111;10231;3323;11032
210565;201508;1478;5226;1270;4901;108;537;934;3612;1042;4149
210570;201508;12361;34932;11173;33576;824;1777;9567;29876;10391;31653
210580;201508;3137;9486;2817;9083;336;839;2140;7516;2476;8355
210590;201508;4068;12726;3800;12403;295;1004;3197;10432;3492;11436
210592;201508;2406;7574;2321;7437;47;205;2071;6627;2118;6832
210594;201508;2678;7522;2202;6834;118;350;1747;5543;1865;5893
210596;201508;2688;10038;2552;9782;263;1047;1945;7585;2208;8632
210598;201508;1896;5849;1750;5666;113;429;1506;4813;1619;5242
210600;201508;3174;9281;2801;8769;185;618;2279;7120;2464;7738
210610;201508;2496;8254;2327;8037;136;567;2018;6891;2154;7458
210620;201508;1894;6087;1777;5936;51;145;1621;5490;1672;5635
210630;201508;3659;13019;3215;12260;382;1591;2139;8313;2521;9904
210632;201508;4466;15663;4185;15238;410;1566;3291;12085;3701;13651
210635;201508;1893;6667;1799;6523;79;270;1623;5975;1702;6245
210637;201508;2699;9094;2497;8817;143;544;2079;7413;2222;7957
210640;201508;4188;15265;4114;15183;10;40;4030;14979;4040;15019
210650;201508;6805;20897;6634;20683;238;758;6247;19502;6485;20260
210660;201508;7735;23501;7166;22657;235;796;6626;20914;6861;21710
210663;201508;2665;7916;2503;7715;189;650;2079;6428;2268;7078
210667;201508;1782;6275;1690;6133;90;385;1446;5267;1536;5652
210670;201508;4359;16332;4166;16014;241;1077;3465;13441;3706;14518
210675;201508;4985;13877;4595;13398;344;905;3862;11528;4206;12433
210680;201508;4063;11384;3658;10885;195;505;3152;9492;3347;9997
210690;201508;7111;23943;6827;23631;273;849;6121;21791;6394;22640
210700;201508;2559;7711;2393;7530;415;1018;1669;5975;2084;6993
210710;201508;4738;15606;4487;15205;200;815;3849;13046;4049;13861
210720;201508;2512;9190;2365;8974;154;716;2066;7751;2220;8467
210725;201508;1072;4057;952;3842;136;591;582;2363;718;2954
210730;201508;1104;3527;999;3377;99;289;763;2641;862;2930
210735;201508;4102;14329;3754;13737;679;2492;2499;9504;3178;11996
210740;201508;4929;14506;4675;14242;162;616;4202;12553;4364;13169
210745;201508;3839;11498;3587;11165;246;600;3064;9727;3310;10327
210750;201508;20269;54594;17730;51721;2029;5838;13677;40802;15706;46640
210760;201508;5881;16391;5495;15979;51;192;5324;15448;5375;15640
210770;201508;5794;15998;5089;15194;154;613;4626;13730;4780;14343
210780;201508;8391;27878;7666;26588;860;3081;5542;19639;6402;22720
210790;201508;4582;14515;4145;13996;294;757;3436;12201;3730;12958
210800;201508;4708;13467;4277;12942;171;503;3771;11537;3942;12040
210805;201508;3643;15378;3514;15146;173;912;3025;13125;3198;14037
210810;201508;5321;16427;4971;15988;389;780;4243;14343;4632;15123
210820;201508;7806;22515;7124;21551;1223;3568;4768;14804;5991;18372
210825;201508;5650;19366;5376;18983;590;1988;4239;15333;4829;17321
210830;201508;8236;24658;7842;24187;751;2000;6500;20706;7251;22706
210840;201508;3648;10063;3273;9497;195;496;2668;7764;2863;8260
210845;201508;5617;17440;5420;17225;130;291;5131;16605;5261;16896
210850;201508;5992;21538;5470;20617;792;3329;3677;13828;4469;17157
210860;201508;17334;52162;15667;49899;1406;4569;12423;40112;13829;44681
210870;201508;5904;19739;5393;19116;560;1876;4242;15382;4802;17258
210880;201508;4214;13684;4053;13457;310;1096;3358;11173;3668;12269
210890;201508;5277;15481;4797;14927;496;1463;3919;12568;4415;14031
210900;201508;4905;14775;4014;13296;1379;4759;1214;4277;2593;9036
210905;201508;1818;5712;1655;5480;145;375;1293;4447;1438;4822
210910;201508;8627;27363;7825;26064;1266;4482;5264;17610;6530;22092
210920;201508;2982;10585;2862;10391;151;601;2477;9046;2628;9647
210923;201508;1496;5202;1375;5020;162;653;940;3520;1102;4173
210927;201508;4766;15169;4553;14945;46;197;4418;14510;4464;14707
210930;201508;2451;8969;2330;8798;145;779;1985;7338;2130;8117
210940;201508;2796;10923;2739;10819;196;796;2325;9252;2521;10048
210945;201508;5803;17514;5621;17319;244;331;5274;16683;5518;17014
210950;201508;5281;16253;4604;15170;449;1493;3450;11596;3899;13089
210955;201508;1890;6103;1666;5773;204;692;1153;4184;1357;4876
210960;201508;8659;28402;8281;27881;2245;7331;4750;16998;6995;24329
210970;201508;1344;4810;1189;4563;153;704;828;3150;981;3854
210975;201508;1711;5799;1629;5656;138;526;1275;4446;1413;4972
210980;201508;9809;23360;9520;23051;872;1769;8182;20450;9054;22219
210990;201508;16529;49893;13402;45669;2902;10428;7296;25549;10198;35977
211000;201508;15374;49687;13710;47660;794;3236;11501;40377;12295;43613
211003;201508;4717;16783;4300;16163;341;1528;3241;12407;3582;13935
211010;201508;6525;23566;6292;23299;84;343;6049;22522;6133;22865
211020;201508;7255;23474;7044;23125;495;1720;5900;19299;6395;21019
211023;201508;2254;7658;2179;7526;156;626;1834;6336;1990;6962
211027;201508;2870;11246;2789;11120;266;1021;2279;9291;2545;10312
211030;201508;3865;11914;3611;11646;566;1323;2812;9828;3378;11151
211040;201508;4230;16138;4081;15892;150;767;3573;13992;3723;14759
211050;201508;10069;26344;9814;26060;278;623;9135;24344;9413;24967
211060;201508;5932;21210;5762;20961;478;1796;4905;18039;5383;19835
211065;201508;1837;6144;1674;5935;90;326;1497;5370;1587;5696
211070;201508;8090;27707;7445;26637;449;1725;6209;22434;6658;24159
211080;201508;1373;4168;1148;3837;91;428;880;2834;971;3262
211085;201508;1858;6407;1680;6093;321;1197;1046;3851;1367;5048
211090;201508;3487;10349;3275;10064;122;513;2852;8632;2974;9145
211100;201508;6630;17113;6469;16940;43;152;6313;16520;6356;16672
211102;201508;3055;11375;2888;11142;241;906;2443;9607;2684;10513
211105;201508;2655;8496;2280;7931;184;724;1788;6157;1972;6881
211107;201508;4462;14244;4030;13663;220;730;3391;11791;3611;12521
211110;201508;6260;18727;5052;16890;1022;3339;2983;10471;4005;13810
211120;201508;34454;94747;30442;89928;5026;14197;21158;64945;26184;79142
211125;201508;2079;6689;1862;6352;106;376;1578;5405;1684;5781
211130;201508;132337;370220;119881;354449;21741;64191;77900;234868;99641;299059
211140;201508;5291;16865;4925;16301;202;788;4221;13907;4423;14695
211150;201508;9652;28269;8795;27209;479;1714;7392;22825;7871;24539
211153;201508;2811;8672;2630;8439;391;1174;1928;6338;2319;7512
211157;201508;1197;3855;1030;3604;96;434;690;2466;786;2900
211160;201508;4036;13486;3442;12486;303;1446;2388;8454;2691;9900
211163;201508;1633;5454;1554;5340;45;143;1406;4927;1451;5070
211167;201508;1479;4941;1413;4848;48;225;1308;4469;1356;4694
211170;201508;6368;16889;6086;16560;106;325;5640;15269;5746;15594
211172;201508;2397;7081;2158;6731;148;617;1798;5477;1946;6094
211174;201508;2796;8154;2535;7825;74;353;2263;6855;2337;7208
211176;201508;4492;13968;3918;13235;451;1575;2842;9772;3293;11347
211178;201508;3667;9935;3507;9757;80;222;3295;9136;3375;9358
211180;201508;4229;14893;3985;14517;309;1288;3288;12068;3597;13356
211190;201508;2783;9401;2580;9109;92;446;2239;7905;2331;8351
211195;201508;1470;4499;1218;4183;74;222;1011;3604;1085;3826
211200;201508;2119;7112;1866;6775;303;1026;1297;4996;1600;6022
211210;201508;6794;20757;6488;20344;374;1070;5641;17933;6015;19003
211220;201508;33185;96977;28825;91436;5653;18388;18445;59968;24098;78356
211223;201508;5024;14926;4596;14236;601;1893;3254;10206;3855;12099
211227;201508;1565;5723;1444;5535;120;539;1159;4462;1279;5001
211230;201508;8367;27579;7593;26293;904;3234;5677;19988;6581;23222
211240;201508;8014;27616;7627;27130;284;1172;6844;24224;7128;25396
211245;201508;5384;15829;5343;15784;150;267;5128;15382;5278;15649
211250;201508;12705;43145;11949;42274;1518;4087;9400;35660;10918;39747
211260;201508;8494;26357;8172;25931;583;1996;7146;22622;7729;24618
211270;201508;10282;35409;9195;34032;547;2406;7381;27724;7928;30130
211280;201508;12626;37418;11867;36504;1121;2813;9854;31547;10975;34360
211285;201508;1715;6245;1514;5803;286;1190;786;3110;1072;4300
211290;201508;7171;23682;6915;23351;594;1744;5788;20058;6382;21802
211300;201508;8179;24751;7661;24050;187;564;7084;22422;7271;22986
211400;201508;11509;36016;10297;34385;2675;8905;5169;19025;7844;27930
220005;201508;1820;5267;1667;5036;71;287;1377;4043;1448;4330
220010;201508;1386;4014;1219;3758;73;275;943;2851;1016;3126
220020;201508;3276;10313;3088;9994;568;1868;1994;6440;2562;8308
220025;201508;2171;5382;1961;5057;31;100;1673;4239;1704;4339
220027;201508;1367;3713;1235;3540;69;195;1018;2941;1087;3136
220030;201508;3222;9037;3156;8934;164;552;2775;7781;2939;8333
220040;201508;7488;23500;6995;22631;1393;4590;4444;14349;5837;18939
220045;201508;1385;4501;1263;4267;65;271;958;3176;1023;3447
220050;201508;4438;13287;3900;12374;241;940;3104;9698;3345;10638
220060;201508;1935;5010;1831;4886;52;103;1659;4431;1711;4534
220070;201508;2400;7128;2194;6801;145;470;1776;5494;1921;5964
220080;201508;697;2138;654;2068;60;256;530;1615;590;1871
220090;201508;1784;4529;1514;4180;68;224;1300;3522;1368;3746
220095;201508;726;1971;674;1896;19;78;606;1654;625;1732
220100;201508;1355;4106;1138;3738;104;374;826;2713;930;3087
220105;201508;2201;7097;1965;6647;170;580;1450;4937;1620;5517
220110;201508;3385;9950;3176;9611;143;558;2744;8164;2887;8722
220115;201508;2371;8358;2279;8214;171;715;1966;7032;2137;7747
220117;201508;1309;3508;1081;3169;81;239;875;2575;956;2814
220120;201508;12198;35257;11325;34179;175;762;10646;31986;10821;32748
220130;201508;896;3051;777;2878;69;277;635;2353;704;2630
220140;201508;1630;4412;1444;4183;221;505;1124;3398;1345;3903
220150;201508;6978;21596;6584;21036;204;847;5814;18389;6018;19236
220155;201508;1106;3409;895;3008;59;245;585;1913;644;2158
220157;201508;1046;2664;931;2486;20;65;819;2162;839;2227
220160;201508;2654;7979;2350;7448;117;495;1876;5829;1993;6324
220170;201508;1350;4196;1174;3902;53;246;943;3081;996;3327
220173;201508;2041;6183;1661;5438;52;252;1355;4333;1407;4585
220177;201508;1774;5197;1739;5141;62;224;1611;4733;1673;4957
220180;201508;1135;3094;934;2723;30;112;653;1819;683;1931
220190;201508;4397;14835;4106;14391;612;2183;3064;10818;3676;13001
220191;201508;1407;4757;1337;4638;197;674;933;3244;1130;3918
220192;201508;1813;5099;1427;4402;116;375;994;3062;1110;3437
220194;201508;1644;4958;1476;4666;124;430;1091;3358;1215;3788
220196;201508;1946;5794;1791;5536;184;606;1354;4183;1538;4789
220198;201508;1334;3775;1045;3397;18;60;967;3185;985;3245
220200;201508;4308;14633;4079;14291;621;2208;2890;10222;3511;12430
220202;201508;2069;6428;1854;6036;51;238;1603;5104;1654;5342
220205;201508;2773;7268;2486;6863;47;196;2231;6069;2278;6265
220207;201508;869;2690;760;2498;73;290;568;1837;641;2127
220208;201508;1795;5825;1546;5374;222;887;965;3294;1187;4181
220209;201508;1488;4579;1354;4364;54;240;1093;3483;1147;3723
220210;201508;1711;4642;1508;4324;42;178;1264;3533;1306;3711
220211;201508;1620;4716;1539;4612;86;352;1322;3885;1408;4237
220213;201508;1690;4868;1554;4614;39;155;1275;3686;1314;3841
220217;201508;1911;6213;1839;6127;40;152;1700;5719;1740;5871
220220;201508;10885;30347;9806;28720;840;2172;7121;21394;7961;23566
220225;201508;1072;3150;924;2949;30;124;776;2434;806;2558
220230;201508;5265;14640;4781;13940;161;478;4214;12291;4375;12769
220240;201508;2825;8842;2623;8476;169;627;2049;6594;2218;7221
220245;201508;1492;4007;1306;3744;44;147;1131;3262;1175;3409
220250;201508;3168;9038;2922;8664;75;288;2590;7631;2665;7919
220253;201508;1654;5027;1426;4617;151;566;1041;3321;1192;3887
220255;201508;1737;4955;1507;4563;70;288;1194;3439;1264;3727
220260;201508;4793;15299;4209;14209;347;1225;3128;10613;3475;11838
220265;201508;1323;4626;1204;4429;107;447;810;3034;917;3481
220270;201508;6617;21453;6376;21006;337;1591;5452;17410;5789;19001
220271;201508;1473;4119;1349;3925;88;234;1133;3336;1221;3570
220272;201508;1750;5349;1589;5060;67;292;1274;3975;1341;4267
220273;201508;1214;3536;1069;3271;100;309;771;2342;871;2651
220275;201508;2086;5367;1733;4935;31;128;1575;4414;1606;4542
220277;201508;2263;6355;2020;5972;96;316;1621;4748;1717;5064
220280;201508;1606;4305;1411;3970;102;369;1108;3014;1210;3383
220285;201508;1585;4302;1348;3969;27;112;1199;3542;1226;3654
220290;201508;5976;20187;5222;19138;481;2028;3940;14481;4421;16509
220300;201508;1919;6307;1722;6035;85;425;1392;4808;1477;5233
220310;201508;2368;8167;2216;7997;86;337;1918;7083;2004;7420
220320;201508;3215;9679;2751;8828;317;1116;1964;6297;2281;7413
220323;201508;1457;5212;1280;4952;146;610;965;3769;1111;4379
220325;201508;1165;3775;1014;3466;89;369;729;2473;818;2842
220327;201508;1288;4179;1186;4007;44;233;974;3216;1018;3449
220330;201508;3565;9793;3311;9477;141;402;2970;8549;3111;8951
220335;201508;1862;5680;1695;5481;56;183;1545;5047;1601;5230
220340;201508;1902;5283;1631;4877;125;399;1238;3669;1363;4068
220342;201508;1094;3677;1025;3570;73;319;815;2815;888;3134
220345;201508;2884;7559;2538;7018;69;160;2292;6369;2361;6529
220350;201508;3966;10533;3428;9679;210;620;2684;7534;2894;8154
220360;201508;1280;3589;1103;3303;105;352;841;2481;946;2833
220370;201508;9058;26128;8257;25062;388;1330;7270;21934;7658;23264
220375;201508;1535;4765;1431;4637;27;84;1357;4440;1384;4524
220380;201508;1387;3747;1173;3456;53;177;962;2797;1015;2974
220385;201508;837;2156;675;1895;20;74;546;1502;566;1576
220390;201508;9435;29262;8428;27404;2158;7334;3302;10844;5460;18178
220400;201508;1519;3568;1225;3115;39;136;1021;2497;1060;2633
220410;201508;1408;3982;1165;3625;97;374;886;2684;983;3058
220415;201508;868;2365;770;2239;57;172;560;1595;617;1767
220420;201508;2157;6259;1843;5631;95;297;1460;4445;1555;4742
220430;201508;2532;7314;2461;7218;153;499;2135;6220;2288;6719
220435;201508;1591;4747;1465;4530;45;168;1208;3711;1253;3879
220440;201508;2381;7922;2209;7693;131;498;1867;6428;1998;6926
220450;201508;2138;6600;1817;6131;409;1453;1060;3587;1469;5040
220455;201508;1310;4180;1219;4052;61;224;1087;3622;1148;3846
220460;201508;901;2441;835;2362;45;135;737;2061;782;2196
220465;201508;2340;7742;2116;7402;561;2076;1160;4089;1721;6165
220470;201508;3850;11464;3506;10892;208;697;2722;8338;2930;9035
220480;201508;2498;7120;2194;6669;151;439;1728;5247;1879;5686
220490;201508;2307;6596;2122;6357;69;267;1864;5504;1933;5771
220500;201508;3253;8800;2756;7951;113;497;2246;6287;2359;6784
220510;201508;2720;7911;2184;6988;100;397;1608;5074;1708;5471
220515;201508;1992;4827;1712;4462;165;394;1350;3558;1515;3952
220520;201508;5122;14081;4683;13487;128;398;4211;12165;4339;12563
220525;201508;1311;3703;1224;3571;49;161;1050;3050;1099;3211
220527;201508;1403;4307;1243;3975;146;485;897;2920;1043;3405
220530;201508;1227;3584;1094;3388;58;243;940;2835;998;3078
220535;201508;890;2676;842;2615;88;286;631;1939;719;2225
220540;201508;3434;11191;3282;10954;149;644;2824;9313;2973;9957
220545;201508;1390;4673;1327;4556;166;646;962;3246;1128;3892
220550;201508;9136;29459;8528;28460;1044;3716;6145;20419;7189;24135
220551;201508;1426;4650;1305;4456;70;324;1050;3522;1120;3846
220552;201508;1585;4987;1374;4578;68;336;1042;3337;1110;3673
220553;201508;1598;4660;1316;4231;54;209;1019;3311;1073;3520
220554;201508;813;2363;717;2220;64;205;556;1723;620;1928
220555;201508;2293;6824;2132;6612;61;252;1935;5956;1996;6208
220556;201508;1448;4501;1292;4205;64;263;986;3121;1050;3384
220557;201508;1554;5057;1394;4744;174;623;929;3165;1103;3788
220558;201508;1049;3260;951;3087;67;299;718;2242;785;2541
220559;201508;1497;4256;1361;4018;34;114;1168;3433;1202;3547
220560;201508;1673;4165;1384;3762;69;186;1147;3071;1216;3257
220570;201508;7234;23408;6814;22658;1277;4222;4371;14915;5648;19137
220580;201508;6444;20668;6256;20402;304;987;5615;18324;5919;19311
220585;201508;1998;7155;1892;6958;148;617;1526;5596;1674;6213
220590;201508;1322;3965;1197;3791;201;665;797;2578;998;3243
220595;201508;2303;6816;2144;6603;48;213;1929;5873;1977;6086
220600;201508;1286;3118;1045;2819;177;326;754;2197;931;2523
220605;201508;1958;5739;1679;5283;82;280;1350;4189;1432;4469
220610;201508;2680;8119;2580;7976;69;268;2334;7180;2403;7448
220620;201508;7526;25258;7296;24934;308;1414;6507;22012;6815;23426
220630;201508;401;1241;339;1123;55;185;183;618;238;803
220635;201508;1684;5956;1525;5610;93;446;1083;3908;1176;4354
220640;201508;2671;7792;2423;7442;127;446;2019;6142;2146;6588
220650;201508;2262;6543;2007;6090;124;435;1573;4709;1697;5144
220660;201508;2520;8067;2256;7707;165;762;1851;6132;2016;6894
220665;201508;1186;4072;1111;3935;31;167;995;3486;1026;3653
220667;201508;1733;5716;1633;5568;71;250;1396;4781;1467;5031
220669;201508;1861;6100;1750;5901;272;1087;1170;3868;1442;4955
220670;201508;2031;6042;1825;5778;149;386;1506;4918;1655;5304
220672;201508;2519;7184;2376;7016;244;722;1954;5827;2198;6549
220675;201508;1273;3674;1191;3529;80;212;937;2788;1017;3000
220680;201508;2257;7304;2127;7125;167;556;1768;5980;1935;6536
220690;201508;1670;4666;1452;4307;97;310;1160;3465;1257;3775
220695;201508;906;2588;828;2460;41;129;652;1922;693;2051
220700;201508;8564;24545;7513;22907;552;1913;5794;17530;6346;19443
220710;201508;816;2396;681;2160;42;133;497;1580;539;1713
220720;201508;2010;5431;1917;5313;55;170;1712;4724;1767;4894
220730;201508;1391;3928;1185;3607;30;140;999;2987;1029;3127
220735;201508;1003;2584;814;2250;39;131;663;1797;702;1928
220740;201508;1352;4396;1188;4171;106;352;965;3476;1071;3828
220750;201508;3982;11485;3699;11054;408;1010;2879;8869;3287;9879
220755;201508;1225;3435;1105;3235;51;177;890;2558;941;2735
220760;201508;2633;9164;2457;8923;147;709;2052;7339;2199;8048
220770;201508;22058;72982;19627;68293;6463;23569;6862;24719;13325;48288
220775;201508;1238;3301;1201;3259;14;37;1167;3167;1181;3204
220777;201508;1620;4483;1440;4217;84;233;1133;3289;1217;3522
220779;201508;1324;3536;1272;3458;45;170;1138;3007;1183;3177
220780;201508;5960;15916;5266;14880;373;1051;4293;12171;4666;13222
220785;201508;1247;3345;1181;3228;44;106;1055;2859;1099;2965
220790;201508;9957;30786;9244;29667;849;2944;7277;23220;8126;26164
220793;201508;840;2392;766;2279;46;176;627;1836;673;2012
220795;201508;1464;4128;1407;4045;73;219;1272;3655;1345;3874
220800;201508;16193;44623;14635;42390;958;3326;11264;32072;12222;35398
220810;201508;3314;9647;2860;8863;139;569;2268;6924;2407;7493
220820;201508;5319;14646;4890;14035;185;611;4380;12474;4565;13085
220830;201508;7499;21157;6979;20308;686;2022;5446;15933;6132;17955
220840;201508;14225;44991;12597;41687;2977;9980;5878;19817;8855;29797
220850;201508;2860;9842;2713;9659;125;521;2399;8583;2524;9104
220855;201508;631;1928;553;1791;38;147;409;1300;447;1447
220860;201508;960;2590;852;2419;37;137;706;1973;743;2110
220865;201508;2621;7265;2115;6385;85;410;1678;4870;1763;5280
220870;201508;2257;7582;2024;7260;97;446;1789;6343;1886;6789
220880;201508;4753;12829;4443;12459;121;346;4137;11636;4258;11982
220885;201508;1305;4687;1148;4394;98;462;854;3241;952;3703
220887;201508;1412;3500;1214;3224;20;63;1126;2977;1146;3040
220890;201508;1614;5639;1449;5323;123;449;1118;4192;1241;4641
220900;201508;1864;5331;1646;4931;57;158;1403;4202;1460;4360
220910;201508;1618;4867;1418;4572;51;157;1238;4046;1289;4203
220915;201508;1014;2870;876;2610;40;170;681;1969;721;2139
220920;201508;1337;4801;1217;4625;108;520;905;3362;1013;3882
220930;201508;1361;4543;1299;4450;60;260;1073;3657;1133;3917
220935;201508;1074;3285;938;3001;44;190;636;1946;680;2136
220937;201508;1521;4170;1280;3748;63;230;992;2829;1055;3059
220940;201508;1378;4311;1273;4092;78;336;951;2986;1029;3322
220945;201508;434;1602;400;1535;37;162;285;1072;322;1234
220950;201508;1329;3325;966;2740;29;119;698;1915;727;2034
220955;201508;1463;4232;1277;3912;78;247;956;2901;1034;3148
220960;201508;894;2334;706;2018;16;54;553;1559;569;1613
220965;201508;1703;5060;1588;4885;66;313;1336;3984;1402;4297
220970;201508;2175;5769;1608;4852;144;455;1095;3323;1239;3778
220975;201508;658;2164;615;2102;28;141;561;1875;589;2016
220980;201508;1284;3911;1124;3636;90;327;821;2664;911;2991
220985;201508;1206;3533;1138;3433;92;343;865;2521;957;2864
220987;201508;1486;4734;1334;4472;81;357;1025;3328;1106;3685
220990;201508;1827;5273;1577;4859;44;220;1219;3661;1263;3881
220995;201508;1325;3826;973;3271;103;376;683;2336;786;2712
220997;201508;2214;6926;2097;6750;57;234;1941;6207;1998;6441
221000;201508;4276;13115;3971;12582;364;1331;3031;9488;3395;10819
221005;201508;1456;4561;1328;4315;496;1500;555;1943;1051;3443
221010;201508;1146;3102;974;2879;49;144;825;2425;874;2569
221020;201508;1790;5564;1664;5334;78;325;1229;3849;1307;4174
221030;201508;1500;4449;1351;4191;72;309;1121;3420;1193;3729
221035;201508;1419;3948;1339;3846;50;110;1241;3625;1291;3735
221037;201508;632;1889;566;1778;19;75;409;1227;428;1302
221038;201508;615;1729;498;1523;46;140;315;970;361;1110
221039;201508;909;2605;828;2486;45;185;694;2024;739;2209
221040;201508;4621;14233;4332;13754;215;760;3544;11291;3759;12051
221050;201508;3481;10669;3288;10402;172;638;2825;8870;2997;9508
221060;201508;8189;23709;7211;22127;712;2383;5296;16178;6008;18561
221062;201508;1281;4519;1187;4331;57;304;1002;3592;1059;3896
221063;201508;1043;3465;963;3304;236;756;536;1971;772;2727
221065;201508;2775;7653;2494;7191;159;455;2029;5790;2188;6245
221070;201508;3877;12230;3417;11449;166;672;2764;9253;2930;9925
221080;201508;3489;9116;2986;8432;121;375;2544;7169;2665;7544
221090;201508;1394;3838;1188;3502;38;171;978;2809;1016;2980
221093;201508;1652;4942;1558;4739;278;902;878;2589;1156;3491
221095;201508;958;2598;864;2460;23;60;738;2100;761;2160
221097;201508;790;2227;644;1967;43;170;447;1310;490;1480
221100;201508;114818;334321;104653;317162;20060;64537;63300;188831;83360;253368
221110;201508;10106;32133;9485;31353;436;1801;8018;26187;8454;27988
221120;201508;3946;12937;3732;12565;740;2609;2418;8158;3158;10767
221130;201508;4573;13249;3852;11768;1178;3622;1670;5133;2848;8755
221135;201508;1502;4661;1388;4495;127;473;1141;3644;1268;4117
221140;201508;1330;3291;1207;3125;45;114;1050;2692;1095;2806
221150;201508;1212;3109;989;2719;29;127;780;2084;809;2211
221160;201508;826;2172;774;2091;43;123;616;1673;659;1796
221170;201508;1143;3548;1057;3402;56;196;851;2728;907;2924
230010;201508;3264;9049;2728;8134;245;871;2022;5863;2267;6734
230015;201508;2906;10016;2715;9596;403;1635;1650;5702;2053;7337
230020;201508;13724;44883;13296;44141;705;2650;11329;37577;12034;40227
230030;201508;11961;34605;10864;32891;529;1857;8921;26774;9450;28631
230040;201508;4608;12640;3886;11414;330;1150;2778;8012;3108;9162
230050;201508;2632;9010;2067;7490;424;1597;794;2879;1218;4476
230060;201508;2169;6264;1869;5718;85;313;1397;4202;1482;4515
230070;201508;4356;11980;3715;10952;343;1156;2538;7517;2881;8673
230075;201508;8744;31459;8177;30295;608;3150;6321;22744;6929;25894
230080;201508;2400;6317;1952;5659;106;353;1600;4629;1706;4982
230090;201508;3776;11074;3348;10329;444;1545;2323;7125;2767;8670
230100;201508;16561;49429;15125;46823;2599;8693;8992;27963;11591;36656
230110;201508;13152;41893;12062;39544;2281;7856;6661;21611;8942;29467
230120;201508;7948;21984;6827;20333;786;2281;4625;14532;5411;16813
230125;201508;3014;8759;2469;7738;176;609;1790;5562;1966;6171
230130;201508;5904;19208;4972;17233;450;1845;3396;11541;3846;13386
230140;201508;3571;11382;3030;10401;381;1416;2000;6926;2381;8342
230150;201508;1686;5312;1450;4822;289;1062;799;2592;1088;3654
230160;201508;6224;18710;5547;17664;347;1377;4379;13773;4726;15150
230170;201508;6390;19971;5447;18158;360;1399;3858;12653;4218;14052
230180;201508;1765;5190;1557;4773;104;424;1115;3265;1219;3689
230185;201508;4037;13235;3657;12525;597;2119;2253;7931;2850;10050
230190;201508;12771;40716;11194;37465;2273;8371;5382;17680;7655;26051
230195;201508;5144;15770;4540;14761;313;1320;3532;11127;3845;12447
230200;201508;5271;15155;4736;14116;356;1151;3623;10709;3979;11860
230205;201508;4233;13516;3774;12714;261;1127;2720;9054;2981;10181
230210;201508;8946;25780;7742;23876;1635;5083;4277;13547;5912;18630
230220;201508;13044;37369;11729;35077;1171;3950;8370;24515;9541;28465
230230;201508;7445;24053;6727;22623;983;3359;4281;14583;5264;17942
230240;201508;13683;38763;12032;35914;614;2294;9396;27404;10010;29698
230250;201508;9828;30575;9689;30349;580;2184;7604;23422;8184;25606
230260;201508;14436;48433;13386;46292;2354;8713;7445;26184;9799;34897
230270;201508;7423;22028;6402;20265;748;2624;4205;13415;4953;16039
230280;201508;19573;58341;17491;54761;1935;6207;12463;39163;14398;45370
230290;201508;4810;14689;4113;13278;561;1794;2725;8812;3286;10606
230300;201508;4363;13312;4161;13019;294;1111;3369;10394;3663;11505
230310;201508;4813;14390;4210;13359;253;1070;3071;9533;3324;10603
230320;201508;6940;22023;6347;20951;464;1869;4704;15335;5168;17204
230330;201508;4759;13997;4076;12649;330;1131;2869;8778;3199;9909
230340;201508;3298;11187;3002;10531;378;1489;1932;6610;2310;8099
230350;201508;18046;54999;16313;52019;2109;7509;9496;30643;11605;38152
230360;201508;3278;9372;2666;8229;262;907;1740;5281;2002;6188
230365;201508;2978;8114;2616;7504;134;493;2090;5910;2224;6403
230370;201508;53631;172193;47872;162086;12703;45475;21515;74704;34218;120179
230380;201508;6475;19067;5485;17246;339;1159;3909;12234;4248;13393
230390;201508;3500;11041;3096;10330;258;1129;2178;7098;2436;8227
230393;201508;3287;10797;2792;9790;225;1062;1970;6634;2195;7696
230395;201508;5529;16417;4937;15369;775;2449;3005;9606;3780;12055
230400;201508;5371;16461;4682;15354;295;1287;3578;11465;3873;12752
230410;201508;14298;45726;12488;41848;1800;6469;7610;25481;9410;31950
230420;201508;24014;77911;21814;73394;5017;18152;10167;33982;15184;52134
230423;201508;4190;13828;3859;13154;268;1126;2894;9743;3162;10869
230425;201508;5597;18520;5095;17376;703;2522;3288;11209;3991;13731
230426;201508;2720;7601;2172;6554;91;375;1592;4654;1683;5029
230427;201508;1833;5470;1377;4462;175;574;800;2525;975;3099
230428;201508;8568;26802;8142;26008;1292;4598;4914;15447;6206;20045
230430;201508;4489;14345;4138;13666;335;1367;2966;9544;3301;10911
230435;201508;4804;15519;4324;14626;792;3055;2295;7606;3087;10661
230440;201508;346649;1034263;315881;979762;74800;244357;148308;462127;223108;706484
230445;201508;4522;12223;3800;11145;271;829;2714;7948;2985;8777
230450;201508;3516;11222;3048;10339;374;1572;1965;6493;2339;8065
230460;201508;1892;6273;1656;5836;174;715;1127;3907;1301;4622
230465;201508;4092;12236;3435;11028;259;1087;2256;7010;2515;8097
230470;201508;10683;39202;9879;37504;1242;5176;6836;25953;8078;31129
230480;201508;1451;4634;1232;4222;160;619;808;2733;968;3352
230490;201508;2461;7436;2131;6797;371;1276;1041;3189;1412;4465
230495;201508;5786;19107;5163;18011;724;3005;2834;9757;3558;12762
230500;201508;9373;32899;8935;32048;635;2778;6805;24290;7440;27068
230510;201508;1494;5326;1176;4505;312;1276;367;1420;679;2696
230520;201508;4832;14845;4316;13894;459;1699;2804;8911;3263;10610
230523;201508;14486;47106;12570;42687;2948;10948;3196;11013;6144;21961
230526;201508;4084;12271;3490;11246;253;1038;2631;8331;2884;9369
230530;201508;5373;17402;4827;16663;1014;3540;3032;10813;4046;14353
230533;201508;3943;11133;3489;10280;273;821;2684;7937;2957;8758
230535;201508;5568;16408;4852;15123;736;2306;2885;9265;3621;11571
230540;201508;17697;51616;15910;48767;812;3112;12969;39162;13781;42274
230550;201508;19230;57787;17229;53905;3405;11544;8922;27356;12327;38900
230560;201508;6613;19118;5835;17703;245;998;4525;13419;4770;14417
230565;201508;3426;9525;2769;8279;143;517;2021;5974;2164;6491
230570;201508;3660;9986;3244;9471;119;452;2739;7918;2858;8370
230580;201508;10029;30516;9340;29540;523;1874;8096;25555;8619;27429
230590;201508;8955;28032;7742;25717;589;2497;5519;17794;6108;20291
230600;201508;3730;10445;2891;8781;168;590;1879;5655;2047;6245
230610;201508;6029;19466;5577;18735;761;2670;3841;13032;4602;15702
230620;201508;2157;6165;1705;5180;200;664;969;2844;1169;3508
230625;201508;7982;25674;7101;23682;2018;7229;2130;7012;4148;14241
230630;201508;11278;35796;10223;33841;2636;8243;4762;16835;7398;25078
230640;201508;25871;84768;23861;81743;2638;9940;17993;61570;20631;71510
230650;201508;4941;15089;4436;14119;308;1248;3370;10422;3678;11670
230655;201508;9099;34303;8712;33615;788;3351;6901;26833;7689;30184
230660;201508;6145;19199;5238;17500;380;1675;3865;12580;4245;14255
230670;201508;6107;16398;4868;14271;185;700;3723;10563;3908;11263
230680;201508;2826;8268;2371;7393;375;1258;1363;4198;1738;5456
230690;201508;6298;20563;6169;20300;575;2294;4129;13280;4704;15574
230700;201508;9288;26324;8262;24514;721;2558;5779;16600;6500;19158
230710;201508;7461;24320;6469;22433;749;2657;4534;15822;5283;18479
230720;201508;1861;5883;1592;5333;205;734;945;3160;1150;3894
230725;201508;3720;12593;3201;11294;752;2701;1237;4348;1989;7049
230730;201508;57236;172472;47206;155504;12835;47053;13229;44848;26064;91901
230740;201508;5968;18065;5448;17187;262;1091;4306;13320;4568;14411
230750;201508;8441;24334;7216;22332;454;1649;5468;16680;5922;18329
230760;201508;10473;31242;9696;29677;1052;3818;6777;19957;7829;23775
230763;201508;4256;13203;3854;12427;215;1018;2961;9204;3176;10222
230765;201508;38057;120741;33981;112517;9008;32288;11169;37167;20177;69455
230770;201508;24833;68922;22499;65648;2800;8709;15042;43705;17842;52414
230780;201508;5918;22944;5651;22325;1396;5680;2779;11485;4175;17165
230790;201508;2715;8773;2492;8383;268;1002;1806;6084;2074;7086
230800;201508;7455;26536;6739;24926;1483;5911;2999;10922;4482;16833
230810;201508;11934;38877;11244;37676;923;3399;8783;29345;9706;32744
230820;201508;3324;11392;2893;10430;428;1769;1598;5643;2026;7412
230830;201508;7481;22850;6620;21242;579;2165;4757;15122;5336;17287
230835;201508;3997;10623;3273;9536;216;705;2491;7184;2707;7889
230837;201508;3152;10759;2734;9917;321;1400;1793;6335;2114;7735
230840;201508;9132;29754;8351;28393;759;2942;6195;21094;6954;24036
230850;201508;9679;30017;8975;28865;1037;3548;6287;20184;7324;23732
230860;201508;5138;14799;4536;13833;257;963;3642;10979;3899;11942
230870;201508;18698;49381;16210;45662;798;2580;12509;34915;13307;37495
230880;201508;1915;6559;1798;6322;174;766;1223;4212;1397;4978
230890;201508;3883;14257;3573;13547;463;2086;2236;8249;2699;10335
230900;201508;2947;9815;2490;8836;527;1816;1207;4402;1734;6218
230910;201508;3180;9315;2560;8192;209;910;1806;5590;2015;6500
230920;201508;4669;13579;4341;13173;271;1044;3597;10837;3868;11881
230930;201508;7394;22374;6501;20676;657;2215;4410;14097;5067;16312
230940;201508;7762;22195;6734;20596;363;1156;5347;16453;5710;17609
230945;201508;6194;18596;5335;17314;487;1798;3671;12068;4158;13866
230950;201508;6390;17701;5770;16857;269;789;4866;14476;5135;15265
230960;201508;14106;43367;12794;40844;2594;8681;5859;18866;8453;27547
230970;201508;13375;41084;11724;37956;2337;8356;5318;16848;7655;25204
230980;201508;2949;9312;2574;8622;717;2419;1200;4220;1917;6639
230990;201508;1730;5160;1436;4579;132;553;915;2794;1047;3347
231000;201508;2791;7551;2177;6358;171;584;1384;3899;1555;4483
231010;201508;3208;8699;2616;7717;257;832;1798;5149;2055;5981
231020;201508;7885;26383;7439;25426;1316;4538;4530;15774;5846;20312
231025;201508;8000;24512;7241;23221;1017;3386;4685;15272;5702;18658
231030;201508;7665;24986;6497;22541;1175;4432;3636;12582;4811;17014
231040;201508;3137;10091;2778;9366;188;798;1974;6475;2162;7273
231050;201508;12022;34068;10188;30785;800;2704;7547;22568;8347;25272
231060;201508;2406;7809;2211;7448;168;788;1558;5070;1726;5858
231070;201508;8786;27885;7978;26244;1300;4539;4628;15297;5928;19836
231080;201508;4073;12731;3697;12070;195;958;2838;8861;3033;9819
231085;201508;4714;14705;4515;14434;698;2218;3103;10220;3801;12438
231090;201508;4134;11639;3311;9966;180;629;2307;6831;2487;7460
231095;201508;2302;7436;1967;6758;220;863;1302;4457;1522;5320
231100;201508;3198;9879;2655;8799;226;877;1876;6135;2102;7012
231110;201508;3611;12030;3546;11916;353;1370;2447;8152;2800;9522
231120;201508;2085;7019;1954;6740;309;1150;1255;4354;1564;5504
231123;201508;2104;5777;1788;5221;140;400;1385;4023;1525;4423
231126;201508;6253;17748;5258;16105;327;1260;3848;11586;4175;12846
231130;201508;19150;58962;17178;55638;3480;11595;9749;32941;13229;44536
231135;201508;4245;12655;3570;11457;293;1081;2508;7958;2801;9039
231140;201508;16598;52604;14678;48932;1309;5843;9761;31334;11070;37177
231150;201508;5767;16507;4864;14849;781;2545;2575;7772;3356;10317
231160;201508;5677;19080;5315;18363;886;3174;3391;11712;4277;14886
231170;201508;4205;13596;3782;12709;309;1318;2628;8543;2937;9861
231180;201508;14019;41972;12579;39090;2094;7015;7415;22663;9509;29678
231190;201508;4602;12975;3894;11888;270;971;2968;8858;3238;9829
231195;201508;4572;15440;3898;14071;420;1872;2672;9491;3092;11363
231200;201508;7730;26579;6739;24498;481;2410;4753;16791;5234;19201
231210;201508;5025;15582;4338;14627;302;1425;3353;11112;3655;12537
231220;201508;11782;34472;10509;32107;651;2494;7766;23223;8417;25717
231230;201508;8971;30376;8210;29177;793;3383;6103;21609;6896;24992
231240;201508;12169;38242;10879;35637;2253;7668;5248;17406;7501;25074
231250;201508;1967;5722;1357;4220;430;1307;286;888;716;2195
231260;201508;3548;10484;3190;9923;493;1533;2007;6329;2500;7862
231270;201508;7283;20135;6405;18737;352;1438;4802;13656;5154;15094
231280;201508;1748;5752;1623;5499;180;647;1120;3810;1300;4457
231290;201508;33625;114855;30332;107247;6449;25519;12522;42965;18971;68484
231300;201508;4579;13262;3700;11521;252;990;2552;7682;2804;8672
231310;201508;7414;21075;6107;18367;930;2902;3410;10024;4340;12926
231320;201508;6923;21246;5880;19189;316;1334;4206;13613;4522;14947
231325;201508;2708;8112;2371;7552;300;989;1561;5083;1861;6072
231330;201508;12357;39182;10599;35685;1629;5533;6498;22135;8127;27668
231335;201508;5341;15293;4580;13897;218;895;3540;10447;3758;11342
231340;201508;17404;57282;16034;55176;1080;3772;12836;44923;13916;48695
231350;201508;13121;41639;12623;40898;1128;3550;10512;34510;11640;38060
231355;201508;4379;14048;4075;13534;288;1180;3050;10000;3338;11180
231360;201508;7711;24716;6889;23243;1386;4691;4064;14127;5450;18818
231370;201508;2468;6857;1932;5971;91;297;1427;4398;1518;4695
231375;201508;4155;14235;3867;13688;237;1120;3033;10540;3270;11660
231380;201508;5183;16579;4896;16187;622;2142;3372;11447;3994;13589
231390;201508;3403;10732;3135;10284;246;924;2256;7339;2502;8263
231395;201508;3856;12642;3496;11966;611;2120;1986;6846;2597;8966
231400;201508;9052;27849;8433;26605;569;2191;6228;19332;6797;21523
231410;201508;13780;47013;12695;45307;1279;4812;9638;34648;10917;39460
240010;201508;2436;7360;2029;6504;346;1218;979;3034;1325;4252
240020;201508;10668;33567;9453;31215;2118;7456;4545;15070;6663;22526
240030;201508;2413;7046;2350;6945;133;451;1970;5714;2103;6165
240040;201508;835;2461;695;2181;27;132;509;1509;536;1641
240050;201508;3451;9368;2940;8482;120;413;2345;6655;2465;7068
240060;201508;1392;4032;1244;3746;59;234;995;2876;1054;3110
240070;201508;2581;7454;2415;7134;380;1180;1620;4733;2000;5913
240080;201508;3051;8201;2625;7629;229;661;2003;5811;2232;6472
240090;201508;2310;6226;1901;5495;50;186;1466;4117;1516;4303
240100;201508;8202;23487;7370;21770;648;2126;5321;15332;5969;17458
240110;201508;4846;15079;4301;13982;658;2449;2397;7436;3055;9885
240120;201508;2691;9174;2566;8924;386;1471;1662;5719;2048;7190
240130;201508;2794;7545;2393;6929;133;485;1889;5323;2022;5808
240140;201508;2230;6680;1900;6078;320;1194;1040;3197;1360;4391
240145;201508;5784;18323;5219;17295;1390;4873;2541;8556;3931;13429
240150;201508;976;2989;807;2629;81;330;522;1622;603;1952
240160;201508;1437;4635;1242;4286;166;630;758;2683;924;3313
240165;201508;887;2830;776;2599;119;361;478;1682;597;2043
240170;201508;2379;7152;2077;6601;518;1812;963;2990;1481;4802
240180;201508;2595;8250;2320;7698;471;1646;1286;4335;1757;5981
240185;201508;1411;4734;1342;4608;111;407;1048;3609;1159;4016
240190;201508;966;2985;868;2809;50;231;643;2023;693;2254
240200;201508;13791;35900;11387;32555;2533;7402;5302;15591;7835;22993
240210;201508;2863;8050;2593;7652;200;728;2087;6002;2287;6730
240220;201508;7327;24315;6875;23645;609;2782;5218;17457;5827;20239
240230;201508;5584;14941;4887;13834;177;588;4118;11566;4295;12154
240240;201508;1839;5571;1259;4141;282;1054;242;677;524;1731
240250;201508;2677;7817;2514;7600;129;437;2130;6387;2259;6824
240260;201508;12204;41201;11525;40064;1840;7196;7390;25581;9230;32777
240270;201508;2231;7161;2052;6864;200;691;1568;5309;1768;6000
240280;201508;1535;4348;1374;4089;83;299;1107;3254;1190;3553
240290;201508;1293;4125;1139;3830;73;363;756;2407;829;2770
240300;201508;2250;6252;1639;4939;370;1202;593;1712;963;2914
240310;201508;9548;27281;8669;25875;1260;4183;4768;14239;6028;18422
240320;201508;2046;6064;1613;5162;59;262;1187;3640;1246;3902
240325;201508;34974;96268;27447;84058;8488;27846;6863;21355;15351;49201
240330;201508;1487;4514;1248;4004;81;320;818;2519;899;2839
240340;201508;1941;5346;1660;4890;195;618;1160;3370;1355;3988
240350;201508;1928;5716;1799;5555;125;446;1545;4758;1670;5204
240360;201508;7092;21234;6183;19867;1185;4108;3418;11241;4603;15349
240370;201508;1938;5389;1576;4726;215;639;954;2884;1169;3523
240375;201508;841;2283;733;2105;119;396;449;1201;568;1597
240380;201508;2440;7289;1881;6019;264;867;945;2985;1209;3852
240390;201508;940;2590;783;2300;47;181;560;1576;607;1757
240400;201508;1330;3652;1099;3228;92;312;763;2168;855;2480
240410;201508;495;1626;458;1552;83;345;278;898;361;1243
240420;201508;4531;17377;4270;16787;965;4078;2296;9098;3261;13176
240430;201508;3242;9201;2971;8718;139;549;2365;6711;2504;7260
240440;201508;2525;6645;2248;6209;596;1650;1120;3104;1716;4754
240450;201508;3760;11191;3250;10204;306;1257;2043;6043;2349;7300
240460;201508;2896;8924;2740;8715;188;797;2249;6951;2437;7748
240470;201508;3633;11288;2888;9685;800;2586;1323;4523;2123;7109
240480;201508;520;1361;408;1142;38;110;226;609;264;719
240485;201508;2002;6254;1759;5794;311;1074;1003;3335;1314;4409
240490;201508;1655;4224;1394;3826;40;152;1159;3087;1199;3239
240500;201508;2088;6029;1892;5729;131;455;1474;4424;1605;4879
240510;201508;1784;5348;1651;5126;154;515;1288;3991;1442;4506
240520;201508;1244;3645;1121;3436;112;409;821;2433;933;2842
240530;201508;2031;6519;1849;6225;313;1120;1250;4194;1563;5314
240540;201508;1615;5004;1549;4895;122;427;1259;3952;1381;4379
240550;201508;818;2330;707;2144;48;171;536;1586;584;1757
240560;201508;3156;9291;2950;8970;330;1056;2227;6724;2557;7780
240570;201508;3075;8668;2334;6992;524;1703;843;2237;1367;3940
240580;201508;7506;23759;6980;22800;861;3124;5200;16750;6061;19874
240590;201508;778;2206;677;2015;35;136;507;1465;542;1601
240600;201508;1627;4793;1279;4053;170;617;703;2124;873;2741
240610;201508;4689;13376;4049;12157;491;1608;2548;7443;3039;9051
240615;201508;1031;3005;836;2634;151;495;464;1421;615;1916
240620;201508;1752;5485;1558;5162;181;591;1144;3835;1325;4426
240630;201508;1988;6114;1836;5847;176;480;1327;4361;1503;4841
240640;201508;914;2647;771;2407;60;281;532;1578;592;1859
240650;201508;3741;11282;3382;10757;198;728;2710;8582;2908;9310
240660;201508;2384;7681;2236;7467;215;760;1730;5792;1945;6552
240670;201508;2684;8038;2217;7040;287;973;1227;3829;1514;4802
240680;201508;1500;4415;1214;3891;111;384;753;2387;864;2771
240690;201508;928;2603;812;2409;54;209;669;1932;723;2141
240700;201508;2664;7945;2200;7057;89;412;1676;5238;1765;5650
240710;201508;18846;49094;16330;45435;3058;8453;9511;26884;12569;35337
240720;201508;5205;14841;4745;13989;1479;4511;2147;6075;3626;10586
240725;201508;1042;3157;827;2668;78;263;479;1508;557;1771
240730;201508;2156;6509;1853;5945;129;452;1381;4413;1510;4865
240740;201508;1977;5811;1757;5398;166;638;1239;3665;1405;4303
240750;201508;2158;8100;1995;7782;492;2113;990;3832;1482;5945
240760;201508;1319;3644;1117;3371;106;241;827;2683;933;2924
240770;201508;3140;9027;2805;8559;165;652;2313;6951;2478;7603
240780;201508;6296;17254;4983;15187;901;2814;2645;8191;3546;11005
240790;201508;881;2692;727;2418;40;150;489;1654;529;1804
240800;201508;35632;102290;31482;95176;7654;24038;13245;40397;20899;64435
240810;201508;84879;245617;78377;234321;20712;63781;37349;112914;58061;176695
240820;201508;6501;19653;5600;18203;1366;4805;2351;7886;3717;12691
240830;201508;8579;26808;8026;25975;431;1723;6748;21589;7179;23312
240840;201508;1246;3474;1040;3144;87;285;673;1975;760;2260
240850;201508;1280;3811;928;2999;151;527;444;1400;595;1927
240860;201508;1319;3732;1083;3309;60;215;816;2417;876;2632
240870;201508;1186;3248;957;2820;83;279;596;1664;679;1943
240880;201508;1126;3815;1061;3705;99;433;827;2801;926;3234
240890;201508;5061;14439;4266;12929;887;2869;1898;5592;2785;8461
240895;201508;2607;9013;2386;8606;265;1041;1675;6084;1940;7125
240910;201508;2786;8490;2470;7879;175;663;1856;5849;2031;6512
240920;201508;789;2549;683;2314;136;535;327;1058;463;1593
240930;201508;3444;9049;3047;8567;169;481;2480;7034;2649;7515
240933;201508;1359;3977;1224;3754;123;448;876;2615;999;3063
240940;201508;6418;17496;5205;15373;948;2758;2831;8400;3779;11158
240950;201508;998;3256;944;3155;68;317;724;2333;792;2650
240960;201508;779;2436;687;2257;82;290;467;1532;549;1822
240970;201508;1941;5376;1632;4859;123;432;1213;3488;1336;3920
240980;201508;3023;9975;2788;9522;526;1890;1718;5875;2244;7765
240990;201508;2862;8474;2662;8053;443;1428;1604;4772;2047;6200
241000;201508;1050;2932;893;2649;47;171;621;1803;668;1974
241010;201508;2906;9725;2676;9265;336;1411;1848;6194;2184;7605
241020;201508;2051;5730;1656;4945;148;468;1062;3052;1210;3520
241025;201508;1633;4951;1458;4621;84;363;1020;3136;1104;3499
241030;201508;2489;8214;2234;7716;190;826;1634;5578;1824;6404
241040;201508;2234;7675;2044;7323;207;841;1410;5090;1617;5931
241050;201508;1239;3697;1092;3432;54;227;836;2550;890;2777
241060;201508;882;2547;794;2394;59;182;582;1741;641;1923
241070;201508;813;2335;729;2185;73;252;510;1473;583;1725
241080;201508;1164;3431;960;3038;45;198;704;2181;749;2379
241090;201508;2165;6337;1834;5744;131;577;1386;4235;1517;4812
241100;201508;1177;3528;1011;3139;101;326;652;2005;753;2331
241105;201508;1198;3608;1075;3383;235;777;542;1741;777;2518
241110;201508;824;2596;682;2287;50;220;435;1427;485;1647
241120;201508;7267;22282;6596;21211;1379;4451;3874;12789;5253;17240
241140;201508;3352;9245;2902;8351;311;880;2011;5700;2322;6580
241142;201508;712;2153;530;1743;134;512;181;553;315;1065
241150;201508;5451;16179;4854;15145;599;1968;3241;10086;3840;12054
241160;201508;968;2851;894;2714;127;420;591;1769;718;2189
241170;201508;1144;3408;1065;3273;102;305;804;2480;906;2785
241180;201508;927;2615;757;2289;100;318;392;1145;492;1463
241190;201508;1201;3313;964;2839;67;245;600;1682;667;1927
241200;201508;19063;55676;16866;52110;3951;13066;7705;24023;11656;37089
241210;201508;1452;4106;1166;3510;186;650;606;1741;792;2391
241220;201508;7659;25527;7153;24542;1606;5836;3845;13320;5451;19156
241230;201508;3002;8834;2736;8432;162;642;2281;6880;2443;7522
241240;201508;1195;3521;817;2622;104;366;341;1087;445;1453
241250;201508;5917;18434;4996;16635;255;1319;3855;12433;4110;13752
241255;201508;1637;6363;1529;6106;350;1486;754;3052;1104;4538
241260;201508;5049;13681;4074;12154;221;893;2990;8698;3211;9591
241270;201508;1825;5673;1606;5222;147;539;1053;3385;1200;3924
241280;201508;1860;5406;1696;5086;212;646;1191;3548;1403;4194
241290;201508;3049;8605;2556;7731;300;954;1673;5007;1973;5961
241300;201508;1443;4148;1248;3796;61;197;889;2706;950;2903
241310;201508;1578;4795;1457;4585;143;492;1068;3336;1211;3828
241320;201508;915;3127;832;2948;125;493;509;1783;634;2276
241330;201508;1430;4472;1323;4327;104;444;1086;3468;1190;3912
241335;201508;2692;8216;2487;7844;150;527;2052;6418;2202;6945
241340;201508;1842;5732;1577;5148;368;1315;695;2171;1063;3486
241350;201508;1916;6066;1731;5724;146;628;1288;4105;1434;4733
241355;201508;1387;3926;1136;3499;54;185;941;2874;995;3059
241360;201508;2022;5524;1688;4890;76;220;1240;3482;1316;3702
241370;201508;1343;4095;1098;3592;146;538;610;1932;756;2470
241380;201508;659;1884;557;1676;90;280;318;947;408;1227
241390;201508;2701;8976;2526;8661;333;1317;1816;6153;2149;7470
241400;201508;3744;10946;3430;10529;381;1288;2561;7859;2942;9147
241410;201508;2539;7651;2281;7267;488;1661;1289;4075;1777;5736
241415;201508;1666;5040;1508;4785;101;397;1189;3704;1290;4101
241420;201508;2281;7892;1989;7386;623;2544;502;1794;1125;4338
241430;201508;575;1730;451;1439;51;180;248;745;299;925
241440;201508;6203;22417;5833;21792;1160;4474;3753;14267;4913;18741
241445;201508;1029;2999;978;2935;85;211;797;2535;882;2746
241450;201508;3160;8614;2754;8025;333;1069;1872;5374;2205;6443
241460;201508;3376;9915;2982;9121;262;906;2117;6310;2379;7216
241470;201508;1342;3801;1121;3509;147;520;749;2308;896;2828
241475;201508;1219;3718;1005;3269;46;203;760;2376;806;2579
241480;201508;2732;9142;2511;8760;975;3502;740;2767;1715;6269
241490;201508;660;1757;557;1607;40;112;340;961;380;1073
241500;201508;772;2443;657;2257;35;155;477;1590;512;1745
250010;201508;2701;8507;2319;7644;151;639;1706;5478;1857;6117
250020;201508;1653;4765;1267;4053;77;326;839;2561;916;2887
250030;201508;6888;20209;6480;19621;517;1652;5282;15949;5799;17601
250040;201508;4220;14152;3887;13425;648;2352;2401;8297;3049;10649
250050;201508;3411;10812;3227;10537;436;1525;2227;7196;2663;8721
250053;201508;1226;3682;1125;3544;150;490;773;2471;923;2961
250057;201508;635;2636;625;2626;13;25;593;2569;606;2594
250060;201508;4977;15093;4672;14639;412;1511;3703;11398;4115;12909
250070;201508;3934;12274;3655;11795;175;810;2871;8925;3046;9735
250073;201508;752;2308;665;2153;45;174;530;1687;575;1861
250077;201508;2122;6235;1793;5705;188;629;1150;3698;1338;4327
250080;201508;4105;12048;3954;11806;395;1220;2995;8758;3390;9978
250090;201508;2524;7381;2414;7196;97;317;2004;5887;2101;6204
250100;201508;3852;12760;3642;12375;358;1332;2780;9321;3138;10653
250110;201508;5219;15640;4945;15241;479;1714;3886;11790;4365;13504
250115;201508;518;1694;459;1555;29;153;300;945;329;1098
250120;201508;1973;5942;1714;5428;104;369;1314;4126;1418;4495
250130;201508;5372;16744;4995;16145;234;927;4160;13374;4394;14301
250135;201508;1050;3256;959;3097;73;274;706;2274;779;2548
250140;201508;1983;6669;1900;6534;168;691;1468;5056;1636;5747
250150;201508;4982;16780;4526;15915;346;1509;3289;11374;3635;12883
250153;201508;1429;3916;1261;3667;44;195;1076;3044;1120;3239
250157;201508;1699;5654;1565;5379;177;704;1129;3857;1306;4561
250160;201508;3201;9790;3090;9620;146;556;2790;8636;2936;9192
250170;201508;1489;4504;1361;4306;225;739;919;2936;1144;3675
250180;201508;15474;45974;14672;44722;1422;5232;10910;32306;12332;37538
250190;201508;4133;11986;3769;11398;627;1918;2276;6779;2903;8697
250200;201508;2011;5867;1689;5395;111;428;1377;4354;1488;4782
250205;201508;878;3027;820;2914;55;276;609;2128;664;2404
250210;201508;1475;4929;1374;4770;121;486;1025;3481;1146;3967
250215;201508;1349;4489;1285;4389;109;444;866;2917;975;3361
250220;201508;738;2205;657;2098;39;151;558;1765;597;1916
250230;201508;1560;3972;1324;3579;79;241;1058;2746;1137;2987
250240;201508;2305;7775;2183;7545;131;519;1745;6018;1876;6537
250250;201508;4228;12873;3918;12454;202;673;3358;10733;3560;11406
250260;201508;1683;5191;1485;4885;84;338;1161;3805;1245;4143
250270;201508;1218;3858;1112;3723;105;347;848;2929;953;3276
250280;201508;3583;10698;3165;10026;421;1340;2274;7253;2695;8593
250290;201508;1942;5155;1647;4775;39;164;1471;4249;1510;4413
250300;201508;5428;15864;5133;15505;592;2491;4127;11803;4719;14294
250310;201508;1153;3539;1020;3327;104;393;781;2507;885;2900
250320;201508;7899;24300;7519;23585;948;3336;5196;15872;6144;19208
250330;201508;2447;7678;2122;7196;158;657;1644;5481;1802;6138
250340;201508;1083;3236;979;3059;40;148;821;2535;861;2683
250350;201508;4176;11687;3735;11151;155;543;3233;9668;3388;10211
250355;201508;1858;6003;1716;5796;89;454;1456;4771;1545;5225
250360;201508;1827;5486;1725;5337;62;189;1497;4661;1559;4850
250370;201508;11514;33894;10453;32721;895;2924;8927;28073;9822;30997
250375;201508;1079;3343;1002;3229;43;167;863;2771;906;2938
250380;201508;1685;4819;1588;4696;93;362;1363;3958;1456;4320
250390;201508;1913;5135;1531;4488;173;505;1036;3028;1209;3533
250400;201508;67915;183640;55218;163121;13676;42480;23946;71255;37622;113735
250403;201508;1516;4965;1409;4818;235;897;855;2839;1090;3736
250407;201508;1182;3370;1030;3120;76;242;738;2172;814;2414
250410;201508;541;1796;504;1722;33;164;397;1314;430;1478
250415;201508;1743;5396;1584;5112;110;385;1185;3770;1295;4155
250420;201508;1226;3701;1135;3566;35;136;994;3084;1029;3220
250430;201508;6009;16666;5649;16128;299;1013;4730;13271;5029;14284
250435;201508;1333;4121;1212;3903;146;538;829;2640;975;3178
250440;201508;4350;12766;4038;12319;181;541;3387;10333;3568;10874
250450;201508;1961;5620;1771;5361;65;213;1529;4572;1594;4785
250460;201508;6350;19191;5921;18590;626;2054;4534;14392;5160;16446
250470;201508;1508;4180;1292;3878;142;494;859;2441;1001;2935
250480;201508;3675;11249;3441;10911;98;434;3048;9573;3146;10007
250485;201508;670;1677;548;1489;30;98;438;1148;468;1246
250490;201508;3737;11983;3651;11861;840;2779;2302;7515;3142;10294
250500;201508;1746;5288;1557;4982;318;959;966;3195;1284;4154
250510;201508;4612;13346;4151;12662;185;657;3587;10910;3772;11567
250520;201508;1697;5217;1593;5038;244;846;965;2980;1209;3826
250523;201508;1566;5077;1513;4994;232;834;1050;3437;1282;4271
250527;201508;1379;4176;1313;4095;25;121;1205;3700;1230;3821
250530;201508;622;1905;533;1794;26;77;467;1603;493;1680
250535;201508;1291;4064;1224;3927;55;232;982;3081;1037;3313
250540;201508;2351;6956;2210;6793;54;252;1959;5887;2013;6139
250550;201508;885;2972;799;2835;52;244;625;2175;677;2419
250560;201508;1647;5192;1599;5122;95;382;1393;4394;1488;4776
250570;201508;2619;8328;2298;7703;162;677;1723;5659;1885;6336
250580;201508;1114;3001;945;2729;92;344;724;2003;816;2347
250590;201508;879;2765;827;2702;83;341;669;2120;752;2461
250600;201508;7148;20912;6700;20272;572;1650;5302;16156;5874;17806
250610;201508;3067;9107;2835;8757;294;956;2088;6464;2382;7420
250620;201508;695;2044;614;1881;107;340;369;1113;476;1453
250625;201508;2332;7527;2292;7479;155;461;2083;6884;2238;7345
250630;201508;9150;28829;8502;27533;1988;6535;4407;14340;6395;20875
250640;201508;3433;10558;3288;10384;167;711;2866;8891;3033;9602
250650;201508;773;2295;694;2163;52;214;503;1501;555;1715
250660;201508;1884;5019;1711;4795;34;81;1607;4540;1641;4621
250670;201508;2378;8101;2272;7909;147;674;1879;6423;2026;7097
250680;201508;4679;13562;4466;13288;192;753;3901;11463;4093;12216
250690;201508;5925;15583;5670;15272;418;1128;5006;13451;5424;14579
250700;201508;4924;14509;4478;13849;736;2359;2928;9004;3664;11363
250710;201508;4141;13374;3889;13017;555;1965;2661;9008;3216;10973
250720;201508;2567;7584;2446;7391;104;443;2134;6341;2238;6784
250730;201508;3491;10707;3285;10408;307;1043;2410;7483;2717;8526
250740;201508;1869;5540;1674;5227;146;567;1262;3805;1408;4372
250750;201508;98035;278759;90668;267764;12922;41695;61260;178262;74182;219957
250760;201508;2192;6332;1968;6012;131;474;1603;4822;1734;5296
250770;201508;3741;12796;3548;12540;577;2195;2300;8121;2877;10316
250780;201508;1803;5310;1561;4866;180;680;1010;3010;1190;3690
250790;201508;2400;7883;2272;7667;511;1742;1289;4449;1800;6191
250800;201508;2618;7408;2323;6921;101;332;1912;5593;2013;5925
250810;201508;1297;3805;1133;3560;88;361;886;2722;974;3083
250820;201508;1816;5713;1743;5618;62;261;1594;5103;1656;5364
250830;201508;5657;18202;5241;17353;633;2312;3490;11328;4123;13640
250840;201508;906;2922;774;2630;58;234;520;1748;578;1982
250850;201508;1942;6020;1766;5730;105;479;1380;4382;1485;4861
250855;201508;1037;3144;957;3023;66;290;731;2224;797;2514
250860;201508;3061;10060;2666;9323;662;2488;843;2945;1505;5433
250870;201508;1054;3089;970;2935;39;162;755;2210;794;2372
250880;201508;1371;3901;1203;3661;171;523;859;2623;1030;3146
250890;201508;9083;27942;8504;27119;1115;4383;5925;18154;7040;22537
250900;201508;2809;9156;2473;8489;266;885;1791;6196;2057;7081
250905;201508;1957;6318;1879;6212;303;999;1354;4539;1657;5538
250910;201508;4910;14285;4662;13916;294;976;3805;11255;4099;12231
250915;201508;1412;4373;1380;4319;106;296;1170;3738;1276;4034
250920;201508;3290;9506;3078;9173;403;1133;2132;6441;2535;7574
250930;201508;1962;6128;1842;5926;216;835;1291;4036;1507;4871
250933;201508;1100;3634;1045;3521;83;331;760;2518;843;2849
250937;201508;660;2083;611;1981;64;258;433;1369;497;1627
250939;201508;1535;4820;1445;4660;149;505;1008;3235;1157;3740
250940;201508;3660;10997;3446;10645;138;535;2887;8875;3025;9410
250950;201508;1246;3851;1108;3671;42;168;899;2950;941;3118
250960;201508;1096;3596;1043;3518;89;348;828;2780;917;3128
250970;201508;8320;23180;7246;21522;873;2625;5026;14928;5899;17553
250980;201508;2522;7533;2305;7132;133;535;1669;4954;1802;5489
250990;201508;1945;6667;1748;6229;253;1034;1081;3737;1334;4771
251000;201508;2119;6419;1941;6137;77;327;1615;5055;1692;5382
251010;201508;2788;8134;2508;7698;96;333;2148;6606;2244;6939
251020;201508;1569;4640;1448;4480;84;269;1283;3982;1367;4251
251030;201508;1109;3128;1006;2940;68;236;734;2106;802;2342
251040;201508;1793;5685;1622;5398;121;554;1195;3826;1316;4380
251050;201508;1061;3111;926;2867;105;347;600;1832;705;2179
251060;201508;993;2337;774;2045;49;157;601;1557;650;1714
251065;201508;464;1417;412;1334;30;110;275;827;305;937
251070;201508;627;1761;564;1677;50;197;436;1223;486;1420
251080;201508;19599;55395;17781;52344;4523;13800;8711;26181;13234;39981
251090;201508;2936;9198;2622;8575;215;807;1888;6063;2103;6870
251100;201508;922;2976;816;2778;107;430;494;1610;601;2040
251110;201508;1977;5803;1730;5327;160;496;1174;3599;1334;4095
251120;201508;5993;20469;5742;20021;686;2834;4203;14365;4889;17199
251130;201508;4015;10436;3660;10058;17;38;3594;9910;3611;9948
251140;201508;4116;12699;3872;12310;131;590;3255;10274;3386;10864
251150;201508;2435;8086;2303;7881;219;959;1717;5715;1936;6674
251160;201508;1741;5772;1681;5694;60;240;1530;5186;1590;5426
251170;201508;1406;4290;1335;4205;95;374;1104;3386;1199;3760
251180;201508;2524;7751;2321;7435;427;1335;1389;4476;1816;5811
251190;201508;4272;11959;4120;11787;187;551;3798;10854;3985;11405
251200;201508;3783;12326;3664;12180;86;352;3402;11285;3488;11637
251203;201508;1031;3449;998;3385;60;300;781;2586;841;2886
251207;201508;1104;3472;956;3206;68;325;654;2085;722;2410
251210;201508;7858;22408;6736;20927;753;2284;5124;16370;5877;18654
251220;201508;1097;2959;915;2687;94;285;685;2019;779;2304
251230;201508;4417;13555;4108;13191;224;877;3678;11719;3902;12596
251240;201508;3124;9745;2967;9540;377;1218;2244;7227;2621;8445
251250;201508;10170;30241;9408;29062;990;3564;7010;21162;8000;24726
251260;201508;505;1586;459;1519;21;78;343;1126;364;1204
251270;201508;4178;13451;3907;13119;155;705;3439;11494;3594;12199
251272;201508;1333;3981;1282;3908;85;276;1118;3411;1203;3687
251274;201508;870;2777;793;2635;82;333;565;1831;647;2164
251275;201508;1214;3596;1161;3513;88;373;861;2461;949;2834
251276;201508;1189;3715;1110;3568;80;322;814;2552;894;2874
251278;201508;557;1803;497;1683;65;268;325;1088;390;1356
251280;201508;2274;7006;2155;6804;144;543;1687;5167;1831;5710
251290;201508;5524;15394;5218;15031;592;2108;4046;11263;4638;13371
251300;201508;737;2507;689;2428;43;183;537;1874;580;2057
251310;201508;2986;8899;2766;8579;124;526;2285;6898;2409;7424
251315;201508;1585;5536;1510;5402;198;712;1016;3677;1214;4389
251320;201508;1850;5209;1468;4570;64;240;1076;3305;1140;3545
251330;201508;1808;4866;1570;4544;92;393;1333;3699;1425;4092
251335;201508;1017;3483;942;3350;92;419;657;2269;749;2688
251340;201508;3436;9692;2977;8996;224;887;2231;6502;2455;7389
251350;201508;1321;4206;1228;4050;105;401;924;2961;1029;3362
251360;201508;1763;5681;1608;5483;69;306;1392;4721;1461;5027
251365;201508;811;2383;648;2037;27;109;456;1394;483;1503
251370;201508;21471;68213;20915;67417;1888;7551;16474;51476;18362;59027
251380;201508;1340;4177;1151;3849;47;246;944;3024;991;3270
251385;201508;815;2240;710;2065;81;226;445;1241;526;1467
251390;201508;5753;19853;5263;18999;1207;4540;3025;11037;4232;15577
251392;201508;1022;3038;931;2904;72;247;699;2151;771;2398
251394;201508;601;1867;496;1660;33;129;356;1166;389;1295
251396;201508;832;2371;725;2189;106;329;473;1402;579;1731
251398;201508;979;2870;844;2603;53;201;566;1710;619;1911
251400;201508;1169;3310;1009;3093;93;364;744;2192;837;2556
251410;201508;1336;3602;1228;3429;66;260;1020;2773;1086;3033
251420;201508;1964;5758;1757;5502;214;672;1241;3865;1455;4537
251430;201508;1673;5914;1530;5668;94;468;1253;4546;1347;5014
251440;201508;1280;3783;1057;3347;69;233;772;2434;841;2667
251445;201508;1523;4668;1449;4562;79;345;1208;3684;1287;4029
251450;201508;4414;14365;4153;14010;126;611;3554;11878;3680;12489
251455;201508;1091;3515;986;3322;92;349;682;2290;774;2639
251460;201508;810;2510;763;2435;81;235;603;1964;684;2199
251465;201508;437;1392;382;1270;19;85;281;908;300;993
251470;201508;1167;3444;966;3056;92;322;581;1824;673;2146
251480;201508;963;2714;858;2530;27;134;706;2007;733;2141
251490;201508;1697;5181;1545;4943;186;697;1053;3329;1239;4026
251500;201508;1679;5498;1634;5414;145;557;1255;4067;1400;4624
251510;201508;2566;8428;2314;7906;438;1550;1271;4328;1709;5878
251520;201508;902;2533;807;2377;116;339;492;1443;608;1782
251530;201508;11553;32888;10984;32103;385;1646;9461;26934;9846;28580
251540;201508;2816;9135;2598;8699;200;842;2058;6797;2258;7639
251550;201508;3476;9034;2998;8397;84;327;2564;7057;2648;7384
251560;201508;700;2184;651;2092;88;340;391;1169;479;1509
251570;201508;1000;2968;809;2580;47;198;564;1717;611;1915
251580;201508;1897;5383;1758;5189;361;933;1138;3518;1499;4451
251590;201508;1542;5059;1487;4989;57;232;1296;4340;1353;4572
251593;201508;983;3077;914;2984;132;481;580;1848;712;2329
251597;201508;1896;5840;1829;5755;80;337;1581;4884;1661;5221
251600;201508;6496;19149;6063;18459;372;1258;4918;14874;5290;16132
251610;201508;3191;9717;2959;9356;317;999;2128;6742;2445;7741
251615;201508;1129;3293;921;2937;81;323;631;1956;712;2279
251620;201508;14995;42319;13161;40061;980;3056;10678;33071;11658;36127
251630;201508;4499;11754;3909;10923;244;731;3145;8683;3389;9414
251640;201508;2545;7450;2120;6711;139;552;1578;4933;1717;5485
251650;201508;3852;11291;3574;10911;237;792;3059;9283;3296;10075
251660;201508;3390;11118;3157;10708;131;648;2620;8626;2751;9274
251670;201508;4361;12961;3752;12167;57;179;3455;11335;3512;11514
251675;201508;707;2287;653;2209;140;506;363;1204;503;1710
251680;201508;2655;7670;2198;6945;117;510;1719;5292;1836;5802
251690;201508;3208;9834;2994;9413;170;615;2329;7185;2499;7800
251700;201508;1940;6275;1818;6114;121;522;1535;5098;1656;5620
251710;201508;923;2398;670;1922;83;280;374;1030;457;1310
251720;201508;1376;4247;1216;3966;89;425;917;2866;1006;3291
251740;201508;774;2206;614;1927;74;246;376;1178;450;1424
260005;201508;25154;61380;21371;56051;4633;12133;11749;30976;16382;43109
260010;201508;9763;26341;7955;24041;1214;3691;4856;15227;6070;18918
260020;201508;5567;16265;4767;15041;318;1094;3641;11592;3959;12686
260030;201508;5804;16953;5276;16142;391;1332;4083;12424;4474;13756
260040;201508;10096;24367;8331;22363;732;1798;6375;17716;7107;19514
260050;201508;11141;34747;10406;33888;580;2097;9007;29592;9587;31689
260060;201508;3868;10938;3432;10182;324;959;2522;7531;2846;8490
260070;201508;9674;28168;8949;27014;1460;4743;5693;16911;7153;21654
260080;201508;5466;14891;4833;13971;604;1836;3399;9732;4003;11568
260090;201508;5094;14262;4777;13798;954;2627;3142;9294;4096;11921
260100;201508;3287;9050;2863;8446;171;666;2354;6861;2525;7527
260105;201508;4666;13514;4438;13092;396;1339;3400;9794;3796;11133
260110;201508;20694;59031;19146;57160;890;2752;16923;50659;17813;53411
260120;201508;11467;35134;10381;33216;2601;8467;5287;17584;7888;26051
260130;201508;3223;9117;3007;8777;456;1260;2083;6181;2539;7441
260140;201508;13206;32900;11257;30522;880;2633;8890;24238;9770;26871
260150;201508;3105;8841;2766;8377;206;796;2174;6528;2380;7324
260160;201508;5604;17721;5001;16940;340;1444;4021;13521;4361;14965
260170;201508;16109;45692;15455;44743;1141;3475;12796;36956;13937;40431
260180;201508;3229;9960;2950;9559;211;791;2425;7806;2636;8597
260190;201508;15814;37258;14512;35632;526;1360;12654;30860;13180;32220
260200;201508;10477;29279;9675;28178;711;2311;8039;23473;8750;25784
260210;201508;11270;34488;10215;32924;631;2427;8358;26889;8989;29316
260220;201508;9322;27385;9001;26952;468;1797;7913;23325;8381;25122
260230;201508;9428;27309;8689;26280;447;1536;7114;21651;7561;23187
260240;201508;2957;8978;2569;8416;369;1317;1787;5877;2156;7194
260250;201508;2255;6271;2033;5976;104;321;1735;5105;1839;5426
260260;201508;12036;33948;11005;32521;1727;5393;7833;23482;9560;28875
260270;201508;3580;10415;3322;10023;287;1157;2463;7040;2750;8197
260280;201508;12737;41465;11715;39891;682;2485;9888;33929;10570;36414
260290;201508;29129;87822;27502;84885;4619;15410;17257;52265;21876;67675
260300;201508;8458;25834;7518;24407;439;1818;5863;19032;6302;20850
260310;201508;4641;13744;4238;13135;1248;3549;2219;7455;3467;11004
260320;201508;6900;22647;6407;21854;403;1521;5260;18027;5663;19548
260330;201508;2598;8407;2415;8082;144;622;1893;6226;2037;6848
260340;201508;1860;5485;1727;5275;74;275;1503;4534;1577;4809
260345;201508;22823;71250;21308;68238;5565;19681;8489;25826;14054;45507
260350;201508;4637;12699;4349;12265;235;802;3607;10031;3842;10833
260360;201508;2270;6707;2061;6345;177;676;1408;4258;1585;4934
260370;201508;5807;18075;5120;16815;525;2035;3632;11863;4157;13898
260380;201508;4731;15690;4345;15105;319;1319;3316;11467;3635;12786
260390;201508;4365;13907;3833;12859;352;1335;2706;8904;3058;10239
260392;201508;3501;11039;3224;10688;203;875;2761;8983;2964;9858
260400;201508;13404;38370;12688;37163;1738;5701;8740;24995;10478;30696
260410;201508;60113;172000;52311;159392;15101;48402;20790;64591;35891;112993
260415;201508;3865;12226;3314;11111;340;1404;2063;6634;2403;8038
260420;201508;11882;27224;10618;25864;280;831;9575;23065;9855;23896
260430;201508;2736;9062;2446;8541;252;941;1686;5856;1938;6797
260440;201508;3223;9746;2860;8998;398;1402;1734;5288;2132;6690
260450;201508;4874;14491;4649;14157;199;704;4083;12454;4282;13158
260460;201508;5515;17071;5058;16240;894;3140;2995;9393;3889;12533
260470;201508;4554;13696;4266;13320;272;879;3674;11657;3946;12536
260480;201508;4012;11530;3532;10850;603;2084;2245;6879;2848;8963
260490;201508;4996;13365;4355;12270;331;1087;3444;9497;3775;10584
260500;201508;5910;16915;5267;15896;735;2239;3538;10646;4273;12885
260510;201508;8597;23108;8000;22347;354;1045;7111;19817;7465;20862
260515;201508;4706;14390;3647;12226;270;1065;2305;7679;2575;8744
260520;201508;15662;41306;15031;40446;2351;6301;10816;29220;13167;35521
260530;201508;9644;29449;8599;27887;444;1629;7248;23554;7692;25183
260540;201508;5997;14859;5456;14281;747;1469;4270;11695;5017;13164
260545;201508;71;254;40;159;8;33;11;38;19;71
260550;201508;2751;9049;2360;8221;496;1910;975;3359;1471;5269
260560;201508;6253;16399;5657;15522;177;636;4978;13450;5155;14086
260570;201508;6741;22465;6217;21581;723;2847;4398;15188;5121;18035
260580;201508;3697;10388;3417;9916;191;673;2833;8003;3024;8676
260590;201508;6095;15319;5761;14922;286;736;5041;13084;5327;13820
260600;201508;26525;78976;23970;74614;2370;8587;17074;52476;19444;61063
260610;201508;6627;19843;6266;19295;975;3159;4344;13242;5319;16401
260620;201508;15825;47877;15081;46521;2554;8635;9482;28711;12036;37346
260630;201508;2164;6511;1936;6120;149;597;1519;4666;1668;5263
260640;201508;17078;47221;15991;45689;2484;7391;10519;29975;13003;37366
260650;201508;5272;16935;4720;15977;450;1592;3521;12074;3971;13666
260660;201508;7991;22203;7178;21168;361;1230;6134;17930;6495;19160
260670;201508;2344;6371;1901;5744;178;590;1341;4054;1519;4644
260680;201508;21326;59774;19477;56533;4195;12417;9524;27581;13719;39998
260690;201508;3668;9994;3122;9090;134;516;2608;7467;2742;7983
260700;201508;5555;16695;5411;16545;50;144;5296;16300;5346;16444
260710;201508;1253;3748;1151;3605;89;326;894;2787;983;3113
260720;201508;15553;51288;14747;49859;3442;12082;7976;27154;11418;39236
260730;201508;6599;22315;6179;21600;969;3514;4296;15038;5265;18552
260740;201508;1260;3844;1104;3572;129;461;739;2387;868;2848
260750;201508;6574;20569;5963;19738;559;1780;4808;16151;5367;17931
260760;201508;4640;12532;4318;12103;257;789;3586;10080;3843;10869
260765;201508;7608;25873;7248;25290;1070;4713;4989;16667;6059;21380
260770;201508;3710;9832;3433;9433;117;410;2874;7757;2991;8167
260775;201508;5033;14535;4745;14082;461;1646;3420;9854;3881;11500
260780;201508;3623;11714;3396;11265;670;2490;1821;5757;2491;8247
260790;201508;109335;276173;101441;264241;19991;53721;60597;156853;80588;210574
260795;201508;2981;9166;2688;8710;320;1154;1820;5904;2140;7058
260800;201508;4762;12900;4415;12420;169;670;3919;10678;4088;11348
260805;201508;3915;11364;3441;10632;406;1427;2311;6970;2717;8397
260810;201508;6649;19001;6462;18780;314;968;5692;16471;6006;17439
260820;201508;4258;12011;3857;11428;944;2885;2037;5937;2981;8822
260825;201508;2841;9159;2566;8704;197;730;1999;6802;2196;7532
260830;201508;3681;11891;3305;11147;769;2488;1880;6614;2649;9102
260840;201508;4225;12135;3777;11476;254;988;3050;9062;3304;10050
260845;201508;4139;12048;3869;11555;515;1626;2733;8178;3248;9804
260850;201508;4891;16032;4313;14734;850;3263;2062;6808;2912;10071
260860;201508;3267;10365;2937;9697;182;701;2259;7430;2441;8131
260870;201508;4141;11530;3678;10931;479;1304;2720;8262;3199;9566
260875;201508;6433;17737;5732;16669;906;2649;3781;11051;4687;13700
260880;201508;9215;28613;8487;27412;743;2426;6569;21354;7312;23780
260890;201508;13175;37757;12279;36363;894;3044;9351;27380;10245;30424
260900;201508;5868;18082;5010;16419;567;2215;3108;10003;3675;12218
260910;201508;2969;8963;2706;8560;194;708;2089;6601;2283;7309
260915;201508;4442;15043;4243;14762;82;391;3918;13592;4000;13983
260920;201508;3232;9856;3023;9555;365;1362;2245;7035;2610;8397
260930;201508;3932;12749;3472;12000;391;1425;2471;8587;2862;10012
260940;201508;13613;36575;12365;34500;1521;4949;8310;22451;9831;27400
260950;201508;6162;19090;5640;18060;823;3107;3134;9514;3957;12621
260960;201508;55808;155532;51174;147821;10128;31012;27898;80041;38026;111053
260970;201508;4728;14950;4350;14423;276;1161;3484;11442;3760;12603
260980;201508;3809;12377;3588;12100;130;567;3227;10830;3357;11397
260990;201508;16764;52906;15289;50911;1177;4291;12209;40937;13386;45228
261000;201508;16132;43774;12975;38818;2450;7715;6636;20421;9086;28136
261010;201508;2545;7200;2344;6951;156;355;2036;6212;2192;6567
261020;201508;5888;17468;5316;16567;484;1788;4090;12333;4574;14121
261030;201508;3370;10952;3129;10511;216;897;2485;8209;2701;9106
261040;201508;5084;16546;4474;15347;385;1544;3293;11191;3678;12735
261050;201508;7939;23253;7419;22304;1020;3049;4990;15049;6010;18098
261060;201508;11934;35262;11081;33693;1144;4047;8062;23881;9206;27928
261070;201508;49712;122518;43479;113604;6809;18180;27332;71606;34141;89786
261080;201508;5762;16880;5414;16351;376;1057;4591;14104;4967;15161
261090;201508;16364;45092;15063;43308;1426;4017;11744;34134;13170;38151
261100;201508;7817;24854;6967;23326;1362;4833;3836;13071;5198;17904
261110;201508;59737;176623;53028;166242;12057;39706;27963;89040;40020;128746
261120;201508;3626;9698;3195;9181;94;330;2865;8229;2959;8559
261130;201508;6961;17822;6507;17301;198;590;5910;15583;6108;16173
261140;201508;3261;9150;2943;8663;418;1413;1779;5060;2197;6473
261150;201508;5254;15602;4851;14944;453;1643;3797;11607;4250;13250
261153;201508;2062;6006;1669;5391;72;300;1241;4007;1313;4307
261160;201508;197624;516519;182830;494951;41833;116809;94554;259256;136387;376065
261170;201508;5793;15942;5265;15164;603;1771;3943;11451;4546;13222
261180;201508;9531;26499;8924;25645;843;2695;6426;18244;7269;20939
261190;201508;5082;15808;4736;15374;570;2381;3266;10145;3836;12526
261200;201508;3633;9140;3272;8699;425;1116;2529;6861;2954;7977
261210;201508;1889;5001;1787;4872;120;315;1580;4339;1700;4654
261220;201508;12969;40649;10794;35873;1944;7003;5374;17722;7318;24725
261230;201508;4291;13003;3953;12575;162;627;3426;10919;3588;11546
261240;201508;4728;14125;4396;13555;649;1916;2993;9447;3642;11363
261245;201508;3506;11011;3015;10109;165;776;2405;7872;2570;8648
261247;201508;3300;10105;2788;9162;239;925;1994;6565;2233;7490
261250;201508;19692;52399;18572;50924;3572;9397;12879;36208;16451;45605
261255;201508;3949;12342;3600;11733;216;857;2972;9602;3188;10459
261260;201508;11882;33782;10675;32300;610;1930;8921;27005;9531;28935
261270;201508;3601;10672;3251;10091;399;1370;2171;6597;2570;7967
261280;201508;2448;7541;2249;7245;146;520;1828;5855;1974;6375
261290;201508;2898;8373;2638;8034;174;665;2130;6453;2304;7118
261300;201508;10513;34291;9238;31951;1521;5996;5548;18880;7069;24876
261310;201508;7269;22341;6848;21568;1620;5261;3885;12239;5505;17500
261320;201508;5481;17387;5091;16662;245;981;4113;13364;4358;14345
261330;201508;5392;15894;5117;15515;479;1484;4021;12164;4500;13648
261340;201508;4023;13402;3812;13050;424;1830;2544;8545;2968;10375
261350;201508;8025;26612;7519;25725;340;1629;6079;20348;6419;21977
261360;201508;8034;21284;7198;20099;613;1843;5664;15537;6277;17380
261370;201508;19425;57389;18127;55351;3647;11679;10679;32577;14326;44256
261380;201508;4070;13980;3746;13282;586;2297;2362;8342;2948;10639
261390;201508;15433;47397;13992;44918;2126;7461;8626;27514;10752;34975
261400;201508;4735;16319;4229;15249;409;1728;2955;10594;3364;12322
261410;201508;8497;23992;7707;22767;966;2911;5646;16849;6612;19760
261420;201508;7290;24665;6973;24221;1636;6424;4109;13940;5745;20364
261430;201508;3380;10630;2974;10033;269;910;2253;7712;2522;8622
261440;201508;1577;5096;1425;4863;55;277;1120;3732;1175;4009
261450;201508;13875;39259;13413;38693;390;1377;12160;34843;12550;36220
261460;201508;7074;20966;6649;20409;441;1263;5720;17879;6161;19142
261470;201508;3889;10610;3521;10133;156;520;3177;9089;3333;9609
261480;201508;3515;12743;3242;12226;337;1401;2312;8597;2649;9998
261485;201508;4940;15179;4476;14345;774;2889;2603;8114;3377;11003
261500;201508;5650;15698;4998;14820;481;1323;3783;11579;4264;12902
261510;201508;1925;6162;1779;5932;129;472;1385;4621;1514;5093
261520;201508;2634;8561;2437;8184;148;585;1672;5793;1820;6378
261530;201508;11861;38051;10420;35241;2205;8272;4406;14777;6611;23049
261540;201508;7237;23345;6854;22667;1472;4842;4132;13991;5604;18833
261550;201508;3377;9623;3185;9352;258;1009;2521;7173;2779;8182
261560;201508;7077;23038;6386;22122;978;3651;4408;15442;5386;19093
261570;201508;3386;10362;2977;9690;424;1427;1899;6150;2323;7577
261580;201508;5620;17810;5033;16850;370;1489;4094;13652;4464;15141
261590;201508;2373;6800;2119;6415;180;561;1595;4844;1775;5405
261600;201508;5150;14091;4453;13108;347;1064;3464;10252;3811;11316
261610;201508;2441;7049;2076;6515;113;470;1627;4985;1740;5455
261618;201508;2463;6956;2253;6689;203;657;1709;4964;1912;5621
261620;201508;4064;12646;3790;12174;612;2055;2562;8292;3174;10347
261630;201508;7691;22452;6452;20130;924;3374;3568;10764;4492;14138
261640;201508;32474;82204;30106;79287;2161;5543;24228;65644;26389;71187
261650;201508;3583;11125;3317;10736;418;1481;2317;7509;2735;8990
270010;201508;4389;16631;4024;15910;480;2238;2686;10623;3166;12861
270020;201508;3752;10882;3531;10553;355;1175;2745;8068;3100;9243
270030;201508;39655;118894;37008;114589;8953;28501;20482;63925;29435;92426
270040;201508;10576;32324;9786;31279;2250;7042;5421;18075;7671;25117
270050;201508;4156;11835;3821;11407;375;1306;2964;8744;3339;10050
270060;201508;1653;5249;1546;5106;270;989;1016;3365;1286;4354
270070;201508;4210;13128;3878;12684;183;878;3298;10515;3481;11393
270080;201508;1240;3953;1086;3638;161;614;676;2188;837;2802
270090;201508;2130;6587;1968;6254;54;267;1667;5119;1721;5386
270100;201508;5718;17759;5384;17144;911;3084;3415;10718;4326;13802
270110;201508;3195;8786;2845;8397;392;1163;1887;5949;2279;7112
270120;201508;3062;8776;2737;8367;107;406;2436;7462;2543;7868
270130;201508;4964;15263;4663;14917;605;1903;3651;11962;4256;13865
270135;201508;1728;4644;1614;4505;167;357;1377;3977;1544;4334
270140;201508;10223;24904;8851;23168;725;2762;6922;16884;7647;19646
270150;201508;2692;8991;2626;8905;98;348;2428;8252;2526;8600
270160;201508;5030;16801;4618;16281;239;1050;3934;13760;4173;14810
270170;201508;3808;12334;3492;11889;617;2406;2026;6793;2643;9199
270180;201508;2184;7324;2005;7076;121;622;1633;5640;1754;6262
270190;201508;1765;5856;1686;5751;106;440;1410;4813;1516;5253
270200;201508;2559;8597;2396;8361;207;901;1818;6233;2025;7134
270210;201508;4514;13935;4264;13570;316;1289;3453;10717;3769;12006
270220;201508;1395;4550;1303;4376;244;901;746;2462;990;3363
270230;201508;10822;34378;9477;32162;1303;5423;5902;19315;7205;24738
270235;201508;6303;20437;5896;19770;377;1631;4885;16168;5262;17799
270240;201508;9399;28313;7966;26428;1818;6346;4140;13871;5958;20217
270250;201508;3269;8535;2996;8200;305;823;2465;6690;2770;7513
270255;201508;4962;14966;3933;13096;274;1138;2798;9129;3072;10267
270260;201508;5692;18707;5514;18447;454;1910;4591;15056;5045;16966
270270;201508;1171;3358;1069;3206;193;606;618;1815;811;2421
270280;201508;3572;10205;3216;9686;371;1146;2330;6961;2701;8107
270290;201508;8174;28567;7677;27686;732;3156;5897;20961;6629;24117
270300;201508;3556;11685;3210;11287;331;1311;2333;8126;2664;9437
270310;201508;7323;22327;6418;20898;280;1405;5365;17024;5645;18429
270320;201508;5726;18539;5504;18166;873;3429;3770;12063;4643;15492
270330;201508;4331;14687;4086;14341;375;1472;3284;11542;3659;13014
270340;201508;1724;5352;1523;5084;131;466;1194;3978;1325;4444
270350;201508;1867;5207;1690;4993;153;527;1244;3648;1397;4175
270360;201508;1995;6226;1932;6151;177;511;1612;5270;1789;5781
270370;201508;1553;5154;1413;4904;141;579;1012;3502;1153;4081
270375;201508;2810;8002;2521;7590;249;889;1875;5461;2124;6350
270380;201508;5701;17633;5354;17140;556;1814;4095;13339;4651;15153
270390;201508;1243;3470;1095;3253;81;290;815;2320;896;2610
270400;201508;6236;18746;5623;17871;432;1608;3973;12302;4405;13910
270410;201508;4786;14886;4422;14194;465;1655;3116;9847;3581;11502
270420;201508;5712;18413;5510;18133;274;1268;4517;14502;4791;15770
270430;201508;132269;384813;122391;369965;31896;100971;58719;180641;90615;281612
270440;201508;4704;14250;4333;13723;228;860;3532;11214;3760;12074
270450;201508;6242;19291;5988;18967;346;1448;4944;15407;5290;16855
270460;201508;3452;9223;3083;8738;214;695;2603;7279;2817;7974
270470;201508;10210;32908;9437;31633;1266;4411;6193;21113;7459;25524
270480;201508;2916;9065;2576;8451;241;976;1777;5592;2018;6568
270490;201508;935;3045;882;2958;43;183;708;2338;751;2521
270500;201508;4872;16721;4606;16390;348;1460;3772;13382;4120;14842
270510;201508;5942;17802;5336;16969;684;2775;3875;11774;4559;14549
270520;201508;3577;11392;3290;10900;953;3451;1281;4276;2234;7727
270530;201508;1417;4317;1303;4147;160;523;863;2829;1023;3352
270540;201508;2012;6847;1841;6601;133;670;1469;5094;1602;5764
270550;201508;7074;20822;6175;19638;875;2929;4108;13306;4983;16235
270560;201508;3035;9207;2827;8889;341;1271;2022;6168;2363;7439
270570;201508;3920;12704;3588;12139;359;1534;2722;8987;3081;10521
270580;201508;1949;6335;1857;6210;197;683;1428;4853;1625;5536
270590;201508;1366;4540;1299;4424;29;135;1234;4175;1263;4310
270600;201508;2751;9262;2483;8811;179;897;1885;6510;2064;7407
270610;201508;3162;10043;2930;9707;223;829;2379;7820;2602;8649
270620;201508;1359;4644;1288;4532;100;489;1029;3458;1129;3947
270630;201508;16840;48402;15548;46297;2300;6725;10705;32618;13005;39343
270640;201508;5668;17538;5118;16765;340;1443;4115;13183;4455;14626
270642;201508;2247;7939;2107;7731;263;1189;1525;5483;1788;6672
270644;201508;2619;7624;2334;7275;227;645;1822;5819;2049;6464
270650;201508;3659;11662;3490;11416;518;2189;2336;7195;2854;9384
270660;201508;2457;6197;1908;5411;95;366;1349;3761;1444;4127
270670;201508;16183;42207;13908;39584;1794;4820;10228;30225;12022;35045
270680;201508;4227;12653;4054;12461;159;428;3708;11530;3867;11958
270690;201508;8682;24202;7860;23256;2472;7064;3942;12312;6414;19376
270700;201508;665;2068;602;1957;81;328;407;1256;488;1584
270710;201508;5855;19010;5578;18647;488;1854;4562;15142;5050;16996
270720;201508;3285;11149;2996;10633;163;858;2428;8424;2591;9282
270730;201508;6199;18716;5896;18383;676;2242;4728;14810;5404;17052
270740;201508;2299;6585;2168;6398;268;906;1613;4662;1881;5568
270750;201508;4829;15426;4509;14916;564;1998;3268;10736;3832;12734
270760;201508;3353;10188;3014;9615;212;781;2352;7472;2564;8253
270770;201508;18934;49663;15669;45669;3212;9343;8968;27324;12180;36667
270780;201508;1798;5943;1699;5775;216;846;1188;4012;1404;4858
270790;201508;1557;4848;1422;4639;335;1172;748;2386;1083;3558
270800;201508;11260;33346;10463;32293;813;2947;8552;26069;9365;29016
270810;201508;3335;10092;2585;8716;285;1172;1604;5367;1889;6539
270820;201508;1758;5923;1594;5644;253;985;1003;3558;1256;4543
270830;201508;5486;15399;4964;14750;461;1560;3861;11625;4322;13185
270840;201508;7764;25347;7194;24616;358;1786;6230;20896;6588;22682
270850;201508;7279;23208;7038;22899;1186;4673;4794;14786;5980;19459
270860;201508;11312;31521;9588;29271;1130;4089;6569;19570;7699;23659
270870;201508;2171;6523;1790;5716;266;889;1112;3519;1378;4408
270880;201508;8010;25805;7495;25037;538;2217;5977;19627;6515;21844
270890;201508;2383;7242;2234;6971;257;975;1620;4887;1877;5862
270895;201508;2827;10574;2708;10406;184;846;2304;8842;2488;9688
270900;201508;1948;5258;1569;4710;87;310;1183;3473;1270;3783
270910;201508;3435;11429;3234;11053;270;1212;2504;8321;2774;9533
270915;201508;9587;32114;8616;30348;1467;5955;4903;16847;6370;22802
270920;201508;6012;19125;5787;18806;220;1154;5190;16394;5410;17548
270930;201508;17436;46372;14293;42485;2748;8356;8376;25733;11124;34089
270940;201508;5581;18695;5302;18390;530;2318;4151;14222;4681;16540
280010;201508;644;1949;553;1780;52;236;343;1019;395;1255
280020;201508;4684;13732;4007;12549;712;2385;2456;7591;3168;9976
280030;201508;72834;191207;62935;176407;17309;50744;26560;75422;43869;126166
280040;201508;3106;9593;2763;9075;261;974;2034;6653;2295;7627
280050;201508;3713;12003;3435;11515;1132;4012;1300;4495;2432;8507
280060;201508;4296;14145;3951;13535;802;2950;2146;7450;2948;10400
280067;201508;7335;20816;6308;19299;836;2614;4171;12842;5007;15456
280070;201508;1824;6201;1733;6067;296;1060;1196;4233;1492;5293
280100;201508;3767;11729;3375;11031;744;2559;1833;6042;2577;8601
280110;201508;1400;4265;1288;4096;74;322;1064;3304;1138;3626
280120;201508;7681;24434;7098;23498;1092;3406;4896;16867;5988;20273
280130;201508;7190;20514;6556;19587;1166;3702;4162;12532;5328;16234
280140;201508;5433;14916;4938;14208;487;1416;3817;11049;4304;12465
280150;201508;3308;10007;3060;9579;344;1226;2110;6384;2454;7610
280160;201508;1356;3955;1196;3695;137;452;827;2519;964;2971
280170;201508;4773;14133;4284;13404;466;1471;3210;10220;3676;11691
280190;201508;1063;2994;956;2814;62;229;737;2104;799;2333
280200;201508;1138;3434;1040;3289;129;509;725;2195;854;2704
280210;201508;12987;39537;11710;37709;2175;7304;7022;22965;9197;30269
280220;201508;1529;4718;1434;4565;89;344;1188;3708;1277;4052
280230;201508;3433;10273;3055;9662;402;1372;1962;6240;2364;7612
280240;201508;3398;10033;3085;9524;283;852;2359;7320;2642;8172
280250;201508;813;2150;667;1918;114;395;348;881;462;1276
280260;201508;1998;5358;1848;5172;82;255;1656;4660;1738;4915
280270;201508;2281;7040;2001;6611;126;506;1552;5035;1678;5541
280280;201508;4144;13522;3772;12891;847;2427;2119;8110;2966;10537
280290;201508;16954;52042;15286;49395;2202;7744;9596;31236;11798;38980
280300;201508;9419;28774;8757;27969;909;3017;6859;22184;7768;25201
280310;201508;1338;3774;1185;3532;73;299;847;2458;920;2757
280320;201508;8333;26928;7621;25662;1496;5548;3846;12756;5342;18304
280330;201508;4466;12538;4073;11922;363;1278;3214;9132;3577;10410
280340;201508;3698;10679;3478;10371;352;1190;2697;8032;3049;9222
280350;201508;21550;61037;19232;57507;2742;8467;12749;38405;15491;46872
280360;201508;5648;17788;5293;17195;1009;3744;3022;9559;4031;13303
280370;201508;1837;5170;1604;4786;143;465;1142;3365;1285;3830
280380;201508;1032;3117;943;2986;97;371;697;2150;794;2521
280390;201508;3081;9125;2641;8299;430;1410;1641;5138;2071;6548
280400;201508;4098;11832;3711;11264;1136;3376;1803;5773;2939;9149
280410;201508;2149;6825;1841;6236;250;955;1099;3601;1349;4556
280420;201508;4044;11884;3766;11445;226;743;3197;9681;3423;10424
280430;201508;2218;5665;2007;5376;106;339;1567;4100;1673;4439
280440;201508;4671;13876;4373;13518;350;1139;3591;11039;3941;12178
280445;201508;2441;6916;2265;6618;70;273;1831;5260;1901;5533
280450;201508;8600;23495;8027;22769;547;1347;6786;19749;7333;21096
280460;201508;6903;18309;6204;17311;856;2545;4388;12327;5244;14872
280470;201508;1786;5438;1618;5149;188;588;1160;3730;1348;4318
280480;201508;29922;87877;28392;85623;4522;15545;18753;55031;23275;70576
280490;201508;3758;11298;3281;10461;276;1058;2389;7450;2665;8508
280500;201508;912;2428;828;2318;54;174;675;1821;729;1995
280510;201508;2693;7778;2333;7302;233;833;1725;5384;1958;6217
280520;201508;1741;4855;1585;4657;154;419;1277;3824;1431;4243
280530;201508;2231;6401;2080;6210;151;456;1684;5071;1835;5527
280540;201508;9166;25149;8540;24282;235;996;7509;20843;7744;21839
280550;201508;6836;18146;5796;16532;635;1848;4030;11524;4665;13372
280560;201508;7402;21992;7010;21406;387;1376;5888;17677;6275;19053
280570;201508;6352;17353;5582;16311;650;2139;3768;10802;4418;12941
280580;201508;5560;17190;4699;15673;842;2860;2741;9343;3583;12203
280590;201508;2322;7082;2166;6880;237;1042;1501;4579;1738;5621
280600;201508;3742;11462;3501;11104;341;1247;2638;8258;2979;9505
280610;201508;2437;6835;2237;6540;224;805;1591;4497;1815;5302
280620;201508;5138;15332;4470;14116;612;1803;2962;9682;3574;11485
280630;201508;3770;12263;3564;11954;365;1125;2854;9893;3219;11018
280640;201508;2203;6580;2095;6459;92;240;1933;6044;2025;6284
280650;201508;1110;3444;997;3255;117;437;674;2186;791;2623
280660;201508;2622;7462;2509;7316;411;1119;1927;5724;2338;6843
280670;201508;15794;41509;14585;39846;2712;7737;9204;24957;11916;32694
280680;201508;2726;7386;2421;6907;202;667;1909;5357;2111;6024
280690;201508;943;2693;839;2546;116;367;585;1759;701;2126
280700;201508;1082;3192;949;2990;67;216;697;2208;764;2424
280710;201508;11528;30694;10564;29584;766;2025;8865;25232;9631;27257
280720;201508;2234;6168;2032;5929;264;783;1428;4259;1692;5042
280730;201508;920;2755;861;2673;84;287;699;2147;783;2434
280740;201508;12958;35322;11206;32638;1629;4693;7180;21257;8809;25950
280750;201508;3511;10685;3197;10134;346;1212;2224;7037;2570;8249
280760;201508;5537;17002;5021;16254;695;2354;3255;10787;3950;13141
290010;201508;2995;6749;2143;5430;57;242;1701;4087;1758;4329
290020;201508;4356;14576;4284;14472;401;1142;3532;12150;3933;13292
290030;201508;3093;9739;2920;9477;514;1631;1979;6508;2493;8139
290035;201508;4647;11917;4000;11055;246;829;3166;8972;3412;9801
290040;201508;3823;10606;3320;10033;209;825;2658;7874;2867;8699
290050;201508;2490;8078;2203;7604;166;689;1653;5648;1819;6337
290060;201508;1298;3357;1105;3123;193;619;785;2150;978;2769
290070;201508;32402;81221;27459;75037;5978;16109;13675;39681;19653;55790
290080;201508;6087;18061;5186;16881;604;1945;3846;12888;4450;14833
290090;201508;2141;4659;1689;4177;172;392;1390;3501;1562;3893
290100;201508;9665;27561;8436;25620;1130;3563;5400;16759;6530;20322
290110;201508;4793;14301;4543;13859;674;2245;2987;8932;3661;11177
290115;201508;4730;14280;4188;13547;250;832;3396;11210;3646;12042
290120;201508;6790;17701;5667;16353;271;918;4751;13573;5022;14491
290130;201508;4572;12029;3822;11098;217;806;3063;8612;3280;9418
290135;201508;4522;11509;3877;10510;274;925;2854;7373;3128;8298
290140;201508;4072;12775;3532;12033;274;1051;2908;9937;3182;10988
290150;201508;2125;6381;2013;6196;242;796;1534;4651;1776;5447
290160;201508;3328;8889;3212;8747;258;544;2738;7524;2996;8068
290170;201508;2714;9063;2459;8664;180;849;2032;7006;2212;7855
290180;201508;2867;8393;2514;7842;202;752;1922;5935;2124;6687
290190;201508;3723;12516;3576;12279;229;952;2747;9313;2976;10265
290195;201508;2157;5911;1838;5421;110;414;1471;4291;1581;4705
290200;201508;3793;11852;3376;11182;290;963;2640;8822;2930;9785
290205;201508;3103;9220;2761;8693;310;1173;1948;5972;2258;7145
290210;201508;14923;42015;13720;40475;2591;6870;9026;28560;11617;35430
290220;201508;2202;6592;2083;6404;154;637;1613;4777;1767;5414
290225;201508;2849;7523;2622;7270;159;425;2352;6552;2511;6977
290230;201508;2254;7380;2179;7286;142;562;1810;6041;1952;6603
290240;201508;3622;9793;3309;9320;314;926;2467;6833;2781;7759
290250;201508;3681;11822;3243;11164;193;695;2666;9327;2859;10022
290260;201508;4761;13923;4106;12892;330;1169;3136;9803;3466;10972
290265;201508;3263;10312;2919;9677;156;658;2281;7498;2437;8156
290270;201508;11931;43397;11307;42404;1501;5918;8162;31034;9663;36952
290280;201508;5186;17038;4824;16444;401;1524;3688;12597;4089;14121
290290;201508;9539;30314;8549;28668;1373;4742;5625;19224;6998;23966
290300;201508;4580;13048;3256;10558;279;894;2131;7178;2410;8072
290310;201508;1491;4445;1320;4175;242;840;742;2317;984;3157
290320;201508;27542;80327;23415;74731;5637;19027;11461;37515;17098;56542
290323;201508;3790;10257;3325;9735;177;552;2773;8105;2950;8657
290327;201508;4290;13157;3696;12046;567;1917;2334;7579;2901;9496
290330;201508;1778;4462;1651;4323;146;405;1420;3717;1566;4122
290340;201508;4851;15287;4543;14873;1347;4398;2408;8025;3755;12423
290350;201508;4277;13428;3747;12618;433;1491;2604;9016;3037;10507
290360;201508;4470;13640;3879;12845;177;669;3230;10757;3407;11426
290370;201508;4681;13192;4046;12369;444;1242;3212;10025;3656;11267
290380;201508;5512;16055;4817;15010;358;1302;3774;11754;4132;13056
290390;201508;14379;44529;13130;42641;2441;8050;7898;26773;10339;34823
290395;201508;2589;8429;2293;7886;146;645;1726;5913;1872;6558
290400;201508;3485;10386;3031;9730;293;961;2192;7005;2485;7966
290405;201508;4582;14554;3829;13093;562;1938;2314;8099;2876;10037
290410;201508;5971;17599;4863;15842;485;1847;3397;10744;3882;12591
290420;201508;3260;9467;2721;8701;216;750;2117;6736;2333;7486
290430;201508;2988;9533;2721;9048;475;1702;1688;5633;2163;7335
290440;201508;2928;7856;2417;7138;174;601;1845;5454;2019;6055
290450;201508;3273;9475;2824;8835;322;1087;1961;6120;2283;7207
290460;201508;12709;36989;11343;34715;2925;9264;5024;15393;7949;24657
290470;201508;4510;12406;3431;10795;723;2512;1657;5316;2380;7828
290475;201508;4967;16900;4477;15946;367;1671;3317;11622;3684;13293
290480;201508;2463;6553;2239;6258;323;941;1511;4373;1834;5314
290485;201508;4769;15138;4160;14233;329;1546;3266;10903;3595;12449
290490;201508;7887;20881;7515;20370;607;1741;6128;16484;6735;18225
290500;201508;4166;13040;3376;11463;535;1975;1783;6014;2318;7989
290510;201508;3302;9544;2874;8941;168;630;2384;7423;2552;8053
290515;201508;3231;9434;2762;8795;252;816;2169;7024;2421;7840
290520;201508;12037;36872;9707;32471;814;3350;6091;20129;6905;23479
290530;201508;5043;14818;4410;13845;337;1047;3476;10985;3813;12032
290540;201508;3874;11252;3676;11004;423;1223;2869;8738;3292;9961
290550;201508;4431;11946;3926;11356;144;430;3575;10403;3719;10833
290560;201508;6053;17900;5339;16844;1295;4178;2923;9428;4218;13606
290570;201508;42361;116038;38194;110036;4331;12737;26905;77497;31236;90234
290580;201508;6905;23570;6503;22942;858;3147;4675;16850;5533;19997
290590;201508;7333;23297;6266;21372;332;1388;4979;16907;5311;18295
290600;201508;17117;51991;15810;50028;2358;7165;11318;37020;13676;44185
290610;201508;2477;8309;2046;7450;151;712;1433;5124;1584;5836
290620;201508;6418;19489;5857;18616;385;1284;4799;15213;5184;16497
290630;201508;7902;20857;7016;19885;625;1808;5785;16524;6410;18332
290640;201508;2663;7736;2115;6826;160;634;1592;5056;1752;5690
290650;201508;11066;31435;10289;30353;2139;6186;6409;19490;8548;25676
290660;201508;3591;10037;3101;9320;147;501;2390;7369;2537;7870
290670;201508;6827;20889;6144;19769;698;2280;4375;14338;5073;16618
290680;201508;10173;30278;9192;29062;445;1681;7654;24064;8099;25745
290682;201508;4409;12724;3946;12061;165;632;3377;10190;3542;10822
290685;201508;3689;8836;2430;7031;295;900;1463;4336;1758;5236
290687;201508;7598;21094;5929;18603;1403;4511;2955;9595;4358;14106
290689;201508;3124;9055;2710;8402;249;808;2073;6573;2322;7381
290690;201508;5447;15611;4867;14835;643;2045;3421;10441;4064;12486
290700;201508;2336;7311;2204;7113;182;673;1687;5431;1869;6104
290710;201508;7634;24263;7191;23584;354;1195;6158;20296;6512;21491
290720;201508;18429;54096;16726;51956;1361;4029;13617;43259;14978;47288
290730;201508;7080;19685;6339;18717;1036;2965;4189;12526;5225;15491
290740;201508;920;2733;766;2461;82;283;510;1641;592;1924
290750;201508;9847;27452;8248;24512;1488;4899;4381;12532;5869;17431
290755;201508;2340;6579;1913;5875;97;343;1417;4308;1514;4651
290760;201508;4188;12665;3403;11253;401;1224;2187;7430;2588;8654
290770;201508;2501;8817;2374;8639;99;464;1908;6950;2007;7414
290780;201508;8857;22419;7648;20675;786;1632;5852;16511;6638;18143
290790;201508;4245;12888;3954;12468;253;800;3333;10571;3586;11371
290800;201508;7291;15527;5804;13932;668;1355;4291;10951;4959;12306
290810;201508;5045;15721;4258;14460;213;808;3252;11147;3465;11955
290820;201508;5625;15711;4965;14824;460;1564;3773;11297;4233;12861
290830;201508;4264;11490;3885;10932;231;784;2963;8114;3194;8898
290840;201508;17466;49274;15416;46226;2492;7231;10056;31398;12548;38629
290850;201508;6200;17883;5975;17611;713;1896;4806;14707;5519;16603
290860;201508;4929;16817;4587;16398;511;1888;3499;12821;4010;14709
290870;201508;4570;13582;3742;12218;277;1130;2736;8856;3013;9986
290880;201508;1412;3847;1109;3352;91;270;753;2288;844;2558
290890;201508;6928;18219;5942;17120;673;1845;4643;13587;5316;15432
290900;201508;2623;7385;1918;6196;278;953;971;3166;1249;4119
290910;201508;4560;12423;3869;11417;126;460;3347;9750;3473;10210
290920;201508;4592;13566;4232;13040;309;890;3444;10727;3753;11617
290930;201508;7634;23756;6746;22204;465;1927;5183;16824;5648;18751
290940;201508;3431;10910;3165;10548;159;573;2717;9187;2876;9760
290950;201508;1533;4277;1352;4008;168;474;905;2730;1073;3204
290960;201508;5707;16242;5196;15572;192;689;4383;13190;4575;13879
290970;201508;3591;11418;3131;10623;327;1121;2124;7306;2451;8427
290980;201508;10422;29853;8806;26823;2419;7561;2933;8926;5352;16487
290990;201508;8996;26998;7840;25080;821;2757;5725;18162;6546;20919
291000;201508;2887;8900;2634;8583;194;709;2254;7365;2448;8074
291005;201508;14036;37016;12352;34719;1806;5167;8376;23930;10182;29097
291010;201508;3279;10165;2548;8585;282;977;1604;5473;1886;6450
291020;201508;1380;3632;1050;3046;121;385;595;1631;716;2016
291030;201508;2293;6244;1674;5022;174;549;1019;2986;1193;3535
291040;201508;5414;16364;4826;15533;410;1517;3735;12005;4145;13522
291050;201508;7605;24915;6881;23529;1738;6667;3436;11359;5174;18026
291060;201508;5945;21870;5601;21307;891;3793;3623;13601;4514;17394
291070;201508;15956;45981;13975;43097;1163;3861;10635;32891;11798;36752
291072;201508;22587;66432;18158;57586;4621;15853;6444;20615;11065;36468
291075;201508;5011;14170;4439;13375;268;662;3487;10839;3755;11501
291077;201508;1478;4174;1183;3700;98;320;775;2428;873;2748
291080;201508;77368;239323;68494;221724;23152;76323;17401;55503;40553;131826
291085;201508;5553;14699;4815;13711;464;1360;3843;10970;4307;12330
291090;201508;1440;3601;1304;3438;65;208;1138;2981;1203;3189
291100;201508;2596;6656;2122;6146;104;400;1691;4827;1795;5227
291110;201508;4662;17121;4279;16518;559;2475;2980;11304;3539;13779
291120;201508;7310;19651;6724;18760;840;2389;4778;13413;5618;15802
291125;201508;1851;3733;1394;3242;105;259;1097;2603;1202;2862
291130;201508;2829;8797;2392;8024;130;572;1779;5805;1909;6377
291140;201508;4153;12313;3665;11406;494;1528;2408;7541;2902;9069
291150;201508;1944;5136;1844;5021;119;380;1511;4031;1630;4411
291160;201508;5333;16505;4655;15377;1125;3694;2374;7909;3499;11603
291165;201508;2514;7061;1939;5971;54;219;1411;4233;1465;4452
291170;201508;21220;55122;18108;50995;1157;3708;12952;36265;14109;39973
291180;201508;6276;16445;5087;14658;487;1543;3594;10323;4081;11866
291185;201508;3749;10173;3352;9579;301;880;2674;7578;2975;8458
291190;201508;7025;19355;6202;18210;508;1646;4943;14433;5451;16079
291200;201508;2886;8580;2313;7512;159;527;1584;5244;1743;5771
291210;201508;6880;16515;5790;15258;301;927;4561;11995;4862;12922
291220;201508;4102;12785;3753;12220;474;1776;2576;8263;3050;10039
291230;201508;3970;10159;3599;9740;83;177;3365;9231;3448;9408
291240;201508;4575;12404;3937;11225;157;498;3178;8900;3335;9398
291250;201508;3534;10809;2800;9469;299;1048;1880;6435;2179;7483
291260;201508;1051;3098;961;2976;56;231;806;2429;862;2660
291270;201508;4540;14503;4116;13703;1358;4690;1870;6301;3228;10991
291280;201508;2203;6086;1712;5321;393;1315;815;2423;1208;3738
291290;201508;5461;15204;4749;14278;856;2569;2794;8572;3650;11141
291300;201508;4349;12368;3393;10705;237;858;2483;7700;2720;8558
291310;201508;5344;15279;4657;14018;314;1022;3577;10722;3891;11744
291320;201508;5974;18914;4960;16956;1139;4171;2457;8325;3596;12496
291330;201508;1578;4749;1402;4458;136;503;984;3060;1120;3563
291340;201508;3877;11176;3223;10247;164;577;2581;8171;2745;8748
291345;201508;3518;11126;3266;10824;220;710;2788;9464;3008;10174
291350;201508;5631;16555;4922;15319;306;1048;3872;12168;4178;13216
291360;201508;32625;90787;29420;86261;7231;21210;16584;50086;23815;71296
291370;201508;8365;24024;7864;23395;563;1771;6188;18622;6751;20393
291380;201508;3654;11106;3138;10262;230;839;2264;7523;2494;8362
291390;201508;9902;27123;9178;26237;1373;3705;6605;19168;7978;22873
291400;201508;15965;41955;13097;37951;2466;6654;7741;23938;10207;30592
291410;201508;3197;8440;2406;7224;152;645;1775;5121;1927;5766
291420;201508;2074;5729;1819;5418;102;362;1516;4448;1618;4810
291430;201508;3235;9504;2893;9049;142;679;2348;7106;2490;7785
291440;201508;6477;19755;5480;18042;539;1888;4018;13331;4557;15219
291450;201508;8204;24198;7229;22813;338;1070;5732;18769;6070;19839
291460;201508;12981;39190;11613;36996;1790;6240;7104;22649;8894;28889
291465;201508;7941;22555;7043;21528;503;1737;5733;17434;6236;19171
291470;201508;15583;42169;13662;39826;1158;3286;10288;30941;11446;34227
291480;201508;33450;86849;28439;79865;3791;11696;17396;48614;21187;60310
291490;201508;4333;13976;4145;13728;425;1455;3231;10842;3656;12297
291500;201508;4276;12198;3618;11237;243;904;2832;8714;3075;9618
291510;201508;3510;10642;3219;10258;80;268;2918;9371;2998;9639
291520;201508;3872;10486;3352;9770;354;1096;2288;6694;2642;7790
291530;201508;2076;5856;1684;5255;392;1254;868;2834;1260;4088
291535;201508;3828;11543;3448;10966;222;768;2716;8681;2938;9449
291540;201508;2142;5077;1794;4713;145;259;1550;4228;1695;4487
291550;201508;5149;13995;4480;13049;1013;2803;2448;7354;3461;10157
291560;201508;18157;43291;13091;37378;1155;3283;9779;28845;10934;32128
291570;201508;2207;5944;2027;5720;162;373;1711;4990;1873;5363
291580;201508;5522;16771;4870;15794;542;2148;3507;11262;4049;13410
291590;201508;1760;5569;1591;5290;177;631;1161;3903;1338;4534
291600;201508;5717;15456;4151;13022;1097;3614;1689;5171;2786;8785
291610;201508;4750;15142;4592;14953;208;762;4107;13435;4315;14197
291620;201508;2966;6995;2333;6327;135;373;1871;5202;2006;5575
291630;201508;3156;7656;2636;7052;276;716;2000;5433;2276;6149
291640;201508;17023;46139;13681;41252;3377;10761;4609;14218;7986;24979
291650;201508;7861;23595;7276;22882;658;1707;6024;19557;6682;21264
291660;201508;2189;5787;1818;5213;153;539;1199;3279;1352;3818
291670;201508;1768;4990;1604;4754;108;315;1292;3880;1400;4195
291680;201508;4084;11901;3534;10968;673;2262;2033;6275;2706;8537
291685;201508;4694;11801;3877;10713;630;1656;2555;7312;3185;8968
291690;201508;4021;10718;3158;9303;221;621;2257;6650;2478;7271
291700;201508;8977;28063;8017;26375;900;2983;5918;19716;6818;22699
291710;201508;5122;13427;4168;12231;383;1205;3020;8883;3403;10088
291720;201508;4307;14244;3678;12952;358;1432;2514;8726;2872;10158
291730;201508;5915;17814;5366;17067;599;2023;4074;13143;4673;15166
291733;201508;2548;7396;2181;6900;226;767;1455;4695;1681;5462
291735;201508;2766;7710;2290;7001;129;471;1834;5551;1963;6022
291740;201508;3544;10571;3059;9856;252;937;2392;7634;2644;8571
291750;201508;22245;57104;17126;49138;3894;11486;8392;24601;12286;36087
291760;201508;11028;35073;9707;32750;3892;14440;2712;9076;6604;23516
291770;201508;7556;21783;6434;19733;895;2926;4129;12487;5024;15413
291780;201508;4433;13427;4137;12919;318;1038;3326;10367;3644;11405
291790;201508;2639;8091;2492;7889;97;426;2120;6601;2217;7027
291800;201508;29748;81475;26040;76250;4257;12539;16149;48845;20406;61384
291810;201508;10460;29082;8829;27079;431;1572;7221;22056;7652;23628
291820;201508;3662;10841;3289;10288;241;819;2506;7857;2747;8676
291830;201508;4091;10940;3772;10479;492;1413;2768;7751;3260;9164
291835;201508;6265;19564;5006;17317;1398;5195;2395;8325;3793;13520
291840;201508;46923;131330;41253;124841;6019;17728;29383;91645;35402;109373
291845;201508;2677;7916;2499;7686;177;476;2203;6932;2380;7408
291850;201508;4590;13061;3753;11728;386;1101;2740;8845;3126;9946
291855;201508;1782;4533;1532;4213;170;597;1099;2880;1269;3477
291860;201508;2128;6081;1742;5340;102;371;1142;3430;1244;3801
291870;201508;1416;3767;1029;3050;81;291;651;1864;732;2155
291875;201508;2801;8848;2536;8438;133;553;1845;6002;1978;6555
291880;201508;4874;15580;4561;15053;416;1383;3500;11692;3916;13075
291890;201508;1261;3292;1080;3069;294;819;620;1862;914;2681
291900;201508;1275;3465;1057;3117;79;279;822;2398;901;2677
291905;201508;2735;7339;2095;6226;93;323;1566;4506;1659;4829
291910;201508;2734;7284;2286;6749;123;473;1925;5590;2048;6063
291915;201508;7015;21285;5863;19181;335;1171;4640;15273;4975;16444
291920;201508;29470;84871;26720;80942;4709;14739;16163;49519;20872;64258
291930;201508;2606;7636;2301;7145;195;707;1662;5057;1857;5764
291940;201508;3317;9436;2426;7791;328;1182;1373;4257;1701;5439
291950;201508;8544;28677;7778;27240;1252;4438;4615;16596;5867;21034
291955;201508;9800;29055;9191;28280;2106;6456;5461;17568;7567;24024
291960;201508;3153;9197;2564;8305;248;812;1855;6211;2103;7023
291970;201508;3829;11955;3570;11546;426;1525;2404;7785;2830;9310
291980;201508;11890;33748;9049;29627;1092;3675;6030;20240;7122;23915
291990;201508;2196;6640;1983;6358;98;321;1646;5425;1744;5746
291992;201508;2733;8317;2659;8169;360;1173;2004;6105;2364;7278
291995;201508;1933;5716;1741;5425;118;427;1470;4587;1588;5014
292000;201508;2373;6678;2104;6304;258;898;1468;4381;1726;5279
292010;201508;6340;16073;4891;13962;472;1298;3643;10505;4115;11803
292020;201508;3980;13805;3761;13419;623;2299;2674;9545;3297;11844
292030;201508;2025;6214;1797;5882;232;811;1033;3350;1265;4161
292040;201508;4373;11895;3738;11224;295;679;3152;9964;3447;10643
292045;201508;2899;9766;2799;9624;101;391;2575;8775;2676;9166
292050;201508;6244;19072;5359;17274;460;1751;3566;11326;4026;13077
292060;201508;11453;30815;10582;29696;1131;2865;8218;23241;9349;26106
292070;201508;4647;14300;4390;14001;425;1271;3623;11737;4048;13008
292080;201508;3498;9123;2929;8408;196;600;2454;7082;2650;7682
292090;201508;3949;10400;3412;9766;210;712;2880;8270;3090;8982
292100;201508;11103;29838;9258;27257;2535;7753;4071;12582;6606;20335
292105;201508;2988;9319;2670;8809;140;566;2154;7095;2294;7661
292110;201508;6491;17321;5047;15006;1298;3853;2527;7734;3825;11587
292120;201508;7686;21587;6446;19224;1337;3924;3465;10696;4802;14620
292130;201508;2951;7974;2522;7350;468;1262;1556;4697;2024;5959
292140;201508;4929;12857;4102;11693;864;2211;2573;7597;3437;9808
292145;201508;2436;7432;2175;6979;301;942;1455;4845;1756;5787
292150;201508;12780;38906;11730;37185;648;2299;9356;29744;10004;32043
292160;201508;2527;7262;2143;6766;120;465;1829;5703;1949;6168
292170;201508;8621;24689;7123;22058;895;3152;4576;14005;5471;17157
292180;201508;2915;8613;2374;7653;337;1067;1495;4920;1832;5987
292190;201508;3423;9580;2848;8732;590;1905;1656;5157;2246;7062
292200;201508;6563;20420;5588;18635;1642;5912;2027;6727;3669;12639
292205;201508;3780;11693;3372;11061;174;806;2711;8601;2885;9407
292210;201508;6441;17568;5382;16164;363;1298;4374;13089;4737;14387
292220;201508;1880;5192;1679;4883;530;1436;715;2133;1245;3569
292225;201508;3196;9825;2903;9402;185;734;2351;7562;2536;8296
292230;201508;6339;18753;5999;18191;369;1506;4621;13485;4990;14991
292240;201508;4757;14276;4237;13215;499;1632;2927;9020;3426;10652
292250;201508;5010;15416;4592;14629;1102;3611;2098;6758;3200;10369
292260;201508;3120;9298;2919;9020;202;643;2439;7567;2641;8210
292265;201508;3065;9448;2656;8734;150;648;1982;6398;2132;7046
292270;201508;4072;10379;3210;9380;177;582;2669;7861;2846;8443
292273;201508;2730;6329;2053;5496;204;506;1518;4266;1722;4772
292275;201508;1645;4444;1453;4158;180;546;1061;3059;1241;3605
292280;201508;2063;6018;1789;5708;171;482;1362;4626;1533;5108
292285;201508;2493;6760;2084;6159;123;447;1635;4750;1758;5197
292290;201508;7123;21287;5914;19655;402;1533;4588;15411;4990;16944
292300;201508;7950;23949;6955;22711;1676;5715;3937;13199;5613;18914
292303;201508;2800;8585;2551;8244;102;438;2181;6906;2283;7344
292305;201508;2907;7911;2740;7665;65;244;2507;6935;2572;7179
292310;201508;5799;17174;5373;16540;206;712;4457;13684;4663;14396
292320;201508;6483;18468;5516;16833;475;1544;4168;12646;4643;14190
292330;201508;2128;5792;1961;5554;170;566;1565;4358;1735;4924
292335;201508;5069;13249;4526;12533;420;1144;3729;10467;4149;11611
292340;201508;6213;17776;5291;16241;545;1669;3725;11484;4270;13153
292350;201508;2217;6620;1960;6241;178;667;1522;4808;1700;5475
292360;201508;5150;13671;4907;13189;217;461;4113;11570;4330;12031
292370;201508;7986;23513;7293;22550;715;1917;5689;17970;6404;19887
292380;201508;7218;21328;6606;20354;527;1525;5257;16375;5784;17900
292390;201508;3392;7824;2914;7304;93;201;2682;6785;2775;6986
292400;201508;20470;61697;19322;59895;2389;7563;14231;44323;16620;51886
292405;201508;4449;11200;3578;10075;203;518;2893;8202;3096;8720
292410;201508;1937;5187;1812;5046;134;387;1530;4231;1664;4618
292420;201508;3705;12072;3523;11812;209;758;3029;10207;3238;10965
292430;201508;5588;16547;4217;14553;287;1178;3079;10584;3366;11762
292440;201508;8409;27835;7777;26893;246;1014;6933;24162;7179;25176
292450;201508;3961;11807;3262;10670;320;1057;2332;7734;2652;8791
292460;201508;5149;15304;4427;14052;652;2171;2872;9134;3524;11305
292465;201508;2363;7057;1970;6403;191;708;1306;4302;1497;5010
292467;201508;1890;6071;1795;5918;300;1057;1203;4025;1503;5082
292470;201508;2855;7683;2374;6870;122;430;1882;5384;2004;5814
292480;201508;5996;16144;5200;15075;162;615;4640;13343;4802;13958
292490;201508;2346;6477;1946;5878;148;499;1505;4505;1653;5004
292500;201508;6437;19162;5472;17421;655;2163;3632;11698;4287;13861
292510;201508;12750;36078;11033;33626;851;2911;8508;26121;9359;29032
292520;201508;5398;15670;4719;14606;1134;3532;2463;7741;3597;11273
292525;201508;5193;13704;4464;12842;194;603;3807;10983;4001;11586
292530;201508;26985;75934;23218;70812;6061;19130;11056;34702;17117;53832
292540;201508;2801;7788;2481;7370;264;894;1917;5649;2181;6543
292550;201508;6335;19611;5523;18540;617;2173;4220;14535;4837;16708
292560;201508;3986;11107;3470;10348;187;741;2707;7909;2894;8650
292570;201508;4013;11820;3730;11524;74;171;3526;11142;3600;11313
292575;201508;6058;20330;5889;20050;719;2498;4641;15941;5360;18439
292580;201508;6744;19971;6346;19429;409;1311;5309;16264;5718;17575
292590;201508;7154;21539;6629;20759;521;1649;5436;16939;5957;18588
292593;201508;2994;7889;2485;7079;188;481;1972;5644;2160;6125
292595;201508;5765;15974;5083;15095;396;1253;3954;11781;4350;13034
292600;201508;10495;29586;9451;28241;934;2256;7264;22517;8198;24773
292610;201508;4517;12750;3663;11311;323;1014;2251;7225;2574;8239
292620;201508;5844;17272;5204;16518;133;450;4809;15330;4942;15780
292630;201508;9294;23339;7713;20906;793;2109;5404;14938;6197;17047
292640;201508;7641;24987;7057;24105;465;1739;5403;18657;5868;20396
292650;201508;4739;12753;4455;12378;380;828;3787;10764;4167;11592
292660;201508;10530;31719;9711;30519;1049;3405;7342;23343;8391;26748
292665;201508;2558;7876;2459;7747;47;93;2322;7427;2369;7520
292670;201508;3667;10363;2844;8885;194;669;1847;5749;2041;6418
292680;201508;3561;10713;3254;10199;397;1212;2361;7403;2758;8615
292690;201508;2846;7809;2113;6651;185;613;1474;4747;1659;5360
292700;201508;9169;27288;8064;25636;1121;3354;5292;17588;6413;20942
292710;201508;2045;6701;1934;6556;77;324;1712;5780;1789;6104
292720;201508;9191;23427;7902;21988;364;1175;6774;18918;7138;20093
292730;201508;3520;10570;3380;10357;307;943;2587;7967;2894;8910
292740;201508;317210;848188;295579;815951;51720;151460;187978;514532;239698;665992
292750;201508;6382;17156;5465;15875;292;955;4432;12867;4724;13822
292760;201508;3954;12412;3582;11728;432;1507;2390;7862;2822;9369
292770;201508;5907;17336;5237;16382;986;3193;3185;10231;4171;13424
292780;201508;1880;4486;1438;3912;151;497;1019;2680;1170;3177
292790;201508;3198;7949;3060;7805;96;183;2890;7466;2986;7649
292800;201508;8860;26349;8180;25210;516;1744;6569;20155;7085;21899
292805;201508;2892;8223;2577;7781;342;1118;1879;5643;2221;6761
292810;201508;9294;28062;7828;26012;934;3206;5522;18745;6456;21951
292820;201508;6967;20364;5464;18174;307;1234;4257;14141;4564;15375
292830;201508;1762;5130;1584;4875;70;299;1364;4132;1434;4431
292840;201508;7605;23641;7098;22948;306;1247;6266;19969;6572;21216
292850;201508;3180;8347;2578;7415;349;1020;1578;4445;1927;5465
292860;201508;14690;38397;13440;36725;1180;3333;10431;28395;11611;31728
292870;201508;18867;51483;16358;47499;2149;6877;9695;27674;11844;34551
292880;201508;12522;35588;11074;33500;1216;4073;7667;22843;8883;26916
292890;201508;5256;17820;4737;16886;688;2606;3089;11136;3777;13742
292895;201508;2713;6648;2112;5735;260;658;1464;4013;1724;4671
292900;201508;2752;8543;2612;8318;192;859;1937;5880;2129;6739
292905;201508;4032;11904;3360;10882;201;711;2563;8331;2764;9042
292910;201508;4965;14807;4491;13936;622;2058;2752;8528;3374;10586
292920;201508;8931;26193;8409;25386;574;2060;6836;20046;7410;22106
292925;201508;5017;15358;4508;14604;422;1387;3379;10988;3801;12375
292930;201508;6397;20544;6062;19941;491;2092;4406;14099;4897;16191
292935;201508;2100;6005;1763;5639;115;409;1456;4798;1571;5207
292937;201508;3156;8042;2620;7381;254;784;2020;5635;2274;6419
292940;201508;3244;8867;2530;7867;287;902;1704;5505;1991;6407
292950;201508;7809;22922;7240;21947;576;2125;5316;15643;5892;17768
292960;201508;5124;13305;4402;12314;322;978;3224;8928;3546;9906
292970;201508;4218;12700;3721;12019;159;702;3076;9874;3235;10576
292975;201508;3416;9193;3217;8935;352;900;2691;7605;3043;8505
292980;201508;3246;8773;2515;7733;232;820;1799;5486;2031;6306
292990;201508;11714;33719;10304;31548;447;1617;8476;25773;8923;27390
293000;201508;2755;7243;2465;6887;69;220;2082;5988;2151;6208
293010;201508;17764;49158;15041;44735;2454;7768;8943;26345;11397;34113
293015;201508;7281;25072;6452;23411;849;3520;4120;14773;4969;18293
293020;201508;9098;30277;8510;29461;356;1586;7293;25116;7649;26702
293030;201508;5339;15525;4269;13835;333;1104;3030;10224;3363;11328
293040;201508;3633;11996;3467;11671;183;647;3041;10214;3224;10861
293050;201508;19806;54605;17356;51497;2793;8537;10409;31950;13202;40487
293060;201508;3792;9919;3097;8772;269;827;2273;6344;2542;7171
293070;201508;21180;60972;18481;56754;4548;14039;9094;28844;13642;42883
293075;201508;3258;11013;2991;10613;228;943;2338;8295;2566;9238
293076;201508;3719;10305;3358;9815;204;574;2822;8404;3026;8978
293077;201508;4654;14743;4207;14075;1010;3541;2254;7700;3264;11241
293080;201508;4484;14201;4105;13590;200;951;3384;10958;3584;11909
293090;201508;3233;10425;2681;9582;286;1059;1895;6860;2181;7919
293100;201508;5734;16956;4752;15194;439;1491;3471;11202;3910;12693
293105;201508;3960;13088;3453;12101;530;1838;2215;7956;2745;9794
293110;201508;1977;5688;1750;5338;59;215;1472;4492;1531;4707
293120;201508;3696;12277;3505;11971;328;1038;2749;9618;3077;10656
293130;201508;4052;11430;3434;10750;154;546;3059;9671;3213;10217
293135;201508;31080;77996;23244;66868;4759;15393;9561;27183;14320;42576
293140;201508;1941;5560;1851;5430;144;521;1475;4183;1619;4704
293150;201508;5437;17970;4667;16429;807;2881;2791;10062;3598;12943
293160;201508;3748;9585;3441;9222;593;1176;2430;7058;3023;8234
293170;201508;3287;9779;3006;9367;329;1179;2120;6627;2449;7806
293180;201508;5172;14531;4127;12817;179;747;3213;9739;3392;10486
293190;201508;13748;41441;12717;39875;441;2093;10974;33695;11415;35788
293200;201508;6861;19175;5946;17976;217;789;4818;14606;5035;15395
293210;201508;4882;14212;4321;13225;300;1038;3305;10055;3605;11093
293220;201508;5066;14901;4395;13729;1131;3618;1808;5757;2939;9375
293230;201508;3800;11612;3463;11084;513;1779;2363;7565;2876;9344
293240;201508;4393;11967;3511;10498;147;485;2617;7789;2764;8274
293245;201508;4171;12014;3807;11466;327;980;2922;8886;3249;9866
293250;201508;5704;15793;5136;14940;531;1590;3655;10588;4186;12178
293260;201508;4542;13570;3854;12566;279;964;2945;9696;3224;10660
293270;201508;5578;14875;5180;14452;398;906;4510;12858;4908;13764
293280;201508;5262;14800;4485;13754;261;789;3551;11046;3812;11835
293290;201508;14878;49234;13827;47159;3299;11656;6671;23183;9970;34839
293300;201508;6784;16087;5677;14798;341;790;4512;11985;4853;12775
293305;201508;4799;11902;4071;10913;166;510;3430;9127;3596;9637
293310;201508;2482;6498;2020;5703;177;494;1421;3987;1598;4481
293315;201508;4186;10732;3578;9780;437;1156;2587;7165;3024;8321
293317;201508;2449;7135;2178;6637;204;632;1491;4586;1695;5218
293320;201508;7911;26395;7723;26158;650;2471;6414;21740;7064;24211
293325;201508;1825;5197;1495;4687;204;718;1000;3132;1204;3850
293330;201508;51049;161565;45436;151644;9803;35069;22530;75727;32333;110796
293340;201508;2686;7543;2070;6461;321;1038;1135;3521;1456;4559
293345;201508;3316;9764;2876;9161;268;732;2212;7365;2480;8097
293350;201508;6632;18861;6239;18395;331;781;5500;16670;5831;17451
293360;201508;12904;39540;11682;37986;812;2945;9950;32315;10762;35260
310010;201508;985;2681;751;2308;137;521;331;944;468;1465
310020;201508;3146;9722;2531;8446;576;2107;437;1303;1013;3410
310030;201508;2318;7251;1904;6523;425;1620;1007;3393;1432;5013
310040;201508;1018;2672;838;2430;67;235;640;1819;707;2054
310050;201508;1901;6477;1697;6010;326;1299;721;2489;1047;3788
310060;201508;3211;10216;2809;9696;334;1220;2056;7130;2390;8350
310070;201508;333;954;261;822;27;115;150;432;177;547
310080;201508;701;2140;565;1892;116;493;199;600;315;1093
310090;201508;4619;13712;3957;12532;546;1942;2444;7654;2990;9596
310100;201508;3311;10074;2751;9109;194;776;2126;6994;2320;7770
310110;201508;4790;13469;4086;12327;665;2263;2342;6885;3007;9148
310120;201508;584;1786;459;1528;128;539;180;481;308;1020
310130;201508;420;1264;375;1194;90;341;189;548;279;889
310140;201508;198;655;162;590;59;257;40;112;99;369
310150;201508;4613;14105;3991;12887;944;3359;1606;5050;2550;8409
310160;201508;7504;23318;6087;20709;1738;6449;1500;4943;3238;11392
310163;201508;973;3098;800;2748;203;732;248;836;451;1568
310170;201508;8959;25337;8040;24004;1218;3787;5229;15895;6447;19682
310180;201508;1620;4683;1353;4261;308;1071;624;1876;932;2947
310190;201508;2739;9070;2488;8652;691;2614;371;1280;1062;3894
310200;201508;1860;6044;1548;5397;345;1339;545;1868;890;3207
310205;201508;1110;3197;860;2798;161;529;460;1520;621;2049
310210;201508;2697;7870;2426;7464;238;803;1861;5739;2099;6542
310220;201508;1032;3197;962;3079;183;666;554;1719;737;2385
310230;201508;2525;7907;2104;6980;430;1664;994;3071;1424;4735
310240;201508;913;3298;815;3098;129;538;437;1711;566;2249
310250;201508;844;2798;811;2737;141;588;485;1526;626;2114
310260;201508;3292;10377;2543;8779;632;2483;732;2278;1364;4761
310270;201508;2458;7144;2108;6632;185;693;1601;4981;1786;5674
310280;201508;2276;6088;1890;5501;277;993;989;2698;1266;3691
310285;201508;2056;7318;1929;7123;249;1060;1441;5346;1690;6406
310290;201508;1208;3647;1128;3530;280;1003;546;1544;826;2547
310300;201508;1730;5817;1630;5631;445;1745;850;2810;1295;4555
310310;201508;372;1010;265;802;41;121;121;375;162;496
310320;201508;383;1221;314;1080;47;222;148;490;195;712
310330;201508;511;1277;350;977;33;111;155;376;188;487
310340;201508;8319;25052;6846;22498;1310;4464;3544;11992;4854;16456
310350;201508;14030;37121;10027;30359;2525;8528;2849;8316;5374;16844
310360;201508;435;1315;411;1280;39;163;284;819;323;982
310370;201508;1385;4652;1284;4472;356;1268;660;2327;1016;3595
310375;201508;1259;3343;803;2511;119;427;316;951;435;1378
310380;201508;377;1016;273;860;97;334;94;265;191;599
310390;201508;455;1599;384;1451;90;379;73;231;163;610
310400;201508;10154;28384;7536;23749;1827;6281;1859;5791;3686;12072
310410;201508;793;2591;530;2114;127;559;111;427;238;986
310420;201508;5658;15839;3474;11102;597;2092;560;1566;1157;3658
310430;201508;1364;4464;1035;3767;262;1057;179;596;441;1653
310440;201508;567;1617;440;1393;87;325;175;514;262;839
310445;201508;1216;4002;1009;3603;151;588;633;2242;784;2830
310450;201508;4558;12833;3667;11543;491;1626;2422;7741;2913;9367
310460;201508;1522;4605;1258;4187;364;1332;271;950;635;2282
310470;201508;3547;8862;2995;8177;274;680;2449;6827;2723;7507
310480;201508;1219;3573;914;2962;183;693;389;1151;572;1844
310490;201508;2855;9277;2444;8462;626;2493;948;3158;1574;5651
310500;201508;1286;4333;1136;4011;266;1063;451;1522;717;2585
310510;201508;2125;6637;1640;5547;415;1522;298;958;713;2480
310520;201508;1399;3655;1072;3134;88;259;716;2102;804;2361
310530;201508;885;2727;495;1699;71;263;66;194;137;457
310540;201508;2909;9511;2625;8985;644;2295;1149;3926;1793;6221
310550;201508;1196;3407;955;3004;216;823;442;1275;658;2098
310560;201508;15437;46915;12904;41893;3524;12778;3930;11886;7454;24664
310570;201508;1165;3476;996;3182;155;587;674;2108;829;2695
310590;201508;4301;12441;3392;10712;605;2072;1366;4146;1971;6218
310600;201508;1369;4506;1215;4169;297;1183;440;1366;737;2549
310610;201508;481;1619;415;1472;91;407;134;406;225;813
310620;201508;144218;439687;121375;395924;28532;104614;47601;144665;76133;249279
310630;201508;3915;11901;3632;11418;386;1400;2666;8288;3052;9688
310640;201508;1305;3900;1017;3378;319;1156;252;758;571;1914
310650;201508;2646;8476;2138;7578;362;1384;1174;4159;1536;5543
310660;201508;1357;4100;1188;3863;139;467;840;2709;979;3176
310665;201508;1252;3810;1114;3609;117;418;844;2774;961;3192
310670;201508;42215;128113;37114;117276;9481;31835;13739;41926;23220;73761
310680;201508;683;1957;619;1861;124;405;366;1078;490;1483
310690;201508;1402;4491;1119;3980;258;1053;345;1146;603;2199
310700;201508;583;1463;449;1283;95;317;255;690;350;1007
310710;201508;6328;20688;4904;18195;1076;4765;907;2989;1983;7754
310720;201508;760;2291;681;2152;118;430;385;1172;503;1602
310730;201508;9252;28668;8206;26904;1500;5355;4778;15549;6278;20904
310740;201508;4865;15491;3876;13528;985;3797;880;2893;1865;6690
310750;201508;1498;3694;1128;3199;200;607;621;1662;821;2269
310760;201508;621;1871;512;1690;108;383;202;667;310;1050
310770;201508;852;2669;658;2359;156;637;270;891;426;1528
310780;201508;3675;10252;3097;9218;508;1515;1815;5396;2323;6911
310790;201508;1902;6054;1699;5684;429;1501;783;2730;1212;4231
310800;201508;2801;8821;2130;7504;653;2631;204;644;857;3275
310810;201508;1210;3376;1070;3128;197;635;574;1589;771;2224
310820;201508;1280;3650;923;2975;222;791;248;761;470;1552
310825;201508;2495;8372;1961;7416;129;677;1409;5250;1538;5927
310830;201508;1290;4148;987;3533;293;1116;240;801;533;1917
310840;201508;2140;6568;1677;5727;424;1571;457;1455;881;3026
310850;201508;1557;4576;1292;4232;202;703;859;2821;1061;3524
310855;201508;2873;9053;2462;8413;427;1604;1558;5361;1985;6965
310860;201508;7522;22992;6304;20800;903;3182;3626;12118;4529;15300
310870;201508;1015;2810;807;2478;148;493;409;1256;557;1749
310880;201508;1175;3556;873;2979;158;642;427;1427;585;2069
310890;201508;2660;8117;2032;7006;489;1909;466;1437;955;3346
310900;201508;3928;12434;3079;10586;701;2662;985;3102;1686;5764
310910;201508;2011;5700;1291;4255;271;1015;195;531;466;1546
310920;201508;1875;5531;1467;4917;349;1337;624;2046;973;3383
310925;201508;896;2943;807;2783;310;1173;285;941;595;2114
310930;201508;6001;17020;4766;15158;863;2951;2687;8750;3550;11701
310940;201508;6235;17694;5166;16017;924;2971;2688;8288;3612;11259
310945;201508;1190;3415;1022;3164;142;516;622;1851;764;2367
310950;201508;1999;6350;1470;5171;388;1579;360;1087;748;2666
310960;201508;395;1265;325;1135;91;355;107;374;198;729
310970;201508;1470;4937;1052;3920;269;1117;142;440;411;1557
310980;201508;460;1112;283;813;37;127;137;339;174;466
310990;201508;1167;3838;954;3379;222;889;271;886;493;1775
311000;201508;3603;12187;3185;11321;858;3484;1107;3641;1965;7125
311010;201508;732;2413;676;2306;218;815;310;1019;528;1834
311020;201508;900;2673;705;2322;152;558;291;893;443;1451
311030;201508;1612;4373;1111;3457;280;1003;388;1082;668;2085
311040;201508;481;1625;421;1464;90;329;99;326;189;655
311050;201508;2046;6428;1789;6014;484;1800;808;2715;1292;4515
311060;201508;2198;6578;1638;5350;354;1301;428;1283;782;2584
311070;201508;1398;4801;1217;4444;291;1220;473;1690;764;2910
311080;201508;867;2588;747;2359;137;480;368;1067;505;1547
311090;201508;1562;5789;1316;5276;404;1789;241;959;645;2748
311100;201508;2061;6906;1686;6097;634;2490;314;1102;948;3592
311110;201508;3698;8776;2600;7203;382;1143;1401;3860;1783;5003
311115;201508;1203;3531;1004;3229;112;474;654;2038;766;2512
311120;201508;7789;21891;5969;18610;1470;5107;1528;4355;2998;9462
311130;201508;1935;6064;1622;5606;364;1531;702;2258;1066;3789
311140;201508;1353;3612;1092;3259;110;397;761;2219;871;2616
311150;201508;1823;6159;1663;5900;279;1103;1025;3624;1304;4727
311160;201508;4229;14025;3448;12589;1179;4720;881;3102;2060;7822
311170;201508;775;2358;609;2048;78;274;300;1045;378;1319
311180;201508;1316;3695;1003;3089;291;973;242;671;533;1644
311190;201508;1014;2988;858;2677;187;676;274;756;461;1432
311200;201508;2094;6348;1683;5483;475;1726;342;955;817;2681
311205;201508;1026;3354;867;3025;141;550;383;1346;524;1896
311210;201508;932;3002;857;2896;155;521;597;2075;752;2596
311220;201508;891;2780;704;2365;162;582;228;746;390;1328
311230;201508;8446;26128;6704;22672;1319;4784;2692;9366;4011;14150
311240;201508;1105;3295;849;2844;198;733;244;762;442;1495
311250;201508;836;2709;742;2558;215;862;249;726;464;1588
311260;201508;2510;6633;1855;5546;464;1526;603;1769;1067;3295
311265;201508;1263;3478;991;3029;171;605;547;1636;718;2241
311270;201508;3312;10525;2876;9892;353;1562;1933;6380;2286;7942
311280;201508;1286;3551;837;2627;165;599;254;754;419;1353
311290;201508;1990;6681;1852;6360;397;1376;1056;3664;1453;5040
311300;201508;4425;14721;3962;13865;497;2015;2683;9368;3180;11383
311310;201508;546;1864;493;1769;90;389;202;664;292;1053
311320;201508;4031;13300;3518;12143;703;2754;1171;3785;1874;6539
311330;201508;4827;14328;4104;13108;1162;4150;1669;5258;2831;9408
311340;201508;12102;37938;10494;34842;3156;11292;2953;9649;6109;20941
311350;201508;2273;6484;1780;5539;321;1170;788;2227;1109;3397
311360;201508;1174;3224;897;2862;332;1110;187;595;519;1705
311370;201508;3773;11270;3160;10175;692;2689;1333;3918;2025;6607
311380;201508;402;1322;349;1222;96;369;115;387;211;756
311390;201508;1800;6530;1649;6300;670;2927;508;1779;1178;4706
311400;201508;1448;4554;1204;4079;228;934;531;1623;759;2557
311410;201508;1792;6122;1611;5878;435;1767;801;2946;1236;4713
311420;201508;1927;6196;1302;4637;292;1128;227;612;519;1740
311430;201508;3923;11667;2645;8815;487;1776;302;916;789;2692
311440;201508;2345;7499;1736;6343;532;2276;304;1051;836;3327
311450;201508;1966;6747;1627;5964;433;1756;346;1163;779;2919
311455;201508;1207;3204;981;2835;218;688;496;1329;714;2017
311460;201508;692;2233;529;1896;115;501;124;414;239;915
311470;201508;515;1646;405;1404;102;435;118;350;220;785
311480;201508;765;2024;716;1963;181;482;421;1148;602;1630
311490;201508;235;879;210;807;61;253;77;278;138;531
311500;201508;462;1325;364;1142;80;291;159;487;239;778
311510;201508;3143;9679;2549;8530;818;3223;570;1730;1388;4953
311520;201508;625;2048;571;1929;190;707;212;669;402;1376
311530;201508;11684;30021;8138;24119;1871;6599;2241;6417;4112;13016
311535;201508;822;2387;526;1787;116;454;79;256;195;710
311540;201508;626;2186;586;2127;225;824;244;867;469;1691
311545;201508;2063;6386;1875;6150;198;749;1347;4359;1545;5108
311547;201508;1519;4265;1268;3859;99;333;847;2579;946;2912
311550;201508;2895;9173;2397;8140;458;1761;812;2697;1270;4458
311560;201508;261;675;218;620;38;122;124;333;162;455
311570;201508;2180;5400;1672;4741;121;381;1258;3620;1379;4001
311580;201508;2378;4856;1809;4197;518;1112;958;2369;1476;3481
311590;201508;449;1383;383;1283;107;422;135;444;242;866
311600;201508;1186;3591;1008;3354;184;599;627;2129;811;2728
311610;201508;3078;10709;2746;10114;882;3192;1152;4462;2034;7654
311615;201508;3070;9436;2526;8555;271;1056;1734;5869;2005;6925
311620;201508;426;1322;371;1231;77;283;206;675;283;958
311630;201508;1383;4016;1144;3603;267;813;636;2026;903;2839
311640;201508;816;2580;672;2331;128;489;379;1277;507;1766
311650;201508;2257;6582;1895;5968;264;894;1050;3370;1314;4264
311660;201508;2400;7961;1894;6774;370;1461;234;674;604;2135
311670;201508;1580;4666;1284;4142;416;1481;408;1275;824;2756
311680;201508;2055;6458;1737;5920;396;1427;913;3106;1309;4533
311690;201508;499;1299;418;1198;43;137;333;951;376;1088
311700;201508;2185;5920;1815;5414;125;469;1409;4086;1534;4555
311710;201508;1677;5040;1222;4180;443;1694;312;1004;755;2698
311720;201508;395;1305;348;1204;63;242;167;558;230;800
311730;201508;5834;14490;3344;10089;921;3240;897;2142;1818;5382
311740;201508;852;2489;784;2405;283;838;408;1298;691;2136
311750;201508;3958;12884;3418;11997;673;2642;1749;6009;2422;8651
311760;201508;809;2698;722;2491;180;734;253;757;433;1491
311770;201508;2322;7282;1869;6415;437;1685;571;1844;1008;3529
311780;201508;1073;3839;887;3392;266;1162;201;701;467;1863
311783;201508;1942;6374;1639;5777;112;548;1198;4170;1310;4718
311787;201508;572;1956;409;1463;71;283;90;261;161;544
311790;201508;1416;4170;1016;3387;235;878;309;977;544;1855
311800;201508;4230;14236;3370;11819;608;2248;168;471;776;2719
311810;201508;1039;3406;945;3215;67;306;655;2184;722;2490
311820;201508;599;1896;484;1613;125;453;236;751;361;1204
311830;201508;8131;27132;6559;23224;2134;8165;822;2565;2956;10730
311840;201508;3115;9204;2697;8596;738;2672;1233;3791;1971;6463
311850;201508;290;857;249;786;62;215;109;331;171;546
311860;201508;49004;144546;41273;130460;9102;31620;19085;57983;28187;89603
311870;201508;2173;6338;1621;5272;344;1286;498;1463;842;2749
311880;201508;6810;19586;6010;18597;810;2371;4231;13590;5041;15961
311890;201508;1417;4230;1136;3674;279;1002;452;1414;731;2416
311900;201508;767;2360;684;2249;112;377;433;1492;545;1869
311910;201508;4265;12443;3460;11257;832;2930;1461;4718;2293;7648
311920;201508;1917;6292;1670;5836;200;779;1042;3619;1242;4398
311930;201508;3611;10331;3052;9433;1113;3632;934;2825;2047;6457
311940;201508;11802;35413;9489;30590;2510;8800;1867;5602;4377;14402
311950;201508;2218;6452;1837;5915;155;560;1292;4105;1447;4665
311960;201508;363;1128;320;1033;73;271;123;336;196;607
311970;201508;348;1209;290;1078;63;275;78;276;141;551
311980;201508;649;1802;431;1406;73;255;160;520;233;775
311990;201508;424;1253;351;1131;130;461;118;349;248;810
311995;201508;1164;3550;706;2421;56;199;81;208;137;407
312000;201508;622;1862;553;1755;75;266;344;1095;419;1361
312010;201508;923;2993;777;2665;138;532;327;1089;465;1621
312015;201508;1402;4485;1245;4202;154;626;799;2671;953;3297
312020;201508;947;2963;823;2766;164;602;411;1372;575;1974
312030;201508;1756;5203;1574;4973;120;454;1280;3994;1400;4448
312040;201508;718;2646;609;2347;164;718;127;453;291;1171
312050;201508;1428;4896;1209;4401;289;1182;162;509;451;1691
312060;201508;750;2258;647;2095;264;915;217;640;481;1555
312070;201508;1029;3148;662;2343;160;610;218;762;378;1372
312080;201508;2613;7295;2067;6427;330;1195;1080;3166;1410;4361
312083;201508;901;2577;778;2388;104;357;524;1577;628;1934
312087;201508;2165;6605;1917;6233;247;861;1316;4346;1563;5207
312090;201508;8791;27300;7614;25226;2150;7619;2934;9462;5084;17081
312100;201508;1372;4600;1144;4235;251;1040;536;1959;787;2999
312110;201508;1099;3818;951;3492;305;1292;175;548;480;1840
312120;201508;755;2458;645;2235;148;617;224;669;372;1286
312125;201508;1163;3669;1017;3402;236;817;507;1755;743;2572
312130;201508;828;2379;629;1975;97;355;242;709;339;1064
312140;201508;900;2852;749;2494;153;569;232;654;385;1223
312150;201508;543;1557;457;1370;24;89;298;847;322;936
312160;201508;7318;24738;6504;23016;1762;6857;2341;8122;4103;14979
312170;201508;964;2746;811;2482;85;288;496;1498;581;1786
312180;201508;1354;4112;1174;3753;262;902;457;1379;719;2281
312190;201508;579;1854;441;1576;147;580;82;275;229;855
312200;201508;4782;13758;4013;12525;514;1657;2619;8128;3133;9785
312210;201508;1002;2701;765;2345;204;684;292;832;496;1516
312220;201508;1866;6232;1705;6045;194;682;1363;5024;1557;5706
312230;201508;12995;39576;9864;33345;3289;12308;1567;5006;4856;17314
312235;201508;1578;4698;1368;4380;158;627;916;2854;1074;3481
312240;201508;942;3090;754;2685;174;679;235;770;409;1449
312245;201508;2221;6538;1964;6199;120;410;1601;5046;1721;5456
312247;201508;830;2488;645;2159;167;618;293;979;460;1597
312250;201508;1184;3279;919;2830;164;591;371;1062;535;1653
312260;201508;897;2848;738;2582;128;517;456;1548;584;2065
312270;201508;656;1966;544;1751;81;342;241;688;322;1030
312280;201508;395;1329;350;1231;121;454;50;162;171;616
312290;201508;747;2436;687;2346;196;781;224;740;420;1521
312300;201508;864;2856;673;2387;156;607;81;214;237;821
312310;201508;901;3354;821;3161;237;1010;301;1109;538;2119
312320;201508;1948;5557;1451;4530;335;1114;254;622;589;1736
312330;201508;982;2891;820;2646;140;539;586;1858;726;2397
312340;201508;303;790;263;735;30;122;208;543;238;665
312350;201508;309;775;277;737;23;71;234;603;257;674
312352;201508;1603;5098;1427;4823;371;1276;844;2933;1215;4209
312360;201508;2882;9305;2349;8181;537;2071;689;2346;1226;4417
312370;201508;1715;5421;1541;5141;543;2030;494;1540;1037;3570
312380;201508;1886;5295;1674;4995;116;366;1351;4126;1467;4492
312385;201508;1280;3767;1102;3479;113;452;760;2318;873;2770
312390;201508;2152;6960;1730;6065;467;1763;295;924;762;2687
312400;201508;3164;10070;2665;9113;908;3216;790;2792;1698;6008
312410;201508;9745;31795;8569;29480;1949;7332;3507;11729;5456;19061
312420;201508;3963;12153;3726;11853;540;1750;2636;8537;3176;10287
312430;201508;7636;22901;6685;21187;1209;3903;4045;12935;5254;16838
312440;201508;677;2149;599;2015;142;523;301;1059;443;1582
312450;201508;1164;3866;917;3337;307;1183;294;1080;601;2263
312460;201508;355;1065;317;1021;86;307;157;503;243;810
312470;201508;682;1847;435;1363;81;284;141;425;222;709
312480;201508;1226;3298;948;2980;226;794;489;1443;715;2237
312490;201508;2028;5309;1560;4620;230;764;871;2459;1101;3223
312500;201508;677;2063;597;1946;103;415;284;899;387;1314
312510;201508;3154;9207;2440;7717;422;1527;1172;3425;1594;4952
312520;201508;268;909;216;808;59;237;71;269;130;506
312530;201508;589;1763;525;1669;76;309;336;1019;412;1328
312540;201508;1463;4575;1132;3908;242;890;540;1840;782;2730
312550;201508;679;2079;576;1851;122;402;255;774;377;1176
312560;201508;1996;5340;1685;4935;107;366;1350;3910;1457;4276
312570;201508;2471;7248;2031;6485;599;2045;587;1795;1186;3840
312580;201508;529;1738;440;1548;79;345;160;523;239;868
312590;201508;1708;5677;1479;5185;302;1262;598;1918;900;3180
312595;201508;1987;6660;1760;6129;409;1509;887;3065;1296;4574
312600;201508;794;2561;612;2193;98;461;307;993;405;1454
312610;201508;6955;19483;5069;16004;1173;4145;1210;3548;2383;7693
312620;201508;2054;6043;1612;5437;163;636;1177;4030;1340;4666
312630;201508;347;1118;303;1035;77;299;129;413;206;712
312640;201508;547;1746;433;1508;90;352;146;465;236;817
312650;201508;2122;6263;1544;5106;161;577;891;2936;1052;3513
312660;201508;1336;3604;1102;3256;112;391;742;2142;854;2533
312670;201508;5612;16697;4775;15500;1288;4620;1725;5406;3013;10026
312675;201508;1263;4052;1054;3599;135;546;641;2127;776;2673
312680;201508;1458;4503;1282;4238;216;809;728;2293;944;3102
312690;201508;2166;5786;1745;5191;298;991;1032;2934;1330;3925
312695;201508;813;2915;779;2868;155;561;508;1935;663;2496
312700;201508;1912;5661;1461;4724;212;783;722;2268;934;3051
312705;201508;1257;3590;1065;3258;102;357;756;2271;858;2628
312707;201508;1649;5098;1276;4367;190;757;658;2149;848;2906
312710;201508;7047;17979;4542;13748;1201;4156;947;2609;2148;6765
312720;201508;751;2547;654;2348;151;602;237;794;388;1396
312730;201508;1883;4458;1307;3778;188;594;728;2108;916;2702
312733;201508;1666;4425;1232;3611;85;324;835;2326;920;2650
312735;201508;826;2312;716;2163;175;596;404;1178;579;1774
312737;201508;858;2148;614;1800;193;565;235;712;428;1277
312738;201508;541;1621;389;1300;103;416;126;359;229;775
312740;201508;400;1066;256;895;82;317;67;239;149;556
312750;201508;1228;4361;1171;4247;239;1067;570;1957;809;3024
312760;201508;2062;6551;1571;5543;387;1494;361;1249;748;2743
312770;201508;40621;111547;31556;96288;8223;27120;9086;26813;17309;53933
312780;201508;2690;9348;2393;8844;441;1802;1255;4721;1696;6523
312790;201508;327;829;184;573;43;167;49;108;92;275
312800;201508;4954;16140;4010;14187;1238;4747;1073;3770;2311;8517
312810;201508;2135;6504;1469;5184;359;1365;261;855;620;2220
312820;201508;1909;5486;1697;5135;118;425;1153;3398;1271;3823
312825;201508;1358;3668;1170;3423;108;347;893;2592;1001;2939
312830;201508;2655;8177;1821;6461;452;1732;312;1067;764;2799
312840;201508;1231;3939;1036;3576;122;511;555;1848;677;2359
312850;201508;640;2034;513;1785;86;360;164;547;250;907
312860;201508;1097;3180;851;2746;214;808;240;656;454;1464
312870;201508;5537;17052;3815;13375;745;2919;810;2690;1555;5609
312880;201508;1262;3737;1088;3454;171;603;623;2012;794;2615
312890;201508;1626;4830;1091;3662;286;1084;365;1200;651;2284
312900;201508;1218;3597;1070;3386;152;505;750;2432;902;2937
312910;201508;1608;3262;1000;2466;170;495;522;1158;692;1653
312920;201508;858;2704;713;2449;191;754;287;910;478;1664
312930;201508;2223;6350;1903;5876;422;1366;907;2856;1329;4222
312940;201508;891;2901;767;2686;213;852;204;664;417;1516
312950;201508;3266;9061;2493;7877;816;2797;673;2076;1489;4873
312960;201508;1934;5587;1682;5256;250;737;1248;4030;1498;4767
312965;201508;1785;5653;1509;5152;214;845;885;2998;1099;3843
312970;201508;974;3311;813;3024;255;1099;140;462;395;1561
312980;201508;16842;56274;15732;53856;5016;18839;6149;20069;11165;38908
312990;201508;443;1339;327;1131;107;419;97;331;204;750
313000;201508;506;1651;406;1450;97;451;163;498;260;949
313005;201508;2554;8222;2243;7640;482;1631;1205;4160;1687;5791
313010;201508;3721;11798;3125;10754;810;3018;1304;4405;2114;7423
313020;201508;950;3051;778;2658;173;684;219;644;392;1328
313030;201508;1484;3971;1097;3427;231;890;463;1349;694;2239
313040;201508;839;2782;707;2446;124;502;268;849;392;1351
313050;201508;1760;5477;1339;4823;313;1275;350;1117;663;2392
313055;201508;1565;5046;1426;4852;119;436;1103;3794;1222;4230
313060;201508;679;2195;528;1816;157;553;61;195;218;748
313065;201508;1933;6242;1656;5798;340;1315;1093;3809;1433;5124
313070;201508;1108;3197;900;2825;211;769;404;1159;615;1928
313080;201508;463;1448;359;1239;86;347;120;350;206;697
313090;201508;5246;15033;4522;13862;969;3152;2411;7425;3380;10577
313100;201508;1067;3290;956;3103;107;361;725;2374;832;2735
313110;201508;1733;4883;1283;4009;241;856;524;1513;765;2369
313115;201508;2431;8168;2288;7875;550;2167;1075;3434;1625;5601
313120;201508;3452;9188;2872;8389;777;2489;1397;3855;2174;6344
313130;201508;24398;73707;20752;66089;4942;17352;7687;22883;12629;40235
313140;201508;674;1713;507;1461;34;124;355;1004;389;1128
313150;201508;1353;4265;1132;3845;462;1709;271;881;733;2590
313160;201508;1020;3061;885;2804;154;574;510;1554;664;2128
313170;201508;7774;26300;6187;22480;1552;6031;1252;4433;2804;10464
313180;201508;2395;6546;1893;5813;517;1745;678;1986;1195;3731
313190;201508;3064;10584;2439;8933;518;2077;682;2306;1200;4383
313200;201508;1245;4042;1088;3745;149;578;730;2466;879;3044
313210;201508;4296;13172;3598;12153;829;3058;1615;5235;2444;8293
313220;201508;1354;4087;994;3287;240;880;216;606;456;1486
313230;201508;2263;8069;2084;7804;323;1313;1409;5270;1732;6583
313240;201508;7452;22949;5886;20043;1245;4861;2219;7183;3464;12044
313250;201508;7059;22034;6193;20546;928;3176;3566;11934;4494;15110
313260;201508;607;1803;447;1470;73;276;107;317;180;593
313270;201508;5389;15999;4540;14547;820;2819;2523;7996;3343;10815
313280;201508;380;1261;300;1083;48;211;81;254;129;465
313290;201508;859;2987;692;2667;233;982;118;391;351;1373
313300;201508;1809;6002;1465;5169;409;1570;220;665;629;2235
313310;201508;1083;3713;952;3440;230;931;183;602;413;1533
313320;201508;2353;6799;1791;5864;346;1270;775;2507;1121;3777
313330;201508;3905;12135;3242;10941;432;1699;1817;5966;2249;7665
313340;201508;1951;4771;1515;4123;290;810;842;2255;1132;3065
313350;201508;3138;9564;2388;7942;518;1919;463;1360;981;3279
313360;201508;1201;3471;893;2964;237;930;449;1383;686;2313
313370;201508;1140;3851;1044;3585;159;660;547;1746;706;2406
313375;201508;2224;5767;1486;4643;281;1097;481;1421;762;2518
313380;201508;4885;15189;3993;13337;1002;3692;1338;4206;2340;7898
313390;201508;858;2951;817;2893;95;380;563;1990;658;2370
313400;201508;3702;10167;3289;9697;238;677;2803;8430;3041;9107
313410;201508;1255;3541;1043;3229;225;788;583;1763;808;2551
313420;201508;20206;47870;11982;33822;2309;7297;2249;6083;4558;13380
313430;201508;1068;3315;814;2765;164;676;323;1003;487;1679
313440;201508;6154;13947;4208;11674;312;983;2801;7749;3113;8732
313450;201508;636;1850;507;1590;107;420;178;491;285;911
313460;201508;2155;7343;1862;6823;498;2084;570;1914;1068;3998
313470;201508;3129;8690;2862;8336;370;1066;2108;6117;2478;7183
313480;201508;1096;3126;846;2699;123;461;340;994;463;1455
313490;201508;1392;4156;828;3203;255;1082;122;444;377;1526
313500;201508;395;1236;340;1106;62;234;129;382;191;616
313505;201508;8971;26479;8274;25680;427;1022;7465;23690;7892;24712
313507;201508;1329;3756;1173;3539;153;535;782;2369;935;2904
313510;201508;15347;43917;13317;40929;2109;6683;7689;23855;9798;30538
313520;201508;14223;43791;11950;39585;1432;5443;7588;24791;9020;30234
313530;201508;605;1888;486;1656;48;200;169;538;217;738
313535;201508;2401;7231;2146;6761;201;683;1542;4782;1743;5465
313540;201508;1058;3326;799;2649;211;762;190;556;401;1318
313545;201508;1271;4665;1142;4392;135;675;688;2485;823;3160
313550;201508;1833;5874;1601;5409;407;1450;735;2401;1142;3851
313560;201508;2136;5180;1795;4788;317;792;1193;3325;1510;4117
313570;201508;869;3060;733;2790;242;988;207;768;449;1756
313580;201508;5863;16577;4798;15096;798;2705;2904;9179;3702;11884
313590;201508;989;2811;762;2506;370;1335;190;584;560;1919
313600;201508;3811;11484;3291;10654;498;1771;2088;6789;2586;8560
313610;201508;985;2969;837;2679;182;645;397;1234;579;1879
313620;201508;5407;16611;4606;15146;1282;4514;1627;5273;2909;9787
313630;201508;7938;22359;6032;19500;1141;4198;2622;8785;3763;12983
313640;201508;780;2287;592;1992;174;655;186;604;360;1259
313650;201508;2054;6643;1782;6200;290;1168;1162;3938;1452;5106
313652;201508;963;3426;887;3289;151;634;536;1944;687;2578
313655;201508;928;2989;771;2717;118;514;446;1510;564;2024
313657;201508;1280;3910;1085;3605;112;531;777;2356;889;2887
313660;201508;819;2696;735;2547;162;666;351;1145;513;1811
313665;201508;3406;10980;2984;10102;645;2458;1360;4384;2005;6842
313670;201508;49556;137123;32844;108105;8170;29613;9651;30852;17821;60465
313680;201508;1052;3150;921;2931;155;563;572;1760;727;2323
313690;201508;832;2988;725;2734;194;764;268;1011;462;1775
313695;201508;1348;4404;1157;4055;122;489;797;2792;919;3281
313700;201508;3751;12483;3168;11726;518;2006;2130;8082;2648;10088
313710;201508;1282;3475;1000;3043;218;718;481;1423;699;2141
313720;201508;5081;16348;4047;14056;822;3172;1278;4081;2100;7253
313730;201508;1262;3425;963;3046;176;627;524;1638;700;2265
313740;201508;2116;7540;1770;6688;514;2204;166;539;680;2743
313750;201508;2230;6724;1854;6013;482;1692;606;1817;1088;3509
313753;201508;1810;5280;1420;4594;348;1241;541;1711;889;2952
313760;201508;4338;14009;3541;12387;984;3756;947;3079;1931;6835
313770;201508;3258;10627;2921;10046;900;3346;1165;3883;2065;7229
313780;201508;3697;10190;2925;9053;465;1757;1273;3892;1738;5649
313790;201508;492;1706;466;1659;105;375;264;971;369;1346
313800;201508;1214;3339;1051;3086;133;431;679;2007;812;2438
313810;201508;1485;4304;1416;4209;70;197;1236;3762;1306;3959
313820;201508;12929;34371;10465;30403;1771;6062;4995;13819;6766;19881
313830;201508;411;1364;349;1239;95;391;118;410;213;801
313835;201508;917;3041;849;2934;160;649;475;1553;635;2202
313840;201508;7521;21435;5795;18462;1451;5138;1499;4607;2950;9745
313850;201508;1192;3223;1024;2921;208;709;513;1336;721;2045
313860;201508;2759;8360;2089;6877;489;1733;457;1428;946;3161
313862;201508;1185;2957;788;2293;116;329;384;1176;500;1505
313865;201508;2214;6838;2005;6523;249;942;1431;4584;1680;5526
313867;201508;1101;3754;929;3365;304;1190;291;1089;595;2279
313868;201508;1574;5460;1363;5017;144;636;900;3264;1044;3900
313870;201508;797;2481;723;2360;204;762;221;632;425;1394
313880;201508;1500;4580;1283;4253;220;867;737;2289;957;3156
313890;201508;1827;5017;1534;4622;291;822;981;3119;1272;3941
313900;201508;3951;14280;3525;13279;1037;4422;1040;3723;2077;8145
313910;201508;757;2523;626;2255;222;870;84;271;306;1141
313920;201508;3388;11140;2924;10272;484;1796;1674;5987;2158;7783
313925;201508;1907;5101;1375;4104;85;285;847;2509;932;2794
313930;201508;5210;16947;4274;15238;773;2920;2188;7889;2961;10809
313940;201508;8221;27351;6863;25146;2041;8270;2266;8647;4307;16917
313950;201508;4046;11531;3162;10054;957;3535;1030;2891;1987;6426
313960;201508;5510;14097;3982;11971;1171;3877;1103;3097;2274;6974
313970;201508;1428;4060;1236;3845;137;470;774;2511;911;2981
313980;201508;1249;3936;970;3434;267;1095;391;1368;658;2463
313990;201508;1831;6738;1543;6037;501;2165;310;1068;811;3233
314000;201508;7582;24386;6822;22893;1237;4965;3810;12138;5047;17103
314010;201508;1101;3105;905;2848;111;401;558;1702;669;2103
314015;201508;1157;3997;980;3663;265;1098;364;1275;629;2373
314020;201508;520;1583;384;1295;90;350;90;266;180;616
314030;201508;866;2768;672;2329;99;379;239;808;338;1187
314040;201508;677;1915;562;1717;259;829;157;488;416;1317
314050;201508;1765;5423;1379;4642;309;1207;453;1366;762;2573
314053;201508;1518;4828;1357;4621;183;635;922;3264;1105;3899
314055;201508;2123;6377;1875;6007;87;376;1455;4656;1542;5032
314060;201508;1133;3481;891;3063;71;307;560;1878;631;2185
314070;201508;3945;12174;3007;10301;783;2888;700;2276;1483;5164
314080;201508;1958;5997;1288;4415;234;894;274;805;508;1699
314085;201508;1947;6545;1690;6179;444;1818;623;2246;1067;4064
314090;201508;3291;11331;2881;10506;756;3064;1001;3691;1757;6755
314100;201508;3246;8424;2833;7863;211;487;2371;6806;2582;7293
314110;201508;4064;12817;3504;11647;661;2568;1423;4298;2084;6866
314120;201508;1001;2430;508;1626;121;432;132;408;253;840
314130;201508;717;2038;373;1254;58;211;72;232;130;443
314140;201508;4915;15223;4090;13565;887;3121;1658;5421;2545;8542
314150;201508;1594;4370;1294;3856;210;712;673;1970;883;2682
314160;201508;2529;6489;1977;5748;188;591;1223;3712;1411;4303
314170;201508;1073;3216;865;2758;118;417;454;1384;572;1801
314180;201508;5383;17267;4765;16252;1217;4533;2129;7337;3346;11870
314190;201508;715;2066;565;1834;126;513;229;659;355;1172
314200;201508;2971;9299;2579;8576;308;1241;1725;5588;2033;6829
314210;201508;1941;5720;1715;5317;251;932;1051;3096;1302;4028
314220;201508;1653;5139;1277;4393;379;1472;254;740;633;2212
314225;201508;1304;3825;1163;3634;85;280;974;3085;1059;3365
314230;201508;638;2104;573;1985;129;500;245;822;374;1322
314240;201508;1119;3371;930;3079;142;472;542;1887;684;2359
314250;201508;560;1662;423;1376;94;346;133;375;227;721
314260;201508;1087;3856;975;3602;268;1081;314;1098;582;2179
314270;201508;2877;9274;2417;8457;235;915;1604;5659;1839;6574
314280;201508;3193;8824;2130;6741;491;1822;671;1828;1162;3650
314290;201508;4832;13341;4138;12185;1114;3406;2129;6176;3243;9582
314300;201508;1555;5144;1333;4637;369;1365;427;1411;796;2776
314310;201508;5259;15740;4449;14189;1298;4492;1471;4474;2769;8966
314315;201508;862;3335;793;3199;106;511;514;2058;620;2569
314320;201508;3043;8370;2218;7294;611;2256;1118;3708;1729;5964
314330;201508;52427;158664;45594;147425;12543;43811;16804;53433;29347;97244
314340;201508;2835;7734;1560;5173;343;1230;115;244;458;1474
314345;201508;1210;4114;1093;3922;271;1014;612;2204;883;3218
314350;201508;1356;3912;1071;3444;396;1399;259;785;655;2184
314360;201508;684;2162;454;1607;92;382;100;331;192;713
314370;201508;526;1826;484;1759;145;585;276;983;421;1568
314380;201508;1263;3780;864;2978;236;881;135;452;371;1333
314390;201508;14269;40937;10637;34126;2571;8995;2736;8069;5307;17064
314400;201508;4540;13324;3840;12328;1356;4559;1430;4702;2786;9261
314410;201508;2600;8114;2160;7235;617;2390;694;2158;1311;4548
314420;201508;748;2149;586;1908;39;192;389;1193;428;1385
314430;201508;6547;19443;5658;17754;1658;5675;1678;5309;3336;10984
314435;201508;1307;4175;1147;3892;117;501;732;2443;849;2944
314437;201508;1142;2937;955;2654;45;131;746;2048;791;2179
314440;201508;657;1904;494;1661;156;581;86;253;242;834
314450;201508;1598;4648;1324;4242;335;1247;571;1692;906;2939
314460;201508;4273;14259;3438;12438;860;3486;651;2223;1511;5709
314465;201508;2272;7114;2087;6803;125;561;1609;5097;1734;5658
314467;201508;1062;2965;887;2651;91;254;621;1889;712;2143
314470;201508;2441;7669;1976;6661;412;1623;586;1737;998;3360
314480;201508;6037;19907;4032;14509;610;2416;448;1351;1058;3767
314490;201508;953;2787;742;2363;183;646;307;922;490;1568
314500;201508;2088;5830;1522;4837;396;1337;615;1907;1011;3244
314505;201508;1754;5198;1621;5004;259;882;1049;3247;1308;4129
314510;201508;1901;5146;1273;4259;412;1522;308;998;720;2520
314520;201508;3074;11001;2314;9126;528;2393;342;1107;870;3500
314530;201508;6230;22049;5892;21454;1126;4023;3490;13140;4616;17163
314535;201508;2730;7643;2329;7079;224;769;1779;5375;2003;6144
314537;201508;1174;3679;933;3240;143;599;531;1800;674;2399
314540;201508;416;1249;340;1085;77;279;107;303;184;582
314545;201508;1364;4177;1174;3896;183;703;779;2572;962;3275
314550;201508;625;1706;461;1479;77;323;194;563;271;886
314560;201508;4613;15787;3832;13844;750;3084;1125;3870;1875;6954
314570;201508;305;895;231;741;61;214;102;315;163;529
314580;201508;509;1701;398;1446;100;435;67;202;167;637
314585;201508;830;2706;589;2170;135;566;149;528;284;1094
314587;201508;1870;5824;1616;5363;366;1160;755;2603;1121;3763
314590;201508;3274;11020;2263;8283;388;1589;276;874;664;2463
314600;201508;1905;6187;1386;5099;374;1542;209;679;583;2221
314610;201508;6910;23400;6148;21618;1445;5732;2497;8218;3942;13950
314620;201508;1613;4776;1451;4547;181;556;1052;3331;1233;3887
314625;201508;1465;5015;1380;4865;189;804;973;3279;1162;4083
314630;201508;4861;14452;4239;13462;308;1189;3141;9902;3449;11091
314640;201508;576;1567;441;1329;109;357;124;308;233;665
314650;201508;1155;3198;802;2566;133;515;305;875;438;1390
314655;201508;1605;4750;1175;3894;288;928;425;1422;713;2350
314660;201508;265;717;198;587;22;77;101;281;123;358
314670;201508;1630;4372;1256;3746;216;718;713;2112;929;2830
314675;201508;1788;5479;1529;5018;149;581;1050;3419;1199;4000
314690;201508;2401;7574;1946;6742;531;2129;492;1578;1023;3707
314700;201508;8447;29327;6336;24460;1944;8422;1043;3859;2987;12281
314710;201508;8971;27154;6023;20571;1136;4342;908;2831;2044;7173
314720;201508;2359;7747;1964;6863;487;1906;699;2404;1186;4310
314730;201508;2276;6742;1817;6051;489;1788;611;1937;1100;3725
314740;201508;2913;9271;2522;8509;521;1999;1103;3543;1624;5542
314750;201508;340;1058;271;898;43;170;127;388;170;558
314760;201508;1748;5831;1298;4712;224;933;264;819;488;1752
314770;201508;1189;3729;671;2291;73;294;99;248;172;542
314780;201508;298;762;202;633;54;193;84;256;138;449
314790;201508;11955;34892;8681;29104;3558;13629;1135;3247;4693;16876
314795;201508;1656;4741;1394;4327;130;526;1018;3008;1148;3534
314800;201508;11672;33692;8220;26730;2354;8329;1228;3744;3582;12073
314810;201508;12354;35863;9486;30758;2748;9914;2048;6533;4796;16447
314820;201508;941;2536;625;2019;165;595;214;654;379;1249
314830;201508;1662;5516;1443;5132;453;1784;564;1992;1017;3776
314840;201508;968;3486;788;3205;162;793;445;1750;607;2543
314850;201508;1937;5660;1552;4948;228;907;952;2887;1180;3794
314860;201508;3215;10742;2862;10097;681;2614;1371;4833;2052;7447
314870;201508;5463;17315;4751;16359;546;2315;3383;11572;3929;13887
314875;201508;1722;5753;1634;5619;318;1057;1188;4187;1506;5244
314880;201508;855;2342;719;2167;45;134;530;1671;575;1805
314890;201508;604;1802;405;1366;86;355;140;410;226;765
314900;201508;493;1499;393;1340;97;349;183;612;280;961
314910;201508;1638;5384;1331;4868;405;1694;397;1340;802;3034
314915;201508;2487;7862;2186;7382;187;767;1572;5164;1759;5931
314920;201508;549;1515;385;1262;46;180;201;605;247;785
314930;201508;4571;15250;3917;13786;1048;4008;998;3384;2046;7392
314940;201508;404;1166;370;1107;68;224;196;543;264;767
314950;201508;339;1022;258;884;49;179;72;233;121;412
314960;201508;750;2326;575;1967;149;574;165;491;314;1065
314970;201508;547;1837;450;1654;98;422;123;432;221;854
314980;201508;1637;5067;1372;4594;409;1542;161;470;570;2012
314990;201508;2638;8259;1998;6864;566;2246;380;1090;946;3336
314995;201508;1584;4836;1382;4522;149;591;895;2837;1044;3428
315000;201508;1059;3095;870;2784;116;435;531;1678;647;2113
315010;201508;455;1412;355;1199;88;347;118;348;206;695
315015;201508;2032;6225;1811;5961;250;847;1316;4522;1566;5369
315020;201508;812;2537;610;2083;105;422;285;915;390;1337
315030;201508;726;2176;587;1917;176;622;137;429;313;1051
315040;201508;851;2650;797;2545;146;479;491;1549;637;2028
315050;201508;1431;4097;1138;3633;252;922;465;1446;717;2368
315053;201508;1077;3201;944;2969;159;622;426;1331;585;1953
315057;201508;1717;5909;1495;5561;280;1047;835;3205;1115;4252
315060;201508;858;2802;627;2291;153;616;144;522;297;1138
315070;201508;770;2301;668;2149;176;617;319;970;495;1587
315080;201508;2887;9778;2551;9048;595;2300;1205;4206;1800;6506
315090;201508;774;2768;677;2548;166;702;193;710;359;1412
315100;201508;1214;4075;877;3274;212;909;209;693;421;1602
315110;201508;1370;4227;1177;3831;275;972;480;1534;755;2506
315120;201508;14240;33224;9638;27266;1503;4453;4983;14870;6486;19323
315130;201508;1420;4651;1270;4354;355;1371;396;1291;751;2662
315140;201508;2635;8460;2173;7471;503;2009;725;2253;1228;4262
315150;201508;4884;13119;3597;10941;739;2551;1302;3807;2041;6358
315160;201508;1239;3520;1025;3101;197;646;496;1436;693;2082
315170;201508;1446;4270;1185;3862;219;753;546;1932;765;2685
315180;201508;17059;48091;9808;32433;1813;6827;1737;5149;3550;11976
315190;201508;2121;5524;1777;4994;488;1411;889;2507;1377;3918
315200;201508;3926;13092;3193;11460;954;3757;754;2549;1708;6306
315210;201508;7767;22687;6112;19292;1398;4905;2088;6267;3486;11172
315213;201508;1085;3470;1020;3379;63;230;835;2756;898;2986
315217;201508;2500;8529;2085;7794;292;1293;1193;4426;1485;5719
315220;201508;9967;28652;8271;25979;2433;7526;3505;11502;5938;19028
315230;201508;2784;7372;2467;6997;196;324;2037;6267;2233;6591
315240;201508;3012;9378;2615;8748;607;2248;1431;4641;2038;6889
315250;201508;9938;30120;7230;24854;1839;7022;2139;7290;3978;14312
315260;201508;968;3030;685;2392;163;627;122;377;285;1004
315270;201508;751;2398;571;2044;122;484;139;450;261;934
315280;201508;3088;8766;1972;6343;468;1650;412;1127;880;2777
315290;201508;1398;3896;1027;3292;337;1178;164;496;501;1674
315300;201508;541;1402;368;1187;171;581;123;394;294;975
315310;201508;1258;4039;1053;3651;134;572;667;2199;801;2771
315320;201508;790;2394;632;2184;117;462;303;1072;420;1534
315330;201508;692;2498;435;1799;110;502;47;208;157;710
315340;201508;3694;10574;3003;9487;657;2296;1215;3686;1872;5982
315350;201508;1784;4965;1314;4265;247;842;702;2332;949;3174
315360;201508;1670;5505;1332;4648;254;961;429;1383;683;2344
315370;201508;477;1416;405;1303;91;320;226;742;317;1062
315380;201508;200;691;157;588;41;177;32;96;73;273
315390;201508;1295;4383;985;3644;247;1043;189;621;436;1664
315400;201508;4328;13009;3523;11427;744;2681;1546;4896;2290;7577
315410;201508;2014;5339;1683;4868;219;757;1096;3151;1315;3908
315415;201508;1023;3370;931;3227;339;1195;425;1541;764;2736
315420;201508;1236;3917;920;3251;228;852;149;492;377;1344
315430;201508;3789;10279;2811;8612;718;2483;653;1886;1371;4369
315440;201508;893;2767;763;2543;132;503;360;1158;492;1661
315445;201508;2085;5809;1675;5204;188;673;1186;3632;1374;4305
315450;201508;2393;7620;2162;7262;462;1464;1257;4374;1719;5838
315460;201508;34323;111910;30025;102775;9868;36165;6158;19948;16026;56113
315470;201508;509;1514;413;1339;48;194;221;682;269;876
315480;201508;1750;5278;1081;3739;204;791;179;591;383;1382
315490;201508;3129;8413;2415;7422;353;1266;1051;3082;1404;4348
315500;201508;489;1471;316;1067;45;170;109;312;154;482
315510;201508;1427;4040;1203;3690;88;307;887;2675;975;2982
315520;201508;1109;3225;869;2887;114;427;548;1770;662;2197
315530;201508;556;1900;477;1711;189;725;130;429;319;1154
315540;201508;1087;3385;891;3002;171;694;317;1042;488;1736
315550;201508;1729;4856;1331;4296;405;1445;412;1272;817;2717
315560;201508;6504;21619;5862;20714;659;2622;4016;14266;4675;16888
315570;201508;2018;6325;1865;6068;343;1262;1012;3219;1355;4481
315580;201508;2546;7430;1960;6348;496;1849;542;1599;1038;3448
315590;201508;909;2647;802;2478;149;514;427;1281;576;1795
315600;201508;2480;8797;2016;7906;356;1475;1068;4328;1424;5803
315610;201508;993;2844;800;2445;158;620;302;767;460;1387
315620;201508;309;1090;292;1060;89;306;156;598;245;904
315630;201508;858;2716;718;2438;177;649;192;618;369;1267
315640;201508;565;1618;458;1438;95;356;209;600;304;956
315645;201508;868;2655;722;2346;264;931;175;538;439;1469
315650;201508;1885;5210;1528;4701;93;393;1140;3455;1233;3848
315660;201508;2554;6692;2135;6032;412;1182;1271;3568;1683;4750
315670;201508;10069;33446;8797;30941;2646;10023;2895;9958;5541;19981
315680;201508;2964;10011;2364;8758;845;3306;406;1492;1251;4798
315690;201508;3478;9849;2398;7880;616;2226;484;1605;1100;3831
315700;201508;7171;22365;6034;20073;1127;4219;2775;8807;3902;13026
315710;201508;1823;5339;1485;4791;140;561;946;2950;1086;3511
315720;201508;3474;10882;3060;10128;629;2439;1541;4837;2170;7276
315725;201508;1401;4517;1264;4308;348;1216;678;2353;1026;3569
315727;201508;618;1898;508;1669;114;414;202;623;316;1037
315730;201508;844;2578;762;2424;129;463;426;1321;555;1784
315733;201508;948;2876;843;2678;271;931;253;750;524;1681
315737;201508;1305;3950;996;3373;90;374;635;2179;725;2553
315740;201508;1015;3124;837;2762;155;625;420;1288;575;1913
315750;201508;1112;3463;1023;3300;78;289;740;2367;818;2656
315760;201508;1019;2766;976;2712;30;100;879;2426;909;2526
315765;201508;1385;4333;1253;4146;73;264;1025;3416;1098;3680
315770;201508;1562;4996;1349;4584;358;1366;398;1288;756;2654
315780;201508;21902;71221;19604;66142;5322;19219;5638;18729;10960;37948
315790;201508;3441;11556;3012;10670;325;1083;2005;7333;2330;8416
315800;201508;1512;5788;1189;4825;292;1342;212;803;504;2145
315810;201508;1381;3785;1178;3472;151;444;817;2387;968;2831
315820;201508;2597;8697;2273;8126;711;2644;967;3540;1678;6184
315830;201508;1198;4015;1016;3588;129;561;314;964;443;1525
315840;201508;836;2189;594;1765;95;314;180;501;275;815
315850;201508;1032;3702;995;3623;246;945;487;1731;733;2676
315860;201508;536;1834;398;1532;96;435;65;219;161;654
315870;201508;470;1386;387;1251;109;389;136;399;245;788
315880;201508;1189;3093;933;2761;207;736;328;893;535;1629
315890;201508;1515;5119;1313;4791;480;1863;542;1961;1022;3824
315895;201508;5088;15690;4490;14407;994;3528;1794;5473;2788;9001
315900;201508;737;2269;709;2216;86;356;530;1532;616;1888
315910;201508;529;1789;491;1723;160;613;267;909;427;1522
315920;201508;1555;4277;924;2937;202;703;183;465;385;1168
315930;201508;1096;2983;825;2503;211;715;209;593;420;1308
315935;201508;982;3231;880;3002;237;890;263;876;500;1766
315940;201508;645;2010;559;1835;139;541;247;756;386;1297
315950;201508;1151;3538;1040;3323;215;654;643;2104;858;2758
315960;201508;3110;9889;2209;8130;858;3619;97;224;955;3843
315970;201508;759;2052;577;1793;51;143;413;1350;464;1493
315980;201508;4079;9863;2464;7113;637;2120;599;1406;1236;3526
315990;201508;3950;11468;3327;10465;576;2182;1690;5133;2266;7315
316000;201508;537;1620;457;1513;149;590;171;544;320;1134
316010;201508;572;1928;465;1702;88;378;172;554;260;932
316020;201508;1120;3539;921;3214;143;577;537;1858;680;2435
316030;201508;3325;9663;2444;8085;283;1041;1379;4674;1662;5715
316040;201508;3737;11702;2730;9516;444;1780;454;1225;898;3005
316045;201508;2089;6502;1904;6193;293;925;1315;4410;1608;5335
316050;201508;345;1089;269;963;52;203;125;418;177;621
316060;201508;737;2171;582;1941;85;383;336;1040;421;1423
316070;201508;5916;18688;5073;16780;1170;4349;2052;6417;3222;10766
316080;201508;738;2681;646;2440;140;608;91;334;231;942
316090;201508;591;1747;385;1292;75;284;92;268;167;552
316095;201508;1430;4566;1229;4205;247;860;717;2480;964;3340
316100;201508;2791;9221;2051;7326;501;2038;376;1206;877;3244
316105;201508;966;2691;719;2282;190;651;270;858;460;1509
316110;201508;12192;41693;10837;39307;1387;5489;7130;26463;8517;31952
316120;201508;1125;3652;903;3085;224;829;258;779;482;1608
316130;201508;1463;3262;880;2426;131;409;424;1097;555;1506
316140;201508;952;2786;735;2420;96;317;416;1392;512;1709
316150;201508;1456;4109;1308;3846;241;818;742;2145;983;2963
316160;201508;1234;3670;951;3113;157;597;438;1407;595;2004
316165;201508;933;2510;778;2285;148;513;423;1215;571;1728
316170;201508;1385;3969;1032;3358;173;642;433;1294;606;1936
316180;201508;1350;4227;933;3291;213;844;174;507;387;1351
316190;201508;2804;8718;1409;4941;272;998;186;553;458;1551
316200;201508;3942;12538;3033;10720;699;2853;818;2755;1517;5608
316210;201508;4800;15183;4028;13645;1577;5658;651;2067;2228;7725
316220;201508;783;2420;549;1950;118;492;67;243;185;735
316225;201508;1173;3298;994;3002;135;474;645;1885;780;2359
316230;201508;447;1239;340;1055;57;198;171;560;228;758
316240;201508;6501;20020;5647;18869;622;2131;4117;13872;4739;16003
316245;201508;3165;10980;2929;10579;225;1091;2259;7939;2484;9030
316250;201508;9841;29175;7916;25280;2239;7778;2163;6522;4402;14300
316255;201508;2523;7704;2212;7311;421;1493;1401;4616;1822;6109
316257;201508;1342;3747;1018;3151;200;697;383;1111;583;1808
316260;201508;1766;5026;1367;4434;117;438;802;2718;919;3156
316265;201508;1319;3670;957;2945;107;413;552;1619;659;2032
316270;201508;4166;13826;3806;13074;978;3633;1613;5394;2591;9027
316280;201508;3272;10575;2930;9909;482;1842;1600;5334;2082;7176
316290;201508;3287;10265;2777;9272;548;2147;1150;3634;1698;5781
316292;201508;3333;10693;2972;10055;655;2474;1512;4872;2167;7346
316294;201508;886;2827;620;2230;127;538;53;178;180;716
316295;201508;1754;5941;1611;5657;257;1110;954;3172;1211;4282
316300;201508;1003;3094;843;2826;74;266;554;1877;628;2143
316310;201508;704;2022;462;1555;90;351;137;435;227;786
316320;201508;610;1943;483;1722;84;363;98;320;182;683
316330;201508;939;2875;726;2391;92;336;450;1441;542;1777
316340;201508;957;3071;785;2714;188;777;317;1005;505;1782
316350;201508;1315;4180;1174;3941;191;665;667;2291;858;2956
316360;201508;724;1897;567;1664;63;195;404;1189;467;1384
316370;201508;4354;14119;3722;12789;1026;3859;638;2170;1664;6029
316380;201508;1569;4212;1245;3755;101;335;876;2655;977;2990
316390;201508;896;2632;737;2360;194;685;301;977;495;1662
316400;201508;1256;3961;1001;3476;217;812;407;1367;624;2179
316410;201508;1064;3531;983;3405;211;775;594;2048;805;2823
316420;201508;1843;6114;1658;5860;159;709;1141;3905;1300;4614
316430;201508;928;2823;688;2337;171;633;173;517;344;1150
316440;201508;670;2186;551;1990;202;848;118;401;320;1249
316443;201508;698;2047;569;1803;133;472;211;623;344;1095
316447;201508;1592;4810;1443;4602;98;328;1241;3977;1339;4305
316450;201508;2120;7143;1812;6528;258;1033;1153;4192;1411;5225
316460;201508;731;2254;659;2125;159;570;367;1130;526;1700
316470;201508;7348;23630;5736;20126;1434;5853;1652;5477;3086;11330
316480;201508;194;656;169;603;41;158;55;186;96;344
316490;201508;288;890;248;790;52;175;103;301;155;476
316500;201508;1119;4014;758;2906;136;563;36;124;172;687
316510;201508;799;2923;705;2725;232;955;181;667;413;1622
316520;201508;1142;3431;934;3121;171;641;330;975;501;1616
316530;201508;1091;3501;905;3121;198;842;334;970;532;1812
316540;201508;887;2832;791;2675;162;667;297;921;459;1588
316550;201508;1160;3873;1078;3728;219;876;656;2238;875;3114
316553;201508;1831;6358;1428;5395;407;1686;329;1222;736;2908
316555;201508;2790;9636;2464;9233;188;789;1787;6736;1975;7525
316556;201508;607;1613;481;1397;53;189;319;865;372;1054
316557;201508;745;2706;708;2647;286;1131;152;521;438;1652
316560;201508;331;1143;281;1035;68;312;65;201;133;513
316570;201508;1266;4022;1094;3668;138;503;567;1901;705;2404
316580;201508;290;842;193;636;48;185;54;163;102;348
316590;201508;1492;4056;1064;3334;274;889;449;1313;723;2202
316600;201508;1022;3282;895;3025;280;1019;265;855;545;1874
316610;201508;572;2072;497;1918;99;439;298;1133;397;1572
316620;201508;2114;6517;1798;5926;331;1271;1017;3250;1348;4521
316630;201508;1457;4818;1240;4349;512;1902;329;1153;841;3055
316640;201508;182;575;158;524;34;145;67;184;101;329
316650;201508;895;3284;784;3103;142;574;461;1892;603;2466
316660;201508;201;524;98;300;12;50;27;64;39;114
316670;201508;1830;5281;1472;4630;575;1977;285;787;860;2764
316680;201508;1907;5154;1534;4619;228;720;1050;3157;1278;3877
316690;201508;1175;3919;1037;3612;297;1177;338;1132;635;2309
316695;201508;1082;3411;934;3121;98;360;593;1978;691;2338
316700;201508;345;1081;308;1013;47;196;179;537;226;733
316710;201508;3114;11638;2685;10681;935;3967;680;2845;1615;6812
316720;201508;15776;50486;12746;43822;3674;13496;2722;8977;6396;22473
316730;201508;363;1118;308;1004;72;267;145;429;217;696
316740;201508;665;2236;588;2094;175;722;228;759;403;1481
316750;201508;412;1381;348;1231;70;292;113;353;183;645
316760;201508;3350;11259;2890;10663;1593;5977;810;3106;2403;9083
316770;201508;1226;3509;1114;3362;129;477;828;2467;957;2944
316780;201508;575;1916;501;1768;140;563;110;337;250;900
316790;201508;860;2451;624;2039;154;561;202;650;356;1211
316800;201508;5289;17361;4692;16198;914;3598;2318;7542;3232;11140
316805;201508;828;2192;783;2134;76;205;660;1856;736;2061
316810;201508;612;1864;506;1646;145;517;198;606;343;1123
316820;201508;388;1009;226;726;46;172;39;110;85;282
316830;201508;595;2021;565;1962;162;620;235;786;397;1406
316840;201508;2891;8815;2524;8116;612;2258;1032;3121;1644;5379
316850;201508;2058;6116;1747;5559;266;961;956;3019;1222;3980
316860;201508;17523;55326;14959;50458;3494;13618;6346;20321;9840;33939
316870;201508;5820;18735;4670;16038;1400;5277;776;2522;2176;7799
316880;201508;791;2492;717;2364;199;760;256;788;455;1548
316890;201508;1285;3167;1021;2825;312;1011;529;1355;841;2366
316900;201508;2515;7599;1982;6457;465;1706;596;1724;1061;3430
316905;201508;454;1511;393;1377;127;475;132;453;259;928
316910;201508;778;2495;566;2061;164;632;106;390;270;1022
316920;201508;1501;4254;1156;3767;323;1188;400;1241;723;2429
316930;201508;8605;29044;6717;24712;1504;6146;960;3170;2464;9316
316935;201508;5066;14720;3256;10999;847;3229;572;1722;1419;4951
316940;201508;7014;22936;5675;19994;1336;5032;1223;4119;2559;9151
316950;201508;1464;4216;1268;3935;127;476;886;2710;1013;3186
316960;201508;4939;12414;3864;10978;716;2211;2134;5967;2850;8178
316970;201508;3238;10304;3038;9976;779;2942;1104;3334;1883;6276
316980;201508;1041;3141;752;2607;259;1009;157;534;416;1543
316990;201508;9533;30586;7933;26794;2548;9330;730;2307;3278;11637
317000;201508;2741;9387;2638;9271;245;810;2018;7901;2263;8711
317005;201508;2570;7897;2273;7451;447;1482;1309;4342;1756;5824
317010;201508;30761;76595;18484;56838;4618;15980;4013;12787;8631;28767
317020;201508;57761;161053;34338;112129;7369;26409;7212;21584;14581;47993
317030;201508;768;2199;629;1979;73;289;383;1164;456;1453
317040;201508;10201;29643;8145;25892;2136;7389;3086;9698;5222;17087
317043;201508;736;2056;637;1927;82;232;422;1306;504;1538
317047;201508;1143;3004;824;2471;124;413;390;1153;514;1566
317050;201508;1512;5160;1175;4336;237;965;474;1628;711;2593
317052;201508;2322;7462;2115;7140;183;725;1543;5138;1726;5863
317057;201508;1741;4838;1311;4075;136;514;740;2216;876;2730
317060;201508;405;1172;281;890;58;222;86;227;144;449
317065;201508;1220;4064;1114;3885;127;547;806;2733;933;3280
317070;201508;9676;29916;6384;22347;1380;5432;1017;3433;2397;8865
317075;201508;1073;3241;871;2825;221;777;255;756;476;1533
317080;201508;5964;16475;5044;14895;1477;4595;1639;4644;3116;9239
317090;201508;4871;16126;4511;15527;658;2258;3070;10781;3728;13039
317100;201508;2969;8280;2289;7110;716;2431;796;2340;1512;4771
317103;201508;2012;6931;1688;6266;282;1322;799;2848;1081;4170
317107;201508;1315;4009;1116;3592;193;741;675;2032;868;2773
317110;201508;662;1673;387;1184;75;283;152;447;227;730
317115;201508;1147;3621;979;3269;134;450;634;2148;768;2598
317120;201508;10961;35909;8786;30743;2149;8323;3115;10525;5264;18848
317130;201508;7511;22541;6320;20363;1326;4853;2790;8802;4116;13655
317140;201508;548;1821;525;1785;54;195;395;1374;449;1569
317150;201508;982;2739;850;2587;96;333;596;1774;692;2107
317160;201508;3470;9248;2648;8159;238;799;1823;5590;2061;6389
317170;201508;1810;5029;1482;4497;79;323;932;2650;1011;2973
317180;201508;1800;5969;1414;5120;386;1513;365;1259;751;2772
317190;201508;1387;3956;1113;3572;126;444;750;2370;876;2814
317200;201508;4406;13774;3783;12503;956;3482;1240;3911;2196;7393
317210;201508;1040;3124;853;2861;172;693;448;1473;620;2166
317220;201508;296;1026;280;997;87;342;122;416;209;758
320010;201508;5011;15820;4371;14412;798;2766;2259;7395;3057;10161
320013;201508;1920;5760;1369;4609;202;698;620;2146;822;2844
320016;201508;3172;8995;2749;8360;379;1115;1908;5832;2287;6947
320020;201508;3810;11821;3223;10606;947;3387;1101;3568;2048;6955
320030;201508;1641;5261;1303;4501;403;1471;417;1388;820;2859
320035;201508;1749;5186;1539;4861;435;1567;728;2137;1163;3704
320040;201508;3271;10639;2597;9097;611;2346;740;2487;1351;4833
320050;201508;1773;4783;1499;4280;333;1026;670;1789;1003;2815
320060;201508;12004;37828;9092;31081;2203;8258;2663;8520;4866;16778
320070;201508;1470;4726;1181;4039;272;1046;307;919;579;1965
320080;201508;5355;15204;4014;12487;1129;3707;1005;3079;2134;6786
320090;201508;8244;24002;6456;20362;1744;5885;2505;7527;4249;13412
320100;201508;2960;9018;2361;7794;595;2101;913;2900;1508;5001
320110;201508;1268;3759;1115;3461;259;833;398;1220;657;2053
320115;201508;1809;6414;1630;6070;842;3285;435;1632;1277;4917
320120;201508;16128;49227;12443;41910;3346;12321;3609;12086;6955;24407
320130;201508;36277;116236;32710;108854;7168;26622;15264;48874;22432;75496
320140;201508;4014;12612;2785;9725;668;2591;292;933;960;3524
320150;201508;16649;45737;11681;36116;2878;9667;1852;5424;4730;15091
320160;201508;4735;14991;4107;13637;1045;3947;1393;4169;2438;8116
320170;201508;1735;5548;1399;4786;387;1409;511;1740;898;3149
320180;201508;802;2620;693;2432;279;1025;187;666;466;1691
320190;201508;3778;12851;2950;10762;857;3337;674;2322;1531;5659
320200;201508;1075;3322;900;3006;232;834;344;1175;576;2009
320210;201508;4872;13543;4144;12155;892;2966;2017;5514;2909;8480
320220;201508;2578;7949;2085;6973;549;1998;801;2703;1350;4701
320225;201508;1425;4849;1121;4096;375;1476;216;797;591;2273
320230;201508;4218;13704;3661;12737;1199;4496;1264;4423;2463;8919
320240;201508;12074;35599;9335;30456;2575;9151;2392;7654;4967;16805
320245;201508;3675;12471;3378;11742;1130;4213;996;3285;2126;7498
320250;201508;1809;5485;1271;4238;344;1327;247;687;591;2014
320255;201508;1805;6042;1552;5602;621;2450;563;2085;1184;4535
320260;201508;1047;3227;782;2584;205;740;193;527;398;1267
320265;201508;2386;7438;2080;7018;374;1299;1328;4612;1702;5911
320270;201508;2721;8120;2014;6702;482;1756;810;2654;1292;4410
320280;201508;6794;20506;5955;18839;1356;4728;2555;7679;3911;12407
320290;201508;1473;4808;1070;3773;358;1330;195;648;553;1978
320300;201508;4296;14248;3794;13128;1175;4319;950;3228;2125;7547
320305;201508;4465;14338;3874;12979;931;3430;1686;5382;2617;8812
320310;201508;1977;5875;1675;5271;436;1453;669;2026;1105;3479
320313;201508;2238;6544;1511;4858;370;1406;276;750;646;2156
320316;201508;1745;5261;1423;4592;451;1533;538;1656;989;3189
320320;201508;19795;61122;15933;53697;4432;16458;5381;17546;9813;34004
320330;201508;3062;9052;2610;8287;629;1960;1302;4350;1931;6310
320332;201508;4888;16291;4241;15029;1504;5661;1313;4685;2817;10346
320334;201508;1886;6067;1320;4780;396;1602;228;759;624;2361
320335;201508;2334;6867;1475;4895;390;1451;214;582;604;2033
320340;201508;5893;15982;4750;14028;1068;3419;2033;6025;3101;9444
320350;201508;5121;13701;3813;11283;876;2791;1462;4229;2338;7020
320360;201508;1753;4608;1269;3648;231;726;529;1385;760;2111
320370;201508;3219;10399;2595;8999;754;2696;859;2930;1613;5626
320380;201508;2378;6949;2084;6417;325;1143;1297;3888;1622;5031
320390;201508;7707;22988;6122;19607;1766;6196;1632;4855;3398;11051
320400;201508;3702;11164;3242;10361;980;3511;1193;3488;2173;6999
320405;201508;3972;11628;3490;10883;902;3027;1710;5123;2612;8150
320410;201508;5564;14448;4062;12497;995;3327;1873;5680;2868;9007
320420;201508;1866;5711;1381;4825;412;1581;276;954;688;2535
320425;201508;1942;5209;1658;4733;227;704;1009;2801;1236;3505
320430;201508;2306;6527;2008;5931;424;1345;1074;3064;1498;4409
320435;201508;2781;9182;2319;8219;1062;3916;641;2409;1703;6325
320440;201508;1147;3788;1000;3391;249;960;357;1117;606;2077
320450;201508;2032;6331;1650;5537;469;1755;693;2214;1162;3969
320455;201508;4235;14012;3042;11031;886;3439;755;2678;1641;6117
320460;201508;2783;8925;2180;7556;567;2155;685;2226;1252;4381
320465;201508;1611;5013;1223;4116;252;925;503;1626;755;2551
320470;201508;4404;13247;2915;9812;809;2992;478;1440;1287;4432
320480;201508;1944;5860;1655;5313;415;1484;608;1855;1023;3339
320490;201508;15681;48371;12887;42933;4021;14645;3640;12020;7661;26665
320495;201508;1241;3764;877;2946;321;1118;111;400;432;1518
320500;201508;45907;138916;39462;126891;10043;35095;18126;56772;28169;91867
320501;201508;4130;12928;3552;12026;1103;4252;1356;4331;2459;8583
320503;201508;1916;6436;1538;5604;588;2345;405;1268;993;3613
320506;201508;3836;11968;2598;8881;830;3014;204;613;1034;3627
320510;201508;8063;25194;6831;22694;1755;6291;2980;9672;4735;15963
320515;201508;1973;5602;1606;4820;431;1337;397;1114;828;2451
320517;201508;2161;6943;1726;6034;618;2386;363;1146;981;3532
320520;201508;36015;108440;28927;94814;7919;28579;10448;33702;18367;62281
320530;201508;27065;81945;22259;72404;4819;18170;10389;31434;15208;49604
330010;201508;19751;60216;17706;56177;3413;11919;10032;30971;13445;42890
330015;201508;1701;4685;1457;4231;252;869;621;1723;873;2592
330020;201508;16920;49797;15358;47233;3102;10503;8859;26597;11961;37100
330022;201508;1772;5379;1514;4942;275;1066;798;2483;1073;3549
330023;201508;3241;10044;2852;9344;786;2821;978;3021;1764;5842
330025;201508;4199;11396;3358;10035;789;2585;1751;5118;2540;7703
330030;201508;7812;26104;6833;24069;1525;5937;3190;10746;4715;16683
330040;201508;11957;34676;10264;31600;2355;7763;5034;14981;7389;22744
330045;201508;66886;186308;58692;174151;7589;24266;39959;116684;47548;140950
330050;201508;2567;7964;2250;7322;662;2402;673;1992;1335;4394
330060;201508;5694;16531;4939;15397;1158;4071;2508;7744;3666;11815
330070;201508;22767;68556;20035;63693;4514;15473;9247;29192;13761;44665
330080;201508;7847;22414;7328;21610;950;2762;5120;15332;6070;18094
330090;201508;2659;7279;2406;6850;468;1501;1312;3622;1780;5123
330093;201508;2027;6002;1663;5301;401;1328;602;1944;1003;3272
330095;201508;1019;3453;888;3152;253;1033;191;612;444;1645
330100;201508;54217;173172;49057;164199;8878;33345;25900;86468;34778;119813
330110;201508;2342;7432;2082;6946;532;1907;651;2123;1183;4030
330115;201508;2024;5823;1790;5444;342;1167;938;2767;1280;3934
330120;201508;2466;6936;2166;6486;543;1812;1085;3090;1628;4902
330130;201508;3518;11275;3078;10463;811;3041;1383;4560;2194;7601
330140;201508;2927;9146;2651;8723;629;2237;1307;4317;1936;6554
330150;201508;2387;6982;1803;5789;408;1450;433;1342;841;2792
330160;201508;1077;3570;976;3388;287;1120;423;1392;710;2512
330170;201508;101642;304574;92913;290486;15268;50993;58644;182069;73912;233062
330180;201508;1981;5840;1651;5206;161;650;1017;3015;1178;3665
330185;201508;7697;24193;6722;22258;1527;5505;3501;11355;5028;16860
330187;201508;3856;11014;3291;10047;471;1617;2195;6604;2666;8221
330190;201508;25588;73008;23683;69911;4583;14290;15194;44479;19777;58769
330200;201508;13644;43328;12112;40499;3005;10390;5883;19872;8888;30262
330205;201508;2243;6071;1932;5540;372;1202;1046;2887;1418;4089
330210;201508;4231;11257;3165;9260;882;2738;719;2065;1601;4803
330220;201508;10042;30562;8721;27725;2360;8152;2416;7058;4776;15210
330225;201508;3948;12117;3583;11500;454;1725;2323;7423;2777;9148
330227;201508;17581;50369;15671;47484;4096;12807;7974;24400;12070;37207
330230;201508;1395;4160;1258;3921;310;1093;533;1554;843;2647
330240;201508;16374;51051;14106;46385;4900;17457;3044;9435;7944;26892
330245;201508;1259;3916;991;3375;254;952;189;606;443;1558
330250;201508;35700;104064;32321;98285;9745;29995;13385;41572;23130;71567
330260;201508;3630;11358;3139;10323;636;2320;1340;4140;1976;6460
330270;201508;15053;39350;11298;33871;3031;9888;4135;12250;7166;22138
330280;201508;2107;6328;1737;5578;311;1104;777;2288;1088;3392
330285;201508;18195;52269;16375;49573;2803;9173;10243;30766;13046;39939
330290;201508;3540;9844;3101;9189;516;1756;1850;5227;2366;6983
330300;201508;3337;10790;3051;10272;439;1728;1848;6061;2287;7789
330310;201508;2352;6705;2030;6154;355;1150;1086;3214;1441;4364
330320;201508;13066;38995;12168;37610;1839;6258;8720;26659;10559;32917
330330;201508;27029;75517;23937;70542;4087;13675;14947;42477;19034;56152
330340;201508;14288;41901;11028;35626;2968;10163;3249;10357;6217;20520
330350;201508;84448;255370;78823;246888;11559;37718;56336;176731;67895;214449
330360;201508;5598;16895;5401;16609;358;1230;4541;13877;4899;15107
330370;201508;3412;12114;3081;11367;1074;4138;1007;3717;2081;7855
330380;201508;4886;15702;4111;14179;926;3531;1752;5826;2678;9357
330385;201508;4083;14034;3714;13287;1167;4477;1369;4827;2536;9304
330390;201508;22893;74947;20183;69339;4840;18243;9081;30367;13921;48610
330395;201508;2988;8798;2691;8282;282;1029;1811;5414;2093;6443
330400;201508;2463;7850;2199;7374;338;1361;1261;3912;1599;5273
330410;201508;2796;8660;2327;7744;471;1691;1107;3622;1578;5313
330411;201508;2312;7183;1985;6477;246;983;1141;3524;1387;4507
330412;201508;1319;4476;1074;3974;247;1072;414;1411;661;2483
330414;201508;24696;69423;21416;64769;4007;12291;13145;39974;17152;52265
330415;201508;3553;10820;3048;9888;785;2638;1192;3868;1977;6506
330420;201508;9330;27321;6238;21259;1513;5577;1082;3561;2595;9138
330430;201508;7545;22264;6685;20629;1418;4748;3219;9662;4637;14410
330440;201508;1784;5927;1495;5277;463;1821;298;897;761;2718
330450;201508;1405;4649;1256;4380;286;1181;632;2118;918;3299
330452;201508;13225;38939;10272;33056;2699;9523;3642;11163;6341;20686
330455;201508;477980;1333791;394748;1199805;95540;308101;190544;572505;286084;880606
330460;201508;1214;3936;1083;3694;232;908;516;1709;748;2617
330470;201508;4301;13109;3798;12165;968;3405;1647;5105;2615;8510
330475;201508;7806;24269;6869;22617;1947;7033;2653;8505;4600;15538
330480;201508;5809;17180;5293;16404;1136;3820;2845;8646;3981;12466
330490;201508;105868;282245;95303;266673;9465;27349;72446;203508;81911;230857
330500;201508;5454;16903;5180;16383;606;2140;3678;11490;4284;13630
330510;201508;37650;115825;33851;109591;10207;33531;15608;51373;25815;84904
330513;201508;1510;4516;1358;4235;417;1300;502;1592;919;2892
330515;201508;2996;9271;2630;8572;802;2671;841;2695;1643;5366
330520;201508;11545;34275;10193;31844;2184;7248;5011;15431;7195;22679
330530;201508;1514;4525;1327;4160;342;1138;523;1593;865;2731
330540;201508;3038;8957;2543;8086;615;2137;1081;3309;1696;5446
330550;201508;7972;26641;6966;24681;3042;11251;1222;4296;4264;15547
330555;201508;10314;30454;9113;28687;1736;5567;5571;17908;7307;23475
330560;201508;4155;12572;3778;11869;782;2733;1921;5810;2703;8543
330570;201508;3616;10481;3074;9561;813;2645;1483;4619;2296;7264
330575;201508;5165;14951;4604;13954;782;2659;2875;8356;3657;11015
330580;201508;14515;45540;12263;40833;3267;11486;4863;16215;8130;27701
330590;201508;1647;5011;1522;4793;312;1061;911;2813;1223;3874
330600;201508;10723;30466;8463;26738;1209;4374;4577;14066;5786;18440
330610;201508;8902;27984;8081;26450;1509;5641;4480;14297;5989;19938
330615;201508;1666;5837;1494;5441;651;2510;332;1231;983;3741
330620;201508;3599;12368;3210;11628;1103;4361;813;2974;1916;7335
330630;201508;22033;65339;17951;57893;3435;12608;9285;28603;12720;41211
350010;201508;2027;5990;1369;4626;330;1231;240;687;570;1918
350020;201508;466;1210;314;917;55;177;169;474;224;651
350030;201508;4365;13589;3389;11549;1207;4515;722;2218;1929;6733
350040;201508;482;1642;370;1377;90;382;92;287;182;669
350050;201508;1048;3134;821;2716;194;747;283;839;477;1586
350055;201508;646;1909;564;1769;134;455;301;904;435;1359
350060;201508;94;295;78;266;24;94;33;103;57;197
350070;201508;3345;10331;2196;7743;475;1829;388;1198;863;3027
350075;201508;525;1744;415;1545;121;488;97;328;218;816
350080;201508;540;1499;375;1178;68;236;150;456;218;692
350090;201508;555;1468;376;1158;75;252;127;368;202;620
350100;201508;1812;5684;1280;4529;286;1114;352;1152;638;2266
350110;201508;458;1345;341;1080;51;189;167;500;218;689
350115;201508;1268;3891;1114;3548;228;868;567;1617;795;2485
350120;201508;571;1491;281;865;54;181;46;132;100;313
350130;201508;3211;9416;2839;8696;486;1687;1488;4260;1974;5947
350140;201508;580;1866;500;1722;91;356;226;743;317;1099
350150;201508;378;1278;335;1184;122;456;85;295;207;751
350160;201508;6800;20719;4950;16724;1297;4913;1896;5809;3193;10722
350170;201508;1723;5906;1475;5286;405;1584;352;1168;757;2752
350180;201508;1109;3007;760;2257;160;489;335;957;495;1446
350190;201508;3094;9605;2540;8484;533;2139;1270;3815;1803;5954
350200;201508;332;1064;280;968;47;178;127;446;174;624
350210;201508;5147;13609;3806;11382;1068;3568;1525;4326;2593;7894
350220;201508;2473;7736;2188;7212;570;2210;795;2351;1365;4561
350230;201508;614;2034;560;1937;130;504;243;824;373;1328
350240;201508;394;1243;350;1143;77;258;203;647;280;905
350250;201508;2105;7632;1976;7370;717;2867;689;2510;1406;5377
350260;201508;937;2482;661;1998;121;397;297;859;418;1256
350270;201508;5040;15339;4205;13488;804;2761;1785;5494;2589;8255
350275;201508;1953;6501;1744;6121;475;1793;637;2106;1112;3899
350280;201508;21465;53253;12963;38320;2848;8954;2720;7890;5568;16844
350290;201508;1651;5367;1278;4577;291;1161;311;1026;602;2187
350300;201508;350;1046;306;970;51;164;184;579;235;743
350310;201508;867;2847;748;2561;118;453;345;1138;463;1591
350315;201508;526;1646;411;1397;68;281;120;375;188;656
350320;201508;11345;35150;9749;31981;2699;9475;1479;4913;4178;14388
350330;201508;13381;38005;8715;27078;1843;5736;2841;8374;4684;14110
350335;201508;360;1121;314;1028;40;131;186;612;226;743
350340;201508;1112;3302;768;2601;154;600;244;766;398;1366
350350;201508;728;2263;618;2071;115;464;238;763;353;1227
350360;201508;779;2640;653;2365;180;681;237;878;417;1559
350370;201508;691;2056;491;1615;90;330;96;275;186;605
350380;201508;3291;10177;2523;8833;843;3248;603;1899;1446;5147
350390;201508;8505;26687;7537;24848;2213;7635;2963;9540;5176;17175
350395;201508;333;931;172;592;28;111;35;115;63;226
350400;201508;7826;22170;6185;19156;1436;4996;2465;7211;3901;12207
350410;201508;7715;25997;5920;22073;1649;6834;1063;3671;2712;10505
350420;201508;546;1583;374;1275;72;296;36;94;108;390
350430;201508;728;2260;591;2003;117;458;285;917;402;1375
350440;201508;1220;3806;1102;3570;285;945;519;1649;804;2594
350450;201508;7558;22467;5741;18794;1398;4922;1393;4253;2791;9175
350460;201508;1327;3708;867;2733;180;639;270;754;450;1393
350470;201508;241;658;193;576;40;144;107;291;147;435
350480;201508;796;2424;535;1837;75;293;81;224;156;517
350490;201508;1741;5198;1487;4820;375;1388;604;1806;979;3194
350500;201508;568;1662;485;1521;105;354;223;685;328;1039
350510;201508;1012;3072;783;2561;139;537;316;943;455;1480
350520;201508;1077;3933;855;3421;228;1007;159;573;387;1580
350530;201508;2385;6989;1936;6059;560;1870;552;1562;1112;3432
350535;201508;1330;4128;1233;3934;123;502;887;2689;1010;3191
350540;201508;1918;5329;1508;4581;406;1312;510;1519;916;2831
350550;201508;11585;30740;7775;24303;1638;5770;2777;8248;4415;14018
350560;201508;3360;11002;3010;10259;461;1698;1592;5466;2053;7164
350570;201508;17992;60240;16053;55908;4742;17767;5885;19518;10627;37285
350580;201508;1646;5087;1155;3955;245;924;157;446;402;1370
350590;201508;4071;12568;3031;10404;795;3054;975;3008;1770;6062
350600;201508;39840;97689;26092;74366;4193;13026;12444;33580;16637;46606
350610;201508;7629;21807;5815;18585;1152;4152;2591;7952;3743;12104
350620;201508;394;1104;298;955;61;234;138;408;199;642
350630;201508;1574;4672;1207;3981;282;1096;315;902;597;1998
350635;201508;5742;17191;4337;14592;1063;3850;1645;5437;2708;9287
350640;201508;717;2232;485;1649;86;324;119;368;205;692
350650;201508;7117;21668;3950;13860;972;3761;394;1296;1366;5057
350660;201508;4169;12569;3573;11560;752;2658;1917;6087;2669;8745
350670;201508;1708;5254;1576;4994;303;1029;953;2920;1256;3949
350680;201508;1115;3386;861;2861;196;758;360;1156;556;1914
350690;201508;861;2793;690;2445;165;661;218;697;383;1358
350700;201508;3953;11917;2631;9327;810;3070;643;2001;1453;5071
350710;201508;2456;7693;2186;7241;328;1191;1373;4489;1701;5680
350715;201508;854;2605;748;2409;234;837;246;689;480;1526
350720;201508;136;397;122;374;38;123;44;127;82;250
350730;201508;391;1464;369;1405;104;447;138;500;242;947
350740;201508;1907;5903;1476;4869;271;970;565;1722;836;2692
350745;201508;362;1118;269;894;45;168;121;357;166;525
350750;201508;10001;29947;7602;25083;1820;6622;1688;5076;3508;11698
350760;201508;12715;37469;10211;32877;2559;9167;3684;11000;6243;20167
350770;201508;729;2067;480;1563;69;259;221;687;290;946
350775;201508;534;1458;443;1314;65;233;263;753;328;986
350780;201508;1986;6018;1475;4952;436;1632;196;609;632;2241
350790;201508;1978;6159;1468;5118;384;1451;332;1019;716;2470
350800;201508;2988;9884;2805;9577;470;1857;1760;5865;2230;7722
350810;201508;1999;5607;1631;5054;485;1632;600;1823;1085;3455
350820;201508;557;1497;401;1186;70;251;174;460;244;711
350830;201508;871;2689;588;2021;88;327;143;391;231;718
350840;201508;2445;8577;1981;7411;576;2361;346;1074;922;3435
350850;201508;6101;20177;5010;17719;1595;5966;1130;3871;2725;9837
350860;201508;3100;9677;2958;9459;252;1016;2314;7290;2566;8306
350870;201508;2568;8214;2167;7588;570;2257;1226;4281;1796;6538
350880;201508;1285;4201;1052;3704;256;981;244;818;500;1799
350890;201508;650;1839;427;1362;72;274;99;240;171;514
350900;201508;3800;12413;2885;10283;741;2920;417;1318;1158;4238
350910;201508;816;2420;712;2213;244;796;248;726;492;1522
350920;201508;9740;28084;8732;26274;1208;4038;5824;16885;7032;20923
350925;201508;4736;14442;3907;12732;982;3424;1515;4506;2497;7930
350930;201508;1586;4302;1275;3750;140;460;838;2380;978;2840
350940;201508;1915;6276;1746;6016;323;1322;1083;3615;1406;4937
350945;201508;844;2738;724;2488;129;528;375;1219;504;1747
350950;201508;66256;201690;52852;173737;12774;46052;21278;66570;34052;112622
350960;201508;4225;14073;3551;12642;610;2491;2011;6858;2621;9349
350970;201508;4295;14781;3593;13089;1148;4535;825;2654;1973;7189
350980;201508;588;1920;527;1815;220;809;181;618;401;1427
350990;201508;1714;5824;1453;5305;451;1767;386;1352;837;3119
350995;201508;771;2652;735;2577;114;518;457;1512;571;2030
351000;201508;3216;9526;2655;8453;356;1286;1350;4064;1706;5350
351010;201508;352;1000;223;722;58;210;75;241;133;451
351015;201508;855;2830;730;2590;183;733;309;1043;492;1776
351020;201508;7811;24588;6785;22964;1695;6081;3096;10541;4791;16622
351030;201508;1585;5660;1417;5247;329;1422;468;1596;797;3018
351040;201508;3267;9910;2968;9387;491;1808;1883;5692;2374;7500
351050;201508;12305;36252;8791;29653;2377;8791;2502;8231;4879;17022
351060;201508;32299;95863;26184;84392;6060;21385;11189;34954;17249;56339
351070;201508;1576;4367;1056;3409;305;1086;150;391;455;1477
351080;201508;2586;7458;1969;6683;492;1855;875;2823;1367;4678
351090;201508;384;1284;287;1067;60;254;58;204;118;458
351100;201508;1960;5985;1567;5198;479;1646;515;1766;994;3412
351110;201508;7701;19221;4088;13042;931;3356;936;2688;1867;6044
351120;201508;610;1747;489;1503;60;219;252;676;312;895
351130;201508;1015;2836;545;1862;91;356;100;314;191;670
351140;201508;1604;5528;1419;5111;434;1709;388;1301;822;3010
351150;201508;1702;5838;1254;4652;224;913;279;884;503;1797
351160;201508;1300;4393;1136;4010;297;1191;394;1282;691;2473
351170;201508;1457;4614;1157;3950;236;880;508;1632;744;2512
351190;201508;722;2290;574;1911;111;377;129;399;240;776
351200;201508;2112;6189;1736;5424;348;1233;620;1734;968;2967
351210;201508;1007;3010;764;2506;173;640;264;768;437;1408
351220;201508;3252;10824;2868;10030;585;2258;1352;4642;1937;6900
351230;201508;1735;5398;1465;4907;298;1204;785;2503;1083;3707
351240;201508;1077;3430;786;2760;202;770;178;531;380;1301
351250;201508;884;2513;609;1950;130;451;221;662;351;1113
351260;201508;880;2550;758;2294;173;565;328;926;501;1491
351270;201508;355;1217;319;1144;70;295;143;465;213;760
351280;201508;5086;14887;3743;11994;839;2881;1312;3892;2151;6773
351290;201508;988;2783;732;2283;166;534;297;888;463;1422
351300;201508;12088;39811;8979;32923;2289;9293;2782;9894;5071;19187
351310;201508;3172;9602;2537;8427;485;1897;1195;3625;1680;5522
351320;201508;884;2950;753;2648;173;708;219;658;392;1366
351330;201508;290;807;242;726;98;300;61;171;159;471
351340;201508;5688;18924;4886;17281;1379;5177;1906;6695;3285;11872
351350;201508;7181;23117;6149;20892;1809;6449;1943;6178;3752;12627
351360;201508;4090;12692;3722;11964;929;3300;1390;4155;2319;7455
351370;201508;2226;6816;1741;5802;390;1457;644;1962;1034;3419
351380;201508;35736;105504;32214;98736;6327;21155;14760;43761;21087;64916
351385;201508;184;569;171;544;42;141;85;253;127;394
351390;201508;1117;3613;934;3235;252;994;356;1089;608;2083
351400;201508;868;2892;818;2768;325;1161;264;878;589;2039
351410;201508;2659;7949;2318;7322;393;1321;1331;4077;1724;5398
351420;201508;354;1001;228;751;47;161;61;191;108;352
351430;201508;841;2594;765;2466;80;263;547;1764;627;2027
351440;201508;3680;10752;2794;8793;686;2237;539;1472;1225;3709
351450;201508;1647;4583;1364;4163;346;1093;591;1888;937;2981
351460;201508;717;2141;598;1940;293;989;170;520;463;1509
351470;201508;1032;3050;891;2775;219;775;355;1043;574;1818
351480;201508;2755;8938;2502;8511;450;1879;1337;4325;1787;6204
351490;201508;1761;5803;1549;5344;209;873;912;2983;1121;3856
351492;201508;198;621;151;512;20;83;81;262;101;345
351495;201508;139;458;112;390;27;111;38;118;65;229
351500;201508;22255;64480;17171;54742;4487;15836;6720;20339;11207;36175
351510;201508;8266;25831;6788;22811;1599;5830;3267;10756;4866;16586
351512;201508;412;1186;329;1021;50;158;195;618;245;776
351515;201508;2206;6878;1550;5401;391;1457;407;1275;798;2732
351518;201508;2001;6314;1369;5101;341;1456;376;1259;717;2715
351519;201508;777;2270;592;1871;114;445;205;497;319;942
351520;201508;819;2258;417;1470;63;256;60;197;123;453
351530;201508;379;1160;266;884;40;136;76;221;116;357
351535;201508;2310;5939;1777;5145;189;644;1128;3134;1317;3778
351540;201508;1732;5203;1401;4584;455;1640;224;674;679;2314
351550;201508;4746;13821;3366;10984;760;2821;1163;3612;1923;6433
351560;201508;358;1127;296;992;61;237;56;173;117;410
351565;201508;180;589;163;542;34;132;77;239;111;371
351570;201508;11139;34243;9445;30775;2172;7642;4926;15588;7098;23230
351580;201508;337;879;214;622;54;156;58;151;112;307
351590;201508;395;1054;296;866;32;94;118;329;150;423
351600;201508;1639;4486;1431;4169;232;760;727;2009;959;2769
351610;201508;658;1803;503;1535;58;213;238;665;296;878
351620;201508;18529;58999;13877;49300;3082;12280;3295;10198;6377;22478
351630;201508;17998;57395;16178;54295;3689;13163;8957;29759;12646;42922
351640;201508;10343;32048;8570;28835;1733;6425;4602;15131;6335;21556
351650;201508;435;1310;208;718;38;145;33;99;71;244
351660;201508;748;2348;538;1816;124;445;123;362;247;807
351670;201508;3887;11979;3155;10387;566;2140;1479;4556;2045;6696
351680;201508;643;1942;389;1321;70;246;84;271;154;517
351685;201508;418;1221;338;1088;87;280;151;495;238;775
351690;201508;1023;2998;703;2265;135;485;193;519;328;1004
351700;201508;1189;3426;1020;3106;261;792;414;1229;675;2021
351710;201508;630;2033;512;1777;96;345;191;610;287;955
351720;201508;1616;4873;1089;3554;218;763;338;988;556;1751
351730;201508;1021;2901;819;2620;277;1020;289;875;566;1895
351740;201508;4011;10919;3138;9161;664;2068;1073;2972;1737;5040
351750;201508;1169;3676;817;2846;191;757;253;786;444;1543
351760;201508;3639;11320;3007;9921;811;2877;1055;3222;1866;6099
351770;201508;2288;7116;1905;6441;545;1941;810;2606;1355;4547
351780;201508;1537;4279;886;2811;160;556;225;658;385;1214
351790;201508;982;2840;849;2636;255;797;384;1228;639;2025
351800;201508;408;897;294;743;38;101;160;406;198;507
351810;201508;983;2774;891;2657;139;431;651;1955;790;2386
351820;201508;2157;6829;1675;5867;466;1711;167;548;633;2259
351830;201508;3906;12235;3044;10230;543;2067;1497;4745;2040;6812
351840;201508;7053;23271;6018;21209;1631;6218;2143;7328;3774;13546
351850;201508;1737;4929;1271;4072;202;816;578;1626;780;2442
351860;201508;3368;10679;2919;9721;792;2851;1196;3745;1988;6596
351870;201508;29326;87706;24879;79437;6555;22287;11603;36379;18158;58666
351880;201508;106213;336312;90661;303292;26593;94183;27633;89035;54226;183218
351885;201508;529;1883;490;1797;132;501;219;785;351;1286
351890;201508;663;1967;497;1612;113;418;118;336;231;754
351900;201508;1261;3821;1069;3505;290;1020;334;1065;624;2085
351905;201508;448;1421;366;1270;60;254;193;612;253;866
351907;201508;16508;48972;13606;43554;1974;7454;7986;24563;9960;32017
351910;201508;914;2790;804;2598;167;614;396;1213;563;1827
351920;201508;1016;2776;888;2573;118;404;571;1601;689;2005
351925;201508;908;2786;769;2510;126;452;392;1187;518;1639
351930;201508;2600;8433;2446;8125;509;2085;1567;4821;2076;6906
351940;201508;928;2766;776;2458;163;553;373;1143;536;1696
351950;201508;1407;3860;1006;3108;139;458;527;1582;666;2040
351960;201508;3905;11149;2725;8959;592;2116;1108;3563;1700;5679
351970;201508;5239;18853;4607;17553;1388;5672;1596;5927;2984;11599
351980;201508;881;2622;670;2188;145;531;250;708;395;1239
351990;201508;1520;4280;1198;3657;271;970;257;643;528;1613
352000;201508;2169;6943;1940;6461;413;1481;910;2845;1323;4326
352010;201508;1749;5819;1509;5269;379;1456;354;1175;733;2631
352020;201508;1388;4339;1179;3939;279;1038;441;1372;720;2410
352030;201508;4811;14058;3972;12800;954;3145;2043;6653;2997;9798
352040;201508;1953;6453;1597;5645;351;1365;380;1229;731;2594
352042;201508;3045;8475;1988;6153;417;1434;928;2748;1345;4182
352044;201508;1283;4274;956;3503;191;752;149;494;340;1246
352050;201508;8529;26149;5461;19172;1336;5193;1003;3131;2339;8324
352060;201508;699;2005;592;1824;132;498;259;706;391;1204
352070;201508;765;1995;598;1703;158;465;219;617;377;1082
352080;201508;419;1187;299;950;55;194;123;354;178;548
352090;201508;1626;5281;1265;4450;262;1023;257;791;519;1814
352100;201508;2448;7410;1759;6074;465;1801;552;1709;1017;3510
352110;201508;480;1680;408;1517;112;456;157;547;269;1003
352115;201508;422;1327;358;1188;74;265;147;446;221;711
352120;201508;937;2858;784;2595;160;614;390;1226;550;1840
352130;201508;1836;5238;1236;4012;343;1176;333;976;676;2152
352140;201508;1583;4729;995;3387;160;568;394;1298;554;1866
352150;201508;719;2189;550;1847;139;482;235;776;374;1258
352160;201508;1012;2793;814;2415;162;528;292;759;454;1287
352170;201508;2650;7943;2359;7357;488;1658;1228;3584;1716;5242
352180;201508;3332;9459;2776;8373;683;2247;999;2854;1682;5101
352190;201508;1092;3281;929;2939;176;673;357;947;533;1620
352200;201508;362;1258;296;1124;48;207;148;548;196;755
352210;201508;16925;44902;13314;39605;2478;7731;7617;22980;10095;30711
352215;201508;533;1669;491;1612;67;251;292;935;359;1186
352220;201508;11883;38567;10316;35304;3290;12142;3144;10494;6434;22636
352230;201508;12272;41027;10487;37586;3002;11749;3850;13347;6852;25096
352240;201508;11596;33788;8787;28654;2617;9570;2680;7939;5297;17509
352250;201508;22613;72444;19580;66107;5567;20187;6592;21875;12159;42062
352260;201508;5239;14806;3209;10560;626;2331;1108;3353;1734;5684
352265;201508;856;2729;729;2494;77;340;433;1384;510;1724
352270;201508;1877;6333;1549;5606;440;1690;408;1411;848;3101
352280;201508;2173;6566;1769;5857;461;1743;626;1961;1087;3704
352290;201508;1100;3431;944;3103;219;858;328;942;547;1800
352300;201508;915;2705;725;2349;179;632;300;899;479;1531
352310;201508;34900;105237;29212;95470;7382;25498;15703;51247;23085;76745
352320;201508;5603;17142;4790;15573;1366;4754;1501;4396;2867;9150
352330;201508;1969;6283;1674;5860;542;2006;482;1646;1024;3652
352340;201508;5408;17684;4186;14973;1136;4392;728;2334;1864;6726
352350;201508;1511;5207;1349;4851;280;1141;546;1851;826;2992
352360;201508;1098;3376;960;3105;185;750;591;1795;776;2545
352370;201508;813;2793;735;2610;129;527;358;1212;487;1739
352380;201508;967;3046;831;2803;270;1056;220;684;490;1740
352390;201508;17659;47957;11482;35893;2047;7376;5416;15640;7463;23016
352400;201508;3888;10847;2374;7848;638;2245;670;2015;1308;4260
352410;201508;2907;8674;2400;7802;628;2132;825;2585;1453;4717
352420;201508;925;2618;788;2351;207;679;359;1014;566;1693
352430;201508;6318;18904;5174;16982;1687;6107;1533;4824;3220;10931
352440;201508;15412;46730;12250;40530;3098;10938;4328;13852;7426;24790
352450;201508;672;1948;432;1478;92;351;106;320;198;671
352460;201508;2348;7600;1954;6856;589;2282;512;1610;1101;3892
352470;201508;4553;12519;2637;8514;446;1578;858;2574;1304;4152
352480;201508;4546;12310;3486;10334;667;2300;1404;3803;2071;6103
352490;201508;693;2358;545;1976;97;399;125;408;222;807
352500;201508;7698;22955;6907;21683;3267;11074;1863;5122;5130;16196
352510;201508;2959;9486;2349;8233;728;2807;579;1940;1307;4747
352520;201508;2083;7241;1824;6612;460;1803;837;2956;1297;4759
352530;201508;7769;24813;5735;20188;1582;5938;826;2555;2408;8493
352540;201508;495;1531;365;1243;61;252;93;280;154;532
352550;201508;871;2896;585;2174;146;629;102;324;248;953
352560;201508;664;1947;471;1516;86;274;158;454;244;728
352570;201508;1771;5837;1309;4739;265;1098;268;867;533;1965
352580;201508;865;2499;730;2283;159;541;380;1158;539;1699
352585;201508;210;681;163;584;56;212;33;124;89;336
352590;201508;12296;37541;9636;32106;2359;8576;4356;13788;6715;22364
352600;201508;1532;4642;1349;4302;354;1235;585;1753;939;2988
352610;201508;3287;9988;2711;8975;818;3017;797;2436;1615;5453
352620;201508;5121;15728;4726;15139;972;3410;2773;8671;3745;12081
352630;201508;606;1947;565;1839;131;507;240;711;371;1218
352640;201508;2764;8468;2229;7332;322;1215;1177;3723;1499;4938
352650;201508;833;2450;609;1967;139;473;179;533;318;1006
352660;201508;1011;3409;778;2849;153;620;178;614;331;1234
352670;201508;10149;30590;6005;21192;1478;5644;707;2260;2185;7904
352680;201508;2991;10147;2274;8404;514;2109;637;2089;1151;4198
352690;201508;29621;81534;20080;62059;3699;12503;9158;26978;12857;39481
352700;201508;700;2099;564;1881;157;593;260;823;417;1416
352710;201508;5623;16379;4158;13395;994;3583;1484;4492;2478;8075
352720;201508;7294;23463;6504;21760;1958;6640;2266;7521;4224;14161
352725;201508;402;1124;240;783;35;142;97;284;132;426
352730;201508;2241;7392;1969;6674;403;1487;703;2102;1106;3589
352740;201508;1896;5327;1499;4648;261;969;862;2511;1123;3480
352750;201508;452;1295;239;799;43;165;59;166;102;331
352760;201508;1085;3732;938;3384;282;1073;367;1262;649;2335
352770;201508;706;2192;606;1992;136;501;255;792;391;1293
352780;201508;611;1996;498;1736;99;393;161;509;260;902
352790;201508;634;1815;457;1477;94;323;96;301;190;624
352800;201508;903;3218;644;2510;150;662;172;556;322;1218
352810;201508;1134;2948;730;2162;139;463;225;633;364;1096
352820;201508;544;1532;398;1310;113;419;98;320;211;739
352830;201508;493;1390;322;1024;49;182;48;109;97;291
352840;201508;3731;12645;3250;11588;1018;3828;1008;3524;2026;7352
352850;201508;8385;26134;7106;23842;1848;6640;2609;8559;4457;15199
352860;201508;785;2567;709;2391;174;631;250;780;424;1411
352870;201508;951;2371;697;1895;76;295;410;995;486;1290
352880;201508;2297;6491;1647;5131;339;1096;530;1517;869;2613
352885;201508;219;731;207;703;28;102;127;413;155;515
352890;201508;671;1772;486;1393;66;234;239;601;305;835
352900;201508;19360;56568;14047;45638;2997;10687;5316;16363;8313;27050
352910;201508;260;792;178;609;27;104;23;64;50;168
352920;201508;2403;7140;1887;6156;455;1692;747;2184;1202;3876
352930;201508;5568;17221;4281;14328;1133;4078;978;3061;2111;7139
352940;201508;23126;75311;19199;66031;6385;23405;2769;8818;9154;32223
352950;201508;271;777;171;591;42;176;45;121;87;297
352960;201508;598;1839;376;1318;69;276;53;171;122;447
352965;201508;278;832;231;730;63;218;43;119;106;337
352970;201508;2914;7376;2320;6470;301;883;1499;4212;1800;5095
352980;201508;1204;3603;1008;3307;231;752;563;1968;794;2720
352990;201508;3950;12596;3469;11739;977;3671;1279;4077;2256;7748
353000;201508;470;1296;257;803;41;132;43;114;84;246
353010;201508;2954;8230;2154;6654;509;1771;627;1699;1136;3470
353020;201508;4246;11534;2698;8146;388;1355;1040;2780;1428;4135
353030;201508;3885;11299;3161;9948;886;3014;738;2134;1624;5148
353040;201508;625;1733;525;1571;146;496;182;499;328;995
353050;201508;4864;16145;4028;14421;1159;4469;1463;4962;2622;9431
353060;201508;33887;104425;31470;100486;3663;14134;22838;70054;26501;84188
353070;201508;9204;29532;6706;23943;1796;6840;1668;5919;3464;12759
353080;201508;5093;16222;3457;12457;752;2985;786;2544;1538;5529
353090;201508;516;1702;464;1592;54;217;254;802;308;1019
353100;201508;234;623;115;364;25;85;26;72;51;157
353110;201508;7260;22371;6323;20714;1599;5543;3277;10788;4876;16331
353120;201508;682;2007;422;1396;99;380;112;309;211;689
353130;201508;2467;7110;1994;6346;639;2197;646;1968;1285;4165
353140;201508;2276;6132;1715;5027;435;1382;682;1847;1117;3229
353150;201508;1672;5069;1355;4507;387;1380;367;1208;754;2588
353160;201508;664;1882;423;1348;94;314;68;151;162;465
353170;201508;468;1537;419;1455;114;506;188;582;302;1088
353180;201508;7692;22066;5969;18838;984;3456;3112;9468;4096;12924
353190;201508;3540;10806;2938;9495;561;2039;1444;4337;2005;6376
353200;201508;915;3067;730;2628;220;878;192;642;412;1520
353205;201508;400;1274;346;1167;80;281;136;451;216;732
353210;201508;966;2466;722;2034;42;166;476;1299;518;1465
353215;201508;407;1285;357;1174;60;223;131;379;191;602
353220;201508;654;2012;521;1714;127;462;126;361;253;823
353230;201508;841;2687;764;2545;195;726;222;666;417;1392
353240;201508;1963;6277;1763;5883;417;1586;906;2845;1323;4431
353250;201508;1036;2776;796;2339;126;393;385;1099;511;1492
353260;201508;908;2451;667;2027;110;382;281;794;391;1176
353270;201508;630;1867;541;1693;151;510;189;549;340;1059
353280;201508;580;1869;476;1639;119;446;123;406;242;852
353282;201508;1629;5201;1528;5016;209;779;965;3026;1174;3805
353284;201508;338;925;200;634;39;125;51;164;90;289
353286;201508;143;428;100;329;15;44;15;53;30;97
353290;201508;538;1712;427;1508;91;371;226;754;317;1125
353300;201508;1409;4359;1165;3806;281;1052;418;1199;699;2251
353310;201508;199;593;169;533;47;168;64;176;111;344
353320;201508;517;1484;453;1374;81;271;247;715;328;986
353325;201508;567;1865;465;1655;88;358;86;241;174;599
353330;201508;613;1768;405;1274;76;273;186;538;262;811
353340;201508;2893;8151;1846;6110;501;1763;559;1741;1060;3504
353350;201508;3178;9485;2598;8393;771;2658;1035;3162;1806;5820
353360;201508;377;1220;330;1116;46;193;207;662;253;855
353370;201508;644;2086;552;1861;74;290;310;994;384;1284
353380;201508;325;1045;264;921;52;217;102;311;154;528
353390;201508;5826;15609;4037;12338;778;2621;1466;4114;2244;6735
353400;201508;484;1434;397;1254;105;372;108;278;213;650
353410;201508;600;1727;485;1536;101;350;266;828;367;1178
353420;201508;570;1566;403;1195;112;325;129;358;241;683
353430;201508;2180;7438;1567;5776;368;1431;190;626;558;2057
353440;201508;56361;180672;47372;159861;13042;46089;16302;53214;29344;99303
353450;201508;426;1273;355;1133;76;276;141;417;217;693
353460;201508;3460;9633;2933;8731;442;1450;1431;4309;1873;5759
353470;201508;9010;26871;6360;21375;1395;5231;1518;4649;2913;9880
353475;201508;1627;4558;1085;3374;204;670;306;848;510;1518
353480;201508;1415;4206;1249;3883;229;773;717;2165;946;2938
353490;201508;977;2737;778;2346;167;549;298;822;465;1371
353500;201508;954;2572;787;2278;242;715;332;945;574;1660
353510;201508;999;3139;755;2528;164;602;181;512;345;1114
353520;201508;1076;3103;823;2663;169;638;323;1007;492;1645
353530;201508;2458;7208;2155;6664;391;1415;1149;3410;1540;4825
353540;201508;1892;5708;1627;5258;414;1433;680;2130;1094;3563
353550;201508;5865;16086;5017;14780;578;2054;3234;9079;3812;11133
353560;201508;2103;6925;1720;6203;428;1764;485;1623;913;3387
353570;201508;415;1273;349;1137;56;194;210;646;266;840
353580;201508;2169;6752;1977;6427;355;1335;1267;4029;1622;5364
353590;201508;684;1950;523;1656;144;491;160;505;304;996
353600;201508;1670;4644;1495;4341;233;752;786;2210;1019;2962
353610;201508;559;1852;423;1551;80;353;103;328;183;681
353620;201508;2079;6747;1742;6068;475;1793;547;1747;1022;3540
353625;201508;266;723;171;559;34;121;50;159;84;280
353630;201508;1609;5499;1214;4453;222;879;148;442;370;1321
353640;201508;1329;3840;1057;3259;151;485;559;1669;710;2154
353650;201508;6870;20429;5091;16654;1045;3586;1736;5468;2781;9054
353657;201508;303;948;268;878;48;172;98;303;146;475
353660;201508;1177;2996;849;2447;335;1048;136;267;471;1315
353670;201508;3619;11549;3027;10236;929;3572;968;2908;1897;6480
353680;201508;655;2153;572;1997;230;887;197;637;427;1524
353690;201508;505;1339;292;935;52;195;93;243;145;438
353700;201508;2099;6469;1796;5845;329;1160;713;2193;1042;3353
353710;201508;2959;7145;1321;4372;297;1019;257;813;554;1832
353715;201508;450;1285;308;983;33;125;80;235;113;360
353720;201508;1988;6223;1712;5777;315;1230;926;2984;1241;4214
353730;201508;4326;13076;3296;10834;701;2485;924;2771;1625;5256
353740;201508;1966;5823;1503;4875;423;1445;419;1299;842;2744
353750;201508;804;2670;604;2188;123;506;164;583;287;1089
353760;201508;9270;26290;7427;23334;1474;5193;3968;12182;5442;17375
353770;201508;807;2433;449;1537;70;237;27;44;97;281
353780;201508;4193;14250;3569;12969;1208;4692;968;3422;2176;8114
353790;201508;1909;6517;1550;5744;407;1728;297;1049;704;2777
353800;201508;15216;46988;11783;40467;3110;11598;4050;13465;7160;25063
353810;201508;1034;3206;776;2638;165;632;261;833;426;1465
353820;201508;1210;4082;1088;3791;250;1032;552;1738;802;2770
353830;201508;666;1792;516;1538;90;290;250;733;340;1023
353850;201508;1601;5029;1429;4696;299;1031;662;2113;961;3144
353860;201508;2444;8101;2015;7099;509;1914;573;1936;1082;3850
353870;201508;26604;77236;17805;59622;3843;14100;5129;15471;8972;29571
353880;201508;2467;7699;2045;6929;285;1154;1112;3665;1397;4819
353890;201508;2718;6667;1857;5260;353;1088;872;2310;1225;3398
353900;201508;1027;3182;739;2562;160;614;200;639;360;1253
353910;201508;1195;4324;1159;4242;329;1252;656;2384;985;3636
353920;201508;2230;6571;1541;5054;335;1169;255;733;590;1902
353930;201508;4024;12572;2867;10316;746;2897;602;2132;1348;5029
353940;201508;1194;3779;928;3180;166;629;363;1150;529;1779
353950;201508;3336;10563;2989;9918;443;1707;1886;6003;2329;7710
353960;201508;580;1816;436;1495;88;327;102;278;190;605
353970;201508;542;1579;474;1486;44;153;341;1063;385;1216
353980;201508;12388;37350;10641;33937;2342;8024;5361;16562;7703;24586
353990;201508;330;1013;297;942;56;222;139;400;195;622
354000;201508;2050;5878;1319;4327;260;929;134;389;394;1318
354010;201508;346;1033;289;943;73;245;152;508;225;753
354020;201508;4388;13543;3820;12255;992;3446;1410;4142;2402;7588
354025;201508;797;2263;615;1939;124;423;203;605;327;1028
354030;201508;494;1349;343;1086;57;210;165;480;222;690
354040;201508;742;1999;539;1620;59;218;284;780;343;998
354050;201508;939;3008;794;2713;224;846;245;792;469;1638
354060;201508;5042;15466;3454;11907;832;3063;1031;3369;1863;6432
354070;201508;2772;9114;2359;8168;595;2226;491;1594;1086;3820
354075;201508;1917;7198;1807;6980;480;2042;802;3055;1282;5097
354080;201508;1520;4606;1040;3485;226;801;229;651;455;1452
354085;201508;307;783;273;734;17;60;222;584;239;644
354090;201508;1283;3761;1216;3654;119;399;887;2682;1006;3081
354100;201508;14748;49055;12124;43821;3076;11886;5320;18883;8396;30769
354105;201508;855;2617;747;2411;118;431;437;1357;555;1788
354110;201508;741;2025;595;1826;219;763;150;380;369;1143
354120;201508;1954;5326;1492;4452;271;912;628;1715;899;2627
354130;201508;5914;17095;4553;14395;1766;5956;724;1920;2490;7876
354140;201508;24926;62939;15159;44964;3148;10073;4870;13253;8018;23326
354150;201508;3922;10545;2967;8809;555;1845;1395;3945;1950;5790
354160;201508;3354;10848;2766;9501;732;2749;1093;3577;1825;6326
354165;201508;342;1267;297;1156;87;375;99;368;186;743
354170;201508;1379;4227;1071;3530;200;757;408;1183;608;1940
354180;201508;450;1316;405;1215;59;215;238;632;297;847
354190;201508;1467;4688;1194;4080;338;1280;386;1235;724;2515
354200;201508;1050;2962;837;2560;133;468;347;946;480;1414
354210;201508;659;2148;568;1974;85;363;303;979;388;1342
354220;201508;2807;8243;2395;7463;577;1974;1089;3261;1666;5235
354230;201508;627;2038;567;1924;100;380;257;835;357;1215
354240;201508;1187;3833;867;3070;143;575;191;605;334;1180
354250;201508;666;1919;446;1530;163;615;115;384;278;999
354260;201508;7978;23280;6602;20942;1859;6410;2236;6900;4095;13310
354270;201508;1106;3792;938;3380;227;912;342;1200;569;2112
354280;201508;663;2018;613;1930;81;314;435;1312;516;1626
354290;201508;959;3233;867;3057;196;758;371;1288;567;2046
354300;201508;3390;11290;3263;11047;859;3030;1592;5290;2451;8320
354310;201508;855;2637;648;2199;165;603;241;798;406;1401
354320;201508;739;2172;610;1924;146;527;204;562;350;1089
354323;201508;411;1160;315;985;72;250;100;271;172;521
354325;201508;1192;3947;1011;3496;192;763;389;1248;581;2011
354330;201508;6452;19532;5293;17178;1098;3961;2555;7789;3653;11750
354340;201508;24437;75525;19620;66746;6118;22541;6957;22810;13075;45351
354350;201508;1064;3144;986;2998;283;958;484;1364;767;2322
354360;201508;450;1423;314;1122;54;201;26;94;80;295
354370;201508;1183;3924;1022;3587;118;514;605;2041;723;2555
354380;201508;926;2717;732;2373;219;840;126;312;345;1152
354390;201508;12059;36471;8335;28752;1860;6967;1820;5958;3680;12925
354400;201508;1527;5238;1212;4478;264;1085;344;1200;608;2285
354410;201508;5248;16037;4324;14332;994;3525;1985;6514;2979;10039
354420;201508;1134;3395;855;2732;208;724;335;989;543;1713
354425;201508;2480;6973;2074;6226;654;2089;496;1408;1150;3497
354430;201508;1239;4031;1132;3809;250;946;490;1578;740;2524
354440;201508;509;1504;382;1240;50;193;177;526;227;719
354450;201508;423;1196;240;796;34;134;48;132;82;266
354460;201508;861;2359;640;1984;184;621;250;751;434;1372
354470;201508;551;1524;430;1279;53;203;209;548;262;751
354480;201508;677;1885;574;1717;90;311;337;966;427;1277
354490;201508;699;2294;527;1887;100;390;171;559;271;949
354500;201508;2055;6840;1803;6363;670;2719;317;971;987;3690
354510;201508;690;1995;619;1870;105;311;392;1206;497;1517
354515;201508;289;959;218;790;42;179;72;235;114;414
354520;201508;6773;21944;3828;13401;765;3030;1497;4897;2262;7927
354530;201508;2754;9552;2468;8917;616;2452;1090;3832;1706;6284
354540;201508;1215;3680;993;3271;338;1237;163;467;501;1704
354550;201508;461;1388;388;1235;74;263;192;583;266;846
354560;201508;1574;4510;1049;3324;211;661;405;1207;616;1868
354570;201508;753;2226;511;1656;113;388;79;220;192;608
354580;201508;9777;28124;7488;23680;1485;5115;3202;9540;4687;14655
354600;201508;1493;4951;1314;4602;304;1291;636;2079;940;3370
354610;201508;374;1081;223;720;31;93;45;127;76;220
354620;201508;385;1255;304;1109;78;348;134;452;212;800
354625;201508;254;822;194;694;43;162;54;182;97;344
354630;201508;1999;6730;1773;6230;766;2761;372;1218;1138;3979
354640;201508;3535;11490;2754;9738;634;2552;613;1926;1247;4478
354650;201508;877;2635;778;2438;102;361;501;1516;603;1877
354660;201508;2346;6799;1817;5874;325;1188;965;3082;1290;4270
354670;201508;1544;5022;1248;4289;325;1219;294;867;619;2086
354680;201508;4353;14294;3887;13300;1007;3729;1628;5412;2635;9141
354690;201508;762;2429;492;1746;93;328;144;487;237;815
354700;201508;1214;3396;801;2507;153;567;326;859;479;1426
354710;201508;523;1542;441;1372;67;238;198;548;265;786
354720;201508;205;557;141;430;46;131;39;120;85;251
354730;201508;7599;24906;5830;21103;1406;5566;2354;8193;3760;13759
354740;201508;231;700;136;482;19;78;28;91;47;169
354750;201508;2428;7373;1834;6284;529;2032;647;2127;1176;4159
354760;201508;1928;6122;1542;5280;443;1632;262;834;705;2466
354765;201508;220;612;135;439;11;43;15;37;26;80
354770;201508;2205;6141;1694;5267;644;2130;429;1259;1073;3389
354780;201508;43149;124278;37367;111561;7089;23710;19857;55251;26946;78961
354790;201508;775;2471;648;2238;125;494;315;1014;440;1508
354800;201508;1950;5716;1710;5378;424;1489;860;2649;1284;4138
354805;201508;919;2774;654;2174;60;211;143;437;203;648
354810;201508;580;1875;352;1283;57;244;67;188;124;432
354820;201508;970;3294;822;2977;184;796;242;770;426;1566
354830;201508;383;1082;288;907;72;242;142;411;214;653
354840;201508;653;1869;526;1635;111;377;261;790;372;1167
354850;201508;16322;50623;11991;41628;2743;10551;4457;14158;7200;24709
354860;201508;1325;4142;1126;3806;228;890;476;1519;704;2409
354870;201508;40666;123161;36635;114639;8984;29977;16249;49786;25233;79763
354880;201508;4003;11023;2273;7408;393;1492;630;1652;1023;3144
354890;201508;15273;44972;12674;40057;3242;10985;4542;13841;7784;24826
354900;201508;443;1300;332;1070;83;299;97;299;180;598
354910;201508;6470;19241;3554;12687;612;2408;219;716;831;3124
354920;201508;428;1258;303;1009;68;260;84;266;152;526
354925;201508;342;983;205;698;30;114;30;80;60;194
354930;201508;204;535;150;449;35;111;74;216;109;327
354940;201508;2010;7032;1557;5833;567;2256;207;711;774;2967
354950;201508;1442;4583;1242;4271;140;594;733;2427;873;3021
354960;201508;758;2363;655;2193;137;528;272;866;409;1394
354970;201508;3992;12959;3460;11844;621;2461;1877;6164;2498;8625
354980;201508;33131;81886;19447;58811;3725;12596;6595;18473;10320;31069
354990;201508;45718;136929;36398;117903;6966;24525;17897;55820;24863;80345
354995;201508;1612;4967;1457;4746;341;1183;794;2568;1135;3751
355000;201508;1421;4581;1225;4222;384;1511;243;713;627;2224
355010;201508;3509;10703;2750;9034;719;2531;1046;3430;1765;5961
355020;201508;2786;9346;2161;8037;899;3626;462;1638;1361;5264
355030;201508;968561;2722747;831943;2449711;194031;620139;369886;1044677;563917;1664816
355040;201508;2542;7761;2227;7206;564;1991;1145;3611;1709;5602
355050;201508;1180;3595;943;3117;306;1075;175;556;481;1631
355060;201508;4807;16069;3824;13928;923;3782;982;3224;1905;7006
355070;201508;6487;19984;5733;18741;1208;4589;3045;9302;4253;13891
355080;201508;1086;3705;787;2980;143;642;109;317;252;959
355090;201508;1116;3829;910;3365;182;726;365;1310;547;2036
355100;201508;18524;57433;15483;52330;4364;16212;6761;22271;11125;38483
355110;201508;1191;3962;1048;3662;314;1203;296;995;610;2198
355120;201508;600;1897;504;1702;120;475;192;586;312;1061
355130;201508;593;1500;288;835;50;150;105;267;155;417
355140;201508;1050;3475;994;3381;219;830;530;1827;749;2657
355150;201508;3183;9317;2651;8448;593;2004;1369;4354;1962;6358
355160;201508;1579;5025;1341;4654;454;1792;419;1328;873;3120
355170;201508;9376;25572;6596;20729;2000;6767;1606;5061;3606;11828
355180;201508;2824;8674;2315;7707;606;2390;755;2239;1361;4629
355190;201508;1223;4113;1026;3677;360;1376;325;1120;685;2496
355200;201508;732;2636;673;2508;285;1155;150;529;435;1684
355210;201508;2399;7745;2094;7090;441;1738;1050;3341;1491;5079
355220;201508;29887;91545;24218;80188;8227;28714;6069;19123;14296;47837
355230;201508;1387;3854;754;2446;134;452;184;536;318;988
355240;201508;25877;74021;17887;57735;3890;13657;6319;19277;10209;32934
355250;201508;24347;79007;21190;72905;6017;22148;8845;29861;14862;52009
355255;201508;794;2190;538;1647;102;327;141;399;243;726
355260;201508;1395;3932;1185;3578;280;969;493;1311;773;2280
355270;201508;1478;4405;1419;4322;96;361;1204;3615;1300;3976
355280;201508;23258;68044;19018;59703;3781;13418;8398;24899;12179;38317
355290;201508;864;2706;708;2342;139;491;275;828;414;1319
355300;201508;1087;3534;888;3104;184;696;306;993;490;1689
355310;201508;977;2964;807;2623;137;477;417;1348;554;1825
355320;201508;596;1830;504;1624;83;333;198;529;281;862
355330;201508;1696;5264;1193;4251;259;1025;432;1475;691;2500
355340;201508;2373;6250;2130;5836;352;1019;1299;3461;1651;4480
355350;201508;1281;4353;1049;3821;268;1090;315;1055;583;2145
355360;201508;1070;3432;972;3236;153;527;672;2300;825;2827
355365;201508;226;726;188;646;42;181;60;187;102;368
355370;201508;7410;18170;5263;15488;1395;4439;2200;6689;3595;11128
355380;201508;3314;10013;2532;8184;589;2113;535;1410;1124;3523
355385;201508;829;2619;767;2522;288;1012;226;679;514;1691
355390;201508;844;2360;636;1952;141;495;270;723;411;1218
355395;201508;1874;5615;1384;4491;215;746;583;1749;798;2495
355400;201508;8585;28168;7362;25602;2171;8165;2346;7777;4517;15942
355410;201508;14853;49700;12127;44004;4029;15939;2595;9331;6624;25270
355420;201508;761;2658;694;2512;225;902;205;728;430;1630
355430;201508;3433;9622;2853;8603;534;1775;1532;4454;2066;6229
355440;201508;910;2832;688;2325;122;446;208;628;330;1074
355450;201508;3465;9994;1954;6500;378;1318;592;1803;970;3121
355460;201508;621;1672;428;1326;82;311;136;332;218;643
355465;201508;372;1151;308;1029;66;242;78;252;144;494
355470;201508;749;2345;624;2099;133;508;294;930;427;1438
355475;201508;128;472;117;440;27;102;56;208;83;310
355480;201508;2882;10183;2643;9702;712;2785;1231;4424;1943;7209
355490;201508;939;2689;620;2024;108;371;130;393;238;764
355495;201508;688;2297;607;2122;123;478;226;743;349;1221
355500;201508;7746;22126;4868;15837;819;2942;983;2879;1802;5821
355510;201508;2022;5389;1154;3618;180;674;353;969;533;1643
355520;201508;428;1017;239;661;33;120;104;252;137;372
355530;201508;366;855;151;468;17;59;40;111;57;170
355535;201508;667;2030;518;1734;151;578;124;329;275;907
355540;201508;8099;25575;7564;24661;1906;6653;3967;12528;5873;19181
355550;201508;725;2194;616;2022;136;528;286;901;422;1429
355560;201508;1259;3719;816;2726;155;606;130;305;285;911
355570;201508;184;583;133;461;17;63;23;67;40;130
355580;201508;1147;3162;806;2488;168;599;310;930;478;1529
355590;201508;219;574;181;504;24;70;108;299;132;369
355600;201508;1087;3366;901;2970;308;1103;240;740;548;1843
355610;201508;1369;3817;1157;3470;230;779;539;1541;769;2320
355620;201508;3960;12341;3114;10414;569;2172;1386;4277;1955;6449
355630;201508;3227;9218;1938;6540;378;1376;490;1544;868;2920
355635;201508;914;2981;783;2759;99;421;523;1830;622;2251
355640;201508;2996;9531;2182;7761;394;1586;312;977;706;2563
355645;201508;3091;10682;2801;10191;442;1780;1712;6194;2154;7974
355650;201508;6384;19369;5422;17521;804;3059;3331;10129;4135;13188
355660;201508;1208;3782;956;3257;194;808;386;1206;580;2014
355670;201508;2425;7551;1667;5761;326;1314;661;2021;987;3335
355680;201508;1469;4782;1083;3879;346;1347;238;789;584;2136
355690;201508;404;1267;296;1082;186;722;24;65;210;787
355695;201508;302;918;175;572;12;36;16;30;28;66
355700;201508;5296;17552;4455;15619;1138;4218;1721;5769;2859;9987
355710;201508;10588;26149;6218;18116;1541;4827;1558;4192;3099;9019
355715;201508;259;768;159;540;38;137;29;85;67;222
355720;201508;1476;4865;1202;4240;331;1257;349;1087;680;2344
355730;201508;750;2499;621;2198;204;732;138;488;342;1220
410010;201508;1431;4455;1236;4047;276;977;312;980;588;1957
410020;201508;1161;3800;1007;3467;275;1010;393;1305;668;2315
410030;201508;1132;3833;922;3301;225;865;155;542;380;1407
410040;201508;9754;31948;8476;29384;2280;8848;2494;8304;4774;17152
410045;201508;964;2722;654;2105;150;510;167;503;317;1013
410050;201508;2405;6663;1470;4779;383;1315;163;457;546;1772
410060;201508;2159;6733;1906;6237;478;1692;795;2612;1273;4304
410070;201508;1694;4751;1282;3933;404;1350;281;764;685;2114
410080;201508;1263;3741;1024;3286;178;646;454;1360;632;2006
410090;201508;1011;3184;919;2987;238;871;309;959;547;1830
410100;201508;2607;7937;1873;6203;458;1678;202;594;660;2272
410105;201508;396;1238;252;885;47;198;36;101;83;299
410110;201508;2474;7325;1972;6335;347;1250;635;1981;982;3231
410115;201508;518;1408;395;1168;46;148;159;432;205;580
410120;201508;2403;8240;2234;7945;686;2589;956;3422;1642;6011
410130;201508;1135;3662;1022;3373;368;1254;276;870;644;2124
410140;201508;16473;43215;10746;32711;2345;7880;2974;8677;5319;16557
410150;201508;17539;43597;8502;25404;1703;5579;1434;3777;3137;9356
410160;201508;2872;8857;2581;8364;697;2514;940;3053;1637;5567
410165;201508;741;2154;596;1846;137;445;236;677;373;1122
410170;201508;2084;6080;1626;5078;475;1653;334;981;809;2634
410180;201508;9593;30499;8128;27213;2049;7470;3011;9371;5060;16841
410185;201508;567;1549;452;1333;110;329;142;385;252;714
410190;201508;2000;5885;1569;4900;344;1179;296;822;640;2001
410200;201508;3803;10622;2700;8368;597;2056;336;937;933;2993
410210;201508;2470;7333;1815;5885;317;1203;406;1087;723;2290
410220;201508;626;1771;449;1412;75;263;132;382;207;645
410230;201508;1377;4310;1179;3929;320;1234;461;1439;781;2673
410240;201508;4311;13056;3865;12122;1100;3954;1012;3025;2112;6979
410250;201508;2538;7023;1742;5372;434;1460;317;861;751;2321
410260;201508;1526;4651;1281;4181;313;1095;492;1560;805;2655
410270;201508;511;1440;393;1211;61;215;150;422;211;637
410275;201508;865;2588;598;2000;85;300;281;929;366;1229
410280;201508;2250;6543;1641;5276;358;1344;457;1350;815;2694
410290;201508;3376;10149;2844;9116;693;2382;1132;3631;1825;6013
410300;201508;663;1872;568;1675;91;294;253;676;344;970
410302;201508;365;988;247;791;30;103;143;464;173;567
410304;201508;1209;3893;1087;3631;299;1043;429;1478;728;2521
410305;201508;1875;4951;1528;4399;370;1153;814;2342;1184;3495
410310;201508;2145;6982;1921;6568;431;1656;746;2512;1177;4168
410315;201508;630;1826;391;1331;69;256;121;378;190;634
410320;201508;1206;3607;703;2393;90;344;71;219;161;563
410322;201508;532;1560;340;1129;60;197;94;289;154;486
410330;201508;1369;3721;1114;3229;249;774;322;900;571;1674
410335;201508;949;2790;807;2530;163;551;304;898;467;1449
410337;201508;781;2060;563;1632;77;274;220;554;297;828
410340;201508;488;1442;320;989;42;147;133;366;175;513
410345;201508;1668;4757;1151;3644;269;907;347;1056;616;1963
410347;201508;704;1907;457;1436;69;254;148;450;217;704
410350;201508;948;2865;663;2262;142;541;91;269;233;810
410360;201508;3368;9482;2693;8276;478;1657;1186;3506;1664;5163
410370;201508;11870;34170;8373;26115;1621;5740;2422;6593;4043;12333
410380;201508;1185;3554;1042;3244;153;567;530;1564;683;2131
410390;201508;2642;7633;2037;6453;662;2275;530;1485;1192;3760
410395;201508;871;2865;761;2631;198;796;316;1044;514;1840
410400;201508;4232;13182;3566;11870;831;3157;1298;4076;2129;7233
410405;201508;917;2652;722;2267;163;583;256;780;419;1363
410410;201508;1253;4010;1193;3918;355;1383;469;1409;824;2792
410420;201508;7060;22703;5774;19722;1545;5679;984;2921;2529;8600
410425;201508;3085;9701;2146;7551;395;1491;239;758;634;2249
410430;201508;14405;38789;10296;30995;2128;7037;3093;8854;5221;15891
410440;201508;2922;9285;2583;8616;682;2526;1061;3417;1743;5943
410442;201508;2644;8873;2316;8115;707;2565;651;2278;1358;4843
410445;201508;2266;7536;1949;6930;510;2050;640;2315;1150;4365
410450;201508;2171;6126;1649;5097;494;1596;217;556;711;2152
410460;201508;2051;6034;1611;5135;409;1375;460;1370;869;2745
410465;201508;1871;6250;1535;5501;347;1362;561;1864;908;3226
410470;201508;1609;5183;1284;4421;289;1153;327;1081;616;2234
410480;201508;28999;82035;18995;60648;4471;15359;2966;8297;7437;23656
410490;201508;10540;33282;8014;27731;2013;7778;2013;6320;4026;14098
410500;201508;1538;4795;1237;4125;450;1646;311;1005;761;2651
410510;201508;2443;6461;1709;4972;325;996;669;1750;994;2746
410520;201508;3095;10746;2907;10351;888;3394;1073;3815;1961;7209
410530;201508;1600;4392;1171;3497;212;722;407;1091;619;1813
410540;201508;3013;8876;2033;6758;447;1559;595;1915;1042;3474
410550;201508;6248;17901;4097;13113;790;2855;622;1726;1412;4581
410560;201508;1161;3455;877;2834;205;771;268;721;473;1492
410570;201508;2598;8239;2312;7723;619;2248;801;2866;1420;5114
410580;201508;21475;65304;17338;56820;4558;16562;4855;14663;9413;31225
410590;201508;1316;4096;779;2601;116;390;147;439;263;829
410600;201508;1811;5280;1443;4545;343;1100;568;1784;911;2884
410610;201508;751;2157;583;1820;88;318;218;643;306;961
410620;201508;1619;5603;1187;4461;345;1391;135;482;480;1873
410630;201508;2469;7289;1783;5749;446;1552;320;865;766;2417
410640;201508;4244;11787;3100;9567;824;2939;557;1577;1381;4516
410645;201508;1116;3910;1058;3823;482;1876;252;913;734;2789
410650;201508;2222;6787;1742;5751;561;1939;272;808;833;2747
410655;201508;822;2367;635;2002;133;497;214;640;347;1137
410657;201508;705;1969;481;1490;90;320;178;474;268;794
410660;201508;2499;7241;1425;4744;303;1104;167;470;470;1574
410670;201508;937;2587;625;1920;118;391;185;499;303;890
410680;201508;2732;9090;2199;7739;613;2115;703;2642;1316;4757
410685;201508;628;1805;546;1665;47;146;387;1197;434;1343
410690;201508;113157;326760;76355;248348;16912;60355;15865;45299;32777;105654
410700;201508;2218;6782;2027;6407;547;1867;839;2531;1386;4398
410710;201508;881;2633;606;1986;145;513;161;451;306;964
410712;201508;810;2454;680;2198;242;833;188;627;430;1460
410715;201508;962;2996;726;2444;138;516;253;770;391;1286
410720;201508;3290;9677;2350;7669;506;1868;535;1577;1041;3445
410725;201508;1031;2911;702;2238;109;337;109;298;218;635
410730;201508;507;1403;408;1236;123;411;106;325;229;736
410740;201508;890;2646;619;2083;109;423;267;889;376;1312
410750;201508;1795;5230;1443;4465;300;1020;459;1329;759;2349
410752;201508;292;808;166;541;32;127;61;166;93;293
410753;201508;432;1242;262;846;39;145;86;244;125;389
410754;201508;1025;3122;875;2857;72;247;571;1931;643;2178
410755;201508;802;2031;622;1743;87;279;358;969;445;1248
410760;201508;2211;6748;1932;6224;550;1964;586;1807;1136;3771
410765;201508;15714;46442;11115;37048;2053;7654;1151;3446;3204;11100
410770;201508;899;2474;653;1980;194;656;132;360;326;1016
410773;201508;1290;3702;1099;3401;223;800;606;1803;829;2603
410775;201508;1501;4260;1394;4102;336;1076;591;1691;927;2767
410780;201508;515;1429;358;1132;91;288;125;446;216;734
410785;201508;714;2278;580;1953;212;758;135;434;347;1192
410790;201508;457;1439;371;1233;71;257;67;165;138;422
410800;201508;2790;6926;2108;5797;418;1328;791;1968;1209;3296
410810;201508;324;985;258;838;46;173;106;344;152;517
410820;201508;848;2536;634;2031;156;549;109;305;265;854
410830;201508;31216;89344;24684;77675;7228;25179;8097;24502;15325;49681
410832;201508;975;2844;845;2585;101;375;479;1365;580;1740
410840;201508;6850;20147;4344;14571;1029;3749;458;1240;1487;4989
410845;201508;1256;3706;1052;3276;187;662;446;1317;633;1979
410850;201508;2743;7956;2424;7452;520;1811;1124;3423;1644;5234
410855;201508;582;1595;419;1246;83;283;151;392;234;675
410860;201508;3715;10416;2952;8965;554;1809;1160;3424;1714;5233
410865;201508;1515;5214;1434;5056;379;1469;774;2758;1153;4227
410870;201508;1135;3513;1047;3373;376;1280;476;1522;852;2802
410880;201508;3907;11965;3095;10364;671;2489;656;2019;1327;4508
410890;201508;937;3033;726;2572;174;696;63;183;237;879
410895;201508;1116;3837;983;3513;330;1273;236;765;566;2038
410900;201508;865;2382;618;1940;112;428;201;565;313;993
410910;201508;404;1074;340;964;47;153;195;536;242;689
410920;201508;822;2296;645;1973;165;574;235;686;400;1260
410930;201508;1733;5085;1468;4583;343;1285;548;1636;891;2921
410940;201508;20214;65470;17228;59842;5042;19097;5157;18014;10199;37111
410950;201508;1707;5682;1579;5435;265;952;1031;3562;1296;4514
410960;201508;7054;19503;4427;14447;1326;4730;954;2907;2280;7637
410965;201508;1021;3100;878;2826;254;869;362;1133;616;2002
410970;201508;4394;13044;3404;11050;964;3615;668;2055;1632;5670
410975;201508;1568;4493;1238;3864;212;783;491;1489;703;2272
410980;201508;5687;15949;3380;11159;695;2559;507;1566;1202;4125
410990;201508;892;2581;537;1779;167;620;80;193;247;813
411000;201508;488;1465;344;1129;66;251;70;185;136;436
411005;201508;487;1433;299;970;75;264;35;88;110;352
411007;201508;2218;6985;1904;6265;551;1931;604;1908;1155;3839
411010;201508;3795;12937;3340;11854;855;3395;560;1767;1415;5162
411020;201508;2472;7688;2192;7203;683;2523;692;2196;1375;4719
411030;201508;659;1765;477;1397;101;338;140;373;241;711
411040;201508;625;1812;293;959;50;180;71;232;121;412
411050;201508;2060;7167;1820;6624;509;2066;289;921;798;2987
411060;201508;1509;4633;1217;3987;245;892;184;527;429;1419
411065;201508;362;1078;273;897;54;185;94;294;148;479
411070;201508;5592;16787;4140;13739;1168;4268;752;2210;1920;6478
411080;201508;2148;6477;1899;6010;531;1885;540;1611;1071;3496
411090;201508;790;1934;561;1589;81;286;128;330;209;616
411095;201508;1398;4036;1040;3255;168;610;257;700;425;1310
411100;201508;1350;3921;969;3135;163;632;157;423;320;1055
411110;201508;640;1864;369;1226;45;162;53;135;98;297
411120;201508;1640;4915;1205;3954;311;1134;385;1160;696;2294
411125;201508;4129;13493;3911;13035;1153;4094;1553;5001;2706;9095
411130;201508;705;2099;529;1701;123;413;154;518;277;931
411140;201508;2080;7318;1774;6585;589;2276;523;2015;1112;4291
411150;201508;4311;11980;3261;9801;786;2604;606;1500;1392;4104
411155;201508;925;2510;703;2081;124;429;324;881;448;1310
411160;201508;224;650;180;562;39;133;46;123;85;256
411170;201508;646;2063;532;1795;129;490;190;599;319;1089
411180;201508;5521;16495;4483;14499;1062;3815;1481;4688;2543;8503
411190;201508;1449;4103;1185;3590;298;1042;320;837;618;1879
411200;201508;4198;12369;3341;10854;822;3016;1172;3591;1994;6607
411210;201508;2029;5837;1568;4947;467;1589;211;604;678;2193
411220;201508;1157;3268;897;2756;218;780;335;893;553;1673
411230;201508;1222;3378;754;2413;176;617;194;547;370;1164
411240;201508;1338;3203;709;2125;134;408;229;632;363;1040
411250;201508;2281;6678;1858;5891;510;1764;499;1529;1009;3293
411260;201508;301;824;201;644;31;104;90;279;121;383
411270;201508;1740;5487;1542;5101;317;1219;730;2306;1047;3525
411275;201508;1356;4018;1101;3424;273;901;252;707;525;1608
411280;201508;1472;4305;1020;3332;183;661;209;613;392;1274
411290;201508;783;2244;591;1817;149;485;185;533;334;1018
411295;201508;946;2661;847;2468;158;489;338;1005;496;1494
411300;201508;1320;3373;916;2575;104;344;363;928;467;1272
411310;201508;835;2303;647;1978;85;298;213;636;298;934
411320;201508;5551;16018;3993;12908;1038;3538;771;2275;1809;5813
411325;201508;1500;4723;1309;4316;265;932;708;2330;973;3262
411330;201508;3179;9796;2694;8858;900;3284;728;2330;1628;5614
411340;201508;913;2685;567;1852;79;298;202;617;281;915
411342;201508;714;2022;574;1738;150;489;184;493;334;982
411345;201508;965;2983;858;2774;216;765;397;1276;613;2041
411350;201508;2713;7964;1879;6238;489;1809;232;703;721;2512
411360;201508;543;1348;360;1029;42;155;172;418;214;573
411370;201508;45961;129102;34605;107759;6244;22475;13176;37788;19420;60263
411373;201508;1464;4546;1224;4069;278;1043;300;988;578;2031
411375;201508;1095;3014;780;2378;156;484;194;543;350;1027
411380;201508;1270;3429;724;2186;112;358;212;584;324;942
411390;201508;1788;5285;1473;4644;308;1070;456;1320;764;2390
411400;201508;2021;5800;1451;4528;269;921;367;1049;636;1970
411410;201508;2067;6180;1551;4957;347;1265;414;1105;761;2370
411420;201508;4097;11738;2849;8879;487;1703;494;1227;981;2930
411430;201508;2991;9224;2485;8326;701;2555;1063;3491;1764;6046
411435;201508;427;1379;344;1163;81;309;138;435;219;744
411440;201508;2633;8474;2344;7868;769;2770;591;2043;1360;4813
411450;201508;2209;6716;1984;6279;410;1329;1037;3361;1447;4690
411460;201508;3156;9307;1654;5748;318;1194;97;324;415;1518
411470;201508;853;2531;553;1799;83;282;88;232;171;514
411480;201508;4378;13025;3216;10745;874;3260;570;1739;1444;4999
411490;201508;1445;4337;1194;3873;284;1023;298;829;582;1852
411500;201508;1833;4898;1272;3882;266;889;346;996;612;1885
411510;201508;2018;6025;1626;5207;459;1616;321;863;780;2479
411520;201508;25612;69494;14973;46848;2920;9907;3164;9099;6084;19006
411530;201508;1009;2850;694;2256;177;645;109;291;286;936
411535;201508;514;1539;246;892;36;148;26;76;62;224
411540;201508;3017;8111;2205;6499;385;1314;968;2652;1353;3966
411545;201508;931;3114;844;2949;148;557;550;1955;698;2512
411550;201508;783;2112;621;1855;234;780;124;350;358;1130
411560;201508;2425;7188;1775;5664;336;1190;290;775;626;1965
411570;201508;6507;17526;4726;14549;1181;4152;1055;3250;2236;7402
411573;201508;868;2590;814;2494;147;481;496;1525;643;2006
411575;201508;1486;4630;1232;4068;242;853;452;1453;694;2306
411580;201508;3936;11131;2565;8271;404;1541;387;1009;791;2550
411585;201508;665;2168;372;1307;78;296;66;206;144;502
411590;201508;372;1101;322;1026;57;203;137;399;194;602
411600;201508;284;835;203;695;50;202;74;248;124;450
411605;201508;1909;5057;1228;3690;202;704;476;1324;678;2028
411610;201508;2114;5827;1779;5282;327;1049;1005;2897;1332;3946
411620;201508;2637;8356;2420;7977;691;2463;1082;3603;1773;6066
411630;201508;468;1218;279;922;52;213;46;134;98;347
411640;201508;486;1424;367;1168;56;184;130;366;186;550
411650;201508;200;652;159;569;41;178;42;127;83;305
411660;201508;810;2234;621;1868;121;397;261;769;382;1166
411670;201508;1203;3325;977;2844;222;711;361;985;583;1696
411680;201508;1387;4250;1242;3983;188;610;788;2621;976;3231
411690;201508;3232;9486;2514;8073;653;2218;541;1746;1194;3964
411695;201508;777;2512;621;2167;144;553;186;642;330;1195
411700;201508;1757;5082;1211;3926;240;868;235;660;475;1528
411705;201508;2029;6924;1778;6408;403;1440;941;3541;1344;4981
411710;201508;1701;4948;1314;4127;321;1088;289;844;610;1932
411720;201508;813;2338;604;1882;89;301;176;501;265;802
411721;201508;685;2062;578;1858;163;571;79;226;242;797
411722;201508;639;1857;440;1415;87;322;127;344;214;666
411725;201508;1355;4360;828;2970;187;722;153;525;340;1247
411727;201508;1872;5426;1437;4491;335;1150;424;1209;759;2359
411729;201508;542;1454;382;1159;124;385;70;187;194;572
411730;201508;5473;15728;4524;13882;1770;5541;1130;3426;2900;8967
411740;201508;622;1769;404;1260;69;242;139;405;208;647
411745;201508;861;2517;692;2170;145;487;223;672;368;1159
411750;201508;4518;13470;3359;10761;774;2741;800;2412;1574;5153
411760;201508;7747;22530;6589;20456;2057;6937;1827;5538;3884;12475
411770;201508;3301;11073;2702;9631;843;3215;517;1773;1360;4988
411780;201508;2565;8136;2413;7912;262;919;1675;5669;1937;6588
411790;201508;3078;8725;2203;6930;587;2115;606;1800;1193;3915
411800;201508;1211;3453;797;2579;120;445;148;398;268;843
411810;201508;1532;4470;1283;3981;277;974;434;1210;711;2184
411820;201508;13828;44037;11466;39229;4019;14267;2867;9993;6886;24260
411830;201508;475;1261;361;1070;116;357;15;54;131;411
411840;201508;10024;28899;7316;23572;1794;6287;1540;4759;3334;11046
411845;201508;512;1561;323;1072;52;191;68;189;120;380
411850;201508;6741;20119;5488;17559;1408;4847;1486;4672;2894;9519
411860;201508;868;2677;694;2304;178;624;219;689;397;1313
411870;201508;866;2893;595;2144;117;502;135;434;252;936
411880;201508;2230;6438;1805;5665;441;1605;449;1263;890;2868
411885;201508;883;2377;700;2027;130;474;237;588;367;1062
411890;201508;1061;3206;645;2168;96;363;90;223;186;586
411900;201508;960;3055;673;2328;174;615;95;330;269;945
411910;201508;1229;4045;956;3370;286;1079;247;801;533;1880
411915;201508;14738;40951;9376;29858;1830;6324;2073;6003;3903;12327
411920;201508;850;2871;725;2559;189;808;108;287;297;1095
411925;201508;599;1688;389;1284;95;315;94;286;189;601
411930;201508;5870;19091;5183;17795;2113;7708;1115;3713;3228;11421
411940;201508;3202;10684;2760;9726;719;2673;647;2187;1366;4860
411950;201508;11357;35973;9411;32112;2339;8631;4127;13835;6466;22466
411960;201508;5167;15404;4708;14531;1145;3915;1952;5850;3097;9765
411965;201508;594;1684;427;1394;82;319;148;489;230;808
411970;201508;738;2045;592;1815;187;626;200;632;387;1258
411980;201508;1597;4831;1357;4336;275;933;480;1533;755;2466
411990;201508;27780;90110;22955;79638;6195;23801;6405;21452;12600;45253
411995;201508;2470;7565;2095;6822;693;2534;485;1431;1178;3965
412000;201508;2205;5726;1734;4914;265;892;856;2178;1121;3070
412010;201508;693;2346;552;2016;102;389;119;413;221;802
412015;201508;651;1945;513;1647;103;348;239;765;342;1113
412020;201508;397;1136;269;856;56;205;103;297;159;502
412030;201508;701;2219;470;1664;76;297;111;352;187;649
412033;201508;728;2148;484;1545;80;289;119;341;199;630
412035;201508;995;2756;675;2150;153;524;242;748;395;1272
412040;201508;575;1824;457;1550;96;345;149;477;245;822
412050;201508;1631;4753;1248;3987;237;851;276;831;513;1682
412060;201508;6707;22986;6031;21551;1896;7268;1839;6513;3735;13781
412065;201508;878;2607;673;2150;143;503;195;557;338;1060
412070;201508;1206;3281;948;2752;159;498;327;921;486;1419
412080;201508;1328;4105;752;2707;112;464;34;73;146;537
412085;201508;378;1095;139;476;35;128;32;92;67;220
412090;201508;4092;13152;3849;12699;608;2231;2382;7908;2990;10139
412100;201508;1874;5860;1563;5186;447;1617;433;1377;880;2994
412110;201508;1055;3012;700;2238;157;544;169;526;326;1070
412120;201508;1821;6137;1559;5506;410;1633;569;1812;979;3445
412125;201508;679;2146;599;1989;118;417;239;760;357;1177
412130;201508;597;1781;431;1399;98;352;75;217;173;569
412135;201508;488;1370;331;1053;72;253;126;365;198;618
412140;201508;1593;4757;1285;4102;311;1065;285;864;596;1929
412150;201508;2857;8273;2426;7404;311;1103;1474;4376;1785;5479
412160;201508;1091;3472;661;2359;158;605;88;268;246;873
412170;201508;4365;13523;3479;11737;953;3497;1214;3873;2167;7370
412175;201508;1335;4559;1139;4101;301;1197;445;1570;746;2767
412180;201508;1610;4981;1180;4123;293;1173;313;1015;606;2188
412190;201508;3112;8943;2313;7480;575;2029;642;2147;1217;4176
412200;201508;2207;7021;1508;5207;301;1134;469;1599;770;2733
412210;201508;722;1986;409;1320;66;242;46;128;112;370
412215;201508;3686;11338;3329;10687;695;2244;1918;6359;2613;8603
412217;201508;1067;3043;955;2842;118;446;638;1760;756;2206
412220;201508;5477;18046;5194;17492;1539;5349;2537;8523;4076;13872
412230;201508;2717;8897;2314;8082;529;2078;653;2116;1182;4194
412240;201508;9378;24106;5160;16008;950;3327;934;2527;1884;5854
412250;201508;1873;5506;1587;4902;400;1365;316;837;716;2202
412260;201508;1298;3605;808;2532;117;428;277;781;394;1209
412265;201508;1042;3193;918;2975;212;806;416;1327;628;2133
412270;201508;789;2485;511;1774;98;380;133;436;231;816
412280;201508;618;1930;445;1545;194;720;42;137;236;857
412290;201508;1003;2887;773;2419;153;515;257;734;410;1249
412300;201508;1888;5696;1558;5035;444;1586;361;1113;805;2699
412310;201508;1044;3005;916;2810;126;450;494;1567;620;2017
412320;201508;804;2176;560;1731;117;421;184;545;301;966
412330;201508;1546;4386;1176;3610;188;650;600;1798;788;2448
412340;201508;901;2806;571;1935;81;296;84;256;165;552
412350;201508;2263;7021;1781;5905;396;1413;194;535;590;1948
412360;201508;285;849;178;577;24;90;60;164;84;254
412370;201508;830;2513;652;2156;162;591;162;502;324;1093
412380;201508;1573;4981;1299;4303;309;1098;376;1178;685;2276
412382;201508;672;1903;454;1434;89;288;101;274;190;562
412385;201508;2412;7482;2107;6783;680;2312;472;1432;1152;3744
412390;201508;2094;6037;1876;5664;488;1624;719;2206;1207;3830
412395;201508;835;2370;661;2066;88;307;389;1181;477;1488
412400;201508;914;2884;785;2605;236;828;201;677;437;1505
412402;201508;1892;5652;1503;4812;365;1317;332;889;697;2206
412405;201508;3616;10467;2207;7256;382;1450;216;584;598;2034
412410;201508;4393;13742;3719;12430;1137;4462;756;2289;1893;6751
412420;201508;361;1051;249;795;50;170;86;220;136;390
412430;201508;544;1520;400;1220;63;219;155;426;218;645
412440;201508;3361;10111;2714;8957;595;2162;943;3089;1538;5251
412450;201508;319;1021;240;820;41;136;21;47;62;183
412460;201508;788;2364;594;1946;142;527;132;378;274;905
412470;201508;1883;6401;1616;5703;527;1969;457;1629;984;3598
412480;201508;1304;3798;869;2834;165;564;109;273;274;837
412490;201508;863;2551;732;2277;139;458;211;609;350;1067
412500;201508;1930;5572;1590;4889;324;1127;406;1068;730;2195
412510;201508;2218;7319;1868;6446;531;1959;740;2513;1271;4472
412520;201508;1468;4169;1088;3342;265;862;243;686;508;1548
412530;201508;642;1863;490;1508;99;311;127;363;226;674
412535;201508;628;1857;396;1299;88;299;81;241;169;540
412540;201508;1207;3489;939;2936;143;521;274;828;417;1349
412545;201508;800;2274;605;1815;92;317;201;509;293;826
412550;201508;27918;83345;18546;61929;4646;16580;3448;10616;8094;27196
412555;201508;295;888;198;661;36;132;44;127;80;259
412560;201508;5218;16347;4059;13853;976;3847;963;2961;1939;6808
412570;201508;4310;12711;2902;9517;661;2448;543;1692;1204;4140
412575;201508;854;2592;657;2114;152;546;170;482;322;1028
412580;201508;1209;3316;862;2684;164;532;250;728;414;1260
412590;201508;402;1167;262;857;60;229;72;219;132;448
412600;201508;1417;4275;1087;3536;229;833;321;959;550;1792
412610;201508;697;2075;469;1483;103;371;142;402;245;773
412620;201508;1193;3809;930;3222;232;900;137;406;369;1306
412625;201508;10592;29545;7808;24096;1810;6063;1352;3737;3162;9800
412627;201508;913;2816;627;2145;167;608;66;201;233;809
412630;201508;3266;10371;2669;9065;581;2038;803;2589;1384;4627
412635;201508;466;1397;308;1031;78;271;15;40;93;311
412640;201508;890;2645;579;1911;98;341;56;151;154;492
412650;201508;1790;5260;1465;4601;307;1129;464;1250;771;2379
412660;201508;2807;8172;2127;6715;412;1440;398;1120;810;2560
412665;201508;632;1646;334;1053;91;293;62;190;153;483
412667;201508;1586;4682;1237;3964;304;1065;234;687;538;1752
412670;201508;540;1688;383;1313;108;428;68;183;176;611
412680;201508;1331;3980;819;2796;140;530;202;601;342;1131
412690;201508;732;2229;535;1787;176;625;103;341;279;966
412700;201508;1836;5644;1533;5167;508;1946;435;1416;943;3362
412710;201508;7356;22882;6012;20030;1369;5122;1424;4370;2793;9492
412720;201508;1401;4322;941;3137;161;580;178;482;339;1062
412730;201508;2166;6396;1320;4419;269;1002;169;418;438;1420
412740;201508;1416;4415;1052;3610;245;945;207;711;452;1656
412750;201508;3830;11902;3380;11116;539;2127;1976;6256;2515;8383
412760;201508;2213;7218;2095;7016;475;1840;1104;3527;1579;5367
412770;201508;11112;30479;6145;19617;934;3290;1119;3078;2053;6368
412780;201508;1251;3960;1077;3590;260;934;384;1212;644;2146
412785;201508;2300;6658;1691;5367;448;1538;728;2273;1176;3811
412788;201508;1391;4426;1216;4048;257;982;417;1206;674;2188
412790;201508;1110;3276;829;2694;170;611;197;554;367;1165
412795;201508;895;2494;727;2171;177;549;245;712;422;1261
412796;201508;2690;8338;2451;7856;629;2278;944;2798;1573;5076
412800;201508;3041;8685;2295;7110;426;1472;760;2229;1186;3701
412810;201508;10672;29170;5848;18472;874;3078;1232;3197;2106;6275
412820;201508;6968;20445;4988;16494;1188;4261;1061;3525;2249;7786
412830;201508;342;1050;267;875;44;177;82;229;126;406
412840;201508;1838;5240;1461;4466;276;928;311;852;587;1780
412850;201508;2621;7838;2216;7170;433;1655;884;2644;1317;4299
412853;201508;1619;4593;1427;4227;156;563;799;2175;955;2738
412855;201508;1478;4241;1128;3481;271;940;299;805;570;1745
412860;201508;1219;3483;990;3052;241;831;395;1162;636;1993
412862;201508;759;1957;508;1464;81;253;183;485;264;738
412863;201508;1177;3982;1137;3913;167;640;791;2683;958;3323
412865;201508;670;2054;498;1652;117;412;177;598;294;1010
412870;201508;890;2495;702;2175;228;776;138;381;366;1157
412880;201508;954;2678;723;2240;173;575;165;444;338;1019
420005;201508;538;1598;344;1146;57;202;125;397;182;599
420010;201508;3085;8926;2532;8132;365;1243;1757;5718;2122;6961
420020;201508;785;2511;436;1582;54;233;50;148;104;381
420030;201508;514;1352;260;865;52;204;44;137;96;341
420040;201508;760;2359;471;1729;105;416;63;158;168;574
420050;201508;659;1979;457;1529;142;500;158;508;300;1008
420055;201508;215;651;124;433;23;93;23;65;46;158
420060;201508;219;733;146;540;35;149;28;86;63;235
420070;201508;1431;4496;1089;3675;178;677;493;1653;671;2330
420075;201508;188;527;94;314;16;61;26;76;42;137
420080;201508;608;1888;470;1607;150;549;118;397;268;946
420090;201508;509;1709;349;1339;89;372;58;225;147;597
420100;201508;1196;3781;1076;3616;235;833;634;2131;869;2964
420110;201508;353;1174;308;1068;75;273;125;428;200;701
420120;201508;289;985;243;893;83;341;55;185;138;526
420125;201508;261;995;235;935;70;294;95;337;165;631
420127;201508;552;1635;210;773;59;227;28;97;87;324
420130;201508;1810;6029;1465;5326;353;1409;388;1243;741;2652
420140;201508;4856;14222;3315;11180;804;3031;553;1630;1357;4661
420150;201508;757;2090;443;1446;97;350;143;417;240;767
420160;201508;293;823;179;587;26;90;51;160;77;250
420165;201508;205;643;119;418;23;93;26;74;49;167
420170;201508;202;611;126;449;43;188;15;32;58;220
420180;201508;423;1301;235;852;43;166;46;163;89;329
420190;201508;468;1358;229;806;32;130;37;105;69;235
420195;201508;1333;3846;1040;3356;252;858;376;1190;628;2048
420200;201508;2923;9334;1774;6607;454;1927;266;850;720;2777
420205;201508;936;3046;807;2822;184;691;404;1421;588;2112
420207;201508;1538;4507;1046;3453;301;1130;236;695;537;1825
420208;201508;560;1551;311;1083;103;381;90;308;193;689
420209;201508;325;995;199;690;37;144;70;229;107;373
420210;201508;1551;4756;1007;3797;240;1074;272;971;512;2045
420213;201508;815;2913;770;2801;155;604;479;1757;634;2361
420215;201508;385;1251;255;921;72;289;40;128;112;417
420220;201508;172;575;141;511;31;131;50;150;81;281
420230;201508;4216;12334;3031;10135;609;2421;1297;4110;1906;6531
420240;201508;11467;31204;7020;22886;1122;4475;2964;8570;4086;13045
420243;201508;608;1850;476;1574;102;381;164;515;266;896
420245;201508;1122;3375;744;2549;151;575;197;594;348;1169
420250;201508;576;1839;538;1775;148;584;235;737;383;1321
420253;201508;538;1440;426;1283;70;223;235;732;305;955
420257;201508;331;935;211;708;39;137;105;347;144;484
420260;201508;1264;3968;1052;3587;236;911;455;1533;691;2444
420270;201508;546;1675;165;595;30;127;38;113;68;240
420280;201508;2398;6356;1411;4533;284;1067;496;1417;780;2484
420285;201508;146;428;59;215;6;19;4;17;10;36
420287;201508;544;1626;454;1464;130;418;154;503;284;921
420290;201508;6624;19459;4186;13834;842;3050;1199;3587;2041;6637
420300;201508;6575;19853;4186;14646;913;3481;741;2524;1654;6005
420310;201508;781;2197;711;2087;116;368;488;1386;604;1754
420315;201508;973;3111;758;2662;205;803;267;896;472;1699
420320;201508;5125;15653;4129;13824;1098;4016;1642;5395;2740;9411
420325;201508;271;890;250;838;52;201;110;349;162;550
420330;201508;1002;3453;730;2724;183;776;182;556;365;1332
420340;201508;1476;4538;1089;3640;240;888;182;519;422;1407
420350;201508;1468;4434;1129;3757;287;1023;408;1308;695;2331
420360;201508;3221;9716;2008;7001;477;1876;243;680;720;2556
420370;201508;1949;5449;1514;4653;156;492;1158;3517;1314;4009
420380;201508;5173;16200;3531;12294;870;3320;846;2813;1716;6133
420390;201508;1619;4511;816;2772;151;599;170;447;321;1046
420395;201508;1515;4638;998;3426;153;596;157;438;310;1034
420400;201508;1329;3842;905;2994;237;935;230;656;467;1591
420410;201508;770;2053;523;1640;123;428;290;887;413;1315
420415;201508;466;1473;337;1156;107;393;94;302;201;695
420417;201508;737;2349;607;2030;97;339;322;1087;419;1426
420419;201508;404;1228;259;937;107;432;37;127;144;559
420420;201508;10938;32762;8519;27909;2731;10027;2292;6797;5023;16824
420425;201508;1336;3619;844;2624;84;324;359;1020;443;1344
420430;201508;3295;9934;2088;7156;459;1719;705;2389;1164;4108
420435;201508;300;892;180;625;40;159;78;250;118;409
420440;201508;990;3035;580;1982;228;840;98;310;326;1150
420445;201508;375;1126;271;873;52;160;123;400;175;560
420450;201508;842;2525;526;1805;113;399;122;366;235;765
420455;201508;1965;5879;1684;5383;313;1223;791;2395;1104;3618
420460;201508;8647;25163;6340;21002;1429;5526;2470;7724;3899;13250
420470;201508;1128;3059;696;2198;161;588;189;522;350;1110
420475;201508;126;371;63;218;19;66;11;32;30;98
420480;201508;4660;13605;3429;11199;1148;4185;534;1634;1682;5819
420490;201508;713;1871;385;1296;100;365;99;308;199;673
420500;201508;1683;5310;1281;4513;382;1521;515;1723;897;3244
420510;201508;108;427;94;397;36;152;36;147;72;299
420515;201508;118;400;95;353;15;67;17;64;32;131
420517;201508;920;2804;785;2554;127;467;411;1274;538;1741
420519;201508;536;1396;368;1095;58;181;109;304;167;485
420520;201508;678;1694;425;1330;88;299;170;475;258;774
420530;201508;1082;3529;793;2824;175;714;195;562;370;1276
420535;201508;279;821;151;538;36;150;11;31;47;181
420540;201508;21106;60349;14674;46337;3721;12892;3992;11110;7713;24002
420543;201508;411;1077;301;894;26;90;192;610;218;700
420545;201508;1573;4920;1245;4200;289;1104;417;1287;706;2391
420550;201508;4207;13358;3076;10843;731;3062;643;1908;1374;4970
420555;201508;405;1239;316;1054;90;336;104;316;194;652
420560;201508;539;1558;438;1364;75;254;219;661;294;915
420570;201508;2037;6525;1560;5382;415;1630;492;1561;907;3191
420580;201508;1326;4108;1040;3598;268;1049;429;1422;697;2471
420590;201508;3252;9797;2100;7097;432;1583;331;965;763;2548
420600;201508;817;2675;735;2500;131;464;379;1343;510;1807
420610;201508;531;1639;300;1107;83;346;69;240;152;586
420620;201508;771;2300;637;2060;194;670;199;635;393;1305
420630;201508;1034;3168;700;2377;156;559;220;654;376;1213
420640;201508;754;2292;355;1314;83;342;24;73;107;415
420650;201508;2527;7284;1471;4995;269;1045;305;881;574;1926
420660;201508;482;1395;382;1198;69;248;178;539;247;787
420665;201508;735;2057;455;1499;80;280;129;373;209;653
420670;201508;1639;4866;1109;3716;216;847;250;713;466;1560
420675;201508;213;654;146;496;29;105;49;151;78;256
420680;201508;512;1211;295;877;49;167;96;260;145;427
420690;201508;888;3046;625;2296;113;430;144;488;257;918
420700;201508;3717;10651;2784;8745;618;2257;852;2481;1470;4738
420710;201508;585;1950;449;1672;131;545;148;517;279;1062
420720;201508;1674;4827;1317;4338;313;1106;748;2465;1061;3571
420730;201508;3337;9953;2678;8738;684;2461;1060;3293;1744;5754
420740;201508;856;2633;690;2311;214;768;302;969;516;1737
420750;201508;2377;7487;1600;5628;287;1191;476;1447;763;2638
420757;201508;104;250;48;160;8;37;22;68;30;105
420760;201508;351;1069;216;709;46;178;56;150;102;328
420765;201508;576;1786;284;1047;54;225;48;151;102;376
420768;201508;1157;4030;885;3413;288;1168;288;1090;576;2258
420770;201508;667;1906;342;1205;71;295;81;261;152;556
420775;201508;669;2027;383;1297;97;347;74;224;171;571
420780;201508;1580;4726;945;3147;210;745;178;525;388;1270
420785;201508;314;936;223;704;33;114;63;173;96;287
420790;201508;1287;4384;994;3674;278;1141;387;1335;665;2476
420800;201508;819;2350;427;1425;115;448;98;292;213;740
420810;201508;2192;7428;1680;6213;517;2179;395;1335;912;3514
420820;201508;8080;24307;5508;19785;1449;5904;1456;5107;2905;11011
420830;201508;2557;8110;2105;7267;684;2571;721;2429;1405;5000
420840;201508;1048;3100;555;2005;131;531;117;362;248;893
420845;201508;1323;4013;943;3297;268;1097;224;702;492;1799
420850;201508;1722;5372;1001;3777;244;1050;131;452;375;1502
420860;201508;470;1312;291;965;76;297;107;334;183;631
420870;201508;1158;3234;891;2796;286;1050;271;732;557;1782
420880;201508;1053;3455;789;2775;173;681;178;539;351;1220
420890;201508;13241;32302;5649;18019;993;3547;1402;3721;2395;7268
420895;201508;243;663;122;397;33;103;12;34;45;137
420900;201508;2096;5804;1213;4051;249;969;301;886;550;1855
420910;201508;22594;67211;14516;50401;2900;11428;4066;13030;6966;24458
420915;201508;546;2131;416;1755;99;450;193;776;292;1226
420917;201508;463;1417;210;676;49;190;83;214;132;404
420920;201508;186;511;74;249;19;68;14;45;33;113
420930;201508;18783;53625;14452;46161;3450;12234;5041;15438;8491;27672
420940;201508;3226;9643;2481;8053;682;2510;395;980;1077;3490
420945;201508;206;661;131;481;27;123;32;108;59;231
420950;201508;619;1732;271;1007;35;165;39;123;74;288
420960;201508;980;2754;783;2406;168;599;365;1042;533;1641
420970;201508;2480;7845;2096;7133;585;2261;670;2184;1255;4445
420980;201508;464;1349;337;1136;108;396;119;445;227;841
420985;201508;512;1465;249;889;50;217;66;213;116;430
420990;201508;909;2488;511;1739;98;374;141;419;239;793
421000;201508;586;1992;371;1421;72;290;66;212;138;502
421003;201508;707;1926;258;851;28;90;42;84;70;174
421005;201508;194;587;150;512;34;124;81;277;115;401
421010;201508;5784;16526;3924;13071;1016;3842;909;2668;1925;6510
421020;201508;479;1496;358;1261;49;176;189;695;238;871
421030;201508;797;2912;744;2778;219;884;160;574;379;1458
421040;201508;727;2037;560;1757;120;422;279;833;399;1255
421050;201508;1658;4604;976;3168;210;763;228;605;438;1368
421055;201508;224;645;125;404;28;98;32;81;60;179
421060;201508;480;1646;331;1214;69;277;121;421;190;698
421070;201508;746;2369;473;1683;108;437;101;327;209;764
421080;201508;531;1583;449;1451;94;307;277;887;371;1194
421085;201508;574;1509;296;1006;63;247;82;286;145;533
421090;201508;373;1054;208;685;33;117;80;221;113;338
421100;201508;895;2528;521;1708;147;491;92;268;239;759
421105;201508;1484;4527;1217;4052;280;1015;454;1511;734;2526
421110;201508;1046;3782;949;3546;341;1362;224;772;565;2134
421120;201508;1435;4530;949;3321;155;637;298;912;453;1549
421125;201508;417;1175;302;966;86;316;95;267;181;583
421130;201508;3293;10675;2718;9604;877;3478;924;3210;1801;6688
421140;201508;357;1053;271;862;52;169;95;280;147;449
421145;201508;566;1783;371;1247;60;229;138;440;198;669
421150;201508;522;1584;377;1333;79;316;153;527;232;843
421160;201508;1256;3509;610;2042;107;414;221;704;328;1118
421165;201508;284;976;218;775;35;121;102;367;137;488
421170;201508;1409;4132;1128;3661;226;812;689;2218;915;3030
421175;201508;1234;3500;903;2951;208;854;337;984;545;1838
421180;201508;602;1658;309;1032;71;274;75;207;146;481
421185;201508;406;1126;282;888;53;153;140;461;193;614
421187;201508;292;867;213;696;38;132;99;305;137;437
421189;201508;424;1302;366;1187;74;268;129;384;203;652
421190;201508;11641;33585;6934;23700;1527;5679;1325;4166;2852;9845
421200;201508;945;3101;792;2762;176;681;232;723;408;1404
421205;201508;259;796;185;649;41;166;41;120;82;286
421210;201508;1649;4983;1223;3924;320;1098;319;956;639;2054
421220;201508;2060;6931;1766;6270;522;2041;410;1357;932;3398
421223;201508;622;1913;466;1599;115;422;171;567;286;989
421225;201508;1101;3454;909;3066;216;823;332;1085;548;1908
421227;201508;819;2736;716;2567;159;599;425;1520;584;2119
421230;201508;468;1486;413;1378;101;384;199;616;300;1000
421240;201508;457;1458;254;895;35;150;44;127;79;277
421250;201508;1762;5023;1084;3777;307;1191;255;826;562;2017
421260;201508;369;1032;95;348;21;75;24;80;45;155
421265;201508;628;1999;539;1831;124;444;212;704;336;1148
421270;201508;813;2182;401;1332;91;317;91;332;182;649
421280;201508;1580;4955;1251;4409;391;1550;422;1435;813;2985
421290;201508;1624;4223;824;2634;156;543;171;447;327;990
421300;201508;305;921;240;784;67;246;92;284;159;530
421310;201508;270;848;209;693;48;162;76;240;124;402
421315;201508;399;1185;222;801;41;155;22;78;63;233
421320;201508;545;1747;339;1205;58;218;41;96;99;314
421330;201508;558;1835;423;1571;146;625;71;247;217;872
421335;201508;565;1850;447;1614;105;422;90;331;195;753
421340;201508;1765;5046;1409;4466;197;782;850;2620;1047;3402
421350;201508;921;3033;736;2623;162;675;273;885;435;1560
421360;201508;3147;9014;1945;6657;392;1540;546;1679;938;3219
421370;201508;767;2536;597;2158;169;691;188;635;357;1326
421380;201508;1001;2833;789;2416;143;503;382;1134;525;1637
421390;201508;144;423;75;259;11;35;35;128;46;163
421400;201508;250;879;186;733;48;200;60;222;108;422
421410;201508;317;906;214;700;31;102;103;327;134;429
421415;201508;355;1168;158;581;37;152;37;114;74;266
421420;201508;923;2789;647;2148;132;482;180;523;312;1005
421430;201508;241;747;176;617;34;132;40;137;74;269
421440;201508;873;2479;556;1894;138;533;226;723;364;1256
421450;201508;489;1508;298;1102;72;293;34;119;106;412
421460;201508;634;1714;309;1090;51;213;72;243;123;456
421470;201508;451;1525;357;1309;96;379;129;463;225;842
421480;201508;2898;8267;1711;5999;376;1550;350;1041;726;2591
421490;201508;285;861;123;464;30;123;24;81;54;204
421500;201508;2302;7751;1901;6883;648;2644;349;1171;997;3815
421505;201508;376;1250;328;1142;67;251;160;545;227;796
421507;201508;568;1721;354;1239;66;243;117;426;183;669
421510;201508;190;620;163;573;31;142;81;238;112;380
421520;201508;862;2292;554;1656;54;196;259;688;313;884
421530;201508;407;1255;233;860;35;165;75;269;110;434
421535;201508;714;2103;399;1433;71;293;171;559;242;852
421540;201508;371;1019;296;880;62;203;120;336;182;539
421545;201508;910;2961;655;2436;178;765;165;563;343;1328
421550;201508;1942;6242;1616;5628;479;1918;441;1379;920;3297
421555;201508;339;1019;119;433;18;70;17;58;35;128
421560;201508;205;620;87;309;22;90;20;69;42;159
421565;201508;952;2816;839;2638;296;1051;331;1000;627;2051
421567;201508;774;2804;669;2551;334;1330;146;532;480;1862
421568;201508;520;1631;350;1229;85;303;86;310;171;613
421569;201508;188;583;107;393;27;111;24;70;51;181
421570;201508;1324;4019;676;2418;180;713;125;417;305;1130
421575;201508;476;1565;413;1440;67;253;265;924;332;1177
421580;201508;3491;10836;2585;8802;653;2569;612;1776;1265;4345
421590;201508;232;723;184;627;26;89;96;322;122;411
421600;201508;586;1745;438;1435;117;414;89;258;206;672
421605;201508;601;1834;430;1486;77;304;111;346;188;650
421610;201508;1457;3930;1131;3371;161;560;639;1814;800;2374
421620;201508;4643;14008;3106;10729;885;3263;942;3234;1827;6497
421625;201508;377;1079;160;554;30;110;27;89;57;199
421630;201508;2880;8589;1533;5277;354;1362;206;596;560;1958
421635;201508;268;802;157;518;22;87;77;231;99;318
421640;201508;1059;3164;795;2619;163;564;334;1047;497;1611
421650;201508;2073;6722;1633;5728;509;2034;258;757;767;2791
421660;201508;7923;25485;6297;22049;1623;6416;2014;6478;3637;12894
421670;201508;1093;3371;745;2576;221;843;196;645;417;1488
421680;201508;1191;3896;1008;3470;338;1235;198;633;536;1868
421690;201508;1809;5860;1336;4697;281;1089;189;574;470;1663
421700;201508;516;1591;297;1022;54;225;88;219;142;444
421710;201508;238;801;129;473;43;163;38;135;81;298
421715;201508;277;744;147;470;41;143;43;122;84;265
421720;201508;1837;5496;1163;4096;327;1260;240;764;567;2024
421725;201508;109;358;94;322;30;111;25;83;55;194
421730;201508;582;1682;263;914;47;180;55;150;102;330
421740;201508;741;2326;492;1721;106;449;101;259;207;708
421750;201508;1082;2936;682;2143;131;449;309;891;440;1340
421755;201508;335;977;215;681;48;177;70;199;118;376
421760;201508;674;2162;357;1287;71;283;115;391;186;674
421770;201508;3087;9191;2294;7568;650;2282;730;2401;1380;4683
421775;201508;574;1679;386;1330;81;299;115;374;196;673
421780;201508;1340;4397;992;3600;261;1074;367;1235;628;2309
421790;201508;891;2382;493;1700;124;498;147;451;271;949
421795;201508;347;1015;212;674;35;132;61;187;96;319
421800;201508;2641;7893;1959;6572;421;1631;800;2472;1221;4103
421810;201508;638;2008;451;1614;113;432;60;199;173;631
421820;201508;1118;3225;690;2328;118;446;160;479;278;925
421825;201508;1427;4601;1311;4326;193;757;774;2424;967;3181
421830;201508;2451;8357;2229;7913;506;2064;1046;3546;1552;5610
421835;201508;149;431;107;368;23;106;63;199;86;305
421840;201508;356;1142;269;938;70;282;88;273;158;555
421850;201508;435;1327;263;912;59;243;74;248;133;491
421860;201508;349;1051;215;760;36;135;44;138;80;273
421870;201508;4411;12439;2978;9504;827;2853;602;1847;1429;4700
421875;201508;438;1296;186;689;40;167;27;89;67;256
421880;201508;912;2816;677;2296;155;592;172;538;327;1130
421885;201508;313;984;246;851;81;306;81;257;162;563
421890;201508;932;3116;788;2824;249;1026;255;866;504;1892
421895;201508;365;1201;322;1120;77;268;174;628;251;896
421900;201508;868;2525;588;1925;161;577;154;427;315;1004
421910;201508;534;1689;363;1297;74;314;95;285;169;599
421915;201508;565;1686;360;1195;71;240;94;271;165;511
421917;201508;577;1705;419;1442;126;521;123;382;249;903
421920;201508;808;2250;525;1859;235;891;156;530;391;1421
421930;201508;3326;8851;1894;6262;460;1712;346;1008;806;2720
421935;201508;711;2322;514;1873;104;439;183;617;287;1056
421940;201508;275;930;137;516;26;112;21;59;47;171
421950;201508;3851;10642;1887;6404;471;1700;315;1052;786;2752
421960;201508;226;684;173;567;44;161;40;110;84;271
421970;201508;2242;6359;1404;4557;485;1671;311;902;796;2573
421985;201508;519;1335;276;839;46;174;76;234;122;408
422000;201508;994;2959;810;2612;198;693;328;1078;526;1771
430003;201508;845;2481;654;2141;182;676;193;605;375;1281
430005;201508;287;909;237;807;45;163;123;400;168;563
430010;201508;2125;5744;1546;4738;399;1289;616;1900;1015;3189
430020;201508;752;1887;619;1700;67;207;429;1138;496;1345
430030;201508;1068;2779;784;2266;258;821;152;388;410;1209
430040;201508;11678;30182;8996;25556;2619;7961;2102;5642;4721;13603
430045;201508;746;2004;577;1660;120;359;273;764;393;1123
430047;201508;278;685;158;476;21;54;66;200;87;254
430050;201508;1210;3265;683;2176;127;427;180;535;307;962
430055;201508;305;824;165;513;27;98;70;199;97;297
430057;201508;69;155;24;66;5;13;5;8;10;21
430060;201508;16007;51285;13731;47165;3762;13696;6043;21016;9805;34712
430063;201508;999;2926;799;2506;198;654;407;1294;605;1948
430064;201508;1526;4471;1239;3961;308;1008;526;1681;834;2689
430066;201508;171;415;123;337;10;35;71;183;81;218
430070;201508;606;1624;222;707;50;182;54;132;104;314
430080;201508;693;1984;428;1460;86;329;126;382;212;711
430085;201508;832;2182;541;1671;118;401;190;590;308;991
430087;201508;1052;3177;979;3052;132;468;654;1957;786;2425
430090;201508;888;2344;323;1069;33;123;52;175;85;298
430100;201508;882;2308;501;1515;121;404;157;408;278;812
430105;201508;944;2805;635;2204;175;681;191;637;366;1318
430107;201508;270;893;194;675;38;149;56;178;94;327
430110;201508;1894;5414;1540;4833;433;1406;621;1915;1054;3321
430120;201508;1707;5048;1282;4147;258;878;651;2053;909;2931
430130;201508;3841;10039;3303;9243;696;2117;1523;4150;2219;6267
430140;201508;1233;3724;839;2847;232;805;263;869;495;1674
430150;201508;822;2183;538;1644;133;444;141;415;274;859
430155;201508;441;1252;261;870;36;131;104;334;140;465
430160;201508;16461;48092;14705;45115;2884;9716;7476;22862;10360;32578
430163;201508;1871;5521;1518;4860;264;935;730;2330;994;3265
430165;201508;459;1129;134;440;23;80;34;105;57;185
430170;201508;940;2620;361;1269;54;185;45;132;99;317
430175;201508;954;2979;764;2521;203;622;312;1117;515;1739
430180;201508;903;2439;729;2143;165;544;387;1086;552;1630
430185;201508;689;1725;351;1069;52;169;108;277;160;446
430187;201508;680;2003;509;1630;115;430;183;544;298;974
430190;201508;1732;5130;1485;4647;296;1055;832;2549;1128;3604
430192;201508;199;602;89;283;6;19;21;59;27;78
430195;201508;335;1017;82;280;9;33;5;16;14;49
430200;201508;1519;4820;1269;4278;384;1369;304;1004;688;2373
430205;201508;537;1542;406;1302;46;178;284;897;330;1075
430210;201508;6554;17461;3497;10983;672;2284;747;2122;1419;4406
430215;201508;378;1045;250;768;48;147;95;275;143;422
430220;201508;764;1899;282;918;43;147;53;168;96;315
430222;201508;307;905;234;740;37;147;107;312;144;459
430223;201508;346;992;297;919;67;209;175;559;242;768
430225;201508;40;106;20;63;5;13;7;18;12;31
430230;201508;1814;5268;1687;5139;194;452;1457;4617;1651;5069
430235;201508;287;936;223;778;55;209;61;192;116;401
430237;201508;532;1390;391;1138;45;152;243;685;288;837
430240;201508;996;2588;651;1985;138;497;258;722;396;1219
430245;201508;918;2845;696;2371;180;635;314;1097;494;1732
430250;201508;1278;3618;1102;3300;414;1313;237;690;651;2003
430258;201508;169;477;122;391;13;47;52;171;65;218
430260;201508;849;2387;571;1827;61;203;300;999;361;1202
430265;201508;318;962;240;796;52;166;21;59;73;225
430270;201508;2953;8202;2510;7460;387;1363;1428;4006;1815;5369
430280;201508;4600;12624;3734;11031;883;2716;1655;4850;2538;7566
430290;201508;2439;6403;2230;6115;161;470;1916;5288;2077;5758
430300;201508;9363;27487;7561;23994;1993;6753;3073;9968;5066;16721
430310;201508;6504;19620;5083;16853;1301;4750;1851;5686;3152;10436
430320;201508;868;2507;554;1855;103;289;272;975;375;1264
430330;201508;744;1965;571;1629;161;467;236;617;397;1084
430340;201508;772;1935;423;1392;71;261;210;691;281;952
430350;201508;6197;19026;5179;16854;1790;6075;1675;5332;3465;11407
430355;201508;376;942;144;445;30;98;18;47;48;145
430360;201508;1094;2850;898;2484;178;568;402;1009;580;1577
430367;201508;263;687;162;505;42;149;58;172;100;321
430370;201508;512;1467;381;1206;107;377;90;251;197;628
430380;201508;875;2238;453;1451;130;459;127;394;257;853
430390;201508;4292;12118;2868;9164;648;2207;613;1849;1261;4056
430400;201508;1441;3441;986;2722;314;933;338;852;652;1785
430410;201508;688;1824;498;1504;95;301;233;694;328;995
430420;201508;3869;11088;2940;9028;776;2456;1197;3607;1973;6063
430430;201508;777;2071;467;1494;133;461;120;370;253;831
430435;201508;2045;5505;1534;4577;342;1106;696;2028;1038;3134
430440;201508;4105;12812;3173;10689;648;2306;1443;4978;2091;7284
430450;201508;7788;21590;6009;18092;2054;6514;1342;4042;3396;10556
430460;201508;29038;85080;21793;71826;5902;21342;6933;22413;12835;43755
430461;201508;529;1414;159;504;24;77;31;88;55;165
430462;201508;312;895;228;746;80;285;56;166;136;451
430463;201508;4081;12895;3489;11762;767;2807;1679;5722;2446;8529
430465;201508;641;1720;529;1525;151;483;258;709;409;1192
430466;201508;3582;9883;3143;9184;595;1925;1808;5143;2403;7068
430467;201508;560;1643;482;1507;98;347;222;650;320;997
430468;201508;1434;4000;1228;3688;386;1262;430;1231;816;2493
430469;201508;315;890;65;232;7;32;11;30;18;62
430470;201508;7649;20335;5291;16258;1540;5141;935;2707;2475;7848
430471;201508;669;2182;587;2005;177;621;149;524;326;1145
430480;201508;1100;2870;552;1751;88;317;137;373;225;690
430485;201508;226;645;104;350;17;60;33;110;50;170
430490;201508;388;1065;246;791;53;193;103;328;156;521
430495;201508;400;1179;247;859;46;170;50;162;96;332
430500;201508;1270;3506;1029;3091;298;999;438;1264;736;2263
430510;201508;20295;59611;16242;51840;5537;19414;4568;13490;10105;32904
430511;201508;434;1323;179;627;18;76;26;70;44;146
430512;201508;1202;3089;1019;2768;252;721;357;1016;609;1737
430513;201508;754;2048;469;1431;96;295;186;565;282;860
430515;201508;502;1466;364;1171;63;212;184;596;247;808
430517;201508;1245;3894;1027;3443;208;713;585;1968;793;2681
430520;201508;1644;4546;1142;3507;293;978;376;1057;669;2035
430530;201508;1071;2950;528;1703;81;300;136;399;217;699
430535;201508;2145;6489;1625;5409;360;1354;595;1888;955;3242
430537;201508;492;1559;418;1405;49;165;300;1018;349;1183
430540;201508;768;1704;509;1352;87;240;298;784;385;1024
430543;201508;519;1334;454;1267;86;255;318;901;404;1156
430544;201508;690;2170;573;1922;110;394;301;986;411;1380
430545;201508;1311;4180;1120;3942;372;1374;480;1758;852;3132
430550;201508;681;1954;430;1405;88;325;135;416;223;741
430558;201508;83;244;42;148;13;59;8;20;21;79
430560;201508;428;1059;245;739;27;91;81;231;108;322
430570;201508;1164;2992;731;2129;188;647;277;672;465;1319
430580;201508;1305;3317;741;2337;178;611;254;793;432;1404
430583;201508;166;460;56;188;4;18;5;17;9;35
430585;201508;359;929;225;643;55;182;98;246;153;428
430587;201508;216;656;187;601;58;196;56;183;114;379
430590;201508;1303;3664;1229;3541;177;532;859;2454;1036;2986
430593;201508;29;111;26;100;7;35;11;36;18;71
430595;201508;260;714;88;306;13;55;16;52;29;107
430597;201508;347;1009;243;764;37;131;71;187;108;318
430600;201508;2189;5896;1238;3777;237;772;402;1167;639;1939
430605;201508;1368;4124;1071;3521;239;903;420;1381;659;2284
430607;201508;768;1889;557;1567;82;249;348;999;430;1248
430610;201508;8575;22704;6406;19225;1724;5602;2063;6112;3787;11714
430613;201508;266;648;112;334;27;76;22;53;49;129
430620;201508;754;2164;582;1800;145;475;232;673;377;1148
430630;201508;470;1441;227;754;39;128;31;83;70;211
430632;201508;736;2017;414;1285;70;248;174;482;244;730
430635;201508;711;1944;506;1544;104;353;243;725;347;1078
430637;201508;506;1442;441;1310;63;223;280;783;343;1006
430640;201508;1745;4592;759;2451;75;246;87;171;162;417
430642;201508;490;1296;296;931;52;177;118;356;170;533
430645;201508;253;608;96;275;17;48;22;67;39;115
430650;201508;1875;6081;1605;5539;342;1194;897;3166;1239;4360
430655;201508;173;476;144;417;30;102;68;168;98;270
430660;201508;5723;16125;4456;13875;1135;3848;1782;5484;2917;9332
430670;201508;505;1474;455;1376;38;115;349;1092;387;1207
430673;201508;698;1653;348;1047;77;238;130;386;207;624
430675;201508;276;796;111;356;17;60;46;144;63;204
430676;201508;3544;10600;2935;9511;798;2790;977;3161;1775;5951
430680;201508;1231;3530;771;2515;146;521;226;645;372;1166
430690;201508;4391;12313;3431;10414;1069;3343;969;2951;2038;6294
430692;201508;294;960;211;788;22;91;134;495;156;586
430693;201508;1375;3795;888;2776;155;566;253;715;408;1281
430695;201508;550;1559;382;1207;76;278;150;422;226;700
430697;201508;479;1343;362;1137;95;292;129;427;224;719
430700;201508;9991;25759;4633;15208;821;3014;323;991;1144;4005
430705;201508;283;849;243;777;83;294;59;156;142;450
430710;201508;1847;4664;1357;3831;297;911;538;1528;835;2439
430720;201508;922;2252;603;1788;134;425;206;601;340;1026
430730;201508;1718;4535;1173;3630;306;929;446;1444;752;2373
430740;201508;577;1602;327;1091;88;313;57;182;145;495
430745;201508;520;1484;268;853;48;168;43;121;91;289
430750;201508;1696;4623;1324;3973;258;861;654;1865;912;2726
430755;201508;579;1527;366;1065;40;133;159;409;199;542
430760;201508;3197;7767;2190;6272;450;1494;957;2824;1407;4318
430770;201508;6774;19395;5157;16347;985;3413;2607;8143;3592;11556
430780;201508;2533;6699;1460;4615;297;1017;450;1362;747;2379
430781;201508;594;1713;398;1311;86;292;119;372;205;664
430783;201508;560;1371;362;1041;65;212;168;446;233;658
430786;201508;79;258;54;191;8;31;24;81;32;112
430790;201508;4747;12907;3188;9737;709;2415;1166;3254;1875;5669
430800;201508;876;2540;581;1841;126;435;197;588;323;1023
430805;201508;545;1510;357;1132;47;144;180;590;227;734
430807;201508;432;1235;284;892;60;216;78;231;138;447
430810;201508;798;2147;370;1202;58;209;77;217;135;426
430820;201508;1286;3940;851;2858;183;667;242;778;425;1445
430825;201508;412;1080;169;512;34;103;43;107;77;210
430830;201508;2078;6242;1903;5974;262;891;1290;4036;1552;4927
430840;201508;983;3003;885;2816;226;732;418;1375;644;2107
430843;201508;103;297;50;164;10;39;17;51;27;90
430845;201508;345;1031;278;893;108;372;25;68;133;440
430850;201508;2632;7703;2195;6869;514;1743;863;2632;1377;4375
430860;201508;1018;2727;514;1675;144;549;150;443;294;992
430865;201508;678;1779;611;1674;213;612;282;744;495;1356
430870;201508;709;1982;383;1265;96;318;73;206;169;524
430880;201508;1295;3624;929;2899;267;898;243;781;510;1679
430885;201508;243;595;139;436;18;61;85;266;103;327
430890;201508;1821;4763;1244;3651;155;559;409;1065;564;1624
430900;201508;2931;7718;2426;6830;523;1743;1164;3013;1687;4756
430905;201508;1061;2983;643;2077;161;567;152;464;313;1031
430910;201508;1567;4602;1102;3617;258;941;436;1304;694;2245
430912;201508;500;1407;392;1214;54;196;244;736;298;932
430915;201508;544;1726;374;1380;115;444;92;365;207;809
430920;201508;15321;46546;13482;43032;3005;10514;7582;23509;10587;34023
430925;201508;106;262;55;168;16;55;25;74;41;129
430930;201508;9554;27420;6545;21501;1764;6248;1754;5872;3518;12120
430940;201508;1224;3694;731;2459;127;471;170;515;297;986
430950;201508;1122;3091;739;2284;171;599;278;761;449;1360
430955;201508;144;428;65;206;14;49;22;70;36;119
430957;201508;268;882;215;781;54;212;95;346;149;558
430960;201508;1371;3702;1125;3263;313;1011;468;1381;781;2392
430965;201508;1510;4350;1280;3952;93;349;969;2929;1062;3278
430970;201508;543;1511;315;1020;65;225;85;266;150;491
430975;201508;635;2029;481;1661;83;315;237;818;320;1133
430980;201508;441;1104;266;834;61;209;95;272;156;481
430990;201508;624;1971;454;1550;112;403;100;311;212;714
430995;201508;634;1845;509;1588;181;596;164;481;345;1077
431000;201508;1731;4388;847;2598;154;551;96;235;250;786
431010;201508;2746;7673;1610;5332;309;1134;364;1032;673;2166
431020;201508;12238;29988;7687;21742;1936;5614;2110;5918;4046;11532
431030;201508;365;1060;179;624;44;180;34;115;78;295
431033;201508;2411;7008;2105;6541;522;1736;1031;3271;1553;5007
431036;201508;209;532;80;272;15;53;17;46;32;99
431040;201508;980;2780;770;2425;173;621;364;1098;537;1719
431041;201508;546;1479;489;1398;159;464;193;565;352;1029
431043;201508;383;1224;271;959;114;443;69;201;183;644
431046;201508;117;333;81;253;11;40;28;83;39;123
431050;201508;1794;4504;1367;3792;273;856;795;2148;1068;3004
431053;201508;619;1990;503;1733;146;559;122;416;268;975
431055;201508;682;1856;632;1771;52;156;483;1352;535;1508
431057;201508;398;1162;239;821;52;188;60;193;112;381
431060;201508;5752;16762;5219;16002;1575;4757;2476;7910;4051;12667
431065;201508;552;1567;413;1280;71;245;189;543;260;788
431070;201508;753;2172;434;1429;92;313;77;211;169;524
431075;201508;296;898;205;701;32;114;59;210;91;324
431080;201508;641;2000;511;1717;104;390;126;392;230;782
431085;201508;902;2423;701;2021;109;335;397;1127;506;1462
431087;201508;620;1743;534;1574;67;191;359;1073;426;1264
431090;201508;544;1319;249;755;68;203;53;159;121;362
431100;201508;3821;10576;3044;9220;776;2519;1099;3352;1875;5871
431110;201508;1583;4168;1163;3324;251;761;496;1325;747;2086
431112;201508;597;1889;551;1799;153;503;257;813;410;1316
431113;201508;526;1538;402;1282;109;367;114;377;223;744
431115;201508;1407;4038;1221;3713;233;748;717;2174;950;2922
431120;201508;2711;8342;2110;7126;624;2417;712;2173;1336;4590
431123;201508;500;1427;352;1144;74;257;193;638;267;895
431125;201508;1366;4138;995;3338;304;1015;246;889;550;1904
431127;201508;246;651;50;162;4;9;5;14;9;23
431130;201508;3518;9937;2559;8169;521;1856;911;2847;1432;4703
431140;201508;4593;11304;2417;7544;410;1415;570;1520;980;2935
431142;201508;484;1429;435;1336;43;137;306;955;349;1092
431150;201508;1169;3465;879;2881;190;695;330;1059;520;1754
431160;201508;982;2854;823;2531;142;433;412;1369;554;1802
431162;201508;524;1374;234;792;31;135;28;64;59;199
431164;201508;168;464;42;151;8;30;3;12;11;42
431170;201508;790;2162;536;1686;143;491;156;464;299;955
431171;201508;834;2449;700;2180;236;779;193;574;429;1353
431173;201508;495;1430;427;1314;106;351;242;738;348;1089
431175;201508;1089;3022;925;2755;280;878;315;913;595;1791
431177;201508;906;2900;733;2551;238;936;304;1010;542;1946
431179;201508;371;810;88;257;11;39;23;56;34;95
431180;201508;2298;6597;1582;5087;387;1323;383;1114;770;2437
431190;201508;736;1901;365;1168;64;232;84;254;148;486
431198;201508;379;1249;332;1156;136;492;85;313;221;805
431200;201508;393;1105;107;371;18;54;3;10;21;64
431205;201508;302;906;145;491;35;115;46;155;81;270
431210;201508;768;2073;641;1851;177;503;327;972;504;1475
431213;201508;253;766;203;670;39;155;90;283;129;438
431215;201508;331;965;166;559;25;77;12;26;37;103
431217;201508;200;611;150;499;42;146;50;167;92;313
431220;201508;956;2551;590;1795;74;242;281;781;355;1023
431225;201508;1346;3796;1080;3321;231;747;550;1671;781;2418
431230;201508;887;2546;652;2062;81;273;341;1036;422;1309
431235;201508;109;308;31;96;5;16;6;14;11;30
431237;201508;505;1482;394;1317;104;412;191;619;295;1031
431238;201508;45;145;36;124;9;37;11;36;20;73
431240;201508;3005;8974;2611;8337;867;2975;799;2532;1666;5507
431242;201508;374;1180;327;1087;96;324;108;375;204;699
431244;201508;415;975;252;701;40;134;131;332;171;466
431245;201508;1156;3011;829;2411;126;391;468;1328;594;1719
431247;201508;195;552;140;441;46;150;31;92;77;242
431250;201508;1590;4971;1362;4638;368;1342;594;2032;962;3374
431260;201508;356;990;175;601;32;128;59;184;91;312
431261;201508;238;825;206;752;37;168;67;215;104;383
431262;201508;412;1116;179;587;23;97;78;250;101;347
431265;201508;1478;3846;805;2448;150;506;201;487;351;993
431267;201508;168;465;133;402;27;97;74;209;101;306
431270;201508;2765;6988;1834;5462;477;1583;651;1905;1128;3488
431275;201508;228;697;119;438;36;133;11;36;47;169
431280;201508;311;863;126;419;17;66;31;77;48;143
431290;201508;326;1019;246;832;63;245;55;164;118;409
431295;201508;102;273;55;162;4;14;27;73;31;87
431300;201508;371;923;47;178;5;20;1;6;6;26
431301;201508;268;823;122;411;29;103;23;67;52;170
431303;201508;767;2021;443;1341;69;252;137;373;206;625
431306;201508;2279;5949;1494;4516;170;607;470;1231;640;1838
431308;201508;45;153;40;136;23;83;12;39;35;122
431310;201508;819;2433;484;1658;98;337;142;505;240;842
431320;201508;930;2519;485;1585;97;349;115;342;212;691
431330;201508;2804;6883;1279;4052;335;1197;116;319;451;1516
431333;201508;454;1217;195;601;26;88;53;142;79;230
431335;201508;64;195;49;161;15;48;11;25;26;73
431337;201508;2406;7317;1755;5959;407;1444;333;1068;740;2512
431339;201508;659;1799;453;1376;78;252;205;606;283;858
431340;201508;25866;68383;18487;55418;4294;13978;5275;15325;9569;29303
431342;201508;548;1419;439;1233;144;435;211;557;355;992
431344;201508;357;987;260;810;13;40;196;619;209;659
431346;201508;332;849;143;433;32;104;28;78;60;182
431349;201508;723;2063;483;1484;101;312;145;429;246;741
431350;201508;4067;11869;3330;10502;697;2499;1390;4119;2087;6618
431360;201508;698;1788;462;1387;116;376;141;424;257;800
431365;201508;1195;3525;1014;3220;279;952;472;1527;751;2479
431370;201508;4936;13928;3865;12054;1069;3618;1249;3866;2318;7484
431380;201508;954;2960;883;2805;126;446;561;1736;687;2182
431390;201508;3275;8604;1960;6083;392;1382;558;1535;950;2917
431395;201508;1261;3715;1052;3359;236;857;517;1593;753;2450
431400;201508;314;972;158;538;35;134;21;52;56;186
431402;201508;1310;3067;734;2043;149;446;358;950;507;1396
431403;201508;277;800;194;649;52;190;32;108;84;298
431405;201508;4200;11582;3324;10288;667;2345;1683;5060;2350;7405
431406;201508;794;2420;581;1956;167;602;251;820;418;1422
431407;201508;559;1612;361;1204;90;304;95;284;185;588
431410;201508;14169;40691;9578;31583;2844;10504;1284;4101;4128;14605
431413;201508;231;568;107;335;10;34;35;100;45;134
431415;201508;753;2092;554;1725;124;456;221;608;345;1064
431417;201508;642;1572;515;1390;68;192;300;820;368;1012
431420;201508;1418;3888;1224;3579;257;798;577;1780;834;2578
431430;201508;529;1372;316;945;61;195;107;278;168;473
431440;201508;23384;65259;18851;57821;5442;17709;6560;20945;12002;38654
431442;201508;145;407;93;280;16;55;13;23;29;78
431445;201508;518;1455;227;712;33;106;86;256;119;362
431446;201508;473;1377;329;1078;79;274;114;363;193;637
431447;201508;700;1970;504;1572;108;350;211;656;319;1006
431449;201508;820;2284;641;1952;66;208;385;1171;451;1379
431450;201508;2157;5422;1902;5040;317;915;1335;3459;1652;4374
431454;201508;63;225;54;202;14;53;21;85;35;138
431455;201508;725;1844;375;1080;99;280;95;253;194;533
431460;201508;3482;9629;2929;8566;798;2360;975;2951;1773;5311
431470;201508;1868;5480;1419;4459;347;1080;499;1577;846;2657
431475;201508;183;532;42;165;7;28;1;4;8;32
431477;201508;745;1937;495;1437;58;184;267;735;325;919
431478;201508;271;695;101;303;20;59;20;53;40;112
431480;201508;3069;8448;2241;6933;590;2017;788;2303;1378;4320
431490;201508;111883;302004;94801;276177;11963;41138;65401;185359;77364;226497
431500;201508;720;1952;547;1618;118;354;268;765;386;1119
431505;201508;508;1221;354;1001;28;70;245;710;273;780
431507;201508;358;868;224;608;41;104;130;344;171;448
431510;201508;2109;5761;1611;4802;355;1128;647;1805;1002;2933
431513;201508;298;807;133;422;21;70;64;198;85;268
431514;201508;103;267;36;125;4;19;2;5;6;24
431515;201508;730;2100;499;1533;106;375;194;494;300;869
431517;201508;81;256;71;230;17;56;21;55;38;111
431520;201508;490;1354;252;815;36;141;39;111;75;252
431530;201508;4289;10185;3227;8917;1088;3226;974;2828;2062;6054
431531;201508;289;819;186;606;36;117;65;212;101;329
431532;201508;517;1440;438;1264;113;350;174;492;287;842
431535;201508;397;1030;179;539;30;95;60;158;90;253
431540;201508;2141;6993;1876;6591;223;753;1216;4519;1439;5272
431545;201508;312;851;47;160;5;18;9;34;14;52
431550;201508;2313;6761;2028;6238;379;1327;950;2798;1329;4125
431555;201508;724;1842;568;1593;101;284;342;969;443;1253
431560;201508;19237;57869;13745;46887;3467;13146;3393;11952;6860;25098
431570;201508;5318;14707;4658;13645;1286;3848;2161;6454;3447;10302
431575;201508;433;1092;299;866;46;155;78;197;124;352
431580;201508;682;1924;424;1351;84;302;146;423;230;725
431590;201508;1001;2721;607;1898;94;282;238;750;332;1032
431595;201508;477;1357;370;1133;60;183;192;591;252;774
431600;201508;1998;5554;1379;4381;303;1159;335;950;638;2109
431610;201508;1471;4306;1083;3530;219;731;441;1429;660;2160
431620;201508;463;1371;228;733;58;200;93;269;151;469
431630;201508;1477;3932;966;2884;257;793;349;1007;606;1800
431640;201508;6113;17485;5453;16475;1153;3909;2977;8883;4130;12792
431642;201508;526;1416;416;1222;63;212;199;561;262;773
431643;201508;178;437;141;373;18;47;64;149;82;196
431645;201508;1821;5171;1568;4750;304;980;883;2666;1187;3646
431647;201508;176;502;110;344;22;72;21;54;43;126
431650;201508;311;952;213;748;33;131;50;148;83;279
431660;201508;1198;3343;725;2341;156;549;167;467;323;1016
431670;201508;1316;3469;973;2845;211;709;407;1107;618;1816
431673;201508;231;635;121;391;26;94;20;54;46;148
431675;201508;636;1704;177;588;29;104;33;85;62;189
431680;201508;10284;27656;7454;22473;2005;6473;1972;5948;3977;12421
431690;201508;24286;67192;18760;57961;5157;17048;6611;20845;11768;37893
431695;201508;137;411;92;298;21;68;19;42;40;110
431697;201508;455;1294;398;1183;99;296;189;580;288;876
431700;201508;1605;4528;1346;4020;244;785;728;2100;972;2885
431710;201508;12908;37110;10330;32766;3292;11319;2570;8505;5862;19824
431720;201508;7304;20013;5508;16518;1172;3858;2078;6035;3250;9893
431725;201508;23;65;12;39;2;5;4;11;6;16
431730;201508;3936;11502;3054;9868;825;2913;809;2664;1634;5577
431740;201508;5306;14772;4175;12671;1372;4595;807;2210;2179;6805
431750;201508;9567;26883;8147;24551;1785;5834;3969;12113;5754;17947
431755;201508;326;884;71;250;15;51;11;34;26;85
431760;201508;3906;11270;3100;9759;711;2427;1073;3212;1784;5639
431770;201508;2108;5585;1731;4983;331;987;979;2778;1310;3765
431775;201508;216;585;148;458;51;164;20;53;71;217
431780;201508;2470;6622;1856;5469;483;1518;437;1174;920;2692
431790;201508;1273;3899;1055;3466;186;657;580;1929;766;2586
431795;201508;391;1072;241;738;39;131;87;257;126;388
431800;201508;8925;26225;6982;22436;2117;7344;1367;4163;3484;11507
431805;201508;327;789;97;330;16;62;14;47;30;109
431810;201508;3443;9493;2657;7895;514;1654;1171;3368;1685;5022
431820;201508;2681;8304;2295;7543;475;1708;940;2974;1415;4682
431830;201508;10868;26769;8398;23066;2371;7051;3250;8967;5621;16018
431840;201508;2762;8175;2353;7457;588;2003;1034;3290;1622;5293
431842;201508;815;2037;357;1075;51;172;88;222;139;394
431843;201508;357;1034;293;916;39;136;151;455;190;591
431844;201508;245;670;109;353;22;86;27;67;49;153
431845;201508;528;1539;420;1304;37;125;269;849;306;974
431846;201508;375;1124;329;1053;37;143;225;701;262;844
431848;201508;236;636;124;408;14;45;26;78;40;123
431849;201508;440;1078;90;272;20;64;15;32;35;96
431850;201508;4950;14289;4306;13062;1031;3324;1744;5249;2775;8573
431860;201508;802;2100;589;1741;113;377;274;740;387;1117
431861;201508;101;301;53;191;7;23;8;27;15;50
431862;201508;476;1538;378;1342;107;427;90;277;197;704
431870;201508;18755;53041;14341;45209;3670;12614;4626;14421;8296;27035
431880;201508;4385;12952;3428;10931;785;2778;1347;4095;2132;6873
431890;201508;5310;14234;3870;11619;1194;3820;1046;3139;2240;6959
431900;201508;1090;3088;713;2316;187;689;283;828;470;1517
431910;201508;1027;2425;466;1334;75;213;150;389;225;602
431912;201508;619;1764;477;1495;141;422;152;506;293;928
431915;201508;1368;3669;1030;3068;239;754;398;1172;637;1926
431920;201508;1356;3764;1182;3490;125;369;894;2639;1019;3008
431930;201508;1272;3484;906;2860;233;715;417;1389;650;2104
431935;201508;71;217;57;189;13;51;20;56;33;107
431936;201508;392;1156;296;940;51;157;150;502;201;659
431937;201508;344;887;192;577;46;149;36;91;82;240
431940;201508;2657;7199;1699;5281;403;1331;447;1344;850;2675
431950;201508;1653;5006;1415;4579;280;1022;644;1979;924;3001
431960;201508;3020;8729;2620;7936;677;2187;870;2558;1547;4745
431970;201508;495;1335;246;787;37;144;58;155;95;299
431971;201508;106;290;72;223;9;26;26;64;35;90
431973;201508;493;1694;424;1542;56;201;254;968;310;1169
431975;201508;96;219;16;65;5;25;2;4;7;29
431980;201508;1431;4143;1165;3594;273;910;378;1089;651;1999
431990;201508;7970;21927;5905;18380;1071;3857;1960;5688;3031;9545
432000;201508;10427;28827;8030;24604;2460;7919;2729;8249;5189;16168
432010;201508;2300;6490;1872;5703;407;1312;873;2630;1280;3942
432020;201508;2367;5807;1829;5086;234;714;1261;3456;1495;4170
432023;201508;537;1548;351;1137;76;263;102;301;178;564
432026;201508;1284;3833;930;3058;154;497;495;1620;649;2117
432030;201508;414;1197;309;965;61;195;145;431;206;626
432032;201508;599;1549;389;1163;71;222;176;486;247;708
432035;201508;834;2547;728;2344;214;716;318;1042;532;1758
432040;201508;999;2354;467;1454;98;342;131;372;229;714
432045;201508;227;665;137;485;28;108;52;190;80;298
432050;201508;671;1867;569;1676;99;291;332;1013;431;1304
432055;201508;851;2538;680;2202;127;453;404;1273;531;1726
432057;201508;426;1063;321;883;44;122;209;555;253;677
432060;201508;516;1366;190;648;36;138;42;128;78;266
432065;201508;221;626;168;533;41;145;64;191;105;336
432067;201508;994;3049;714;2428;149;543;350;1180;499;1723
432070;201508;2422;6618;1542;4786;353;1189;363;1037;716;2226
432080;201508;3705;10551;3132;9530;968;3136;1033;3100;2001;6236
432085;201508;314;861;205;680;45;159;104;350;149;509
432090;201508;1478;4216;1149;3535;362;1198;414;1182;776;2380
432100;201508;1333;3845;662;2249;128;456;87;221;215;677
432110;201508;2699;8074;1985;6580;495;1859;264;737;759;2596
432120;201508;5095;14894;4239;13390;1578;5335;1200;3645;2778;8980
432130;201508;2628;7313;2094;6600;670;2311;801;2509;1471;4820
432132;201508;434;1234;210;720;27;109;72;227;99;336
432135;201508;708;2164;670;2092;85;291;500;1537;585;1828
432140;201508;2028;6386;1599;5548;381;1378;681;2458;1062;3836
432143;201508;1412;4115;1171;3697;227;733;566;1861;793;2594
432145;201508;1172;3601;696;2447;141;547;119;370;260;917
432146;201508;211;663;139;491;34;134;34;112;68;246
432147;201508;661;2060;487;1678;135;491;155;547;290;1038
432149;201508;371;1047;226;705;50;161;90;284;140;445
432150;201508;3790;10492;2761;8586;614;2121;858;2523;1472;4644
432160;201508;4483;13961;3866;12911;1166;4035;1418;4913;2584;8948
432162;201508;396;953;73;233;10;37;15;39;25;76
432163;201508;405;1072;91;291;5;17;5;18;10;35
432166;201508;734;2153;599;1882;89;333;306;915;395;1248
432170;201508;1048;3259;660;2393;137;512;117;405;254;917
432180;201508;2963;7831;1980;6033;499;1601;536;1598;1035;3199
432183;201508;429;1326;340;1139;146;520;62;191;208;711
432185;201508;940;2524;577;1832;114;378;244;771;358;1149
432190;201508;3423;9343;2282;6792;556;1754;662;1808;1218;3562
432195;201508;1242;3342;996;2957;132;427;623;1798;755;2225
432200;201508;3250;9665;2558;8470;641;2328;1149;3840;1790;6168
432210;201508;433;1182;314;983;78;282;127;356;205;638
432215;201508;875;2687;739;2466;138;422;438;1558;576;1980
432218;201508;299;780;203;588;39;114;74;188;113;302
432220;201508;4306;11296;3491;10020;374;1269;2196;6116;2570;7385
432225;201508;71;223;61;206;24;87;19;59;43;146
432230;201508;1101;2937;641;1928;148;488;168;402;316;890
432232;201508;558;1610;432;1365;90;303;167;523;257;826
432234;201508;418;1138;272;805;59;172;87;246;146;418
432235;201508;80;227;41;136;10;40;6;15;16;55
432237;201508;475;1304;434;1239;22;86;329;908;351;994
432240;201508;14145;44523;11801;41282;2048;8385;6789;24331;8837;32716
432250;201508;4902;16598;4396;15576;1528;5924;1376;4840;2904;10764
432252;201508;394;1107;282;919;53;185;157;514;210;699
432253;201508;1327;4176;856;2965;225;845;160;532;385;1377
432254;201508;832;2259;228;758;56;202;30;85;86;287
432255;201508;244;620;128;420;30;103;37;113;67;216
432260;201508;7677;19065;5201;14951;1197;3519;2044;6101;3241;9620
432270;201508;2595;7651;2148;6863;603;1965;824;2721;1427;4686
432280;201508;1351;3699;688;2226;125;441;156;432;281;873
432285;201508;185;593;57;200;11;44;9;22;20;66
432290;201508;579;1708;363;1207;86;291;111;359;197;650
432300;201508;23317;69022;20327;63815;4038;13732;11458;35536;15496;49268
432310;201508;865;2514;690;2216;150;538;367;1145;517;1683
432320;201508;249;629;120;371;27;83;23;60;50;143
432330;201508;312;813;122;403;14;48;8;22;22;70
432335;201508;207;593;87;296;18;64;10;32;28;96
432340;201508;374;931;180;549;33;107;55;160;88;267
432345;201508;678;1882;619;1786;90;333;373;985;463;1318
432350;201508;406;1097;213;700;35;109;67;207;102;316
432360;201508;174;533;35;127;11;49;10;29;21;78
432370;201508;431;1199;339;1012;39;113;224;678;263;791
432375;201508;804;2014;614;1704;82;229;360;1010;442;1239
432377;201508;192;615;52;167;10;31;16;37;26;68
432380;201508;832;2801;741;2631;283;1119;278;918;561;2037
500020;201508;2274;6747;1702;5693;378;1499;688;2163;1066;3662
500025;201508;1245;2985;772;2139;93;273;442;1195;535;1468
500060;201508;6713;19800;5365;17566;701;2408;3445;11661;4146;14069
500070;201508;4156;12047;3436;10783;707;2503;1512;4664;2219;7167
500080;201508;1521;4481;1116;3727;289;1072;392;1309;681;2381
500085;201508;2239;5814;1595;4841;182;602;925;2701;1107;3303
500090;201508;2330;6689;1713;5557;346;1155;802;2670;1148;3825
500100;201508;2543;7387;2163;6695;478;1735;962;2775;1440;4510
500110;201508;8692;25191;6852;22309;1138;4042;3553;12158;4691;16200
500124;201508;2008;6429;1726;5963;346;1116;911;3478;1257;4594
500150;201508;1407;3500;994;2830;196;667;430;1036;626;1703
500190;201508;4892;12618;3806;11180;732;2303;2147;6445;2879;8748
500200;201508;2492;6240;1843;5084;371;1115;760;1961;1131;3076
500210;201508;4802;14238;3983;12920;886;3046;1909;6220;2795;9266
500215;201508;1629;4960;1285;4252;222;813;507;1596;729;2409
500220;201508;2927;9132;2396;8196;496;1823;950;3325;1446;5148
500230;201508;2676;6761;1992;5758;483;1528;882;2566;1365;4094
500240;201508;4737;14633;3357;11766;536;2032;1221;4513;1757;6545
500260;201508;2703;6916;1976;5777;316;1029;951;2631;1267;3660
500270;201508;120013;306465;73842;225480;17829;58718;16875;50390;34704;109108
500280;201508;1397;3694;1169;3393;106;334;876;2574;982;2908
500290;201508;4304;9968;2498;7243;533;1754;830;2231;1363;3985
500295;201508;2610;7714;1697;5580;308;1103;408;1135;716;2238
500310;201508;823;2118;678;1907;149;488;326;866;475;1354
500315;201508;3102;9609;2589;8814;399;1399;1589;5603;1988;7002
500320;201508;16664;52955;13085;46114;3821;14548;3889;14334;7710;28882
500325;201508;4017;10218;2894;8446;607;1939;1479;4281;2086;6220
500330;201508;6478;17215;4749;14040;903;2916;2157;6233;3060;9149
500345;201508;2196;5696;1693;4887;300;945;908;2574;1208;3519
500348;201508;2362;6697;2056;6206;150;548;1520;4536;1670;5084
500350;201508;1241;3723;741;2553;97;365;227;804;324;1169
500370;201508;23169;69586;17235;58460;3864;14738;5234;17625;9098;32363
500375;201508;2928;7965;2129;6434;485;1546;647;1913;1132;3459
500380;201508;2904;8185;2388;7284;687;2160;880;2701;1567;4861
500390;201508;599;1285;355;919;40;123;222;525;262;648
500400;201508;1302;3915;951;3078;220;793;249;705;469;1498
500410;201508;2255;6291;1791;5593;465;1613;805;2492;1270;4105
500430;201508;2442;6996;1934;6263;409;1486;840;2773;1249;4259
500440;201508;1386;3732;1033;3156;197;668;488;1429;685;2097
500450;201508;1749;5252;1278;4316;272;1037;264;771;536;1808
500460;201508;3631;10870;2765;9150;745;2732;643;2023;1388;4755
500470;201508;3038;8837;2061;6695;529;1903;311;901;840;2804
500480;201508;2112;6557;1951;6343;191;627;1466;5033;1657;5660
500490;201508;980;2692;748;2281;215;753;217;641;432;1394
500500;201508;3627;11251;2829;10007;1113;4508;710;2424;1823;6932
500510;201508;851;2196;533;1629;73;245;223;620;296;865
500515;201508;1835;4889;1509;4448;255;775;866;2770;1121;3545
500520;201508;3021;10257;2683;9744;432;1700;1677;6200;2109;7900
500525;201508;1167;3698;933;3241;192;753;424;1489;616;2242
500540;201508;6175;16940;3490;11738;948;3723;512;1460;1460;5183
500560;201508;4612;15041;4190;14388;542;2077;2977;10238;3519;12315
500568;201508;3929;10040;2781;8271;573;2010;1070;2933;1643;4943
500570;201508;7539;20030;4908;15040;1302;4274;1124;3272;2426;7546
500580;201508;3689;10405;2925;9135;298;992;2042;6437;2340;7429
500600;201508;3809;10088;2466;7530;563;1863;820;2434;1383;4297
500620;201508;7669;21736;5714;18048;1147;3978;2553;8055;3700;12033
500625;201508;718;2138;432;1496;94;352;124;421;218;773
500627;201508;517;1520;403;1318;84;283;106;369;190;652
500630;201508;6065;16404;4319;13423;1076;3726;1360;4072;2436;7798
500635;201508;2597;9962;2150;9236;321;1311;1329;6294;1650;7605
500640;201508;1629;3928;1231;3352;93;298;880;2341;973;2639
500660;201508;18956;54017;14535;46773;4208;15295;4545;14418;8753;29713
500690;201508;2806;7988;2208;7215;875;2966;718;2553;1593;5519
500710;201508;3681;10858;3082;9830;669;2417;1412;4381;2081;6798
500720;201508;6000;15899;3752;11883;1014;3500;982;2958;1996;6458
500730;201508;981;2714;681;2103;158;549;212;617;370;1166
500740;201508;3975;10922;3265;9589;435;1559;1467;4363;1902;5922
500750;201508;869;2413;757;2255;134;409;445;1342;579;1751
500755;201508;1228;3575;836;2733;178;648;219;590;397;1238
500769;201508;5055;13364;2959;8976;525;1800;686;1719;1211;3519
500770;201508;1725;5053;1266;4191;326;1179;369;1232;695;2411
500780;201508;1089;3129;876;2732;234;800;287;816;521;1616
500790;201508;9243;25443;7654;22704;1354;4642;4239;12129;5593;16771
500793;201508;2265;6478;1732;5533;434;1513;514;1463;948;2976
500795;201508;2462;7195;2074;6645;261;723;1477;5023;1738;5746
500797;201508;846;2257;595;1823;101;330;225;643;326;973
500800;201508;2719;7361;2123;6537;802;2812;626;1914;1428;4726
500830;201508;18515;49866;12490;38299;2572;8664;4002;11574;6574;20238
500840;201508;1311;3654;903;2827;115;388;381;1130;496;1518
510010;201508;1203;3674;1030;3378;282;928;493;1656;775;2584
510020;201508;3367;9581;2105;6996;468;1665;610;1915;1078;3580
510025;201508;7889;22772;6286;19844;1478;5144;2267;6586;3745;11730
510030;201508;1733;4726;1411;4208;307;1040;660;1842;967;2882
510035;201508;845;2374;662;2118;123;402;380;1235;503;1637
510040;201508;1686;4574;1282;3973;225;777;686;2120;911;2897
510050;201508;1870;5392;1318;4344;359;1291;385;1242;744;2533
510060;201508;1574;4489;1161;3684;227;767;455;1390;682;2157
510080;201508;1170;3607;901;3081;269;1029;184;554;453;1583
510100;201508;673;1793;470;1382;54;170;212;584;266;754
510120;201508;317;673;198;521;20;56;121;320;141;376
510125;201508;3105;8156;2364;6828;428;1510;988;2565;1416;4075
510130;201508;1867;5054;1489;4426;390;1219;529;1572;919;2791
510140;201508;2923;9341;2332;8409;939;3809;536;1681;1475;5490
510160;201508;1359;4529;1247;4370;160;635;883;3073;1043;3708
510170;201508;5407;16138;4392;14357;830;3012;2097;6604;2927;9616
510180;201508;12001;31231;8398;25508;2400;7662;2668;8938;5068;16600
510185;201508;1355;3945;1098;3607;151;467;731;2627;882;3094
510190;201508;2201;6489;1526;5452;338;1319;710;2622;1048;3941
510250;201508;13942;42240;11763;39011;3468;12512;4613;15662;8081;28174
510260;201508;2224;8893;1922;8251;588;2643;783;3745;1371;6388
510263;201508;4235;11221;3005;9165;735;2391;890;2566;1625;4957
510267;201508;5831;16716;4111;13065;943;3261;1190;3557;2133;6818
510268;201508;821;2407;703;2230;138;467;400;1253;538;1720
510269;201508;1015;3088;766;2603;248;876;204;693;452;1569
510270;201508;2668;8564;2288;7801;397;1391;1063;3607;1460;4998
510279;201508;1960;6036;1585;5165;434;1545;464;1333;898;2878
510285;201508;1361;3994;1055;3449;286;1013;362;1126;648;2139
510300;201508;3287;9632;2722;8805;212;808;2066;6695;2278;7503
510305;201508;1532;4666;1184;3987;298;1086;396;1289;694;2375
510310;201508;831;2500;704;2255;228;781;227;682;455;1463
510320;201508;3533;10163;2724;8633;735;2707;680;1989;1415;4696
510325;201508;5266;16597;4459;15483;1178;4212;2661;9528;3839;13740
510330;201508;2782;8696;2212;7675;564;2186;763;2604;1327;4790
510335;201508;4748;14315;3903;13228;516;1681;2793;10038;3309;11719
510336;201508;592;1781;452;1519;84;310;225;743;309;1053
510337;201508;2124;6896;1705;6058;657;2391;374;1408;1031;3799
510340;201508;67425;188287;50416;161339;17856;62971;10230;33987;28086;96958
510343;201508;1090;3156;929;2904;91;299;700;2222;791;2521
510345;201508;1664;4868;1335;4274;327;1110;474;1455;801;2565
510350;201508;3358;9087;2563;7960;623;2043;1200;3871;1823;5914
510360;201508;1778;4357;1138;3569;130;489;777;2377;907;2866
510370;201508;1128;3761;976;3522;205;769;594;2209;799;2978
510380;201508;539;1629;370;1284;136;513;47;140;183;653
510385;201508;954;3543;702;2961;97;440;323;1477;420;1917
510390;201508;1112;3396;1022;3286;278;709;638;2319;916;3028
510395;201508;737;1822;546;1555;85;262;239;784;324;1046
510410;201508;3782;12263;3353;11392;811;2900;1739;5985;2550;8885
510420;201508;2412;6129;1738;4997;213;765;891;2497;1104;3262
510450;201508;584;1574;427;1331;96;336;156;461;252;797
510452;201508;620;1994;438;1575;95;387;195;671;290;1058
510454;201508;848;2696;722;2449;118;426;453;1570;571;1996
510455;201508;967;2978;713;2450;145;572;228;739;373;1311
510460;201508;2237;5854;1714;5094;224;816;992;2773;1216;3589
510480;201508;4523;12030;3173;9514;747;2356;748;2092;1495;4448
510490;201508;1477;4732;1281;4430;258;1014;736;2450;994;3464
510500;201508;1497;4438;1024;3478;245;961;399;1285;644;2246
510510;201508;2690;9302;2323;8631;736;2989;802;2931;1538;5920
510515;201508;6044;18352;4527;15019;1023;3749;1119;3483;2142;7232
510517;201508;1720;5108;1409;4534;451;1504;447;1414;898;2918
510520;201508;2042;4855;1480;4133;68;230;1066;3084;1134;3314
510523;201508;1010;2979;879;2770;148;478;587;1897;735;2375
510525;201508;7899;20221;5167;15839;1083;3465;1910;5798;2993;9263
510530;201508;515;1449;430;1329;57;254;264;763;321;1017
510550;201508;2589;8494;2152;7663;617;2351;714;2511;1331;4862
510558;201508;1948;5537;1612;5045;343;1176;785;2507;1128;3683
510560;201508;1649;5072;1084;4082;307;1243;245;936;552;2179
510562;201508;5377;15835;4176;13411;1177;4153;1136;3644;2313;7797
510590;201508;3059;8112;2488;7378;569;1712;1251;3828;1820;5540
510600;201508;1569;4060;1038;3165;186;611;425;1215;611;1826
510610;201508;2800;7994;2360;7358;171;605;1794;5608;1965;6213
510615;201508;2275;6860;1909;6275;564;1988;894;2967;1458;4955
510617;201508;597;1798;489;1606;40;114;386;1329;426;1443
510618;201508;1435;4185;1018;3348;179;688;452;1419;631;2107
510619;201508;817;2256;475;1601;70;254;65;178;135;432
510620;201508;1485;3654;790;2559;206;740;123;369;329;1109
510621;201508;919;3240;811;3000;214;878;267;943;481;1821
510622;201508;3782;11413;2561;8765;671;2487;349;960;1020;3447
510623;201508;3435;9768;2730;8461;716;2387;1075;3161;1791;5548
510624;201508;1370;4086;954;3229;205;790;268;792;473;1582
510625;201508;2155;6079;1636;5202;419;1482;377;1142;796;2624
510626;201508;1544;4127;1001;3351;310;1166;297;982;607;2148
510627;201508;736;2081;484;1547;117;410;113;352;230;762
510628;201508;1598;3925;1131;3292;114;369;807;2331;921;2700
510629;201508;1708;5473;1394;4790;418;1625;455;1460;873;3085
510630;201508;2530;8526;1880;7142;484;2069;374;1397;858;3466
510631;201508;367;1038;330;980;40;111;247;731;287;842
510637;201508;2678;7774;2294;7151;622;2083;949;2940;1571;5023
510642;201508;4637;15202;3991;14264;1189;4646;1758;6469;2947;11115
510645;201508;950;2132;589;1632;181;480;173;515;354;995
510650;201508;6189;20811;5630;20124;1312;4877;3586;13291;4898;18168
510665;201508;1312;3610;894;2807;220;724;289;890;509;1614
510670;201508;395;887;205;613;21;83;97;274;118;357
510675;201508;6342;19919;5062;17341;1410;5466;1246;4054;2656;9520
510677;201508;2073;5452;1646;4906;200;611;1221;3800;1421;4411
510680;201508;748;2246;583;1908;124;446;196;576;320;1022
510682;201508;2225;6947;1712;5962;453;1777;392;1263;845;3040
510685;201508;943;2528;766;2287;91;312;500;1465;591;1777
510700;201508;4315;11169;2919;9154;632;2063;1453;4679;2085;6742
510704;201508;9077;24170;7427;21546;1482;4805;3872;10954;5354;15759
510706;201508;1857;5609;1342;4785;305;1118;717;2649;1022;3767
510710;201508;3425;9458;2389;7332;576;1863;589;1608;1165;3471
510715;201508;699;1707;434;1228;96;301;153;391;249;692
510718;201508;2206;5535;1479;4703;681;2237;416;1437;1097;3674
510719;201508;437;999;275;787;29;120;135;362;164;482
510720;201508;1146;2751;907;2449;225;670;443;1120;668;1790
510724;201508;775;2323;635;2061;141;513;317;971;458;1484
510726;201508;620;1607;461;1336;94;291;174;465;268;756
510729;201508;753;1866;443;1306;102;345;163;464;265;809
510730;201508;2607;7695;2076;6757;550;1976;675;2086;1225;4062
510735;201508;1091;3602;850;3196;192;818;411;1534;603;2352
510740;201508;1102;2721;801;2268;193;516;407;1206;600;1722
510757;201508;671;2281;552;2036;180;686;196;740;376;1426
510760;201508;29333;76523;19989;60745;5792;19084;5246;15449;11038;34533
510770;201508;4342;11186;3708;10446;373;1011;2495;7809;2868;8820
510774;201508;413;1148;352;1048;74;264;163;498;237;762
510775;201508;737;2123;606;1904;200;692;163;479;363;1171
510776;201508;532;1499;408;1229;89;298;180;524;269;822
510777;201508;1615;4806;1221;4255;177;654;913;3226;1090;3880
510779;201508;670;1970;495;1639;78;271;236;795;314;1066
510780;201508;3644;10955;3033;9982;760;2606;1336;4595;2096;7201
510785;201508;1825;5218;1365;4422;446;1503;334;1082;780;2585
510787;201508;2165;6517;1699;5688;621;2185;367;1174;988;3359
510788;201508;529;1395;381;1171;169;529;90;300;259;829
510790;201508;15726;45375;10425;35117;2365;9137;1242;3955;3607;13092
510792;201508;7540;22732;5165;18023;1104;4371;953;3016;2057;7387
510794;201508;1175;3716;976;3341;344;1302;294;920;638;2222
510795;201508;8264;24510;5936;20057;1575;5858;1383;4759;2958;10617
510800;201508;1635;4574;1311;4091;301;1046;557;1594;858;2640
510805;201508;1902;5296;1531;4750;213;694;1047;3279;1260;3973
510810;201508;676;1640;514;1423;140;385;233;626;373;1011
510820;201508;742;1769;504;1411;95;307;201;497;296;804
510830;201508;672;2116;569;1959;158;597;278;1014;436;1611
510835;201508;644;1952;481;1617;131;497;176;536;307;1033
510840;201508;49482;120683;38250;106193;8917;26100;18590;52972;27507;79072
510850;201508;1484;4193;1072;3459;326;1170;182;450;508;1620
510860;201508;2494;8020;1825;6623;720;2850;99;322;819;3172
510880;201508;662;2166;564;1999;169;645;249;910;418;1555
510885;201508;626;1737;495;1559;96;344;198;607;294;951
510890;201508;870;2707;702;2435;208;820;267;837;475;1657
510895;201508;1100;3392;928;3059;237;891;377;1160;614;2051
520005;201508;1345;4284;1195;4065;328;1176;557;1926;885;3102
520010;201508;1632;5473;1326;4826;511;2160;267;829;778;2989
520013;201508;3549;9803;2615;8067;601;1950;966;2959;1567;4909
520015;201508;444;1285;363;1158;85;287;138;439;223;726
520017;201508;1077;3185;899;2890;236;836;358;1067;594;1903
520020;201508;402;1068;314;942;71;229;138;401;209;630
520025;201508;25275;78665;24074;77210;2508;8705;19622;62865;22130;71570
520030;201508;4475;13962;3768;12787;787;2936;1790;6085;2577;9021
520050;201508;311;833;248;730;19;51;179;533;198;584
520055;201508;721;2188;625;1989;117;367;331;1079;448;1446
520060;201508;1370;4258;1172;3861;250;940;472;1486;722;2426
520080;201508;1715;5127;1462;4775;326;1050;826;2819;1152;3869
520082;201508;907;2622;805;2455;129;354;514;1675;643;2029
520085;201508;936;2856;791;2571;165;558;262;835;427;1393
520090;201508;973;2223;708;1888;161;396;360;1043;521;1439
520110;201508;41357;119578;31863;104867;11421;42616;6484;20523;17905;63139
520120;201508;188;525;127;419;31;124;34;103;65;227
520130;201508;3401;9609;3073;9104;763;2477;1451;4229;2214;6706
520140;201508;38680;124384;33068;113694;11208;42175;7216;23729;18424;65904
520145;201508;369;975;283;840;73;232;117;328;190;560
520150;201508;507;1330;398;1203;62;211;249;750;311;961
520160;201508;795;2253;650;2036;208;685;188;593;396;1278
520170;201508;4057;9487;3206;8519;301;843;2549;6894;2850;7737
520180;201508;2020;5898;1642;5283;364;1382;678;2080;1042;3462
520215;201508;1867;4818;1554;4321;208;603;976;2730;1184;3333
520235;201508;709;1844;523;1568;115;386;220;629;335;1015
520250;201508;1361;4096;1047;3538;262;975;369;1244;631;2219
520260;201508;784;2000;528;1527;80;251;219;599;299;850
520280;201508;500;1488;459;1433;168;558;163;573;331;1131
520310;201508;1091;2660;827;2254;217;614;321;946;538;1560
520320;201508;1770;5506;1451;4883;150;531;904;3103;1054;3634
520330;201508;2612;8098;1988;7000;553;2140;364;1200;917;3340
520340;201508;1803;4498;1403;4001;212;524;944;2878;1156;3402
520350;201508;3056;8367;2371;7102;582;1947;989;2824;1571;4771
520355;201508;1044;3492;938;3319;317;1220;356;1205;673;2425
520357;201508;758;2081;643;1897;46;154;473;1369;519;1523
520360;201508;656;1900;575;1764;118;388;265;825;383;1213
520380;201508;1298;3464;854;2612;151;490;337;1003;488;1493
520390;201508;993;2340;593;1809;159;572;218;590;377;1162
520393;201508;493;1239;387;1086;53;162;239;651;292;813
520396;201508;732;2328;619;2108;77;306;404;1359;481;1665
520400;201508;1699;4821;1449;4475;238;793;921;2818;1159;3611
520410;201508;1375;3447;1045;2985;219;686;573;1617;792;2303
520420;201508;325;909;233;708;45;146;70;191;115;337
520425;201508;1102;3009;925;2694;252;772;455;1315;707;2087
520430;201508;1998;5227;1265;3865;276;934;409;1121;685;2055
520440;201508;3647;9306;2436;7194;736;2372;547;1586;1283;3958
520450;201508;10254;28640;7150;22838;1655;5778;869;2486;2524;8264
520455;201508;667;1984;531;1742;162;587;162;518;324;1105
520460;201508;848;2439;692;2172;129;468;352;1059;481;1527
520465;201508;782;2202;674;2071;120;401;409;1256;529;1657
520470;201508;1725;5565;1546;5278;349;1201;983;3519;1332;4720
520480;201508;965;2760;721;2347;131;468;351;1072;482;1540
520485;201508;1220;3879;1049;3591;281;1077;558;1895;839;2972
520490;201508;3835;12038;3062;10802;937;3429;1320;4786;2257;8215
520495;201508;1238;3418;1079;3212;98;301;889;2679;987;2980
520500;201508;1359;3786;1134;3452;313;1015;468;1397;781;2412
520505;201508;792;2219;676;2054;160;494;357;1085;517;1579
520510;201508;9511;26632;6624;21874;1720;6260;1977;6633;3697;12893
520520;201508;1081;2989;848;2645;257;832;292;921;549;1753
520530;201508;1988;6508;1676;5966;570;2038;537;2020;1107;4058
520540;201508;2884;8111;2173;6783;571;1896;499;1504;1070;3400
520545;201508;1090;3253;892;2851;195;660;287;864;482;1524
520547;201508;689;2195;595;2013;217;763;191;600;408;1363
520549;201508;9564;27634;7878;25455;2272;7697;3794;12388;6066;20085
520551;201508;3436;10428;3163;10038;878;3074;1850;5786;2728;8860
520552;201508;771;2319;698;2216;103;364;484;1540;587;1904
520570;201508;521;1511;369;1243;145;527;75;228;220;755
520580;201508;3207;8057;2169;6543;627;2140;838;2447;1465;4587
520590;201508;1405;3928;1101;3404;261;833;273;780;534;1613
520620;201508;7144;22268;6467;21272;1541;5344;3637;12073;5178;17417
520630;201508;757;1962;551;1659;126;377;252;765;378;1142
520640;201508;2784;7743;2273;6893;653;2061;898;2779;1551;4840
520650;201508;828;2247;626;1866;143;467;295;860;438;1327
520660;201508;339;977;268;870;94;333;91;285;185;618
520670;201508;862;2585;779;2466;42;142;668;2125;710;2267
520680;201508;618;1712;495;1539;123;382;230;727;353;1109
520690;201508;368;953;258;792;56;148;120;395;176;543
520710;201508;538;1382;323;947;7;16;193;563;200;579
520725;201508;1597;4045;1198;3426;226;700;704;1996;930;2696
520735;201508;756;2139;550;1734;138;489;170;506;308;995
520740;201508;1597;4471;1283;4056;244;866;678;2100;922;2966
520750;201508;598;1616;473;1424;89;262;252;794;341;1056
520753;201508;1300;3667;1194;3512;152;423;847;2625;999;3048
520760;201508;851;2314;746;2169;104;330;528;1571;632;1901
520780;201508;1917;4639;1546;4140;161;394;1074;2904;1235;3298
520790;201508;2673;7104;2188;6406;257;731;1550;4697;1807;5428
520800;201508;15253;44494;13324;42175;2769;8456;8274;27886;11043;36342
520810;201508;1020;2539;821;2303;138;377;570;1698;708;2075
520815;201508;572;1840;427;1540;166;682;21;52;187;734
520830;201508;1518;4092;1267;3823;46;157;1071;3221;1117;3378
520840;201508;1395;4562;1156;4117;373;1479;245;885;618;2364
520850;201508;581;1795;446;1541;109;417;187;609;296;1026
520860;201508;6529;18603;4846;15978;1283;4557;1919;6450;3202;11007
520870;201508;108642;288014;72554;226882;19968;69120;17462;51577;37430;120697
520880;201508;7073;20144;5154;17184;1613;6073;779;2502;2392;8575
520890;201508;3728;10544;3031;9390;647;2183;1454;4495;2101;6678
520910;201508;3736;10953;2722;8946;881;3081;478;1506;1359;4587
520915;201508;761;2168;592;1854;136;449;262;795;398;1244
520920;201508;3310;8978;2297;7317;531;1810;752;2466;1283;4276
520929;201508;514;1413;385;1213;77;238;218;711;295;949
520940;201508;1024;3010;855;2756;92;352;609;1939;701;2291
520945;201508;724;1710;571;1456;176;407;244;625;420;1032
520960;201508;864;2598;692;2259;79;252;342;1150;421;1402
520970;201508;3151;9317;2606;8337;623;2197;820;2517;1443;4714
520980;201508;764;2195;689;2087;241;794;305;899;546;1693
520990;201508;2885;9383;2729;9156;471;1641;1849;6401;2320;8042
520993;201508;1018;2638;823;2349;62;191;583;1678;645;1869
520995;201508;2294;6261;2050;5948;317;942;1443;4239;1760;5181
521000;201508;6819;20642;5689;18603;1386;5095;1965;6078;3351;11173
521010;201508;3831;11312;3000;9739;736;2542;1064;3467;1800;6009
521015;201508;662;1830;554;1654;136;385;262;796;398;1181
521020;201508;3489;9959;2324;7561;632;2188;294;878;926;3066
521030;201508;600;1565;495;1391;100;275;245;699;345;974
521040;201508;5784;15662;4884;14324;1738;5216;1862;5822;3600;11038
521056;201508;860;2640;715;2393;239;850;266;933;505;1783
521060;201508;1297;3418;1044;3029;241;676;462;1399;703;2075
521080;201508;1219;2879;734;2074;96;346;285;655;381;1001
521090;201508;2911;7822;2268;6993;714;2287;782;2484;1496;4771
521100;201508;1618;3896;1357;3609;235;601;924;2591;1159;3192
521120;201508;4330;11962;3538;10831;870;2845;1492;4599;2362;7444
521130;201508;1016;2764;773;2302;125;449;438;1265;563;1714
521140;201508;971;3023;801;2684;233;820;242;815;475;1635
521150;201508;12804;32757;7938;23495;2697;8540;1851;5373;4548;13913
521160;201508;842;1997;509;1417;103;300;221;594;324;894
521170;201508;1199;2873;906;2465;191;544;504;1336;695;1880
521180;201508;6458;21246;5808;20044;1977;7272;1678;5821;3655;13093
521190;201508;9469;26778;6296;21017;1661;5933;1557;5175;3218;11108
521200;201508;741;1947;621;1755;77;246;385;1045;462;1291
521205;201508;579;1666;444;1417;42;145;252;794;294;939
521210;201508;925;2543;623;1964;206;751;164;403;370;1154
521220;201508;4011;10616;3047;9295;902;2997;1144;3458;2046;6455
521225;201508;363;898;292;819;35;89;209;618;244;707
521230;201508;1175;3699;1072;3491;345;1219;525;1655;870;2874
521250;201508;27376;87703;24419;83092;10072;36588;7062;24073;17134;60661
521260;201508;711;1737;586;1553;92;313;374;915;466;1228
521270;201508;1820;5501;1672;5288;149;376;1308;4342;1457;4718
521280;201508;1855;5640;1499;4928;450;1560;441;1409;891;2969
521290;201508;472;1365;362;1187;97;358;141;450;238;808
521295;201508;1094;2830;941;2615;114;333;722;2037;836;2370
521300;201508;1917;5355;1619;4866;267;787;934;2877;1201;3664
521305;201508;778;2177;635;1951;122;347;348;1112;470;1459
521308;201508;4422;13062;3472;11175;897;2973;1396;4445;2293;7418
521310;201508;7524;22346;5465;18325;1427;5234;1140;3522;2567;8756
521340;201508;239;653;215;618;17;54;164;469;181;523
521350;201508;1885;5179;1571;4693;222;655;1065;3287;1287;3942
521370;201508;958;2823;744;2448;225;811;202;638;427;1449
521375;201508;1253;3741;1051;3361;239;844;477;1422;716;2266
521377;201508;1062;2722;993;2647;75;141;866;2391;941;2532
521380;201508;5097;14455;3665;11736;682;2321;808;2671;1490;4992
521385;201508;470;1329;422;1264;104;336;228;672;332;1008
521390;201508;901;2434;697;2155;178;628;228;687;406;1315
521400;201508;2110;5924;1916;5685;253;830;1475;4392;1728;5222
521405;201508;1365;3852;1062;3308;287;990;472;1451;759;2441
521410;201508;701;2149;641;2052;231;708;287;998;518;1706
521440;201508;1354;3867;1201;3526;147;477;695;1853;842;2330
521450;201508;4119;13047;3312;11494;1045;3917;705;2339;1750;6256
521460;201508;6384;18680;5412;17036;1355;4655;2609;8070;3964;12725
521470;201508;701;1982;516;1615;111;377;90;267;201;644
521480;201508;410;1221;284;939;63;209;105;341;168;550
521483;201508;2816;7369;2163;6244;592;1764;645;1806;1237;3570
521486;201508;1529;3912;1284;3551;117;332;965;2659;1082;2991
521487;201508;624;1605;432;1282;128;391;79;224;207;615
521490;201508;749;2211;613;1984;66;295;408;1274;474;1569
521500;201508;1308;4168;1011;3499;199;775;290;863;489;1638
521520;201508;891;2108;672;1814;179;484;310;898;489;1382
521523;201508;12360;45330;11410;43598;4286;17568;1581;6624;5867;24192
521525;201508;1022;2676;892;2500;106;353;618;1676;724;2029
521530;201508;1613;4595;989;3303;214;759;176;541;390;1300
521540;201508;942;2532;639;2007;148;551;206;598;354;1149
521550;201508;1028;2640;884;2401;221;644;435;1141;656;1785
521560;201508;3838;12685;3280;11868;1252;4981;1092;3844;2344;8825
521565;201508;641;1604;537;1477;84;202;355;1005;439;1207
521570;201508;4424;12346;2920;9296;701;2440;743;2297;1444;4737
521580;201508;562;1293;377;1034;103;302;131;338;234;640
521590;201508;677;1896;548;1682;165;552;111;335;276;887
521600;201508;525;1418;378;1163;104;341;94;252;198;593
521630;201508;1411;3547;998;2937;244;847;195;467;439;1314
521640;201508;1981;5100;1530;4476;431;1311;627;1900;1058;3211
521645;201508;595;1740;457;1421;72;246;178;501;250;747
521680;201508;1446;4590;1210;4110;596;2188;186;578;782;2766
521690;201508;560;1652;492;1530;121;442;215;598;336;1040
521710;201508;2622;8088;2205;7230;489;1682;938;3062;1427;4744
521720;201508;1808;5140;1476;4567;278;884;850;2550;1128;3434
521730;201508;3650;11937;3197;11042;1209;4608;728;2231;1937;6839
521740;201508;3421;9310;2654;8236;761;2558;1120;3681;1881;6239
521760;201508;12600;41381;11125;38781;2638;10101;5114;17876;7752;27977
521770;201508;2664;7727;2124;6707;769;2599;572;1697;1341;4296
521800;201508;7236;21573;6233;19886;1918;6546;2349;7685;4267;14231
521805;201508;893;2031;639;1662;154;363;347;983;501;1346
521810;201508;855;2178;626;1840;141;446;277;827;418;1273
521830;201508;5096;16225;4575;15455;778;2899;3000;10091;3778;12990
521839;201508;727;1992;544;1651;104;348;183;526;287;874
521850;201508;6762;18266;5148;15360;1226;3858;1637;4477;2863;8335
521860;201508;1830;5085;1416;4400;327;1119;442;1332;769;2451
521870;201508;500;1658;422;1483;116;436;113;377;229;813
521878;201508;717;2106;516;1676;99;361;232;731;331;1092
521880;201508;24249;61568;15739;47702;4115;13400;4934;15114;9049;28514
521890;201508;3480;10326;2705;8810;820;2879;623;1947;1443;4826
521900;201508;1368;3614;1006;3096;245;799;349;973;594;1772
521910;201508;955;2623;853;2499;150;462;515;1564;665;2026
521920;201508;336;1004;282;905;98;361;67;177;165;538
521925;201508;629;1919;528;1732;96;345;195;592;291;937
521930;201508;3590;11592;3150;10727;993;3544;735;2473;1728;6017
521935;201508;604;1736;530;1604;146;437;247;739;393;1176
521940;201508;990;2743;800;2435;201;671;355;1041;556;1712
521945;201508;645;2126;598;2058;110;380;383;1403;493;1783
521950;201508;619;1655;493;1464;85;278;278;827;363;1105
521960;201508;720;2138;586;1886;124;452;253;780;377;1232
521970;201508;2446;6795;2134;6398;246;724;1607;4977;1853;5701
521971;201508;1074;2857;758;2262;155;476;200;555;355;1031
521973;201508;899;2828;738;2514;165;607;269;895;434;1502
521975;201508;12288;33629;11370;32535;1896;5671;8076;23052;9972;28723
521980;201508;1913;5512;1670;5219;254;695;1289;4206;1543;4901
521990;201508;1041;3014;876;2761;98;344;568;1807;666;2151
522000;201508;2292;6243;1665;5446;232;839;944;3193;1176;4032
522005;201508;393;952;262;743;81;220;85;253;166;473
522010;201508;3182;9244;2638;8331;926;3047;586;1842;1512;4889
522015;201508;851;2577;715;2355;158;543;366;1201;524;1744
522020;201508;5142;13409;4114;11923;918;2743;2235;6473;3153;9216
522026;201508;611;1639;439;1432;119;426;149;503;268;929
522028;201508;518;1513;424;1303;74;233;258;779;332;1012
522040;201508;2410;5894;1831;5170;412;1198;1055;3007;1467;4205
522045;201508;14743;48004;12162;42589;3570;13700;2332;7859;5902;21559
522050;201508;1107;3125;833;2623;216;725;277;779;493;1504
522060;201508;2683;7971;2075;7029;583;2205;952;3156;1535;5361
522068;201508;1586;5045;1457;4898;152;453;1150;4057;1302;4510
522070;201508;762;2303;684;2179;78;307;483;1526;561;1833
522100;201508;580;1702;506;1590;182;647;204;596;386;1243
522108;201508;889;2729;751;2526;64;253;572;1899;636;2152
522119;201508;1367;4213;1162;3894;262;933;566;1931;828;2864
522130;201508;343;1004;296;949;93;312;173;558;266;870
522140;201508;17409;47827;14127;42327;4096;13284;4600;13049;8696;26333
522145;201508;796;2239;706;2090;294;907;213;656;507;1563
522150;201508;871;2440;760;2257;219;661;290;843;509;1504
522155;201508;782;2219;685;2068;123;344;453;1423;576;1767
522157;201508;684;1928;583;1782;50;182;460;1396;510;1578
522160;201508;5901;16694;4178;13489;1307;4728;466;1341;1773;6069
522170;201508;3037;8529;2459;7556;799;2527;634;1983;1433;4510
522180;201508;319;925;247;800;76;267;81;269;157;536
522185;201508;15048;43474;12522;40181;3157;10737;6923;22332;10080;33069
522190;201508;928;2309;701;1972;106;311;377;1092;483;1403
522200;201508;1627;5176;1356;4607;377;1397;395;1262;772;2659
522205;201508;1416;4042;1151;3609;274;903;539;1643;813;2546
522220;201508;1355;3652;1082;3316;269;825;544;1822;813;2647
522230;201508;1184;3373;1016;3105;117;413;653;1981;770;2394
530010;201508;229742;720126;202338;670192;56074;205850;68431;219937;124505;425787
110001;201507;3823;12078;3168;11061;713;2650;1698;5954;2411;8604
110002;201507;12957;38890;10392;34313;3021;10915;3858;12485;6879;23400
110003;201507;794;2518;703;2352;202;706;178;555;380;1261
110004;201507;9995;31511;8167;27741;2630;9676;1933;6500;4563;16176
110005;201507;1769;5671;1576;5293;550;1904;631;2104;1181;4008
110006;201507;2023;6111;1389;4882;425;1621;245;738;670;2359
110007;201507;1345;4087;1259;3963;315;1080;572;2000;887;3080
110008;201507;2370;8024;2238;7832;389;1278;1607;5876;1996;7154
110009;201507;4549;13689;3678;12268;1032;3818;1366;4380;2398;8198
110010;201507;7676;22536;6701;21272;1672;5140;3622;12572;5294;17712
110011;201507;8006;24554;6766;22178;2202;7628;2502;8070;4704;15698
110012;201507;14008;42067;11683;37756;3625;12313;3652;11836;7277;24149
110013;201507;5205;16457;4342;14976;1525;5463;1432;5130;2957;10593
110014;201507;4156;12207;3604;11322;844;2776;2019;6369;2863;9145
110015;201507;4946;14804;3654;12420;1093;4079;967;3204;2060;7283
110018;201507;4226;11833;3222;10450;847;3119;1325;4088;2172;7207
110020;201507;58402;163370;44669;144751;9933;33960;22482;74794;32415;108754
110025;201507;4314;12482;3550;11086;634;2095;2184;6744;2818;8839
110026;201507;646;1987;598;1917;145;469;359;1162;504;1631
110028;201507;7514;21552;5402;17838;1479;5376;843;2594;2322;7970
110029;201507;1329;3950;1126;3593;335;1108;457;1476;792;2584
110030;201507;10243;27918;7870;24593;1924;6547;3533;11191;5457;17738
110032;201507;3984;12606;3507;11611;1118;3836;1182;3866;2300;7702
110033;201507;5371;17045;4879;16231;1491;4896;2180;7692;3671;12588
110034;201507;3410;9174;2933;8560;629;1814;1951;5735;2580;7549
110037;201507;2051;6849;1737;6237;457;1756;809;2872;1266;4628
110040;201507;3479;10920;3050;10145;910;3295;1340;4340;2250;7635
110045;201507;5109;16632;4438;15801;1400;5435;2302;8124;3702;13559
110050;201507;1665;5334;1432;4925;421;1510;710;2462;1131;3972
110060;201507;791;2639;677;2411;226;894;208;728;434;1622
110070;201507;1984;6594;1863;6340;476;1743;1020;3422;1496;5165
110080;201507;3860;11081;3471;10626;492;1442;2632;8333;3124;9775
110090;201507;759;2260;611;1995;164;614;276;828;440;1442
110092;201507;1290;4362;1217;4275;189;709;836;3008;1025;3717
110094;201507;3465;10533;3135;10061;978;3280;1477;4782;2455;8062
110100;201507;2212;7041;1992;6637;603;2117;999;3298;1602;5415
110110;201507;1639;5235;1504;5056;637;2229;480;1664;1117;3893
110120;201507;1813;5828;1415;4935;431;1570;323;1114;754;2684
110130;201507;2517;7305;1912;6279;650;2273;485;1553;1135;3826
110140;201507;2455;8069;2111;7406;500;1874;971;3375;1471;5249
110143;201507;1261;3973;981;3481;285;1055;442;1561;727;2616
110145;201507;1026;2944;851;2666;197;677;478;1461;675;2138
110146;201507;416;1277;362;1198;72;240;210;713;282;953
110147;201507;769;2235;609;1950;163;560;225;641;388;1201
110148;201507;1256;3786;924;3074;294;1030;181;571;475;1601
110149;201507;3330;10029;2711;8985;824;2763;1294;4413;2118;7176
110150;201507;2431;7204;2109;6721;480;1629;969;3138;1449;4767
110155;201507;842;2616;763;2437;202;690;382;1169;584;1859
110160;201507;2015;6361;1674;5711;578;2021;628;2128;1206;4149
110170;201507;2937;8261;2174;6883;473;1584;1145;3562;1618;5146
110175;201507;1689;5117;1309;4628;220;849;763;2792;983;3641
110180;201507;1427;4181;1194;3834;281;911;715;2350;996;3261
120001;201507;2712;9495;2542;9210;464;1805;1659;6124;2123;7929
120005;201507;1493;6229;1421;6094;130;603;1116;4917;1246;5520
120010;201507;4410;15400;4185;15041;657;2323;3076;11379;3733;13702
120013;201507;1731;6902;1660;6795;390;1545;1058;4606;1448;6151
120017;201507;2011;7265;1869;7009;514;1985;867;3544;1381;5529
120020;201507;13899;62112;13466;61302;2031;9249;9787;46196;11818;55445
120025;201507;2463;8557;2373;8430;456;1750;1546;5543;2002;7293
120030;201507;5949;23634;5831;23504;240;998;5347;21757;5587;22755
120032;201507;1444;6938;1384;6794;193;1118;995;4910;1188;6028
120033;201507;3523;14001;3444;13858;270;1104;3005;12251;3275;13355
120034;201507;1983;8252;1918;8152;179;930;1567;6593;1746;7523
120035;201507;2882;13491;2832;13383;204;1063;2437;11649;2641;12712
120038;201507;2568;9390;2447;9158;627;2420;1350;5175;1977;7595
120039;201507;1591;8172;1555;8087;159;914;1214;6391;1373;7305
120040;201507;44438;158524;40197;150125;10075;40412;19898;75600;29973;116012
120042;201507;2835;12273;2692;11948;371;1785;1899;8570;2270;10355
120043;201507;882;4247;853;4197;67;291;723;3693;790;3984
120045;201507;4158;14291;4080;14190;638;2315;3198;11209;3836;13524
120050;201507;7850;32761;7495;31958;1237;5276;4985;22271;6222;27547
120060;201507;7273;33129;7152;32891;631;3304;5899;27420;6530;30724
120070;201507;2596;9875;2525;9712;431;1626;1691;6747;2122;8373
120080;201507;3494;13311;3313;13021;506;2024;2456;9908;2962;11932
130002;201507;2999;12489;2836;12221;204;1026;2363;10211;2567;11237
130006;201507;1908;8130;1675;7700;256;1323;1149;5331;1405;6654
130008;201507;2097;8423;1999;8254;171;739;1634;6829;1805;7568
130010;201507;2812;9452;2440;9022;188;743;2111;7847;2299;8590
130014;201507;3153;10382;2801;9819;459;1723;1841;6506;2300;8229
130020;201507;2619;9514;2560;9417;56;273;2320;8465;2376;8738
130030;201507;7145;27212;6884;26902;577;1979;5878;23726;6455;25705
130040;201507;3746;11462;3351;10939;269;970;2754;9092;3023;10062
130050;201507;5988;24276;5507;23550;474;1982;4399;19627;4873;21609
130060;201507;5586;26223;5339;25773;521;2928;4204;20294;4725;23222
130063;201507;3541;15697;3473;15611;305;1423;2961;13507;3266;14930
130068;201507;3053;12865;2764;12265;381;1797;1803;8114;2184;9911
130070;201507;6637;21592;5909;20685;645;2304;4566;16315;5211;18619
130080;201507;4886;22139;4673;21801;770;3828;3271;15589;4041;19417
130083;201507;2153;8573;2031;8388;303;1427;1421;5868;1724;7295
130090;201507;2564;9250;2476;9108;128;596;2175;7938;2303;8534
130100;201507;5466;20605;5313;20407;198;886;4926;18921;5124;19807
130110;201507;6441;20964;6056;20490;716;2270;4806;16783;5522;19053
130115;201507;4302;15320;4085;15015;104;352;3773;13962;3877;14314
130120;201507;13888;53317;13218;52444;1338;5280;10827;43946;12165;49226
130130;201507;3643;15215;3584;15099;266;1286;3058;12935;3324;14221
130140;201507;6188;24046;6105;23950;168;676;5766;22664;5934;23340
130150;201507;3374;13152;3303;13064;178;947;2908;11333;3086;12280
130160;201507;4145;17195;4019;17015;459;2249;3283;13789;3742;16038
130165;201507;2849;11794;2731;11591;301;1380;2144;9171;2445;10551
130170;201507;8796;32153;7894;31051;1024;4240;6020;24163;7044;28403
130180;201507;3468;11231;3380;11107;129;319;3124;10408;3253;10727
130185;201507;10729;34901;9727;33744;889;2881;8043;28966;8932;31847
130190;201507;16638;57341;14649;54756;2704;10132;9645;37585;12349;47717
130195;201507;1902;7983;1843;7898;106;463;1631;7082;1737;7545
130200;201507;1968;7051;1823;6817;474;1771;1093;4196;1567;5967
130210;201507;1174;4650;1111;4564;112;543;910;3729;1022;4272
130220;201507;1940;8068;1773;7743;310;1553;1021;4464;1331;6017
130230;201507;3607;16297;3376;15900;413;2024;2490;12162;2903;14186
130240;201507;8324;31878;7705;30949;417;2107;6643;26749;7060;28856
130250;201507;19346;67594;18252;66163;2721;9782;13353;50313;16074;60095
130255;201507;4125;14618;3926;14301;145;494;3566;13173;3711;13667
130260;201507;239669;787514;215780;746050;61396;224200;98551;344704;159947;568904
130270;201507;6943;29446;6413;28591;877;4076;4739;21778;5616;25854
130280;201507;3192;13086;3110;12973;163;712;2792;11818;2955;12530
130290;201507;11154;39397;10737;38908;140;264;10337;38122;10477;38386
130300;201507;4198;16554;4021;16260;285;1358;3399;13723;3684;15081
130310;201507;5022;18976;4653;18507;359;1451;3874;15727;4233;17178
130320;201507;2891;10278;2637;9919;351;1380;1900;7292;2251;8672
130330;201507;3486;12845;3254;12539;219;1020;2718;10470;2937;11490
130340;201507;17207;66416;16070;64963;2902;11595;11643;48667;14545;60262
130350;201507;3219;13426;3142;13317;299;1630;2551;10664;2850;12294
130353;201507;5879;18032;5128;17045;1156;3778;3105;11028;4261;14806
130356;201507;4397;15849;4149;15487;363;1231;3369;13118;3732;14349
130360;201507;3175;9049;2878;8720;118;332;2644;8131;2762;8463
130370;201507;5242;20546;4466;19449;255;1446;3546;15437;3801;16883
130380;201507;7537;31297;7235;30883;517;2425;6219;26787;6736;29212
130390;201507;4819;21534;4479;20930;468;2409;3404;16182;3872;18591
130395;201507;2049;7404;1813;6904;292;1175;1169;4414;1461;5589
130400;201507;2035;7825;1960;7724;138;629;1744;6859;1882;7488
130406;201507;10404;39473;9361;37913;2193;9233;5701;23753;7894;32986
130410;201507;3853;14792;3493;14114;1054;4534;1567;6549;2621;11083
130420;201507;10270;43597;9858;42921;2609;10990;6160;28203;8769;39193
130423;201507;3185;12432;2995;12173;260;1283;2512;10146;2772;11429
130426;201507;2095;9200;2038;9097;294;1381;1511;6863;1805;8244
130430;201507;3269;11793;3156;11619;370;1433;2436;9069;2806;10502
130440;201507;3486;12787;3347;12631;191;733;2994;11416;3185;12149
140002;201507;1618;5254;1504;5093;154;541;1095;3774;1249;4315
140005;201507;2979;8779;2846;8630;89;218;2703;8267;2792;8485
140010;201507;51340;154591;43135;141789;10615;37423;20223;68341;30838;105764
140015;201507;2858;9276;2698;9068;331;920;2139;7528;2470;8448
140017;201507;3177;9881;2871;9491;289;914;2237;7649;2526;8563
140020;201507;4401;15126;4087;14654;570;2208;2956;10589;3526;12797
140023;201507;2110;7167;1851;6769;258;1026;1268;4691;1526;5717
140028;201507;2111;5846;1995;5674;129;393;1624;4467;1753;4860
140030;201507;3704;11666;3502;11376;465;1226;2651;8971;3116;10197
140040;201507;1615;7516;1570;7408;109;621;1278;6055;1387;6676
140045;201507;2436;9064;2218;8739;465;1653;1414;6108;1879;7761
140047;201507;5359;15007;4766;14225;1395;4248;2310;7334;3705;11582
140050;201507;1477;4655;1336;4475;274;954;830;2812;1104;3766
140060;201507;1494;4587;1345;4354;292;1000;835;2728;1127;3728
140070;201507;1417;7557;1375;7410;94;594;1152;6210;1246;6804
150010;201507;33822;105268;32020;102888;2018;6850;27017;87607;29035;94457
150013;201507;1660;4863;1527;4712;166;494;1201;3792;1367;4286
150020;201507;12233;40981;11838;40446;999;3334;10117;35079;11116;38413
150030;201507;6597;28499;6390;28175;626;2446;5328;24341;5954;26787
150034;201507;4225;11795;4013;11520;231;640;3502;10089;3733;10729
150040;201507;12519;41107;10757;38968;2096;6971;7344;28626;9440;35597
150050;201507;5679;21922;5462;21539;325;1526;4669;18442;4994;19968
150060;201507;16400;51788;15050;49706;2539;8135;10301;35075;12840;43210
150070;201507;5838;23968;5235;23325;353;1743;4603;20659;4956;22402
150080;201507;66361;175220;56872;162396;10329;28371;35068;104225;45397;132596
150085;201507;5131;17692;4879;17353;522;1594;4001;14824;4523;16418
150090;201507;9842;37949;9351;37234;914;3629;7377;30025;8291;33654
150095;201507;5176;17290;4727;16621;413;1363;3771;13704;4184;15067
150100;201507;3244;12178;3058;11846;191;926;2467;9403;2658;10329
150110;201507;3275;16247;3265;16224;204;980;2955;14861;3159;15841
150120;201507;6059;23217;5926;22981;654;2432;4762;18825;5416;21257
150125;201507;741;2172;657;2067;119;413;436;1340;555;1753
150130;201507;21466;65209;19933;63077;1894;5710;15645;50742;17539;56452
150140;201507;149065;425958;141494;416133;14524;41816;114003;339886;128527;381702
150145;201507;4451;14325;4069;13835;616;2170;3028;10482;3644;12652
150150;201507;11010;34393;10187;33126;1642;5561;7089;23321;8731;28882
150157;201507;3101;9348;2701;8777;359;1295;1948;6404;2307;7699
150160;201507;2989;9715;2791;9425;837;2867;1484;5191;2321;8058
150170;201507;21443;79338;20224;77323;3333;12864;14144;55103;17477;67967
150172;201507;2940;10194;2615;9647;430;1613;1781;6718;2211;8331
150175;201507;1950;5853;1830;5717;146;420;1507;4900;1653;5320
150178;201507;9906;31178;8887;29981;905;3186;6765;23425;7670;26611
150180;201507;17886;71869;17187;70942;1435;6476;14310;59593;15745;66069
150190;201507;6905;23129;6616;22724;335;1122;5837;20339;6172;21461
150195;201507;5010;16772;4655;16194;311;1166;3915;13726;4226;14892
150200;201507;5250;16837;5027;16580;135;432;4666;15566;4801;15998
150210;201507;24063;91145;23244;89986;2300;8475;18925;75723;21225;84198
150215;201507;6334;20081;5507;18733;1515;5439;2394;8232;3909;13671
150220;201507;12077;37641;10737;35511;2399;8178;5662;19089;8061;27267
150230;201507;10763;36025;9737;34519;1193;4754;7051;25065;8244;29819
150240;201507;34685;103016;30308;95484;9916;32293;10289;33687;20205;65980
150250;201507;4072;16557;3929;16341;534;2283;2970;12708;3504;14991
150260;201507;2031;8197;1924;7992;373;1561;1212;5179;1585;6740
150270;201507;8397;26098;6771;24049;1582;5914;3995;14444;5577;20358
150275;201507;5791;21148;5506;20685;716;2718;4042;15471;4758;18189
150276;201507;2060;6248;1849;5955;419;1439;1244;3997;1663;5436
150277;201507;4818;14980;4194;14196;782;2700;2827;9866;3609;12566
150280;201507;5742;25676;5576;25295;1113;5058;3701;17329;4814;22387
150285;201507;2654;10676;2517;10424;523;2232;1538;6608;2061;8840
150290;201507;9548;28201;9127;27716;708;1727;7795;24530;8503;26257
150293;201507;9534;26235;7267;23035;2185;7398;2627;8989;4812;16387
150295;201507;6855;20923;5730;19575;1369;4723;3342;12165;4711;16888
150300;201507;1788;6315;1708;6215;151;604;1344;4957;1495;5561
150304;201507;3980;12599;3501;11891;579;1991;2303;8045;2882;10036
150307;201507;6468;21826;6008;21176;400;1346;5002;17840;5402;19186
150309;201507;6103;21174;5584;20433;1206;4380;3562;13629;4768;18009
150310;201507;5808;25860;5621;25563;677;3225;4402;20348;5079;23573
150320;201507;9083;21291;8417;20597;461;754;7535;19053;7996;19807
150330;201507;13342;46140;12463;44863;1531;5400;9536;35397;11067;40797
150340;201507;2351;7641;2176;7378;299;1046;1568;5386;1867;6432
150345;201507;6442;21679;6065;21171;596;2047;4909;17535;5505;19582
150350;201507;7502;23941;7028;23314;1118;3168;5203;18040;6321;21208
150360;201507;20585;64725;18094;61461;2854;9801;12349;43393;15203;53194
150370;201507;9537;35385;9011;34669;1214;4362;7054;28183;8268;32545
150375;201507;2756;12137;2693;12050;256;1118;2288;10434;2544;11552
150380;201507;9699;28355;8589;26807;627;2025;7102;22470;7729;24495
150390;201507;7680;33241;7231;32404;1340;5869;4719;21961;6059;27830
150400;201507;5715;22753;5479;22261;517;2062;4327;18032;4844;20094
150405;201507;8022;24429;7175;23380;1337;3630;4882;17366;6219;20996
150410;201507;1566;6107;1479;5931;219;969;978;3978;1197;4947
150420;201507;35309;120276;30077;111602;8957;35916;11533;44611;20490;80527
150430;201507;6998;23887;6674;23360;931;3147;4859;17479;5790;20626
150440;201507;5391;18838;5179;18545;943;3223;3664;13598;4607;16821
150442;201507;19609;58507;17872;55880;3242;10332;11450;36522;14692;46854
150445;201507;4970;17417;4621;16817;633;2264;3382;12600;4015;14864
150450;201507;4231;20543;4086;20325;343;1758;3423;17366;3766;19124
150460;201507;6387;24858;5883;24258;363;1830;5033;20991;5396;22821
150470;201507;17060;52231;16411;51465;519;1318;15340;48773;15859;50091
150475;201507;2455;8559;2263;8312;241;870;1826;6886;2067;7756
150480;201507;13470;46241;12567;44885;1201;4534;10136;36599;11337;41133
150490;201507;6738;26064;6594;25844;281;1195;5857;23122;6138;24317
150495;201507;4877;18109;4763;17952;244;980;4321;16341;4565;17321
150497;201507;2755;10095;2516;9609;793;3231;1181;4481;1974;7712
150500;201507;3069;8539;2851;8231;311;868;2173;6290;2484;7158
150503;201507;3683;11462;3205;10864;1093;3786;1647;5857;2740;9643
150506;201507;11185;39341;10131;37823;2301;8155;6460;25726;8761;33881
150510;201507;9386;37033;8652;35621;1352;5706;5857;24943;7209;30649
150520;201507;6618;25906;6516;25762;294;1103;6050;24159;6344;25262
150530;201507;11837;40922;10655;39116;1144;4001;8177;30699;9321;34700
150540;201507;4556;14078;4110;13444;296;999;3403;11173;3699;12172
150543;201507;5393;16912;4857;16118;1017;3502;3050;10346;4067;13848
150548;201507;8700;28128;8166;27453;343;1136;7439;25249;7782;26385
150549;201507;2095;6744;1936;6563;84;290;1739;5961;1823;6251
150550;201507;19542;61771;17015;57415;5211;18047;6763;23428;11974;41475
150553;201507;22641;78019;18854;69973;7023;27864;4670;17370;11693;45234
150555;201507;1596;4947;1414;4658;102;384;1089;3579;1191;3963
150560;201507;1932;6260;1820;6022;261;865;1219;4040;1480;4905
150563;201507;2843;9223;2628;8845;640;2323;1448;4862;2088;7185
150565;201507;3635;12598;3313;12100;209;914;2730;10053;2939;10967
150570;201507;5551;20727;5421;20506;415;1839;4356;16536;4771;18375
150580;201507;9473;39576;9249;39308;622;2508;8142;35372;8764;37880
150590;201507;5658;22884;5503;22690;100;313;5237;21836;5337;22149
150600;201507;7802;30224;7516;29802;393;1623;6702;26875;7095;28498
150610;201507;2337;8046;2135;7625;251;995;1485;5233;1736;6228
150611;201507;2640;9330;2471;8995;214;856;1950;7123;2164;7979
150613;201507;11731;35608;9917;32922;3279;11361;4245;14527;7524;25888
150616;201507;2982;9129;2329;8072;564;2167;903;2971;1467;5138
150618;201507;6176;21499;5738;20689;1601;5948;2944;10787;4545;16735
150619;201507;5106;17591;4768;17065;571;2248;3495;12524;4066;14772
150620;201507;6234;22529;5718;21855;741;2820;4476;17545;5217;20365
150630;201507;5599;16956;5318;16622;468;1513;4483;14250;4951;15763
150635;201507;3921;12956;3600;12325;759;2706;1980;6914;2739;9620
150640;201507;1735;5390;1677;5316;232;691;1320;4405;1552;5096
150650;201507;12273;37124;10879;34703;2919;9446;4976;16421;7895;25867
150655;201507;4870;16473;4624;16039;629;2208;3417;12038;4046;14246
150658;201507;4141;13025;3735;12440;930;3421;2204;7318;3134;10739
150660;201507;5470;17447;4993;16751;1216;4028;2750;9569;3966;13597
150670;201507;6454;17846;5442;16562;915;2914;3947;12291;4862;15205
150680;201507;53577;194227;47511;183591;14544;58136;20177;83387;34721;141523
150690;201507;2004;6244;1807;5922;327;1014;1142;3873;1469;4887
150700;201507;6148;18947;5620;18276;1028;3428;3713;12363;4741;15791
150710;201507;4232;14238;3789;13507;440;1614;2785;10131;3225;11745
150715;201507;4909;15500;4267;14512;536;1988;3137;10748;3673;12736
150720;201507;6379;26140;6011;25469;862;3734;4344;19064;5206;22798
150730;201507;9252;32021;8755;31181;931;3244;7119;25950;8050;29194
150740;201507;3683;11760;3297;11068;592;2119;1935;6495;2527;8614
150745;201507;5220;16553;4774;15933;1134;3949;2948;9824;4082;13773
150746;201507;1359;4489;1302;4388;177;649;918;3108;1095;3757
150747;201507;5340;16679;4694;15876;422;1205;3641;13129;4063;14334
150750;201507;3088;10316;2889;10064;209;815;2414;8437;2623;9252
150760;201507;10781;35279;10086;34337;2101;7222;6344;22171;8445;29393
150770;201507;5708;21764;5325;20970;527;1996;4354;18047;4881;20043
150775;201507;1147;3489;1005;3233;205;821;552;1687;757;2508
150780;201507;3153;10410;3093;10341;67;197;2925;9853;2992;10050
150790;201507;4905;15935;4544;15495;380;1377;3707;13151;4087;14528
150795;201507;15388;47930;13778;45575;2804;9249;8565;29296;11369;38545
150796;201507;2916;8720;2660;8425;375;1130;1988;6521;2363;7651
150797;201507;3615;12267;3361;11867;129;542;2949;10407;3078;10949
150800;201507;13569;45158;12514;43867;2630;8627;8482;31471;11112;40098
150803;201507;6524;23647;6128;23002;667;2626;4596;17490;5263;20116
150805;201507;2598;9275;2434;9005;318;1147;1778;6724;2096;7871
150808;201507;5511;18646;4643;17022;1894;7439;832;3064;2726;10503
150810;201507;18535;58032;15721;54545;2178;7202;10917;39921;13095;47123
150812;201507;5174;16290;4745;15572;486;1956;3446;10856;3932;12812
150815;201507;8357;27291;7553;26293;768;2627;6134;21842;6902;24469
150820;201507;11208;32035;9960;30653;705;1602;8344;26527;9049;28129
150830;201507;12789;48128;11756;46592;594;2685;9974;40734;10568;43419
150835;201507;1997;7060;1847;6767;459;1733;888;3316;1347;5049
150840;201507;6622;20263;5503;18420;1298;4719;2659;8835;3957;13554
160005;201507;636;2349;599;2283;61;289;467;1736;528;2025
160010;201507;1377;4584;1373;4579;69;147;1276;4368;1345;4515
160015;201507;1671;6208;1632;6151;93;324;1458;5617;1551;5941
160020;201507;1997;7084;1854;6888;229;882;1374;5232;1603;6114
160021;201507;954;4122;922;4063;149;759;634;2805;783;3564
160023;201507;1038;4133;1025;4109;100;386;865;3519;965;3905
160025;201507;1247;3839;1233;3824;25;97;1195;3685;1220;3782
160027;201507;8079;24274;7479;23606;2630;7847;3824;13120;6454;20967
160030;201507;43419;155343;38603;146405;9123;34433;21771;87070;30894;121503
160040;201507;4134;16337;4044;16200;172;922;3702;14667;3874;15589
160050;201507;3059;11616;2783;11248;1251;5020;1165;5039;2416;10059
160053;201507;2620;10138;2556;10039;543;2222;1691;6758;2234;8980
160055;201507;634;2485;624;2473;78;339;489;1936;567;2275
160060;201507;15093;51389;14125;50305;2842;9605;9656;35762;12498;45367
160070;201507;2418;9417;2292;9193;176;846;1918;7624;2094;8470
160080;201507;2550;9576;2524;9543;95;503;2360;8807;2455;9310
170025;201507;512;1710;468;1643;140;494;239;886;379;1380
170030;201507;1159;3794;1021;3541;305;1078;367;1293;672;2371
170035;201507;1498;4373;1191;3806;350;1215;408;1295;758;2510
170040;201507;1853;6026;1633;5724;272;1106;1006;3624;1278;4730
170070;201507;1800;4794;1417;4284;326;1071;745;2205;1071;3276
170100;201507;2431;7141;2123;6660;252;834;1617;5054;1869;5888
170105;201507;751;2354;593;2031;115;453;307;1007;422;1460
170110;201507;1054;3299;896;3033;203;744;420;1418;623;2162
170130;201507;1344;4264;1150;3902;301;1053;563;1960;864;3013
170190;201507;1577;4620;1191;3996;501;1620;240;928;741;2548
170200;201507;1616;4563;1063;3496;264;958;305;943;569;1901
170210;201507;31326;89231;24946;78714;7102;24138;7545;24730;14647;48868
170215;201507;1169;3645;993;3371;81;334;743;2494;824;2828
170220;201507;5604;19359;5192;18547;1130;4262;2928;10526;4058;14788
170230;201507;1429;4596;1188;4131;245;997;564;1856;809;2853
170240;201507;2644;8090;2229;7448;302;1208;1505;4967;1807;6175
170255;201507;3316;10653;2796;9782;853;3003;1213;4449;2066;7452
170270;201507;1022;2568;719;2152;85;272;475;1408;560;1680
170290;201507;2656;8352;2479;8133;158;428;2157;7304;2315;7732
170300;201507;1939;5977;1609;5435;217;821;1033;3501;1250;4322
170305;201507;760;2305;610;2033;111;401;319;1070;430;1471
170307;201507;1081;3796;901;3453;179;771;463;1833;642;2604
170310;201507;1607;4443;1218;3788;306;1003;550;1744;856;2747
170320;201507;1096;3188;800;2660;206;727;288;982;494;1709
170330;201507;733;2415;670;2313;96;374;490;1661;586;2035
170360;201507;445;1438;375;1317;85;321;169;579;254;900
170370;201507;1367;3925;1091;3477;223;806;554;1754;777;2560
170380;201507;1781;5757;1437;5192;265;1122;770;2706;1035;3828
170382;201507;542;1811;466;1686;117;476;242;854;359;1330
170384;201507;1530;6266;1421;6067;328;1515;824;3536;1152;5051
170386;201507;910;2715;788;2530;177;623;378;1210;555;1833
170388;201507;646;1927;525;1723;109;426;205;641;314;1067
170389;201507;910;3048;828;2910;89;354;601;2095;690;2449
170390;201507;1264;3706;1104;3504;111;385;830;2682;941;3067
170410;201507;529;1674;453;1538;48;205;294;978;342;1183
170460;201507;494;1345;346;1093;83;294;118;362;201;656
170510;201507;788;2646;647;2382;86;382;340;1218;426;1600
170550;201507;6485;18687;4851;15789;1562;5617;804;2532;2366;8149
170555;201507;1328;3822;1043;3383;229;804;514;1683;743;2487
170560;201507;967;3294;783;3045;169;713;444;1800;613;2513
170600;201507;1294;3765;1161;3582;248;750;753;2419;1001;3169
170610;201507;1564;4861;1248;4343;133;542;784;2723;917;3265
170625;201507;427;1329;331;1143;66;232;95;336;161;568
170650;201507;1230;3964;1057;3651;253;955;458;1624;711;2579
170700;201507;4051;12859;3290;11576;661;2577;1490;5410;2151;7987
170710;201507;1794;5319;1461;4706;237;809;892;2909;1129;3718
170720;201507;1808;4897;1505;4398;326;858;910;2821;1236;3679
170730;201507;989;2848;806;2563;216;739;362;1147;578;1886
170740;201507;2173;7786;1918;7332;265;1128;1312;5048;1577;6176
170755;201507;807;2490;662;2180;143;545;236;743;379;1288
170765;201507;1338;3655;1045;3162;291;929;425;1306;716;2235
170770;201507;1711;5807;1572;5550;259;980;975;3440;1234;4420
170820;201507;3572;11399;3194;10779;758;2699;1538;5272;2296;7971
170825;201507;747;2223;597;1927;114;393;254;795;368;1188
170830;201507;1385;4035;1217;3789;25;52;1115;3524;1140;3576
170900;201507;2557;9069;2424;8841;230;834;1935;7202;2165;8036
170930;201507;3565;11080;3084;10228;968;3423;1099;3711;2067;7134
170950;201507;13848;39970;10215;33481;3223;11959;2005;6328;5228;18287
170980;201507;494;1492;372;1280;88;339;153;495;241;834
171050;201507;1458;4977;1314;4701;95;420;1055;3740;1150;4160
171070;201507;1510;4742;1380;4547;336;1114;767;2595;1103;3709
171090;201507;997;2749;828;2511;69;211;599;1813;668;2024
171110;201507;601;1759;454;1497;123;446;191;589;314;1035
171150;201507;838;2392;607;1984;101;364;359;1183;460;1547
171180;201507;685;2065;479;1639;121;438;183;663;304;1101
171190;201507;1618;5955;1422;5541;289;1198;716;2888;1005;4086
171195;201507;818;2906;710;2687;98;405;410;1581;508;1986
171200;201507;674;2150;549;1910;150;581;207;651;357;1232
171215;201507;456;1361;352;1152;64;228;148;496;212;724
171240;201507;729;2579;673;2470;82;357;458;1714;540;2071
171245;201507;632;2081;514;1798;108;439;167;536;275;975
171250;201507;1084;3141;870;2778;143;530;515;1558;658;2088
171270;201507;410;1692;385;1641;122;503;156;742;278;1245
171280;201507;861;2620;723;2395;181;582;346;1256;527;1838
171320;201507;3839;11657;3275;10668;881;2881;1530;5085;2411;7966
171330;201507;2861;8348;2334;7523;606;2064;1047;3353;1653;5417
171360;201507;1408;4587;1242;4326;211;744;784;2784;995;3528
171370;201507;674;1922;581;1791;136;461;314;947;450;1408
171380;201507;1312;4232;1106;3848;416;1457;370;1336;786;2793
171395;201507;873;2634;684;2279;151;600;316;1001;467;1601
171420;201507;2251;6761;1721;5797;428;1532;638;2106;1066;3638
171430;201507;1026;3165;859;2893;202;681;446;1504;648;2185
171488;201507;2435;7459;2135;7023;488;1616;1173;3973;1661;5589
171500;201507;765;2350;670;2184;93;291;449;1508;542;1799
171510;201507;892;3132;802;2981;74;326;576;2157;650;2483
171515;201507;489;1413;388;1239;58;193;216;679;274;872
171525;201507;614;2014;523;1854;106;434;265;904;371;1338
171550;201507;303;1018;234;884;85;356;36;140;121;496
171570;201507;1231;3908;1080;3608;190;646;728;2442;918;3088
171575;201507;1866;5315;1435;4511;270;878;663;2121;933;2999
171610;201507;5151;16722;4357;15301;1215;4729;1568;5433;2783;10162
171620;201507;2535;7466;2224;7031;114;439;1868;5905;1982;6344
171630;201507;867;2750;711;2484;236;890;269;914;505;1804
171650;201507;2156;6691;1700;5789;447;1651;634;2167;1081;3818
171660;201507;2464;6809;1909;5819;259;872;1141;3486;1400;4358
171665;201507;1438;4274;1175;3852;175;624;705;2393;880;3017
171670;201507;1921;5510;1617;5008;421;1458;732;2158;1153;3616
171700;201507;1075;3504;935;3236;143;571;599;2043;742;2614
171720;201507;718;2105;599;1900;213;675;228;745;441;1420
171750;201507;1164;3624;935;3145;267;935;313;1066;580;2001
171780;201507;1142;3182;881;2805;107;375;517;1688;624;2063
171790;201507;1439;4875;1265;4614;217;773;846;3223;1063;3996
171800;201507;642;2023;571;1929;72;271;417;1439;489;1710
171820;201507;9824;29042;8365;27000;1659;5847;4742;15364;6401;21211
171830;201507;1416;5285;1281;4982;345;1359;580;2273;925;3632
171840;201507;801;2248;695;2102;44;137;575;1753;619;1890
171845;201507;734;2002;572;1735;98;335;302;898;400;1233
171850;201507;944;3362;834;3139;106;459;518;1943;624;2402
171855;201507;1133;3567;1025;3357;90;354;759;2421;849;2775
171865;201507;467;1506;401;1395;92;356;195;657;287;1013
171870;201507;711;2153;576;1915;131;467;230;807;361;1274
171875;201507;1317;4164;1100;3809;121;501;748;2538;869;3039
171880;201507;814;3038;793;3004;77;308;646;2494;723;2802
171884;201507;952;2649;690;2256;156;570;207;775;363;1345
171886;201507;1437;4699;1163;4108;352;1366;331;1124;683;2490
171888;201507;660;2034;545;1820;62;219;307;1049;369;1268
171889;201507;487;1575;451;1511;94;338;258;878;352;1216
171890;201507;1152;3655;982;3406;146;567;589;2047;735;2614
171900;201507;494;1859;439;1751;120;489;208;837;328;1326
172000;201507;560;1854;485;1706;74;287;278;966;352;1253
172010;201507;1174;4101;1093;3963;127;552;800;2882;927;3434
172015;201507;339;1305;283;1199;58;232;155;695;213;927
172020;201507;2216;7439;2053;7174;256;928;1457;5159;1713;6087
172025;201507;726;2091;556;1800;80;286;309;1015;389;1301
172030;201507;1130;3739;1000;3516;82;363;740;2566;822;2929
172049;201507;1320;3517;997;2959;145;441;745;2251;890;2692
172065;201507;1240;3450;1059;3241;61;189;959;2973;1020;3162
172080;201507;2510;7753;2117;7051;232;913;1386;4536;1618;5449
172085;201507;514;1402;367;1122;60;188;116;345;176;533
172090;201507;3159;9568;2606;8699;302;1085;1859;6324;2161;7409
172093;201507;596;1842;465;1621;123;515;211;714;334;1229
172097;201507;665;1972;533;1762;127;424;219;761;346;1185
172100;201507;29075;90143;23129;79105;7016;26722;6474;21810;13490;48532
172110;201507;1672;6234;1496;5948;187;788;1074;4402;1261;5190
172120;201507;5091;15733;4268;14633;543;1985;2982;10376;3525;12361
172125;201507;263;815;222;740;37;140;104;344;141;484
172130;201507;542;1509;434;1333;44;166;286;888;330;1054
172208;201507;2076;6258;1872;5943;342;1151;1064;3409;1406;4560
172210;201507;2437;7580;2170;7159;501;1787;1190;3867;1691;5654
210005;201507;21464;66859;18091;61644;5481;20002;7385;25345;12866;45347
210010;201507;1553;5660;1395;5383;134;570;1049;4107;1183;4677
210015;201507;3266;10367;2934;9869;202;509;2490;8642;2692;9151
210020;201507;6816;16888;6430;16420;233;629;5869;14976;6102;15605
210030;201507;5495;18326;5157;17861;350;1547;4293;14799;4643;16346
210040;201507;1801;5162;1658;4997;112;355;1400;4223;1512;4578
210043;201507;6387;18439;5577;17389;534;1550;4240;13856;4774;15406
210047;201507;6262;24497;5780;23649;683;3079;4177;17195;4860;20274
210050;201507;2306;8506;1920;7765;651;2708;717;3052;1368;5760
210055;201507;1699;5820;1562;5629;165;615;1200;4385;1365;5000
210060;201507;7211;27761;6700;26827;824;3515;4768;19457;5592;22972
210070;201507;6839;20419;6327;19776;171;653;5658;17715;5829;18368
210080;201507;3657;12616;3576;12505;51;230;3381;11808;3432;12038
210083;201507;4268;14947;3972;14632;85;243;3796;14182;3881;14425
210087;201507;2823;8458;2578;8146;266;865;2069;6624;2335;7489
210090;201507;9686;31795;9221;31046;390;1534;8117;27372;8507;28906
210095;201507;5754;21390;5570;21124;410;1646;4661;17925;5071;19571
210100;201507;7121;21434;6557;20743;905;3038;4912;15466;5817;18504
210110;201507;2844;9993;2757;9874;111;517;2485;8851;2596;9368
210120;201507;25788;71007;22091;66654;2668;6833;16589;52996;19257;59829
210125;201507;3494;11149;3358;11006;239;650;2925;9832;3164;10482
210130;201507;4044;12103;3795;11754;258;822;3206;9957;3464;10779
210135;201507;1675;4928;1476;4648;112;343;1192;3804;1304;4147
210140;201507;16665;53500;14496;50461;2690;9701;9094;32778;11784;42479
210150;201507;4449;11059;4008;10511;73;190;3748;9828;3821;10018
210160;201507;17171;54740;16177;53274;1552;4558;13138;44639;14690;49197
210170;201507;13705;49062;13352;48608;746;2576;11929;44127;12675;46703
210173;201507;1912;7964;1856;7862;118;639;1616;6752;1734;7391
210177;201507;2998;9348;2845;9167;176;617;2494;8061;2670;8678
210180;201507;1467;4506;1370;4359;62;233;1170;3669;1232;3902
210190;201507;4753;15170;4413;14553;235;1041;3490;11280;3725;12321
210193;201507;1389;4391;1254;4168;72;255;1050;3542;1122;3797
210197;201507;2073;6846;1911;6663;245;833;1478;5311;1723;6144
210200;201507;8436;28466;7847;27615;971;3141;6016;22064;6987;25205
210203;201507;6339;20722;6051;20338;379;1098;5286;18034;5665;19132
210207;201507;2950;9753;2773;9430;373;1162;2033;7162;2406;8324
210210;201507;8454;28482;8035;27946;112;488;7420;26160;7532;26648
210215;201507;1247;5095;1193;5010;105;506;975;4107;1080;4613
210220;201507;5981;23042;5712;22613;426;1830;4714;18867;5140;20697
210230;201507;4914;16502;4642;16060;308;1124;3942;13766;4250;14890
210232;201507;12124;40093;10259;37808;1571;5936;7035;27400;8606;33336
210235;201507;3451;10906;3132;10492;198;792;2652;8904;2850;9696
210237;201507;2324;9028;2278;8955;81;464;2077;8031;2158;8495
210240;201507;2984;9426;2805;9176;170;548;2345;7714;2515;8262
210250;201507;4998;16202;4735;15864;125;548;4350;14514;4475;15062
210255;201507;2479;7957;2273;7585;359;1237;1604;5422;1963;6659
210260;201507;5210;16767;4734;16065;648;2132;3465;12111;4113;14243
210270;201507;5354;15251;4709;14352;121;545;4177;12625;4298;13170
210275;201507;3580;8747;3369;8519;56;84;3264;8352;3320;8436
210280;201507;5502;16591;4824;15698;303;1216;3804;12195;4107;13411
210290;201507;5396;17983;5002;17490;355;1205;4269;15192;4624;16397
210300;201507;36607;103774;30185;95858;2061;6742;23522;77547;25583;84289
210310;201507;2863;8089;2643;7797;83;195;2336;6941;2419;7136
210312;201507;2143;6901;2061;6788;72;328;1849;6055;1921;6383
210315;201507;2439;8427;2293;8221;168;714;1936;6933;2104;7647
210317;201507;4207;12827;4010;12576;230;724;3580;11349;3810;12073
210320;201507;18728;59971;17384;58324;963;3351;14936;50669;15899;54020
210325;201507;3518;11105;3154;10549;308;1154;2357;7916;2665;9070
210330;201507;36439;87778;28212;79037;3699;8233;19903;62747;23602;70980
210340;201507;11487;35006;10469;33715;1270;3333;7735;26825;9005;30158
210350;201507;9917;31106;9056;29899;623;2062;7390;24676;8013;26738
210355;201507;3832;14077;3551;13675;184;672;3140;12368;3324;13040
210360;201507;16070;48829;14711;46945;1102;3584;11954;38642;13056;42226
210370;201507;9165;22237;7795;20769;259;473;7005;19275;7264;19748
210375;201507;2976;9182;2567;8656;744;2576;1316;4578;2060;7154
210380;201507;6021;16942;5344;16030;405;1100;4458;13631;4863;14731
210390;201507;2812;9975;2563;9569;119;603;2200;8207;2319;8810
210400;201507;4796;15174;4638;14981;142;416;4337;14150;4479;14566
210405;201507;8166;22534;6614;20364;2052;6324;2728;9318;4780;15642
210407;201507;2028;7222;1769;6788;198;742;1295;5107;1493;5849
210408;201507;2346;9124;2199;8950;130;587;1900;7965;2030;8552
210409;201507;3710;13569;3509;13265;189;822;2964;11294;3153;12116
210410;201507;3413;11514;3301;11379;272;719;2850;10240;3122;10959
210420;201507;3977;13113;3646;12532;269;904;2931;10236;3200;11140
210430;201507;2182;6745;2106;6653;117;386;1832;5789;1949;6175
210440;201507;3970;12512;3865;12371;195;567;3524;11431;3719;11998
210450;201507;2826;8895;2526;8455;166;618;2048;6802;2214;7420
210455;201507;4068;11889;3580;11143;557;1751;2491;8020;3048;9771
210460;201507;3622;12013;3413;11691;139;566;2962;10173;3101;10739
210462;201507;1497;5438;1395;5246;95;433;1125;4238;1220;4671
210465;201507;2533;8425;2360;8179;287;782;1910;6923;2197;7705
210467;201507;6131;20316;5727;19846;375;1143;4943;17538;5318;18681
210470;201507;2036;5568;1560;4885;75;235;1211;3837;1286;4072
210480;201507;13549;44818;12004;42755;2751;9537;7413;28143;10164;37680
210490;201507;3494;9943;3095;9371;169;569;2577;7751;2746;8320
210500;201507;6264;25831;6034;25420;718;2925;4556;19803;5274;22728
210510;201507;6424;22043;6132;21690;364;1115;5253;19097;5617;20212
210515;201507;3515;11614;3366;11441;108;340;3125;10746;3233;11086
210520;201507;2525;7892;2315;7603;89;289;2102;6973;2191;7262
210530;201507;35328;109772;28658;99668;7220;28320;12973;46071;20193;74391
210535;201507;3175;11046;3043;10853;119;428;2723;9806;2842;10234
210540;201507;13063;43719;11489;41381;2658;9229;6499;25428;9157;34657
210542;201507;5690;16591;5250;16117;322;760;4577;14493;4899;15253
210545;201507;2249;7399;2136;7210;67;328;1859;6217;1926;6545
210547;201507;3751;13205;3511;12806;283;967;2833;10586;3116;11553
210550;201507;5884;17558;5436;17090;276;687;4948;15937;5224;16624
210560;201507;4134;12927;3703;12221;209;791;3130;10291;3339;11082
210565;201507;1478;5211;1271;4887;111;554;934;3582;1045;4136
210570;201507;12332;34931;11159;33589;801;1726;9581;29951;10382;31677
210580;201507;3114;9479;2805;9094;332;853;2143;7547;2475;8400
210590;201507;4047;12719;3793;12419;272;899;3258;10719;3530;11618
210592;201507;2397;7537;2315;7403;45;190;2081;6650;2126;6840
210594;201507;2672;7514;2205;6841;119;357;1756;5570;1875;5927
210596;201507;2687;10041;2554;9790;262;1046;1950;7596;2212;8642
210598;201507;1886;5825;1744;5648;109;416;1504;4810;1613;5226
210600;201507;3172;9275;2801;8766;185;620;2289;7150;2474;7770
210610;201507;2491;8242;2324;8027;133;547;2035;6971;2168;7518
210620;201507;1885;6034;1771;5889;52;144;1614;5446;1666;5590
210630;201507;3640;12977;3204;12228;396;1648;2126;8279;2522;9927
210632;201507;4434;15619;4168;15224;376;1410;3337;12341;3713;13751
210635;201507;1895;6692;1803;6554;72;252;1637;6032;1709;6284
210637;201507;2703;9105;2509;8845;140;527;2107;7507;2247;8034
210640;201507;4196;15095;4125;15016;9;35;4044;14820;4053;14855
210650;201507;6813;20983;6656;20790;128;396;6432;20161;6560;20557
210660;201507;7738;23553;7176;22719;228;758;6647;21026;6875;21784
210663;201507;2658;7886;2498;7688;182;620;2097;6493;2279;7113
210667;201507;1784;6282;1693;6142;89;383;1456;5306;1545;5689
210670;201507;4352;16333;4169;16033;238;1043;3486;13549;3724;14592
210675;201507;4973;13852;4590;13380;339;891;3867;11545;4206;12436
210680;201507;4056;11419;3662;10937;187;483;3178;9607;3365;10090
210690;201507;7080;23840;6800;23534;259;795;6134;21830;6393;22625
210700;201507;2538;7650;2377;7475;418;1027;1661;5934;2079;6961
210710;201507;4740;15607;4492;15212;195;789;3865;13098;4060;13887
210720;201507;2504;9176;2358;8961;154;713;2064;7764;2218;8477
210725;201507;1070;4046;951;3832;133;573;589;2388;722;2961
210730;201507;1100;3516;1001;3376;97;289;772;2661;869;2950
210735;201507;4068;14274;3729;13694;682;2519;2478;9458;3160;11977
210740;201507;4870;14268;4642;14031;146;538;4195;12455;4341;12993
210745;201507;3833;11490;3583;11161;246;601;3076;9782;3322;10383
210750;201507;20031;54164;17622;51443;1980;5668;13713;40937;15693;46605
210760;201507;5888;16374;5512;15973;46;170;5339;15439;5385;15609
210770;201507;5697;15926;5038;15178;154;612;4605;13821;4759;14433
210780;201507;8352;27783;7639;26519;883;3182;5532;19613;6415;22795
210790;201507;4565;14477;4145;13983;295;737;3452;12241;3747;12978
210800;201507;4709;13466;4278;12939;171;502;3771;11531;3942;12033
210805;201507;3633;15389;3508;15163;161;818;3042;13268;3203;14086
210810;201507;5310;16420;4962;15983;375;748;4264;14418;4639;15166
210820;201507;7774;22457;7103;21513;1214;3556;4772;14825;5986;18381
210825;201507;5618;19304;5355;18943;499;1664;4354;15759;4853;17423
210830;201507;8245;24742;7854;24275;750;2015;6522;20803;7272;22818
210840;201507;3639;10044;3271;9487;194;485;2670;7779;2864;8264
210845;201507;5595;17421;5404;17215;131;289;5115;16598;5246;16887
210850;201507;5983;21545;5474;20648;762;3219;3761;14174;4523;17393
210860;201507;17246;52085;15648;49927;1394;4530;12502;40493;13896;45023
210870;201507;5890;19675;5392;19079;540;1773;4328;15730;4868;17503
210880;201507;4186;13559;4044;13360;232;848;3487;11526;3719;12374
210890;201507;5261;15459;4797;14926;440;1332;3987;12724;4427;14056
210900;201507;4880;14733;4003;13281;1354;4674;1269;4501;2623;9175
210905;201507;1807;5671;1645;5443;139;358;1294;4445;1433;4803
210910;201507;8598;27286;7807;26004;1267;4500;5287;17686;6554;22186
210920;201507;2986;10595;2877;10423;147;570;2511;9171;2658;9741
210923;201507;1488;5210;1371;5037;158;644;945;3557;1103;4201
210927;201507;4753;15142;4544;14922;40;175;4422;14531;4462;14706
210930;201507;2451;8982;2345;8847;137;715;2031;7556;2168;8271
210940;201507;2792;10917;2738;10817;197;801;2330;9281;2527;10082
210945;201507;5805;17496;5626;17305;243;330;5282;16678;5525;17008
210950;201507;5275;16229;4610;15169;451;1501;3450;11579;3901;13080
210955;201507;1883;6091;1657;5759;206;700;1151;4188;1357;4888
210960;201507;8619;28350;8258;27850;2255;7351;4775;17141;7030;24492
210970;201507;1337;4805;1184;4562;153;705;828;3168;981;3873
210975;201507;1709;5801;1629;5665;141;545;1277;4460;1418;5005
210980;201507;9780;23299;9505;23003;692;1438;8396;20796;9088;22234
210990;201507;16477;49650;13381;45506;2882;10309;7501;26301;10383;36610
211000;201507;15324;49601;13709;47631;772;3108;11596;40717;12368;43825
211003;201507;4719;16780;4308;16169;336;1498;3285;12555;3621;14053
211010;201507;6504;23496;6282;23243;85;342;6039;22460;6124;22802
211020;201507;7244;23381;7053;23069;417;1445;6079;19870;6496;21315
211023;201507;2256;7666;2182;7535;150;602;1856;6412;2006;7014
211027;201507;2859;11228;2779;11103;254;972;2300;9403;2554;10375
211030;201507;3842;11887;3597;11628;549;1232;2847;9982;3396;11214
211040;201507;4213;16100;4068;15866;150;754;3575;14033;3725;14787
211050;201507;10050;26349;9822;26095;241;548;9334;24924;9575;25472
211060;201507;5923;21169;5762;20935;468;1732;4922;18100;5390;19832
211065;201507;1833;6132;1672;5928;99;367;1488;5328;1587;5695
211070;201507;8077;27662;7447;26618;444;1712;6223;22457;6667;24169
211080;201507;1370;4172;1149;3849;95;447;888;2874;983;3321
211085;201507;1844;6379;1670;6074;322;1195;1043;3857;1365;5052
211090;201507;3478;10344;3268;10062;123;515;2849;8644;2972;9159
211100;201507;6630;17145;6470;16973;43;149;6315;16560;6358;16709
211102;201507;3055;11388;2890;11159;243;897;2469;9734;2712;10631
211105;201507;2658;8505;2285;7955;183;740;1813;6240;1996;6980
211107;201507;4458;14264;4038;13700;222;752;3413;11875;3635;12627
211110;201507;6222;18658;5041;16870;1018;3339;3000;10536;4018;13875
211120;201507;34138;93965;30196;89232;4869;13719;21288;65393;26157;79112
211125;201507;2077;6708;1866;6383;108;381;1603;5518;1711;5899
211130;201507;131621;368386;119479;353094;21481;63284;78388;236367;99869;299651
211140;201507;5296;16915;4947;16381;199;772;4302;14225;4501;14997
211150;201507;9592;28196;8771;27183;481;1713;7434;23023;7915;24736
211153;201507;2797;8656;2626;8443;389;1162;1959;6462;2348;7624
211157;201507;1188;3819;1021;3568;97;435;691;2469;788;2904
211160;201507;4024;13490;3441;12507;310;1479;2413;8570;2723;10049
211163;201507;1636;5454;1558;5342;44;140;1410;4930;1454;5070
211167;201507;1471;4911;1405;4817;45;207;1301;4447;1346;4654
211170;201507;6361;16896;6085;16574;104;326;5645;15298;5749;15624
211172;201507;2394;7077;2159;6734;151;634;1801;5481;1952;6115
211174;201507;2797;8179;2539;7854;72;339;2271;6908;2343;7247
211176;201507;4536;14160;3974;13447;451;1573;2919;10077;3370;11650
211178;201507;3638;9911;3496;9754;78;209;3291;9156;3369;9365
211180;201507;4215;14880;3980;14520;304;1254;3305;12167;3609;13421
211190;201507;2780;9396;2578;9107;93;450;2238;7903;2331;8353
211195;201507;1467;4489;1216;4175;73;214;1012;3613;1085;3827
211200;201507;2107;7093;1862;6772;286;954;1335;5154;1621;6108
211210;201507;6777;20696;6490;20317;343;992;5716;18113;6059;19105
211220;201507;33026;96826;28759;91429;5589;18223;18730;61108;24319;79331
211223;201507;5012;14914;4595;14244;560;1773;3324;10435;3884;12208
211227;201507;1565;5733;1446;5548;117;531;1167;4500;1284;5031
211230;201507;8371;27631;7602;26355;908;3236;5689;20074;6597;23310
211240;201507;7983;27599;7619;27155;256;976;6998;24983;7254;25959
211245;201507;5360;15670;5325;15632;118;212;5145;15298;5263;15510
211250;201507;12643;43108;11912;42272;1501;4006;9426;35872;10927;39878
211260;201507;8461;26290;8171;25914;576;1928;7186;22800;7762;24728
211270;201507;10274;35382;9219;34062;544;2368;7525;28253;8069;30621
211280;201507;12624;37441;11878;36543;1109;2759;9896;31706;11005;34465
211285;201507;1707;6230;1508;5792;287;1183;785;3129;1072;4312
211290;201507;7160;23688;6910;23366;598;1757;5800;20122;6398;21879
211300;201507;8142;24672;7632;23982;192;577;7047;22319;7239;22896
211400;201507;11508;36049;10325;34476;2659;8843;5261;19369;7920;28212
220005;201507;1824;5269;1678;5055;68;273;1390;4078;1458;4351
220010;201507;1385;4009;1217;3753;77;293;940;2842;1017;3135
220020;201507;3282;10340;3093;10016;569;1891;2030;6565;2599;8456
220025;201507;2174;5386;1970;5076;29;97;1709;4340;1738;4437
220027;201507;1358;3687;1228;3517;71;197;1017;2940;1088;3137
220030;201507;3223;9036;3157;8933;162;547;2780;7795;2942;8342
220040;201507;7431;23363;6957;22539;1385;4581;4453;14408;5838;18989
220045;201507;1379;4488;1262;4264;71;290;961;3186;1032;3476
220050;201507;4422;13235;3898;12347;245;956;3103;9671;3348;10627
220060;201507;1931;5008;1831;4889;55;110;1668;4475;1723;4585
220070;201507;2389;7110;2188;6792;142;465;1777;5501;1919;5966
220080;201507;681;2124;653;2077;64;280;531;1621;595;1901
220090;201507;1763;4498;1502;4160;68;224;1293;3516;1361;3740
220095;201507;725;1970;673;1895;21;85;603;1646;624;1731
220100;201507;1348;4103;1137;3744;106;377;829;2736;935;3113
220105;201507;2206;7111;1969;6661;167;584;1463;4971;1630;5555
220110;201507;3370;9964;3163;9629;148;582;2736;8197;2884;8779
220115;201507;2358;8333;2270;8194;171;711;1959;7026;2130;7737
220117;201507;1307;3504;1082;3169;81;237;876;2575;957;2812
220120;201507;12155;35200;11303;34148;174;754;10644;32025;10818;32779
220130;201507;897;3054;780;2888;67;260;644;2394;711;2654
220140;201507;1629;4419;1449;4198;221;508;1131;3416;1352;3924
220150;201507;6961;21592;6577;21052;195;790;5839;18529;6034;19319
220155;201507;1106;3415;897;3019;57;239;591;1934;648;2173
220157;201507;1046;2667;934;2496;22;67;824;2184;846;2251
220160;201507;2652;8002;2356;7486;120;500;1890;5908;2010;6408
220170;201507;1346;4198;1173;3910;54;251;945;3092;999;3343
220173;201507;2038;6207;1688;5528;56;278;1375;4405;1431;4683
220177;201507;1766;5195;1732;5140;66;240;1598;4707;1664;4947
220180;201507;1134;3091;933;2721;30;111;654;1825;684;1936
220190;201507;4361;14780;4089;14370;585;2046;3128;11122;3713;13168
220191;201507;1408;4764;1339;4646;193;656;946;3303;1139;3959
220192;201507;1809;5101;1427;4410;120;391;994;3068;1114;3459
220194;201507;1641;4950;1475;4660;123;421;1086;3336;1209;3757
220196;201507;1926;5729;1779;5486;176;580;1362;4195;1538;4775
220198;201507;1325;3741;1042;3373;16;60;968;3161;984;3221
220200;201507;4299;14623;4075;14289;619;2212;2920;10339;3539;12551
220202;201507;2055;6395;1842;6006;50;231;1592;5080;1642;5311
220205;201507;2765;7252;2483;6852;47;203;2232;6064;2279;6267
220207;201507;866;2687;763;2505;73;290;570;1841;643;2131
220208;201507;1791;5816;1549;5378;215;846;980;3355;1195;4201
220209;201507;1487;4585;1357;4377;52;229;1098;3505;1150;3734
220210;201507;1702;4621;1503;4309;42;180;1269;3552;1311;3732
220211;201507;1621;4751;1541;4648;83;339;1329;3941;1412;4280
220213;201507;1688;4871;1557;4624;40;161;1286;3728;1326;3889
220217;201507;1900;6195;1829;6111;43;163;1688;5697;1731;5860
220220;201507;10867;30350;9799;28740;840;2174;7133;21463;7973;23637
220225;201507;1064;3139;921;2944;32;131;779;2434;811;2565
220230;201507;5263;14660;4798;13991;163;482;4244;12388;4407;12870
220240;201507;2821;8845;2621;8484;170;639;2045;6590;2215;7229
220245;201507;1494;4007;1309;3744;45;146;1134;3264;1179;3410
220250;201507;3170;9042;2930;8680;72;269;2611;7699;2683;7968
220253;201507;1651;5029;1431;4638;152;563;1064;3411;1216;3974
220255;201507;1735;4960;1507;4569;73;305;1201;3465;1274;3770
220260;201507;4779;15286;4210;14233;344;1224;3140;10660;3484;11884
220265;201507;1325;4620;1206;4423;106;444;817;3040;923;3484
220270;201507;6601;21430;6376;21017;325;1544;5476;17524;5801;19068
220271;201507;1470;4116;1350;3929;86;232;1139;3353;1225;3585
220272;201507;1752;5368;1593;5081;68;299;1288;4033;1356;4332
220273;201507;1211;3533;1067;3274;98;309;772;2343;870;2652
220275;201507;2076;5340;1728;4916;32;134;1575;4409;1607;4543
220277;201507;2232;6328;1996;5955;97;331;1608;4755;1705;5086
220280;201507;1610;4311;1417;3980;100;366;1114;3023;1214;3389
220285;201507;1583;4286;1350;3958;28;116;1198;3523;1226;3639
220290;201507;5966;20182;5222;19143;475;1993;3954;14544;4429;16537
220300;201507;1919;6310;1723;6041;87;436;1392;4806;1479;5242
220310;201507;2356;8151;2211;7989;72;243;1959;7292;2031;7535
220320;201507;3217;9673;2755;8827;321;1127;1967;6300;2288;7427
220323;201507;1457;5229;1281;4969;137;566;976;3835;1113;4401
220325;201507;1156;3772;1020;3494;89;368;732;2492;821;2860
220327;201507;1288;4177;1190;4013;45;241;983;3239;1028;3480
220330;201507;3541;9748;3298;9447;141;406;2952;8499;3093;8905
220335;201507;1862;5666;1696;5468;51;163;1550;5043;1601;5206
220340;201507;1897;5283;1630;4883;126;406;1244;3697;1370;4103
220342;201507;1079;3656;1010;3548;73;314;813;2839;886;3153
220345;201507;2835;7524;2497;6994;52;154;2268;6349;2320;6503
220350;201507;3940;10498;3419;9679;195;582;2713;7641;2908;8223
220360;201507;1276;3582;1103;3300;106;356;839;2472;945;2828
220370;201507;8957;25972;8197;24953;385;1269;7214;21872;7599;23141
220375;201507;1533;4758;1428;4629;28;87;1353;4429;1381;4516
220380;201507;1380;3732;1175;3452;53;172;967;2815;1020;2987
220385;201507;825;2134;670;1884;20;74;547;1505;567;1579
220390;201507;9393;29191;8410;27370;2163;7366;3306;10872;5469;18238
220400;201507;1510;3556;1221;3112;39;134;1017;2496;1056;2630
220410;201507;1408;3989;1169;3641;94;365;898;2732;992;3097
220415;201507;864;2350;768;2226;56;162;565;1611;621;1773
220420;201507;2141;6243;1839;5635;95;300;1467;4480;1562;4780
220430;201507;2525;7321;2456;7227;150;482;2131;6238;2281;6720
220435;201507;1581;4729;1460;4523;43;156;1207;3720;1250;3876
220440;201507;2379;7951;2217;7743;109;436;1923;6634;2032;7070
220450;201507;2132;6601;1816;6137;416;1469;1057;3590;1473;5059
220455;201507;1307;4165;1222;4050;45;145;1116;3736;1161;3881
220460;201507;900;2446;834;2367;42;130;740;2075;782;2205
220465;201507;2320;7693;2101;7360;557;2048;1157;4094;1714;6142
220470;201507;3834;11435;3506;10895;201;695;2745;8396;2946;9091
220480;201507;2494;7117;2200;6682;148;433;1740;5285;1888;5718
220490;201507;2304;6593;2123;6360;69;257;1866;5526;1935;5783
220500;201507;3254;8816;2761;7973;109;486;2269;6371;2378;6857
220510;201507;2719;7910;2185;6989;100;405;1620;5103;1720;5508
220515;201507;1990;4826;1710;4462;162;387;1354;3576;1516;3963
220520;201507;5093;14070;4681;13514;111;350;4255;12320;4366;12670
220525;201507;1304;3681;1218;3550;49;163;1046;3034;1095;3197
220527;201507;1398;4296;1240;3964;145;486;903;2934;1048;3420
220530;201507;1212;3566;1087;3382;57;237;933;2829;990;3066
220535;201507;889;2674;842;2614;85;278;640;1967;725;2245
220540;201507;3426;11155;3275;10920;145;624;2823;9309;2968;9933
220545;201507;1387;4668;1325;4552;169;662;961;3241;1130;3903
220550;201507;9119;29432;8530;28469;1029;3654;6202;20639;7231;24293
220551;201507;1421;4646;1305;4460;72;324;1060;3575;1132;3899
220552;201507;1574;4975;1366;4574;70;347;1041;3346;1111;3693
220553;201507;1582;4641;1307;4221;55;211;1020;3320;1075;3531
220554;201507;813;2361;720;2222;65;206;557;1721;622;1927
220555;201507;2294;6825;2136;6617;51;196;1950;6014;2001;6210
220556;201507;1443;4495;1287;4199;65;271;983;3119;1048;3390
220557;201507;1548;5054;1391;4750;167;621;946;3216;1113;3837
220558;201507;1050;3259;952;3087;70;308;713;2221;783;2529
220559;201507;1494;4244;1358;4007;33;117;1171;3433;1204;3550
220560;201507;1667;4159;1384;3764;65;179;1150;3075;1215;3254
220570;201507;7230;23388;6826;22677;1270;4186;4476;15278;5746;19464
220580;201507;6431;20689;6249;20438;299;972;5646;18500;5945;19472
220585;201507;1991;7141;1887;6949;144;602;1525;5602;1669;6204
220590;201507;1312;3948;1194;3784;198;655;802;2599;1000;3254
220595;201507;2298;6813;2147;6613;46;203;1940;5914;1986;6117
220600;201507;1277;3109;1037;2811;179;339;748;2189;927;2528
220605;201507;1962;5748;1684;5294;81;275;1352;4190;1433;4465
220610;201507;2671;8110;2576;7971;70;275;2331;7174;2401;7449
220620;201507;7504;25248;7284;24936;285;1280;6547;22246;6832;23526
220630;201507;408;1258;349;1146;60;206;193;641;253;847
220635;201507;1678;5955;1523;5620;97;472;1086;3929;1183;4401
220640;201507;2672;7798;2429;7457;129;452;2035;6199;2164;6651
220650;201507;2253;6527;2006;6087;121;425;1584;4745;1705;5170
220660;201507;2515;8056;2256;7703;167;764;1869;6209;2036;6973
220665;201507;1175;4072;1116;3966;30;161;1011;3563;1041;3724
220667;201507;1730;5745;1637;5611;61;214;1422;4903;1483;5117
220669;201507;1864;6108;1754;5907;272;1080;1179;3902;1451;4982
220670;201507;2025;6052;1823;5793;148;387;1511;4952;1659;5339
220672;201507;2516;7182;2380;7023;242;718;1963;5840;2205;6558
220675;201507;1272;3679;1193;3542;81;208;946;2834;1027;3042
220680;201507;2249;7287;2124;7114;166;551;1767;5976;1933;6527
220690;201507;1667;4671;1454;4324;99;314;1163;3485;1262;3799
220695;201507;897;2563;821;2438;43;138;642;1887;685;2025
220700;201507;8519;24462;7508;22894;548;1905;5828;17624;6376;19529
220710;201507;817;2400;682;2164;46;147;496;1578;542;1725
220720;201507;2009;5445;1918;5329;55;168;1721;4768;1776;4936
220730;201507;1383;3905;1183;3593;37;162;1002;2999;1039;3161
220735;201507;1004;2593;816;2261;39;134;668;1816;707;1950
220740;201507;1349;4407;1189;4189;112;373;968;3505;1080;3878
220750;201507;3980;11521;3713;11119;407;1020;2915;9005;3322;10025
220755;201507;1218;3429;1100;3233;50;173;886;2561;936;2734
220760;201507;2632;9148;2461;8918;136;648;2093;7493;2229;8141
220770;201507;21893;72647;19573;68164;6457;23550;6956;25080;13413;48630
220775;201507;1234;3262;1197;3220;12;32;1168;3146;1180;3178
220777;201507;1618;4491;1449;4243;86;244;1152;3341;1238;3585
220779;201507;1325;3544;1275;3469;40;150;1154;3062;1194;3212
220780;201507;5952;15921;5268;14902;369;1034;4322;12276;4691;13310
220785;201507;1236;3337;1177;3227;45;106;1058;2884;1103;2990
220790;201507;9906;30751;9220;29673;846;2915;7263;23262;8109;26177
220793;201507;840;2396;768;2289;42;158;654;1932;696;2090
220795;201507;1465;4104;1408;4022;71;216;1273;3630;1344;3846
220800;201507;16143;44563;14607;42362;934;3268;11306;32258;12240;35526
220810;201507;3300;9614;2857;8851;145;594;2268;6913;2413;7507
220820;201507;5284;14610;4889;14046;174;581;4412;12588;4586;13169
220830;201507;7457;21085;6951;20260;669;1960;5470;16046;6139;18006
220840;201507;14193;44947;12594;41724;2970;9995;5956;20109;8926;30104
220850;201507;2838;9816;2700;9644;129;534;2388;8565;2517;9099
220855;201507;629;1931;554;1799;39;148;411;1311;450;1459
220860;201507;957;2578;851;2409;36;132;708;1975;744;2107
220865;201507;2613;7265;2120;6411;89;432;1680;4883;1769;5315
220870;201507;2253;7576;2023;7259;96;439;1784;6334;1880;6773
220880;201507;4757;12817;4450;12450;115;327;4153;11655;4268;11982
220885;201507;1305;4693;1149;4403;99;466;855;3250;954;3716
220887;201507;1409;3492;1212;3217;20;63;1125;2976;1145;3039
220890;201507;1608;5645;1447;5337;118;442;1123;4218;1241;4660
220900;201507;1850;5305;1636;4910;58;162;1398;4194;1456;4356
220910;201507;1618;4858;1421;4569;53;162;1240;4042;1293;4204
220915;201507;1010;2879;874;2622;40;174;682;1987;722;2161
220920;201507;1317;4760;1204;4593;109;524;899;3365;1008;3889
220930;201507;1361;4537;1300;4446;60;260;1075;3655;1135;3915
220935;201507;1072;3273;937;2994;45;191;636;1945;681;2136
220937;201507;1509;4133;1271;3717;64;233;985;2806;1049;3039
220940;201507;1373;4298;1270;4083;75;324;955;3004;1030;3328
220945;201507;435;1605;403;1542;37;164;288;1080;325;1244
220950;201507;1329;3322;973;2748;29;124;702;1918;731;2042
220955;201507;1444;4218;1264;3909;79;255;944;2892;1023;3147
220960;201507;890;2326;702;2008;14;47;551;1554;565;1601
220965;201507;1692;5046;1580;4878;68;324;1337;4003;1405;4327
220970;201507;2167;5759;1602;4848;143;444;1092;3329;1235;3773
220975;201507;653;2157;614;2099;27;134;561;1879;588;2013
220980;201507;1279;3905;1123;3638;93;338;822;2672;915;3010
220985;201507;1200;3523;1132;3423;90;336;861;2521;951;2857
220987;201507;1491;4737;1342;4478;81;355;1033;3343;1114;3698
220990;201507;1821;5251;1575;4842;47;230;1221;3660;1268;3890
220995;201507;1311;3802;973;3270;107;389;679;2319;786;2708
220997;201507;2195;6897;2081;6724;57;234;1928;6190;1985;6424
221000;201507;4262;13108;3964;12589;379;1401;3029;9515;3408;10916
221005;201507;1451;4579;1326;4338;490;1497;581;2053;1071;3550
221010;201507;1138;3092;974;2877;47;149;830;2431;877;2580
221020;201507;1784;5542;1662;5319;75;314;1247;3914;1322;4228
221030;201507;1492;4420;1350;4174;67;279;1135;3467;1202;3746
221035;201507;1411;3938;1334;3842;49;108;1237;3623;1286;3731
221037;201507;632;1887;566;1776;19;75;410;1228;429;1303
221038;201507;614;1726;497;1520;41;125;322;991;363;1116
221039;201507;910;2606;830;2490;45;185;696;2026;741;2211
221040;201507;4592;14160;4312;13699;216;762;3551;11331;3767;12093
221050;201507;3483;10688;3297;10434;169;629;2838;8921;3007;9550
221060;201507;8171;23670;7216;22135;701;2382;5330;16245;6031;18627
221062;201507;1266;4517;1183;4354;60;312;1017;3687;1077;3999
221063;201507;1035;3440;959;3293;236;755;545;2010;781;2765
221065;201507;2769;7660;2492;7206;167;479;2021;5785;2188;6264
221070;201507;3866;12173;3411;11402;165;670;2780;9281;2945;9951
221080;201507;3463;9107;2990;8472;124;389;2564;7263;2688;7652
221090;201507;1382;3811;1180;3483;38;173;971;2792;1009;2965
221093;201507;1650;4942;1557;4741;286;925;873;2585;1159;3510
221095;201507;956;2602;864;2467;23;62;741;2114;764;2176
221097;201507;790;2225;652;1978;44;181;468;1358;512;1539
221100;201507;113821;332194;104257;316292;19453;63055;64956;194284;84409;257339
221110;201507;10072;32139;9478;31402;435;1773;8109;26624;8544;28397
221120;201507;3899;12822;3696;12470;744;2624;2446;8295;3190;10919
221130;201507;4526;13121;3841;11735;1190;3655;1672;5146;2862;8801
221135;201507;1494;4661;1387;4510;132;500;1140;3647;1272;4147
221140;201507;1327;3289;1206;3125;44;105;1050;2701;1094;2806
221150;201507;1209;3104;997;2740;28;126;789;2112;817;2238
221160;201507;828;2179;778;2101;39;113;630;1710;669;1823
221170;201507;1140;3541;1056;3402;57;198;849;2728;906;2926
230010;201507;3262;9024;2727;8110;231;824;2035;5891;2266;6715
230015;201507;2892;9971;2703;9558;403;1656;1683;5819;2086;7475
230020;201507;13710;44914;13296;44201;658;2468;11457;38089;12115;40557
230030;201507;11934;34617;10868;32950;528;1863;9005;27092;9533;28955
230040;201507;4607;12687;3893;11481;312;1110;2836;8225;3148;9335
230050;201507;2628;9011;2069;7516;425;1604;809;2948;1234;4552
230060;201507;2124;6181;1837;5656;93;347;1367;4133;1460;4480
230070;201507;4347;11945;3714;10928;328;1098;2575;7622;2903;8720
230075;201507;8716;31407;8169;30298;602;3118;6354;22923;6956;26041
230080;201507;2399;6330;1954;5675;101;327;1616;4701;1717;5028
230090;201507;3761;11051;3344;10324;432;1523;2336;7161;2768;8684
230100;201507;16408;49198;14990;46597;2640;8854;8948;27950;11588;36804
230110;201507;13147;41908;12103;39694;2256;7832;6850;22256;9106;30088
230120;201507;7927;22009;6815;20373;781;2282;4657;14682;5438;16964
230125;201507;3001;8730;2461;7719;178;606;1785;5563;1963;6169
230130;201507;5895;19200;4976;17254;470;1926;3411;11620;3881;13546
230140;201507;3550;11381;3024;10431;400;1487;1985;6943;2385;8430
230150;201507;1668;5263;1437;4782;273;1010;818;2647;1091;3657
230160;201507;6214;18728;5548;17694;339;1333;4402;13902;4741;15235
230170;201507;6383;19992;5465;18238;354;1406;3980;13089;4334;14495
230180;201507;1753;5165;1553;4768;106;432;1114;3268;1220;3700
230185;201507;4037;13214;3661;12515;593;2092;2277;7999;2870;10091
230190;201507;12709;40554;11175;37405;2279;8391;5420;17834;7699;26225
230195;201507;5127;15717;4535;14730;290;1252;3569;11235;3859;12487
230200;201507;5243;15128;4722;14116;365;1189;3615;10724;3980;11913
230205;201507;4224;13498;3780;12729;260;1124;2772;9240;3032;10364
230210;201507;8896;25756;7717;23897;1654;5171;4272;13587;5926;18758
230220;201507;12976;37345;11698;35123;1182;4026;8434;24848;9616;28874
230230;201507;7394;24011;6707;22659;959;3382;4355;14863;5314;18245
230240;201507;13627;38699;12016;35920;620;2337;9415;27507;10035;29844
230250;201507;9840;30654;9699;30426;529;1975;7762;24027;8291;26002
230260;201507;14404;48486;13398;46450;2367;8775;7586;26765;9953;35540
230270;201507;7401;22037;6392;20292;742;2598;4264;13667;5006;16265
230280;201507;19513;58456;17484;54955;2003;6434;12459;39392;14462;45826
230290;201507;4794;14683;4112;13316;556;1784;2734;8889;3290;10673
230300;201507;4357;13329;4156;13038;299;1124;3370;10427;3669;11551
230310;201507;4789;14362;4199;13349;255;1082;3084;9602;3339;10684
230320;201507;6921;22020;6341;20972;473;1925;4755;15538;5228;17463
230330;201507;4747;13980;4074;12657;330;1140;2883;8835;3213;9975
230340;201507;3286;11164;3001;10539;376;1488;1940;6646;2316;8134
230350;201507;17966;54925;16233;51945;2128;7599;9533;30862;11661;38461
230360;201507;3285;9407;2679;8278;276;959;1765;5376;2041;6335
230365;201507;2956;8100;2608;7519;131;494;2091;5930;2222;6424
230370;201507;53216;171529;47680;161845;12688;45503;21876;76247;34564;121750
230380;201507;6454;19062;5485;17284;340;1175;3924;12306;4264;13481
230390;201507;3489;11005;3091;10311;259;1124;2185;7123;2444;8247
230393;201507;3273;10790;2783;9789;229;1081;1967;6653;2196;7734
230395;201507;5488;16304;4913;15289;752;2382;3051;9757;3803;12139
230400;201507;5318;16358;4648;15281;285;1259;3575;11495;3860;12754
230410;201507;14266;45635;12506;41876;1800;6471;7697;25763;9497;32234
230420;201507;23876;77586;21730;73188;5029;18230;10205;34149;15234;52379
230423;201507;4161;13742;3839;13095;270;1138;2881;9705;3151;10843
230425;201507;5550;18424;5062;17316;693;2496;3285;11254;3978;13750
230426;201507;2713;7594;2168;6550;95;388;1589;4652;1684;5040
230427;201507;1830;5480;1390;4516;151;500;836;2649;987;3149
230428;201507;8507;26731;8106;26004;1267;4520;4998;15848;6265;20368
230430;201507;4462;14278;4128;13631;335;1384;2964;9522;3299;10906
230435;201507;4773;15489;4300;14615;792;3058;2325;7817;3117;10875
230440;201507;342917;1027412;314028;976542;74196;243740;150196;469226;224392;712966
230445;201507;4503;12183;3785;11113;267;808;2715;7975;2982;8783
230450;201507;3500;11210;3045;10359;370;1564;1986;6603;2356;8167
230460;201507;1894;6291;1664;5864;171;700;1135;3937;1306;4637
230465;201507;4066;12186;3415;10993;260;1084;2263;7078;2523;8162
230470;201507;10567;39025;9834;37494;1136;4766;7102;27176;8238;31942
230480;201507;1449;4660;1235;4261;160;620;817;2796;977;3416
230490;201507;2452;7428;2130;6804;367;1268;1063;3252;1430;4520
230495;201507;5770;19123;5157;18049;736;3068;2865;9916;3601;12984
230500;201507;9356;32943;8931;32123;620;2720;6885;24691;7505;27411
230510;201507;1494;5326;1189;4548;309;1258;379;1477;688;2735
230520;201507;4822;14849;4325;13943;448;1669;2854;9100;3302;10769
230523;201507;14424;47009;12538;42662;2978;11106;3239;11190;6217;22296
230526;201507;3966;12107;3452;11225;264;1093;2579;8255;2843;9348
230530;201507;5332;17349;4801;16631;1003;3520;3051;10899;4054;14419
230533;201507;3919;11142;3515;10401;250;781;2739;8100;2989;8881
230535;201507;5546;16375;4838;15096;730;2291;2905;9329;3635;11620
230540;201507;17649;51532;15889;48725;796;3071;12974;39166;13770;42237
230550;201507;19142;57689;17209;53942;3432;11689;9090;27943;12522;39632
230560;201507;6610;19124;5841;17723;248;1008;4543;13486;4791;14494
230565;201507;3403;9521;2760;8298;149;554;2014;5989;2163;6543
230570;201507;3650;9984;3238;9474;118;452;2744;7950;2862;8402
230580;201507;10024;30535;9345;29576;483;1706;8191;25931;8674;27637
230590;201507;8921;27974;7734;25713;592;2508;5557;17948;6149;20456
230600;201507;3716;10448;2894;8809;186;642;1874;5675;2060;6317
230610;201507;6005;19496;5572;18794;739;2646;3905;13260;4644;15906
230620;201507;2152;6135;1704;5162;186;621;989;2895;1175;3516
230625;201507;7944;25643;7077;23687;2056;7454;2128;7039;4184;14493
230630;201507;11244;35780;10213;33876;2639;8257;4789;16988;7428;25245
230640;201507;25825;84837;23853;81888;2617;9883;18153;62319;20770;72202
230650;201507;4925;15064;4426;14102;311;1263;3365;10408;3676;11671
230655;201507;9068;34243;8690;33576;765;3243;6945;27059;7710;30302
230660;201507;6130;19161;5243;17505;387;1685;3876;12620;4263;14305
230670;201507;6088;16400;4880;14334;191;725;3736;10631;3927;11356
230680;201507;2823;8277;2376;7419;373;1254;1379;4257;1752;5511
230690;201507;6283;20539;6164;20295;538;2149;4232;13669;4770;15818
230700;201507;9220;26231;8220;24468;722;2605;5792;16686;6514;19291
230710;201507;7455;24330;6481;22485;756;2683;4584;16053;5340;18736
230720;201507;1855;5878;1603;5368;212;745;972;3274;1184;4019
230725;201507;3729;12631;3224;11370;756;2732;1262;4420;2018;7152
230730;201507;56954;171939;46980;155108;12768;46814;13689;46457;26457;93271
230740;201507;5934;18020;5428;17171;262;1115;4342;13473;4604;14588
230750;201507;8400;24253;7201;22305;445;1626;5495;16782;5940;18408
230760;201507;10433;31165;9666;29621;1039;3795;6780;19990;7819;23785
230763;201507;4258;13264;3867;12509;240;1133;2993;9336;3233;10469
230765;201507;37719;120053;33847;112305;9099;32856;11436;38106;20535;70962
230770;201507;24728;68715;22480;65583;2697;8415;15441;44939;18138;53354
230780;201507;5909;22945;5648;22345;1409;5718;2794;11568;4203;17286
230790;201507;2700;8741;2481;8357;261;978;1814;6117;2075;7095
230800;201507;7359;26301;6678;24778;1484;5947;3038;11118;4522;17065
230810;201507;11889;38811;11224;37651;919;3378;8829;29546;9748;32924
230820;201507;3313;11376;2894;10444;426;1774;1606;5673;2032;7447
230830;201507;7457;22814;6614;21246;572;2127;4776;15208;5348;17335
230835;201507;3983;10614;3262;9531;215;711;2489;7191;2704;7902
230837;201507;3143;10746;2734;9922;319;1409;1809;6405;2128;7814
230840;201507;9099;29724;8333;28386;749;2891;6235;21299;6984;24190
230850;201507;9646;29998;8966;28910;1007;3530;6421;20594;7428;24124
230860;201507;5131;14831;4541;13881;261;971;3662;11080;3923;12051
230870;201507;18582;49275;16146;45634;826;2712;12565;35238;13391;37950
230880;201507;1907;6533;1791;6299;185;801;1220;4219;1405;5020
230890;201507;3878;14228;3573;13541;480;2174;2244;8260;2724;10434
230900;201507;2943;9846;2496;8893;531;1863;1240;4521;1771;6384
230910;201507;3174;9307;2557;8187;202;875;1803;5587;2005;6462
230920;201507;4645;13538;4329;13153;242;927;3654;11041;3896;11968
230930;201507;7348;22293;6472;20626;644;2184;4463;14322;5107;16506
230940;201507;7749;22174;6728;20589;362;1149;5343;16459;5705;17608
230945;201507;6205;18635;5350;17362;492;1807;3699;12173;4191;13980
230950;201507;6355;17664;5747;16834;270;798;4837;14420;5107;15218
230960;201507;13965;43044;12678;40578;2607;8788;5836;18833;8443;27621
230970;201507;13265;40830;11664;37818;2317;8417;5432;17225;7749;25642
230980;201507;2939;9328;2575;8655;725;2462;1201;4250;1926;6712
230990;201507;1717;5148;1432;4582;140;591;922;2827;1062;3418
231000;201507;2787;7551;2181;6371;174;592;1393;3926;1567;4518
231010;201507;3203;8699;2633;7778;258;869;1856;5331;2114;6200
231020;201507;7874;26412;7452;25516;1330;4611;4607;16095;5937;20706
231025;201507;7981;24548;7235;23281;1018;3428;4723;15470;5741;18898
231030;201507;7665;25056;6516;22654;1175;4433;3724;12950;4899;17383
231040;201507;3130;10115;2784;9412;200;852;2000;6589;2200;7441
231050;201507;12006;34077;10207;30863;798;2707;7605;22797;8403;25504
231060;201507;2401;7782;2208;7424;172;808;1559;5068;1731;5876
231070;201507;8769;27870;7984;26286;1300;4565;4733;15690;6033;20255
231080;201507;4052;12692;3685;12051;190;925;2830;8867;3020;9792
231085;201507;4694;14694;4504;14437;682;2154;3138;10375;3820;12529
231090;201507;4128;11636;3313;9984;179;636;2310;6845;2489;7481
231095;201507;2288;7414;1954;6738;214;835;1304;4497;1518;5332
231100;201507;3199;9883;2666;8827;231;894;1886;6166;2117;7060
231110;201507;3632;12086;3566;11970;354;1371;2514;8371;2868;9742
231120;201507;2080;7003;1956;6743;306;1130;1274;4430;1580;5560
231123;201507;2093;5774;1779;5221;140;407;1381;4027;1521;4434
231126;201507;6236;17710;5252;16087;325;1253;3858;11613;4183;12866
231130;201507;19071;58842;17126;55571;3496;11651;9782;33135;13278;44786
231135;201507;4224;12605;3566;11445;295;1090;2519;8000;2814;9090
231140;201507;16570;52650;14692;49074;1329;5955;9856;31730;11185;37685
231150;201507;5738;16433;4837;14779;766;2531;2619;7898;3385;10429
231160;201507;5672;19134;5319;18440;886;3222;3466;12023;4352;15245
231170;201507;4201;13585;3779;12695;318;1342;2633;8568;2951;9910
231180;201507;13993;41902;12565;39048;2084;6997;7503;22966;9587;29963
231190;201507;4585;12988;3899;11952;264;958;3039;9139;3303;10097
231195;201507;4551;15436;3901;14130;403;1818;2741;9795;3144;11613
231200;201507;7727;26573;6736;24488;490;2454;4756;16800;5246;19254
231210;201507;5011;15546;4332;14602;287;1338;3373;11207;3660;12545
231220;201507;11748;34487;10517;32211;654;2510;7812;23451;8466;25961
231230;201507;8897;30236;8175;29105;785;3331;6140;21814;6925;25145
231240;201507;12103;38228;10875;35770;2228;7664;5433;18133;7661;25797
231250;201507;1969;5730;1358;4229;433;1318;286;898;719;2216
231260;201507;3544;10484;3186;9923;470;1457;2041;6454;2511;7911
231270;201507;7242;20083;6389;18731;359;1473;4816;13736;5175;15209
231280;201507;1743;5727;1620;5483;175;623;1133;3861;1308;4484
231290;201507;33191;113992;30014;106672;6413;25522;12547;43342;18960;68864
231300;201507;4549;13199;3683;11485;256;1004;2559;7737;2815;8741
231310;201507;7348;20926;6081;18311;938;2951;3422;10068;4360;13019
231320;201507;6905;21191;5879;19183;311;1307;4233;13733;4544;15040
231325;201507;2706;8109;2373;7558;293;968;1573;5124;1866;6092
231330;201507;12326;39158;10606;35740;1639;5584;6542;22278;8181;27862
231335;201507;5337;15267;4590;13918;222;887;3551;10481;3773;11368
231340;201507;17319;57100;15996;55083;1050;3657;12888;45164;13938;48821
231350;201507;13035;41589;12561;40890;1123;3508;10472;34587;11595;38095
231355;201507;4364;14019;4074;13533;287;1186;3084;10112;3371;11298
231360;201507;7622;24590;6847;23196;1401;4765;4080;14267;5481;19032
231370;201507;2463;6860;1927;5972;93;308;1430;4423;1523;4731
231375;201507;4152;14212;3873;13679;239;1129;3038;10532;3277;11661
231380;201507;5167;16563;4887;16179;621;2129;3388;11523;4009;13652
231390;201507;3383;10694;3126;10270;232;926;2304;7476;2536;8402
231395;201507;3855;12651;3506;11999;610;2130;2016;6945;2626;9075
231400;201507;9047;27789;8437;26566;582;2254;6247;19344;6829;21598
231410;201507;13704;46863;12663;45216;1230;4627;9676;34836;10906;39463
240010;201507;2432;7351;2032;6508;349;1236;977;3024;1326;4260
240020;201507;10636;33580;9442;31287;2139;7593;4587;15281;6726;22874
240030;201507;2398;7025;2342;6938;136;463;1965;5717;2101;6180
240040;201507;843;2501;705;2221;32;154;519;1547;551;1701
240050;201507;3430;9325;2929;8460;117;410;2350;6681;2467;7091
240060;201507;1386;4034;1242;3754;58;235;996;2891;1054;3126
240070;201507;2577;7421;2421;7122;382;1182;1651;4815;2033;5997
240080;201507;3039;8163;2616;7600;231;664;2006;5825;2237;6489
240090;201507;2266;6157;1896;5479;52;191;1473;4136;1525;4327
240100;201507;8141;23350;7353;21732;638;2114;5345;15401;5983;17515
240110;201507;4834;15035;4291;13944;654;2435;2420;7511;3074;9946
240120;201507;2687;9164;2562;8914;385;1470;1672;5753;2057;7223
240130;201507;2788;7535;2395;6935;139;509;1889;5331;2028;5840
240140;201507;2219;6653;1891;6052;317;1192;1043;3216;1360;4408
240145;201507;5762;18259;5210;17260;1379;4861;2581;8668;3960;13529
240150;201507;970;2969;801;2609;81;337;521;1615;602;1952
240160;201507;1426;4614;1235;4271;167;628;754;2684;921;3312
240165;201507;878;2811;766;2576;107;321;483;1712;590;2033
240170;201507;2362;7101;2059;6549;520;1823;955;2975;1475;4798
240180;201507;2585;8217;2318;7690;461;1621;1303;4391;1764;6012
240185;201507;1403;4717;1339;4601;108;398;1056;3642;1164;4040
240190;201507;982;3014;884;2838;52;231;658;2058;710;2289
240200;201507;13787;35894;11397;32602;2512;7334;5420;15980;7932;23314
240210;201507;2857;8046;2598;7678;194;714;2153;6258;2347;6972
240220;201507;7282;24189;6848;23540;589;2711;5279;17652;5868;20363
240230;201507;5522;14845;4852;13784;175;591;4105;11567;4280;12158
240240;201507;1833;5553;1260;4140;282;1057;244;678;526;1735
240250;201507;2674;7802;2510;7584;126;435;2123;6357;2249;6792
240260;201507;12102;40932;11457;39865;1827;7152;7393;25632;9220;32784
240270;201507;2220;7136;2043;6841;201;694;1564;5302;1765;5996
240280;201507;1532;4342;1374;4085;81;291;1114;3273;1195;3564
240290;201507;1287;4113;1136;3823;75;373;769;2460;844;2833
240300;201507;2247;6252;1636;4940;373;1216;588;1699;961;2915
240310;201507;9497;27290;8637;25933;1249;4135;4794;14477;6043;18612
240320;201507;2036;6038;1613;5154;56;241;1190;3655;1246;3896
240325;201507;34820;96049;27400;84053;8513;28045;7002;21827;15515;49872
240330;201507;1485;4507;1247;3998;82;319;818;2520;900;2839
240340;201507;1877;5312;1604;4870;179;574;1159;3514;1338;4088
240350;201507;1925;5712;1801;5555;123;439;1553;4777;1676;5216
240360;201507;7046;21108;6140;19752;1153;3995;3445;11373;4598;15368
240370;201507;1926;5350;1567;4695;204;606;961;2900;1165;3506
240375;201507;838;2273;732;2099;118;396;454;1215;572;1611
240380;201507;2426;7271;1880;6025;262;860;947;2990;1209;3850
240390;201507;943;2597;790;2312;47;181;577;1624;624;1805
240400;201507;1317;3625;1096;3233;93;317;760;2170;853;2487
240410;201507;493;1615;457;1541;81;331;279;903;360;1234
240420;201507;4530;17360;4279;16806;974;4077;2378;9467;3352;13544
240430;201507;3205;9123;2955;8695;141;553;2375;6772;2516;7325
240440;201507;2507;6626;2246;6218;575;1587;1158;3227;1733;4814
240450;201507;3725;11104;3232;10148;311;1281;2034;6016;2345;7297
240460;201507;2894;8934;2743;8734;193;809;2264;7024;2457;7833
240470;201507;3636;11294;2893;9699;787;2535;1339;4571;2126;7106
240480;201507;519;1358;410;1145;38;110;229;617;267;727
240485;201507;1985;6207;1752;5769;311;1080;1010;3358;1321;4438
240490;201507;1638;4198;1382;3802;44;157;1148;3069;1192;3226
240500;201507;2082;6015;1891;5724;134;459;1475;4428;1609;4887
240510;201507;1775;5308;1643;5087;159;532;1276;3940;1435;4472
240520;201507;1238;3649;1120;3446;114;418;830;2480;944;2898
240530;201507;2032;6529;1850;6235;303;1081;1268;4265;1571;5346
240540;201507;1612;4995;1547;4888;118;412;1264;3973;1382;4385
240550;201507;820;2334;711;2150;49;177;543;1603;592;1780
240560;201507;3161;9300;2965;8995;305;967;2324;7020;2629;7987
240570;201507;3035;8595;2334;7016;528;1733;862;2293;1390;4026
240580;201507;7460;23681;6957;22760;866;3142;5188;16754;6054;19896
240590;201507;775;2201;676;2015;35;135;506;1469;541;1604
240600;201507;1617;4778;1284;4078;170;624;709;2148;879;2772
240610;201507;4674;13346;4039;12135;488;1613;2539;7417;3027;9030
240615;201507;1026;2987;831;2615;148;485;470;1449;618;1934
240620;201507;1748;5473;1558;5158;181;598;1150;3849;1331;4447
240630;201507;1973;6109;1825;5849;172;469;1343;4452;1515;4921
240640;201507;902;2630;763;2394;56;265;530;1586;586;1851
240650;201507;3709;11245;3363;10736;191;682;2727;8695;2918;9377
240660;201507;2370;7666;2230;7464;214;747;1740;5849;1954;6596
240670;201507;2679;8041;2213;7044;283;980;1238;3864;1521;4844
240680;201507;1496;4397;1212;3877;112;389;761;2414;873;2803
240690;201507;915;2583;804;2395;51;198;667;1932;718;2130
240700;201507;2668;7952;2204;7064;89;412;1680;5245;1769;5657
240710;201507;18716;48683;16279;45198;3006;8312;9675;27349;12681;35661
240720;201507;5177;14739;4759;13984;1483;4496;2219;6270;3702;10766
240725;201507;1040;3153;825;2663;76;260;480;1508;556;1768
240730;201507;2146;6498;1848;5945;128;449;1387;4449;1515;4898
240740;201507;1968;5794;1757;5403;166;638;1242;3679;1408;4317
240750;201507;2144;8087;1985;7772;492;2124;1006;3915;1498;6039
240760;201507;1313;3654;1116;3392;110;263;828;2691;938;2954
240770;201507;3138;9036;2806;8574;163;649;2327;6999;2490;7648
240780;201507;6256;17211;4984;15227;910;2857;2674;8335;3584;11192
240790;201507;870;2662;719;2400;40;155;488;1652;528;1807
240800;201507;35492;102033;31445;95131;7692;24253;13552;41428;21244;65681
240810;201507;84166;244102;78004;233431;20564;63531;37655;113919;58219;177450
240820;201507;6464;19568;5575;18141;1357;4811;2374;7975;3731;12786
240830;201507;8562;26783;8014;25960;417;1641;6774;21739;7191;23380
240840;201507;1241;3462;1040;3143;87;290;676;1982;763;2272
240850;201507;1274;3805;923;2988;152;532;449;1416;601;1948
240860;201507;1313;3723;1082;3309;64;233;823;2443;887;2676
240870;201507;1180;3240;952;2817;84;286;601;1685;685;1971
240880;201507;1119;3825;1057;3725;106;462;818;2809;924;3271
240890;201507;5048;14417;4268;12943;879;2884;1967;5802;2846;8686
240895;201507;2580;8934;2364;8532;254;986;1678;6111;1932;7097
240910;201507;2780;8476;2470;7876;177;677;1858;5851;2035;6528
240920;201507;791;2568;687;2337;142;563;326;1057;468;1620
240930;201507;3438;9050;3043;8571;168;480;2486;7065;2654;7545
240933;201507;1346;3947;1215;3733;123;439;880;2649;1003;3088
240940;201507;6366;17438;5186;15377;940;2776;2839;8427;3779;11203
240950;201507;1002;3282;952;3195;66;306;741;2410;807;2716
240960;201507;779;2436;688;2260;84;291;465;1528;549;1819
240970;201507;1941;5386;1637;4883;126;452;1226;3541;1352;3993
240980;201507;3010;9924;2778;9477;524;1906;1729;5901;2253;7807
240990;201507;2847;8456;2653;8048;436;1405;1617;4821;2053;6226
241000;201507;1050;2942;896;2664;46;171;638;1862;684;2033
241010;201507;2889;9672;2661;9216;332;1399;1847;6183;2179;7582
241020;201507;2044;5723;1655;4947;147;464;1076;3107;1223;3571
241025;201507;1628;4937;1453;4609;85;364;1018;3138;1103;3502
241030;201507;2485;8214;2236;7729;187;819;1642;5610;1829;6429
241040;201507;2226;7651;2042;7314;208;831;1410;5092;1618;5923
241050;201507;1231;3686;1087;3428;53;221;837;2570;890;2791
241060;201507;877;2542;795;2395;60;184;583;1745;643;1929
241070;201507;814;2346;730;2196;72;244;512;1493;584;1737
241080;201507;1155;3410;958;3030;46;204;708;2192;754;2396
241090;201507;2164;6347;1837;5763;131;579;1401;4284;1532;4863
241100;201507;1175;3519;1009;3130;107;344;646;1983;753;2327
241105;201507;1173;3540;1059;3337;233;775;549;1754;782;2529
241110;201507;820;2586;679;2278;51;222;431;1421;482;1643
241120;201507;7175;22092;6548;21093;1332;4322;3955;13067;5287;17389
241140;201507;3346;9230;2902;8351;313;885;2014;5709;2327;6594
241142;201507;711;2153;530;1750;135;516;179;547;314;1063
241150;201507;5436;16157;4849;15151;600;1934;3264;10220;3864;12154
241160;201507;958;2848;895;2733;120;388;624;1899;744;2287
241170;201507;1121;3387;1044;3255;100;322;789;2465;889;2787
241180;201507;928;2621;761;2300;98;310;396;1158;494;1468
241190;201507;1193;3290;959;2827;69;251;597;1676;666;1927
241200;201507;18887;55355;16779;51938;3911;12966;7851;24518;11762;37484
241210;201507;1438;4076;1166;3513;186;638;604;1758;790;2396
241220;201507;7551;25236;7070;24303;1552;5665;3919;13612;5471;19277
241230;201507;2986;8802;2727;8411;161;629;2278;6892;2439;7521
241240;201507;1194;3510;854;2731;108;370;355;1131;463;1501
241250;201507;5904;18449;4996;16667;262;1342;3883;12572;4145;13914
241255;201507;1634;6364;1529;6115;356;1510;752;3053;1108;4563
241260;201507;5026;13635;4068;12140;232;944;2986;8689;3218;9633
241270;201507;1820;5668;1602;5220;147;541;1061;3425;1208;3966
241280;201507;1853;5385;1691;5070;214;653;1189;3542;1403;4195
241290;201507;3036;8591;2547;7725;305;957;1659;4996;1964;5953
241300;201507;1428;4126;1244;3795;60;186;897;2759;957;2945
241310;201507;1564;4774;1445;4567;146;502;1058;3327;1204;3829
241320;201507;910;3111;829;2935;123;474;507;1788;630;2262
241330;201507;1422;4467;1321;4328;103;441;1087;3476;1190;3917
241335;201507;2688;8204;2486;7838;152;536;2056;6428;2208;6964
241340;201507;1840;5748;1578;5169;370;1315;699;2198;1069;3513
241350;201507;1905;6064;1726;5733;150;648;1284;4115;1434;4763
241355;201507;1367;3888;1129;3478;63;211;949;2902;1012;3113
241360;201507;2007;5497;1679;4874;74;227;1251;3514;1325;3741
241370;201507;1341;4101;1102;3611;152;557;605;1922;757;2479
241380;201507;649;1864;555;1671;94;297;316;943;410;1240
241390;201507;2693;8983;2523;8675;338;1325;1819;6191;2157;7516
241400;201507;3741;10965;3435;10558;358;1235;2600;7992;2958;9227
241410;201507;2527;7633;2277;7261;465;1596;1334;4218;1799;5814
241415;201507;1655;5011;1501;4760;99;386;1185;3697;1284;4083
241420;201507;2270;7866;1991;7391;636;2615;513;1828;1149;4443
241430;201507;569;1714;448;1431;50;176;248;747;298;923
241440;201507;6177;22353;5813;21743;1176;4558;3763;14329;4939;18887
241445;201507;1024;2991;973;2927;83;212;795;2527;878;2739
241450;201507;3156;8589;2753;8006;331;1054;1875;5382;2206;6436
241460;201507;3365;9895;2976;9115;243;854;2142;6392;2385;7246
241470;201507;1330;3774;1115;3497;145;530;773;2372;918;2902
241475;201507;1209;3703;1007;3281;50;234;753;2346;803;2580
241480;201507;2724;9131;2514;8773;951;3393;796;2993;1747;6386
241490;201507;659;1749;554;1594;43;122;337;947;380;1069
241500;201507;775;2448;660;2260;37;154;483;1614;520;1768
250010;201507;2673;8459;2312;7646;157;677;1707;5495;1864;6172
250020;201507;1652;4761;1273;4060;82;346;848;2584;930;2930
250030;201507;6878;20224;6480;19654;518;1658;5317;16107;5835;17765
250040;201507;4207;14193;3879;13474;641;2375;2434;8453;3075;10828
250050;201507;3390;10772;3208;10497;419;1486;2236;7242;2655;8728
250053;201507;1225;3680;1124;3543;153;487;775;2489;928;2976
250057;201507;627;2612;618;2603;13;25;589;2552;602;2577
250060;201507;4958;15081;4659;14637;410;1520;3700;11412;4110;12932
250070;201507;3928;12248;3656;11780;176;813;2877;8923;3053;9736
250073;201507;744;2297;659;2145;46;180;524;1676;570;1856
250077;201507;2098;6201;1783;5690;188;627;1141;3683;1329;4310
250080;201507;4096;12049;3949;11815;382;1171;3015;8866;3397;10037
250090;201507;2496;7321;2392;7145;101;332;1990;5860;2091;6192
250100;201507;3845;12740;3636;12356;360;1341;2783;9331;3143;10672
250110;201507;5167;15556;4906;15180;478;1710;3878;11845;4356;13555
250115;201507;520;1707;462;1574;29;153;302;957;331;1110
250120;201507;1965;5936;1711;5438;106;373;1312;4138;1418;4511
250130;201507;5417;16865;5060;16321;245;966;4270;13706;4515;14672
250135;201507;1052;3254;962;3096;72;264;708;2281;780;2545
250140;201507;1984;6666;1901;6530;171;692;1471;5070;1642;5762
250150;201507;4959;16720;4511;15872;354;1549;3286;11362;3640;12911
250153;201507;1421;3925;1260;3686;43;192;1078;3073;1121;3265
250157;201507;1689;5651;1559;5387;188;738;1111;3824;1299;4562
250160;201507;3191;9769;3083;9603;141;535;2791;8651;2932;9186
250170;201507;1477;4469;1352;4274;224;741;918;2922;1142;3663
250180;201507;15397;45894;14644;44729;1431;5287;10948;32514;12379;37801
250190;201507;4119;11967;3766;11397;630;1950;2313;6894;2943;8844
250200;201507;2006;5860;1685;5388;110;432;1382;4374;1492;4806
250205;201507;878;3024;820;2911;55;276;613;2140;668;2416
250210;201507;1470;4913;1369;4753;119;485;1025;3480;1144;3965
250215;201507;1340;4477;1281;4382;112;456;866;2921;978;3377
250220;201507;738;2205;656;2097;39;150;561;1779;600;1929
250230;201507;1553;3952;1321;3567;79;239;1056;2738;1135;2977
250240;201507;2297;7760;2178;7534;134;536;1747;6025;1881;6561
250250;201507;4224;12852;3916;12435;201;666;3360;10732;3561;11398
250260;201507;1680;5186;1482;4876;82;340;1166;3809;1248;4149
250270;201507;1213;3843;1106;3707;103;342;849;2934;952;3276
250280;201507;3564;10685;3169;10069;430;1378;2313;7417;2743;8795
250290;201507;1945;5199;1654;4823;41;176;1480;4300;1521;4476
250300;201507;5413;15841;5120;15485;578;2434;4138;11882;4716;14316
250310;201507;1137;3496;1006;3287;103;388;774;2490;877;2878
250320;201507;7857;24256;7491;23571;964;3424;5217;16015;6181;19439
250330;201507;2438;7667;2124;7206;162;690;1670;5572;1832;6262
250340;201507;1082;3232;979;3057;41;151;821;2529;862;2680
250350;201507;4165;11673;3736;11153;152;532;3245;9707;3397;10239
250355;201507;1851;5965;1716;5766;89;456;1452;4720;1541;5176
250360;201507;1825;5475;1721;5322;64;200;1494;4641;1558;4841
250370;201507;11482;33816;10463;32692;909;2965;8928;28008;9837;30973
250375;201507;1076;3337;1000;3224;43;169;864;2777;907;2946
250380;201507;1686;4818;1590;4696;94;367;1367;3963;1461;4330
250390;201507;1903;5108;1530;4474;175;515;1043;3046;1218;3561
250400;201507;67398;182493;55018;162588;13509;41996;24249;72192;37758;114188
250403;201507;1510;4942;1409;4803;227;867;885;2933;1112;3800
250407;201507;1170;3353;1020;3107;72;238;730;2157;802;2395
250410;201507;542;1797;505;1725;34;169;399;1320;433;1489
250415;201507;1745;5416;1589;5135;113;394;1183;3776;1296;4170
250420;201507;1220;3692;1131;3563;38;150;987;3064;1025;3214
250430;201507;5985;16635;5640;16119;294;1017;4775;13433;5069;14450
250435;201507;1333;4138;1213;3921;149;551;832;2662;981;3213
250440;201507;4348;12782;4036;12333;181;544;3392;10366;3573;10910
250450;201507;1942;5620;1763;5374;62;208;1536;4637;1598;4845
250460;201507;6316;19113;5900;18529;625;2062;4528;14365;5153;16427
250470;201507;1497;4164;1297;3890;131;455;883;2515;1014;2970
250480;201507;3660;11232;3437;10910;92;410;3049;9570;3141;9980
250485;201507;658;1671;541;1493;31;99;432;1160;463;1259
250490;201507;3732;12005;3651;11891;838;2804;2292;7476;3130;10280
250500;201507;1744;5284;1556;4977;338;1031;944;3118;1282;4149
250510;201507;4583;13303;4139;12641;186;676;3583;10896;3769;11572
250520;201507;1691;5219;1590;5049;237;844;986;3054;1223;3898
250523;201507;1564;5106;1512;5025;221;797;1082;3584;1303;4381
250527;201507;1379;4181;1315;4102;25;121;1216;3742;1241;3863
250530;201507;621;1904;534;1795;25;76;469;1605;494;1681
250535;201507;1281;4053;1216;3920;56;243;973;3067;1029;3310
250540;201507;2340;6945;2204;6787;52;244;1964;5916;2016;6160
250550;201507;886;2974;801;2837;54;247;627;2180;681;2427
250560;201507;1634;5171;1589;5105;96;381;1392;4416;1488;4797
250570;201507;2597;8294;2284;7687;164;689;1719;5664;1883;6353
250580;201507;1102;2988;934;2717;91;343;715;1993;806;2336
250590;201507;879;2768;828;2706;83;341;670;2124;753;2465
250600;201507;7096;20859;6662;20246;500;1504;5418;16565;5918;18069
250610;201507;3068;9173;2848;8843;307;1020;2127;6637;2434;7657
250620;201507;681;2018;611;1876;105;331;387;1174;492;1505
250625;201507;2315;7481;2276;7434;146;449;2077;6853;2223;7302
250630;201507;9094;28728;8494;27549;1926;6422;4593;14925;6519;21347
250640;201507;3424;10544;3288;10382;165;700;2878;8934;3043;9634
250650;201507;767;2285;691;2156;52;215;500;1493;552;1708
250660;201507;1875;4988;1704;4768;34;87;1604;4516;1638;4603
250670;201507;2381;8105;2277;7918;145;661;1896;6477;2041;7138
250680;201507;4638;13495;4440;13240;180;737;3907;11485;4087;12222
250690;201507;5894;15514;5655;15222;397;1107;5023;13465;5420;14572
250700;201507;4907;14458;4475;13826;711;2297;2957;9067;3668;11364
250710;201507;4123;13335;3876;12988;558;1985;2677;9070;3235;11055
250720;201507;2553;7556;2439;7373;102;429;2143;6381;2245;6810
250730;201507;3479;10692;3281;10409;306;1039;2407;7491;2713;8530
250740;201507;1860;5531;1672;5226;140;543;1265;3824;1405;4367
250750;201507;97552;277751;90413;267156;12879;41668;61353;178704;74232;220372
250760;201507;2183;6317;1964;6003;125;477;1626;4889;1751;5366
250770;201507;3724;12758;3534;12504;572;2172;2292;8108;2864;10280
250780;201507;1797;5303;1560;4866;180;683;1011;3018;1191;3701
250790;201507;2400;7880;2279;7676;509;1716;1312;4529;1821;6245
250800;201507;2602;7375;2318;6907;96;322;1918;5611;2014;5933
250810;201507;1293;3810;1135;3575;90;374;889;2734;979;3108
250820;201507;1810;5717;1739;5624;55;226;1601;5155;1656;5381
250830;201507;5651;18198;5246;17374;622;2273;3510;11402;4132;13675
250840;201507;903;2916;777;2640;62;254;520;1740;582;1994
250850;201507;1933;6001;1760;5716;109;498;1381;4384;1490;4882
250855;201507;1033;3139;960;3023;68;300;735;2228;803;2528
250860;201507;3031;9989;2650;9276;652;2449;838;2936;1490;5385
250870;201507;1049;3075;967;2926;37;158;757;2213;794;2371
250880;201507;1353;3849;1189;3613;163;503;856;2604;1019;3107
250890;201507;9057;27953;8484;27137;1123;4432;5925;18253;7048;22685
250900;201507;2796;9144;2476;8508;265;893;1800;6236;2065;7129
250905;201507;1945;6296;1871;6194;301;1001;1349;4530;1650;5531
250910;201507;4905;14348;4663;13988;303;1020;3821;11374;4124;12394
250915;201507;1406;4374;1374;4320;99;269;1191;3829;1290;4098
250920;201507;3280;9480;3069;9150;402;1124;2128;6437;2530;7561
250930;201507;1961;6150;1843;5950;224;850;1299;4093;1523;4943
250933;201507;1094;3622;1052;3537;84;338;775;2573;859;2911
250937;201507;655;2077;607;1977;64;263;432;1372;496;1635
250939;201507;1531;4819;1442;4658;150;508;1006;3234;1156;3742
250940;201507;3640;10981;3431;10634;132;507;2871;8864;3003;9371
250950;201507;1236;3855;1106;3685;48;188;914;3025;962;3213
250960;201507;1097;3607;1045;3531;89;348;829;2783;918;3131
250970;201507;8301;23118;7238;21485;874;2634;5035;14951;5909;17585
250980;201507;2514;7527;2302;7130;134;543;1669;4959;1803;5502
250990;201507;1940;6679;1761;6288;240;997;1138;3958;1378;4955
251000;201507;2111;6411;1942;6143;74;313;1617;5073;1691;5386
251010;201507;2771;8097;2503;7676;102;355;2136;6560;2238;6915
251020;201507;1559;4620;1440;4463;82;272;1276;3961;1358;4233
251030;201507;1106;3126;1005;2942;68;236;731;2102;799;2338
251040;201507;1793;5703;1625;5423;128;598;1205;3872;1333;4470
251050;201507;1051;3095;919;2856;108;362;600;1829;708;2191
251060;201507;976;2301;766;2020;49;157;603;1564;652;1721
251065;201507;462;1417;411;1335;31;115;286;873;317;988
251070;201507;624;1754;564;1673;51;207;443;1239;494;1446
251080;201507;19545;55280;17785;52332;4559;13917;8777;26404;13336;40321
251090;201507;2920;9157;2618;8558;207;780;1898;6100;2105;6880
251100;201507;922;2963;816;2765;107;435;507;1642;614;2077
251110;201507;1975;5788;1731;5322;161;507;1186;3623;1347;4130
251120;201507;5962;20408;5724;19979;672;2785;4238;14496;4910;17281
251130;201507;4001;10408;3652;10037;18;40;3585;9887;3603;9927
251140;201507;4098;12666;3855;12281;130;582;3249;10281;3379;10863
251150;201507;2422;8096;2301;7905;223;977;1730;5790;1953;6767
251160;201507;1737;5775;1678;5698;61;240;1530;5207;1591;5447
251170;201507;1383;4227;1311;4141;91;366;1086;3343;1177;3709
251180;201507;2520;7760;2324;7454;436;1369;1408;4550;1844;5919
251190;201507;4248;11921;4105;11761;185;526;3797;10892;3982;11418
251200;201507;3788;12315;3675;12182;83;327;3471;11510;3554;11837
251203;201507;1029;3438;996;3374;61;305;783;2584;844;2889
251207;201507;1101;3464;955;3202;70;337;653;2077;723;2414
251210;201507;7819;22338;6721;20886;751;2271;5115;16346;5866;18617
251220;201507;1094;2955;920;2696;96;294;692;2040;788;2334
251230;201507;4404;13599;4103;13243;210;785;3716;11971;3926;12756
251240;201507;3088;9697;2954;9529;351;1142;2282;7383;2633;8525
251250;201507;10127;30135;9378;28982;984;3564;7011;21146;7995;24710
251260;201507;503;1580;458;1516;21;71;351;1161;372;1232
251270;201507;4162;13426;3897;13104;156;720;3425;11441;3581;12161
251272;201507;1333;3992;1282;3919;86;284;1116;3410;1202;3694
251274;201507;873;2789;797;2649;82;334;569;1843;651;2177
251275;201507;1216;3601;1168;3527;84;355;892;2573;976;2928
251276;201507;1182;3715;1107;3574;81;319;816;2578;897;2897
251278;201507;554;1798;494;1678;65;268;326;1098;391;1366
251280;201507;2262;7002;2154;6822;146;564;1692;5196;1838;5760
251290;201507;5496;15351;5198;14997;583;2073;4044;11282;4627;13355
251300;201507;734;2513;688;2440;43;183;534;1879;577;2062
251310;201507;2970;8890;2762;8584;122;510;2299;6984;2421;7494
251315;201507;1571;5506;1500;5377;196;714;1019;3692;1215;4406
251320;201507;1835;5191;1473;4590;63;238;1080;3324;1143;3562
251330;201507;1803;4862;1576;4556;92;390;1340;3722;1432;4112
251335;201507;1009;3470;937;3341;91;420;657;2277;748;2697
251340;201507;3426;9690;2972;9000;220;877;2234;6522;2454;7399
251350;201507;1316;4201;1228;4054;109;417;924;2967;1033;3384
251360;201507;1751;5710;1607;5530;72;333;1393;4753;1465;5086
251365;201507;810;2382;649;2040;26;106;457;1398;483;1504
251370;201507;21314;67904;20792;67150;1915;7686;16407;51382;18322;59068
251380;201507;1336;4159;1151;3836;50;260;948;3024;998;3284
251385;201507;816;2245;715;2080;79;231;454;1259;533;1490
251390;201507;5720;19795;5258;19005;1193;4506;3066;11205;4259;15711
251392;201507;1025;3056;934;2922;73;252;701;2164;774;2416
251394;201507;593;1836;494;1649;27;103;367;1208;394;1311
251396;201507;829;2357;725;2181;105;328;476;1403;581;1731
251398;201507;969;2857;836;2593;53;195;566;1723;619;1918
251400;201507;1169;3309;1011;3097;95;373;751;2210;846;2583
251410;201507;1331;3591;1224;3418;67;260;1018;2768;1085;3028
251420;201507;1954;5788;1768;5557;221;699;1273;3990;1494;4689
251430;201507;1660;5908;1528;5686;94;467;1257;4589;1351;5056
251440;201507;1276;3783;1055;3349;71;244;776;2452;847;2696
251445;201507;1517;4656;1446;4554;76;326;1211;3704;1287;4030
251450;201507;4396;14317;4149;13988;116;559;3584;12000;3700;12559
251455;201507;1092;3533;987;3340;91;353;687;2320;778;2673
251460;201507;802;2500;759;2429;83;248;604;1967;687;2215
251465;201507;437;1386;382;1264;19;85;281;902;300;987
251470;201507;1167;3446;966;3057;93;324;579;1827;672;2151
251480;201507;963;2716;859;2535;24;118;713;2032;737;2150
251490;201507;1685;5154;1540;4928;183;685;1055;3340;1238;4025
251500;201507;1671;5497;1638;5434;148;570;1273;4145;1421;4715
251510;201507;2545;8378;2303;7883;432;1537;1295;4424;1727;5961
251520;201507;899;2529;808;2376;116;339;494;1447;610;1786
251530;201507;11527;32852;10978;32092;381;1627;9490;27054;9871;28681
251540;201507;2796;9083;2582;8650;202;850;2045;6757;2247;7607
251550;201507;3458;9003;2992;8386;83;322;2562;7066;2645;7388
251560;201507;700;2184;652;2093;89;343;393;1170;482;1513
251570;201507;992;2965;804;2586;57;246;562;1732;619;1978
251580;201507;1898;5393;1761;5202;354;911;1167;3622;1521;4533
251590;201507;1544;5083;1490;5015;60;253;1306;4379;1366;4632
251593;201507;984;3081;917;2992;133;482;586;1864;719;2346
251597;201507;1882;5808;1817;5725;88;379;1563;4821;1651;5200
251600;201507;6473;19094;6053;18420;377;1276;4937;14938;5314;16214
251610;201507;3180;9706;2956;9358;323;1024;2126;6746;2449;7770
251615;201507;1124;3286;917;2933;79;319;631;1961;710;2280
251620;201507;14945;42446;13133;40217;987;3127;10643;33124;11630;36251
251630;201507;4481;11706;3917;10924;250;753;3163;8723;3413;9476
251640;201507;2542;7444;2119;6708;141;558;1575;4926;1716;5484
251650;201507;3833;11290;3570;10932;221;757;3076;9352;3297;10109
251660;201507;3363;11093;3138;10698;135;681;2610;8636;2745;9317
251670;201507;4321;12903;3748;12148;55;170;3455;11323;3510;11493
251675;201507;705;2288;654;2214;141;507;368;1221;509;1728
251680;201507;2636;7644;2188;6933;120;530;1715;5287;1835;5817
251690;201507;3186;9839;2975;9424;176;654;2350;7327;2526;7981
251700;201507;1927;6238;1812;6087;122;534;1540;5109;1662;5643
251710;201507;915;2386;665;1916;82;275;374;1041;456;1316
251720;201507;1365;4220;1214;3959;92;429;924;2891;1016;3320
251740;201507;772;2196;611;1915;74;246;375;1172;449;1418
260005;201507;25033;61181;21335;55995;4661;12323;11836;31198;16497;43521
260010;201507;9684;26172;7889;23906;1087;3340;5025;15760;6112;19100
260020;201507;5544;16253;4760;15049;316;1082;3643;11611;3959;12693
260030;201507;5782;16944;5274;16165;397;1364;4090;12467;4487;13831
260040;201507;10080;24331;8335;22355;721;1727;6430;17885;7151;19612
260050;201507;11101;34662;10386;33833;572;2083;9023;29635;9595;31718
260060;201507;3845;10889;3423;10159;320;953;2524;7544;2844;8497
260070;201507;9625;28061;8930;26966;1459;4726;5717;17031;7176;21757
260080;201507;5430;14879;4808;13975;560;1747;3453;9913;4013;11660
260090;201507;5105;14315;4797;13863;966;2666;3199;9474;4165;12140
260100;201507;3285;9054;2867;8459;164;631;2371;6931;2535;7562
260105;201507;4632;13461;4413;13049;419;1436;3363;9711;3782;11147
260110;201507;20577;58914;19075;57097;867;2691;16913;50763;17780;53454
260120;201507;11442;35055;10397;33217;2592;8406;5356;17814;7948;26220
260130;201507;3219;9101;3012;8775;454;1261;2107;6249;2561;7510
260140;201507;13190;32949;11266;30607;867;2559;8988;24676;9855;27235
260150;201507;3101;8824;2770;8370;200;772;2194;6579;2394;7351
260160;201507;5590;17675;5009;16928;339;1433;4030;13508;4369;14941
260170;201507;16064;45652;15452;44772;1117;3400;12886;37299;14003;40699
260180;201507;3233;9972;2953;9569;211;795;2432;7826;2643;8621
260190;201507;15738;37202;14473;35618;526;1346;12661;30988;13187;32334
260200;201507;10395;29309;9625;28247;712;2326;8037;23596;8749;25922
260210;201507;11255;34480;10216;32945;621;2395;8433;27165;9054;29560
260220;201507;9275;27351;8968;26936;457;1736;7912;23438;8369;25174
260230;201507;9403;27299;8673;26289;451;1552;7146;21809;7597;23361
260240;201507;2946;8951;2563;8401;367;1302;1802;5933;2169;7235
260250;201507;2222;6219;2009;5935;106;333;1713;5056;1819;5389
260260;201507;11990;33825;10993;32467;1697;5313;7890;23667;9587;28980
260270;201507;3573;10409;3320;10027;291;1181;2463;7042;2754;8223
260280;201507;12684;41389;11706;39886;661;2438;9944;34151;10605;36589
260290;201507;28645;86369;27099;83612;4409;14851;17353;52479;21762;67330
260300;201507;8420;25773;7507;24394;449;1866;5876;19092;6325;20958
260310;201507;4634;13726;4237;13129;1252;3564;2231;7490;3483;11054
260320;201507;6846;22557;6373;21809;406;1554;5245;18014;5651;19568
260330;201507;2583;8406;2407;8093;147;654;1910;6314;2057;6968
260340;201507;1861;5505;1731;5301;79;304;1513;4579;1592;4883
260345;201507;22699;70801;21222;67891;5518;19530;8712;26617;14230;46147
260350;201507;4621;12674;4344;12258;236;776;3601;10045;3837;10821
260360;201507;2257;6680;2064;6368;177;678;1425;4315;1602;4993
260370;201507;5802;18062;5118;16813;523;2018;3665;11993;4188;14011
260380;201507;4700;15673;4333;15124;317;1303;3377;11764;3694;13067
260390;201507;4354;13887;3844;12890;361;1377;2730;8984;3091;10361
260392;201507;3475;10981;3213;10646;192;822;2773;9048;2965;9870
260400;201507;13295;38193;12635;37097;1755;5801;8810;25286;10565;31087
260410;201507;59227;170076;52024;158536;15002;48004;21478;66888;36480;114892
260415;201507;3841;12194;3306;11126;349;1449;2070;6695;2419;8144
260420;201507;11795;27081;10590;25791;275;792;9609;23218;9884;24010
260430;201507;2686;8946;2418;8473;238;937;1690;5848;1928;6785
260440;201507;3206;9705;2852;8985;402;1426;1737;5303;2139;6729
260450;201507;4833;14399;4612;14069;196;692;4065;12423;4261;13115
260460;201507;5509;17028;5067;16237;873;3063;3078;9658;3951;12721
260470;201507;4549;13711;4272;13351;272;871;3701;11763;3973;12634
260480;201507;3987;11506;3531;10859;595;2055;2269;6953;2864;9008
260490;201507;4975;13326;4351;12271;340;1119;3431;9475;3771;10594
260500;201507;5869;16802;5255;15842;719;2199;3571;10740;4290;12939
260510;201507;8534;22988;7985;22303;297;840;7245;20281;7542;21121
260515;201507;4689;14375;3642;12231;274;1077;2317;7731;2591;8808
260520;201507;15589;41124;14985;40306;2365;6343;10875;29432;13240;35775
260530;201507;9627;29435;8603;27909;441;1601;7295;23751;7736;25352
260540;201507;5934;14726;5401;14158;709;1417;4279;11686;4988;13103
260545;201507;71;254;40;159;8;33;11;38;19;71
260550;201507;2731;9014;2352;8214;507;1979;976;3361;1483;5340
260560;201507;6246;16398;5664;15546;182;646;4992;13498;5174;14144
260570;201507;6689;22391;6185;21544;731;2889;4459;15514;5190;18403
260580;201507;3683;10362;3411;9906;189;669;2842;8031;3031;8700
260590;201507;6067;15292;5767;14938;271;671;5146;13410;5417;14081
260600;201507;26286;78529;23811;74319;2375;8604;17042;52540;19417;61144
260610;201507;6631;19877;6277;19348;982;3183;4382;13397;5364;16580
260620;201507;15771;47690;15046;46379;2547;8641;9545;28900;12092;37541
260630;201507;2153;6488;1936;6120;148;598;1526;4704;1674;5302
260640;201507;17053;47230;15997;45751;2447;7294;10675;30510;13122;37804
260650;201507;5249;16901;4711;15973;463;1634;3508;12054;3971;13688
260660;201507;7975;22196;7184;21191;361;1248;6180;18070;6541;19318
260670;201507;2314;6338;1894;5745;178;596;1347;4097;1525;4693
260680;201507;21192;59501;19440;56475;4250;12622;9653;28059;13903;40681
260690;201507;3639;9933;3121;9085;126;491;2619;7504;2745;7995
260700;201507;5564;16808;5421;16659;45;113;5313;16450;5358;16563
260710;201507;1242;3744;1142;3603;88;327;887;2786;975;3113
260720;201507;15462;51042;14682;49686;3409;11944;8092;27628;11501;39572
260730;201507;6575;22295;6162;21590;916;3321;4396;15497;5312;18818
260740;201507;1246;3825;1099;3568;129;461;729;2364;858;2825
260750;201507;6517;20567;5938;19770;561;1759;4801;16272;5362;18031
260760;201507;4606;12448;4290;12034;254;774;3570;10042;3824;10816
260765;201507;7537;25686;7198;25147;1052;4636;4999;16773;6051;21409
260770;201507;3702;9805;3436;9429;120;417;2890;7807;3010;8224
260775;201507;5021;14491;4743;14066;464;1651;3433;9885;3897;11536
260780;201507;3616;11733;3404;11320;684;2590;1901;6041;2585;8631
260790;201507;108567;274470;100995;263088;19618;52933;61147;158228;80765;211161
260795;201507;2976;9232;2694;8800;336;1236;1853;6065;2189;7301
260800;201507;4725;12822;4389;12359;161;642;3910;10678;4071;11320
260805;201507;3899;11311;3440;10612;415;1441;2312;6972;2727;8413
260810;201507;6646;19024;6469;18817;314;964;5713;16549;6027;17513
260820;201507;4247;11992;3861;11438;937;2866;2073;6043;3010;8909
260825;201507;2830;9158;2567;8735;186;701;2019;6883;2205;7584
260830;201507;3647;11829;3284;11117;770;2487;1885;6678;2655;9165
260840;201507;4200;12112;3766;11474;254;985;3044;9079;3298;10064
260845;201507;4112;11968;3842;11475;501;1583;2741;8201;3242;9784
260850;201507;4854;15999;4296;14750;868;3349;2061;6851;2929;10200
260860;201507;3257;10343;2936;9698;184;712;2281;7516;2465;8228
260870;201507;4108;11486;3656;10903;474;1294;2725;8306;3199;9600
260875;201507;6388;17636;5705;16595;919;2723;3782;11041;4701;13764
260880;201507;9145;28497;8454;27367;719;2364;6677;21785;7396;24149
260890;201507;13117;37669;12239;36312;889;3050;9390;27552;10279;30602
260900;201507;5833;17994;4987;16363;591;2312;3082;9920;3673;12232
260910;201507;2969;8981;2710;8594;195;707;2139;6810;2334;7517
260915;201507;4389;14963;4210;14716;85;413;3922;13678;4007;14091
260920;201507;3236;9877;3030;9581;368;1373;2254;7072;2622;8445
260930;201507;3920;12680;3471;11949;392;1449;2474;8549;2866;9998
260940;201507;13501;36338;12293;34332;1521;4999;8313;22466;9834;27465
260950;201507;6107;18953;5617;17996;787;3012;3234;9862;4021;12874
260960;201507;55526;155024;51078;147679;10199;31359;28242;81227;38441;112586
260970;201507;4700;14876;4336;14365;276;1158;3483;11432;3759;12590
260980;201507;3774;12338;3564;12080;128;566;3211;10826;3339;11392
260990;201507;16701;52809;15289;50911;1188;4241;12304;41351;13492;45592
261000;201507;16056;43696;12929;38788;2405;7604;6672;20609;9077;28213
261010;201507;2543;7203;2347;6964;152;345;2051;6256;2203;6601
261020;201507;5841;17342;5295;16496;468;1713;4116;12458;4584;14171
261030;201507;3339;10891;3115;10486;221;928;2488;8234;2709;9162
261040;201507;5087;16596;4496;15438;394;1577;3346;11408;3740;12985
261050;201507;7916;23182;7412;22270;1019;3042;5024;15140;6043;18182
261060;201507;11893;35223;11054;33684;1149;4077;8066;23959;9215;28036
261070;201507;49305;121622;43161;112856;6800;18193;27263;71513;34063;89706
261080;201507;5733;16884;5392;16370;361;985;4585;14193;4946;15178
261090;201507;16259;44915;14995;43179;1397;3919;11757;34256;13154;38175
261100;201507;7777;24774;6961;23322;1364;4804;3889;13286;5253;18090
261110;201507;58699;174400;52567;165033;11939;39346;28481;91038;40420;130384
261120;201507;3577;9600;3158;9093;92;310;2841;8195;2933;8505
261130;201507;6942;17795;6514;17306;183;514;5978;15804;6161;16318
261140;201507;3249;9140;2938;8663;419;1428;1787;5102;2206;6530
261150;201507;5235;15601;4837;14950;459;1661;3784;11601;4243;13262
261153;201507;2055;5996;1664;5388;73;306;1243;4021;1316;4327
261160;201507;196217;513626;182124;493281;41166;115097;96189;264051;137355;379148
261170;201507;5766;15930;5258;15186;603;1747;3963;11573;4566;13320
261180;201507;9520;26448;8931;25623;810;2574;6583;18718;7393;21292
261190;201507;5042;15726;4721;15323;561;2361;3277;10168;3838;12529
261200;201507;3628;9127;3273;8693;420;1112;2524;6832;2944;7944
261210;201507;1895;5024;1795;4899;120;311;1591;4377;1711;4688
261220;201507;12883;40538;10749;35872;1956;7112;5397;17848;7353;24960
261230;201507;4266;13005;3935;12589;144;529;3464;11167;3608;11696
261240;201507;4713;14075;4391;13520;648;1922;3013;9490;3661;11412
261245;201507;3490;11018;3021;10168;170;811;2429;7988;2599;8799
261247;201507;3280;10060;2776;9132;245;939;1977;6521;2222;7460
261250;201507;19624;52332;18581;50968;3560;9378;13024;36655;16584;46033
261255;201507;3953;12347;3611;11748;220;869;2998;9672;3218;10541
261260;201507;11796;33699;10649;32288;598;1896;8959;27180;9557;29076
261270;201507;3582;10620;3242;10061;401;1363;2169;6606;2570;7969
261280;201507;2445;7531;2246;7237;147;523;1831;5864;1978;6387
261290;201507;2884;8363;2631;8033;164;621;2145;6525;2309;7146
261300;201507;10448;34183;9189;31866;1503;5971;5586;19055;7089;25026
261310;201507;7215;22255;6819;21533;1610;5233;3928;12430;5538;17663
261320;201507;5450;17348;5073;16646;256;1002;4128;13491;4384;14493
261330;201507;5377;15862;5110;15494;489;1501;4026;12206;4515;13707
261340;201507;4021;13406;3815;13063;426;1828;2552;8589;2978;10417
261350;201507;7991;26565;7508;25723;350;1664;6102;20484;6452;22148
261360;201507;8004;21213;7184;20057;613;1836;5675;15575;6288;17411
261370;201507;19389;57401;18136;55463;3625;11634;10925;33447;14550;45081
261380;201507;4062;13979;3744;13292;584;2295;2408;8529;2992;10824
261390;201507;15282;47025;13891;44648;2086;7368;8685;27714;10771;35082
261400;201507;4710;16255;4220;15224;408;1726;2959;10612;3367;12338
261410;201507;8471;23989;7700;22795;971;2901;5668;17024;6639;19925
261420;201507;7260;24616;6956;24192;1645;6458;4147;14105;5792;20563
261430;201507;3342;10571;2960;10008;271;909;2249;7731;2520;8640
261440;201507;1569;5074;1420;4845;55;278;1118;3726;1173;4004
261450;201507;13814;39097;13362;38538;398;1392;12160;34860;12558;36252
261460;201507;7049;20987;6644;20460;431;1212;5756;18079;6187;19291
261470;201507;3860;10549;3507;10091;140;460;3179;9107;3319;9567
261480;201507;3500;12727;3243;12241;332;1423;2375;8819;2707;10242
261485;201507;4919;15125;4462;14308;777;2903;2604;8121;3381;11024
261500;201507;5633;15666;4984;14795;489;1357;3788;11610;4277;12967
261510;201507;1918;6133;1774;5908;127;460;1385;4620;1512;5080
261520;201507;2630;8556;2429;8171;150;603;1678;5808;1828;6411
261530;201507;11815;38031;10415;35322;2212;8345;4520;15274;6732;23619
261540;201507;7208;23290;6844;22651;1413;4664;4220;14279;5633;18943
261550;201507;3366;9614;3176;9347;259;1011;2525;7201;2784;8212
261560;201507;7051;22986;6380;22108;988;3699;4422;15480;5410;19179
261570;201507;3365;10315;2964;9656;428;1448;1904;6181;2332;7629
261580;201507;5587;17734;5021;16818;378;1517;4098;13674;4476;15191
261590;201507;2359;6779;2111;6407;178;561;1598;4861;1776;5422
261600;201507;5149;14094;4462;13128;341;1057;3506;10373;3847;11430
261610;201507;2436;7079;2078;6559;117;487;1637;5040;1754;5527
261618;201507;2460;6948;2254;6688;211;679;1720;5005;1931;5684
261620;201507;4053;12621;3789;12171;576;1934;2620;8489;3196;10423
261630;201507;7681;22489;6455;20194;938;3418;3602;10916;4540;14334
261640;201507;32363;82127;30026;79249;2115;5421;24302;65987;26417;71408
261650;201507;3566;11097;3308;10723;394;1400;2346;7610;2740;9010
270010;201507;4385;16670;4026;15963;484;2256;2727;10831;3211;13087
270020;201507;3745;10917;3530;10590;344;1162;2766;8168;3110;9330
270030;201507;39319;118189;36796;114117;8841;28279;20774;65088;29615;93367
270040;201507;10573;32326;9804;31325;2263;7066;5468;18274;7731;25340
270050;201507;4111;11791;3808;11401;354;1213;2990;8873;3344;10086
270060;201507;1660;5253;1555;5114;270;987;1020;3365;1290;4352
270070;201507;4196;13095;3874;12667;178;855;3312;10561;3490;11416
270080;201507;1233;3944;1083;3638;161;622;678;2199;839;2821
270090;201507;2126;6637;1989;6354;57;282;1677;5165;1734;5447
270100;201507;5704;17727;5379;17140;901;3056;3446;10810;4347;13866
270110;201507;3141;8717;2828;8373;366;1037;1947;6188;2313;7225
270120;201507;3027;8747;2723;8360;107;410;2428;7463;2535;7873
270130;201507;4914;15209;4640;14895;523;1521;3741;12419;4264;13940
270135;201507;1719;4624;1607;4487;152;301;1381;3998;1533;4299
270140;201507;10187;24857;8840;23148;713;2708;6959;17020;7672;19728
270150;201507;2695;9008;2632;8926;105;382;2425;8233;2530;8615
270160;201507;4999;16798;4599;16293;231;1019;3930;13820;4161;14839
270170;201507;3810;12362;3496;11921;621;2443;2051;6884;2672;9327
270180;201507;2170;7325;2002;7099;119;611;1652;5755;1771;6366
270190;201507;1760;5861;1684;5761;106;434;1409;4835;1515;5269
270200;201507;2560;8618;2398;8385;213;923;1832;6303;2045;7226
270210;201507;4488;13917;4256;13575;309;1281;3461;10751;3770;12032
270220;201507;1389;4545;1298;4373;242;913;746;2461;988;3374
270230;201507;10789;34350;9468;32190;1299;5400;5951;19567;7250;24967
270235;201507;6293;20394;5893;19740;360;1537;4935;16368;5295;17905
270240;201507;9341;28230;7947;26392;1806;6298;4165;13968;5971;20266
270250;201507;3273;8530;3008;8204;216;590;2578;6958;2794;7548
270255;201507;4943;14918;3923;13061;277;1165;2792;9103;3069;10268
270260;201507;5650;18613;5477;18358;465;1942;4560;14993;5025;16935
270270;201507;1163;3336;1064;3189;195;610;614;1802;809;2412
270280;201507;3522;10154;3185;9668;352;1155;2346;7039;2698;8194
270290;201507;8159;28602;7681;27759;741;3226;5929;21119;6670;24345
270300;201507;3542;11673;3209;11289;328;1309;2378;8289;2706;9598
270310;201507;7277;22231;6393;20827;264;1320;5370;17061;5634;18381
270320;201507;5665;18431;5458;18082;869;3447;3760;12076;4629;15523
270330;201507;4314;14655;4075;14318;373;1473;3291;11566;3664;13039
270340;201507;1694;5299;1512;5053;130;472;1199;3996;1329;4468
270350;201507;1861;5231;1688;5026;162;560;1244;3696;1406;4256
270360;201507;1993;6202;1930;6127;177;494;1616;5283;1793;5777
270370;201507;1546;5158;1413;4920;137;576;1025;3554;1162;4130
270375;201507;2808;8074;2523;7661;264;952;1837;5367;2101;6319
270380;201507;5668;17548;5334;17083;545;1773;4109;13401;4654;15174
270390;201507;1297;3585;1148;3367;90;314;850;2391;940;2705
270400;201507;6195;18674;5600;17819;425;1580;3985;12379;4410;13959
270410;201507;4766;14827;4421;14180;469;1694;3145;9925;3614;11619
270420;201507;5698;18400;5513;18145;286;1333;4545;14593;4831;15926
270430;201507;131693;383482;122294;369502;31606;99998;59929;184338;91535;284336
270440;201507;4693;14279;4335;13767;238;896;3550;11313;3788;12209
270450;201507;6214;19268;5970;18956;351;1458;4950;15479;5301;16937
270460;201507;3433;9200;3083;8741;212;702;2606;7274;2818;7976
270470;201507;10174;32888;9417;31639;1224;4300;6254;21358;7478;25658
270480;201507;2906;9055;2568;8446;244;991;1771;5585;2015;6576
270490;201507;932;3035;879;2946;39;160;708;2342;747;2502
270500;201507;4856;16707;4603;16393;351;1472;3779;13424;4130;14896
270510;201507;5908;17761;5313;16942;670;2764;3901;11899;4571;14663
270520;201507;3535;11320;3275;10869;911;3294;1356;4519;2267;7813
270530;201507;1409;4300;1298;4137;158;520;860;2818;1018;3338
270540;201507;2002;6835;1831;6587;134;674;1468;5110;1602;5784
270550;201507;7006;20741;6132;19591;879;2976;4134;13438;5013;16414
270560;201507;3011;9177;2810;8871;345;1290;2008;6144;2353;7434
270570;201507;3920;12722;3595;12172;367;1585;2739;9034;3106;10619
270580;201507;1927;6320;1840;6200;200;702;1419;4858;1619;5560
270590;201507;1367;4627;1301;4512;32;152;1228;4231;1260;4383
270600;201507;2738;9241;2483;8820;186;928;1901;6568;2087;7496
270610;201507;3147;10034;2923;9711;226;856;2381;7837;2607;8693
270620;201507;1356;4648;1287;4538;100;485;1038;3502;1138;3987
270630;201507;16837;48463;15570;46403;2289;6702;10777;32876;13066;39578
270640;201507;5647;17517;5113;16775;337;1432;4138;13284;4475;14716
270642;201507;2237;7916;2100;7711;256;1150;1525;5497;1781;6647
270644;201507;2605;7580;2329;7247;211;595;1865;5945;2076;6540
270650;201507;3649;11697;3491;11475;550;2316;2342;7294;2892;9610
270660;201507;2463;6215;1914;5425;104;385;1352;3786;1456;4171
270670;201507;16108;42073;13862;39486;1737;4676;10302;30473;12039;35149
270680;201507;4213;12632;4046;12446;160;441;3702;11505;3862;11946
270690;201507;8568;23973;7781;23068;2442;7004;3918;12251;6360;19255
270700;201507;665;2071;604;1966;81;328;411;1271;492;1599
270710;201507;5816;19074;5557;18734;500;1901;4536;15214;5036;17115
270720;201507;3274;11119;2989;10611;165;863;2422;8409;2587;9272
270730;201507;6179;18708;5890;18390;656;2164;4774;14997;5430;17161
270740;201507;2292;6586;2163;6401;271;921;1610;4664;1881;5585
270750;201507;4819;15405;4506;14915;541;1945;3312;10878;3853;12823
270760;201507;3357;10213;3021;9646;211;771;2374;7562;2585;8333
270770;201507;18514;48885;15492;45206;3127;9117;9086;27681;12213;36798
270780;201507;1794;5942;1696;5775;210;814;1196;4062;1406;4876
270790;201507;1555;4854;1422;4647;330;1170;759;2419;1089;3589
270800;201507;11237;33316;10456;32289;820;2953;8565;26163;9385;29116
270810;201507;3320;10052;2580;8700;278;1145;1614;5423;1892;6568
270820;201507;1760;5952;1606;5694;255;989;1037;3690;1292;4679
270830;201507;5459;15626;4945;14984;614;2174;3663;11156;4277;13330
270840;201507;7686;25270;7137;24569;354;1763;6190;20924;6544;22687
270850;201507;7252;23211;7026;22924;1185;4714;4848;14993;6033;19707
270860;201507;11254;31405;9572;29228;1141;4157;6652;19881;7793;24038
270870;201507;2162;6511;1790;5718;263;886;1117;3531;1380;4417
270880;201507;8019;25940;7530;25233;547;2278;6122;20204;6669;22482
270890;201507;2382;7253;2234;6983;257;985;1641;4970;1898;5955
270895;201507;2801;10589;2684;10424;186;855;2280;8863;2466;9718
270900;201507;1936;5249;1561;4708;87;316;1183;3488;1270;3804
270910;201507;3397;11401;3207;11045;273;1218;2496;8392;2769;9610
270915;201507;9590;32258;8648;30557;1488;6061;5044;17474;6532;23535
270920;201507;5956;19018;5738;18706;213;1118;5164;16388;5377;17506
270930;201507;17366;46265;14266;42438;2736;8359;8388;25778;11124;34137
270940;201507;5557;18658;5289;18364;519;2255;4186;14386;4705;16641
280010;201507;645;1959;556;1795;52;237;346;1033;398;1270
280020;201507;4660;13662;3995;12498;703;2357;2486;7690;3189;10047
280030;201507;72422;190140;62810;175796;16961;49775;27295;77307;44256;127082
280040;201507;3086;9610;2757;9118;261;970;2044;6773;2305;7743
280050;201507;3693;11971;3432;11520;1134;4025;1341;4666;2475;8691
280060;201507;4247;14035;3922;13465;787;2906;2168;7551;2955;10457
280067;201507;7313;20819;6318;19361;790;2492;4281;13176;5071;15668
280070;201507;1817;6200;1728;6070;300;1085;1191;4230;1491;5315
280100;201507;3750;11700;3367;11017;756;2608;1812;5981;2568;8589
280110;201507;1392;4257;1281;4091;68;303;1061;3302;1129;3605
280120;201507;7606;24314;7047;23420;1070;3359;4957;17145;6027;20504
280130;201507;7054;20300;6436;19387;1149;3734;4089;12401;5238;16135
280140;201507;5372;14787;4901;14137;491;1417;3806;11070;4297;12487
280150;201507;3284;9965;3038;9540;355;1268;2091;6354;2446;7622
280160;201507;1354;3946;1200;3697;135;459;852;2590;987;3049
280170;201507;4742;14082;4278;13405;431;1313;3308;10635;3739;11948
280190;201507;1062;2998;958;2826;63;237;739;2109;802;2346
280200;201507;1134;3420;1039;3280;130;514;723;2186;853;2700
280210;201507;12909;39462;11671;37690;2126;7131;7120;23399;9246;30530
280220;201507;1524;4685;1428;4530;84;323;1200;3745;1284;4068
280230;201507;3425;10277;3054;9675;415;1415;1951;6226;2366;7641
280240;201507;3394;10022;3082;9514;278;827;2362;7339;2640;8166
280250;201507;813;2140;666;1905;109;372;353;893;462;1265
280260;201507;1989;5338;1844;5157;81;252;1654;4651;1735;4903
280270;201507;2278;7049;2002;6636;127;517;1565;5100;1692;5617
280280;201507;4123;13505;3769;12917;850;2444;2127;8155;2977;10599
280290;201507;16895;51902;15242;49277;2183;7684;9666;31490;11849;39174
280300;201507;9421;28913;8782;28148;826;2828;6974;22537;7800;25365
280310;201507;1338;3778;1186;3537;73;299;847;2461;920;2760
280320;201507;8271;26775;7583;25551;1456;5402;3929;13097;5385;18499
280330;201507;4459;12510;4077;11931;339;1178;3329;9575;3668;10753
280340;201507;3684;10684;3466;10381;334;1112;2726;8199;3060;9311
280350;201507;21476;60938;19219;57516;2644;8211;13013;39349;15657;47560
280360;201507;5625;17741;5284;17175;991;3672;3059;9704;4050;13376
280370;201507;1827;5133;1602;4771;138;455;1153;3382;1291;3837
280380;201507;1024;3095;939;2973;94;350;713;2234;807;2584
280390;201507;3062;9093;2632;8283;437;1442;1634;5122;2071;6564
280400;201507;4098;11868;3722;11316;1061;3111;1920;6168;2981;9279
280410;201507;2130;6799;1838;6240;251;963;1097;3606;1348;4569
280420;201507;4013;11832;3743;11406;217;718;3194;9710;3411;10428
280430;201507;2209;5654;2005;5384;107;347;1571;4124;1678;4471
280440;201507;4652;13837;4364;13493;318;986;3694;11464;4012;12450
280445;201507;2423;6924;2252;6637;75;302;1829;5286;1904;5588
280450;201507;8549;23446;7993;22742;545;1344;6765;19768;7310;21112
280460;201507;6881;18309;6194;17329;842;2510;4402;12398;5244;14908
280470;201507;1785;5441;1627;5174;190;596;1173;3766;1363;4362
280480;201507;29812;87733;28341;85598;4423;15270;19019;55984;23442;71254
280490;201507;3734;11248;3272;10432;279;1073;2385;7434;2664;8507
280500;201507;907;2412;825;2305;52;166;673;1816;725;1982
280510;201507;2680;7765;2327;7300;223;827;1736;5427;1959;6254
280520;201507;1728;4851;1580;4663;154;410;1278;3853;1432;4263
280530;201507;2209;6382;2071;6212;164;505;1700;5164;1864;5669
280540;201507;9152;25054;8545;24220;227;951;7567;20963;7794;21914
280550;201507;6782;18063;5780;16522;631;1860;4053;11594;4684;13454
280560;201507;7380;21957;6999;21385;388;1397;5892;17695;6280;19092
280570;201507;6335;17384;5579;16376;652;2161;3797;10974;4449;13135
280580;201507;5538;17162;4698;15693;835;2815;2770;9492;3605;12307
280590;201507;2320;7076;2164;6874;240;1050;1509;4623;1749;5673
280600;201507;3731;11420;3494;11070;333;1229;2657;8309;2990;9538
280610;201507;2425;6804;2227;6513;228;815;1583;4478;1811;5293
280620;201507;5106;15244;4446;14037;629;1830;2934;9610;3563;11440
280630;201507;3759;12248;3565;11969;351;1080;2885;10004;3236;11084
280640;201507;2195;6553;2088;6433;91;244;1924;5998;2015;6242
280650;201507;1104;3431;993;3246;120;445;668;2168;788;2613
280660;201507;2622;7462;2511;7318;412;1115;1926;5726;2338;6841
280670;201507;15835;41580;14677;40002;2669;7614;9441;25541;12110;33155
280680;201507;2716;7369;2414;6897;187;608;1936;5474;2123;6082
280690;201507;945;2709;841;2562;114;366;592;1784;706;2150
280700;201507;1079;3198;949;2998;65;206;722;2300;787;2506
280710;201507;11486;30628;10551;29555;758;2002;8883;25265;9641;27267
280720;201507;2223;6157;2028;5926;262;793;1422;4247;1684;5040
280730;201507;923;2768;864;2687;85;291;706;2175;791;2466
280740;201507;12899;35245;11174;32607;1620;4694;7224;21440;8844;26134
280750;201507;3500;10662;3188;10111;335;1186;2245;7114;2580;8300
280760;201507;5479;16932;4985;16221;658;2244;3345;11132;4003;13376
290010;201507;2996;6754;2147;5438;59;247;1718;4138;1777;4385
290020;201507;4364;14616;4299;14523;389;1119;3554;12218;3943;13337
290030;201507;3084;9725;2915;9469;508;1617;1996;6577;2504;8194
290035;201507;4642;11924;4009;11091;248;833;3185;9032;3433;9865
290040;201507;3781;10564;3300;10013;203;807;2665;7932;2868;8739
290050;201507;2486;8085;2212;7632;159;653;1691;5797;1850;6450
290060;201507;1281;3324;1089;3091;190;609;779;2151;969;2760
290070;201507;32159;80727;27269;74642;5947;16048;13721;39899;19668;55947
290080;201507;6058;17986;5175;16835;575;1842;3911;13107;4486;14949
290090;201507;2134;4631;1686;4154;170;387;1393;3491;1563;3878
290100;201507;9606;27434;8419;25570;1103;3502;5463;16945;6566;20447
290110;201507;4776;14267;4529;13829;673;2233;3014;9043;3687;11276
290115;201507;4705;14211;4167;13479;252;844;3378;11136;3630;11980
290120;201507;6735;17634;5663;16344;266;897;4799;13742;5065;14639
290130;201507;4551;11967;3815;11050;220;821;3085;8664;3305;9485
290135;201507;4492;11497;3867;10533;275;947;2858;7426;3133;8373
290140;201507;4016;12689;3494;11974;242;935;2940;10114;3182;11049
290150;201507;2122;6357;2014;6175;233;763;1545;4672;1778;5435
290160;201507;3310;8899;3202;8768;224;488;2776;7640;3000;8128
290170;201507;2710;9084;2456;8690;180;837;2036;7061;2216;7898
290180;201507;2859;8372;2508;7824;198;734;1919;5933;2117;6667
290190;201507;3722;12553;3580;12321;232;968;2770;9436;3002;10404
290195;201507;2157;5927;1845;5454;108;391;1502;4418;1610;4809
290200;201507;3771;11815;3366;11160;292;980;2652;8872;2944;9852
290205;201507;3086;9196;2750;8675;312;1177;1949;5985;2261;7162
290210;201507;14886;41934;13718;40447;2609;6891;9051;28691;11660;35582
290220;201507;2189;6583;2074;6399;151;624;1624;4843;1775;5467
290225;201507;2856;7559;2640;7320;155;395;2377;6643;2532;7038
290230;201507;2253;7375;2179;7284;134;533;1830;6106;1964;6639
290240;201507;3604;9775;3293;9305;320;949;2462;6852;2782;7801
290250;201507;3658;11776;3229;11126;193;680;2658;9307;2851;9987
290260;201507;4729;13865;4093;12871;324;1132;3172;9967;3496;11099
290265;201507;3242;10286;2904;9663;155;652;2274;7506;2429;8158
290270;201507;11928;43456;11317;42488;1462;5772;8301;31617;9763;37389
290280;201507;5153;16974;4802;16402;389;1478;3718;12733;4107;14211
290290;201507;9454;30095;8500;28522;1378;4757;5599;19172;6977;23929
290300;201507;4559;12998;3239;10514;261;855;2151;7237;2412;8092
290310;201507;1489;4432;1320;4170;237;821;752;2352;989;3173
290320;201507;27284;79973;23326;74633;5624;19036;11660;38242;17284;57278
290323;201507;3743;10169;3294;9668;169;537;2764;8096;2933;8633
290327;201507;4266;13122;3692;12060;565;1923;2352;7645;2917;9568
290330;201507;1776;4479;1650;4341;145;404;1423;3744;1568;4148
290340;201507;4857;15321;4552;14915;1360;4392;2404;8038;3764;12430
290350;201507;4271;13402;3744;12598;439;1513;2620;9066;3059;10579
290360;201507;4458;13610;3872;12822;180;675;3226;10734;3406;11409
290370;201507;4659;13187;4038;12392;438;1232;3250;10191;3688;11423
290380;201507;5485;16025;4808;15011;356;1285;3772;11777;4128;13062
290390;201507;14294;44496;13117;42693;2462;8129;7905;26932;10367;35061
290395;201507;2568;8388;2277;7854;143;632;1731;5960;1874;6592
290400;201507;3457;10350;3017;9717;284;937;2252;7251;2536;8188
290405;201507;4551;14492;3824;13087;541;1887;2358;8243;2899;10130
290410;201507;5957;17557;4862;15825;490;1883;3411;10779;3901;12662
290420;201507;3246;9463;2716;8716;213;750;2123;6789;2336;7539
290430;201507;2945;9428;2681;8954;469;1681;1681;5642;2150;7323
290440;201507;2893;7787;2402;7098;166;555;1852;5482;2018;6037
290450;201507;3258;9464;2819;8835;333;1131;1966;6149;2299;7280
290460;201507;12644;36849;11303;34631;2892;9221;5086;15590;7978;24811
290470;201507;4480;12359;3430;10820;706;2500;1723;5530;2429;8030
290475;201507;4913;16778;4451;15883;374;1677;3301;11615;3675;13292
290480;201507;2449;6535;2224;6238;324;959;1494;4321;1818;5280
290485;201507;4752;15134;4161;14260;333;1579;3276;10953;3609;12532
290490;201507;7862;20838;7510;20367;582;1670;6203;16740;6785;18410
290500;201507;4151;13026;3377;11487;543;2005;1813;6138;2356;8143
290510;201507;3274;9533;2852;8938;165;631;2376;7452;2541;8083
290515;201507;3185;9344;2740;8735;233;742;2182;7088;2415;7830
290520;201507;11991;36807;9729;32580;817;3394;6194;20507;7011;23901
290530;201507;5005;14707;4391;13767;340;1048;3482;10986;3822;12034
290540;201507;3854;11215;3660;10969;416;1197;2868;8765;3284;9962
290550;201507;4431;11972;3929;11385;144;422;3583;10460;3727;10882
290560;201507;6020;17873;5308;16821;1263;4084;2941;9543;4204;13627
290570;201507;42067;115414;37977;109516;4338;12803;26790;77267;31128;90070
290580;201507;6876;23527;6485;22920;869;3180;4695;16966;5564;20146
290590;201507;7326;23278;6264;21356;343;1420;4969;16889;5312;18309
290600;201507;16967;51733;15674;49785;2353;7205;11197;36758;13550;43963
290610;201507;2466;8313;2046;7479;153;717;1456;5238;1609;5955
290620;201507;6381;19456;5844;18635;370;1246;4850;15449;5220;16695
290630;201507;7830;20745;6983;19816;608;1742;5791;16574;6399;18316
290640;201507;2657;7726;2112;6818;165;648;1591;5057;1756;5705
290650;201507;11032;31334;10267;30280;2147;6220;6425;19545;8572;25765
290660;201507;3579;10010;3094;9297;144;488;2399;7394;2543;7882
290670;201507;6774;20790;6125;19725;695;2247;4404;14484;5099;16731
290680;201507;10148;30240;9183;29048;429;1588;7684;24219;8113;25807
290682;201507;4364;12641;3912;11999;161;624;3349;10131;3510;10755
290685;201507;3666;8787;2423;7012;295;910;1465;4344;1760;5254
290687;201507;7548;20902;5898;18479;1367;4399;3019;9757;4386;14156
290689;201507;3101;8978;2687;8321;242;788;2078;6543;2320;7331
290690;201507;5424;15622;4874;14907;553;1796;3581;10976;4134;12772
290700;201507;2326;7283;2194;7087;180;660;1691;5455;1871;6115
290710;201507;7588;24186;7165;23531;349;1178;6154;20317;6503;21495
290720;201507;18347;54007;16661;51886;1355;3991;13644;43479;14999;47470
290730;201507;7079;19709;6346;18752;1035;2958;4213;12611;5248;15569
290740;201507;914;2712;768;2464;81;271;529;1710;610;1981
290750;201507;9743;27211;8173;24317;1496;4955;4371;12526;5867;17481
290755;201507;2334;6566;1911;5869;97;344;1426;4334;1523;4678
290760;201507;4180;12663;3410;11288;396;1235;2222;7531;2618;8766
290770;201507;2481;8816;2360;8644;101;485;1905;6975;2006;7460
290780;201507;8812;22342;7631;20640;789;1629;5851;16547;6640;18176
290790;201507;4242;12924;3954;12506;251;781;3351;10683;3602;11464
290800;201507;7262;15502;5797;13936;663;1360;4291;10955;4954;12315
290810;201507;5010;15665;4241;14439;217;823;3248;11175;3465;11998
290820;201507;5613;15695;4962;14819;457;1531;3787;11360;4244;12891
290830;201507;4242;11496;3864;10937;226;785;2986;8234;3212;9019
290840;201507;17353;49002;15372;46081;2457;7134;10135;31610;12592;38744
290850;201507;6193;17866;5972;17600;686;1820;4853;14834;5539;16654
290860;201507;4886;16757;4561;16354;514;1887;3480;12812;3994;14699
290870;201507;4548;13580;3734;12242;273;1115;2766;9013;3039;10128
290880;201507;1404;3836;1114;3363;84;262;791;2401;875;2663
290890;201507;6923;18233;5944;17148;683;1922;4663;13641;5346;15563
290900;201507;2611;7369;1904;6177;280;965;965;3156;1245;4121
290910;201507;4489;12311;3865;11413;127;449;3390;9928;3517;10377
290920;201507;4557;13553;4227;13062;300;864;3468;10833;3768;11697
290930;201507;7565;23668;6717;22189;475;1952;5170;16871;5645;18823
290940;201507;3408;10890;3161;10568;167;609;2735;9301;2902;9910
290950;201507;1534;4290;1359;4029;167;476;920;2770;1087;3246
290960;201507;5708;16246;5198;15577;191;691;4396;13231;4587;13922
290970;201507;3557;11355;3113;10588;336;1187;2119;7290;2455;8477
290980;201507;10346;29686;8757;26707;2432;7618;2992;9102;5424;16720
290990;201507;8974;27010;7849;25149;808;2735;5778;18358;6586;21093
291000;201507;2875;8860;2624;8544;194;699;2244;7325;2438;8024
291005;201507;13938;36939;12343;34788;1772;5088;8556;24553;10328;29641
291010;201507;3240;10106;2530;8574;282;985;1592;5452;1874;6437
291020;201507;1378;3640;1050;3061;116;375;614;1699;730;2074
291030;201507;2280;6232;1676;5039;174;567;1022;3006;1196;3573
291040;201507;5386;16299;4819;15507;403;1474;3792;12202;4195;13676
291050;201507;7546;24816;6836;23450;1760;6763;3406;11311;5166;18074
291060;201507;5939;21925;5611;21394;852;3653;3776;14261;4628;17914
291070;201507;15853;45801;13909;42982;1177;3910;10599;32867;11776;36777
291072;201507;22410;66095;18085;57464;4656;16024;6487;20795;11143;36819
291075;201507;4982;14096;4431;13340;264;645;3504;10894;3768;11539
291077;201507;1477;4177;1186;3710;99;334;791;2475;890;2809
291080;201507;76980;238205;68325;221143;23098;76207;17771;56676;40869;132883
291085;201507;5518;14654;4797;13686;462;1372;3836;10957;4298;12329
291090;201507;1431;3568;1299;3411;73;235;1123;2923;1196;3158
291100;201507;2619;6691;2128;6168;101;390;1705;4871;1806;5261
291110;201507;4655;17098;4281;16506;551;2454;3038;11505;3589;13959
291120;201507;7278;19621;6708;18756;827;2377;4807;13504;5634;15881
291125;201507;1834;3705;1383;3221;105;265;1090;2589;1195;2854
291130;201507;2818;8764;2389;8013;137;607;1783;5822;1920;6429
291140;201507;4136;12284;3668;11426;502;1562;2412;7577;2914;9139
291150;201507;1930;5109;1834;4998;116;374;1503;4017;1619;4391
291160;201507;5320;16484;4652;15382;1134;3750;2418;8098;3552;11848
291165;201507;2505;7044;1936;5968;57;235;1407;4222;1464;4457
291170;201507;21186;55081;18126;51043;1061;3460;13231;36983;14292;40443
291180;201507;6249;16387;5080;14654;489;1560;3596;10337;4085;11897
291185;201507;3739;10149;3349;9570;294;834;2693;7663;2987;8497
291190;201507;6978;19294;6177;18183;505;1637;4957;14533;5462;16170
291200;201507;2877;8556;2310;7501;153;505;1598;5290;1751;5795
291210;201507;6862;16446;5777;15204;292;896;4627;12161;4919;13057
291220;201507;4120;12834;3773;12285;483;1796;2637;8476;3120;10272
291230;201507;3954;10130;3598;9726;88;190;3357;9196;3445;9386
291240;201507;4563;12395;3946;11260;163;531;3195;8954;3358;9485
291250;201507;3506;10747;2787;9428;295;1035;1887;6468;2182;7503
291260;201507;1047;3092;959;2974;52;211;812;2460;864;2671
291270;201507;4516;14454;4100;13672;1335;4613;1895;6417;3230;11030
291280;201507;2199;6073;1716;5326;400;1344;818;2429;1218;3773
291290;201507;5413;15171;4726;14279;832;2509;2850;8798;3682;11307
291300;201507;4311;12307;3378;10681;241;883;2470;7671;2711;8554
291310;201507;5311;15239;4646;14027;314;1043;3592;10797;3906;11840
291320;201507;5939;18874;4962;16979;1138;4188;2515;8522;3653;12710
291330;201507;1577;4727;1405;4446;135;494;991;3070;1126;3564
291340;201507;3862;11205;3227;10307;162;589;2601;8268;2763;8857
291345;201507;3506;11113;3259;10819;216;683;2804;9544;3020;10227
291350;201507;5600;16510;4901;15287;301;1027;3866;12178;4167;13205
291360;201507;32395;90510;29270;86099;7168;21054;16693;50621;23861;71675
291370;201507;8331;24044;7857;23451;565;1775;6209;18769;6774;20544
291380;201507;3658;11143;3147;10308;231;841;2280;7600;2511;8441
291390;201507;9847;27014;9130;26133;1329;3584;6652;19343;7981;22927
291400;201507;15843;41638;13050;37786;2395;6527;7847;24131;10242;30658
291410;201507;3175;8391;2400;7207;150;624;1777;5135;1927;5759
291420;201507;2075;5731;1824;5426;104;371;1526;4469;1630;4840
291430;201507;3210;9476;2878;9033;138;662;2349;7143;2487;7805
291440;201507;6448;19696;5455;17992;537;1894;3998;13282;4535;15176
291450;201507;8153;24176;7212;22841;325;1016;5753;18904;6078;19920
291460;201507;12859;38918;11543;36794;1785;6225;7071;22567;8856;28792
291465;201507;7918;22559;7037;21561;481;1645;5806;17752;6287;19397
291470;201507;15498;42048;13604;39737;1169;3329;10265;30959;11434;34288
291480;201507;33180;86358;28229;79454;3743;11598;17406;48750;21149;60348
291490;201507;4330;14001;4157;13773;422;1422;3288;11081;3710;12503
291500;201507;4267;12186;3619;11246;246;905;2827;8704;3073;9609
291510;201507;3495;10601;3209;10220;81;261;2926;9402;3007;9663
291520;201507;3856;10481;3360;9798;356;1096;2300;6745;2656;7841
291530;201507;2035;5813;1678;5263;384;1245;873;2850;1257;4095
291535;201507;3825;11562;3462;11025;217;770;2789;8913;3006;9683
291540;201507;2130;5062;1782;4698;145;261;1538;4211;1683;4472
291550;201507;5136;13990;4482;13062;1020;2813;2453;7389;3473;10202
291560;201507;18109;43287;13078;37408;1159;3299;9813;29015;10972;32314
291570;201507;2200;5964;2026;5745;166;397;1703;4977;1869;5374
291580;201507;5489;16733;4861;15781;542;2140;3526;11361;4068;13501
291590;201507;1761;5589;1593;5313;181;650;1170;3952;1351;4602
291600;201507;5701;15447;4152;13057;1071;3563;1730;5305;2801;8868
291610;201507;4748;15061;4594;14874;230;809;4076;13272;4306;14081
291620;201507;2956;6979;2333;6320;136;369;1870;5204;2006;5573
291630;201507;3136;7652;2623;7053;272;702;2000;5454;2272;6156
291640;201507;16958;45972;13675;41210;3397;10863;4671;14372;8068;25235
291650;201507;7800;23497;7227;22802;641;1658;6051;19721;6692;21379
291660;201507;2165;5726;1814;5191;147;506;1229;3386;1376;3892
291670;201507;1755;4958;1594;4727;109;320;1290;3875;1399;4195
291680;201507;4070;11869;3529;10953;672;2255;2034;6286;2706;8541
291685;201507;4684;11778;3881;10720;569;1476;2645;7605;3214;9081
291690;201507;4002;10699;3161;9324;223;628;2274;6717;2497;7345
291700;201507;8908;27945;8003;26353;855;2864;6018;20072;6873;22936
291710;201507;5077;13365;4143;12196;380;1217;3023;8893;3403;10110
291720;201507;4286;14211;3677;12967;343;1396;2560;8893;2903;10289
291730;201507;5885;17780;5348;17048;608;2071;4060;13133;4668;15204
291733;201507;2532;7369;2176;6890;226;761;1459;4712;1685;5473
291735;201507;2747;7672;2278;6975;125;458;1830;5547;1955;6005
291740;201507;3503;10523;3043;9841;253;943;2374;7604;2627;8547
291750;201507;22142;56921;17081;49072;3896;11536;8397;24643;12293;36179
291760;201507;10986;34994;9675;32686;3897;14477;2753;9191;6650;23668
291770;201507;7507;21661;6423;19706;886;2919;4212;12764;5098;15683
291780;201507;4422;13410;4135;12920;325;1042;3334;10422;3659;11464
291790;201507;2635;8076;2491;7879;99;438;2128;6625;2227;7063
291800;201507;29555;81106;25926;75992;4218;12485;16244;49177;20462;61662
291810;201507;10427;29068;8834;27130;427;1561;7264;22229;7691;23790
291820;201507;3653;10812;3283;10266;236;783;2504;7872;2740;8655
291830;201507;4084;10915;3776;10477;454;1321;2850;7974;3304;9295
291835;201507;6217;19477;4985;17284;1364;5100;2449;8526;3813;13626
291840;201507;46642;130872;41126;124592;5855;17223;29753;92953;35608;110176
291845;201507;2667;7898;2498;7679;177;480;2204;6926;2381;7406
291850;201507;4577;13034;3745;11712;375;1065;2753;8879;3128;9944
291855;201507;1782;4532;1532;4212;169;603;1106;2899;1275;3502
291860;201507;2119;6073;1741;5342;105;384;1142;3435;1247;3819
291870;201507;1413;3753;1038;3074;81;291;669;1926;750;2217
291875;201507;2782;8824;2522;8421;141;603;1831;5964;1972;6567
291880;201507;4853;15478;4547;14967;408;1334;3542;11829;3950;13163
291890;201507;1261;3294;1085;3083;310;871;612;1836;922;2707
291900;201507;1279;3489;1061;3142;74;262;839;2464;913;2726
291905;201507;2735;7326;2122;6271;91;326;1605;4596;1696;4922
291910;201507;2728;7274;2283;6742;125;478;1924;5587;2049;6065
291915;201507;7018;21300;5879;19216;348;1215;4676;15387;5024;16602
291920;201507;29381;84750;26667;80875;4746;14899;16180;49705;20926;64604
291930;201507;2587;7583;2287;7102;190;689;1660;5056;1850;5745
291940;201507;3274;9365;2411;7767;324;1174;1368;4250;1692;5424
291950;201507;8479;28572;7741;27187;1262;4467;4605;16611;5867;21078
291955;201507;9750;28980;9163;28226;2102;6445;5455;17561;7557;24006
291960;201507;3147;9183;2566;8303;250;821;1856;6198;2106;7019
291970;201507;3819;11956;3569;11559;434;1522;2428;7892;2862;9414
291980;201507;11858;33718;9037;29627;1088;3673;6050;20329;7138;24002
291990;201507;2186;6619;1983;6347;99;327;1642;5397;1741;5724
291992;201507;2705;8285;2636;8143;362;1192;1993;6098;2355;7290
291995;201507;1917;5674;1742;5409;119;425;1471;4573;1590;4998
292000;201507;2362;6692;2100;6331;263;914;1487;4472;1750;5386
292010;201507;6301;16046;4873;13959;464;1288;3653;10551;4117;11839
292020;201507;3964;13769;3751;13396;622;2314;2694;9635;3316;11949
292030;201507;2017;6205;1787;5870;231;811;1030;3352;1261;4163
292040;201507;4335;11851;3717;11201;288;678;3150;9965;3438;10643
292045;201507;2898;9833;2806;9708;95;349;2617;9012;2712;9361
292050;201507;6208;19031;5349;17284;453;1752;3607;11482;4060;13234
292060;201507;11431;30780;10571;29675;1119;2838;8250;23346;9369;26184
292070;201507;4611;14228;4363;13939;410;1205;3625;11786;4035;12991
292080;201507;3497;9132;2945;8441;198;600;2466;7113;2664;7713
292090;201507;3934;10413;3410;9792;208;708;2884;8304;3092;9012
292100;201507;11071;29839;9229;27272;2562;7885;4021;12500;6583;20385
292105;201507;2993;9385;2678;8881;141;576;2165;7165;2306;7741
292110;201507;6448;17241;5025;14965;1262;3767;2578;7917;3840;11684
292120;201507;7661;21581;6447;19271;1320;3871;3519;10905;4839;14776
292130;201507;2944;7947;2523;7339;471;1263;1570;4728;2041;5991
292140;201507;4919;12842;4114;11721;901;2318;2600;7700;3501;10018
292145;201507;2413;7432;2167;7014;212;666;1590;5337;1802;6003
292150;201507;12731;38825;11698;37134;646;2288;9357;29841;10003;32129
292160;201507;2537;7370;2158;6882;115;454;1864;5882;1979;6336
292170;201507;8573;24619;7113;22050;888;3125;4594;14101;5482;17226
292180;201507;2899;8599;2374;7668;324;1029;1518;5009;1842;6038
292190;201507;3403;9532;2844;8714;583;1882;1680;5230;2263;7112
292200;201507;6499;20280;5544;18530;1604;5825;2043;6792;3647;12617
292205;201507;3766;11711;3373;11107;172;780;2730;8717;2902;9497
292210;201507;6404;17563;5355;16173;358;1287;4378;13216;4736;14503
292220;201507;1872;5168;1673;4861;525;1424;729;2164;1254;3588
292225;201507;3181;9801;2899;9394;184;710;2357;7603;2541;8313
292230;201507;6238;18597;5919;18067;387;1587;4586;13483;4973;15070
292240;201507;4744;14236;4232;13197;502;1627;2935;9052;3437;10679
292250;201507;4996;15391;4583;14614;1089;3589;2131;6873;3220;10462
292260;201507;3102;9272;2910;9006;179;594;2470;7646;2649;8240
292265;201507;3018;9375;2635;8703;156;652;1966;6393;2122;7045
292270;201507;4054;10366;3197;9373;181;605;2663;7858;2844;8463
292273;201507;2709;6290;2050;5478;203;506;1523;4270;1726;4776
292275;201507;1626;4401;1439;4120;176;545;1051;3030;1227;3575
292280;201507;2062;6008;1789;5697;160;459;1378;4657;1538;5116
292285;201507;2489;6775;2091;6188;128;471;1641;4776;1769;5247
292290;201507;7112;21313;5916;19706;406;1540;4609;15533;5015;17073
292300;201507;7894;23829;6925;22623;1637;5581;3983;13378;5620;18959
292303;201507;2783;8561;2542;8232;100;439;2184;6926;2284;7365
292305;201507;2903;7923;2749;7699;63;233;2537;7042;2600;7275
292310;201507;5755;17082;5348;16496;201;698;4502;13869;4703;14567
292320;201507;6455;18464;5510;16865;480;1567;4186;12749;4666;14316
292330;201507;2127;5789;1961;5550;164;533;1578;4408;1742;4941
292335;201507;5041;13191;4508;12491;408;1104;3744;10523;4152;11627
292340;201507;6187;17738;5280;16232;542;1652;3730;11536;4272;13188
292350;201507;2201;6587;1955;6224;176;680;1525;4807;1701;5487
292360;201507;5129;13627;4891;13149;209;432;4114;11572;4323;12004
292370;201507;7945;23478;7297;22570;719;1909;5731;18129;6450;20038
292380;201507;7199;21282;6600;20334;520;1533;5288;16457;5808;17990
292390;201507;3375;7801;2924;7311;91;197;2696;6793;2787;6990
292400;201507;20411;61550;19335;59885;2397;7649;14542;45417;16939;53066
292405;201507;4429;11169;3568;10064;204;521;2902;8259;3106;8780
292410;201507;1932;5172;1812;5036;131;370;1535;4245;1666;4615
292420;201507;3706;12092;3546;11877;191;685;3138;10567;3329;11252
292430;201507;5579;16589;4231;14637;291;1204;3144;10859;3435;12063
292440;201507;8388;27849;7770;26926;251;1018;6961;24341;7212;25359
292450;201507;3944;11760;3268;10673;311;1021;2367;7854;2678;8875
292460;201507;5126;15316;4415;14085;684;2307;2846;9105;3530;11412
292465;201507;2339;6992;1962;6363;186;698;1311;4299;1497;4997
292467;201507;1891;6085;1799;5937;301;1067;1214;4064;1515;5131
292470;201507;2854;7711;2383;6917;124;431;1889;5419;2013;5850
292480;201507;5949;16064;5185;15024;168;637;4621;13278;4789;13915
292490;201507;2342;6467;1944;5875;151;508;1507;4519;1658;5027
292500;201507;6393;19070;5449;17361;625;2092;3678;11850;4303;13942
292510;201507;12649;35885;10975;33506;866;2950;8467;26071;9333;29021
292520;201507;5363;15620;4710;14603;1137;3552;2478;7791;3615;11343
292525;201507;5167;13668;4451;12823;196;610;3812;11039;4008;11649
292530;201507;25849;74652;22750;70356;5957;19030;11129;35370;17086;54400
292540;201507;2792;7799;2479;7388;262;893;1925;5705;2187;6598
292550;201507;6266;19517;5493;18496;597;2108;4240;14646;4837;16754
292560;201507;3971;11095;3461;10347;190;756;2733;7994;2923;8750
292570;201507;3956;11732;3711;11476;75;172;3509;11096;3584;11268
292575;201507;5995;20227;5828;19953;716;2522;4599;15874;5315;18396
292580;201507;6686;19890;6307;19374;422;1337;5271;16252;5693;17589
292590;201507;7116;21494;6604;20733;523;1682;5413;16902;5936;18584
292593;201507;3000;7930;2503;7144;188;484;2002;5750;2190;6234
292595;201507;5745;15943;5072;15075;401;1275;3969;11848;4370;13123
292600;201507;10438;29453;9419;28147;930;2239;7279;22551;8209;24790
292610;201507;4492;12725;3653;11311;329;1057;2259;7256;2588;8313
292620;201507;5827;17326;5202;16588;130;441;4833;15504;4963;15945
292630;201507;9270;23303;7707;20903;752;2013;5478;15144;6230;17157
292640;201507;7633;24996;7057;24130;465;1735;5432;18789;5897;20524
292650;201507;4724;12863;4457;12512;370;780;3837;11064;4207;11844
292660;201507;10468;31623;9675;30458;1045;3409;7387;23533;8432;26942
292665;201507;2573;7920;2477;7797;47;100;2345;7491;2392;7591
292670;201507;3660;10359;2848;8910;194;676;1865;5814;2059;6490
292680;201507;3540;10686;3247;10196;387;1164;2403;7593;2790;8757
292690;201507;2836;7791;2111;6655;194;648;1485;4791;1679;5439
292700;201507;9142;27290;8056;25675;1101;3277;5360;17863;6461;21140
292710;201507;2040;6688;1934;6548;74;305;1713;5786;1787;6091
292720;201507;9143;23367;7881;21964;354;1138;6775;18958;7129;20096
292730;201507;3497;10509;3361;10303;301;935;2579;7936;2880;8871
292740;201507;313618;839819;292864;809298;50783;149012;188690;517819;239473;666831
292750;201507;6349;17107;5438;15837;292;950;4435;12903;4727;13853
292760;201507;3908;12333;3544;11671;432;1519;2368;7841;2800;9360
292770;201507;5509;16679;5039;15962;962;3161;3161;10199;4123;13360
292780;201507;1877;4471;1439;3910;146;485;1032;2725;1178;3210
292790;201507;3180;7960;3043;7817;96;188;2874;7474;2970;7662
292800;201507;8786;26225;8127;25123;522;1768;6550;20176;7072;21944
292805;201507;2892;8269;2587;7845;356;1178;1885;5680;2241;6858
292810;201507;9211;27975;7805;26010;925;3176;5550;18908;6475;22084
292820;201507;6924;20292;5450;18149;305;1208;4286;14296;4591;15504
292830;201507;1767;5156;1587;4899;69;298;1373;4177;1442;4475
292840;201507;7583;23661;7097;22995;305;1223;6328;20273;6633;21496
292850;201507;3182;8336;2584;7414;346;1012;1586;4459;1932;5471
292860;201507;14547;38202;13336;36578;1161;3313;10383;28370;11544;31683
292870;201507;18720;51170;16271;47307;2123;6817;9779;27984;11902;34801
292880;201507;12438;35513;11047;33494;1232;4126;7669;22949;8901;27075
292890;201507;5225;17764;4717;16851;686;2605;3094;11172;3780;13777
292895;201507;2695;6616;2106;5724;261;657;1462;4015;1723;4672
292900;201507;2733;8512;2596;8291;192;867;1936;5898;2128;6765
292905;201507;4014;11854;3383;10932;190;651;2662;8692;2852;9343
292910;201507;4952;14791;4482;13929;614;2024;2779;8640;3393;10664
292920;201507;8857;26064;8359;25299;575;2081;6807;20009;7382;22090
292925;201507;4974;15264;4470;14516;421;1386;3359;10952;3780;12338
292930;201507;6402;20612;6088;20064;491;2133;4543;14599;5034;16732
292935;201507;2102;5990;1765;5624;116;394;1457;4793;1573;5187
292937;201507;3140;8003;2615;7354;253;772;2025;5647;2278;6419
292940;201507;3248;8877;2539;7892;291;916;1725;5565;2016;6481
292950;201507;7731;22760;7197;21850;583;2136;5336;15779;5919;17915
292960;201507;5081;13228;4380;12272;327;1001;3223;8935;3550;9936
292970;201507;4204;12691;3718;12036;148;644;3115;10050;3263;10694
292975;201507;3402;9163;3209;8913;349;894;2691;7603;3040;8497
292980;201507;3234;8757;2515;7733;238;843;1806;5501;2044;6344
292990;201507;11664;33694;10291;31578;441;1596;8529;26009;8970;27605
293000;201507;2721;7202;2427;6841;66;210;2074;5984;2140;6194
293010;201507;17699;49027;15026;44720;2411;7697;9088;26832;11499;34529
293015;201507;7249;25002;6448;23394;852;3524;4144;14870;4996;18394
293020;201507;9048;30191;8469;29389;357;1587;7267;25086;7624;26673
293030;201507;5328;15540;4286;13898;339;1123;3043;10288;3382;11411
293040;201507;3632;11997;3470;11676;184;664;3048;10221;3232;10885
293050;201507;19671;54436;17267;51385;2697;8255;10602;32577;13299;40832
293060;201507;3780;9890;3090;8751;270;837;2279;6357;2549;7194
293070;201507;20889;60304;18284;56234;4502;13953;9098;28967;13600;42920
293075;201507;3233;10943;2971;10549;225;919;2342;8323;2567;9242
293076;201507;3701;10299;3348;9818;206;577;2816;8423;3022;9000
293077;201507;4628;14715;4203;14076;1003;3511;2259;7726;3262;11237
293080;201507;4464;14142;4097;13554;203;965;3390;10976;3593;11941
293090;201507;3224;10425;2686;9611;279;1045;1919;6939;2198;7984
293100;201507;5715;16927;4746;15194;422;1431;3502;11348;3924;12779
293105;201507;3945;13073;3454;12118;527;1850;2255;8090;2782;9940
293110;201507;1968;5686;1742;5338;63;245;1468;4484;1531;4729
293120;201507;3684;12294;3498;11996;299;959;2783;9764;3082;10723
293130;201507;4047;11431;3432;10754;149;514;3067;9734;3216;10248
293135;201507;30812;77366;23098;66453;4677;15213;9673;27507;14350;42720
293140;201507;1938;5580;1850;5456;145;530;1479;4218;1624;4748
293150;201507;5407;17915;4656;16422;820;2943;2807;10148;3627;13091
293160;201507;3729;9567;3432;9215;589;1153;2432;7082;3021;8235
293170;201507;3271;9778;2995;9369;337;1202;2114;6641;2451;7843
293180;201507;5112;14440;4094;12768;192;800;3195;9722;3387;10522
293190;201507;13676;41359;12715;39904;442;2103;11030;33911;11472;36014
293200;201507;6750;19068;5874;17908;227;819;4831;14752;5058;15571
293210;201507;4843;14141;4300;13195;299;1074;3313;10095;3612;11169
293220;201507;5005;14776;4370;13686;1114;3590;1881;5988;2995;9578
293230;201507;3786;11609;3458;11096;517;1794;2375;7630;2892;9424
293240;201507;4371;11917;3499;10468;147;484;2614;7790;2761;8274
293245;201507;4159;11997;3804;11460;327;978;2936;8943;3263;9921
293250;201507;5692;15790;5135;14962;525;1580;3661;10628;4186;12208
293260;201507;4522;13552;3847;12574;287;1006;2958;9769;3245;10775
293270;201507;5541;14826;5166;14428;394;906;4524;12927;4918;13833
293280;201507;5236;14794;4477;13775;261;775;3561;11121;3822;11896
293290;201507;14860;49282;13842;47287;3335;11827;6825;23781;10160;35608
293300;201507;6732;16015;5653;14762;337;783;4520;12026;4857;12809
293305;201507;4793;11870;4073;10889;171;518;3436;9116;3607;9634
293310;201507;2460;6457;2007;5678;166;478;1429;4002;1595;4480
293315;201507;4215;10785;3610;9840;443;1184;2623;7242;3066;8426
293317;201507;2442;7119;2173;6624;194;600;1506;4633;1700;5233
293320;201507;7904;26434;7722;26209;581;2202;6535;22245;7116;24447
293325;201507;1818;5179;1490;4673;202;711;1000;3134;1202;3845
293330;201507;50991;161467;45456;151733;9814;35219;22798;76701;32612;111920
293340;201507;2679;7517;2081;6474;316;1025;1190;3652;1506;4677
293345;201507;3299;9741;2865;9143;262;722;2220;7392;2482;8114
293350;201507;6646;18854;6259;18401;339;825;5520;16641;5859;17466
293360;201507;12857;39474;11659;37956;662;2386;10098;32875;10760;35261
310010;201507;990;2693;755;2316;137;523;336;954;473;1477
310020;201507;3118;9665;2513;8406;571;2094;445;1328;1016;3422
310030;201507;2304;7222;1895;6503;422;1616;1013;3419;1435;5035
310040;201507;1013;2669;838;2434;69;243;644;1836;713;2079
310050;201507;1879;6425;1683;5980;315;1289;770;2655;1085;3944
310060;201507;3203;10237;2810;9730;322;1185;2083;7254;2405;8439
310070;201507;333;960;260;826;27;115;150;437;177;552
310080;201507;696;2119;561;1868;113;481;199;594;312;1075
310090;201507;4606;13684;3957;12528;541;1913;2458;7718;2999;9631
310100;201507;3298;10032;2751;9091;194;789;2129;6980;2323;7769
310110;201507;4767;13431;4074;12323;640;2217;2393;7044;3033;9261
310120;201507;551;1703;451;1512;133;561;175;470;308;1031
310130;201507;417;1257;374;1190;84;308;197;588;281;896
310140;201507;197;650;161;585;61;261;39;110;100;371
310150;201507;4587;14056;3982;12876;941;3348;1633;5167;2574;8515
310160;201507;7456;23163;6079;20654;1719;6370;1577;5202;3296;11572
310163;201507;955;3066;795;2743;199;729;260;877;459;1606
310170;201507;8924;25283;8028;23984;1216;3798;5245;15941;6461;19739
310180;201507;1609;4656;1346;4241;307;1066;622;1875;929;2941
310190;201507;2730;9042;2480;8624;691;2611;372;1283;1063;3894
310200;201507;1852;6031;1541;5386;342;1331;558;1917;900;3248
310205;201507;1105;3191;858;2799;156;515;470;1556;626;2071
310210;201507;2680;7869;2419;7476;252;870;1836;5666;2088;6536
310220;201507;1031;3201;961;3083;182;664;556;1728;738;2392
310230;201507;2514;7900;2093;6968;440;1716;976;3013;1416;4729
310240;201507;910;3306;814;3115;136;606;449;1756;585;2362
310250;201507;842;2797;810;2740;141;587;484;1528;625;2115
310260;201507;3266;10323;2550;8821;645;2546;757;2381;1402;4927
310270;201507;2449;7136;2102;6626;183;679;1604;5009;1787;5688
310280;201507;2259;6064;1882;5490;292;1033;987;2709;1279;3742
310285;201507;2053;7330;1926;7135;244;1031;1458;5437;1702;6468
310290;201507;1201;3623;1119;3503;282;1010;552;1569;834;2579
310300;201507;1729;5826;1637;5657;439;1717;878;2914;1317;4631
310310;201507;372;1010;265;802;41;121;121;375;162;496
310320;201507;384;1225;316;1087;48;227;149;491;197;718
310330;201507;509;1268;352;981;33;108;156;378;189;486
310340;201507;8279;24986;6839;22499;1313;4488;3577;12110;4890;16598
310350;201507;13961;37025;9980;30287;2542;8603;2831;8301;5373;16904
310360;201507;428;1301;408;1272;42;180;287;830;329;1010
310370;201507;1368;4626;1286;4484;364;1301;676;2382;1040;3683
310375;201507;1306;3460;845;2628;125;453;335;1002;460;1455
310380;201507;374;1009;272;856;98;340;96;271;194;611
310390;201507;449;1579;381;1439;91;382;70;219;161;601
310400;201507;10023;28106;7486;23634;1834;6314;1896;5943;3730;12257
310410;201507;783;2572;523;2098;131;576;108;420;239;996
310420;201507;5632;15785;3464;11105;610;2159;552;1541;1162;3700
310430;201507;1360;4459;1044;3811;269;1090;195;661;464;1751
310440;201507;548;1561;436;1368;88;318;178;521;266;839
310445;201507;1210;3986;1006;3595;152;593;629;2227;781;2820
310450;201507;4532;12828;3665;11582;502;1678;2416;7739;2918;9417
310460;201507;1507;4581;1250;4168;365;1337;267;940;632;2277
310470;201507;3501;8807;2963;8140;276;700;2421;6777;2697;7477
310480;201507;1207;3537;911;2948;186;709;388;1142;574;1851
310490;201507;2830;9236;2439;8459;641;2546;952;3173;1593;5719
310500;201507;1280;4322;1138;4013;263;1045;464;1569;727;2614
310510;201507;2103;6579;1620;5492;412;1506;302;977;714;2483
310520;201507;1375;3625;1069;3134;87;262;716;2101;803;2363
310530;201507;879;2713;498;1705;72;262;69;208;141;470
310540;201507;2879;9427;2604;8922;637;2261;1158;3964;1795;6225
310550;201507;1190;3392;952;2996;221;853;436;1245;657;2098
310560;201507;15378;46817;12862;41833;3545;12898;3978;12096;7523;24994
310570;201507;1156;3456;999;3183;154;577;692;2156;846;2733
310590;201507;4272;12404;3385;10708;587;2026;1378;4177;1965;6203
310600;201507;1347;4455;1197;4125;297;1185;433;1348;730;2533
310610;201507;474;1586;415;1459;94;419;133;400;227;819
310620;201507;142576;435606;120310;393179;28355;104397;47642;145323;75997;249720
310630;201507;3854;11740;3576;11265;395;1439;2624;8162;3019;9601
310640;201507;1297;3866;1010;3348;323;1164;247;746;570;1910
310650;201507;2632;8455;2135;7578;361;1383;1175;4172;1536;5555
310660;201507;1353;4096;1185;3860;139;467;842;2721;981;3188
310665;201507;1242;3788;1106;3595;118;428;835;2745;953;3173
310670;201507;41805;127003;36921;116684;9438;31871;13960;42567;23398;74438
310680;201507;678;1950;615;1855;127;414;359;1067;486;1481
310690;201507;1388;4491;1119;3999;268;1093;341;1142;609;2235
310700;201507;572;1459;441;1279;110;371;236;645;346;1016
310710;201507;6272;20569;4878;18135;1089;4830;943;3133;2032;7963
310720;201507;750;2271;674;2140;122;447;375;1145;497;1592
310730;201507;9204;28603;8165;26851;1504;5387;4818;15747;6322;21134
310740;201507;4797;15301;3837;13404;999;3861;893;2942;1892;6803
310750;201507;1493;3684;1140;3231;185;547;716;1990;901;2537
310760;201507;623;1866;515;1691;111;393;206;679;317;1072
310770;201507;836;2638;649;2340;155;640;271;895;426;1535
310780;201507;3638;10161;3083;9169;503;1505;1826;5421;2329;6926
310790;201507;1884;5993;1684;5633;426;1493;785;2731;1211;4224
310800;201507;2781;8764;2117;7464;664;2672;209;676;873;3348
310810;201507;1201;3359;1066;3120;192;620;579;1616;771;2236
310820;201507;1247;3599;914;2964;215;783;251;767;466;1550
310825;201507;2487;8334;1957;7387;129;677;1411;5238;1540;5915
310830;201507;1289;4147;986;3533;287;1093;239;795;526;1888
310840;201507;2121;6535;1683;5753;449;1678;483;1543;932;3221
310850;201507;1550;4565;1287;4223;195;697;867;2838;1062;3535
310855;201507;2864;9032;2459;8401;431;1625;1555;5347;1986;6972
310860;201507;7494;22941;6301;20803;900;3176;3636;12163;4536;15339
310870;201507;1008;2806;806;2481;150;498;412;1263;562;1761
310880;201507;1175;3566;873;2989;165;675;425;1422;590;2097
310890;201507;2647;8073;2035;7008;497;1940;499;1557;996;3497
310900;201507;3867;12268;3053;10504;715;2742;990;3119;1705;5861
310910;201507;2004;5687;1307;4303;278;1038;195;532;473;1570
310920;201507;1867;5518;1467;4923;351;1347;633;2076;984;3423
310925;201507;886;2915;798;2759;306;1167;287;953;593;2120
310930;201507;5973;16956;4744;15102;864;2962;2676;8704;3540;11666
310940;201507;6220;17691;5160;16036;932;3010;2709;8391;3641;11401
310945;201507;1191;3432;1029;3194;150;552;629;1877;779;2429
310950;201507;1986;6319;1466;5159;391;1590;368;1132;759;2722
310960;201507;389;1248;316;1112;88;343;108;380;196;723
310970;201507;1455;4895;1046;3905;278;1162;140;433;418;1595
310980;201507;463;1120;284;817;36;123;141;352;177;475
310990;201507;1142;3785;953;3380;222;894;280;907;502;1801
311000;201507;3582;12125;3170;11275;867;3523;1115;3673;1982;7196
311010;201507;733;2414;679;2317;219;822;311;1020;530;1842
311020;201507;896;2654;702;2307;158;579;289;883;447;1462
311030;201507;1590;4336;1106;3442;276;988;394;1107;670;2095
311040;201507;481;1627;420;1465;91;333;98;326;189;659
311050;201507;2035;6404;1782;5998;481;1789;814;2743;1295;4532
311060;201507;2145;6431;1618;5286;347;1274;431;1308;778;2582
311070;201507;1384;4767;1206;4419;300;1271;467;1666;767;2937
311080;201507;864;2586;752;2376;134;463;376;1101;510;1564
311090;201507;1579;5812;1328;5284;415;1838;252;970;667;2808
311100;201507;2059;6901;1686;6100;643;2528;319;1128;962;3656
311110;201507;3678;8737;2588;7173;387;1163;1397;3839;1784;5002
311115;201507;1201;3530;1006;3232;117;489;654;2039;771;2528
311120;201507;7735;21746;5939;18525;1478;5158;1543;4397;3021;9555
311130;201507;1917;6043;1615;5600;367;1556;710;2284;1077;3840
311140;201507;1351;3632;1094;3286;112;415;761;2229;873;2644
311150;201507;1806;6115;1652;5865;272;1069;1027;3642;1299;4711
311160;201507;4220;14007;3452;12602;1204;4836;909;3200;2113;8036
311170;201507;771;2346;607;2040;79;276;301;1047;380;1323
311180;201507;1312;3694;1002;3092;294;994;242;671;536;1665
311190;201507;1007;2971;854;2669;188;681;278;767;466;1448
311200;201507;2079;6306;1676;5455;487;1761;360;1021;847;2782
311205;201507;1024;3354;869;3036;147;570;380;1333;527;1903
311210;201507;934;3016;861;2911;160;533;598;2084;758;2617
311220;201507;888;2789;712;2404;169;614;246;814;415;1428
311230;201507;8423;26083;6757;22824;1321;4818;2824;9771;4145;14589
311240;201507;1105;3311;864;2896;211;785;269;855;480;1640
311250;201507;829;2679;738;2533;216;861;249;724;465;1585
311260;201507;2501;6617;1854;5544;466;1530;608;1791;1074;3321
311265;201507;1259;3475;996;3045;171;612;555;1655;726;2267
311270;201507;3280;10435;2857;9847;363;1601;1928;6385;2291;7986
311280;201507;1275;3526;832;2619;167;604;253;755;420;1359
311290;201507;1996;6712;1861;6401;399;1379;1067;3712;1466;5091
311300;201507;4411;14717;3953;13870;509;2077;2684;9399;3193;11476
311310;201507;545;1871;491;1772;93;404;202;677;295;1081
311320;201507;4010;13238;3502;12095;704;2761;1190;3868;1894;6629
311330;201507;4798;14271;4079;13072;1171;4186;1667;5272;2838;9458
311340;201507;11994;37732;10466;34792;3131;11229;3014;9870;6145;21099
311350;201507;2254;6466;1769;5533;324;1190;777;2214;1101;3404
311360;201507;1168;3207;889;2845;333;1128;190;606;523;1734
311370;201507;3717;11170;3128;10126;689;2695;1337;3972;2026;6667
311380;201507;401;1324;349;1226;96;372;115;389;211;761
311390;201507;1788;6518;1642;6296;676;2962;519;1831;1195;4793
311400;201507;1417;4483;1189;4052;229;938;534;1659;763;2597
311410;201507;1779;6103;1599;5862;437;1778;799;2945;1236;4723
311420;201507;1902;6129;1307;4670;296;1154;230;621;526;1775
311430;201507;3900;11633;2638;8828;495;1815;303;921;798;2736
311440;201507;2329;7455;1728;6306;545;2331;309;1071;854;3402
311450;201507;1946;6682;1620;5917;426;1723;359;1189;785;2912
311455;201507;1209;3214;983;2845;213;675;511;1384;724;2059
311460;201507;691;2233;529;1897;114;497;125;419;239;916
311470;201507;515;1645;408;1411;102;434;124;366;226;800
311480;201507;758;2008;710;1948;179;477;417;1140;596;1617
311490;201507;235;878;210;806;62;257;78;281;140;538
311500;201507;458;1324;364;1149;81;296;164;507;245;803
311510;201507;3132;9640;2548;8515;834;3291;577;1752;1411;5043
311520;201507;620;2036;566;1917;192;714;206;658;398;1372
311530;201507;11626;29925;8110;24065;1867;6593;2261;6509;4128;13102
311535;201507;815;2370;526;1782;115;450;85;277;200;727
311540;201507;628;2186;590;2133;223;808;256;910;479;1718
311545;201507;2058;6388;1879;6162;198;754;1360;4401;1558;5155
311547;201507;1514;4246;1263;3843;98;329;846;2573;944;2902
311550;201507;2863;9068;2371;8044;464;1775;801;2663;1265;4438
311560;201507;261;671;218;616;36;115;128;342;164;457
311570;201507;2167;5375;1668;4742;118;363;1269;3668;1387;4031
311580;201507;2362;4837;1803;4187;518;1124;960;2366;1478;3490
311590;201507;447;1382;382;1285;109;430;133;441;242;871
311600;201507;1180;3578;1005;3345;183;603;627;2119;810;2722
311610;201507;3082;10731;2754;10141;880;3192;1179;4566;2059;7758
311615;201507;3055;9403;2525;8546;269;1066;1749;5918;2018;6984
311620;201507;422;1309;371;1227;80;293;207;677;287;970
311630;201507;1372;3998;1137;3590;267;818;632;2020;899;2838
311640;201507;817;2578;673;2329;126;482;383;1291;509;1773
311650;201507;2247;6576;1888;5967;259;883;1055;3399;1314;4282
311660;201507;2391;7922;1891;6757;370;1456;241;695;611;2151
311670;201507;1570;4650;1285;4150;426;1517;416;1298;842;2815
311680;201507;2045;6436;1733;5909;397;1433;925;3148;1322;4581
311690;201507;505;1316;423;1214;46;145;334;956;380;1101
311700;201507;2170;5898;1811;5404;122;478;1412;4087;1534;4565
311710;201507;1671;5013;1222;4167;450;1721;315;1018;765;2739
311720;201507;393;1302;348;1207;63;242;168;560;231;802
311730;201507;5796;14467;3330;10098;916;3238;922;2233;1838;5471
311740;201507;848;2495;780;2411;280;836;413;1325;693;2161
311750;201507;3934;12809;3391;11921;640;2527;1807;6227;2447;8754
311760;201507;803;2678;738;2525;195;791;289;866;484;1657
311770;201507;2312;7259;1865;6405;438;1697;570;1847;1008;3544
311780;201507;1066;3820;881;3377;270;1187;205;713;475;1900
311783;201507;1938;6350;1633;5752;113;554;1197;4159;1310;4713
311787;201507;566;1936;404;1444;74;295;88;255;162;550
311790;201507;1403;4122;1006;3347;238;895;303;956;541;1851
311800;201507;4178;14089;3311;11643;599;2229;175;484;774;2713
311810;201507;1039;3415;949;3234;67;308;665;2225;732;2533
311820;201507;594;1881;481;1603;128;463;235;749;363;1212
311830;201507;7987;26728;6495;23039;2160;8260;835;2642;2995;10902
311840;201507;3104;9202;2689;8597;743;2697;1230;3796;1973;6493
311850;201507;287;852;248;786;63;220;112;345;175;565
311860;201507;48550;143525;41020;129848;9170;31882;18926;57665;28096;89547
311870;201507;2168;6312;1627;5279;335;1269;518;1505;853;2774
311880;201507;6761;19529;5989;18572;812;2382;4221;13604;5033;15986
311890;201507;1396;4171;1124;3633;271;979;457;1424;728;2403
311900;201507;757;2352;675;2247;114;380;431;1513;545;1893
311910;201507;4239;12393;3451;11232;840;2968;1461;4724;2301;7692
311920;201507;1899;6264;1661;5832;190;752;1055;3690;1245;4442
311930;201507;3586;10280;3031;9391;1095;3581;944;2866;2039;6447
311940;201507;11676;35136;9441;30506;2559;9009;1851;5583;4410;14592
311950;201507;2202;6417;1832;5900;155;561;1287;4087;1442;4648
311960;201507;359;1108;317;1017;70;264;128;348;198;612
311970;201507;345;1202;289;1075;69;295;76;270;145;565
311980;201507;645;1798;430;1402;69;242;166;538;235;780
311990;201507;425;1256;353;1137;131;465;119;352;250;817
311995;201507;1157;3525;704;2415;63;227;84;214;147;441
312000;201507;617;1857;553;1758;76;268;347;1103;423;1371
312010;201507;921;2992;780;2675;136;532;335;1108;471;1640
312015;201507;1392;4470;1239;4198;155;636;798;2672;953;3308
312020;201507;917;2871;792;2670;164;611;398;1332;562;1943
312030;201507;1753;5197;1578;4973;118;443;1281;3980;1399;4423
312040;201507;698;2595;597;2315;161;704;125;454;286;1158
312050;201507;1427;4900;1213;4417;312;1277;182;588;494;1865
312060;201507;746;2248;645;2091;267;928;213;626;480;1554
312070;201507;1026;3136;663;2344;160;613;219;765;379;1378
312080;201507;2597;7256;2052;6387;337;1234;1066;3108;1403;4342
312083;201507;900;2568;779;2385;105;365;527;1576;632;1941
312087;201507;2167;6615;1918;6243;246;852;1327;4386;1573;5238
312090;201507;8707;27113;7583;25144;2121;7543;3004;9736;5125;17279
312100;201507;1364;4584;1140;4224;252;1035;541;1987;793;3022
312110;201507;1097;3822;948;3493;305;1288;178;571;483;1859
312120;201507;743;2447;639;2232;150;632;220;661;370;1293
312125;201507;1149;3634;1011;3378;227;788;515;1784;742;2572
312130;201507;812;2344;622;1961;95;344;241;710;336;1054
312140;201507;919;2905;765;2539;149;555;249;705;398;1260
312150;201507;542;1550;459;1371;25;91;301;853;326;944
312160;201507;7264;24631;6474;22973;1773;6908;2361;8223;4134;15131
312170;201507;954;2739;812;2491;86;294;498;1507;584;1801
312180;201507;1354;4116;1177;3765;260;889;459;1395;719;2284
312190;201507;576;1836;439;1564;145;569;82;275;227;844
312200;201507;4770;13765;4025;12586;496;1611;2696;8397;3192;10008
312210;201507;988;2682;758;2330;209;704;289;832;498;1536
312220;201507;1846;6182;1688;5999;173;618;1372;5057;1545;5675
312230;201507;12799;39080;9740;33020;3314;12429;1589;5126;4903;17555
312235;201507;1563;4661;1353;4342;147;588;924;2878;1071;3466
312240;201507;936;3072;751;2670;173;676;237;781;410;1457
312245;201507;2206;6542;1947;6197;123;410;1594;5081;1717;5491
312247;201507;828;2492;645;2163;166;615;299;1003;465;1618
312250;201507;1171;3255;913;2816;171;617;378;1101;549;1718
312260;201507;889;2822;730;2562;127;516;460;1567;587;2083
312270;201507;656;1968;543;1752;81;344;242;697;323;1041
312280;201507;387;1306;344;1214;124;465;48;160;172;625
312290;201507;742;2425;682;2335;198;796;222;730;420;1526
312300;201507;855;2823;669;2371;154;601;82;216;236;817
312310;201507;894;3339;815;3149;238;1016;298;1097;536;2113
312320;201507;1952;5569;1464;4570;339;1129;265;665;604;1794
312330;201507;977;2889;816;2648;140;542;584;1865;724;2407
312340;201507;302;778;262;723;28;115;208;539;236;654
312350;201507;306;766;274;728;23;69;232;600;255;669
312352;201507;1593;5086;1427;4824;369;1259;850;2968;1219;4227
312360;201507;2822;9125;2314;8051;531;2052;693;2346;1224;4398
312370;201507;1703;5385;1528;5100;540;2023;489;1520;1029;3543
312380;201507;1870;5282;1656;4977;122;392;1340;4109;1462;4501
312385;201507;1265;3729;1092;3449;110;450;752;2288;862;2738
312390;201507;2138;6921;1721;6031;477;1795;291;910;768;2705
312400;201507;3153;10055;2662;9117;915;3246;811;2886;1726;6132
312410;201507;9641;31491;8505;29263;1957;7379;3472;11633;5429;19012
312420;201507;3946;12111;3720;11829;535;1724;2650;8597;3185;10321
312430;201507;7404;22466;6644;21112;1163;3795;4134;13245;5297;17040
312440;201507;673;2141;597;2011;141;516;305;1079;446;1595
312450;201507;1141;3808;903;3304;304;1174;296;1088;600;2262
312460;201507;354;1063;316;1019;87;313;158;503;245;816
312470;201507;681;1849;435;1365;81;283;142;432;223;715
312480;201507;1200;3274;935;2969;224;796;489;1458;713;2254
312490;201507;2020;5290;1555;4608;228;757;864;2439;1092;3196
312500;201507;678;2071;598;1953;101;412;302;954;403;1366
312510;201507;3073;8963;2382;7530;401;1466;1157;3385;1558;4851
312520;201507;268;911;215;808;59;240;72;272;131;512
312530;201507;589;1763;525;1671;76;309;338;1023;414;1332
312540;201507;1456;4571;1129;3915;243;896;540;1851;783;2747
312550;201507;677;2079;575;1852;121;398;253;772;374;1170
312560;201507;1979;5311;1678;4919;111;384;1349;3914;1460;4298
312570;201507;2468;7256;2034;6501;596;2026;598;1836;1194;3862
312580;201507;525;1732;436;1542;79;347;161;530;240;877
312590;201507;1703;5668;1476;5179;310;1291;587;1891;897;3182
312595;201507;1980;6656;1756;6130;431;1607;873;3016;1304;4623
312600;201507;772;2501;596;2145;102;482;304;993;406;1475
312610;201507;6880;19287;5038;15912;1181;4206;1228;3603;2409;7809
312620;201507;2031;5961;1603;5371;152;589;1184;4022;1336;4611
312630;201507;346;1115;303;1033;77;306;131;421;208;727
312640;201507;543;1731;430;1499;89;349;143;449;232;798
312650;201507;2105;6229;1532;5083;163;587;894;2956;1057;3543
312660;201507;1330;3594;1097;3246;114;398;747;2162;861;2560
312670;201507;5622;16739;4793;15552;1281;4582;1793;5639;3074;10221
312675;201507;1262;4061;1056;3615;139;558;640;2135;779;2693
312680;201507;1457;4504;1280;4238;218;817;727;2295;945;3112
312690;201507;2149;5744;1738;5165;304;1010;1023;2908;1327;3918
312695;201507;810;2921;777;2877;153;556;510;1959;663;2515
312700;201507;1894;5616;1464;4737;208;761;735;2317;943;3078
312705;201507;1253;3587;1064;3259;104;352;757;2292;861;2644
312707;201507;1649;5103;1289;4407;190;755;670;2195;860;2950
312710;201507;6841;17639;4466;13598;1171;4084;947;2639;2118;6723
312720;201507;744;2529;646;2324;151;606;235;785;386;1391
312730;201507;1870;4453;1301;3784;184;597;740;2155;924;2752
312733;201507;1668;4439;1242;3642;85;323;848;2370;933;2693
312735;201507;826;2313;717;2168;179;608;403;1178;582;1786
312737;201507;853;2140;614;1799;200;582;248;751;448;1333
312738;201507;533;1604;386;1296;101;403;127;380;228;783
312740;201507;398;1077;260;912;86;341;69;247;155;588
312750;201507;1216;4343;1160;4230;241;1082;568;1961;809;3043
312760;201507;2045;6526;1567;5543;393;1529;362;1253;755;2782
312770;201507;40356;110954;31478;96069;8260;27341;9148;27026;17408;54367
312780;201507;2685;9352;2390;8854;445;1823;1257;4743;1702;6566
312790;201507;326;823;184;571;44;168;50;109;94;277
312800;201507;4934;16108;4025;14248;1253;4813;1107;3901;2360;8714
312810;201507;2122;6488;1475;5209;365;1393;262;864;627;2257
312820;201507;1908;5498;1696;5146;115;415;1159;3431;1274;3846
312825;201507;1348;3644;1168;3417;107;340;900;2620;1007;2960
312830;201507;2701;8336;1856;6591;466;1805;324;1125;790;2930
312840;201507;1213;3904;1025;3556;128;564;555;1851;683;2415
312850;201507;630;2012;511;1785;89;384;171;574;260;958
312860;201507;1089;3167;844;2735;216;821;240;658;456;1479
312870;201507;5500;16966;3818;13393;751;2954;828;2765;1579;5719
312880;201507;1260;3735;1086;3452;171;610;622;2001;793;2611
312890;201507;1606;4771;1091;3665;297;1137;363;1189;660;2326
312900;201507;1216;3592;1069;3384;155;518;745;2419;900;2937
312910;201507;1604;3255;999;2464;172;503;522;1156;694;1659
312920;201507;844;2664;703;2415;184;722;298;958;482;1680
312930;201507;2206;6325;1893;5865;421;1357;910;2882;1331;4239
312940;201507;881;2877;761;2671;215;867;206;673;421;1540
312950;201507;3256;9041;2493;7875;814;2795;694;2134;1508;4929
312960;201507;1920;5587;1681;5273;253;760;1253;4048;1506;4808
312965;201507;1774;5640;1499;5140;225;873;868;2969;1093;3842
312970;201507;972;3307;812;3025;264;1143;139;459;403;1602
312980;201507;16622;55689;15529;53315;4923;18523;6128;20108;11051;38631
312990;201507;444;1343;330;1143;110;432;101;342;211;774
313000;201507;503;1642;403;1443;98;462;163;498;261;960
313005;201507;2533;8191;2237;7646;464;1607;1234;4266;1698;5873
313010;201507;3618;11491;3042;10490;795;2979;1260;4270;2055;7249
313020;201507;903;2913;759;2618;185;746;230;683;415;1429
313030;201507;1467;3956;1084;3416;240;923;463;1367;703;2290
313040;201507;823;2740;701;2430;127;510;271;861;398;1371
313050;201507;1756;5476;1341;4839;337;1365;370;1189;707;2554
313055;201507;1564;5050;1425;4856;122;441;1101;3803;1223;4244
313060;201507;657;2139;520;1794;160;567;61;204;221;771
313065;201507;1920;6226;1649;5791;332;1292;1100;3845;1432;5137
313070;201507;1103;3182;898;2818;206;749;410;1186;616;1935
313080;201507;459;1440;357;1237;87;355;118;343;205;698
313090;201507;5216;14953;4497;13799;943;3077;2460;7576;3403;10653
313100;201507;1065;3281;958;3100;107;361;728;2378;835;2739
313110;201507;1720;4865;1277;4006;250;891;515;1491;765;2382
313115;201507;2420;8149;2287;7882;546;2145;1106;3563;1652;5708
313120;201507;3412;9129;2850;8360;774;2493;1417;3935;2191;6428
313130;201507;24112;72955;20562;65578;4981;17538;7609;22728;12590;40266
313140;201507;671;1711;506;1462;33;121;358;1019;391;1140
313150;201507;1348;4251;1131;3841;459;1694;278;912;737;2606
313160;201507;1007;3021;880;2784;153;571;518;1580;671;2151
313170;201507;7591;25768;6090;22192;1554;6077;1258;4471;2812;10548
313180;201507;2380;6518;1895;5811;518;1751;682;1996;1200;3747
313190;201507;2971;10343;2389;8781;500;2049;689;2325;1189;4374
313200;201507;1242;4044;1098;3777;149;581;741;2503;890;3084
313210;201507;4280;13169;3601;12183;825;3077;1661;5389;2486;8466
313220;201507;1342;4055;995;3299;250;914;219;626;469;1540
313230;201507;2260;8086;2085;7829;321;1296;1421;5328;1742;6624
313240;201507;7320;22644;5828;19900;1254;4926;2267;7400;3521;12326
313250;201507;7046;22043;6191;20578;946;3246;3582;12029;4528;15275
313260;201507;619;1836;458;1506;79;300;111;323;190;623
313270;201507;5365;15926;4536;14526;815;2792;2546;8089;3361;10881
313280;201507;381;1266;302;1092;55;239;85;266;140;505
313290;201507;856;2976;692;2662;231;979;129;429;360;1408
313300;201507;1798;5973;1462;5159;413;1591;219;662;632;2253
313310;201507;1075;3684;944;3411;232;938;180;589;412;1527
313320;201507;2337;6779;1790;5880;344;1253;791;2581;1135;3834
313330;201507;3867;12152;3232;11007;532;2071;1752;5841;2284;7912
313340;201507;1944;4749;1513;4107;296;822;836;2234;1132;3056
313350;201507;3116;9516;2384;7944;528;1968;456;1338;984;3306
313360;201507;1180;3439;884;2944;239;934;441;1369;680;2303
313370;201507;1142;3853;1050;3604;159;659;558;1786;717;2445
313375;201507;2195;5682;1463;4577;277;1087;483;1437;760;2524
313380;201507;4809;15011;3933;13196;996;3693;1324;4193;2320;7886
313390;201507;838;2900;801;2848;91;369;560;1985;651;2354
313400;201507;3680;10150;3280;9696;224;637;2814;8479;3038;9116
313410;201507;1211;3494;1034;3240;218;766;588;1810;806;2576
313420;201507;20205;47901;12130;34169;2334;7347;2370;6378;4704;13725
313430;201507;1067;3307;818;2782;167;686;336;1054;503;1740
313440;201507;6106;13850;4157;11566;309;970;2795;7760;3104;8730
313450;201507;631;1829;501;1571;107;420;182;502;289;922
313460;201507;2144;7306;1864;6825;500;2084;561;1885;1061;3969
313470;201507;3142;8813;2908;8536;328;903;2308;6848;2636;7751
313480;201507;1100;3150;850;2723;127;486;353;1047;480;1533
313490;201507;1389;4135;827;3187;256;1077;124;447;380;1524
313500;201507;387;1209;337;1086;65;240;137;403;202;643
313505;201507;8928;26515;8245;25735;382;875;7520;24015;7902;24890
313507;201507;1322;3753;1169;3544;156;545;776;2366;932;2911
313510;201507;15275;43853;13284;40966;2109;6710;7843;24517;9952;31227
313520;201507;14153;43635;11927;39541;1469;5602;7557;24685;9026;30287
313530;201507;594;1853;474;1623;45;190;170;544;215;734
313535;201507;2381;7203;2132;6745;204;706;1534;4771;1738;5477
313540;201507;1050;3308;797;2647;212;769;190;562;402;1331
313545;201507;1270;4666;1141;4395;139;703;698;2532;837;3235
313550;201507;1820;5824;1596;5381;413;1469;744;2435;1157;3904
313560;201507;2122;5150;1788;4767;310;768;1203;3354;1513;4122
313570;201507;833;2976;713;2742;246;1012;195;722;441;1734
313580;201507;5846;16537;4808;15109;797;2709;2965;9342;3762;12051
313590;201507;991;2819;768;2523;378;1365;192;591;570;1956
313600;201507;3801;11485;3287;10663;495;1753;2086;6806;2581;8559
313610;201507;977;2956;832;2671;182;649;396;1239;578;1888
313620;201507;5359;16470;4583;15084;1274;4506;1649;5357;2923;9863
313630;201507;7845;22159;5989;19369;1153;4242;2636;8855;3789;13097
313640;201507;779;2286;591;1990;175;659;190;624;365;1283
313650;201507;2046;6640;1781;6210;279;1103;1182;4044;1461;5147
313652;201507;957;3424;880;3286;150;634;535;1954;685;2588
313655;201507;922;2983;768;2717;120;525;449;1526;569;2051
313657;201507;1283;3916;1087;3608;116;533;779;2364;895;2897
313660;201507;823;2719;740;2572;160;655;358;1182;518;1837
313665;201507;3299;10736;2957;10003;638;2425;1342;4341;1980;6766
313670;201507;49075;135872;32617;107441;8172;29696;9641;30845;17813;60541
313680;201507;1049;3151;921;2939;158;566;579;1799;737;2365
313690;201507;826;2957;720;2709;190;755;267;1003;457;1758
313695;201507;1337;4391;1152;4053;125;511;799;2808;924;3319
313700;201507;3740;12493;3165;11744;517;2002;2142;8154;2659;10156
313710;201507;1275;3439;992;3012;221;726;479;1412;700;2138
313720;201507;5009;16157;4018;13984;812;3173;1295;4140;2107;7313
313730;201507;1257;3416;967;3051;184;643;521;1632;705;2275
313740;201507;2109;7522;1766;6679;513;2202;172;559;685;2761
313750;201507;2191;6605;1824;5914;484;1702;602;1798;1086;3500
313753;201507;1771;5190;1398;4535;355;1277;526;1674;881;2951
313760;201507;4454;14351;3660;12751;1025;3914;999;3204;2024;7118
313770;201507;3228;10606;2922;10066;922;3437;1142;3800;2064;7237
313780;201507;3609;9999;2857;8873;469;1767;1291;3954;1760;5721
313790;201507;490;1697;467;1656;100;353;268;984;368;1337
313800;201507;1195;3297;1037;3051;130;430;675;1997;805;2427
313810;201507;1481;4317;1421;4233;69;194;1250;3810;1319;4004
313820;201507;12822;34104;10423;30260;1738;5976;5063;14063;6801;20039
313830;201507;400;1328;340;1206;92;378;111;384;203;762
313835;201507;915;3035;849;2932;160;645;481;1576;641;2221
313840;201507;7488;21362;5789;18449;1478;5243;1548;4771;3026;10014
313850;201507;1192;3217;1022;2912;210;719;528;1380;738;2099
313860;201507;2735;8282;2080;6842;498;1767;466;1458;964;3225
313862;201507;1171;2911;775;2250;119;345;362;1091;481;1436
313865;201507;2208;6822;2003;6514;246;932;1439;4612;1685;5544
313867;201507;1097;3738;925;3354;306;1187;296;1112;602;2299
313868;201507;1566;5442;1367;5028;141;627;901;3273;1042;3900
313870;201507;792;2475;718;2354;207;780;223;636;430;1416
313880;201507;1497;4581;1311;4353;224;922;831;2609;1055;3531
313890;201507;1788;4946;1515;4575;233;689;1020;3198;1253;3887
313900;201507;3921;14227;3517;13278;1062;4545;1058;3794;2120;8339
313910;201507;752;2513;631;2269;226;888;86;283;312;1171
313920;201507;3375;11108;2918;10252;485;1806;1684;6018;2169;7824
313925;201507;1906;5102;1377;4111;85;286;852;2524;937;2810
313930;201507;5195;16955;4272;15266;761;2886;2211;8008;2972;10894
313940;201507;8133;27125;6819;24988;2064;8368;2289;8717;4353;17085
313950;201507;4000;11402;3128;9953;925;3422;1061;2997;1986;6419
313960;201507;5492;14069;3974;11976;1193;3972;1114;3131;2307;7103
313970;201507;1425;4044;1233;3833;138;479;778;2510;916;2989
313980;201507;1234;3890;961;3400;266;1090;392;1377;658;2467
313990;201507;1822;6731;1547;6066;513;2221;324;1122;837;3343
314000;201507;7494;24192;6771;22788;1257;5077;3801;12153;5058;17230
314010;201507;1091;3099;900;2846;116;434;564;1726;680;2160
314015;201507;1130;3937;965;3623;262;1086;358;1266;620;2352
314020;201507;512;1566;387;1297;96;370;90;268;186;638
314030;201507;861;2758;670;2325;96;369;241;814;337;1183
314040;201507;669;1900;552;1693;260;821;156;494;416;1315
314050;201507;1752;5400;1370;4631;314;1232;447;1354;761;2586
314053;201507;1507;4813;1349;4611;184;640;920;3269;1104;3909
314055;201507;2099;6359;1872;6019;91;388;1451;4670;1542;5058
314060;201507;1127;3473;890;3060;73;317;557;1868;630;2185
314070;201507;3894;12023;2971;10197;771;2849;683;2232;1454;5081
314080;201507;1934;5945;1273;4383;233;896;271;803;504;1699
314085;201507;1928;6513;1679;6159;445;1830;619;2235;1064;4065
314090;201507;3278;11300;2883;10509;761;3077;1023;3767;1784;6844
314100;201507;3224;8408;2809;7845;215;500;2347;6779;2562;7279
314110;201507;4031;12745;3501;11652;672;2618;1431;4352;2103;6970
314120;201507;992;2404;508;1616;125;447;133;410;258;857
314130;201507;715;2045;378;1283;59;216;74;245;133;461
314140;201507;4869;15133;4086;13590;873;3098;1705;5612;2578;8710
314150;201507;1581;4351;1284;3845;211;731;673;1973;884;2704
314160;201507;2514;6467;1964;5731;177;567;1239;3753;1416;4320
314170;201507;1059;3180;854;2732;117;418;448;1376;565;1794
314180;201507;5338;17177;4740;16221;1188;4458;2215;7698;3403;12156
314190;201507;710;2066;564;1842;128;522;228;667;356;1189
314200;201507;2956;9281;2576;8580;304;1225;1727;5601;2031;6826
314210;201507;1937;5720;1714;5324;245;914;1067;3161;1312;4075
314220;201507;1645;5119;1273;4378;386;1498;266;782;652;2280
314225;201507;1289;3795;1149;3605;80;265;972;3085;1052;3350
314230;201507;636;2095;571;1976;126;492;246;822;372;1314
314240;201507;1109;3357;924;3072;143;480;548;1906;691;2386
314250;201507;560;1665;424;1382;92;340;138;392;230;732
314260;201507;1079;3835;972;3595;265;1074;323;1133;588;2207
314270;201507;2836;9216;2412;8455;233;916;1630;5754;1863;6670
314280;201507;3174;8761;2123;6716;501;1852;674;1842;1175;3694
314290;201507;4808;13305;4136;12190;1081;3329;2205;6391;3286;9720
314300;201507;1539;5105;1326;4614;358;1330;451;1497;809;2827
314310;201507;5203;15624;4407;14095;1288;4477;1446;4404;2734;8881
314315;201507;860;3334;793;3204;109;527;517;2077;626;2604
314320;201507;3023;8325;2214;7272;613;2260;1133;3761;1746;6021
314330;201507;51840;157332;45377;146844;12511;43928;17222;54925;29733;98853
314340;201507;2817;7687;1554;5155;341;1227;116;245;457;1472
314345;201507;1193;4085;1077;3893;273;1038;600;2172;873;3210
314350;201507;1346;3888;1069;3436;406;1448;260;781;666;2229
314360;201507;679;2149;452;1602;91;379;100;329;191;708
314370;201507;524;1823;482;1756;146;580;276;994;422;1574
314380;201507;1253;3758;860;2969;239;894;130;433;369;1327
314390;201507;14220;40847;10624;34101;2580;9040;2755;8152;5335;17192
314400;201507;4532;13286;3833;12297;1358;4551;1457;4794;2815;9345
314410;201507;2579;8053;2146;7192;604;2367;710;2205;1314;4572
314420;201507;747;2153;588;1922;43;209;390;1202;433;1411
314430;201507;6497;19338;5624;17671;1662;5711;1696;5379;3358;11090
314435;201507;1306;4179;1148;3899;117;511;734;2450;851;2961
314437;201507;1131;2929;951;2654;46;135;755;2080;801;2215
314440;201507;654;1900;493;1662;167;626;85;255;252;881
314450;201507;1587;4612;1320;4218;341;1271;584;1729;925;3000
314460;201507;4249;14195;3433;12425;874;3548;658;2253;1532;5801
314465;201507;2260;7101;2075;6790;122;543;1620;5171;1742;5714
314467;201507;1063;2977;890;2667;95;268;620;1891;715;2159
314470;201507;2425;7633;1955;6602;417;1641;561;1658;978;3299
314480;201507;5986;19731;4011;14429;610;2407;442;1337;1052;3744
314490;201507;954;2793;744;2371;185;654;309;928;494;1582
314500;201507;2064;5770;1512;4811;395;1341;618;1922;1013;3263
314505;201507;1731;5166;1613;4989;263;903;1040;3215;1303;4118
314510;201507;1884;5099;1264;4220;410;1522;311;1007;721;2529
314520;201507;3037;10871;2296;9068;522;2376;351;1155;873;3531
314530;201507;6215;22055;5885;21480;1112;3997;3512;13235;4624;17232
314535;201507;2726;7641;2332;7091;228;794;1786;5383;2014;6177
314537;201507;1168;3668;931;3237;146;610;527;1791;673;2401
314540;201507;415;1245;341;1086;78;282;109;310;187;592
314545;201507;1352;4152;1166;3874;181;694;769;2546;950;3240
314550;201507;624;1715;463;1494;80;338;195;575;275;913
314560;201507;4553;15618;3802;13763;764;3122;1135;3930;1899;7052
314570;201507;302;893;229;739;58;205;104;324;162;529
314580;201507;508;1705;398;1452;100;438;71;221;171;659
314585;201507;831;2710;590;2179;138;578;155;556;293;1134
314587;201507;1863;5812;1615;5365;364;1146;761;2626;1125;3772
314590;201507;3265;11015;2267;8304;399;1621;284;901;683;2522
314600;201507;1878;6119;1386;5102;383;1580;222;741;605;2321
314610;201507;6843;23210;6107;21479;1456;5800;2495;8229;3951;14029
314620;201507;1615;4793;1457;4578;180;550;1071;3401;1251;3951
314625;201507;1460;4991;1381;4856;189;807;982;3299;1171;4106
314630;201507;4839;14418;4221;13438;313;1216;3134;9894;3447;11110
314640;201507;573;1566;440;1334;107;352;130;337;237;689
314650;201507;1153;3192;802;2566;130;498;307;883;437;1381
314655;201507;1612;4770;1185;3922;283;917;433;1444;716;2361
314660;201507;262;711;200;596;20;68;103;290;123;358
314670;201507;1617;4363;1254;3752;209;705;741;2207;950;2912
314675;201507;1780;5466;1520;5002;147;582;1051;3429;1198;4011
314690;201507;2399;7560;1950;6752;535;2146;502;1601;1037;3747
314700;201507;8315;29003;6290;24323;1933;8406;1081;4043;3014;12449
314710;201507;8851;26830;5989;20465;1140;4342;899;2807;2039;7149
314720;201507;2332;7651;1952;6815;481;1873;708;2426;1189;4299
314730;201507;2255;6688;1803;6016;497;1819;607;1938;1104;3757
314740;201507;2871;9155;2492;8420;535;2057;1078;3468;1613;5525
314750;201507;337;1054;274;908;43;171;132;407;175;578
314760;201507;1751;5865;1287;4700;222;933;262;820;484;1753
314770;201507;1200;3769;686;2341;76;312;103;262;179;574
314780;201507;298;761;203;634;53;187;85;259;138;446
314790;201507;11891;34743;8619;28981;3561;13690;1161;3354;4722;17044
314795;201507;1657;4733;1395;4317;131;536;1030;3024;1161;3560
314800;201507;11560;33399;8207;26685;2398;8499;1249;3820;3647;12319
314810;201507;12308;35814;9504;30851;2778;10036;2079;6637;4857;16673
314820;201507;940;2539;624;2022;164;593;214;658;378;1251
314830;201507;1656;5494;1438;5115;453;1784;571;2024;1024;3808
314840;201507;957;3472;784;3205;170;835;436;1727;606;2562
314850;201507;1930;5653;1548;4946;225;896;957;2916;1182;3812
314860;201507;3199;10707;2859;10090;655;2512;1452;5126;2107;7638
314870;201507;5441;17294;4751;16372;553;2320;3399;11647;3952;13967
314875;201507;1728;5755;1643;5628;313;1036;1199;4208;1512;5244
314880;201507;847;2328;713;2154;46;139;526;1661;572;1800
314890;201507;596;1768;400;1349;83;340;139;408;222;748
314900;201507;492;1495;393;1339;97;349;183;611;280;960
314910;201507;1621;5344;1324;4847;406;1697;395;1347;801;3044
314915;201507;2480;7859;2192;7404;189;771;1584;5204;1773;5975
314920;201507;542;1499;382;1248;46;176;200;602;246;778
314930;201507;4471;14929;3862;13592;1066;4075;1006;3449;2072;7524
314940;201507;401;1157;367;1098;71;234;192;533;263;767
314950;201507;337;1025;262;899;54;198;76;249;130;447
314960;201507;743;2302;567;1942;151;574;152;459;303;1033
314970;201507;531;1788;447;1642;100;432;123;433;223;865
314980;201507;1632;5057;1371;4593;408;1543;161;470;569;2013
314990;201507;2617;8200;1993;6845;568;2261;383;1095;951;3356
314995;201507;1579;4851;1390;4559;157;616;925;2955;1082;3571
315000;201507;1040;3052;855;2742;115;442;530;1671;645;2113
315010;201507;454;1409;357;1200;90;360;123;355;213;715
315015;201507;2019;6202;1805;5946;249;847;1314;4515;1563;5362
315020;201507;812;2513;609;2065;105;414;283;909;388;1323
315030;201507;721;2166;584;1909;182;640;144;458;326;1098
315040;201507;848;2645;796;2543;147;484;494;1559;641;2043
315050;201507;1427;4085;1131;3613;254;930;464;1439;718;2369
315053;201507;1068;3179;940;2954;160;626;429;1333;589;1959
315057;201507;1701;5888;1490;5560;277;1029;839;3238;1116;4267
315060;201507;857;2804;628;2300;153;616;144;527;297;1143
315070;201507;767;2295;667;2147;173;606;321;980;494;1586
315080;201507;2881;9801;2568;9119;582;2257;1247;4376;1829;6633
315090;201507;771;2757;676;2547;168;709;204;755;372;1464
315100;201507;1202;4050;882;3289;210;914;210;686;420;1600
315110;201507;1355;4189;1173;3827;270;950;489;1575;759;2525
315120;201507;14214;33195;9629;27254;1506;4478;4997;14890;6503;19368
315130;201507;1414;4639;1266;4347;361;1400;394;1281;755;2681
315140;201507;2602;8379;2152;7425;500;2019;725;2247;1225;4266
315150;201507;4857;13037;3582;10882;736;2546;1323;3867;2059;6413
315160;201507;1205;3449;1016;3083;196;642;503;1460;699;2102
315170;201507;1433;4211;1176;3810;209;713;574;2026;783;2739
315180;201507;16933;47774;9779;32342;1827;6879;1730;5149;3557;12028
315190;201507;2099;5549;1770;5041;476;1412;903;2596;1379;4008
315200;201507;3906;13067;3179;11442;934;3699;777;2657;1711;6356
315210;201507;7705;22540;6090;19236;1421;4986;2081;6274;3502;11260
315213;201507;1075;3469;1016;3390;67;239;833;2782;900;3021
315217;201507;2491;8528;2083;7813;286;1262;1213;4539;1499;5801
315220;201507;9915;28669;8264;26110;2388;7451;3745;12345;6133;19796
315230;201507;2733;7302;2424;6931;207;387;1961;6041;2168;6428
315240;201507;2998;9356;2612;8750;585;2160;1472;4812;2057;6972
315250;201507;9805;29766;7157;24641;1840;7055;2139;7317;3979;14372
315260;201507;967;3026;693;2416;168;649;125;384;293;1033
315270;201507;716;2319;560;2001;119;477;138;443;257;920
315280;201507;3005;8563;1962;6320;468;1638;418;1164;886;2802
315290;201507;1390;3880;1026;3286;339;1179;158;482;497;1661
315300;201507;537;1388;365;1175;170;576;120;384;290;960
315310;201507;1256;4042;1057;3665;131;554;671;2220;802;2774
315320;201507;787;2383;630;2174;120;473;305;1079;425;1552
315330;201507;689;2493;435;1802;114;519;48;213;162;732
315340;201507;3673;10534;2994;9460;650;2275;1239;3763;1889;6038
315350;201507;1776;4951;1305;4244;240;814;698;2331;938;3145
315360;201507;1660;5478;1322;4617;252;954;428;1385;680;2339
315370;201507;476;1407;404;1294;89;306;228;750;317;1056
315380;201507;200;691;158;592;44;187;30;90;74;277
315390;201507;1274;4340;982;3655;251;1080;191;625;442;1705
315400;201507;4286;12921;3514;11421;740;2688;1556;4932;2296;7620
315410;201507;1986;5291;1657;4823;219;775;1071;3076;1290;3851
315415;201507;1024;3384;934;3246;340;1195;428;1561;768;2756
315420;201507;1225;3896;922;3262;235;875;145;481;380;1356
315430;201507;3766;10229;2803;8588;703;2440;670;1939;1373;4379
315440;201507;885;2755;758;2534;136;515;378;1242;514;1757
315445;201507;2071;5816;1678;5239;188;706;1199;3658;1387;4364
315450;201507;2393;7614;2170;7272;476;1511;1264;4390;1740;5901
315460;201507;34068;111174;29871;102272;9782;35848;6255;20331;16037;56179
315470;201507;507;1501;415;1338;47;190;235;730;282;920
315480;201507;1737;5252;1072;3717;206;799;181;594;387;1393
315490;201507;3104;8391;2405;7414;342;1239;1089;3229;1431;4468
315500;201507;474;1445;314;1068;49;192;109;312;158;504
315510;201507;1425;4017;1201;3668;80;285;896;2692;976;2977
315520;201507;1104;3240;870;2914;122;464;553;1802;675;2266
315530;201507;552;1895;476;1713;190;734;132;435;322;1169
315540;201507;1064;3345;889;3008;175;716;312;1031;487;1747
315550;201507;1714;4801;1319;4244;413;1489;415;1284;828;2773
315560;201507;6489;21574;5853;20683;654;2637;4035;14312;4689;16949
315570;201507;2010;6303;1857;6045;351;1288;1018;3241;1369;4529
315580;201507;2538;7409;1955;6340;493;1847;554;1617;1047;3464
315590;201507;908;2627;803;2463;147;506;435;1295;582;1801
315600;201507;2464;8770;2012;7915;356;1478;1082;4417;1438;5895
315610;201507;990;2835;795;2429;155;605;303;780;458;1385
315620;201507;310;1094;293;1064;90;311;157;600;247;911
315630;201507;844;2677;713;2419;177;651;197;634;374;1285
315640;201507;563;1614;458;1438;96;362;213;612;309;974
315645;201507;851;2620;716;2332;264;932;174;540;438;1472
315650;201507;1849;5163;1529;4707;90;383;1149;3477;1239;3860
315660;201507;2551;6713;2143;6074;407;1149;1274;3617;1681;4766
315670;201507;9901;33005;8665;30591;2645;10109;2872;9942;5517;20051
315680;201507;2956;9999;2361;8751;843;3294;402;1474;1245;4768
315690;201507;3459;9805;2388;7853;616;2242;490;1620;1106;3862
315700;201507;7136;22297;6025;20060;1134;4278;2818;8963;3952;13241
315710;201507;1810;5314;1476;4769;142;568;937;2932;1079;3500
315720;201507;3460;10825;3047;10069;652;2517;1530;4807;2182;7324
315725;201507;1399;4515;1266;4310;349;1214;680;2360;1029;3574
315727;201507;612;1876;503;1648;113;409;207;650;320;1059
315730;201507;842;2568;760;2416;129;460;430;1337;559;1797
315733;201507;933;2843;833;2650;272;934;254;760;526;1694
315737;201507;1301;3945;995;3379;92;387;631;2165;723;2552
315740;201507;993;3073;832;2743;154;621;426;1303;580;1924
315750;201507;1108;3453;1021;3297;81;299;743;2384;824;2683
315760;201507;1018;2764;975;2710;30;100;878;2425;908;2525
315765;201507;1365;4283;1235;4098;73;266;1009;3371;1082;3637
315770;201507;1553;4982;1348;4585;350;1325;391;1261;741;2586
315780;201507;21753;70790;19535;65942;5365;19418;5643;18784;11008;38202
315790;201507;3413;11496;2999;10652;322;1075;2008;7365;2330;8440
315800;201507;1502;5775;1190;4843;287;1316;225;872;512;2188
315810;201507;1375;3820;1179;3513;152;448;817;2419;969;2867
315820;201507;2598;8729;2287;8194;712;2638;988;3624;1700;6262
315830;201507;1187;3994;1008;3573;132;579;314;971;446;1550
315840;201507;836;2182;596;1766;97;318;188;521;285;839
315850;201507;1032;3704;995;3625;248;952;487;1731;735;2683
315860;201507;518;1794;392;1520;97;445;65;224;162;669
315870;201507;469;1391;388;1260;109;389;135;399;244;788
315880;201507;1176;3079;923;2751;207;738;323;887;530;1625
315890;201507;1504;5081;1310;4770;480;1844;560;2035;1040;3879
315895;201507;5037;15522;4481;14350;1005;3568;1853;5674;2858;9242
315900;201507;726;2251;696;2190;88;368;518;1507;606;1875
315910;201507;530;1790;492;1725;160;613;268;911;428;1524
315920;201507;1537;4240;923;2943;207;725;188;490;395;1215
315930;201507;1089;2971;823;2502;214;729;216;613;430;1342
315935;201507;980;3241;877;3006;229;861;277;945;506;1806
315940;201507;643;2006;558;1833;141;544;246;756;387;1300
315950;201507;1135;3475;1032;3290;213;649;641;2091;854;2740
315960;201507;3086;9856;2207;8133;870;3684;111;268;981;3952
315970;201507;755;2041;578;1789;49;141;421;1365;470;1506
315980;201507;4063;9823;2452;7087;633;2096;608;1442;1241;3538
315990;201507;3924;11418;3313;10442;574;2189;1714;5225;2288;7414
316000;201507;538;1628;458;1521;149;594;172;548;321;1142
316010;201507;562;1907;461;1702;92;405;165;535;257;940
316020;201507;1109;3539;914;3214;151;618;526;1835;677;2453
316030;201507;3314;9642;2437;8075;293;1080;1368;4644;1661;5724
316040;201507;3698;11634;2726;9546;451;1831;439;1178;890;3009
316045;201507;2079;6477;1892;6161;293;928;1306;4394;1599;5322
316050;201507;344;1089;270;970;56;226;135;451;191;677
316060;201507;736;2166;584;1942;89;399;333;1024;422;1423
316070;201507;5870;18588;5043;16712;1166;4350;2050;6424;3216;10774
316080;201507;727;2641;645;2433;139;594;94;347;233;941
316090;201507;593;1764;387;1309;78;299;91;258;169;557
316095;201507;1426;4557;1227;4200;250;864;710;2464;960;3328
316100;201507;2780;9194;2055;7349;511;2085;372;1191;883;3276
316105;201507;956;2659;716;2264;193;658;268;851;461;1509
316110;201507;12123;41581;10801;39253;1381;5465;7156;26608;8537;32073
316120;201507;1125;3658;904;3096;228;851;259;787;487;1638
316130;201507;1433;3178;872;2394;127;402;443;1160;570;1562
316140;201507;951;2781;734;2416;100;340;418;1401;518;1741
316150;201507;1446;4052;1306;3812;243;819;741;2145;984;2964
316160;201507;1235;3677;952;3119;158;602;439;1411;597;2013
316165;201507;927;2503;778;2292;145;504;428;1231;573;1735
316170;201507;1380;3964;1033;3375;172;639;435;1308;607;1947
316180;201507;1346;4214;930;3283;211;842;184;552;395;1394
316190;201507;2786;8650;1407;4937;271;984;185;549;456;1533
316200;201507;3911;12469;3017;10680;705;2897;820;2762;1525;5659
316210;201507;4742;15010;4009;13611;1584;5692;665;2122;2249;7814
316220;201507;776;2395;546;1936;115;479;67;241;182;720
316225;201507;1173;3327;1006;3065;132;478;667;1964;799;2442
316230;201507;443;1236;338;1058;57;200;173;568;230;768
316240;201507;6483;20005;5649;18894;611;2062;4180;14149;4791;16211
316245;201507;3143;10949;2915;10568;229;1108;2248;7947;2477;9055
316250;201507;9759;28987;7895;25230;2266;7879;2191;6621;4457;14500
316255;201507;2508;7680;2206;7298;410;1458;1410;4643;1820;6101
316257;201507;1334;3731;1018;3154;204;713;387;1125;591;1838
316260;201507;1760;5011;1364;4424;120;443;806;2736;926;3179
316265;201507;1321;3675;962;2957;106;409;556;1627;662;2036
316270;201507;4153;13803;3799;13073;976;3626;1663;5593;2639;9219
316280;201507;3259;10562;2921;9905;496;1893;1599;5335;2095;7228
316290;201507;3247;10158;2746;9184;548;2170;1147;3606;1695;5776
316292;201507;3297;10599;2944;9976;650;2460;1495;4822;2145;7282
316294;201507;872;2791;609;2194;132;569;54;171;186;740
316295;201507;1749;5894;1608;5614;265;1150;949;3114;1214;4264
316300;201507;1002;3087;843;2821;71;251;555;1875;626;2126
316310;201507;667;1942;447;1518;86;339;139;449;225;788
316320;201507;608;1936;485;1724;81;341;104;349;185;690
316330;201507;932;2862;724;2391;91;334;451;1452;542;1786
316340;201507;950;3045;783;2702;195;804;311;979;506;1783
316350;201507;1308;4170;1174;3945;197;672;673;2325;870;2997
316360;201507;718;1879;563;1651;61;190;405;1191;466;1381
316370;201507;4298;13949;3691;12694;1035;3885;646;2219;1681;6104
316380;201507;1562;4200;1245;3755;104;350;875;2649;979;2999
316390;201507;879;2603;727;2338;199;705;301;977;500;1682
316400;201507;1251;3946;1001;3477;216;805;414;1393;630;2198
316410;201507;1057;3520;978;3397;201;742;601;2085;802;2827
316420;201507;1832;6093;1652;5849;162;726;1133;3885;1295;4611
316430;201507;921;2800;687;2332;174;643;178;541;352;1184
316440;201507;667;2179;552;1993;206;860;119;409;325;1269
316443;201507;694;2033;565;1787;129;451;212;631;341;1082
316447;201507;1583;4813;1441;4616;88;276;1259;4072;1347;4348
316450;201507;2096;7097;1802;6516;260;1036;1144;4185;1404;5221
316460;201507;720;2225;653;2107;159;574;370;1134;529;1708
316470;201507;7318;23536;5715;20056;1435;5870;1653;5484;3088;11354
316480;201507;194;658;174;620;42;161;59;197;101;358
316490;201507;282;872;245;779;53;179;101;295;154;474
316500;201507;1114;4012;756;2905;134;555;37;128;171;683
316510;201507;797;2915;701;2713;236;960;175;653;411;1613
316520;201507;1141;3437;936;3132;175;657;340;1014;515;1671
316530;201507;1086;3494;902;3119;202;861;336;980;538;1841
316540;201507;886;2825;793;2673;168;689;309;960;477;1649
316550;201507;1161;3878;1080;3736;217;865;669;2285;886;3150
316553;201507;1813;6287;1419;5351;417;1732;332;1227;749;2959
316555;201507;2782;9585;2463;9192;191;761;1800;6788;1991;7549
316556;201507;598;1596;473;1381;48;172;324;894;372;1066
316557;201507;743;2696;708;2641;289;1150;154;524;443;1674
316560;201507;329;1133;280;1030;67;309;63;191;130;500
316570;201507;1263;4015;1092;3665;141;513;566;1902;707;2415
316580;201507;286;831;193;633;48;185;56;170;104;355
316590;201507;1487;4052;1071;3357;270;884;459;1336;729;2220
316600;201507;1012;3256;888;3005;286;1039;260;841;546;1880
316610;201507;575;2078;500;1925;98;436;303;1145;401;1581
316620;201507;2097;6494;1787;5910;329;1269;1032;3310;1361;4579
316630;201507;1452;4799;1235;4329;513;1909;329;1154;842;3063
316640;201507;181;574;157;523;34;145;65;179;99;324
316650;201507;888;3289;780;3114;149;602;454;1891;603;2493
316660;201507;202;524;98;299;10;43;26;60;36;103
316670;201507;1826;5273;1462;4609;553;1904;303;852;856;2756
316680;201507;1885;5107;1525;4595;234;748;1049;3143;1283;3891
316690;201507;1168;3910;1037;3619;295;1178;352;1179;647;2357
316695;201507;1080;3411;936;3122;93;337;608;2027;701;2364
316700;201507;339;1063;304;1001;51;222;175;513;226;735
316710;201507;3104;11631;2685;10699;932;3955;701;2933;1633;6888
316720;201507;15576;49950;12651;43568;3683;13564;2726;9019;6409;22583
316730;201507;364;1123;309;1009;72;268;147;437;219;705
316740;201507;654;2200;577;2057;182;747;209;690;391;1437
316750;201507;412;1387;352;1251;73;308;115;370;188;678
316760;201507;3328;11219;2878;10651;1615;6075;818;3150;2433;9225
316770;201507;1217;3499;1107;3354;133;482;821;2455;954;2937
316780;201507;570;1905;497;1761;142;570;109;337;251;907
316790;201507;852;2422;616;2012;153;560;199;634;352;1194
316800;201507;5288;17400;4696;16252;915;3613;2325;7592;3240;11205
316805;201507;821;2193;776;2135;73;199;659;1866;732;2065
316810;201507;608;1852;505;1644;144;513;199;611;343;1124
316820;201507;385;1003;226;727;47;172;38;108;85;280
316830;201507;593;2015;563;1956;165;635;236;789;401;1424
316840;201507;2884;8788;2523;8103;621;2293;1024;3105;1645;5398
316850;201507;2038;6080;1740;5545;269;977;980;3109;1249;4086
316860;201507;17378;55013;14843;50201;3493;13666;6349;20400;9842;34066
316870;201507;5814;18729;4700;16114;1411;5319;791;2551;2202;7870
316880;201507;786;2484;713;2359;206;786;260;803;466;1589
316890;201507;1269;3147;1013;2814;314;1018;519;1338;833;2356
316900;201507;2480;7540;1973;6454;457;1690;623;1819;1080;3509
316905;201507;453;1511;392;1378;129;478;131;456;260;934
316910;201507;764;2464;556;2039;161;618;104;392;265;1010
316920;201507;1485;4226;1153;3757;314;1153;410;1275;724;2428
316930;201507;8551;28947;6736;24814;1538;6291;977;3260;2515;9551
316935;201507;5050;14688;3255;10991;850;3253;576;1723;1426;4976
316940;201507;6990;22849;5686;20003;1351;5110;1269;4252;2620;9362
316950;201507;1452;4195;1271;3937;121;458;899;2757;1020;3215
316960;201507;4888;12288;3846;10926;714;2212;2153;6026;2867;8238
316970;201507;3223;10273;3027;9956;789;2981;1102;3343;1891;6324
316980;201507;1042;3138;755;2632;275;1079;171;589;446;1668
316990;201507;9477;30477;7918;26815;2604;9586;741;2350;3345;11936
317000;201507;2734;9363;2632;9248;217;723;2047;7977;2264;8700
317005;201507;2547;7860;2263;7439;444;1473;1312;4371;1756;5844
317010;201507;30498;76007;18464;56666;4635;16052;4119;13087;8754;29139
317020;201507;56901;158921;34051;111294;7344;26458;7356;22116;14700;48574
317030;201507;769;2202;631;1983;76;303;387;1173;463;1476
317040;201507;10106;29427;8092;25753;2114;7330;3119;9818;5233;17148
317043;201507;732;2048;633;1919;85;244;424;1314;509;1558
317047;201507;1143;3011;823;2476;127;432;387;1150;514;1582
317050;201507;1507;5155;1179;4362;235;962;483;1670;718;2632
317052;201507;2312;7450;2110;7132;181;718;1554;5185;1735;5903
317057;201507;1733;4844;1315;4108;142;543;751;2277;893;2820
317060;201507;400;1165;283;896;58;224;87;230;145;454
317065;201507;1218;4063;1114;3887;128;551;812;2759;940;3310
317070;201507;9580;29702;6392;22409;1392;5496;1044;3564;2436;9060
317075;201507;1069;3228;873;2836;227;802;261;782;488;1584
317080;201507;5919;16374;5019;14827;1449;4513;1658;4708;3107;9221
317090;201507;4852;16106;4493;15506;639;2227;3088;10838;3727;13065
317100;201507;2951;8242;2283;7093;710;2410;810;2384;1520;4794
317103;201507;2012;6923;1688;6261;295;1389;802;2854;1097;4243
317107;201507;1308;3991;1112;3580;193;744;675;2035;868;2779
317110;201507;634;1641;380;1177;72;274;148;438;220;712
317115;201507;1138;3597;972;3250;139;467;625;2121;764;2588
317120;201507;10849;35651;8701;30534;2136;8320;3105;10524;5241;18844
317130;201507;7448;22396;6290;20291;1323;4859;2802;8861;4125;13720
317140;201507;541;1810;520;1781;52;192;404;1418;456;1610
317150;201507;985;2753;853;2600;94;324;605;1807;699;2131
317160;201507;3458;9252;2648;8176;234;796;1840;5654;2074;6450
317170;201507;1798;4988;1481;4488;80;333;946;2686;1026;3019
317180;201507;1788;5952;1412;5126;386;1526;367;1258;753;2784
317190;201507;1378;3946;1109;3574;124;437;748;2373;872;2810
317200;201507;4369;13678;3760;12440;944;3440;1249;3948;2193;7388
317210;201507;1042;3147;856;2888;180;731;454;1503;634;2234
317220;201507;291;1026;279;1011;82;316;149;540;231;856
320010;201507;4981;15765;4355;14385;793;2759;2272;7478;3065;10237
320013;201507;1922;5779;1375;4633;212;735;628;2182;840;2917
320016;201507;3164;8994;2758;8393;381;1118;1919;5888;2300;7006
320020;201507;3777;11725;3215;10581;955;3436;1123;3646;2078;7082
320030;201507;1640;5248;1304;4492;407;1485;420;1394;827;2879
320035;201507;1738;5157;1537;4855;406;1445;784;2340;1190;3785
320040;201507;3241;10558;2582;9055;606;2356;733;2456;1339;4812
320050;201507;1766;4767;1493;4265;332;1023;669;1788;1001;2811
320060;201507;12013;37848;9135;31186;2209;8294;2744;8769;4953;17063
320070;201507;1462;4694;1178;4024;273;1044;303;905;576;1949
320080;201507;5324;15110;4004;12450;1123;3695;1035;3178;2158;6873
320090;201507;8214;23962;6453;20382;1767;5976;2521;7595;4288;13571
320100;201507;2961;9011;2368;7803;568;1997;975;3112;1543;5109
320110;201507;1254;3731;1107;3446;258;832;402;1238;660;2070
320115;201507;1805;6396;1629;6059;846;3301;440;1645;1286;4946
320120;201507;15800;48425;12313;41541;3347;12355;3607;12141;6954;24496
320130;201507;35860;115050;32433;107996;7171;26666;15224;48886;22395;75552
320140;201507;3995;12571;2769;9686;673;2613;285;914;958;3527
320150;201507;16642;45729;11771;36385;2937;9860;1900;5581;4837;15441
320160;201507;4687;14869;4081;13569;1044;3956;1392;4187;2436;8143
320170;201507;1719;5515;1386;4766;395;1442;493;1691;888;3133
320180;201507;797;2596;691;2417;278;1018;189;677;467;1695
320190;201507;3783;12906;2966;10855;845;3295;743;2613;1588;5908
320200;201507;1068;3334;900;3029;230;829;354;1224;584;2053
320210;201507;4832;13474;4151;12194;888;2975;2063;5665;2951;8640
320220;201507;2546;7840;2069;6905;544;1982;804;2697;1348;4679
320225;201507;1430;4872;1132;4138;392;1543;220;813;612;2356
320230;201507;4191;13639;3651;12714;1211;4548;1274;4470;2485;9018
320240;201507;11945;35227;9240;30167;2569;9148;2376;7616;4945;16764
320245;201507;3674;12477;3386;11774;1126;4197;1013;3351;2139;7548
320250;201507;1785;5435;1257;4210;335;1288;258;737;593;2025
320255;201507;1796;6012;1545;5577;617;2431;569;2112;1186;4543
320260;201507;1057;3254;800;2628;209;753;201;545;410;1298
320265;201507;2374;7409;2072;6998;364;1276;1346;4672;1710;5948
320270;201507;2710;8101;2003;6674;474;1726;818;2678;1292;4404
320280;201507;6675;20294;5901;18758;1330;4695;2574;7770;3904;12465
320290;201507;1464;4774;1071;3780;355;1310;192;648;547;1958
320300;201507;4268;14169;3774;13065;1174;4307;968;3293;2142;7600
320305;201507;4412;14197;3834;12867;923;3406;1713;5503;2636;8909
320310;201507;1966;5858;1676;5280;438;1469;677;2054;1115;3523
320313;201507;2218;6503;1509;4859;375;1426;273;747;648;2173
320316;201507;1741;5254;1421;4591;450;1531;541;1664;991;3195
320320;201507;19676;60934;15883;53652;4425;16460;5445;17879;9870;34339
320330;201507;3050;9026;2607;8283;611;1890;1326;4437;1937;6327
320332;201507;4845;16209;4232;15030;1499;5665;1358;4865;2857;10530
320334;201507;1850;5985;1308;4751;387;1563;234;797;621;2360
320335;201507;2320;6833;1487;4926;406;1509;225;628;631;2137
320340;201507;5860;15915;4720;13970;1061;3409;2030;6016;3091;9425
320350;201507;5096;13639;3803;11258;878;2791;1460;4246;2338;7037
320360;201507;1747;4601;1262;3635;229;719;536;1415;765;2134
320370;201507;3209;10369;2592;8990;776;2783;865;2952;1641;5735
320380;201507;2372;6939;2083;6429;311;1093;1327;4010;1638;5103
320390;201507;7659;22904;6110;19606;1793;6308;1649;4921;3442;11229
320400;201507;3697;11167;3247;10391;985;3533;1207;3551;2192;7084
320405;201507;3898;11419;3443;10735;903;3020;1707;5126;2610;8146
320410;201507;5548;14406;4058;12492;989;3303;1934;5882;2923;9185
320420;201507;1833;5614;1350;4736;401;1539;271;942;672;2481
320425;201507;1941;5193;1662;4728;228;710;1018;2814;1246;3524
320430;201507;2277;6449;1988;5876;420;1330;1074;3079;1494;4409
320435;201507;2725;9088;2306;8206;1069;3968;648;2427;1717;6395
320440;201507;1139;3772;995;3385;254;974;355;1120;609;2094
320450;201507;2023;6296;1645;5510;466;1742;693;2213;1159;3955
320455;201507;4213;13962;3033;11010;898;3484;761;2711;1659;6195
320460;201507;2784;8909;2188;7567;568;2152;702;2273;1270;4425
320465;201507;1607;5003;1226;4122;264;966;496;1607;760;2573
320470;201507;4312;13020;2890;9736;813;3017;464;1409;1277;4426
320480;201507;1946;5885;1655;5328;416;1496;623;1904;1039;3400
320490;201507;15593;48144;12823;42759;4022;14636;3654;12117;7676;26753
320495;201507;1237;3789;879;2981;332;1164;116;430;448;1594
320500;201507;45493;137836;39191;126134;10053;35228;18115;56839;28168;92067
320501;201507;4057;12786;3519;11946;1079;4153;1379;4452;2458;8605
320503;201507;1927;6484;1548;5645;594;2373;413;1310;1007;3683
320506;201507;3794;11846;2569;8791;809;2963;206;609;1015;3572
320510;201507;7995;24969;6781;22504;1749;6311;2957;9558;4706;15869
320515;201507;1970;5592;1612;4838;437;1360;413;1162;850;2522
320517;201507;2146;6884;1713;5979;613;2350;357;1131;970;3481
320520;201507;35691;107725;28776;94462;7935;28734;10531;34117;18466;62851
320530;201507;26905;81644;22205;72319;4848;18339;10431;31634;15279;49973
330010;201507;19641;59943;17664;56044;3367;11787;10163;31382;13530;43169
330015;201507;1695;4671;1459;4235;242;836;630;1749;872;2585
330020;201507;16737;49368;15258;46960;3079;10454;8891;26740;11970;37194
330022;201507;1757;5333;1501;4899;265;1023;799;2488;1064;3511
330023;201507;3231;10036;2846;9344;780;2792;986;3075;1766;5867
330025;201507;4021;10978;3283;9828;772;2546;1755;5110;2527;7656
330030;201507;7745;25919;6781;23914;1533;6012;3176;10701;4709;16713
330040;201507;11889;34509;10224;31505;2360;7782;5074;15169;7434;22951
330045;201507;66255;184898;58388;173260;7516;24066;39976;116882;47492;140948
330050;201507;2546;7901;2240;7289;673;2452;682;2036;1355;4488
330060;201507;5648;16450;4927;15360;1138;4001;2540;7849;3678;11850
330070;201507;22493;67920;19865;63268;4477;15460;9321;29462;13798;44922
330080;201507;7827;22356;7316;21561;949;2759;5121;15336;6070;18095
330090;201507;2646;7253;2401;6843;462;1480;1315;3640;1777;5120
330093;201507;2020;5977;1659;5283;398;1324;595;1909;993;3233
330095;201507;1006;3418;880;3131;256;1044;190;611;446;1655
330100;201507;54022;172708;48943;163871;8945;33598;25887;86600;34832;120198
330110;201507;2329;7392;2077;6919;536;1937;667;2169;1203;4106
330115;201507;2020;5815;1794;5451;352;1203;940;2773;1292;3976
330120;201507;2439;6873;2150;6442;542;1810;1076;3070;1618;4880
330130;201507;3506;11240;3076;10456;801;2994;1414;4688;2215;7682
330140;201507;2911;9107;2642;8695;627;2222;1304;4310;1931;6532
330150;201507;2383;6969;1802;5782;407;1445;438;1356;845;2801
330160;201507;1070;3555;971;3377;291;1142;417;1375;708;2517
330170;201507;100910;302680;92632;289473;14892;49790;59660;185428;74552;235218
330180;201507;1925;5731;1628;5169;167;678;1024;3064;1191;3742
330185;201507;7657;24095;6709;22223;1525;5508;3510;11404;5035;16912
330187;201507;3846;11003;3292;10061;468;1626;2212;6650;2680;8276
330190;201507;25432;72705;23584;69706;4558;14242;15174;44503;19732;58745
330200;201507;13462;42821;11989;40097;2963;10286;5904;19923;8867;30209
330205;201507;2233;6043;1925;5516;368;1187;1044;2880;1412;4067
330210;201507;4283;11370;3192;9336;890;2766;730;2095;1620;4861
330220;201507;9923;30284;8652;27551;2365;8207;2423;7118;4788;15325
330225;201507;3908;12037;3579;11496;430;1635;2375;7614;2805;9249
330227;201507;17515;50268;15647;47455;4144;13019;7958;24356;12102;37375
330230;201507;1394;4154;1257;3917;310;1090;536;1569;846;2659
330240;201507;16287;50895;14104;46400;4952;17692;3029;9395;7981;27087
330245;201507;1254;3905;991;3376;256;956;194;632;450;1588
330250;201507;35516;103633;32234;98054;9725;30046;13537;42007;23262;72053
330260;201507;3606;11290;3122;10279;636;2339;1335;4127;1971;6466
330270;201507;14686;38774;11167;33629;3015;9871;4123;12280;7138;22151
330280;201507;2095;6308;1735;5571;310;1107;787;2327;1097;3434
330285;201507;18133;52136;16342;49504;2789;9126;10276;30934;13065;40060
330290;201507;3535;9826;3097;9177;518;1773;1867;5276;2385;7049
330300;201507;3333;10786;3057;10293;429;1681;1896;6270;2325;7951
330310;201507;2340;6694;2029;6161;359;1161;1086;3224;1445;4385
330320;201507;12983;38762;12119;37444;1790;6080;8778;26867;10568;32947
330330;201507;26727;75015;23894;70490;4072;13619;15109;43129;19181;56748
330340;201507;14081;41453;10962;35464;2992;10291;3230;10310;6222;20601
330350;201507;83558;253761;78315;245891;11373;37089;56685;178530;68058;215619
330360;201507;5556;16798;5368;16525;361;1237;4527;13858;4888;15095
330370;201507;3390;12063;3073;11343;1076;4137;1021;3799;2097;7936
330380;201507;4862;15612;4092;14105;924;3523;1764;5862;2688;9385
330385;201507;4070;13984;3709;13258;1182;4542;1367;4817;2549;9359
330390;201507;22519;73985;19976;68784;4773;18103;9247;31113;14020;49216
330395;201507;2945;8714;2667;8233;278;1040;1812;5415;2090;6455
330400;201507;2439;7792;2181;7324;331;1335;1258;3921;1589;5256
330410;201507;2781;8626;2331;7749;460;1659;1155;3792;1615;5451
330411;201507;2293;7109;1972;6414;256;1033;1137;3483;1393;4516
330412;201507;1304;4431;1065;3954;246;1061;408;1396;654;2457
330414;201507;24623;69272;21400;64739;3920;12033;13303;40494;17223;52527
330415;201507;3538;10779;3043;9874;790;2688;1234;3996;2024;6684
330420;201507;9243;27138;6231;21257;1534;5675;1087;3596;2621;9271
330430;201507;7498;22158;6672;20604;1437;4812;3280;9893;4717;14705
330440;201507;1788;5952;1503;5320;466;1838;303;928;769;2766
330450;201507;1390;4613;1252;4372;307;1282;644;2169;951;3451
330452;201507;12980;38253;10161;32635;2679;9484;3618;11064;6297;20548
330455;201507;472757;1322383;391931;1192671;95123;307202;189958;572217;285081;879419
330460;201507;1200;3893;1073;3662;223;873;518;1731;741;2604
330470;201507;4268;13025;3781;12111;981;3475;1637;5069;2618;8544
330475;201507;7779;24193;6864;22577;1947;7020;2707;8693;4654;15713
330480;201507;5792;17116;5279;16344;1138;3827;2851;8678;3989;12505
330490;201507;104135;278532;94363;264317;9041;26044;73329;206771;82370;232815
330500;201507;5404;16785;5137;16286;592;2105;3679;11524;4271;13629
330510;201507;36877;114179;33376;108468;9994;32990;15714;51974;25708;84964
330513;201507;1508;4511;1362;4242;417;1293;512;1631;929;2924
330515;201507;2969;9211;2624;8557;800;2702;881;2827;1681;5529
330520;201507;11508;34167;10198;31833;2192;7288;5038;15532;7230;22820
330530;201507;1510;4521;1329;4171;339;1124;535;1635;874;2759
330540;201507;3026;8949;2545;8107;616;2141;1091;3356;1707;5497
330550;201507;7907;26486;6942;24621;3046;11287;1248;4393;4294;15680
330555;201507;10260;30347;9088;28637;1699;5472;5648;18194;7347;23666
330560;201507;4144;12553;3771;11856;784;2743;1929;5853;2713;8596
330570;201507;3598;10430;3061;9520;796;2569;1499;4682;2295;7251
330575;201507;5134;14840;4585;13872;781;2656;2875;8338;3656;10994
330580;201507;14439;45359;12258;40846;3285;11589;4908;16389;8193;27978
330590;201507;1646;5014;1522;4798;313;1071;914;2817;1227;3888
330600;201507;10626;30135;8410;26512;1193;4350;4575;14041;5768;18391
330610;201507;8862;27900;8070;26429;1530;5740;4482;14344;6012;20084
330615;201507;1659;5830;1491;5437;655;2528;335;1247;990;3775
330620;201507;3573;12282;3196;11573;1100;4339;821;3008;1921;7347
330630;201507;21842;64906;17879;57716;3478;12866;9301;28658;12779;41524
350010;201507;2005;5919;1360;4593;330;1225;247;715;577;1940
350020;201507;464;1204;312;911;55;177;168;470;223;647
350030;201507;4340;13489;3375;11464;1209;4521;716;2188;1925;6709
350040;201507;486;1660;374;1395;91;387;94;297;185;684
350050;201507;1041;3129;817;2719;190;733;283;854;473;1587
350055;201507;601;1801;535;1685;119;416;300;905;419;1321
350060;201507;94;297;78;268;24;94;32;102;56;196
350070;201507;3247;10091;2187;7714;486;1879;395;1207;881;3086
350075;201507;508;1691;406;1513;118;469;101;353;219;822
350080;201507;534;1484;372;1172;68;236;149;455;217;691
350090;201507;529;1398;361;1115;73;248;121;348;194;596
350100;201507;1796;5651;1267;4500;294;1153;346;1137;640;2290
350110;201507;458;1342;340;1074;51;189;166;498;217;687
350115;201507;1264;3887;1109;3532;230;866;562;1608;792;2474
350120;201507;567;1487;276;847;55;179;48;133;103;312
350130;201507;3206;9407;2838;8695;486;1697;1486;4256;1972;5953
350140;201507;579;1860;501;1722;92;359;224;732;316;1091
350150;201507;378;1277;335;1183;121;451;86;298;207;749
350160;201507;6766;20618;4957;16736;1315;4990;1935;5930;3250;10920
350170;201507;1711;5880;1472;5298;404;1591;356;1188;760;2779
350180;201507;1100;2992;760;2267;160;493;335;969;495;1462
350190;201507;3054;9486;2512;8389;521;2099;1291;3914;1812;6013
350200;201507;320;1019;273;938;51;194;121;411;172;605
350210;201507;5127;13567;3796;11355;1076;3600;1508;4264;2584;7864
350220;201507;2460;7712;2190;7225;575;2251;833;2469;1408;4720
350230;201507;608;2004;554;1907;128;496;239;802;367;1298
350240;201507;375;1176;340;1103;71;239;206;654;277;893
350250;201507;2091;7593;1972;7357;713;2873;699;2539;1412;5412
350260;201507;938;2487;661;2001;119;389;297;869;416;1258
350270;201507;5006;15255;4196;13470;791;2723;1813;5620;2604;8343
350275;201507;1944;6489;1742;6118;474;1792;643;2126;1117;3918
350280;201507;21096;52629;12903;38192;2840;8993;2721;7938;5561;16931
350290;201507;1615;5264;1263;4525;291;1157;304;1017;595;2174
350300;201507;346;1031;303;958;54;175;180;565;234;740
350310;201507;848;2771;738;2511;121;464;341;1118;462;1582
350315;201507;525;1640;411;1395;69;290;124;382;193;672
350320;201507;11283;34987;9708;31853;2704;9491;1471;4879;4175;14370
350330;201507;13285;37816;8648;26928;1844;5775;2805;8264;4649;14039
350335;201507;352;1099;306;1006;42;136;179;596;221;732
350340;201507;1100;3271;767;2599;156;605;249;781;405;1386
350350;201507;732;2288;628;2113;121;499;245;795;366;1294
350360;201507;765;2590;641;2323;178;680;226;836;404;1516
350370;201507;689;2051;489;1610;92;335;94;271;186;606
350380;201507;3282;10134;2530;8849;861;3320;616;1949;1477;5269
350390;201507;8408;26405;7451;24580;2182;7539;2982;9604;5164;17143
350395;201507;331;938;177;618;32;130;37;121;69;251
350400;201507;7747;21980;6148;19052;1420;4951;2485;7292;3905;12243
350410;201507;7617;25839;5914;22086;1650;6863;1089;3776;2739;10639
350420;201507;545;1562;372;1251;71;288;39;97;110;385
350430;201507;727;2257;594;2008;122;479;286;916;408;1395
350440;201507;1212;3780;1101;3567;289;971;533;1691;822;2662
350450;201507;7525;22374;5734;18768;1401;4949;1398;4265;2799;9214
350460;201507;1313;3658;860;2709;181;631;260;731;441;1362
350470;201507;241;658;193;576;40;144;107;291;147;435
350480;201507;790;2406;527;1807;78;300;78;216;156;516
350490;201507;1731;5169;1479;4797;371;1364;614;1842;985;3206
350500;201507;561;1638;482;1509;109;362;218;672;327;1034
350510;201507;998;3050;774;2548;142;551;303;904;445;1455
350520;201507;1024;3763;815;3296;227;1024;152;557;379;1581
350530;201507;2357;6929;1908;5993;570;1914;532;1513;1102;3427
350535;201507;1330;4115;1236;3926;119;489;915;2778;1034;3267
350540;201507;1910;5309;1515;4597;414;1328;511;1537;925;2865
350550;201507;11516;30599;7763;24271;1625;5742;2835;8454;4460;14196
350560;201507;3351;10992;3004;10265;458;1693;1593;5484;2051;7177
350570;201507;17903;60053;16006;55821;4748;17842;5940;19763;10688;37605
350580;201507;1644;5071;1152;3931;247;933;160;451;407;1384
350590;201507;4059;12538;3025;10394;803;3115;987;3036;1790;6151
350600;201507;39388;96382;25913;73790;4128;12842;12600;34096;16728;46938
350610;201507;7592;21676;5798;18509;1162;4192;2593;7950;3755;12142
350620;201507;389;1091;299;956;59;229;141;415;200;644
350630;201507;1597;4734;1232;4046;291;1115;327;944;618;2059
350635;201507;5613;16914;4255;14377;1055;3836;1611;5365;2666;9201
350640;201507;689;2161;482;1641;88;335;118;369;206;704
350650;201507;7073;21563;3919;13787;971;3756;390;1324;1361;5080
350660;201507;4118;12455;3546;11487;750;2647;1925;6138;2675;8785
350670;201507;1704;5255;1575;4999;298;1019;962;2950;1260;3969
350680;201507;1102;3354;854;2844;194;755;364;1176;558;1931
350690;201507;857;2794;691;2461;162;657;218;700;380;1357
350700;201507;3585;11039;2579;9068;876;3305;718;2272;1594;5577
350710;201507;2433;7628;2172;7193;324;1176;1381;4519;1705;5695
350715;201507;842;2581;742;2402;231;841;247;693;478;1534
350720;201507;134;397;120;373;34;117;44;124;78;241
350730;201507;388;1441;368;1388;103;438;138;497;241;935
350740;201507;1901;5883;1493;4920;279;1016;588;1797;867;2813
350745;201507;361;1116;269;895;45;168;122;364;167;532
350750;201507;9940;29790;7571;24996;1815;6609;1724;5216;3539;11825
350760;201507;12139;36334;10087;32502;2579;9239;3839;11528;6418;20767
350770;201507;724;2046;479;1557;70;263;218;677;288;940
350775;201507;516;1423;429;1283;65;229;259;755;324;984
350780;201507;1977;6007;1474;4957;430;1605;203;636;633;2241
350790;201507;1963;6130;1461;5105;382;1447;329;1016;711;2463
350800;201507;2974;9856;2793;9552;470;1871;1774;5934;2244;7805
350810;201507;1903;5403;1578;4914;471;1602;576;1745;1047;3347
350820;201507;558;1501;402;1190;74;264;167;439;241;703
350830;201507;867;2676;592;2027;85;315;143;393;228;708
350840;201507;2401;8447;1958;7344;578;2387;346;1085;924;3472
350850;201507;6059;20037;4990;17635;1600;5983;1127;3851;2727;9834
350860;201507;3082;9645;2947;9443;250;997;2332;7372;2582;8369
350870;201507;2550;8187;2159;7574;575;2276;1214;4250;1789;6526
350880;201507;1270;4154;1043;3674;257;978;236;796;493;1774
350890;201507;638;1803;422;1340;70;265;99;244;169;509
350900;201507;3779;12364;2881;10285;743;2918;427;1365;1170;4283
350910;201507;810;2402;708;2199;244;798;245;716;489;1514
350920;201507;9643;27837;8656;26070;1216;4057;5812;16904;7028;20961
350925;201507;4691;14319;3893;12693;982;3437;1548;4621;2530;8058
350930;201507;1581;4286;1273;3745;138;455;850;2422;988;2877
350940;201507;1915;6288;1749;6038;321;1317;1094;3665;1415;4982
350945;201507;822;2697;710;2458;128;531;359;1166;487;1697
350950;201507;65357;199471;52271;172300;12714;45959;21129;66416;33843;112375
350960;201507;4200;14034;3539;12630;587;2417;2037;6974;2624;9391
350970;201507;4277;14739;3596;13106;1151;4557;847;2739;1998;7296
350980;201507;584;1910;524;1806;215;786;184;636;399;1422
350990;201507;1702;5808;1450;5315;459;1805;394;1391;853;3196
350995;201507;761;2616;727;2545;115;519;447;1480;562;1999
351000;201507;3197;9480;2646;8430;341;1242;1376;4156;1717;5398
351010;201507;352;1000;224;725;58;210;76;244;134;454
351015;201507;844;2799;722;2566;192;769;309;1049;501;1818
351020;201507;7783;24548;6772;22963;1687;6069;3122;10643;4809;16712
351030;201507;1562;5584;1402;5200;333;1435;480;1640;813;3075
351040;201507;3247;9860;2957;9350;484;1783;1888;5714;2372;7497
351050;201507;11795;35143;8584;29097;2357;8761;2506;8289;4863;17050
351060;201507;31821;94792;25896;83666;6042;21383;11005;34501;17047;55884
351070;201507;1565;4336;1062;3427;313;1132;168;430;481;1562
351080;201507;2593;7468;1983;6708;477;1808;928;2998;1405;4806
351090;201507;378;1265;282;1052;57;244;59;213;116;457
351100;201507;1902;5835;1534;5101;466;1597;510;1753;976;3350
351110;201507;7678;19173;4080;13018;927;3353;943;2710;1870;6063
351120;201507;608;1744;489;1507;64;227;253;686;317;913
351130;201507;1005;2802;540;1844;89;351;99;306;188;657
351140;201507;1582;5452;1404;5051;434;1723;394;1325;828;3048
351150;201507;1701;5840;1259;4674;225;925;278;884;503;1809
351160;201507;1288;4347;1133;3990;299;1191;400;1310;699;2501
351170;201507;1450;4604;1152;3944;235;874;508;1641;743;2515
351190;201507;705;2232;566;1879;116;392;124;380;240;772
351200;201507;2110;6147;1733;5384;352;1240;618;1726;970;2966
351210;201507;998;3001;758;2498;172;640;262;769;434;1409
351220;201507;3227;10758;2849;9977;592;2304;1353;4637;1945;6941
351230;201507;1724;5368;1461;4893;291;1171;794;2541;1085;3712
351240;201507;1078;3432;788;2764;205;786;176;522;381;1308
351250;201507;878;2495;604;1931;130;455;222;662;352;1117
351260;201507;864;2506;747;2267;169;563;333;941;502;1504
351270;201507;350;1193;316;1128;74;312;136;432;210;744
351280;201507;5053;14806;3718;11940;841;2896;1275;3761;2116;6657
351290;201507;982;2767;734;2284;168;544;303;898;471;1442
351300;201507;11900;39320;8870;32611;2281;9276;2764;9894;5045;19170
351310;201507;3157;9555;2539;8422;482;1890;1217;3695;1699;5585
351320;201507;868;2914;738;2613;176;722;213;647;389;1369
351330;201507;287;792;239;711;101;302;57;162;158;464
351340;201507;5633;18753;4844;17143;1369;5158;1911;6712;3280;11870
351350;201507;7062;22773;6057;20624;1800;6467;1940;6190;3740;12657
351360;201507;4090;12704;3725;11989;937;3333;1416;4260;2353;7593
351370;201507;2206;6746;1734;5771;411;1540;640;1949;1051;3489
351380;201507;34926;103574;31560;97160;6165;20767;14520;43258;20685;64025
351385;201507;184;568;171;543;41;137;86;256;127;393
351390;201507;1114;3604;933;3230;255;1000;357;1100;612;2100
351400;201507;871;2890;820;2763;324;1153;272;901;596;2054
351410;201507;2638;7920;2311;7327;387;1297;1332;4100;1719;5397
351420;201507;354;1001;227;748;48;167;61;191;109;358
351430;201507;840;2595;765;2468;79;261;550;1775;629;2036
351440;201507;3664;10703;2785;8761;695;2263;552;1512;1247;3775
351450;201507;1636;4558;1359;4157;352;1126;597;1919;949;3045
351460;201507;714;2130;595;1929;291;979;170;520;461;1499
351470;201507;1022;3040;883;2770;225;804;343;1016;568;1820
351480;201507;2759;8973;2506;8547;459;1929;1330;4300;1789;6229
351490;201507;1734;5732;1527;5285;207;862;898;2959;1105;3821
351492;201507;196;616;149;507;20;83;79;257;99;340
351495;201507;137;452;110;384;27;112;37;115;64;227
351500;201507;21819;63329;16886;53885;4458;15767;6582;19996;11040;35763
351510;201507;8111;25567;6723;22724;1602;5873;3245;10777;4847;16650
351512;201507;408;1178;328;1022;53;167;191;610;244;777
351515;201507;2186;6821;1548;5388;389;1438;412;1316;801;2754
351518;201507;1984;6280;1358;5086;341;1461;367;1246;708;2707
351519;201507;772;2271;592;1879;113;446;209;512;322;958
351520;201507;816;2247;418;1471;62;252;61;199;123;451
351530;201507;370;1130;266;880;40;137;77;220;117;357
351535;201507;2263;5872;1762;5134;181;626;1150;3242;1331;3868
351540;201507;1721;5186;1395;4578;463;1674;220;664;683;2338
351550;201507;4722;13763;3353;10951;764;2847;1169;3646;1933;6493
351560;201507;357;1124;296;991;64;249;57;174;121;423
351565;201507;179;585;162;538;33;129;77;238;110;367
351570;201507;10980;33891;9366;30599;2156;7617;4940;15695;7096;23312
351580;201507;341;895;218;638;55;161;60;159;115;320
351590;201507;393;1053;292;863;32;105;114;320;146;425
351600;201507;1620;4454;1424;4151;226;747;736;2037;962;2784
351610;201507;655;1784;498;1512;58;213;237;655;295;868
351620;201507;18310;58395;13737;48871;3091;12347;3276;10174;6367;22521
351630;201507;17776;56880;16028;53922;3681;13181;8939;29811;12620;42992
351640;201507;9975;31066;8305;28068;1707;6360;4444;14719;6151;21079
351650;201507;423;1262;205;701;39;147;33;97;72;244
351660;201507;747;2340;539;1813;125;450;132;389;257;839
351670;201507;3833;11829;3122;10299;546;2086;1489;4592;2035;6678
351680;201507;651;1972;398;1350;71;251;84;270;155;521
351685;201507;415;1217;336;1085;88;284;149;494;237;778
351690;201507;1005;2943;688;2219;136;482;187;505;323;987
351700;201507;1179;3410;1018;3104;268;816;415;1235;683;2051
351710;201507;628;2028;512;1777;97;342;188;606;285;948
351720;201507;1608;4867;1091;3587;220;787;341;997;561;1784
351730;201507;1013;2883;812;2605;283;1047;282;849;565;1896
351740;201507;3977;10844;3131;9140;668;2088;1079;2988;1747;5076
351750;201507;1165;3656;817;2834;192;775;258;792;450;1567
351760;201507;3601;11235;2987;9880;804;2872;1074;3305;1878;6177
351770;201507;2277;7078;1895;6405;535;1897;820;2646;1355;4543
351780;201507;1529;4259;889;2823;164;571;226;665;390;1236
351790;201507;972;2827;842;2632;261;824;380;1224;641;2048
351800;201507;396;868;285;719;36;93;157;402;193;495
351810;201507;985;2779;893;2662;140;437;654;1960;794;2397
351820;201507;2132;6750;1672;5853;488;1792;173;579;661;2371
351830;201507;3874;12124;3025;10151;537;2042;1508;4775;2045;6817
351840;201507;7013;23166;6001;21158;1635;6241;2160;7389;3795;13630
351850;201507;1686;4814;1241;3992;201;812;562;1588;763;2400
351860;201507;3331;10579;2909;9701;792;2842;1223;3850;2015;6692
351870;201507;29102;87125;24837;79299;6495;22148;11803;37059;18298;59207
351880;201507;105416;334408;90552;303098;26679;94687;28163;91175;54842;185862
351885;201507;523;1861;485;1777;135;524;222;796;357;1320
351890;201507;654;1943;491;1597;108;394;120;347;228;741
351900;201507;1242;3770;1051;3456;283;999;337;1079;620;2078
351905;201507;438;1388;357;1241;56;239;195;628;251;867
351907;201507;16229;48285;13433;43075;2004;7530;7889;24341;9893;31871
351910;201507;900;2752;801;2586;164;605;397;1214;561;1819
351920;201507;1007;2748;883;2553;123;420;569;1594;692;2014
351925;201507;909;2790;778;2530;125;449;404;1222;529;1671
351930;201507;2568;8345;2415;8039;504;2072;1546;4762;2050;6834
351940;201507;913;2732;776;2463;168;569;390;1206;558;1775
351950;201507;1393;3822;996;3082;136;453;524;1575;660;2028
351960;201507;3823;10875;2669;8773;587;2100;1139;3670;1726;5770
351970;201507;5225;18820;4595;17529;1387;5687;1599;5940;2986;11627
351980;201507;872;2609;666;2185;145;530;249;709;394;1239
351990;201507;1516;4269;1198;3647;274;988;264;663;538;1651
352000;201507;2157;6915;1935;6451;418;1505;914;2859;1332;4364
352010;201507;1735;5792;1499;5251;382;1469;364;1214;746;2683
352020;201507;1361;4272;1173;3903;279;1032;444;1387;723;2419
352030;201507;4779;14007;3955;12775;953;3158;2038;6661;2991;9819
352040;201507;1926;6371;1577;5578;354;1393;378;1212;732;2605
352042;201507;2990;8375;1976;6132;416;1446;928;2763;1344;4209
352044;201507;1371;4575;1023;3747;206;823;156;510;362;1333
352050;201507;8115;25026;5253;18540;1320;5151;962;3022;2282;8173
352060;201507;698;2007;591;1826;132;498;258;710;390;1208
352070;201507;643;1757;565;1631;172;515;223;646;395;1161
352080;201507;416;1177;298;948;55;194;124;359;179;553
352090;201507;1638;5322;1278;4494;263;1011;274;848;537;1859
352100;201507;2416;7325;1735;6004;462;1803;538;1663;1000;3466
352110;201507;465;1625;401;1483;114;465;153;529;267;994
352115;201507;418;1318;354;1179;79;288;144;436;223;724
352120;201507;934;2853;783;2594;158;607;398;1265;556;1872
352130;201507;1837;5253;1250;4072;348;1188;354;1053;702;2241
352140;201507;1564;4672;998;3400;165;582;402;1330;567;1912
352150;201507;712;2167;545;1832;140;485;230;760;370;1245
352160;201507;999;2749;806;2390;161;523;297;779;458;1302
352170;201507;2624;7886;2350;7340;490;1692;1234;3603;1724;5295
352180;201507;3307;9393;2765;8355;673;2219;1011;2891;1684;5110
352190;201507;1094;3289;932;2949;170;653;371;994;541;1647
352200;201507;358;1233;295;1110;45;190;168;638;213;828
352210;201507;16832;44687;13279;39486;2444;7640;7717;23313;10161;30953
352215;201507;563;1748;514;1681;72;270;299;962;371;1232
352220;201507;11733;38192;10307;35270;3317;12250;3215;10731;6532;22981
352230;201507;12200;40884;10449;37533;2989;11763;3892;13562;6881;25325
352240;201507;11490;33540;8808;28700;2665;9785;2833;8474;5498;18259
352250;201507;22653;72601;19686;66459;5587;20310;6796;22578;12383;42888
352260;201507;5217;14775;3196;10553;620;2318;1121;3418;1741;5736
352265;201507;851;2725;723;2489;76;341;428;1376;504;1717
352270;201507;1866;6300;1542;5588;444;1701;402;1391;846;3092
352280;201507;2181;6601;1784;5907;464;1756;634;1981;1098;3737
352290;201507;1079;3360;929;3049;216;847;328;944;544;1791
352300;201507;906;2674;721;2330;182;636;300;898;482;1534
352310;201507;33897;102786;28618;93809;7165;24897;15728;51558;22893;76455
352320;201507;5590;17099;4789;15557;1374;4785;1514;4439;2888;9224
352330;201507;1928;6198;1649;5798;547;2047;489;1668;1036;3715
352340;201507;5333;17555;4168;14941;1144;4430;732;2372;1876;6802
352350;201507;1489;5156;1332;4812;275;1107;544;1868;819;2975
352360;201507;1061;3276;927;3016;179;730;582;1781;761;2511
352370;201507;800;2754;724;2577;124;508;357;1214;481;1722
352380;201507;964;3051;832;2815;271;1065;221;686;492;1751
352390;201507;17429;47477;11397;35733;2037;7377;5417;15723;7454;23100
352400;201507;3874;10796;2368;7816;628;2196;670;2020;1298;4216
352410;201507;2883;8603;2381;7738;631;2149;815;2555;1446;4704
352420;201507;927;2624;791;2360;209;684;364;1032;573;1716
352430;201507;6281;18786;5148;16892;1673;6063;1530;4815;3203;10878
352440;201507;15301;46414;12183;40310;3087;10924;4344;13950;7431;24874
352450;201507;670;1945;434;1485;95;361;105;316;200;677
352460;201507;2332;7585;1941;6844;581;2253;523;1668;1104;3921
352470;201507;4499;12377;2620;8447;441;1576;863;2586;1304;4162
352480;201507;4517;12240;3474;10299;661;2303;1424;3862;2085;6165
352490;201507;680;2312;541;1960;103;422;129;425;232;847
352500;201507;7497;22484;6795;21355;3209;10962;1895;5172;5104;16134
352510;201507;2928;9404;2323;8160;722;2801;570;1902;1292;4703
352520;201507;2066;7194;1810;6573;458;1793;829;2939;1287;4732
352530;201507;7685;24592;5676;20025;1575;5947;817;2531;2392;8478
352540;201507;495;1532;372;1265;60;242;90;277;150;519
352550;201507;861;2866;576;2145;142;607;100;325;242;932
352560;201507;662;1942;475;1531;85;268;162;464;247;732
352570;201507;1743;5738;1288;4659;264;1094;260;847;524;1941
352580;201507;852;2470;719;2256;153;524;377;1151;530;1675
352585;201507;212;689;165;592;58;220;33;124;91;344
352590;201507;12238;37445;9659;32204;2321;8443;4497;14301;6818;22744
352600;201507;1520;4607;1339;4271;358;1250;579;1738;937;2988
352610;201507;3245;9867;2685;8888;807;2975;786;2411;1593;5386
352620;201507;5087;15693;4710;15137;958;3387;2838;8920;3796;12307
352630;201507;603;1941;562;1833;131;509;240;711;371;1220
352640;201507;2747;8430;2223;7319;325;1229;1164;3685;1489;4914
352650;201507;827;2427;606;1951;140;479;182;539;322;1018
352660;201507;1003;3376;773;2828;151;607;179;616;330;1223
352670;201507;10139;30567;6006;21192;1481;5659;734;2373;2215;8032
352680;201507;2996;10185;2288;8471;527;2171;642;2106;1169;4277
352690;201507;28975;80221;19739;61258;3684;12477;9004;26710;12688;39187
352700;201507;702;2107;568;1892;159;597;262;830;421;1427
352710;201507;5588;16309;4149;13377;986;3580;1495;4522;2481;8102
352720;201507;7230;23330;6486;21741;1926;6579;2350;7809;4276;14388
352725;201507;397;1107;240;776;34;132;98;293;132;425
352730;201507;2205;7292;1944;6601;398;1471;696;2090;1094;3561
352740;201507;1877;5279;1488;4620;263;975;856;2502;1119;3477
352750;201507;431;1230;235;785;43;165;54;150;97;315
352760;201507;1071;3666;927;3334;279;1061;367;1248;646;2309
352770;201507;676;2084;580;1894;126;467;251;767;377;1234
352780;201507;609;1989;498;1737;100;399;162;511;262;910
352790;201507;632;1812;458;1481;93;318;98;306;191;624
352800;201507;864;3060;617;2393;147;648;162;508;309;1156
352810;201507;1133;2942;731;2166;140;471;228;639;368;1110
352820;201507;508;1465;385;1277;114;420;97;313;211;733
352830;201507;486;1365;318;1006;47;171;50;116;97;287
352840;201507;3675;12503;3211;11490;1012;3838;998;3512;2010;7350
352850;201507;8332;26017;7086;23794;1850;6691;2641;8671;4491;15362
352860;201507;789;2571;713;2395;177;640;249;776;426;1416
352870;201507;955;2367;705;1902;76;293;421;1022;497;1315
352880;201507;2285;6476;1650;5149;341;1112;533;1539;874;2651
352885;201507;215;713;203;685;27;98;125;402;152;500
352890;201507;665;1757;484;1390;68;244;236;592;304;836
352900;201507;19057;55854;13955;45354;2999;10693;5324;16400;8323;27093
352910;201507;255;790;176;608;27;104;23;67;50;171
352920;201507;2382;7080;1874;6115;454;1675;744;2189;1198;3864
352930;201507;5508;17056;4244;14218;1129;4065;977;3085;2106;7150
352940;201507;22534;73762;18722;64787;6342;23325;2765;8884;9107;32209
352950;201507;271;777;171;591;42;176;45;121;87;297
352960;201507;589;1813;373;1308;61;240;56;184;117;424
352965;201507;280;841;237;756;63;229;48;131;111;360
352970;201507;2868;7266;2294;6398;288;844;1508;4242;1796;5086
352980;201507;1208;3615;1013;3321;235;779;569;1978;804;2757
352990;201507;3903;12484;3446;11677;967;3653;1294;4138;2261;7791
353000;201507;473;1307;264;826;46;150;41;107;87;257
353010;201507;2933;8192;2154;6662;513;1787;645;1783;1158;3570
353020;201507;4223;11497;2705;8183;394;1390;1041;2779;1435;4169
353030;201507;3858;11211;3144;9884;891;3012;741;2145;1632;5157
353040;201507;626;1749;528;1590;145;492;185;520;330;1012
353050;201507;4843;16087;4015;14385;1163;4503;1460;4950;2623;9453
353060;201507;33433;103403;31117;99658;3627;14111;22722;69957;26349;84068
353070;201507;9113;29272;6645;23786;1776;6788;1656;5902;3432;12690
353080;201507;5019;16009;3423;12334;741;2946;767;2483;1508;5429
353090;201507;512;1687;460;1575;52;216;255;800;307;1016
353100;201507;230;608;114;355;25;85;26;73;51;158
353110;201507;7123;22095;6273;20599;1573;5471;3306;10902;4879;16373
353120;201507;665;1946;412;1357;97;374;112;307;209;681
353130;201507;2458;7090;1998;6360;644;2234;656;1986;1300;4220
353140;201507;2276;6138;1716;5035;439;1396;679;1845;1118;3241
353150;201507;1661;5048;1347;4494;386;1380;377;1244;763;2624
353160;201507;630;1822;426;1373;94;315;72;175;166;490
353170;201507;464;1537;417;1457;115;502;185;588;300;1090
353180;201507;7584;21823;5925;18706;935;3313;3169;9678;4104;12991
353190;201507;3504;10723;2911;9431;558;2037;1428;4301;1986;6338
353200;201507;910;3030;726;2597;219;871;194;649;413;1520
353205;201507;399;1274;346;1169;78;272;139;461;217;733
353210;201507;956;2440;716;2016;42;168;476;1292;518;1460
353215;201507;406;1285;357;1176;57;208;132;385;189;593
353220;201507;648;1996;519;1708;118;432;132;381;250;813
353230;201507;832;2660;758;2527;200;738;220;669;420;1407
353240;201507;1952;6236;1755;5847;425;1604;892;2799;1317;4403
353250;201507;1032;2772;795;2341;131;409;376;1075;507;1484
353260;201507;899;2439;669;2036;112;401;291;827;403;1228
353270;201507;627;1857;540;1687;152;516;188;541;340;1057
353280;201507;581;1865;487;1668;122;454;131;434;253;888
353282;201507;1617;5164;1518;4986;211;790;956;2987;1167;3777
353284;201507;337;923;196;624;39;127;51;165;90;292
353286;201507;143;427;100;328;16;47;14;49;30;96
353290;201507;532;1693;424;1494;91;362;223;749;314;1111
353300;201507;1398;4337;1156;3789;276;1035;417;1196;693;2231
353310;201507;197;583;168;527;47;168;66;182;113;350
353320;201507;506;1457;447;1358;77;264;250;726;327;990
353325;201507;554;1826;454;1621;83;337;82;231;165;568
353330;201507;595;1719;389;1234;74;268;183;535;257;803
353340;201507;2861;8060;1823;6024;477;1677;568;1766;1045;3443
353350;201507;3146;9404;2592;8366;776;2664;1045;3199;1821;5863
353360;201507;372;1205;325;1101;46;192;203;651;249;843
353370;201507;639;2074;550;1855;76;300;311;999;387;1299
353380;201507;323;1034;264;918;54;226;105;321;159;547
353390;201507;5802;15539;4033;12323;778;2620;1469;4118;2247;6738
353400;201507;484;1448;398;1270;105;375;108;287;213;662
353410;201507;601;1735;486;1544;100;349;269;838;369;1187
353420;201507;563;1546;396;1175;109;311;127;357;236;668
353430;201507;2146;7321;1547;5697;364;1420;186;603;550;2023
353440;201507;55990;179639;47313;159596;13021;46086;16488;53803;29509;99889
353450;201507;425;1283;355;1144;76;281;144;430;220;711
353460;201507;3453;9603;2939;8728;437;1448;1443;4330;1880;5778
353470;201507;8980;26829;6349;21379;1399;5282;1540;4739;2939;10021
353475;201507;1610;4542;1074;3362;196;651;303;852;499;1503
353480;201507;1412;4188;1245;3863;230;771;715;2160;945;2931
353490;201507;973;2721;776;2332;166;544;299;825;465;1369
353500;201507;938;2545;786;2280;244;727;328;926;572;1653
353510;201507;984;3080;753;2510;168;624;187;522;355;1146
353520;201507;1060;3088;817;2662;171;644;328;1038;499;1682
353530;201507;2433;7133;2142;6618;384;1395;1149;3407;1533;4802
353540;201507;1883;5666;1621;5225;410;1420;694;2181;1104;3601
353550;201507;5830;16021;5003;14759;563;2027;3268;9210;3831;11237
353560;201507;2095;6903;1713;6182;418;1717;509;1709;927;3426
353570;201507;408;1250;343;1115;51;175;208;642;259;817
353580;201507;2150;6704;1960;6387;352;1327;1263;4035;1615;5362
353590;201507;676;1928;521;1648;146;497;159;503;305;1000
353600;201507;1658;4619;1486;4322;229;747;794;2235;1023;2982
353610;201507;561;1860;426;1564;80;355;109;353;189;708
353620;201507;2070;6723;1738;6056;470;1797;547;1733;1017;3530
353625;201507;245;667;159;516;35;123;49;154;84;277
353630;201507;1609;5509;1216;4476;229;909;148;452;377;1361
353640;201507;1325;3829;1062;3271;152;484;559;1670;711;2154
353650;201507;6761;20119;5011;16402;1039;3556;1695;5340;2734;8896
353657;201507;302;950;268;881;51;185;96;297;147;482
353660;201507;1176;3012;853;2473;339;1064;139;282;478;1346
353670;201507;3597;11500;3016;10213;939;3619;958;2880;1897;6499
353680;201507;637;2117;566;1984;237;912;198;654;435;1566
353690;201507;497;1320;297;939;51;191;96;251;147;442
353700;201507;2090;6441;1789;5818;333;1183;711;2175;1044;3358
353710;201507;2952;7125;1316;4355;291;997;256;813;547;1810
353715;201507;449;1286;306;981;35;131;76;219;111;350
353720;201507;1961;6178;1695;5758;310;1233;934;3035;1244;4268
353730;201507;4285;12963;3267;10752;705;2505;901;2705;1606;5210
353740;201507;1961;5820;1503;4884;423;1443;427;1330;850;2773
353750;201507;804;2670;608;2196;122;497;164;583;286;1080
353760;201507;9157;26076;7365;23189;1470;5171;3947;12181;5417;17352
353770;201507;808;2439;471;1616;93;345;38;61;131;406
353780;201507;4110;13964;3505;12753;1201;4670;958;3415;2159;8085
353790;201507;1872;6424;1535;5699;407;1727;297;1050;704;2777
353800;201507;14897;46244;11636;40083;3099;11662;4087;13669;7186;25331
353810;201507;1024;3171;775;2632;171;669;264;833;435;1502
353820;201507;1190;4022;1070;3742;253;1056;542;1712;795;2768
353830;201507;659;1776;514;1529;86;277;244;715;330;992
353850;201507;1581;4989;1421;4685;299;1050;683;2180;982;3230
353860;201507;2422;8060;1999;7070;519;1957;559;1897;1078;3854
353870;201507;26705;77774;18041;60454;3893;14421;5314;16058;9207;30479
353880;201507;2430;7595;2014;6846;268;1103;1116;3702;1384;4805
353890;201507;2706;6649;1856;5263;354;1092;878;2329;1232;3421
353900;201507;1023;3161;735;2541;162;625;198;616;360;1241
353910;201507;1177;4269;1141;4187;322;1251;652;2362;974;3613
353920;201507;2240;6590;1575;5149;349;1214;254;728;603;1942
353930;201507;3987;12467;2838;10230;744;2892;596;2109;1340;5001
353940;201507;1181;3733;920;3149;169;648;364;1139;533;1787
353950;201507;3327;10554;2997;9958;433;1683;1932;6178;2365;7861
353960;201507;571;1782;429;1467;88;327;102;282;190;609
353970;201507;535;1556;467;1461;40;140;341;1062;381;1202
353980;201507;12336;37261;10640;33958;2337;8003;5430;16811;7767;24814
353990;201507;325;996;292;927;59;228;129;371;188;599
354000;201507;2028;5806;1314;4306;258;912;138;406;396;1318
354010;201507;339;1003;284;916;74;246;143;472;217;718
354020;201507;4347;13411;3808;12200;1007;3499;1442;4241;2449;7740
354025;201507;792;2245;618;1939;129;432;198;589;327;1021
354030;201507;480;1313;337;1071;58;211;160;467;218;678
354040;201507;727;1968;532;1607;60;222;281;776;341;998
354050;201507;934;3004;796;2728;232;883;262;845;494;1728
354060;201507;5029;15438;3446;11899;836;3076;1043;3424;1879;6500
354070;201507;2750;9059;2345;8131;598;2241;492;1616;1090;3857
354075;201507;1941;7283;1831;7066;498;2139;822;3120;1320;5259
354080;201507;1518;4605;1043;3495;228;822;226;638;454;1460
354085;201507;301;767;270;723;17;60;219;573;236;633
354090;201507;1264;3723;1201;3624;121;410;886;2687;1007;3097
354100;201507;14708;48980;12160;44008;3077;11892;5421;19328;8498;31220
354105;201507;838;2562;734;2362;123;456;422;1298;545;1754
354110;201507;745;2033;599;1834;215;746;169;442;384;1188
354120;201507;1943;5310;1488;4449;276;933;620;1697;896;2630
354130;201507;5831;16891;4523;14303;1793;6058;764;2047;2557;8105
354140;201507;24694;62476;15119;44879;3112;9975;4974;13552;8086;23527
354150;201507;3904;10545;2965;8838;553;1853;1408;3998;1961;5851
354160;201507;3352;10875;2794;9622;743;2806;1128;3714;1871;6520
354165;201507;330;1233;286;1126;87;376;91;340;178;716
354170;201507;1363;4167;1060;3483;197;735;402;1172;599;1907
354180;201507;444;1298;399;1200;57;212;237;633;294;845
354190;201507;1448;4661;1187;4079;333;1273;385;1244;718;2517
354200;201507;1041;2937;831;2537;130;456;345;932;475;1388
354210;201507;656;2134;565;1960;84;360;302;972;386;1332
354220;201507;2788;8202;2387;7446;589;2023;1099;3304;1688;5327
354230;201507;617;2014;561;1918;99;377;261;865;360;1242
354240;201507;1170;3785;861;3054;148;601;187;585;335;1186
354250;201507;659;1896;440;1509;166;631;113;377;279;1008
354260;201507;7785;22963;6561;20879;1843;6384;2301;7124;4144;13508
354270;201507;1095;3774;934;3385;234;928;346;1236;580;2164
354280;201507;650;1984;601;1899;76;301;436;1318;512;1619
354290;201507;948;3205;858;3034;194;743;365;1274;559;2017
354300;201507;3398;11334;3275;11099;868;3108;1620;5355;2488;8463
354310;201507;852;2634;645;2198;167;615;239;797;406;1412
354320;201507;731;2157;604;1912;146;525;201;562;347;1087
354323;201507;399;1134;310;965;73;252;98;266;171;518
354325;201507;1182;3927;1004;3489;193;781;395;1260;588;2041
354330;201507;6401;19397;5275;17133;1099;3985;2575;7874;3674;11859
354340;201507;24322;75256;19579;66677;6189;22774;7055;23299;13244;46073
354350;201507;1055;3138;979;2995;284;966;476;1352;760;2318
354360;201507;445;1398;312;1102;53;192;27;95;80;287
354370;201507;1175;3920;1020;3599;114;500;604;2049;718;2549
354380;201507;923;2709;733;2372;222;853;126;310;348;1163
354390;201507;11941;36251;8341;28770;1881;7060;1870;6118;3751;13178
354400;201507;1520;5219;1207;4473;264;1089;344;1198;608;2287
354410;201507;5218;15930;4327;14323;962;3410;2036;6674;2998;10084
354420;201507;1122;3358;848;2710;207;725;337;1002;544;1727
354425;201507;2479;6985;2077;6247;657;2117;506;1441;1163;3558
354430;201507;1220;3982;1118;3771;255;971;483;1551;738;2522
354440;201507;505;1489;381;1233;51;199;176;516;227;715
354450;201507;422;1192;240;797;35;138;47;131;82;269
354460;201507;845;2337;630;1972;185;621;242;739;427;1360
354470;201507;547;1517;428;1276;52;201;206;544;258;745
354480;201507;674;1876;570;1706;87;301;338;973;425;1274
354490;201507;704;2312;531;1904;100;394;178;581;278;975
354500;201507;2068;6884;1826;6429;685;2767;333;1036;1018;3803
354510;201507;673;1958;605;1838;103;306;383;1186;486;1492
354515;201507;284;948;215;786;39;169;72;238;111;407
354520;201507;6602;21451;3758;13210;749;2984;1468;4827;2217;7811
354530;201507;2725;9469;2456;8886;610;2429;1098;3866;1708;6295
354540;201507;1206;3652;986;3246;331;1206;167;478;498;1684
354550;201507;454;1367;384;1220;73;257;194;592;267;849
354560;201507;1541;4452;1041;3312;207;646;403;1219;610;1865
354570;201507;730;2173;512;1667;119;415;78;224;197;639
354580;201507;9702;27927;7475;23635;1482;5156;3228;9613;4710;14769
354600;201507;1471;4885;1301;4558;294;1247;642;2113;936;3360
354610;201507;369;1064;221;710;31;93;44;119;75;212
354620;201507;380;1235;299;1089;77;341;131;443;208;784
354625;201507;250;814;191;688;44;173;52;177;96;350
354630;201507;1981;6678;1770;6217;787;2824;398;1314;1185;4138
354640;201507;3521;11445;2754;9731;626;2526;626;1971;1252;4497
354650;201507;864;2605;769;2413;96;339;503;1529;599;1868
354660;201507;2323;6732;1801;5818;325;1189;964;3080;1289;4269
354670;201507;1539;5007;1250;4289;321;1203;302;895;623;2098
354680;201507;4322;14213;3865;13248;979;3633;1629;5427;2608;9060
354690;201507;738;2341;481;1702;93;333;144;483;237;816
354700;201507;1206;3370;800;2503;152;560;330;876;482;1436
354710;201507;520;1533;441;1375;66;238;198;550;264;788
354720;201507;199;544;140;426;46;132;40;124;86;256
354730;201507;7527;24696;5782;20951;1416;5615;2348;8192;3764;13807
354740;201507;230;697;134;473;18;74;27;87;45;161
354750;201507;2412;7320;1826;6263;535;2060;644;2107;1179;4167
354760;201507;1912;6090;1530;5256;432;1593;268;856;700;2449
354765;201507;214;591;130;420;10;38;16;45;26;83
354770;201507;2178;6082;1679;5229;642;2129;416;1227;1058;3356
354780;201507;41860;120948;36486;109162;7049;23687;19249;53674;26298;77361
354790;201507;771;2457;646;2230;122;481;316;1014;438;1495
354800;201507;1923;5636;1686;5303;420;1479;851;2633;1271;4112
354805;201507;905;2738;645;2147;63;221;139;424;202;645
354810;201507;579;1874;356;1301;61;263;67;184;128;447
354820;201507;968;3287;819;2968;192;829;236;755;428;1584
354830;201507;373;1055;282;892;71;237;143;424;214;661
354840;201507;652;1874;529;1648;113;383;260;788;373;1171
354850;201507;16230;50530;11988;41773;2804;10805;4422;14187;7226;24992
354860;201507;1316;4121;1122;3793;224;879;482;1541;706;2420
354870;201507;40054;121481;36271;113550;8896;29714;16364;50315;25260;80029
354880;201507;3947;10869;2256;7344;399;1503;624;1631;1023;3134
354890;201507;15186;44722;12617;39868;3250;11026;4491;13653;7741;24679
354900;201507;443;1299;339;1100;82;296;114;361;196;657
354910;201507;6403;19036;3525;12590;595;2361;208;680;803;3041
354920;201507;428;1261;303;1012;67;258;85;270;152;528
354925;201507;336;964;204;695;31;116;30;82;61;198
354930;201507;205;544;151;458;35;111;76;227;111;338
354940;201507;2017;7051;1573;5882;569;2268;216;737;785;3005
354950;201507;1430;4542;1235;4242;141;581;738;2454;879;3035
354960;201507;756;2351;653;2180;140;534;271;857;411;1391
354970;201507;3977;12910;3450;11805;624;2470;1860;6107;2484;8577
354980;201507;32935;81303;19299;58320;3706;12542;6511;18224;10217;30766
354990;201507;45022;135196;36009;116765;6859;24185;17939;56108;24798;80293
354995;201507;1604;4952;1453;4740;328;1145;826;2684;1154;3829
355000;201507;1391;4503;1195;4147;378;1498;234;697;612;2195
355010;201507;3488;10649;2740;9003;722;2543;1056;3460;1778;6003
355020;201507;2764;9281;2155;8025;899;3633;473;1694;1372;5327
355030;201507;951506;2683515;822074;2425812;192140;616044;368292;1044505;560432;1660549
355040;201507;2516;7696;2208;7151;558;1965;1137;3599;1695;5564
355050;201507;1168;3568;935;3093;295;1030;178;573;473;1603
355060;201507;4766;15999;3806;13916;932;3813;976;3251;1908;7064
355070;201507;6453;19919;5719;18716;1208;4608;3058;9359;4266;13967
355080;201507;1088;3713;793;2997;144;647;112;325;256;972
355090;201507;1099;3781;904;3340;184;737;370;1322;554;2059
355100;201507;18425;57188;15428;52200;4365;16228;6766;22348;11131;38576
355110;201507;1132;3833;1006;3552;307;1186;304;1031;611;2217
355120;201507;590;1874;499;1695;123;486;197;614;320;1100
355130;201507;587;1491;288;837;41;136;112;280;153;416
355140;201507;1028;3422;979;3338;216;819;522;1808;738;2627
355150;201507;3170;9291;2644;8430;583;1968;1367;4349;1950;6317
355160;201507;1566;4995;1335;4635;455;1802;419;1322;874;3124
355170;201507;9323;25424;6559;20613;1984;6698;1628;5160;3612;11858
355180;201507;2798;8630;2308;7699;610;2415;766;2292;1376;4707
355190;201507;1216;4085;1019;3651;365;1403;327;1119;692;2522
355200;201507;727;2625;669;2501;282;1146;151;534;433;1680
355210;201507;2367;7671;2076;7052;452;1780;1052;3355;1504;5135
355220;201507;29168;89453;23691;78600;8064;28282;5970;18912;14034;47194
355230;201507;1361;3785;740;2408;126;417;181;532;307;949
355240;201507;25461;73159;17780;57537;3859;13627;6387;19543;10246;33170
355250;201507;24147;78567;21107;72703;5979;22058;8939;30275;14918;52333
355255;201507;767;2144;530;1636;107;342;141;407;248;749
355260;201507;1386;3916;1181;3581;285;997;487;1294;772;2291
355270;201507;1465;4385;1408;4304;97;373;1192;3589;1289;3962
355280;201507;23045;67483;18930;59457;3773;13419;8416;25005;12189;38424
355290;201507;849;2664;700;2316;142;510;275;831;417;1341
355300;201507;1068;3482;870;3052;184;688;292;955;476;1643
355310;201507;973;2966;804;2629;136;487;410;1329;546;1816
355320;201507;590;1810;497;1604;81;323;199;539;280;862
355330;201507;1647;5123;1169;4175;260;1035;414;1408;674;2443
355340;201507;2340;6173;2102;5765;342;1015;1305;3479;1647;4494
355350;201507;1267;4318;1043;3811;271;1108;323;1094;594;2202
355360;201507;1066;3443;971;3254;155;536;672;2315;827;2851
355365;201507;226;726;189;649;43;184;59;185;102;369
355370;201507;7293;17903;5197;15318;1362;4337;2217;6752;3579;11089
355380;201507;3298;9963;2518;8146;594;2153;538;1428;1132;3581
355385;201507;782;2462;722;2367;273;962;238;715;511;1677
355390;201507;831;2317;625;1917;135;475;270;722;405;1197
355395;201507;1865;5587;1386;4509;219;769;587;1753;806;2522
355400;201507;8535;28013;7332;25500;2170;8170;2354;7799;4524;15969
355410;201507;14576;48926;12001;43581;4021;15905;2614;9450;6635;25355
355420;201507;757;2652;692;2512;229;924;205;731;434;1655
355430;201507;3397;9566;2834;8579;522;1756;1526;4445;2048;6201
355440;201507;898;2804;681;2306;125;455;201;606;326;1061
355450;201507;3376;9786;1930;6447;385;1364;582;1779;967;3143
355460;201507;610;1660;430;1337;83;319;139;344;222;663
355465;201507;373;1157;311;1037;68;243;81;269;149;512
355470;201507;749;2352;624;2106;136;519;294;936;430;1455
355475;201507;125;465;114;433;27;98;54;207;81;305
355480;201507;2862;10133;2636;9685;692;2692;1294;4678;1986;7370
355490;201507;911;2627;611;2004;117;409;115;347;232;756
355495;201507;682;2282;606;2118;127;495;227;744;354;1239
355500;201507;7704;22007;4878;15873;839;3028;1018;3002;1857;6030
355510;201507;2010;5356;1161;3638;187;696;351;962;538;1658
355520;201507;418;1005;230;649;32;115;102;258;134;373
355530;201507;350;812;145;453;14;46;40;122;54;168
355535;201507;668;2032;519;1740;155;589;125;335;280;924
355540;201507;8031;25398;7524;24536;1880;6569;3986;12586;5866;19155
355550;201507;716;2160;611;1999;138;532;286;898;424;1430
355560;201507;1251;3693;823;2740;160;618;130;306;290;924
355570;201507;177;559;132;455;19;70;22;61;41;131
355580;201507;1116;3106;806;2489;169;606;315;940;484;1546
355590;201507;220;578;182;508;24;70;108;300;132;370
355600;201507;1067;3324;882;2928;302;1091;229;718;531;1809
355610;201507;1341;3760;1142;3437;229;773;530;1524;759;2297
355620;201507;3927;12264;3094;10368;575;2199;1377;4261;1952;6460
355630;201507;3214;9192;1931;6525;376;1390;496;1559;872;2949
355635;201507;911;2983;781;2763;99;416;524;1847;623;2263
355640;201507;2966;9468;2175;7751;393;1585;315;995;708;2580
355645;201507;3059;10610;2788;10155;449;1817;1729;6283;2178;8100
355650;201507;6350;19281;5395;17453;809;3090;3325;10142;4134;13232
355660;201507;1197;3744;944;3217;191;798;381;1190;572;1988
355670;201507;2397;7475;1651;5722;332;1348;655;2022;987;3370
355680;201507;1460;4772;1081;3889;343;1346;246;823;589;2169
355690;201507;405;1263;297;1078;189;735;24;62;213;797
355695;201507;302;919;176;575;12;36;16;31;28;67
355700;201507;5224;17344;4402;15455;1131;4199;1709;5745;2840;9944
355710;201507;10533;26054;6199;18080;1529;4784;1570;4244;3099;9028
355715;201507;257;764;159;541;36;131;29;85;65;216
355720;201507;1528;5008;1253;4388;348;1324;361;1102;709;2426
355730;201507;734;2461;614;2186;204;753;134;467;338;1220
410010;201507;1422;4454;1236;4070;286;1025;316;1003;602;2028
410020;201507;1143;3767;998;3460;275;1016;391;1310;666;2326
410030;201507;1124;3809;924;3308;235;884;158;565;393;1449
410040;201507;9615;31624;8377;29148;2305;9036;2471;8231;4776;17267
410045;201507;963;2736;655;2124;153;527;169;516;322;1043
410050;201507;2355;6545;1456;4739;394;1356;180;520;574;1876
410060;201507;2147;6698;1900;6219;470;1663;800;2621;1270;4284
410070;201507;1669;4715;1277;3928;412;1386;277;753;689;2139
410080;201507;1222;3664;1005;3241;176;650;454;1370;630;2020
410090;201507;985;3125;900;2952;237;870;308;969;545;1839
410100;201507;2606;7939;1889;6255;466;1715;207;613;673;2328
410105;201507;395;1237;253;887;47;201;36;96;83;297
410110;201507;2435;7243;1937;6262;349;1270;633;1975;982;3245
410115;201507;513;1394;393;1160;48;154;163;447;211;601
410120;201507;2385;8206;2223;7930;687;2617;978;3515;1665;6132
410130;201507;1123;3637;1008;3344;359;1236;281;891;640;2127
410140;201507;16345;42941;10692;32578;2327;7843;3032;8892;5359;16735
410150;201507;17424;43287;8450;25241;1693;5540;1445;3796;3138;9336
410160;201507;2828;8759;2549;8284;694;2506;944;3084;1638;5590
410165;201507;738;2153;596;1852;139;466;243;692;382;1158
410170;201507;2059;6008;1609;5028;478;1662;340;1005;818;2667
410180;201507;9432;30043;8029;26944;2012;7374;3004;9435;5016;16809
410185;201507;560;1548;453;1348;110;332;152;422;262;754
410190;201507;1966;5778;1559;4854;356;1213;302;836;658;2049
410200;201507;3774;10556;2684;8331;597;2053;339;950;936;3003
410210;201507;2431;7232;1797;5838;322;1216;398;1080;720;2296
410220;201507;620;1749;441;1390;78;274;135;396;213;670
410230;201507;1379;4321;1180;3936;326;1253;470;1477;796;2730
410240;201507;4273;12954;3842;12053;1091;3925;1057;3182;2148;7107
410250;201507;2524;7001;1738;5373;424;1437;322;880;746;2317
410260;201507;1508;4605;1269;4145;317;1122;483;1538;800;2660
410270;201507;507;1439;392;1216;63;222;150;431;213;653
410275;201507;865;2590;598;2000;89;314;280;924;369;1238
410280;201507;2200;6439;1612;5198;358;1350;440;1298;798;2648
410290;201507;3368;10138;2835;9104;677;2336;1143;3678;1820;6014
410300;201507;659;1854;571;1668;88;291;267;704;355;995
410302;201507;362;977;248;789;30;103;144;464;174;567
410304;201507;1200;3874;1079;3616;293;1032;432;1490;725;2522
410305;201507;1875;4962;1528;4409;367;1156;828;2368;1195;3524
410310;201507;2105;6881;1889;6484;429;1645;772;2608;1201;4253
410315;201507;632;1833;398;1351;71;262;124;387;195;649
410320;201507;1204;3585;709;2397;89;343;63;182;152;525
410322;201507;522;1539;342;1138;61;197;95;290;156;487
410330;201507;1349;3667;1098;3186;245;769;328;909;573;1678
410335;201507;937;2759;800;2506;166;566;300;877;466;1443
410337;201507;776;2050;562;1629;79;276;220;555;299;831
410340;201507;469;1396;319;990;42;154;135;364;177;518
410345;201507;1773;5057;1266;3976;297;998;377;1129;674;2127
410347;201507;697;1896;453;1432;68;259;151;464;219;723
410350;201507;943;2854;658;2250;138;543;98;283;236;826
410360;201507;3296;9367;2653;8203;474;1646;1162;3474;1636;5120
410370;201507;11742;33793;8330;25981;1615;5705;2438;6675;4053;12380
410380;201507;1147;3468;1010;3166;151;556;508;1513;659;2069
410390;201507;2627;7598;2044;6473;676;2323;529;1481;1205;3804
410395;201507;857;2819;751;2595;194;787;309;1017;503;1804
410400;201507;4156;12964;3519;11716;825;3134;1305;4137;2130;7271
410405;201507;918;2657;730;2288;158;567;263;802;421;1369
410410;201507;1245;4007;1185;3915;359;1397;455;1374;814;2771
410420;201507;7043;22649;5791;19765;1587;5870;1018;3025;2605;8895
410425;201507;3072;9705;2146;7573;394;1505;247;798;641;2303
410430;201507;14307;38610;10254;30918;2136;7107;3102;8910;5238;16017
410440;201507;2910;9269;2572;8600;680;2532;1088;3525;1768;6057
410442;201507;2622;8818;2303;8082;692;2535;661;2303;1353;4838
410445;201507;2240;7482;1936;6910;509;2046;658;2393;1167;4439
410450;201507;2143;6078;1649;5105;510;1644;240;627;750;2271
410460;201507;2014;5942;1597;5086;402;1346;478;1433;880;2779
410465;201507;1838;6151;1511;5418;357;1414;546;1807;903;3221
410470;201507;1589;5119;1271;4376;288;1141;331;1096;619;2237
410480;201507;28628;81053;19111;60894;4673;16086;3129;8856;7802;24942
410490;201507;10485;33199;7990;27721;2058;7972;2055;6530;4113;14502
410500;201507;1530;4751;1234;4095;443;1621;323;1038;766;2659
410510;201507;2422;6427;1702;4956;331;1019;674;1755;1005;2774
410520;201507;3074;10682;2891;10295;899;3444;1064;3769;1963;7213
410530;201507;1594;4361;1180;3508;214;729;427;1143;641;1872
410540;201507;2983;8803;2035;6773;450;1587;608;1959;1058;3546
410550;201507;6195;17739;4070;13033;787;2827;636;1783;1423;4610
410560;201507;1132;3359;853;2755;188;719;274;740;462;1459
410570;201507;2576;8189;2297;7693;619;2236;803;2886;1422;5122
410580;201507;21196;64531;17151;56250;4541;16524;4785;14480;9326;31004
410590;201507;1302;4065;772;2588;115;382;142;432;257;814
410600;201507;1806;5257;1440;4532;342;1096;584;1842;926;2938
410610;201507;744;2142;584;1831;92;336;217;636;309;972
410620;201507;1594;5535;1182;4449;342;1379;135;478;477;1857
410630;201507;2448;7244;1783;5757;464;1629;331;894;795;2523
410640;201507;4162;11606;3059;9463;828;2957;580;1645;1408;4602
410645;201507;1098;3861;1041;3775;474;1850;254;923;728;2773
410650;201507;2199;6749;1740;5764;564;1957;279;832;843;2789
410655;201507;816;2371;631;2011;136;510;215;656;351;1166
410657;201507;687;1936;473;1476;91;327;175;471;266;798
410660;201507;2461;7125;1411;4689;302;1086;175;491;477;1577
410670;201507;927;2563;624;1918;117;388;188;502;305;890
410680;201507;2710;9050;2181;7708;611;2120;719;2722;1330;4842
410685;201507;627;1803;546;1666;44;136;393;1216;437;1352
410690;201507;111519;322623;75687;246635;16984;60867;15914;45777;32898;106644
410700;201507;2209;6740;2022;6380;548;1883;845;2548;1393;4431
410710;201507;875;2633;606;1999;149;535;163;460;312;995
410712;201507;808;2452;689;2224;255;889;196;649;451;1538
410715;201507;959;2979;728;2441;147;551;255;780;402;1331
410720;201507;3280;9644;2349;7666;511;1891;556;1660;1067;3551
410725;201507;1020;2874;696;2217;108;341;109;298;217;639
410730;201507;502;1384;406;1224;120;401;112;340;232;741
410740;201507;884;2632;615;2075;107;418;268;900;375;1318
410750;201507;1772;5171;1425;4414;307;1035;448;1303;755;2338
410752;201507;290;804;168;549;32;127;61;166;93;293
410753;201507;426;1217;261;841;42;161;91;254;133;415
410754;201507;1020;3110;873;2851;71;246;575;1938;646;2184
410755;201507;798;2026;620;1742;83;270;366;1001;449;1271
410760;201507;2182;6683;1918;6184;551;1959;599;1854;1150;3813
410765;201507;15765;46557;11182;37199;2122;7904;1230;3679;3352;11583
410770;201507;890;2462;652;1982;192;641;137;380;329;1021
410773;201507;1279;3684;1095;3397;226;817;610;1823;836;2640
410775;201507;1495;4255;1389;4100;341;1092;600;1722;941;2814
410780;201507;515;1420;361;1133;92;294;131;456;223;750
410785;201507;700;2229;568;1909;203;719;131;428;334;1147
410790;201507;472;1460;383;1251;76;278;77;183;153;461
410800;201507;2770;6877;2096;5768;414;1307;801;2013;1215;3320
410810;201507;322;983;259;841;46;172;109;352;155;524
410820;201507;842;2531;638;2048;162;569;117;330;279;899
410830;201507;30961;88801;24614;77543;7200;25183;8211;24920;15411;50103
410832;201507;963;2827;834;2571;104;390;475;1372;579;1762
410840;201507;6823;20095;4381;14722;1066;3885;483;1338;1549;5223
410845;201507;1251;3702;1047;3275;180;657;448;1322;628;1979
410850;201507;2730;7943;2422;7461;507;1783;1174;3583;1681;5366
410855;201507;565;1559;406;1217;82;284;148;386;230;670
410860;201507;3688;10358;2942;8946;555;1813;1189;3542;1744;5355
410865;201507;1512;5222;1434;5069;371;1416;789;2846;1160;4262
410870;201507;1131;3512;1043;3370;385;1308;464;1491;849;2799
410880;201507;3862;11832;3062;10256;667;2475;659;2026;1326;4501
410890;201507;926;2988;723;2553;166;658;65;192;231;850
410895;201507;1108;3808;984;3512;333;1293;241;770;574;2063
410900;201507;850;2353;620;1949;114;436;200;560;314;996
410910;201507;401;1061;339;955;47;151;194;529;241;680
410920;201507;796;2235;625;1922;163;567;230;682;393;1249
410930;201507;1726;5096;1466;4609;352;1333;556;1668;908;3001
410940;201507;20045;65128;17155;59700;5014;19063;5414;19004;10428;38067
410950;201507;1700;5662;1574;5419;269;960;1021;3538;1290;4498
410960;201507;6981;19312;4393;14331;1351;4836;961;2944;2312;7780
410965;201507;1003;3065;870;2809;267;918;350;1100;617;2018
410970;201507;4358;12974;3379;11005;978;3679;664;2068;1642;5747
410975;201507;1556;4470;1237;3870;204;762;514;1577;718;2339
410980;201507;5617;15714;3324;10970;697;2565;486;1507;1183;4072
410990;201507;877;2555;537;1790;168;617;79;199;247;816
411000;201507;476;1425;334;1097;64;245;70;189;134;434
411005;201507;475;1406;298;968;70;248;37;93;107;341
411007;201507;2192;6926;1885;6229;557;1959;601;1907;1158;3866
411010;201507;3748;12790;3300;11728;859;3417;568;1788;1427;5205
411020;201507;2445;7660;2183;7208;687;2547;697;2239;1384;4786
411030;201507;647;1738;471;1385;101;338;140;369;241;707
411040;201507;622;1793;293;956;49;180;73;236;122;416
411050;201507;2052;7148;1816;6615;514;2089;293;940;807;3029
411060;201507;1497;4587;1211;3956;249;903;181;511;430;1414
411065;201507;360;1076;273;900;53;184;97;308;150;492
411070;201507;5494;16532;4059;13525;1149;4222;730;2172;1879;6394
411080;201507;2145;6472;1898;6010;538;1908;537;1599;1075;3507
411090;201507;776;1889;551;1552;81;284;134;348;215;632
411095;201507;1385;4001;1025;3215;168;610;255;691;423;1301
411100;201507;1347;3902;966;3118;169;654;148;394;317;1048
411110;201507;638;1869;379;1270;49;181;60;156;109;337
411120;201507;1624;4884;1195;3949;311;1152;382;1158;693;2310
411125;201507;4095;13418;3890;12983;1152;4106;1586;5136;2738;9242
411130;201507;697;2079;526;1692;121;409;155;520;276;929
411140;201507;2069;7302;1770;6588;599;2324;514;1983;1113;4307
411150;201507;4286;11931;3249;9777;802;2667;607;1515;1409;4182
411155;201507;915;2482;698;2063;126;438;325;876;451;1314
411160;201507;227;651;183;562;35;111;56;157;91;268
411170;201507;645;2067;531;1801;127;485;193;615;320;1100
411180;201507;5469;16347;4453;14406;1064;3821;1486;4711;2550;8532
411190;201507;1435;4053;1177;3559;298;1043;322;841;620;1884
411200;201507;4193;12392;3357;10931;820;3004;1234;3808;2054;6812
411210;201507;2015;5766;1565;4913;497;1670;232;691;729;2361
411220;201507;1151;3253;898;2755;219;779;337;896;556;1675
411230;201507;1211;3355;743;2390;177;630;189;544;366;1174
411240;201507;1326;3167;707;2113;138;421;223;614;361;1035
411250;201507;2268;6628;1853;5861;505;1736;503;1550;1008;3286
411260;201507;300;822;200;642;29;97;92;289;121;386
411270;201507;1723;5445;1533;5078;317;1226;740;2344;1057;3570
411275;201507;1348;4013;1101;3430;274;905;253;717;527;1622
411280;201507;1437;4223;1015;3320;190;702;221;651;411;1353
411290;201507;781;2240;590;1816;151;491;189;555;340;1046
411295;201507;928;2615;840;2444;155;480;337;1003;492;1483
411300;201507;1286;3269;894;2496;92;293;364;939;456;1232
411310;201507;826;2293;638;1964;85;300;215;644;300;944
411320;201507;5518;15928;3990;12915;1038;3562;783;2321;1821;5883
411325;201507;1502;4717;1313;4329;257;916;728;2407;985;3323
411330;201507;3168;9802;2694;8897;911;3338;738;2377;1649;5715
411340;201507;907;2668;567;1852;85;321;205;628;290;949
411342;201507;701;1987;563;1705;146;478;184;494;330;972
411345;201507;951;2958;853;2765;221;782;393;1270;614;2052
411350;201507;2690;7904;1858;6185;488;1816;231;697;719;2513
411360;201507;538;1338;355;1019;42;157;170;414;212;571
411370;201507;45609;128433;34476;107556;6254;22646;13231;38093;19485;60739
411373;201507;1452;4508;1208;4023;277;1049;305;1006;582;2055
411375;201507;1090;3006;782;2384;158;496;194;539;352;1035
411380;201507;1261;3410;719;2180;116;377;207;564;323;941
411390;201507;1770;5244;1470;4642;316;1099;466;1355;782;2454
411400;201507;2018;5793;1451;4534;270;927;369;1059;639;1986
411410;201507;2045;6109;1531;4887;353;1290;402;1063;755;2353
411420;201507;4030;11594;2828;8840;499;1755;487;1188;986;2943
411430;201507;2960;9169;2470;8303;702;2562;1051;3465;1753;6027
411435;201507;425;1380;343;1165;86;325;139;438;225;763
411440;201507;2609;8408;2325;7822;778;2813;595;2054;1373;4867
411450;201507;2174;6627;1973;6241;416;1355;1046;3383;1462;4738
411460;201507;3138;9286;1666;5792;326;1224;106;346;432;1570
411470;201507;846;2506;551;1792;85;288;90;244;175;532
411480;201507;4313;12852;3180;10631;889;3324;566;1738;1455;5062
411490;201507;1434;4313;1192;3863;297;1073;297;820;594;1893
411500;201507;1821;4879;1260;3860;267;897;345;1008;612;1905
411510;201507;2003;5977;1609;5147;456;1608;319;857;775;2465
411520;201507;25323;68800;14940;46759;2938;9986;3207;9242;6145;19228
411530;201507;988;2795;673;2193;186;688;109;287;295;975
411535;201507;512;1528;246;888;37;151;26;78;63;229
411540;201507;2973;8018;2210;6540;335;1081;1058;3042;1393;4123
411545;201507;926;3113;841;2951;148;551;554;1981;702;2532
411550;201507;780;2104;618;1844;233;779;129;360;362;1139
411560;201507;2386;7098;1760;5624;348;1235;293;790;641;2025
411570;201507;6443;17366;4684;14433;1182;4144;1036;3195;2218;7339
411573;201507;864;2582;813;2493;147;489;499;1533;646;2022
411575;201507;1461;4584;1221;4052;244;861;452;1469;696;2330
411580;201507;3911;11052;2544;8201;415;1586;377;972;792;2558
411585;201507;651;2133;374;1320;82;310;66;209;148;519
411590;201507;368;1101;318;1024;58;214;135;396;193;610
411600;201507;284;835;202;693;50;202;73;246;123;448
411605;201507;1894;5027;1225;3683;200;697;488;1366;688;2063
411610;201507;2098;5810;1772;5287;326;1053;1033;3014;1359;4067
411620;201507;2585;8221;2390;7882;680;2414;1079;3615;1759;6029
411630;201507;463;1198;273;899;52;214;45;134;97;348
411640;201507;480;1411;362;1157;59;194;129;374;188;568
411650;201507;200;648;159;567;41;178;46;141;87;319
411660;201507;800;2220;618;1868;124;415;261;770;385;1185
411670;201507;1189;3287;975;2839;220;706;369;1014;589;1720
411680;201507;1373;4220;1234;3961;191;620;786;2616;977;3236
411690;201507;3209;9433;2500;8046;661;2256;545;1763;1206;4019
411695;201507;758;2445;605;2113;146;556;179;620;325;1176
411700;201507;1753;5087;1214;3952;237;865;245;696;482;1561
411705;201507;2024;6902;1778;6399;411;1470;958;3609;1369;5079
411710;201507;1678;4895;1300;4096;315;1072;296;871;611;1943
411720;201507;802;2315;596;1868;90;312;173;490;263;802
411721;201507;676;2053;575;1856;169;605;88;251;257;856
411722;201507;636;1855;444;1438;92;341;123;328;215;669
411725;201507;1341;4342;831;2992;186;711;155;541;341;1252
411727;201507;1867;5430;1435;4501;346;1193;420;1195;766;2388
411729;201507;539;1448;380;1152;127;411;78;197;205;608
411730;201507;5450;15678;4528;13907;1819;5715;1150;3510;2969;9225
411740;201507;619;1759;401;1253;67;237;142;413;209;650
411745;201507;845;2482;682;2147;142;482;221;670;363;1152
411750;201507;4458;13316;3315;10642;781;2766;778;2366;1559;5132
411760;201507;7706;22499;6568;20471;2074;7039;1848;5627;3922;12666
411770;201507;3261;10956;2684;9571;843;3210;528;1829;1371;5039
411780;201507;2558;8127;2413;7916;243;844;1737;5884;1980;6728
411790;201507;3041;8628;2189;6908;588;2137;648;1959;1236;4096
411800;201507;1204;3439;793;2570;115;430;153;420;268;850
411810;201507;1520;4430;1281;3961;277;972;438;1218;715;2190
411820;201507;13789;43903;11461;39186;4042;14379;2916;10187;6958;24566
411830;201507;469;1258;361;1081;120;371;17;61;137;432
411840;201507;9882;28610;7293;23550;1825;6436;1567;4877;3392;11313
411845;201507;506;1536;319;1056;49;184;73;199;122;383
411850;201507;6632;19825;5455;17443;1425;4950;1526;4784;2951;9734
411860;201507;855;2642;686;2285;181;624;207;663;388;1287
411870;201507;862;2891;601;2172;110;464;143;481;253;945
411880;201507;2218;6399;1803;5648;452;1650;453;1269;905;2919
411885;201507;869;2362;694;2030;130;475;227;576;357;1051
411890;201507;1048;3167;637;2146;96;366;90;229;186;595
411900;201507;954;3049;673;2342;175;623;97;341;272;964
411910;201507;1204;3974;943;3329;284;1081;249;805;533;1886
411915;201507;14414;40183;9267;29526;1838;6382;2107;6113;3945;12495
411920;201507;832;2803;714;2517;188;804;110;300;298;1104
411925;201507;592;1677;383;1275;94;313;98;310;192;623
411930;201507;5839;19015;5164;17756;2105;7682;1185;3978;3290;11660
411940;201507;3175;10592;2739;9647;716;2677;642;2159;1358;4836
411950;201507;11277;35830;9374;32049;2350;8732;4115;13823;6465;22555
411960;201507;5149;15383;4698;14521;1148;3939;1980;5941;3128;9880
411965;201507;593;1677;432;1408;82;317;152;503;234;820
411970;201507;719;2010;572;1779;178;606;201;635;379;1241
411980;201507;1582;4818;1355;4347;261;888;500;1608;761;2496
411990;201507;27298;88848;22668;78871;6147;23759;6363;21460;12510;45219
411995;201507;2439;7501;2078;6786;704;2593;478;1401;1182;3994
412000;201507;2177;5662;1714;4857;273;929;849;2159;1122;3088
412010;201507;686;2325;548;2001;104;398;118;403;222;801
412015;201507;652;1953;516;1661;101;340;243;782;344;1122
412020;201507;389;1113;261;834;58;217;97;275;155;492
412030;201507;689;2171;463;1631;77;302;110;346;187;648
412033;201507;721;2134;482;1549;85;316;120;343;205;659
412035;201507;984;2718;668;2120;149;512;245;754;394;1266
412040;201507;567;1800;449;1527;102;372;149;472;251;844
412050;201507;1695;4979;1314;4218;261;943;285;867;546;1810
412060;201507;6651;22832;5987;21437;1855;7118;1921;6871;3776;13989
412065;201507;871;2605;673;2162;152;548;205;597;357;1145
412070;201507;1189;3233;941;2732;152;479;333;937;485;1416
412080;201507;1305;4024;739;2656;114;479;37;81;151;560
412085;201507;374;1082;140;478;35;126;32;93;67;219
412090;201507;4072;13143;3842;12719;603;2230;2463;8224;3066;10454
412100;201507;1857;5840;1550;5173;449;1633;434;1393;883;3026
412110;201507;1048;2985;695;2221;150;527;170;525;320;1052
412120;201507;1805;6093;1550;5485;415;1678;581;1845;996;3523
412125;201507;681;2154;603;2003;118;417;242;770;360;1187
412130;201507;589;1769;427;1394;95;343;80;241;175;584
412135;201507;488;1369;331;1053;72;254;126;366;198;620
412140;201507;1579;4720;1277;4079;314;1077;287;877;601;1954
412150;201507;2864;8274;2418;7366;308;1081;1474;4376;1782;5457
412160;201507;1083;3441;659;2352;158;602;89;270;247;872
412170;201507;4298;13407;3432;11672;966;3589;1203;3891;2169;7480
412175;201507;1317;4519;1128;4075;299;1193;447;1589;746;2782
412180;201507;1600;4972;1176;4120;294;1183;325;1059;619;2242
412190;201507;3060;8835;2281;7405;587;2070;635;2133;1222;4203
412200;201507;2188;6982;1501;5194;309;1183;470;1597;779;2780
412210;201507;719;1996;409;1339;70;271;54;166;124;437
412215;201507;3637;11217;3288;10580;664;2154;1935;6424;2599;8578
412217;201507;1066;3036;960;2847;121;455;647;1783;768;2238
412220;201507;5431;17931;5159;17408;1534;5365;2555;8581;4089;13946
412230;201507;2677;8789;2284;8007;537;2132;646;2099;1183;4231
412240;201507;9333;23983;5120;15909;958;3361;918;2495;1876;5856
412250;201507;1849;5431;1565;4834;398;1364;320;842;718;2206
412260;201507;1278;3563;798;2518;124;454;274;786;398;1240
412265;201507;1034;3175;910;2957;203;772;423;1363;626;2135
412270;201507;778;2451;506;1762;104;408;128;411;232;819
412280;201507;608;1900;438;1522;197;732;41;134;238;866
412290;201507;997;2870;770;2404;152;513;259;741;411;1254
412300;201507;1888;5694;1560;5040;450;1610;367;1133;817;2743
412310;201507;1041;3012;916;2819;120;419;512;1644;632;2063
412320;201507;809;2175;565;1734;121;424;186;546;307;970
412330;201507;1531;4348;1174;3599;184;646;603;1804;787;2450
412340;201507;887;2762;567;1919;81;298;82;254;163;552
412350;201507;2259;7023;1802;5985;438;1574;210;576;648;2150
412360;201507;281;833;180;582;22;82;63;174;85;256
412370;201507;808;2456;636;2110;163;598;162;502;325;1100
412380;201507;1558;4935;1291;4282;311;1110;385;1202;696;2312
412382;201507;672;1913;454;1447;93;302;104;292;197;594
412385;201507;2390;7426;2092;6748;666;2271;499;1530;1165;3801
412390;201507;2085;6018;1868;5649;488;1627;721;2212;1209;3839
412395;201507;833;2370;664;2077;85;296;392;1194;477;1490
412400;201507;916;2888;789;2615;237;828;201;675;438;1503
412402;201507;1872;5594;1495;4779;369;1323;338;908;707;2231
412405;201507;3591;10413;2231;7328;398;1502;230;634;628;2136
412410;201507;4394;13752;3729;12456;1157;4549;763;2311;1920;6860
412420;201507;352;1026;246;783;49;164;85;216;134;380
412430;201507;516;1433;389;1177;62;217;151;414;213;631
412440;201507;3329;10013;2696;8906;570;2060;985;3263;1555;5323
412450;201507;323;1040;246;841;43;148;24;51;67;199
412460;201507;778;2326;587;1919;134;506;142;409;276;915
412470;201507;1871;6386;1626;5760;533;1982;489;1753;1022;3735
412480;201507;1297;3785;874;2853;167;567;112;289;279;856
412490;201507;856;2532;726;2257;139;465;213;608;352;1073
412500;201507;1917;5545;1584;4879;333;1153;407;1068;740;2221
412510;201507;2193;7269;1857;6428;531;1975;760;2593;1291;4568
412520;201507;1456;4126;1089;3346;280;917;254;720;534;1637
412530;201507;637;1855;489;1506;99;312;130;372;229;684
412535;201507;622;1841;392;1288;86;298;82;242;168;540
412540;201507;1201;3473;930;2914;143;516;273;834;416;1350
412545;201507;795;2250;601;1794;91;318;203;510;294;828
412550;201507;27981;83807;18795;62898;4811;17233;3497;10836;8308;28069
412555;201507;290;868;194;646;37;140;42;120;79;260
412560;201507;5142;16156;4016;13740;968;3809;961;2964;1929;6773
412570;201507;4270;12651;2904;9533;660;2472;546;1675;1206;4147
412575;201507;897;2723;691;2230;157;567;179;510;336;1077
412580;201507;1210;3326;869;2703;170;552;254;746;424;1298
412590;201507;401;1166;262;859;59;224;72;222;131;446
412600;201507;1407;4263;1086;3542;232;843;326;981;558;1824
412610;201507;683;2035;463;1470;108;395;141;399;249;794
412620;201507;1166;3760;911;3187;244;958;137;422;381;1380
412625;201507;10475;29196;7747;23886;1834;6148;1364;3768;3198;9916
412627;201507;897;2769;621;2130;177;644;64;191;241;835
412630;201507;3232;10273;2661;9024;589;2056;810;2618;1399;4674
412635;201507;455;1366;299;1003;70;250;17;40;87;290
412640;201507;880;2617;579;1912;105;369;59;156;164;525
412650;201507;1768;5202;1443;4543;316;1165;450;1213;766;2378
412660;201507;2780;8065;2123;6677;412;1445;398;1104;810;2549
412665;201507;632;1652;336;1065;89;287;64;197;153;484
412667;201507;1565;4614;1216;3897;297;1051;232;672;529;1723
412670;201507;534;1674;377;1300;110;439;68;183;178;622
412680;201507;1313;3928;812;2774;144;538;201;605;345;1143
412690;201507;724;2207;533;1782;176;622;101;336;277;958
412700;201507;1815;5588;1517;5128;518;1994;444;1446;962;3440
412710;201507;7337;22874;6039;20155;1417;5308;1446;4464;2863;9772
412720;201507;1391;4297;939;3129;168;616;180;482;348;1098
412730;201507;2129;6300;1309;4388;271;1014;163;401;434;1415
412740;201507;1409;4386;1058;3621;254;981;207;709;461;1690
412750;201507;3811;11873;3364;11091;530;2096;1998;6353;2528;8449
412760;201507;2187;7145;2072;6949;479;1864;1095;3497;1574;5361
412770;201507;11028;30304;6162;19673;929;3275;1147;3138;2076;6413
412780;201507;1217;3882;1056;3539;264;961;381;1203;645;2164
412785;201507;2278;6624;1672;5335;439;1534;727;2264;1166;3798
412788;201507;1377;4404;1211;4043;263;1003;416;1216;679;2219
412790;201507;1111;3284;842;2729;173;622;207;584;380;1206
412795;201507;889;2487;732;2188;178;551;247;718;425;1269
412796;201507;2697;8387;2477;7959;639;2321;984;2937;1623;5258
412800;201507;2998;8616;2274;7071;434;1516;753;2234;1187;3750
412810;201507;10513;28769;5759;18229;873;3070;1180;3075;2053;6145
412820;201507;6883;20213;4934;16338;1193;4298;1044;3468;2237;7766
412830;201507;334;1028;261;860;45;185;80;222;125;407
412840;201507;1828;5241;1455;4477;276;932;323;904;599;1836
412850;201507;2589;7763;2200;7122;437;1674;900;2693;1337;4367
412853;201507;1605;4556;1415;4195;155;561;808;2209;963;2770
412855;201507;1464;4203;1120;3459;271;949;302;817;573;1766
412860;201507;1204;3443;979;3020;225;781;400;1183;625;1964
412862;201507;760;1958;514;1474;82;256;192;510;274;766
412863;201507;1175;3980;1136;3913;170;651;791;2691;961;3342
412865;201507;669;2051;498;1654;114;402;183;616;297;1018
412870;201507;890;2504;704;2194;235;812;150;426;385;1238
412880;201507;943;2644;723;2237;183;623;178;486;361;1109
420005;201507;533;1578;344;1144;61;213;120;381;181;594
420010;201507;3030;8841;2494;8071;365;1271;1748;5730;2113;7001
420020;201507;781;2503;438;1584;53;233;49;142;102;375
420030;201507;512;1346;259;861;53;208;44;137;97;345
420040;201507;755;2354;473;1738;106;421;62;157;168;578
420050;201507;651;1963;461;1535;141;493;163;521;304;1014
420055;201507;221;674;129;452;26;102;22;63;48;165
420060;201507;219;733;146;540;36;152;28;86;64;238
420070;201507;1422;4479;1100;3712;174;659;525;1768;699;2427
420075;201507;181;507;94;309;17;67;28;78;45;145
420080;201507;603;1876;468;1600;148;545;119;396;267;941
420090;201507;504;1694;351;1344;89;373;59;225;148;598
420100;201507;1193;3771;1073;3608;234;826;641;2161;875;2987
420110;201507;351;1170;310;1080;78;288;128;445;206;733
420120;201507;287;977;241;884;80;329;58;195;138;524
420125;201507;256;986;231;928;71;296;90;331;161;627
420127;201507;549;1632;211;781;61;237;28;101;89;338
420130;201507;1799;5977;1455;5278;355;1401;390;1264;745;2665
420140;201507;4842;14184;3321;11196;809;3040;564;1680;1373;4720
420150;201507;756;2090;444;1449;97;350;141;411;238;761
420160;201507;276;784;178;576;30;105;52;160;82;265
420165;201507;206;649;121;426;24;95;29;87;53;182
420170;201507;199;597;123;436;40;176;16;36;56;212
420180;201507;422;1299;238;864;44;163;46;163;90;326
420190;201507;469;1357;230;805;34;138;38;107;72;245
420195;201507;1311;3841;1039;3384;256;890;382;1221;638;2111
420200;201507;2881;9227;1760;6557;453;1923;265;837;718;2760
420205;201507;924;3022;800;2806;180;680;402;1419;582;2099
420207;201507;1522;4450;1034;3407;297;1119;235;680;532;1799
420208;201507;546;1519;313;1084;103;380;91;309;194;689
420209;201507;325;998;199;693;37;147;70;229;107;376
420210;201507;1500;4601;972;3667;233;1045;252;901;485;1946
420213;201507;815;2911;771;2802;153;594;483;1770;636;2364
420215;201507;385;1253;255;925;74;298;39;125;113;423
420220;201507;156;535;135;491;31;131;47;137;78;268
420230;201507;4164;12243;3012;10093;608;2415;1280;4075;1888;6490
420240;201507;11309;30782;6919;22588;1110;4434;2923;8484;4033;12918
420243;201507;606;1843;477;1570;97;367;166;518;263;885
420245;201507;1113;3347;740;2533;153;585;197;593;350;1178
420250;201507;569;1831;535;1773;147;577;243;775;390;1352
420253;201507;540;1444;428;1287;68;216;243;758;311;974
420257;201507;328;928;209;703;39;138;104;344;143;482
420260;201507;1257;3946;1048;3569;241;931;455;1533;696;2464
420270;201507;532;1634;158;578;30;125;35;107;65;232
420280;201507;2371;6320;1409;4524;279;1055;500;1441;779;2496
420285;201507;147;430;61;220;6;19;5;21;11;40
420287;201507;538;1624;451;1464;126;413;157;512;283;925
420290;201507;6577;19292;4169;13774;839;3053;1203;3603;2042;6656
420300;201507;6513;19684;4174;14591;908;3498;761;2580;1669;6078
420310;201507;771;2192;708;2096;115;369;488;1402;603;1771
420315;201507;962;3077;757;2649;207;806;271;911;478;1717
420320;201507;5246;15997;4240;14158;1123;4104;1721;5651;2844;9755
420325;201507;268;884;250;840;51;197;110;350;161;547
420330;201507;993;3434;725;2717;185;781;179;560;364;1341
420340;201507;1461;4507;1083;3632;238;886;192;563;430;1449
420350;201507;1426;4348;1115;3728;281;1004;413;1343;694;2347
420360;201507;3191;9632;2003;6984;492;1952;249;700;741;2652
420370;201507;1946;5440;1515;4661;156;500;1176;3578;1332;4078
420380;201507;5068;15986;3496;12214;881;3368;856;2848;1737;6216
420390;201507;1598;4450;809;2750;149;592;173;454;322;1046
420395;201507;1504;4619;994;3428;158;626;151;414;309;1040
420400;201507;1325;3843;907;3002;244;964;230;650;474;1614
420410;201507;762;2033;515;1619;121;420;285;880;406;1300
420415;201507;459;1467;335;1162;102;371;104;347;206;718
420417;201507;734;2335;605;2019;96;335;323;1084;419;1419
420419;201507;402;1226;258;937;107;433;36;126;143;559
420420;201507;10857;32565;8478;27804;2722;10035;2333;6951;5055;16986
420425;201507;1320;3576;833;2588;86;326;351;999;437;1325
420430;201507;3252;9806;2056;7059;452;1698;701;2383;1153;4081
420435;201507;295;874;179;620;32;136;90;289;122;425
420440;201507;990;3050;583;2001;235;873;94;297;329;1170
420445;201507;375;1119;275;883;56;174;124;403;180;577
420450;201507;832;2497;523;1793;115;411;124;368;239;779
420455;201507;1950;5854;1680;5381;304;1182;802;2453;1106;3635
420460;201507;8468;24757;6230;20742;1433;5542;2412;7649;3845;13191
420470;201507;1126;3055;698;2208;166;609;189;520;355;1129
420475;201507;125;371;62;218;20;72;10;30;30;102
420480;201507;4496;13217;3400;11149;1189;4347;522;1603;1711;5950
420490;201507;712;1869;386;1299;99;364;101;314;200;678
420500;201507;1671;5282;1279;4509;382;1522;531;1780;913;3302
420510;201507;107;425;94;396;36;152;35;141;71;293
420515;201507;117;399;94;352;15;67;16;63;31;130
420517;201507;915;2792;787;2555;128;466;419;1307;547;1773
420519;201507;504;1352;358;1082;55;177;109;303;164;480
420520;201507;675;1683;436;1350;102;346;195;554;297;900
420530;201507;1076;3510;794;2829;173;705;196;569;369;1274
420535;201507;274;816;150;539;37;156;11;29;48;185
420540;201507;20759;59453;14452;45745;3705;12868;3922;11001;7627;23869
420543;201507;409;1078;301;901;28;100;188;601;216;701
420545;201507;1555;4871;1237;4178;289;1110;417;1292;706;2402
420550;201507;4166;13264;3076;10831;735;3054;651;1929;1386;4983
420555;201507;403;1233;314;1048;90;336;103;317;193;653
420560;201507;534;1544;437;1358;75;251;219;662;294;913
420570;201507;2015;6458;1552;5358;415;1635;489;1549;904;3184
420580;201507;1285;3991;1012;3508;258;1009;424;1414;682;2423
420590;201507;3218;9706;2096;7078;442;1616;344;1006;786;2622
420600;201507;796;2606;715;2433;133;472;359;1272;492;1744
420610;201507;531;1642;301;1112;85;351;70;241;155;592
420620;201507;769;2305;638;2072;195;680;200;640;395;1320
420630;201507;1029;3150;699;2372;152;550;228;683;380;1233
420640;201507;750;2281;355;1315;85;351;24;69;109;420
420650;201507;2489;7170;1433;4875;258;1002;280;809;538;1811
420660;201507;480;1385;383;1198;72;256;179;543;251;799
420665;201507;732;2050;453;1491;78;268;131;385;209;653
420670;201507;1611;4800;1093;3671;210;821;239;685;449;1506
420675;201507;212;648;146;496;29;105;50;154;79;259
420680;201507;509;1203;294;872;53;173;100;277;153;450
420690;201507;877;3013;621;2282;111;421;149;500;260;921
420700;201507;3705;10640;2778;8749;620;2276;851;2481;1471;4757
420710;201507;581;1937;446;1663;130;543;149;524;279;1067
420720;201507;1643;4772;1309;4326;305;1092;761;2507;1066;3599
420730;201507;3314;9893;2671;8720;681;2457;1065;3304;1746;5761
420740;201507;844;2598;687;2302;212;763;310;1002;522;1765
420750;201507;2348;7397;1581;5561;282;1180;474;1441;756;2621
420757;201507;102;240;48;157;6;28;24;74;30;102
420760;201507;325;989;211;696;43;167;55;147;98;314
420765;201507;567;1757;282;1038;53;220;48;151;101;371
420768;201507;1161;4043;888;3425;288;1165;291;1106;579;2271
420770;201507;665;1898;340;1196;66;277;82;260;148;537
420775;201507;662;2014;383;1299;96;332;79;247;175;579
420780;201507;1572;4703;941;3139;212;759;179;529;391;1288
420785;201507;327;980;229;727;37;132;70;195;107;327
420790;201507;1282;4378;999;3686;279;1152;390;1337;669;2489
420800;201507;799;2306;423;1418;115;449;91;272;206;721
420810;201507;2181;7402;1686;6233;513;2173;417;1419;930;3592
420820;201507;7967;24044;5441;19606;1438;5893;1471;5185;2909;11078
420830;201507;2505;7951;2069;7151;671;2535;716;2417;1387;4952
420840;201507;1006;2948;547;1965;129;521;116;357;245;878
420845;201507;1317;4011;950;3319;272;1111;227;715;499;1826
420850;201507;1708;5330;991;3752;250;1080;135;479;385;1559
420860;201507;470;1311;292;970;80;312;112;348;192;660
420870;201507;1116;3172;884;2796;289;1074;271;740;560;1814
420880;201507;1036;3402;784;2756;174;684;179;541;353;1225
420890;201507;13158;32016;5661;18034;995;3537;1426;3819;2421;7356
420895;201507;244;665;123;399;33;103;13;35;46;138
420900;201507;2093;5799;1214;4051;255;981;296;865;551;1846
420910;201507;22189;66055;14333;49774;2910;11559;4097;13112;7007;24671
420915;201507;544;2128;419;1769;100;455;198;804;298;1259
420917;201507;458;1410;212;683;51;197;83;216;134;413
420920;201507;184;500;75;247;21;75;14;42;35;117
420930;201507;18588;53174;14357;45920;3460;12308;5010;15383;8470;27691
420940;201507;3208;9614;2475;8049;701;2593;397;994;1098;3587
420945;201507;205;656;130;475;26;118;32;108;58;226
420950;201507;617;1729;271;1010;34;160;37;119;71;279
420960;201507;977;2750;793;2429;168;615;383;1083;551;1698
420970;201507;2417;7707;2088;7106;568;2207;714;2333;1282;4540
420980;201507;456;1342;332;1131;108;396;122;459;230;855
420985;201507;511;1461;251;893;51;218;69;221;120;439
420990;201507;896;2465;512;1743;100;390;149;451;249;841
421000;201507;572;1954;367;1418;76;321;63;203;139;524
421003;201507;702;1915;261;862;32;111;41;82;73;193
421005;201507;195;591;151;516;34;124;82;281;116;405
421010;201507;5771;16508;3914;13070;1018;3866;909;2670;1927;6536
421020;201507;479;1507;360;1274;49;173;190;710;239;883
421030;201507;769;2838;729;2741;220;887;174;639;394;1526
421040;201507;725;2036;559;1757;120;424;278;831;398;1255
421050;201507;1652;4579;977;3158;213;771;233;614;446;1385
421055;201507;224;646;128;419;28;97;34;89;62;186
421060;201507;471;1615;329;1202;71;288;127;435;198;723
421070;201507;747;2363;471;1676;109;443;102;332;211;775
421080;201507;524;1553;443;1423;89;294;274;871;363;1165
421085;201507;572;1504;296;1003;63;247;83;286;146;533
421090;201507;363;1032;210;685;34;122;88;249;122;371
421100;201507;906;2560;531;1739;142;477;105;309;247;786
421105;201507;1465;4496;1210;4041;276;1003;448;1499;724;2502
421110;201507;1044;3785;950;3556;340;1364;233;811;573;2175
421120;201507;1428;4511;951;3328;156;646;300;915;456;1561
421125;201507;418;1180;304;972;89;330;95;265;184;595
421130;201507;3267;10592;2701;9535;874;3462;925;3218;1799;6680
421140;201507;357;1051;274;873;52;172;98;288;150;460
421145;201507;563;1772;373;1256;60;227;147;472;207;699
421150;201507;517;1574;376;1330;78;310;154;534;232;844
421160;201507;1237;3484;609;2037;108;418;222;708;330;1126
421165;201507;284;979;218;778;35;125;102;367;137;492
421170;201507;1404;4125;1124;3653;223;803;697;2247;920;3050
421175;201507;1243;3525;917;2996;207;854;349;1016;556;1870
421180;201507;601;1653;311;1035;70;270;77;212;147;482
421185;201507;410;1136;285;895;55;161;142;466;197;627
421187;201507;290;860;212;692;39;138;98;303;137;441
421189;201507;420;1292;362;1175;71;256;130;387;201;643
421190;201507;11479;33158;6898;23548;1522;5639;1348;4250;2870;9889
421200;201507;947;3129;792;2786;175;692;236;745;411;1437
421205;201507;259;796;186;652;40;163;42;124;82;287
421210;201507;1638;4965;1233;3959;319;1097;328;993;647;2090
421220;201507;2060;6945;1777;6318;534;2085;426;1435;960;3520
421223;201507;620;1900;465;1590;113;413;170;564;283;977
421225;201507;1092;3419;898;3025;213;809;332;1079;545;1888
421227;201507;787;2605;687;2441;150;555;416;1487;566;2042
421230;201507;455;1443;402;1339;103;391;190;581;293;972
421240;201507;455;1445;252;880;34;144;46;134;80;278
421250;201507;1744;4992;1080;3773;321;1249;253;823;574;2072
421260;201507;364;1024;96;355;21;75;23;79;44;154
421265;201507;615;1968;529;1804;121;435;208;693;329;1128
421270;201507;808;2164;409;1349;93;322;97;348;190;670
421280;201507;1568;4923;1247;4403;384;1523;431;1487;815;3010
421290;201507;1607;4191;823;2636;153;531;167;438;320;969
421300;201507;305;920;240;783;69;254;91;278;160;532
421310;201507;264;835;206;686;48;162;73;233;121;395
421315;201507;396;1172;221;793;41;153;23;82;64;235
421320;201507;541;1737;340;1207;57;216;42;97;99;313
421330;201507;541;1774;406;1511;145;622;66;225;211;847
421335;201507;561;1837;445;1604;107;433;90;330;197;763
421340;201507;1756;5037;1411;4471;197;782;856;2634;1053;3416
421350;201507;892;2932;707;2522;158;656;249;815;407;1471
421360;201507;3130;8988;1945;6663;403;1584;549;1706;952;3290
421370;201507;758;2506;593;2138;170;690;188;637;358;1327
421380;201507;992;2820;782;2407;140;493;375;1129;515;1622
421390;201507;144;423;75;259;11;35;35;128;46;163
421400;201507;248;869;184;722;48;202;58;213;106;415
421410;201507;314;901;214;701;29;96;103;328;132;424
421415;201507;346;1136;158;578;39;157;39;121;78;278
421420;201507;910;2759;637;2124;133;489;170;497;303;986
421430;201507;238;740;174;609;34;134;38;130;72;264
421440;201507;863;2450;551;1873;138;533;223;712;361;1245
421450;201507;507;1557;322;1163;76;304;50;155;126;459
421460;201507;634;1710;310;1092;52;219;73;244;125;463
421470;201507;446;1515;356;1310;96;387;131;464;227;851
421480;201507;2844;8155;1692;5950;382;1588;355;1059;737;2647
421490;201507;285;861;123;464;32;135;22;69;54;204
421500;201507;2263;7668;1891;6860;647;2652;355;1197;1002;3849
421505;201507;377;1253;329;1145;68;254;163;555;231;809
421507;201507;565;1716;357;1253;64;235;121;444;185;679
421510;201507;187;605;162;561;32;142;83;241;115;383
421520;201507;860;2293;555;1662;56;207;263;702;319;909
421530;201507;407;1251;233;856;35;165;75;269;110;434
421535;201507;709;2096;398;1436;69;285;171;560;240;845
421540;201507;372;1021;296;880;61;199;121;340;182;539
421545;201507;908;2962;656;2442;181;782;162;549;343;1331
421550;201507;1916;6162;1598;5560;475;1903;443;1398;918;3301
421555;201507;339;1015;119;431;19;74;16;57;35;131
421560;201507;207;622;89;313;23;94;21;70;44;164
421565;201507;939;2794;831;2621;297;1055;327;988;624;2043
421567;201507;775;2812;670;2559;335;1335;147;540;482;1875
421568;201507;517;1619;349;1219;85;311;87;303;172;614
421569;201507;187;575;106;388;27;108;24;73;51;181
421570;201507;1312;3989;670;2403;176;702;132;448;308;1150
421575;201507;472;1555;409;1430;67;254;260;909;327;1163
421580;201507;3460;10759;2566;8760;667;2622;606;1765;1273;4387
421590;201507;231;721;184;628;26;89;95;319;121;408
421600;201507;582;1735;436;1431;117;410;93;274;210;684
421605;201507;596;1825;431;1491;84;340;111;337;195;677
421610;201507;1448;3929;1141;3405;161;558;663;1895;824;2453
421620;201507;4619;13931;3116;10747;910;3387;986;3362;1896;6749
421625;201507;374;1068;167;574;28;99;30;104;58;203
421630;201507;2834;8432;1518;5221;351;1360;212;610;563;1970
421635;201507;268;796;158;516;22;82;77;230;99;312
421640;201507;1054;3165;795;2630;158;544;344;1083;502;1627
421650;201507;2065;6706;1647;5760;526;2101;271;791;797;2892
421660;201507;7839;25211;6239;21838;1614;6367;2006;6489;3620;12856
421670;201507;1090;3355;748;2576;221;844;203;660;424;1504
421680;201507;1177;3868;1006;3462;342;1252;199;643;541;1895
421690;201507;1816;5885;1352;4753;287;1113;197;606;484;1719
421700;201507;509;1559;294;1003;56;230;87;214;143;444
421710;201507;239;806;131;482;43;165;40;142;83;307
421715;201507;268;719;145;462;41;141;41;116;82;257
421720;201507;1836;5531;1178;4162;351;1373;256;827;607;2200
421725;201507;106;346;93;318;30;109;24;83;54;192
421730;201507;578;1664;259;899;45;168;54;149;99;317
421740;201507;727;2263;486;1682;103;429;97;237;200;666
421750;201507;1104;2994;710;2209;138;475;329;935;467;1410
421755;201507;330;978;215;702;52;200;68;200;120;400
421760;201507;665;2125;352;1263;67;267;115;387;182;654
421770;201507;3070;9152;2289;7553;654;2299;747;2464;1401;4763
421775;201507;573;1676;385;1325;81;301;116;374;197;675
421780;201507;1341;4406;994;3610;262;1079;371;1251;633;2330
421790;201507;894;2400;498;1729;131;529;149;465;280;994
421795;201507;342;1001;210;669;35;132;62;192;97;324
421800;201507;2618;7827;1944;6528;430;1659;795;2464;1225;4123
421810;201507;630;1990;450;1606;113;429;62;206;175;635
421820;201507;1111;3201;692;2332;117;441;163;487;280;928
421825;201507;1426;4605;1310;4330;192;751;775;2437;967;3188
421830;201507;2434;8320;2214;7886;498;2028;1045;3586;1543;5614
421835;201507;148;430;107;368;23;106;63;199;86;305
421840;201507;353;1137;269;940;69;271;91;293;160;564
421850;201507;434;1324;263;914;64;265;74;249;138;514
421860;201507;353;1072;217;775;36;137;43;136;79;273
421870;201507;4393;12394;2976;9508;831;2865;608;1871;1439;4736
421875;201507;438;1293;186;686;38;159;30;101;68;260
421880;201507;911;2826;678;2313;157;611;173;542;330;1153
421885;201507;314;992;249;863;83;311;83;266;166;577
421890;201507;931;3112;786;2817;249;1024;258;875;507;1899
421895;201507;365;1205;323;1125;76;263;178;643;254;906
421900;201507;805;2397;567;1871;157;560;148;411;305;971
421910;201507;536;1686;365;1299;76;321;93;283;169;604
421915;201507;565;1685;361;1193;68;228;100;288;168;516
421917;201507;577;1709;421;1448;122;506;128;396;250;902
421920;201507;804;2246;525;1861;232;880;159;547;391;1427
421930;201507;3293;8799;1894;6269;469;1738;355;1036;824;2774
421935;201507;708;2321;516;1886;105;441;187;644;292;1085
421940;201507;270;923;140;527;27;116;22;62;49;178
421950;201507;3829;10610;1888;6422;472;1705;313;1042;785;2747
421960;201507;225;682;174;569;44;161;41;112;85;273
421970;201507;2213;6296;1393;4525;491;1694;309;898;800;2592
421985;201507;497;1292;259;807;45;167;72;227;117;394
422000;201507;994;2942;808;2595;199;694;341;1114;540;1808
430003;201507;842;2456;650;2118;183;674;191;601;374;1275
430005;201507;285;898;234;794;43;156;125;410;168;566
430010;201507;2120;5744;1540;4731;389;1252;619;1921;1008;3173
430020;201507;753;1889;620;1704;66;209;438;1155;504;1364
430030;201507;1066;2778;784;2270;258;820;152;393;410;1213
430040;201507;11608;30011;9007;25553;2635;7966;2183;5887;4818;13853
430045;201507;738;1994;570;1652;117;352;284;808;401;1160
430047;201507;275;684;157;480;22;57;65;200;87;257
430050;201507;1196;3215;685;2167;127;434;181;532;308;966
430055;201507;298;817;167;519;27;97;70;200;97;297
430057;201507;69;154;24;66;5;13;5;8;10;21
430060;201507;15855;50816;13610;46773;3702;13499;6084;21171;9786;34670
430063;201507;990;2906;797;2503;195;649;408;1300;603;1949
430064;201507;1529;4480;1242;3970;310;1016;527;1683;837;2699
430066;201507;171;415;125;342;10;35;73;187;83;222
430070;201507;595;1592;224;716;50;182;58;149;108;331
430080;201507;675;1931;419;1433;86;330;121;368;207;698
430085;201507;808;2146;529;1654;116;407;193;598;309;1005
430087;201507;1054;3184;982;3061;134;478;661;1982;795;2460
430090;201507;887;2336;323;1066;35;133;53;175;88;308
430100;201507;871;2286;496;1509;127;427;148;389;275;816
430105;201507;929;2765;629;2184;178;701;186;611;364;1312
430107;201507;269;889;194;676;40;152;54;176;94;328
430110;201507;1865;5355;1532;4810;427;1389;625;1933;1052;3322
430120;201507;1699;5029;1286;4160;265;906;663;2097;928;3003
430130;201507;3797;9946;3268;9161;671;2035;1589;4343;2260;6378
430140;201507;1225;3703;836;2836;231;802;269;890;500;1692
430150;201507;819;2180;538;1646;133;444;138;409;271;853
430155;201507;437;1238;261;868;36;131;103;332;139;463
430160;201507;16324;47767;14619;44904;2822;9550;7647;23427;10469;32977
430163;201507;1849;5452;1517;4844;271;978;732;2329;1003;3307
430165;201507;455;1119;134;436;24;83;37;113;61;196
430170;201507;922;2577;374;1307;59;200;52;152;111;352
430175;201507;950;2974;759;2517;200;611;309;1113;509;1724
430180;201507;901;2446;728;2151;164;541;389;1100;553;1641
430185;201507;689;1725;351;1069;52;169;108;277;160;446
430187;201507;679;2004;509;1634;116;437;182;537;298;974
430190;201507;1717;5089;1474;4618;292;1048;835;2554;1127;3602
430192;201507;198;598;89;280;6;19;22;60;28;79
430195;201507;331;1006;80;277;8;28;5;16;13;44
430200;201507;1518;4832;1270;4294;381;1354;318;1065;699;2419
430205;201507;526;1506;396;1266;44;169;277;872;321;1041
430210;201507;6520;17346;3481;10927;668;2262;732;2074;1400;4336
430215;201507;369;1026;246;762;47;146;92;272;139;418
430220;201507;762;1892;282;918;45;152;53;170;98;322
430222;201507;309;919;236;754;37;149;109;324;146;473
430223;201507;344;985;296;914;66;208;175;558;241;766
430225;201507;40;106;20;63;5;13;7;18;12;31
430230;201507;1817;5307;1690;5178;187;434;1467;4674;1654;5108
430235;201507;277;899;215;748;54;203;59;184;113;387
430237;201507;537;1408;395;1154;46;157;247;699;293;856
430240;201507;998;2596;653;1995;137;495;264;743;401;1238
430245;201507;908;2815;691;2353;171;600;323;1135;494;1735
430250;201507;1273;3602;1100;3293;419;1328;242;712;661;2040
430258;201507;165;462;120;380;13;50;50;157;63;207
430260;201507;844;2366;566;1806;57;192;301;995;358;1187
430265;201507;315;956;238;792;55;176;21;59;76;235
430270;201507;2921;8116;2483;7384;391;1387;1431;4024;1822;5411
430280;201507;4594;12636;3746;11089;875;2707;1699;5000;2574;7707
430290;201507;2425;6378;2217;6093;161;462;1904;5281;2065;5743
430300;201507;9294;27302;7509;23842;1998;6772;3059;9935;5057;16707
430310;201507;6353;19236;5002;16627;1285;4673;1824;5657;3109;10330
430320;201507;866;2504;557;1866;105;297;280;999;385;1296
430330;201507;737;1949;567;1620;160;465;235;613;395;1078
430340;201507;772;1936;429;1409;71;263;212;699;283;962
430350;201507;6170;19009;5160;16853;1801;6170;1694;5411;3495;11581
430355;201507;371;922;142;433;32;105;19;47;51;152
430360;201507;1091;2843;894;2475;171;543;409;1036;580;1579
430367;201507;260;674;159;492;40;140;57;168;97;308
430370;201507;512;1461;383;1206;106;368;91;255;197;623
430380;201507;872;2231;450;1445;123;433;130;409;253;842
430390;201507;4261;12062;2872;9175;658;2243;638;1934;1296;4177
430400;201507;1438;3433;990;2731;311;928;347;872;658;1800
430410;201507;684;1817;497;1500;95;299;235;703;330;1002
430420;201507;3816;10976;2917;8989;774;2465;1208;3649;1982;6114
430430;201507;777;2072;468;1497;132;456;123;381;255;837
430435;201507;2011;5435;1524;4560;340;1104;704;2053;1044;3157
430440;201507;4085;12754;3164;10673;616;2203;1472;5089;2088;7292
430450;201507;7740;21514;5990;18104;2101;6699;1363;4123;3464;10822
430460;201507;28603;83972;21578;71133;5858;21208;7160;23251;13018;44459
430461;201507;514;1385;158;496;24;80;30;87;54;167
430462;201507;310;890;226;741;81;292;56;168;137;460
430463;201507;4035;12775;3463;11681;769;2819;1691;5751;2460;8570
430465;201507;642;1724;532;1534;138;443;267;731;405;1174
430466;201507;3557;9830;3123;9145;595;1929;1797;5124;2392;7053
430467;201507;562;1652;484;1518;98;342;228;680;326;1022
430468;201507;1422;3997;1224;3701;389;1266;426;1246;815;2512
430469;201507;307;868;65;230;7;32;12;32;19;64
430470;201507;7606;20219;5268;16184;1524;5067;955;2788;2479;7855
430471;201507;663;2157;582;1982;178;622;145;509;323;1131
430480;201507;1092;2864;552;1759;89;318;136;372;225;690
430485;201507;225;644;105;352;17;60;33;110;50;170
430490;201507;383;1041;243;775;52;188;103;325;155;513
430495;201507;397;1167;246;849;45;167;50;161;95;328
430500;201507;1260;3484;1021;3073;296;1005;433;1259;729;2264
430510;201507;20025;58883;16054;51286;5511;19341;4563;13521;10074;32862
430511;201507;443;1346;190;657;17;69;26;68;43;137
430512;201507;1198;3088;1017;2771;251;723;357;1017;608;1740
430513;201507;755;2047;475;1444;97;299;196;595;293;894
430515;201507;500;1461;364;1172;64;215;185;597;249;812
430517;201507;1241;3885;1028;3451;203;692;603;2041;806;2733
430520;201507;1635;4526;1139;3500;297;996;379;1065;676;2061
430530;201507;1014;2850;527;1715;83;310;133;399;216;709
430535;201507;2095;6383;1609;5377;359;1353;588;1894;947;3247
430537;201507;494;1559;419;1402;50;165;300;1015;350;1180
430540;201507;766;1701;510;1354;87;232;303;805;390;1037
430543;201507;514;1322;449;1255;84;251;318;901;402;1152
430544;201507;690;2171;572;1921;109;393;302;991;411;1384
430545;201507;1320;4221;1132;3989;380;1413;487;1779;867;3192
430550;201507;678;1949;429;1413;93;336;137;432;230;768
430558;201507;80;230;39;134;14;61;6;14;20;75
430560;201507;429;1057;246;737;27;91;81;229;108;320
430570;201507;1156;2964;729;2116;183;627;287;710;470;1337
430580;201507;1289;3300;740;2340;181;621;246;773;427;1394
430583;201507;164;451;55;184;4;15;4;13;8;28
430585;201507;359;930;226;647;57;189;97;243;154;432
430587;201507;214;652;186;599;57;193;57;190;114;383
430590;201507;1301;3673;1235;3565;173;531;896;2576;1069;3107
430593;201507;29;111;26;100;7;35;11;36;18;71
430595;201507;261;715;89;309;14;58;15;52;29;110
430597;201507;346;1006;247;776;43;152;67;166;110;318
430600;201507;2152;5824;1223;3757;233;769;401;1185;634;1954
430605;201507;1352;4089;1065;3505;231;856;427;1410;658;2266
430607;201507;768;1884;557;1560;81;243;349;999;430;1242
430610;201507;8554;22652;6415;19236;1721;5605;2149;6392;3870;11997
430613;201507;265;644;116;346;26;70;23;57;49;127
430620;201507;747;2145;576;1782;141;462;234;678;375;1140
430630;201507;471;1448;230;767;39;128;32;88;71;216
430632;201507;732;2008;413;1286;73;260;175;483;248;743
430635;201507;709;1941;506;1546;103;348;247;741;350;1089
430637;201507;506;1443;444;1318;62;221;285;807;347;1028
430640;201507;1728;4544;751;2428;71;228;86;170;157;398
430642;201507;489;1295;295;931;53;178;118;362;171;540
430645;201507;247;603;94;275;15;44;24;77;39;121
430650;201507;1874;6070;1607;5542;334;1174;907;3193;1241;4367
430655;201507;173;476;144;417;30;102;68;168;98;270
430660;201507;5675;15984;4420;13761;1128;3828;1777;5477;2905;9305
430670;201507;504;1478;454;1380;38;115;349;1097;387;1212
430673;201507;693;1658;351;1069;80;254;132;394;212;648
430675;201507;276;797;113;362;19;69;46;142;65;211
430676;201507;3513;10531;2915;9461;786;2745;983;3203;1769;5948
430680;201507;1206;3479;779;2539;150;534;239;686;389;1220
430690;201507;4384;12316;3447;10473;1079;3386;992;3040;2071;6426
430692;201507;291;953;211;798;23;99;135;496;158;595
430693;201507;1367;3780;889;2780;155;568;257;725;412;1293
430695;201507;552;1568;388;1224;78;288;151;426;229;714
430697;201507;478;1345;363;1143;101;317;133;447;234;764
430700;201507;9911;25641;4614;15198;835;3085;334;1036;1169;4121
430705;201507;283;854;246;792;82;288;63;176;145;464
430710;201507;1842;4650;1356;3827;295;908;539;1526;834;2434
430720;201507;922;2254;605;1793;140;449;206;596;346;1045
430730;201507;1711;4519;1172;3624;309;936;448;1452;757;2388
430740;201507;571;1584;323;1075;88;314;56;176;144;490
430745;201507;529;1501;281;878;50;177;51;139;101;316
430750;201507;1688;4597;1317;3950;255;854;653;1857;908;2711
430755;201507;577;1524;364;1062;42;140;155;398;197;538
430760;201507;3182;7730;2180;6247;433;1443;976;2886;1409;4329
430770;201507;6735;19295;5138;16299;987;3419;2630;8259;3617;11678
430780;201507;2528;6666;1458;4592;297;1011;457;1390;754;2401
430781;201507;586;1703;397;1316;90;309;117;368;207;677
430783;201507;560;1369;366;1047;66;216;173;456;239;672
430786;201507;79;256;54;189;9;34;24;82;33;116
430790;201507;4693;12745;3158;9640;702;2408;1169;3273;1871;5681
430800;201507;871;2528;579;1837;121;421;196;583;317;1004
430805;201507;528;1456;360;1137;50;155;183;597;233;752
430807;201507;428;1224;288;907;57;209;85;250;142;459
430810;201507;778;2105;369;1199;58;206;69;196;127;402
430820;201507;1257;3856;844;2824;182;659;247;792;429;1451
430825;201507;410;1077;169;512;34;103;43;107;77;210
430830;201507;2078;6259;1906;5997;263;899;1308;4109;1571;5008
430840;201507;983;3005;887;2821;228;739;419;1375;647;2114
430843;201507;102;294;50;163;11;39;17;53;28;92
430845;201507;344;1029;277;893;104;359;24;65;128;424
430850;201507;2611;7669;2180;6849;508;1728;857;2624;1365;4352
430860;201507;1007;2703;514;1684;146;556;145;429;291;985
430865;201507;671;1776;611;1679;212;610;284;753;496;1363
430870;201507;706;1971;381;1253;94;314;80;226;174;540
430880;201507;1286;3604;923;2886;277;939;244;783;521;1722
430885;201507;238;587;136;435;17;59;84;271;101;330
430890;201507;1811;4745;1242;3658;134;468;430;1161;564;1629
430900;201507;2922;7713;2431;6848;517;1712;1192;3117;1709;4829
430905;201507;1058;2987;643;2082;161;567;153;463;314;1030
430910;201507;1557;4588;1098;3617;257;936;435;1317;692;2253
430912;201507;498;1413;398;1233;57;212;249;742;306;954
430915;201507;535;1698;372;1366;111;425;92;361;203;786
430920;201507;15093;45923;13283;42487;2998;10489;7467;23262;10465;33751
430925;201507;108;268;57;175;15;52;28;85;43;137
430930;201507;9485;27272;6523;21451;1774;6297;1760;5925;3534;12222
430940;201507;1222;3673;731;2447;123;460;179;542;302;1002
430950;201507;1113;3080;739;2289;172;601;280;773;452;1374
430955;201507;143;429;65;208;14;49;21;69;35;118
430957;201507;267;882;214;781;54;215;95;348;149;563
430960;201507;1325;3626;1106;3243;322;1048;448;1338;770;2386
430965;201507;1509;4359;1288;3974;92;340;982;2972;1074;3312
430970;201507;543;1510;317;1025;64;221;88;276;152;497
430975;201507;634;2030;484;1673;85;320;240;828;325;1148
430980;201507;433;1078;257;809;64;226;94;265;158;491
430990;201507;618;1949;450;1536;107;389;102;314;209;703
430995;201507;634;1845;510;1591;182;596;170;504;352;1100
431000;201507;1718;4352;842;2580;154;555;96;230;250;785
431010;201507;2736;7642;1610;5326;306;1126;375;1070;681;2196
431020;201507;12180;29871;7716;21825;1929;5623;2184;6127;4113;11750
431030;201507;369;1072;188;647;45;180;39;129;84;309
431033;201507;2397;6983;2098;6529;522;1747;1030;3259;1552;5006
431036;201507;209;532;80;272;15;53;17;46;32;99
431040;201507;975;2765;766;2413;180;645;359;1084;539;1729
431041;201507;545;1490;491;1412;155;455;199;589;354;1044
431043;201507;380;1209;269;947;116;446;69;199;185;645
431046;201507;116;328;80;251;12;44;28;83;40;127
431050;201507;1793;4508;1368;3800;276;867;793;2142;1069;3009
431053;201507;612;1975;502;1735;143;543;129;454;272;997
431055;201507;683;1864;633;1780;51;151;486;1369;537;1520
431057;201507;397;1160;238;819;51;184;62;203;113;387
431060;201507;5739;16745;5214;16006;1521;4612;2542;8114;4063;12726
431065;201507;549;1562;413;1284;70;245;191;552;261;797
431070;201507;751;2166;434;1437;95;326;81;231;176;557
431075;201507;295;898;205;703;33;120;60;215;93;335
431080;201507;624;1952;500;1688;107;412;125;389;232;801
431085;201507;902;2435;714;2069;123;384;402;1142;525;1526
431087;201507;622;1756;536;1587;69;201;360;1080;429;1281
431090;201507;543;1313;252;757;72;218;57;163;129;381
431100;201507;3823;10588;3055;9250;777;2514;1112;3391;1889;5905
431110;201507;1582;4158;1165;3328;244;745;506;1360;750;2105
431112;201507;591;1852;553;1791;155;510;267;845;422;1355
431113;201507;521;1515;397;1259;110;366;108;353;218;719
431115;201507;1412;4068;1227;3745;222;709;738;2257;960;2966
431120;201507;2713;8348;2115;7143;619;2399;730;2250;1349;4649
431123;201507;495;1418;349;1138;74;256;193;644;267;900
431125;201507;1369;4152;998;3352;305;1019;248;898;553;1917
431127;201507;248;659;54;177;5;14;4;11;9;25
431130;201507;3510;9918;2563;8177;536;1917;916;2866;1452;4783
431140;201507;4546;11193;2397;7501;409;1415;561;1509;970;2924
431142;201507;483;1437;435;1345;42;136;310;977;352;1113
431150;201507;1166;3456;877;2878;191;706;333;1068;524;1774
431160;201507;980;2849;821;2526;143;438;409;1359;552;1797
431162;201507;523;1363;236;791;30;131;34;84;64;215
431164;201507;167;468;46;173;8;31;3;12;11;43
431170;201507;768;2121;533;1682;142;483;159;481;301;964
431171;201507;829;2436;697;2170;236;775;189;562;425;1337
431173;201507;494;1428;428;1314;98;321;252;769;350;1090
431175;201507;1093;3046;926;2773;285;897;321;942;606;1839
431177;201507;899;2881;728;2537;237;929;305;1018;542;1947
431179;201507;370;807;87;254;13;44;18;40;31;84
431180;201507;2273;6541;1572;5060;386;1317;395;1158;781;2475
431190;201507;733;1903;366;1179;67;244;81;250;148;494
431198;201507;378;1241;332;1149;139;505;83;298;222;803
431200;201507;377;1058;108;374;20;63;3;10;23;73
431205;201507;296;899;146;497;34;108;49;172;83;280
431210;201507;762;2059;637;1843;174;496;328;976;502;1472
431213;201507;254;762;204;666;43;168;88;271;131;439
431215;201507;331;965;166;560;26;83;13;29;39;112
431217;201507;200;608;150;497;42;149;50;162;92;311
431220;201507;948;2519;597;1803;71;233;294;819;365;1052
431225;201507;1314;3745;1073;3312;225;736;565;1731;790;2467
431230;201507;890;2559;657;2079;81;275;346;1051;427;1326
431235;201507;109;308;31;96;6;21;6;14;12;35
431237;201507;505;1486;394;1322;106;421;189;615;295;1036
431238;201507;45;145;36;124;9;37;11;36;20;73
431240;201507;2973;8899;2581;8264;860;2957;789;2498;1649;5455
431242;201507;369;1164;324;1076;95;320;106;366;201;686
431244;201507;411;967;251;700;40;134;132;336;172;470
431245;201507;1143;2987;827;2408;127;392;475;1357;602;1749
431247;201507;193;547;141;441;48;153;33;98;81;251
431250;201507;1556;4893;1346;4597;367;1343;592;2033;959;3376
431260;201507;357;989;178;604;36;142;59;180;95;322
431261;201507;238;826;206;753;37;168;69;223;106;391
431262;201507;413;1117;180;589;22;92;79;251;101;343
431265;201507;1472;3826;805;2440;157;531;202;497;359;1028
431267;201507;165;456;133;399;26;92;74;208;100;300
431270;201507;2729;6927;1834;5462;476;1575;672;1990;1148;3565
431275;201507;232;701;123;445;36;133;14;38;50;171
431280;201507;298;832;117;399;16;65;25;62;41;127
431290;201507;323;1012;244;828;62;240;52;158;114;398
431295;201507;103;279;56;168;4;14;28;79;32;93
431300;201507;364;910;47;177;6;21;1;6;7;27
431301;201507;266;816;121;408;29;102;22;65;51;167
431303;201507;767;2016;444;1344;68;250;136;372;204;622
431306;201507;2245;5866;1474;4462;171;617;458;1192;629;1809
431308;201507;45;153;40;136;23;83;12;39;35;122
431310;201507;811;2407;482;1654;99;343;138;497;237;840
431320;201507;926;2507;485;1581;102;369;117;349;219;718
431330;201507;2781;6848;1285;4077;348;1238;121;335;469;1573
431333;201507;450;1205;192;588;27;91;58;152;85;243
431335;201507;65;196;49;156;15;48;11;23;26;71
431337;201507;2399;7289;1757;5945;410;1474;332;1044;742;2518
431339;201507;656;1789;449;1358;79;255;202;590;281;845
431340;201507;25720;68091;18437;55284;4279;13973;5348;15559;9627;29532
431342;201507;527;1361;428;1190;136;409;208;543;344;952
431344;201507;356;987;260;812;14;45;197;624;211;669
431346;201507;334;855;146;445;31;99;31;93;62;192
431349;201507;709;2034;478;1473;99;309;146;436;245;745
431350;201507;4055;11833;3324;10481;684;2449;1427;4265;2111;6714
431360;201507;698;1794;463;1395;117;380;139;419;256;799
431365;201507;1188;3507;1007;3201;277;949;473;1539;750;2488
431370;201507;4908;13880;3855;12038;1076;3633;1270;3956;2346;7589
431380;201507;956;2970;888;2825;122;428;579;1806;701;2234
431390;201507;3234;8530;1960;6097;396;1397;558;1549;954;2946
431395;201507;1257;3712;1052;3368;241;888;518;1590;759;2478
431400;201507;311;968;158;543;37;140;21;52;58;192
431402;201507;1310;3077;736;2060;151;452;364;979;515;1431
431403;201507;275;797;194;651;52;191;34;113;86;304
431405;201507;4198;11585;3331;10313;673;2373;1689;5080;2362;7453
431406;201507;794;2421;581;1957;171;618;249;817;420;1435
431407;201507;562;1624;364;1216;91;309;96;288;187;597
431410;201507;14129;40629;9652;31757;2886;10626;1332;4260;4218;14886
431413;201507;223;548;104;325;10;34;37;107;47;141
431415;201507;749;2084;553;1727;126;459;224;627;350;1086
431417;201507;637;1571;516;1398;70;197;302;834;372;1031
431420;201507;1401;3867;1219;3580;251;774;590;1844;841;2618
431430;201507;520;1356;315;944;60;192;107;282;167;474
431440;201507;23198;64847;18737;57563;5431;17687;6624;21163;12055;38850
431442;201507;144;402;92;275;17;58;13;23;30;81
431445;201507;515;1453;226;714;33;106;84;254;117;360
431446;201507;473;1382;330;1087;77;266;119;384;196;650
431447;201507;701;1979;508;1583;106;353;215;661;321;1014
431449;201507;819;2281;642;1957;67;214;385;1172;452;1386
431450;201507;2151;5435;1911;5082;325;945;1365;3560;1690;4505
431454;201507;63;225;54;202;14;53;21;85;35;138
431455;201507;723;1843;379;1090;109;310;100;269;209;579
431460;201507;3464;9577;2924;8545;814;2422;976;2958;1790;5380
431470;201507;1879;5522;1433;4509;353;1102;517;1657;870;2759
431475;201507;179;517;43;167;7;29;2;6;9;35
431477;201507;735;1915;488;1427;57;176;271;763;328;939
431478;201507;270;691;101;301;20;59;20;53;40;112
431480;201507;3036;8348;2220;6863;579;1980;799;2331;1378;4311
431490;201507;111039;300462;94358;275379;11872;40963;65563;186403;77435;227366
431500;201507;720;1946;546;1611;115;346;268;763;383;1109
431505;201507;506;1216;356;1001;30;75;248;714;278;789
431507;201507;352;861;222;605;41;106;129;339;170;445
431510;201507;2096;5751;1650;4945;377;1209;687;1950;1064;3159
431513;201507;295;797;131;417;21;70;65;202;86;272
431514;201507;104;263;37;125;4;18;2;5;6;23
431515;201507;721;2079;490;1511;101;360;186;475;287;835
431517;201507;80;254;70;228;16;54;22;58;38;112
431520;201507;483;1344;260;836;37;134;59;181;96;315
431530;201507;4278;10171;3226;8918;1096;3256;988;2878;2084;6134
431531;201507;290;820;186;605;38;124;65;212;103;336
431532;201507;509;1425;434;1257;115;359;175;501;290;860
431535;201507;370;986;175;527;29;92;59;157;88;249
431540;201507;2138;6997;1876;6603;233;790;1230;4578;1463;5368
431545;201507;308;840;51;172;5;18;8;32;13;50
431550;201507;2306;6747;2025;6233;369;1293;959;2842;1328;4135
431555;201507;722;1835;573;1601;107;299;347;980;454;1279
431560;201507;18924;57075;13556;46364;3443;13074;3454;12227;6897;25301
431570;201507;5308;14709;4656;13668;1278;3838;2216;6623;3494;10461
431575;201507;434;1101;300;875;46;160;80;205;126;365
431580;201507;681;1918;425;1355;85;310;146;423;231;733
431590;201507;997;2715;611;1910;90;272;248;778;338;1050
431595;201507;474;1348;370;1132;60;186;189;580;249;766
431600;201507;1980;5529;1372;4373;300;1156;333;949;633;2105
431610;201507;1458;4283;1081;3528;225;760;437;1415;662;2175
431620;201507;465;1378;229;738;58;200;94;274;152;474
431630;201507;1474;3928;976;2909;258;786;361;1052;619;1838
431640;201507;6063;17392;5416;16396;1141;3903;2969;8850;4110;12753
431642;201507;518;1397;412;1208;62;208;198;557;260;765
431643;201507;167;408;137;355;14;41;70;158;84;199
431645;201507;1815;5163;1564;4749;308;992;878;2657;1186;3649
431647;201507;176;502;110;344;22;72;21;54;43;126
431650;201507;307;938;211;741;33;133;50;148;83;281
431660;201507;1194;3329;727;2348;157;553;168;471;325;1024
431670;201507;1308;3455;973;2848;207;694;416;1138;623;1832
431673;201507;237;649;133;425;25;88;26;71;51;159
431675;201507;636;1706;178;594;29;104;35;88;64;192
431680;201507;10254;27593;7449;22472;2008;6482;2003;6055;4011;12537
431690;201507;24113;66825;18679;57775;5124;16971;6729;21298;11853;38269
431695;201507;135;407;93;303;21;72;20;44;41;116
431697;201507;454;1296;399;1190;99;296;190;587;289;883
431700;201507;1601;4515;1343;4013;242;772;732;2120;974;2892
431710;201507;12719;36885;10237;32667;3281;11315;2546;8532;5827;19847
431720;201507;7280;19985;5515;16559;1176;3873;2118;6173;3294;10046
431725;201507;16;50;12;40;1;4;5;13;6;17
431730;201507;3889;11415;3027;9812;827;2959;812;2677;1639;5636
431740;201507;5271;14729;4176;12696;1389;4653;823;2271;2212;6924
431750;201507;9533;26783;8127;24479;1749;5694;4013;12263;5762;17957
431755;201507;324;867;70;242;13;45;11;32;24;77
431760;201507;3855;11138;3078;9692;706;2422;1085;3253;1791;5675
431770;201507;2096;5565;1721;4967;331;993;971;2763;1302;3756
431775;201507;216;583;148;456;50;160;21;55;71;215
431780;201507;2468;6604;1859;5461;481;1502;444;1200;925;2702
431790;201507;1262;3858;1048;3437;186;657;571;1897;757;2554
431795;201507;394;1085;248;760;40;137;88;260;128;397
431800;201507;8901;26177;6990;22458;2140;7449;1409;4311;3549;11760
431805;201507;328;789;99;334;15;56;15;50;30;106
431810;201507;3440;9484;2656;7886;510;1651;1190;3429;1700;5080
431820;201507;2660;8249;2285;7500;476;1706;938;2977;1414;4683
431830;201507;10820;26725;8376;23072;2379;7097;3268;9062;5647;16159
431840;201507;2744;8138;2341;7430;591;2023;1026;3273;1617;5296
431842;201507;810;2016;360;1079;55;186;89;220;144;406
431843;201507;355;1031;293;922;38;133;154;470;192;603
431844;201507;238;646;109;355;21;82;29;74;50;156
431845;201507;523;1539;422;1320;38;129;272;868;310;997
431846;201507;373;1123;330;1060;37;145;233;735;270;880
431848;201507;236;639;124;412;14;45;26;82;40;127
431849;201507;439;1075;94;289;20;64;16;37;36;101
431850;201507;4922;14238;4290;13035;1039;3358;1748;5269;2787;8627
431860;201507;799;2101;590;1747;108;358;283;771;391;1129
431861;201507;97;298;57;207;7;23;10;35;17;58
431862;201507;469;1519;372;1319;114;465;82;252;196;717
431870;201507;18554;52549;14225;44921;3641;12555;4596;14376;8237;26931
431880;201507;4369;12939;3424;10952;784;2775;1380;4265;2164;7040
431890;201507;5273;14165;3874;11657;1191;3833;1105;3353;2296;7186
431900;201507;1085;3076;708;2306;186;685;280;824;466;1509
431910;201507;1028;2431;470;1349;81;236;148;380;229;616
431912;201507;620;1764;481;1506;142;424;154;517;296;941
431915;201507;1372;3699;1036;3102;240;768;405;1198;645;1966
431920;201507;1356;3763;1186;3499;123;363;907;2681;1030;3044
431930;201507;1267;3468;906;2857;232;710;428;1428;660;2138
431935;201507;73;223;58;192;16;61;21;61;37;122
431936;201507;389;1145;297;940;51;156;151;506;202;662
431937;201507;342;886;193;583;46;153;37;94;83;247
431940;201507;2650;7173;1698;5270;405;1348;450;1341;855;2689
431950;201507;1638;4973;1404;4554;279;1018;649;2001;928;3019
431960;201507;2992;8665;2603;7899;668;2159;880;2602;1548;4761
431970;201507;493;1331;248;790;38;147;59;161;97;308
431971;201507;105;290;74;233;10;29;26;69;36;98
431973;201507;493;1695;426;1549;55;199;256;971;311;1170
431975;201507;96;215;16;63;5;25;3;10;8;35
431980;201507;1425;4115;1160;3574;273;915;380;1098;653;2013
431990;201507;7956;21932;5916;18440;1088;3928;1990;5808;3078;9736
432000;201507;10343;28687;7985;24535;2464;7974;2757;8383;5221;16357
432010;201507;2284;6455;1861;5680;400;1300;868;2624;1268;3924
432020;201507;2369;5804;1840;5101;217;655;1307;3599;1524;4254
432023;201507;533;1532;350;1130;78;274;101;294;179;568
432026;201507;1284;3831;935;3076;151;487;502;1644;653;2131
432030;201507;410;1196;308;970;61;196;144;431;205;627
432032;201507;600;1549;392;1165;71;223;179;490;250;713
432035;201507;824;2526;720;2327;202;680;348;1139;550;1819
432040;201507;969;2267;463;1428;99;345;127;350;226;695
432045;201507;224;661;136;485;28;108;52;193;80;301
432050;201507;672;1875;572;1689;96;287;336;1028;432;1315
432055;201507;853;2545;682;2209;128;456;406;1282;534;1738
432057;201507;419;1048;317;873;45;123;208;552;253;675
432060;201507;516;1368;191;651;37;141;42;127;79;268
432065;201507;219;625;169;535;41;146;65;192;106;338
432067;201507;994;3052;715;2433;149;547;357;1204;506;1751
432070;201507;2413;6579;1557;4818;363;1219;373;1057;736;2276
432080;201507;3680;10487;3120;9491;971;3124;1046;3164;2017;6288
432085;201507;313;866;204;685;43;159;105;355;148;514
432090;201507;1466;4186;1143;3514;367;1217;412;1179;779;2396
432100;201507;1320;3807;660;2240;130;460;89;234;219;694
432110;201507;2678;8024;1984;6574;499;1869;266;746;765;2615
432120;201507;5084;14907;4250;13450;1596;5432;1252;3848;2848;9280
432130;201507;2604;7262;2082;6572;667;2301;826;2603;1493;4904
432132;201507;433;1230;210;719;26;103;74;237;100;340
432135;201507;703;2139;666;2070;83;285;500;1527;583;1812
432140;201507;2021;6373;1596;5545;380;1377;683;2468;1063;3845
432143;201507;1402;4107;1162;3694;227;739;574;1897;801;2636
432145;201507;1148;3517;692;2419;138;539;118;364;256;903
432146;201507;209;656;137;484;35;139;34;110;69;249
432147;201507;661;2064;489;1684;132;481;163;579;295;1060
432149;201507;371;1049;226;705;50;161;91;288;141;449
432150;201507;3761;10423;2735;8523;616;2132;855;2512;1471;4644
432160;201507;4382;13680;3793;12682;1158;4018;1426;4949;2584;8967
432162;201507;395;950;74;237;10;37;15;40;25;77
432163;201507;403;1068;91;291;5;17;5;18;10;35
432166;201507;732;2156;596;1880;89;333;305;918;394;1251
432170;201507;1027;3213;655;2385;135;500;120;424;255;924
432180;201507;2945;7788;2003;6112;528;1704;551;1653;1079;3357
432183;201507;429;1326;340;1140;148;525;62;194;210;719
432185;201507;925;2490;569;1812;115;379;239;758;354;1137
432190;201507;3376;9223;2258;6730;553;1757;661;1799;1214;3556
432195;201507;1233;3332;1004;2990;124;408;652;1900;776;2308
432200;201507;3229;9634;2553;8474;656;2383;1151;3859;1807;6242
432210;201507;428;1166;312;971;73;263;132;369;205;632
432215;201507;873;2684;740;2470;141;445;450;1598;591;2043
432218;201507;296;777;206;602;39;113;73;190;112;303
432220;201507;4287;11244;3486;10006;358;1212;2218;6204;2576;7416
432225;201507;68;211;58;194;24;86;19;59;43;145
432230;201507;1096;2926;640;1930;153;510;166;396;319;906
432232;201507;556;1599;432;1359;92;316;170;528;262;844
432234;201507;416;1132;272;803;62;178;86;242;148;420
432235;201507;79;227;43;144;9;39;7;17;16;56
432237;201507;472;1304;431;1239;23;93;330;915;353;1008
432240;201507;14114;44516;11793;41322;2057;8388;6787;24426;8844;32814
432250;201507;4901;16605;4398;15592;1537;5974;1387;4874;2924;10848
432252;201507;388;1092;278;904;55;194;152;495;207;689
432253;201507;1327;4174;881;3047;241;905;178;593;419;1498
432254;201507;821;2222;230;762;52;188;29;80;81;268
432255;201507;241;614;128;420;30;103;38;117;68;220
432260;201507;7614;18922;5175;14881;1182;3471;2061;6146;3243;9617
432270;201507;2574;7587;2141;6839;595;1939;845;2779;1440;4718
432280;201507;1332;3653;678;2201;118;418;161;451;279;869
432285;201507;184;588;57;199;11;44;10;26;21;70
432290;201507;576;1694;366;1213;88;295;112;362;200;657
432300;201507;23158;68689;20277;63706;4015;13680;11578;35959;15593;49639
432310;201507;862;2513;691;2220;147;531;370;1155;517;1686
432320;201507;249;628;120;371;27;83;23;60;50;143
432330;201507;313;824;127;421;15;50;12;36;27;86
432335;201507;206;594;87;298;20;73;9;29;29;102
432340;201507;369;915;176;536;31;97;58;171;89;268
432345;201507;679;1883;620;1787;90;335;377;999;467;1334
432350;201507;403;1085;217;711;39;127;70;214;109;341
432360;201507;171;526;33;123;11;49;9;28;20;77
432370;201507;430;1209;339;1023;37;101;225;694;262;795
432375;201507;805;2021;617;1718;82;227;363;1024;445;1251
432377;201507;191;612;52;167;10;31;16;37;26;68
432380;201507;833;2799;742;2631;283;1116;278;916;561;2032
500020;201507;2270;6759;1701;5708;381;1511;690;2182;1071;3693
500025;201507;1225;2969;769;2149;96;279;435;1191;531;1470
500060;201507;6660;19655;5330;17453;701;2412;3446;11660;4147;14072
500070;201507;4110;11963;3424;10761;692;2477;1552;4799;2244;7276
500080;201507;1514;4456;1109;3699;289;1069;390;1300;679;2369
500085;201507;2214;5768;1585;4822;180;591;928;2722;1108;3313
500090;201507;2329;6686;1723;5580;348;1173;830;2748;1178;3921
500100;201507;2528;7352;2153;6670;474;1721;974;2822;1448;4543
500110;201507;8625;25037;6811;22200;1123;3973;3576;12276;4699;16249
500124;201507;1986;6359;1706;5899;333;1075;915;3486;1248;4561
500150;201507;1405;3497;1004;2847;197;677;450;1087;647;1764
500190;201507;4866;12557;3794;11139;728;2294;2148;6443;2876;8737
500200;201507;2462;6154;1833;5044;362;1094;775;2002;1137;3096
500210;201507;4802;14259;3990;12960;885;3058;1926;6284;2811;9342
500215;201507;1626;4961;1291;4274;227;833;515;1627;742;2460
500220;201507;2906;9095;2381;8174;496;1825;939;3301;1435;5126
500230;201507;2658;6720;1982;5730;480;1514;870;2534;1350;4048
500240;201507;4706;14574;3342;11744;530;2002;1240;4622;1770;6624
500260;201507;2675;6859;1956;5722;307;995;939;2598;1246;3593
500270;201507;118468;302930;73391;224129;17780;58613;17004;50954;34784;109567
500280;201507;1384;3717;1157;3417;106;336;868;2603;974;2939
500290;201507;4253;9892;2483;7211;536;1774;821;2206;1357;3980
500295;201507;2582;7640;1698;5566;314;1129;405;1115;719;2244
500310;201507;825;2114;681;1908;149;490;330;868;479;1358
500315;201507;3087;9591;2583;8810;405;1410;1597;5654;2002;7064
500320;201507;16556;52535;13068;45934;3849;14598;4016;14816;7865;29414
500325;201507;3955;10076;2849;8336;605;1949;1455;4202;2060;6151
500330;201507;6454;17171;4756;14064;897;2898;2207;6388;3104;9286
500345;201507;2164;5640;1674;4849;283;912;924;2619;1207;3531
500348;201507;2352;6681;2050;6191;148;541;1528;4563;1676;5104
500350;201507;1230;3709;745;2571;99;370;227;807;326;1177
500370;201507;23016;69250;17166;58298;3875;14794;5252;17761;9127;32555
500375;201507;2927;7965;2139;6465;483;1547;675;2002;1158;3549
500380;201507;2891;8143;2387;7270;721;2264;871;2682;1592;4946
500390;201507;598;1267;370;945;36;111;248;589;284;700
500400;201507;1301;3914;955;3091;217;782;255;724;472;1506
500410;201507;2230;6227;1769;5540;457;1586;804;2495;1261;4081
500430;201507;2421;6968;1929;6257;405;1469;854;2831;1259;4300
500440;201507;1382;3730;1033;3166;199;680;492;1449;691;2129
500450;201507;1724;5182;1268;4285;270;1041;267;775;537;1816
500460;201507;3600;10817;2769;9165;740;2719;646;2047;1386;4766
500470;201507;3013;8768;2037;6632;527;1908;299;861;826;2769
500480;201507;2062;6449;1913;6257;180;584;1479;5073;1659;5657
500490;201507;975;2675;753;2290;215;752;219;646;434;1398
500500;201507;3590;11165;2813;9964;1111;4473;725;2503;1836;6976
500510;201507;849;2200;536;1646;74;254;230;646;304;900
500515;201507;1826;4867;1507;4434;247;753;874;2785;1121;3538
500520;201507;3003;10207;2667;9699;439;1729;1671;6195;2110;7924
500525;201507;1160;3664;927;3209;195;767;422;1477;617;2244
500540;201507;6122;16791;3486;11705;949;3734;513;1467;1462;5201
500560;201507;4588;14992;4177;14357;534;2038;2994;10302;3528;12340
500568;201507;3896;9977;2759;8226;568;1977;1087;3012;1655;4989
500570;201507;7461;19833;4900;14986;1302;4258;1170;3415;2472;7673
500580;201507;3678;10405;2917;9140;299;1005;2034;6425;2333;7430
500600;201507;3765;9995;2467;7522;555;1845;841;2495;1396;4340
500620;201507;7649;21681;5725;18064;1160;4037;2579;8134;3739;12171
500625;201507;730;2172;438;1519;95;364;123;409;218;773
500627;201507;517;1514;404;1316;85;287;107;370;192;657
500630;201507;6016;16271;4306;13380;1078;3730;1391;4160;2469;7890
500635;201507;2568;9920;2141;9227;320;1311;1325;6294;1645;7605
500640;201507;1612;3892;1227;3336;93;297;888;2366;981;2663
500660;201507;18826;53745;14475;46616;4192;15273;4550;14443;8742;29716
500690;201507;2812;8003;2214;7228;876;2969;726;2584;1602;5553
500710;201507;3659;10809;3072;9806;653;2361;1435;4478;2088;6839
500720;201507;5915;15663;3735;11793;1019;3511;993;3001;2012;6512
500730;201507;976;2707;680;2108;157;552;218;640;375;1192
500740;201507;3925;10811;3217;9487;435;1568;1442;4287;1877;5855
500750;201507;859;2391;751;2240;137;417;455;1390;592;1807
500755;201507;1227;3567;838;2735;188;688;225;604;413;1292
500769;201507;5000;13255;2964;9000;545;1879;691;1742;1236;3621
500770;201507;1716;5033;1268;4194;335;1233;380;1258;715;2491
500780;201507;1052;3050;853;2683;224;779;289;831;513;1610
500790;201507;9172;25288;7632;22627;1353;4633;4232;12104;5585;16737
500793;201507;2251;6472;1738;5564;429;1501;528;1509;957;3010
500795;201507;2453;7176;2077;6644;262;733;1496;5063;1758;5796
500797;201507;839;2239;592;1814;100;328;226;643;326;971
500800;201507;2698;7327;2102;6506;802;2826;627;1931;1429;4757
500830;201507;18305;49349;12395;37989;2599;8777;3934;11378;6533;20155
500840;201507;1303;3627;899;2813;119;403;381;1131;500;1534
510010;201507;1201;3673;1029;3376;283;929;495;1664;778;2593
510020;201507;3318;9434;2092;6925;464;1653;617;1913;1081;3566
510025;201507;7805;22569;6268;19790;1454;5088;2339;6836;3793;11924
510030;201507;1712;4699;1404;4206;309;1052;647;1804;956;2856
510035;201507;837;2356;658;2103;122;393;376;1222;498;1615
510040;201507;1677;4538;1278;3945;219;751;692;2137;911;2888
510050;201507;1867;5395;1326;4360;356;1275;391;1256;747;2531
510060;201507;1560;4452;1155;3661;233;792;445;1357;678;2149
510080;201507;1163;3582;897;3056;269;1024;183;552;452;1576
510100;201507;671;1792;473;1398;53;171;217;603;270;774
510120;201507;311;666;194;517;20;56;117;315;137;371
510125;201507;3043;8024;2339;6761;417;1472;998;2604;1415;4076
510130;201507;1854;5011;1486;4408;381;1189;539;1597;920;2786
510140;201507;2911;9332;2332;8417;931;3764;541;1716;1472;5480
510160;201507;1357;4518;1248;4365;150;591;907;3165;1057;3756
510170;201507;5408;16170;4405;14401;834;3035;2116;6672;2950;9707
510180;201507;11939;31100;8379;25449;2395;7651;2685;9018;5080;16669
510185;201507;1346;3928;1095;3599;152;470;729;2622;881;3092
510190;201507;2166;6442;1514;5433;339;1334;699;2589;1038;3923
510250;201507;13829;41997;11704;38863;3470;12546;4692;15966;8162;28512
510260;201507;2214;8857;1924;8242;592;2666;776;3702;1368;6368
510263;201507;4219;11205;3006;9180;735;2395;907;2628;1642;5023
510267;201507;5734;16510;4114;13067;950;3284;1211;3625;2161;6909
510268;201507;810;2374;696;2207;136;459;394;1237;530;1696
510269;201507;1010;3070;760;2586;246;873;203;690;449;1563
510270;201507;2648;8504;2284;7780;391;1378;1093;3716;1484;5094
510279;201507;1950;6023;1574;5140;440;1573;451;1288;891;2861
510285;201507;1358;3990;1055;3455;278;990;374;1173;652;2163
510300;201507;3283;9632;2724;8816;211;803;2085;6755;2296;7558
510305;201507;1516;4642;1177;3981;295;1073;393;1294;688;2367
510310;201507;824;2488;698;2247;220;755;229;696;449;1451
510320;201507;3710;10696;2861;9103;792;2918;666;1960;1458;4878
510325;201507;5259;16624;4469;15532;1165;4175;2704;9677;3869;13852
510330;201507;2763;8645;2205;7651;566;2202;771;2626;1337;4828
510335;201507;4699;14209;3884;13164;503;1637;2804;10069;3307;11706
510336;201507;585;1766;450;1513;85;312;226;749;311;1061
510337;201507;2104;6847;1714;6085;669;2404;422;1623;1091;4027
510340;201507;66639;186432;50127;160456;18010;63522;10478;34995;28488;98517
510343;201507;1056;3083;924;2897;86;285;711;2268;797;2553
510345;201507;1647;4829;1336;4263;324;1094;472;1448;796;2542
510350;201507;3338;9073;2558;7970;599;1952;1224;3992;1823;5944
510360;201507;1770;4355;1139;3581;130;491;779;2392;909;2883
510370;201507;1081;3657;939;3437;200;766;573;2159;773;2925
510380;201507;540;1631;373;1292;138;521;47;139;185;660
510385;201507;945;3513;696;2939;102;460;327;1487;429;1947
510390;201507;1104;3376;1018;3276;272;705;642;2320;914;3025
510395;201507;737;1824;552;1567;88;270;241;787;329;1057
510410;201507;3766;12234;3348;11390;806;2870;1748;6030;2554;8900
510420;201507;2395;6090;1730;4974;208;746;898;2521;1106;3267
510450;201507;589;1596;430;1347;96;341;157;465;253;806
510452;201507;616;1988;431;1562;93;377;189;658;282;1035
510454;201507;838;2672;714;2429;112;397;458;1600;570;1997
510455;201507;958;2954;712;2438;140;552;227;731;367;1283
510460;201507;2219;5802;1708;5058;221;808;995;2771;1216;3579
510480;201507;4514;12036;3175;9545;762;2400;742;2081;1504;4481
510490;201507;1415;4571;1243;4306;246;993;749;2502;995;3495
510500;201507;1494;4442;1024;3488;246;971;403;1305;649;2276
510510;201507;2655;9204;2290;8549;731;3014;824;3012;1555;6026
510515;201507;6038;18352;4549;15083;1040;3823;1158;3614;2198;7437
510517;201507;1715;5084;1411;4525;451;1495;461;1463;912;2958
510520;201507;2023;4821;1465;4102;70;234;1063;3085;1133;3319
510523;201507;1004;2964;873;2755;147;471;583;1893;730;2364
510525;201507;7863;20098;5152;15769;1084;3473;1919;5849;3003;9322
510530;201507;514;1448;429;1328;56;251;266;770;322;1021
510550;201507;2563;8419;2145;7637;629;2424;718;2510;1347;4934
510558;201507;1942;5534;1607;5042;351;1216;778;2479;1129;3695
510560;201507;1638;5060;1086;4096;311;1272;255;976;566;2248
510562;201507;5352;15817;4184;13451;1175;4156;1163;3735;2338;7891
510590;201507;2997;7913;2426;7176;564;1725;1192;3615;1756;5340
510600;201507;1571;4067;1044;3190;188;627;427;1223;615;1850
510610;201507;2774;7907;2351;7304;167;590;1828;5684;1995;6274
510615;201507;2277;6894;1916;6319;564;1990;920;3078;1484;5068
510617;201507;576;1713;468;1521;39;107;364;1247;403;1354
510618;201507;1418;4138;1010;3317;183;701;451;1409;634;2110
510619;201507;813;2243;473;1594;72;262;72;200;144;462
510620;201507;1476;3640;790;2562;204;738;125;376;329;1114
510621;201507;937;3271;826;3030;221;887;269;941;490;1828
510622;201507;3743;11295;2539;8685;664;2471;343;927;1007;3398
510623;201507;3433;9788;2740;8500;727;2426;1085;3202;1812;5628
510624;201507;1342;3997;954;3230;198;765;298;880;496;1645
510625;201507;2150;6079;1646;5229;426;1504;380;1150;806;2654
510626;201507;1532;4094;997;3331;311;1174;306;1015;617;2189
510627;201507;727;2063;484;1548;117;413;120;375;237;788
510628;201507;1597;3932;1131;3300;116;379;806;2333;922;2712
510629;201507;1686;5413;1375;4736;403;1568;469;1524;872;3092
510630;201507;2525;8498;1901;7188;491;2102;392;1455;883;3557
510631;201507;367;1033;328;970;39;108;247;728;286;836
510637;201507;2654;7690;2278;7082;606;2019;963;2993;1569;5012
510642;201507;4615;15163;3977;14232;1184;4644;1768;6501;2952;11145
510645;201507;946;2132;590;1638;187;503;178;528;365;1031
510650;201507;6151;20706;5619;20063;1219;4454;3762;14003;4981;18457
510665;201507;1304;3590;892;2796;219;713;287;880;506;1593
510670;201507;394;887;205;615;21;83;97;275;118;358
510675;201507;6315;19862;5056;17349;1425;5528;1253;4077;2678;9605
510677;201507;2076;5459;1649;4915;200;613;1225;3809;1425;4422
510680;201507;749;2244;585;1911;121;440;203;597;324;1037
510682;201507;2219;6933;1718;5971;446;1742;414;1338;860;3080
510685;201507;940;2507;761;2261;80;277;516;1508;596;1785
510700;201507;4315;11181;2935;9192;633;2066;1471;4735;2104;6801
510704;201507;8963;23905;7362;21361;1472;4777;3868;10937;5340;15714
510706;201507;1822;5511;1313;4697;303;1109;697;2589;1000;3698
510710;201507;3406;9420;2391;7352;582;1886;588;1583;1170;3469
510715;201507;692;1701;432;1228;95;299;152;391;247;690
510718;201507;2162;5448;1484;4694;680;2233;443;1491;1123;3724
510719;201507;437;999;277;789;30;125;134;355;164;480
510720;201507;1140;2740;914;2462;215;642;476;1215;691;1857
510724;201507;772;2323;634;2063;141;520;318;974;459;1494
510726;201507;622;1616;468;1364;96;302;180;480;276;782
510729;201507;752;1863;446;1314;100;336;167;481;267;817
510730;201507;2547;7603;2064;6753;550;2006;685;2134;1235;4140
510735;201507;1091;3602;850;3197;197;839;408;1521;605;2360
510740;201507;1093;2693;797;2250;189;509;414;1218;603;1727
510757;201507;661;2253;544;2013;167;642;203;768;370;1410
510760;201507;28862;75554;19895;60487;5831;19227;5361;15835;11192;35062
510770;201507;4328;11213;3713;10497;363;976;2535;7997;2898;8973
510774;201507;411;1144;349;1045;73;262;162;499;235;761
510775;201507;735;2114;606;1904;209;722;168;495;377;1217
510776;201507;526;1478;400;1204;86;282;179;527;265;809
510777;201507;1605;4789;1215;4243;174;651;911;3225;1085;3876
510779;201507;659;1943;483;1610;78;274;228;780;306;1054
510780;201507;3635;10921;3038;9970;765;2613;1356;4660;2121;7273
510785;201507;1812;5189;1370;4431;445;1492;337;1096;782;2588
510787;201507;2137;6449;1680;5638;617;2180;372;1193;989;3373
510788;201507;526;1389;379;1166;167;519;90;305;257;824
510790;201507;15583;45048;10396;35049;2382;9234;1251;4006;3633;13240
510792;201507;7348;22288;5100;17845;1081;4312;983;3136;2064;7448
510794;201507;1177;3736;978;3361;344;1306;296;932;640;2238
510795;201507;8188;24281;5879;19870;1560;5832;1410;4848;2970;10680
510800;201507;1626;4561;1306;4090;310;1086;557;1607;867;2693
510805;201507;1881;5266;1524;4740;186;594;1094;3448;1280;4042
510810;201507;675;1635;516;1423;140;387;235;627;375;1014
510820;201507;743;1771;507;1419;95;311;202;497;297;808
510830;201507;664;2114;565;1965;152;565;283;1063;435;1628
510835;201507;644;1945;481;1610;132;498;180;547;312;1045
510840;201507;49372;120404;38251;106111;8763;25587;18934;53985;27697;79572
510850;201507;1464;4147;1071;3456;341;1227;183;444;524;1671
510860;201507;2464;7968;1816;6599;702;2792;106;345;808;3137
510880;201507;655;2154;560;1991;168;647;251;919;419;1566
510885;201507;622;1734;496;1564;93;332;200;620;293;952
510890;201507;862;2683;694;2410;211;839;258;803;469;1642
510895;201507;1083;3365;918;3049;245;932;393;1237;638;2169
520005;201507;1323;4208;1176;3993;324;1161;548;1892;872;3053
520010;201507;1629;5467;1326;4824;511;2155;268;840;779;2995
520013;201507;3568;9826;2643;8124;589;1903;1000;3054;1589;4957
520015;201507;443;1283;365;1159;89;298;142;457;231;755
520017;201507;1076;3194;900;2902;242;863;360;1076;602;1939
520020;201507;399;1055;312;930;69;221;138;402;207;623
520025;201507;24956;77880;23851;76589;2429;8337;19696;63386;22125;71723
520030;201507;4451;13913;3756;12769;790;2949;1795;6117;2585;9066
520050;201507;310;830;249;730;18;49;182;540;200;589
520055;201507;716;2180;621;1981;119;373;325;1065;444;1438
520060;201507;1365;4237;1169;3844;247;930;474;1487;721;2417
520080;201507;1696;5090;1451;4745;324;1034;823;2823;1147;3857
520082;201507;901;2618;799;2452;131;368;504;1652;635;2020
520085;201507;928;2842;784;2559;162;549;258;833;420;1382
520090;201507;960;2198;700;1866;163;401;353;1021;516;1422
520110;201507;41063;118960;31744;104558;11424;42627;6652;21223;18076;63850
520120;201507;183;514;125;412;30;122;34;99;64;221
520130;201507;3384;9570;3057;9061;745;2418;1457;4235;2202;6653
520140;201507;38478;123930;33039;113635;11204;42185;7421;24492;18625;66677
520145;201507;368;966;287;842;74;232;120;337;194;569
520150;201507;511;1336;401;1207;62;211;251;753;313;964
520160;201507;797;2262;651;2043;210;693;188;594;398;1287
520170;201507;3933;9321;3142;8416;283;792;2531;6901;2814;7693
520180;201507;2017;5890;1640;5276;373;1407;663;2036;1036;3443
520215;201507;1847;4790;1560;4344;206;593;1013;2854;1219;3447
520235;201507;706;1841;522;1565;115;387;221;628;336;1015
520250;201507;1352;4082;1052;3556;265;989;380;1281;645;2270
520260;201507;782;1999;532;1537;78;241;228;631;306;872
520280;201507;498;1480;457;1425;166;554;166;583;332;1137
520310;201507;1080;2634;829;2260;218;611;327;967;545;1578
520320;201507;1758;5468;1444;4854;150;526;902;3095;1052;3621
520330;201507;2609;8097;1994;7018;568;2224;379;1246;947;3470
520340;201507;1727;4344;1341;3863;192;491;932;2833;1124;3324
520350;201507;3028;8298;2369;7081;573;1913;1007;2887;1580;4800
520355;201507;1040;3479;935;3310;317;1222;362;1229;679;2451
520357;201507;744;2036;633;1860;44;147;471;1363;515;1510
520360;201507;654;1900;579;1779;122;409;270;841;392;1250
520380;201507;1293;3468;858;2637;153;499;341;1028;494;1527
520390;201507;968;2306;585;1794;156;569;217;590;373;1159
520393;201507;490;1237;386;1085;52;159;240;655;292;814
520396;201507;730;2319;617;2098;74;295;410;1382;484;1677
520400;201507;1701;4827;1451;4480;239;804;926;2830;1165;3634
520410;201507;1345;3401;1033;2969;215;680;570;1615;785;2295
520420;201507;326;919;239;733;47;158;77;211;124;369
520425;201507;1091;2984;922;2685;252;777;462;1334;714;2111
520430;201507;1989;5204;1272;3884;279;945;431;1180;710;2125
520440;201507;3626;9255;2438;7197;747;2414;554;1608;1301;4022
520450;201507;10161;28423;7127;22780;1662;5827;883;2539;2545;8366
520455;201507;659;1964;530;1737;158;577;167;533;325;1110
520460;201507;838;2409;684;2146;125;451;348;1050;473;1501
520465;201507;769;2161;663;2032;118;395;403;1237;521;1632
520470;201507;1729;5576;1550;5289;351;1208;987;3527;1338;4735
520480;201507;954;2727;722;2340;128;459;357;1093;485;1552
520485;201507;1215;3860;1044;3571;279;1072;558;1896;837;2968
520490;201507;3795;11918;3042;10708;935;3413;1310;4738;2245;8151
520495;201507;1238;3420;1080;3215;91;275;894;2698;985;2973
520500;201507;1271;3638;1098;3371;302;998;462;1375;764;2373
520505;201507;791;2216;677;2057;157;484;359;1090;516;1574
520510;201507;9485;26560;6622;21859;1732;6306;1970;6596;3702;12902
520520;201507;1078;2983;846;2641;257;833;295;936;552;1769
520530;201507;1985;6499;1674;5957;563;2022;548;2042;1111;4064
520540;201507;2876;8095;2171;6772;570;1884;504;1528;1074;3412
520545;201507;1082;3240;886;2844;192;656;290;886;482;1542
520547;201507;688;2195;595;2014;217;763;193;606;410;1369
520549;201507;9396;27124;7748;25020;2240;7582;3813;12422;6053;20004
520551;201507;3411;10373;3149;10004;859;2996;1860;5844;2719;8840
520552;201507;750;2287;689;2197;101;363;481;1536;582;1899
520570;201507;520;1494;370;1229;144;514;77;236;221;750
520580;201507;3164;7993;2155;6515;626;2149;834;2430;1460;4579
520590;201507;1399;3900;1098;3388;257;808;278;798;535;1606
520620;201507;7084;22191;6434;21228;1501;5208;3689;12295;5190;17503
520630;201507;755;1962;551;1661;121;363;256;780;377;1143
520640;201507;2751;7701;2262;6887;654;2077;916;2858;1570;4935
520650;201507;807;2216;621;1857;142;467;297;870;439;1337
520660;201507;324;955;259;855;89;331;89;276;178;607
520670;201507;857;2584;776;2469;42;143;666;2130;708;2273
520680;201507;615;1709;494;1539;121;386;236;749;357;1135
520690;201507;368;954;260;795;55;144;124;408;179;552
520710;201507;534;1367;319;937;5;9;190;553;195;562
520725;201507;1596;4046;1202;3434;228;707;706;2000;934;2707
520735;201507;753;2133;550;1735;136;484;173;516;309;1000
520740;201507;1576;4421;1267;4014;237;850;678;2108;915;2958
520750;201507;595;1608;471;1417;90;266;253;796;343;1062
520753;201507;1264;3620;1176;3487;150;423;850;2636;1000;3059
520760;201507;847;2308;745;2169;103;327;528;1577;631;1904
520780;201507;1912;4623;1546;4132;159;384;1082;2921;1241;3305
520790;201507;2657;7101;2191;6431;258;731;1583;4820;1841;5551
520800;201507;15201;44404;13290;42110;2691;8214;8394;28308;11085;36522
520810;201507;1017;2534;820;2302;137;374;574;1707;711;2081
520815;201507;563;1818;420;1523;175;721;24;65;199;786
520830;201507;1511;4099;1269;3841;47;159;1074;3241;1121;3400
520840;201507;1397;4570;1160;4127;374;1481;247;890;621;2371
520850;201507;580;1789;450;1553;113;434;196;640;309;1074
520860;201507;6496;18513;4835;15933;1270;4529;1956;6578;3226;11107
520870;201507;107752;285910;72029;225414;19842;68752;17485;51858;37327;120610
520880;201507;7021;19987;5122;17055;1581;5960;785;2510;2366;8470
520890;201507;3710;10521;3020;9379;649;2202;1435;4448;2084;6650
520910;201507;3708;10884;2705;8909;871;3056;472;1487;1343;4543
520915;201507;762;2174;594;1862;137;453;261;793;398;1246
520920;201507;3299;8952;2293;7298;531;1807;759;2493;1290;4300
520929;201507;516;1410;388;1211;78;239;217;701;295;940
520940;201507;1025;3011;857;2759;91;345;611;1945;702;2290
520945;201507;723;1715;573;1468;182;430;246;636;428;1066
520960;201507;824;2489;674;2202;79;252;341;1149;420;1401
520970;201507;3140;9294;2603;8326;612;2158;842;2597;1454;4755
520980;201507;761;2185;687;2077;240;785;305;902;545;1687
520990;201507;2865;9361;2710;9135;474;1684;1848;6399;2322;8083
520993;201507;1016;2636;824;2350;63;194;584;1678;647;1872
520995;201507;2291;6254;2050;5945;312;923;1449;4261;1761;5184
521000;201507;6781;20552;5668;18540;1368;5055;2006;6201;3374;11256
521010;201507;3783;11225;2989;9712;734;2541;1073;3488;1807;6029
521015;201507;659;1824;552;1652;134;377;264;807;398;1184
521020;201507;3763;10621;2599;8245;694;2365;414;1129;1108;3494
521030;201507;591;1553;494;1389;101;279;244;695;345;974
521040;201507;5747;15595;4867;14288;1723;5161;1896;5948;3619;11109
521056;201507;855;2618;714;2381;239;852;282;988;521;1840
521060;201507;1287;3408;1039;3026;247;696;456;1386;703;2082
521080;201507;1216;2876;733;2073;100;358;286;658;386;1016
521090;201507;2897;7808;2276;7008;698;2218;918;2945;1616;5163
521100;201507;1616;3888;1361;3607;238;611;925;2581;1163;3192
521120;201507;4290;11906;3524;10807;849;2777;1517;4687;2366;7464
521130;201507;1005;2744;769;2298;127;463;434;1255;561;1718
521140;201507;960;2998;797;2674;243;861;242;814;485;1675
521150;201507;12756;32692;7934;23485;2665;8457;1891;5498;4556;13955
521160;201507;835;1987;512;1423;106;309;222;596;328;905
521170;201507;1185;2833;896;2431;188;530;503;1332;691;1862
521180;201507;6452;21256;5815;20078;2009;7416;1696;5877;3705;13293
521190;201507;9391;26606;6283;20970;1656;5916;1592;5306;3248;11222
521200;201507;736;1931;617;1744;74;237;386;1054;460;1291
521205;201507;578;1653;443;1406;42;143;254;799;296;942
521210;201507;913;2508;621;1947;211;763;168;416;379;1179
521220;201507;3981;10553;3031;9256;904;3002;1139;3451;2043;6453
521225;201507;360;890;289;811;33;84;209;619;242;703
521230;201507;1174;3692;1070;3482;345;1219;521;1643;866;2862
521250;201507;27042;86937;24250;82601;10015;36427;7164;24454;17179;60881
521260;201507;708;1737;585;1554;95;327;371;904;466;1231
521270;201507;1821;5531;1674;5320;149;378;1313;4376;1462;4754
521280;201507;1847;5632;1494;4931;452;1569;444;1434;896;3003
521290;201507;467;1354;358;1177;96;360;141;451;237;811
521295;201507;1097;2865;952;2665;115;338;733;2079;848;2417
521300;201507;1908;5320;1616;4845;271;804;933;2860;1204;3664
521305;201507;767;2151;629;1935;120;346;346;1100;466;1446
521308;201507;4404;13040;3472;11187;883;2937;1418;4518;2301;7455
521310;201507;7436;22108;5436;18214;1428;5229;1140;3520;2568;8749
521340;201507;227;633;198;585;19;61;147;432;166;493
521350;201507;1871;5162;1578;4711;212;627;1103;3386;1315;4013
521370;201507;943;2792;738;2432;218;787;210;668;428;1455
521375;201507;1249;3733;1053;3370;243;870;483;1445;726;2315
521377;201507;1055;2714;988;2641;75;151;865;2392;940;2543
521380;201507;5040;14305;3642;11673;683;2330;813;2696;1496;5026
521385;201507;471;1330;423;1265;105;340;229;671;334;1011
521390;201507;895;2423;694;2149;175;620;230;705;405;1325
521400;201507;2095;5902;1905;5667;253;832;1463;4368;1716;5200
521405;201507;1360;3845;1063;3313;296;1026;476;1473;772;2499
521410;201507;696;2133;636;2036;233;718;284;985;517;1703
521440;201507;1326;3795;1194;3505;133;434;748;2048;881;2482
521450;201507;4089;12929;3295;11417;1032;3868;745;2503;1777;6371
521460;201507;6292;18516;5384;16999;1325;4588;2667;8283;3992;12871
521470;201507;703;1985;525;1632;127;436;89;262;216;698
521480;201507;405;1207;280;927;60;203;107;348;167;551
521483;201507;2796;7293;2150;6184;589;1747;641;1797;1230;3544
521486;201507;1512;3883;1278;3536;120;346;969;2673;1089;3019
521487;201507;624;1606;433;1282;127;388;79;222;206;610
521490;201507;748;2214;612;1987;65;294;408;1278;473;1572
521500;201507;1304;4160;1015;3511;204;788;294;877;498;1665
521520;201507;882;2098;668;1810;173;472;314;906;487;1378
521523;201507;12266;45138;11372;43540;4299;17666;1636;6890;5935;24556
521525;201507;1009;2631;882;2461;98;331;630;1709;728;2040
521530;201507;1613;4596;993;3312;217;773;180;555;397;1328
521540;201507;931;2519;638;2012;149;556;205;601;354;1157
521550;201507;1027;2634;883;2397;222;652;435;1136;657;1788
521560;201507;3834;12674;3279;11865;1242;4932;1099;3868;2341;8800
521565;201507;640;1605;536;1478;84;202;355;1009;439;1211
521570;201507;4319;12118;2871;9163;694;2421;762;2377;1456;4798
521580;201507;550;1274;372;1032;101;312;135;356;236;668
521590;201507;659;1855;530;1642;155;529;109;331;264;860
521600;201507;523;1406;378;1154;102;332;92;242;194;574
521630;201507;1400;3528;991;2920;234;815;203;489;437;1304
521640;201507;1941;5013;1505;4413;424;1307;618;1867;1042;3174
521645;201507;592;1731;459;1430;67;229;186;523;253;752
521680;201507;1441;4579;1206;4102;591;2176;192;599;783;2775
521690;201507;561;1652;495;1534;121;445;218;603;339;1048
521710;201507;2617;8059;2205;7214;487;1674;945;3077;1432;4751
521720;201507;1806;5117;1482;4571;272;853;880;2656;1152;3509
521730;201507;3640;11879;3196;11006;1225;4657;742;2288;1967;6945
521740;201507;3276;9004;2591;8050;748;2539;1149;3755;1897;6294
521760;201507;12514;41187;11085;38692;2564;9829;5260;18448;7824;28277
521770;201507;2631;7657;2113;6695;769;2604;584;1739;1353;4343
521800;201507;7204;21496;6228;19855;1920;6537;2358;7723;4278;14260
521805;201507;888;2019;634;1652;153;362;347;983;500;1345
521810;201507;828;2145;619;1824;145;455;272;816;417;1271
521830;201507;5067;16168;4560;15424;777;2907;3001;10097;3778;13004
521839;201507;726;1990;543;1649;106;359;180;517;286;876
521850;201507;6696;18119;5115;15274;1212;3822;1638;4491;2850;8313
521860;201507;1821;5065;1415;4393;329;1137;441;1320;770;2457
521870;201507;482;1605;410;1446;114;433;115;385;229;818
521878;201507;699;2061;506;1650;103;379;220;698;323;1077
521880;201507;24047;61120;15645;47433;4098;13361;4921;15100;9019;28461
521890;201507;3430;10237;2693;8803;826;2910;636;2000;1462;4910
521900;201507;1362;3586;1006;3077;244;796;357;983;601;1779
521910;201507;954;2615;852;2492;153;473;510;1545;663;2018
521920;201507;334;995;280;896;96;354;68;180;164;534
521925;201507;621;1900;525;1725;96;344;202;623;298;967
521930;201507;3592;11608;3159;10761;1006;3597;753;2530;1759;6127
521935;201507;595;1715;525;1589;144;431;250;750;394;1181
521940;201507;986;2738;798;2435;206;688;347;1018;553;1706
521945;201507;641;2129;598;2069;102;336;401;1488;503;1824
521950;201507;596;1623;470;1429;87;291;251;775;338;1066
521960;201507;718;2135;583;1881;124;451;256;798;380;1249
521970;201507;2405;6816;2115;6446;268;834;1566;4891;1834;5725
521971;201507;1054;2819;753;2251;153;473;206;574;359;1047
521973;201507;883;2778;724;2468;166;611;259;867;425;1478
521975;201507;12238;33537;11347;32482;1851;5540;8149;23266;10000;28806
521980;201507;1906;5509;1668;5222;252;694;1291;4218;1543;4912
521990;201507;968;2851;830;2642;94;343;549;1752;643;2095
522000;201507;2278;6181;1654;5387;232;847;950;3200;1182;4047
522005;201507;391;943;260;734;76;207;87;257;163;464
522010;201507;3154;9210;2625;8324;932;3088;586;1847;1518;4935
522015;201507;850;2575;717;2367;158;542;368;1214;526;1756
522020;201507;5103;13352;4155;12023;922;2788;2371;6877;3293;9665
522026;201507;606;1609;436;1407;118;415;147;491;265;906
522028;201507;515;1509;421;1299;76;244;256;774;332;1018
522040;201507;2379;5866;1831;5179;421;1231;1061;3039;1482;4270
522045;201507;14700;47798;12189;42572;3606;13864;2390;8001;5996;21865
522050;201507;1101;3113;830;2621;219;738;279;793;498;1531
522060;201507;2657;7948;2068;7034;583;2207;955;3184;1538;5391
522068;201507;1581;5024;1453;4879;153;460;1147;4039;1300;4499
522070;201507;762;2307;685;2184;79;312;488;1543;567;1855
522100;201507;576;1693;503;1582;180;638;208;610;388;1248
522108;201507;889;2718;751;2517;64;245;578;1918;642;2163
522119;201507;1365;4219;1163;3905;261;932;579;1984;840;2916
522130;201507;342;998;296;945;89;296;176;564;265;860
522140;201507;17265;47387;14096;42138;4096;13227;4726;13446;8822;26673
522145;201507;789;2220;700;2073;291;895;210;646;501;1541
522150;201507;865;2426;759;2249;223;670;291;844;514;1514
522155;201507;779;2233;686;2091;122;350;457;1446;579;1796
522157;201507;683;1933;584;1791;50;182;463;1410;513;1592
522160;201507;5814;16495;4159;13438;1318;4768;477;1375;1795;6143
522170;201507;3034;8520;2470;7577;799;2516;654;2041;1453;4557
522180;201507;321;927;249;802;77;264;82;273;159;537
522185;201507;14904;43212;12458;40021;3113;10621;6966;22494;10079;33115
522190;201507;921;2300;698;1969;103;305;380;1101;483;1406
522200;201507;1594;5093;1345;4572;382;1420;403;1283;785;2703
522205;201507;1410;4040;1145;3609;275;913;533;1632;808;2545
522220;201507;1354;3646;1082;3312;269;824;544;1821;813;2645
522230;201507;1175;3359;1012;3099;117;405;668;2053;785;2458
530010;201507;228117;716469;201476;668120;56159;206568;68361;220335;124520;426903
110001;201506;3913;12401;3256;11386;741;2758;1771;6230;2512;8988
110002;201506;13388;40438;10851;35952;3212;11684;4071;13235;7283;24919
110003;201506;887;2845;794;2676;232;815;221;704;453;1519
110004;201506;10362;32777;8574;29126;2804;10329;2093;7039;4897;17368
110005;201506;1948;6299;1764;5950;631;2191;721;2422;1352;4613
110006;201506;2257;6640;1520;5308;477;1801;285;857;762;2658
110007;201506;1394;4267;1313;4153;326;1138;617;2159;943;3297
110008;201506;2421;8185;2285;7988;412;1351;1672;6117;2084;7468
110009;201506;4845;14467;3940;13031;1078;3976;1609;5122;2687;9098
110010;201506;7953;23222;6935;21924;1694;5131;3893;13450;5587;18581
110011;201506;8710;26590;7313;24047;2425;8459;2718;8797;5143;17256
110012;201506;14408;43378;12106;39105;3816;12996;3878;12521;7694;25517
110013;201506;5519;16979;4433;15272;1544;5539;1528;5435;3072;10974
110014;201506;4502;12808;3691;11613;818;2696;2179;6910;2997;9606
110015;201506;5203;15585;3857;13166;1199;4495;1057;3543;2256;8038
110018;201506;4534;12769;3487;11368;942;3503;1453;4510;2395;8013
110020;201506;59551;167310;45874;148811;10120;34706;23615;78625;33735;113331
110025;201506;4349;12597;3571;11181;622;2065;2270;7054;2892;9119
110026;201506;665;2068;617;1998;153;501;371;1213;524;1714
110028;201506;7793;22294;5626;18592;1534;5593;1006;3113;2540;8706
110029;201506;1388;4136;1191;3788;355;1171;508;1640;863;2811
110030;201506;10519;28797;8197;25586;2053;7009;3738;11846;5791;18855
110032;201506;4125;13099;3642;12085;1162;3999;1246;4078;2408;8077
110033;201506;5434;17244;4969;16503;1525;4973;2339;8274;3864;13247
110034;201506;3627;9548;3061;8840;597;1653;2176;6397;2773;8050
110037;201506;2106;7027;1793;6424;481;1839;839;2969;1320;4808
110040;201506;3577;11257;3166;10541;957;3481;1438;4687;2395;8168
110045;201506;5295;17344;4644;16553;1453;5643;2416;8544;3869;14187
110050;201506;1750;5530;1474;5084;428;1531;763;2678;1191;4209
110060;201506;842;2794;730;2570;238;955;249;842;487;1797
110070;201506;2060;6847;1952;6628;483;1751;1110;3742;1593;5493
110080;201506;3952;11433;3575;10998;491;1416;2749;8800;3240;10216
110090;201506;796;2382;648;2118;177;661;292;883;469;1544
110092;201506;1391;4682;1301;4566;205;753;878;3178;1083;3931
110094;201506;3553;10837;3228;10375;1012;3394;1549;5051;2561;8445
110100;201506;2347;7392;2089;6939;622;2174;1066;3525;1688;5699
110110;201506;1737;5488;1580;5287;671;2364;522;1785;1193;4149
110120;201506;1836;5925;1447;5059;450;1643;351;1221;801;2864
110130;201506;2706;7685;2004;6563;685;2386;555;1790;1240;4176
110140;201506;2584;8500;2254;7879;536;2008;1109;3862;1645;5870
110143;201506;1310;4144;1025;3639;280;1040;471;1661;751;2701
110145;201506;1046;3014;875;2741;193;661;508;1565;701;2226
110146;201506;444;1377;392;1301;85;284;219;742;304;1026
110147;201506;855;2461;658;2126;177;614;240;696;417;1310
110148;201506;1354;4022;1005;3306;324;1132;221;676;545;1808
110149;201506;3620;10700;2893;9542;882;2935;1395;4755;2277;7690
110150;201506;2518;7462;2184;6977;354;1215;1314;4304;1668;5519
110155;201506;884;2762;809;2593;227;770;411;1284;638;2054
110160;201506;2209;6821;1817;6112;580;2008;750;2541;1330;4549
110170;201506;3139;8771;2307;7297;523;1750;1236;3862;1759;5612
110175;201506;1813;5383;1360;4807;228;882;793;2889;1021;3771
110180;201506;1523;4455;1267;4069;291;953;758;2488;1049;3441
120001;201506;2855;9960;2691;9682;504;1953;1743;6380;2247;8333
120005;201506;1505;6310;1456;6228;133;608;1160;5092;1293;5700
120010;201506;4516;15766;4279;15384;675;2372;3120;11572;3795;13944
120013;201506;1790;7088;1719;6982;407;1615;1084;4688;1491;6303
120017;201506;2062;7411;1923;7162;527;2005;904;3671;1431;5676
120020;201506;14180;63195;13760;62393;2088;9307;10099;47652;12187;56959
120025;201506;2651;9163;2556;9029;492;1884;1657;5917;2149;7801
120030;201506;6231;24571;6112;24436;287;1092;5564;22554;5851;23646
120032;201506;1442;6936;1384;6797;195;1127;994;4915;1189;6042
120033;201506;3530;14033;3461;13906;189;772;3144;12772;3333;13544
120034;201506;1991;8297;1926;8199;168;870;1591;6725;1759;7595
120035;201506;2906;13596;2863;13506;208;1057;2477;11850;2685;12907
120038;201506;2663;9758;2547;9535;655;2535;1415;5422;2070;7957
120039;201506;1606;8229;1570;8145;170;965;1235;6478;1405;7443
120040;201506;46994;167322;42733;158915;11074;44006;21249;80543;32323;124549
120042;201506;2887;12432;2742;12107;382;1822;1948;8764;2330;10586
120043;201506;895;4302;866;4252;65;287;736;3746;801;4033
120045;201506;4341;14878;4271;14784;661;2387;3355;11714;4016;14101
120050;201506;8005;33329;7655;32564;1278;5350;5155;23083;6433;28433
120060;201506;7362;33527;7249;33325;600;3067;6079;28357;6679;31424
120070;201506;2721;10273;2651;10115;466;1732;1796;7124;2262;8856
120080;201506;3652;13856;3492;13599;517;2032;2624;10511;3141;12543
130002;201506;3016;12546;2853;12279;209;1032;2374;10269;2583;11301
130006;201506;1932;8201;1699;7779;260;1342;1169;5408;1429;6750
130008;201506;2106;8465;2009;8300;147;661;1679;7010;1826;7671
130010;201506;2870;9630;2500;9204;188;686;2172;8119;2360;8805
130014;201506;3294;10724;2903;10130;479;1776;1905;6729;2384;8505
130020;201506;2639;9609;2612;9568;28;105;2541;9326;2569;9431
130030;201506;7234;27523;6972;27208;563;1897;5992;24167;6555;26064
130040;201506;3785;11630;3392;11116;279;1027;2819;9351;3098;10378
130050;201506;6281;24956;5678;24066;510;2067;4446;19828;4956;21895
130060;201506;5585;26209;5347;25790;460;2486;4346;21097;4806;23583
130063;201506;3560;15734;3492;15644;267;1182;3040;13868;3307;15050
130068;201506;3100;13014;2812;12441;394;1843;1854;8335;2248;10178
130070;201506;6774;22003;6046;21094;659;2283;4734;16941;5393;19224
130080;201506;5018;22584;4790;22234;800;3943;3336;15877;4136;19820
130083;201506;2179;8665;2060;8485;308;1448;1456;6006;1764;7454
130090;201506;2597;9350;2504;9210;133;599;2197;8037;2330;8636
130100;201506;5619;21002;5404;20723;222;967;4975;19109;5197;20076
130110;201506;6607;21390;6190;20889;730;2279;4955;17311;5685;19590
130115;201506;4337;15442;4138;15180;87;271;3922;14512;4009;14783
130120;201506;14094;53750;13399;52852;1276;4841;11124;45078;12400;49919
130130;201506;3700;15449;3641;15337;291;1358;3096;13136;3387;14494
130140;201506;6258;24320;6175;24224;119;336;5996;23713;6115;24049
130150;201506;3411;13258;3339;13168;176;898;2968;11581;3144;12479
130160;201506;4133;17064;4017;16905;354;1553;3459;14641;3813;16194
130165;201506;2862;11814;2742;11609;312;1416;2173;9284;2485;10700
130170;201506;9072;32907;8108;31727;1053;4208;6195;24934;7248;29142
130180;201506;3489;11259;3401;11137;119;309;3154;10445;3273;10754
130185;201506;10900;35471;9922;34347;930;2917;8214;29657;9144;32574
130190;201506;17402;59427;15248;56666;2814;10458;10052;39093;12866;49551
130195;201506;1918;8027;1858;7940;107;457;1649;7152;1756;7609
130200;201506;2007;7163;1863;6933;491;1815;1114;4268;1605;6083
130210;201506;1190;4684;1125;4593;111;524;926;3787;1037;4311
130220;201506;1975;8154;1804;7828;325;1601;1046;4565;1371;6166
130230;201506;3632;16392;3412;16019;382;1795;2604;12746;2986;14541
130240;201506;8452;32319;7833;31403;380;1817;6852;27713;7232;29530
130250;201506;19457;67918;18379;66515;2642;9389;13687;51549;16329;60938
130255;201506;4210;14810;3985;14457;140;441;3650;13488;3790;13929
130260;201506;251241;820201;226160;778403;64301;233226;106650;373340;170951;606566
130270;201506;7136;29992;6569;29072;895;4096;4870;22268;5765;26364
130280;201506;3248;13193;3161;13072;164;672;2843;11976;3007;12648
130290;201506;11273;39744;10873;39273;155;287;10450;38443;10605;38730
130300;201506;4310;16915;4113;16597;300;1414;3453;13959;3753;15373
130310;201506;5174;19350;4757;18832;372;1478;3958;16049;4330;17527
130320;201506;2977;10488;2710;10116;368;1419;1944;7429;2312;8848
130330;201506;3538;13011;3298;12686;203;915;2813;10881;3016;11796
130340;201506;17950;68754;16763;67196;2970;11597;11957;50048;14927;61645
130350;201506;3241;13425;3169;13328;271;1329;2657;11220;2928;12549
130353;201506;5943;18200;5189;17226;1182;3832;3177;11312;4359;15144
130356;201506;4523;16231;4268;15862;377;1233;3466;13486;3843;14719
130360;201506;3191;9076;2909;8766;79;201;2743;8395;2822;8596
130370;201506;5264;20615;4513;19601;267;1453;3702;16131;3969;17584
130380;201506;7606;31536;7311;31133;488;2268;6361;27334;6849;29602
130390;201506;4846;21663;4513;21082;466;2391;3483;16586;3949;18977
130395;201506;2084;7496;1837;6987;286;1173;1184;4454;1470;5627
130400;201506;2105;7962;2022;7849;139;600;1785;6957;1924;7557
130406;201506;10470;39602;9418;38040;2223;9281;5746;23956;7969;33237
130410;201506;3949;15055;3589;14379;1084;4640;1608;6656;2692;11296
130420;201506;10373;43948;9965;43279;2649;11090;6264;28635;8913;39725
130423;201506;3220;12513;3029;12253;249;1175;2552;10350;2801;11525
130426;201506;2128;9265;2064;9161;282;1248;1579;7221;1861;8469
130430;201506;3415;12177;3267;11965;401;1554;2496;9266;2897;10820
130440;201506;3544;12964;3393;12798;188;683;3039;11642;3227;12325
140002;201506;1666;5360;1557;5220;164;554;1173;4020;1337;4574
140005;201506;3095;9003;2922;8813;87;197;2777;8469;2864;8666
140010;201506;53014;159401;44764;146609;11077;38974;21222;71433;32299;110407
140015;201506;2924;9423;2758;9209;339;932;2175;7618;2514;8550
140017;201506;3279;10117;2973;9734;280;823;2370;8068;2650;8891
140020;201506;4553;15479;4231;15017;465;1620;3269;11916;3734;13536
140023;201506;2145;7278;1891;6891;258;997;1306;4852;1564;5849
140028;201506;2176;5935;2046;5756;91;238;1771;4902;1862;5140
140030;201506;3737;11719;3530;11439;453;1168;2768;9354;3221;10522
140040;201506;1633;7594;1587;7482;114;643;1271;6041;1385;6684
140045;201506;2481;9192;2268;8878;467;1635;1469;6290;1936;7925
140047;201506;5442;15262;4847;14478;1411;4303;2371;7522;3782;11825
140050;201506;1532;4799;1387;4610;233;797;926;3129;1159;3926
140060;201506;1525;4668;1376;4434;295;1003;871;2849;1166;3852
140070;201506;1470;7697;1428;7551;95;587;1209;6389;1304;6976
150010;201506;34181;106794;32424;104487;2036;6832;27633;90072;29669;96904
150013;201506;1683;4932;1552;4787;162;474;1224;3871;1386;4345
150020;201506;12372;41398;11974;40857;1004;3354;10243;35490;11247;38844
150030;201506;6644;28609;6436;28298;611;2318;5424;24771;6035;27089
150034;201506;4317;11983;4082;11695;232;611;3633;10513;3865;11124
150040;201506;12733;41972;10971;39828;2153;7229;7474;29143;9627;36372
150050;201506;5801;22276;5589;21913;350;1588;4780;18825;5130;20413
150060;201506;17118;54168;15769;52137;2755;8813;10844;37028;13599;45841
150070;201506;5962;24402;5355;23740;379;1846;4632;20761;5011;22607
150080;201506;68428;179352;58023;165642;10045;27434;36890;109686;46935;137120
150085;201506;5225;18057;4971;17709;549;1695;4050;15014;4599;16709
150090;201506;9943;38257;9432;37528;882;3428;7578;30903;8460;34331
150095;201506;5284;17573;4802;16867;418;1354;3860;14057;4278;15411
150100;201506;3281;12299;3084;11963;189;915;2517;9628;2706;10543
150110;201506;3293;16336;3282;16311;158;727;3039;15289;3197;16016
150120;201506;6142;23479;5985;23209;676;2529;4809;19013;5485;21542
150125;201506;774;2268;685;2159;124;433;452;1383;576;1816
150130;201506;21760;66297;20242;64193;1913;5831;15944;51822;17857;57653
150140;201506;154872;444180;147210;434383;15527;44844;119189;357133;134716;401977
150145;201506;4557;14516;4178;14035;619;2097;3138;10767;3757;12864
150150;201506;11258;35234;10434;33966;1702;5709;7269;24003;8971;29712
150157;201506;3130;9458;2725;8881;352;1265;2001;6618;2353;7883
150160;201506;3056;9911;2848;9607;821;2769;1571;5519;2392;8288
150170;201506;22371;81797;20907;79548;3500;13414;14739;57248;18239;70662
150172;201506;3034;10486;2706;9955;446;1670;1861;7026;2307;8696
150175;201506;1984;5971;1872;5848;138;376;1588;5171;1726;5547
150178;201506;10320;32054;9192;30778;865;2975;7139;24800;8004;27775
150180;201506;18103;72623;17398;71678;1446;6428;14534;60549;15980;66977
150190;201506;7238;23626;6851;23110;383;1009;5964;20784;6347;21793
150195;201506;5114;17054;4750;16467;321;1189;3997;13986;4318;15175
150200;201506;5295;16984;5071;16723;140;432;4697;15689;4837;16121
150210;201506;24314;91876;23500;90732;2303;8265;19271;77166;21574;85431
150215;201506;6603;20754;5683;19295;1564;5606;2511;8638;4075;14244
150220;201506;12562;39206;11223;37098;2516;8570;5899;19903;8415;28473
150230;201506;11246;37255;9999;35457;1211;4866;7271;25853;8482;30719
150240;201506;35515;105619;31212;98310;10216;33398;10912;35653;21128;69051
150250;201506;4065;16491;3925;16283;534;2256;2988;12775;3522;15031
150260;201506;2112;8489;2011;8305;387;1614;1250;5325;1637;6939
150270;201506;8809;27136;7040;24927;1607;5989;4208;15242;5815;21231
150275;201506;5885;21427;5589;20967;724;2731;4209;16171;4933;18902
150276;201506;2130;6371;1908;6066;422;1440;1319;4187;1741;5627
150277;201506;4972;15393;4313;14575;748;2536;2983;10441;3731;12977
150280;201506;5809;25901;5639;25516;1110;5016;3762;17587;4872;22603
150285;201506;2691;10802;2564;10569;539;2286;1589;6817;2128;9103
150290;201506;9729;28759;9310;28281;747;1823;7955;25076;8702;26899
150293;201506;9644;26643;7418;23504;2231;7551;2762;9449;4993;17000
150295;201506;6913;20894;5737;19499;1246;4142;3585;13068;4831;17210
150300;201506;1808;6388;1731;6293;147;570;1380;5118;1527;5688
150304;201506;4083;12813;3564;12065;586;2015;2370;8270;2956;10285
150307;201506;6535;21988;6049;21313;397;1280;5079;18203;5476;19483
150309;201506;6373;22094;5847;21343;1265;4581;3751;14349;5016;18930
150310;201506;5810;25901;5628;25599;652;3031;4482;20804;5134;23835
150320;201506;9220;21701;8570;21034;483;788;7680;19546;8163;20334
150330;201506;13718;47360;12807;46039;1577;5535;9764;36227;11341;41762
150340;201506;2382;7744;2203;7476;317;1130;1577;5421;1894;6551
150345;201506;6564;22046;6149;21495;596;2033;4999;17924;5595;19957
150350;201506;7737;24562;7233;23906;1130;3209;5356;18491;6486;21700
150360;201506;21100;66163;18468;62738;2895;9870;12728;44790;15623;54660
150370;201506;9643;35811;9138;35141;1168;4036;7323;29342;8491;33378
150375;201506;2809;12229;2738;12131;246;1019;2350;10692;2596;11711
150380;201506;9812;28762;8720;27254;659;2125;7230;22925;7889;25050
150390;201506;7867;33928;7409;33087;1381;5997;4864;22629;6245;28626
150400;201506;5787;22987;5545;22481;532;2118;4344;18091;4876;20209
150405;201506;8198;24931;7321;23852;1364;3686;5015;17844;6379;21530
150410;201506;1635;6342;1550;6173;240;1050;1021;4134;1261;5184
150420;201506;36220;123480;31055;114996;9198;36798;12422;47861;21620;84659
150430;201506;7075;24113;6737;23570;927;3125;4901;17659;5828;20784
150440;201506;5437;18983;5227;18695;942;3227;3728;13809;4670;17036
150442;201506;20149;59987;18357;57348;3306;10564;11898;37990;15204;48554
150445;201506;5095;17809;4725;17199;635;2243;3489;13058;4124;15301
150450;201506;4281;20649;4116;20408;346;1731;3470;17567;3816;19298
150460;201506;6466;25044;5918;24399;347;1641;5134;21543;5481;23184
150470;201506;17310;52941;16643;52146;562;1372;15539;49490;16101;50862
150475;201506;2390;8330;2203;8091;234;829;1798;6801;2032;7630
150480;201506;13631;46852;12762;45557;1212;4523;10408;37626;11620;42149
150490;201506;6801;26144;6646;25918;288;1126;6013;23715;6301;24841
150495;201506;4997;18449;4869;18277;212;830;4462;16850;4674;17680
150497;201506;2905;10457;2606;9906;802;3229;1245;4741;2047;7970
150500;201506;3168;8796;2931;8453;334;954;2212;6382;2546;7336
150503;201506;3836;11882;3310;11231;1123;3888;1710;6098;2833;9986
150506;201506;11476;40275;10406;38755;2341;8245;6672;26519;9013;34764
150510;201506;9652;37879;8898;36472;1387;5791;6063;25776;7450;31567
150520;201506;6678;26072;6577;25933;227;744;6192;24735;6419;25479
150530;201506;12022;41712;10861;39942;1182;4134;8326;31367;9508;35501
150540;201506;4597;14203;4165;13597;297;998;3460;11345;3757;12343
150543;201506;5449;17060;4906;16267;1047;3604;3109;10550;4156;14154
150548;201506;8741;28189;8201;27511;319;1000;7520;25534;7839;26534
150549;201506;2142;6877;1981;6693;87;271;1777;6109;1864;6380
150550;201506;20070;63356;17527;58973;5358;18570;7079;24445;12437;43015
150553;201506;22560;77751;18833;69869;7080;28098;4752;17747;11832;45845
150555;201506;1656;5136;1467;4862;111;413;1158;3848;1269;4261
150560;201506;1948;6327;1838;6090;268;904;1247;4144;1515;5048
150563;201506;2949;9558;2730;9172;654;2361;1507;5081;2161;7442
150565;201506;3694;12782;3371;12281;193;823;2785;10263;2978;11086
150570;201506;5608;20886;5475;20666;446;1931;4421;16811;4867;18742
150580;201506;9560;39869;9341;39608;597;2254;8309;36158;8906;38412
150590;201506;5673;22945;5521;22755;101;309;5265;21955;5366;22264
150600;201506;7936;30633;7654;30223;412;1615;6834;27406;7246;29021
150610;201506;2404;8232;2198;7806;255;1010;1523;5348;1778;6358
150611;201506;2700;9546;2527;9202;230;907;1963;7190;2193;8097
150613;201506;12058;36886;10359;34410;3437;11866;4657;15975;8094;27841
150616;201506;3108;9481;2434;8423;624;2391;995;3304;1619;5695
150618;201506;6510;22554;6051;21733;1720;6403;3098;11289;4818;17692
150619;201506;5176;17855;4842;17348;569;2263;3622;13013;4191;15276
150620;201506;6413;23042;5850;22321;765;2890;4579;17966;5344;20856
150630;201506;5741;17344;5447;16998;429;1327;4636;14771;5065;16098
150635;201506;4141;13620;3808;12969;822;2890;2074;7251;2896;10141
150640;201506;1756;5459;1703;5392;216;641;1361;4527;1577;5168
150650;201506;12553;38047;11177;35684;3021;9820;5186;17109;8207;26929
150655;201506;5001;16906;4751;16469;640;2264;3499;12321;4139;14585
150658;201506;4266;13381;3854;12791;927;3414;2310;7636;3237;11050
150660;201506;5620;17820;5110;17105;1278;4200;2860;9966;4138;14166
150670;201506;6565;18162;5507;16833;976;3135;3947;12357;4923;15492
150680;201506;54592;198476;48544;187927;14916;59772;20834;86200;35750;145972
150690;201506;2020;6300;1825;5986;332;1022;1158;3944;1490;4966
150700;201506;6198;19054;5678;18397;1055;3501;3811;12661;4866;16162
150710;201506;4274;14326;3826;13591;435;1562;2852;10358;3287;11920
150715;201506;5047;15953;4396;14969;546;1987;3277;11302;3823;13289
150720;201506;6449;26383;6070;25696;876;3768;4388;19279;5264;23047
150730;201506;9432;32629;8937;31816;973;3385;7261;26491;8234;29876
150740;201506;3736;11932;3350;11244;589;2113;2012;6783;2601;8896
150745;201506;5381;17014;4935;16386;1144;3954;3098;10308;4242;14262
150746;201506;1407;4587;1339;4470;189;680;934;3152;1123;3832
150747;201506;5365;16804;4725;16006;436;1247;3662;13232;4098;14479
150750;201506;3094;10395;2924;10185;195;731;2530;8855;2725;9586
150760;201506;10986;35847;10298;34934;2166;7374;6598;23086;8764;30460
150770;201506;5830;22153;5437;21338;547;2053;4409;18240;4956;20293
150775;201506;1193;3616;1043;3349;216;862;575;1761;791;2623
150780;201506;3202;10545;3140;10473;59;147;3004;10123;3063;10270
150790;201506;5085;16350;4687;15875;384;1352;3826;13529;4210;14881
150795;201506;15923;49283;14284;46915;2911;9398;9019;30771;11930;40169
150796;201506;2976;8872;2725;8585;370;1121;2074;6773;2444;7894
150797;201506;3726;12610;3465;12209;140;559;3037;10764;3177;11323
150800;201506;13828;46013;12717;44663;2645;8680;8706;32363;11351;41043
150803;201506;6649;24036;6252;23398;693;2695;4694;17883;5387;20578
150805;201506;2741;9640;2552;9349;334;1177;1869;7034;2203;8211
150808;201506;5954;20042;5019;18290;2043;7983;922;3380;2965;11363
150810;201506;19331;60268;16364;56636;2336;7677;11456;41993;13792;49670
150812;201506;5344;16808;4914;16100;513;2074;3573;11281;4086;13355
150815;201506;8593;27927;7741;26882;799;2702;6339;22569;7138;25271
150820;201506;11418;32411;10094;30953;689;1410;8681;27735;9370;29145
150830;201506;13052;48906;11984;47291;621;2722;10017;40926;10638;43648
150835;201506;2051;7272;1896;6955;476;1824;915;3403;1391;5227
150840;201506;6760;20540;5596;18688;1299;4724;2747;9112;4046;13836
160005;201506;703;2586;661;2515;71;327;494;1845;565;2172
160010;201506;1410;4686;1406;4681;75;161;1302;4454;1377;4615
160015;201506;1710;6338;1668;6273;107;372;1472;5667;1579;6039
160020;201506;2041;7175;1895;6978;244;913;1406;5348;1650;6261
160021;201506;957;4141;925;4082;150;759;641;2851;791;3610
160023;201506;1074;4245;1059;4221;84;296;916;3737;1000;4033
160025;201506;1256;3840;1244;3827;9;31;1228;3780;1237;3811
160027;201506;8275;24866;7671;24199;2744;8209;3965;13613;6709;21822
160030;201506;44852;160668;40185;151994;9535;35847;23051;91714;32586;127561
160040;201506;4162;16439;4072;16309;145;758;3776;15002;3921;15760
160050;201506;3227;12134;2925;11730;1310;5214;1222;5249;2532;10463
160053;201506;2675;10363;2609;10261;577;2345;1736;6973;2313;9318
160055;201506;658;2578;646;2566;87;378;500;1993;587;2371
160060;201506;15651;53096;14673;52000;2944;9872;10139;37436;13083;47308
160070;201506;2439;9498;2332;9332;161;728;2008;8058;2169;8786
160080;201506;2570;9651;2555;9634;58;273;2463;9258;2521;9531
170025;201506;543;1814;499;1753;147;516;258;956;405;1472
170030;201506;1177;3845;1036;3590;310;1096;376;1323;686;2419
170035;201506;1531;4473;1224;3909;368;1278;416;1321;784;2599
170040;201506;1877;6081;1656;5781;280;1121;1014;3655;1294;4776
170070;201506;1978;5146;1536;4584;376;1235;833;2498;1209;3733
170100;201506;2514;7263;2207;6784;258;851;1696;5178;1954;6029
170105;201506;762;2405;611;2092;115;456;312;1023;427;1479
170110;201506;1089;3395;928;3126;212;780;444;1492;656;2272
170130;201506;1407;4396;1202;4030;311;1074;593;2074;904;3148
170190;201506;1596;4682;1204;4052;497;1617;262;1012;759;2629
170200;201506;1660;4699;1100;3621;270;976;317;996;587;1972
170210;201506;32133;92201;25843;81891;7594;26007;7950;26235;15544;52242
170215;201506;1193;3725;1018;3452;84;340;764;2574;848;2914
170220;201506;5827;19906;5365;19064;1161;4372;3055;10942;4216;15314
170230;201506;1485;4771;1240;4303;265;1071;590;1950;855;3021
170240;201506;2731;8248;2293;7592;304;1182;1570;5162;1874;6344
170255;201506;3660;11538;3029;10499;895;3141;1266;4624;2161;7765
170270;201506;1068;2664;742;2218;94;302;484;1436;578;1738
170290;201506;2723;8512;2539;8285;169;445;2210;7469;2379;7914
170300;201506;1960;6059;1631;5519;206;788;1070;3633;1276;4421
170305;201506;770;2336;618;2056;112;405;328;1101;440;1506
170307;201506;1087;3791;908;3455;181;776;476;1876;657;2652
170310;201506;1647;4518;1250;3861;313;1023;587;1850;900;2873
170320;201506;1116;3251;819;2719;206;727;304;1030;510;1757
170330;201506;762;2491;695;2384;99;385;501;1693;600;2078
170360;201506;451;1462;382;1345;88;334;172;585;260;919
170370;201506;1384;3983;1103;3532;234;846;552;1767;786;2613
170380;201506;1859;5981;1503;5409;288;1208;796;2806;1084;4014
170382;201506;558;1851;483;1730;114;466;267;936;381;1402
170384;201506;1564;6389;1455;6193;343;1570;849;3639;1192;5209
170386;201506;960;2820;827;2622;197;691;404;1283;601;1974
170388;201506;649;1939;529;1735;110;428;211;662;321;1090
170389;201506;926;3103;845;2965;92;366;613;2135;705;2501
170390;201506;1332;3853;1148;3624;126;432;848;2735;974;3167
170410;201506;534;1691;458;1555;50;212;300;998;350;1210
170460;201506;503;1363;355;1112;83;294;121;369;204;663
170510;201506;788;2644;647;2381;86;382;342;1224;428;1606
170550;201506;6621;19096;5003;16227;1648;5922;871;2720;2519;8642
170555;201506;1364;3922;1072;3471;233;823;540;1764;773;2587
170560;201506;1018;3377;798;3090;171;723;462;1857;633;2580
170600;201506;1338;3838;1192;3641;245;740;779;2471;1024;3211
170610;201506;1680;5087;1306;4491;142;573;812;2800;954;3373
170625;201506;437;1354;342;1171;68;241;97;339;165;580
170650;201506;1273;4054;1099;3743;268;1000;479;1666;747;2666
170700;201506;4092;13035;3338;11768;686;2690;1538;5606;2224;8296
170710;201506;1846;5423;1493;4786;239;806;914;2986;1153;3792
170720;201506;1879;5020;1542;4490;331;878;944;2906;1275;3784
170730;201506;1047;2989;846;2680;223;764;381;1207;604;1971
170740;201506;2242;7988;1982;7534;286;1210;1360;5211;1646;6421
170755;201506;847;2600;696;2277;156;583;241;754;397;1337
170765;201506;1387;3763;1089;3273;297;948;477;1469;774;2417
170770;201506;1766;5975;1619;5708;275;1050;1001;3552;1276;4602
170820;201506;3813;12103;3411;11452;829;2950;1596;5462;2425;8412
170825;201506;778;2310;614;1985;119;416;253;788;372;1204
170830;201506;1402;4082;1236;3838;26;50;1136;3586;1162;3636
170900;201506;2704;9450;2553;9192;247;887;2014;7426;2261;8313
170930;201506;3761;11610;3210;10667;998;3573;1115;3741;2113;7314
170950;201506;14308;41121;10538;34527;3457;12819;2152;6804;5609;19623
170980;201506;503;1511;379;1297;89;342;158;508;247;850
171050;201506;1461;4985;1332;4744;85;353;1093;3893;1178;4246
171070;201506;1582;4906;1439;4699;310;1039;856;2865;1166;3904
171090;201506;1009;2805;843;2572;77;248;606;1842;683;2090
171110;201506;618;1792;466;1527;124;452;203;619;327;1071
171150;201506;875;2507;641;2094;110;393;370;1220;480;1613
171180;201506;693;2082;488;1659;124;441;190;688;314;1129
171190;201506;1773;6386;1536;5906;322;1334;754;3003;1076;4337
171195;201506;841;2967;729;2741;98;407;416;1597;514;2004
171200;201506;713;2277;585;2030;160;624;232;739;392;1363
171215;201506;463;1375;356;1163;67;239;149;498;216;737
171240;201506;751;2630;692;2514;85;354;472;1761;557;2115
171245;201506;663;2151;541;1863;114;435;173;556;287;991
171250;201506;1125;3241;895;2860;152;565;527;1590;679;2155
171270;201506;440;1786;409;1728;131;535;167;784;298;1319
171280;201506;915;2761;776;2550;189;612;391;1404;580;2016
171320;201506;3955;11968;3355;10950;896;2985;1608;5339;2504;8324
171330;201506;2954;8682;2439;7883;649;2242;1098;3514;1747;5756
171360;201506;1466;4688;1267;4381;193;666;827;2936;1020;3602
171370;201506;726;2060;626;1921;139;465;336;1011;475;1476
171380;201506;1329;4301;1125;3921;425;1499;385;1378;810;2877
171395;201506;897;2711;705;2352;157;631;322;1020;479;1651
171420;201506;2268;6804;1754;5882;430;1530;661;2195;1091;3725
171430;201506;1061;3270;892;2997;214;718;464;1560;678;2278
171488;201506;2548;7758;2252;7335;525;1713;1237;4180;1762;5893
171500;201506;806;2473;698;2272;92;285;460;1545;552;1830
171510;201506;922;3206;819;3041;85;362;577;2171;662;2533
171515;201506;509;1458;396;1272;61;201;217;690;278;891
171525;201506;622;2034;524;1862;107;432;271;936;378;1368
171550;201506;320;1064;249;924;86;357;39;154;125;511
171570;201506;1245;3948;1099;3666;197;670;741;2484;938;3154
171575;201506;1884;5387;1455;4588;271;875;688;2226;959;3101
171610;201506;5690;18709;4891;17279;1406;5490;1656;5732;3062;11222
171620;201506;2591;7610;2277;7173;117;427;1912;6051;2029;6478
171630;201506;890;2853;738;2591;245;926;274;934;519;1860
171650;201506;2320;7133;1819;6163;473;1757;672;2277;1145;4034
171660;201506;2483;6852;1925;5864;264;880;1158;3544;1422;4424
171665;201506;1460;4345;1198;3931;183;656;726;2467;909;3123
171670;201506;2080;5862;1718;5287;452;1561;794;2317;1246;3878
171700;201506;1099;3574;958;3306;142;565;618;2108;760;2673
171720;201506;743;2183;624;1976;219;701;240;787;459;1488
171750;201506;1202;3763;976;3291;284;1007;323;1105;607;2112
171780;201506;1272;3428;930;2952;117;416;533;1736;650;2152
171790;201506;1569;5158;1348;4848;243;848;869;3283;1112;4131
171800;201506;669;2102;591;1998;78;292;421;1449;499;1741
171820;201506;10082;29807;8636;27811;1702;5993;5002;16179;6704;22172
171830;201506;1489;5520;1346;5214;360;1448;615;2386;975;3834
171840;201506;816;2295;713;2153;47;141;587;1798;634;1939
171845;201506;792;2139;601;1821;108;372;309;910;417;1282
171850;201506;979;3460;865;3233;113;491;531;1980;644;2471
171855;201506;1152;3628;1040;3416;89;350;784;2514;873;2864
171865;201506;489;1562;411;1434;102;395;204;689;306;1084
171870;201506;727;2197;587;1951;135;482;240;838;375;1320
171875;201506;1374;4261;1124;3877;124;520;779;2630;903;3150
171880;201506;888;3250;861;3205;89;346;687;2615;776;2961
171884;201506;952;2657;692;2267;158;567;207;780;365;1347
171886;201506;1469;4814;1199;4236;366;1426;346;1183;712;2609
171888;201506;688;2096;562;1867;67;234;315;1074;382;1308
171889;201506;512;1641;473;1572;95;337;279;940;374;1277
171890;201506;1167;3702;1005;3479;138;547;654;2275;792;2822
171900;201506;510;1904;454;1795;124;497;220;880;344;1377
172000;201506;604;1970;522;1817;80;313;293;1013;373;1326
172010;201506;1193;4155;1111;4016;126;529;820;2959;946;3488
172015;201506;350;1350;297;1257;56;238;164;729;220;967
172020;201506;2313;7740;2136;7455;275;1011;1504;5320;1779;6331
172025;201506;753;2150;579;1852;74;266;324;1049;398;1315
172030;201506;1152;3821;1022;3599;90;389;745;2608;835;2997
172049;201506;1352;3586;1024;3023;144;432;763;2301;907;2733
172065;201506;1247;3471;1063;3256;64;209;958;2965;1022;3174
172080;201506;2571;7902;2165;7186;232;906;1417;4623;1649;5529
172085;201506;516;1407;368;1126;61;192;115;343;176;535
172090;201506;3253;9760;2625;8819;330;1214;1831;6258;2161;7472
172093;201506;604;1860;472;1639;122;506;216;730;338;1236
172097;201506;684;2010;546;1793;129;431;225;771;354;1202
172100;201506;30788;96643;24951;85768;7649;29259;6803;22984;14452;52243
172110;201506;1712;6334;1533;6046;192;791;1099;4480;1291;5271
172120;201506;5346;16262;4438;15065;575;2034;3120;10849;3695;12883
172125;201506;299;889;238;794;42;161;106;353;148;514
172130;201506;551;1536;442;1359;47;177;295;918;342;1095
172208;201506;2159;6496;1948;6177;361;1238;1102;3519;1463;4757
172210;201506;2451;7638;2198;7241;504;1801;1222;3969;1726;5770
210005;201506;22284;69593;18959;64509;5720;20890;8058;27716;13778;48606
210010;201506;1638;5844;1445;5540;146;613;1081;4225;1227;4838
210015;201506;3324;10546;2989;10047;190;428;2568;8959;2758;9387
210020;201506;6974;17252;6561;16753;251;698;5921;15092;6172;15790
210030;201506;5669;18821;5314;18336;377;1658;4397;15105;4774;16763
210040;201506;1886;5383;1720;5193;125;406;1434;4329;1559;4735
210043;201506;6519;18806;5707;17766;547;1604;4355;14176;4902;15780
210047;201506;6588;25505;6055;24611;744;3303;4363;17945;5107;21248
210050;201506;2386;8648;1956;7896;652;2750;772;3248;1424;5998
210055;201506;1715;5853;1577;5660;167;621;1212;4408;1379;5029
210060;201506;7540;28585;6912;27505;782;3426;5007;20309;5789;23735
210070;201506;6988;20786;6476;20158;181;656;5810;18158;5991;18814
210080;201506;3713;12858;3637;12764;50;209;3469;12208;3519;12417
210083;201506;4340;15125;4036;14800;102;296;3822;14238;3924;14534
210087;201506;2868;8595;2627;8289;248;813;2158;6903;2406;7716
210090;201506;9961;32558;9464;31770;418;1624;8265;27846;8683;29470
210095;201506;5927;21993;5744;21736;437;1714;4799;18481;5236;20195
210100;201506;7214;21674;6674;21027;829;2772;5160;16252;5989;19024
210110;201506;3009;10550;2910;10421;117;496;2608;9382;2725;9878
210120;201506;26337;72682;22535;68228;2724;7077;17005;54504;19729;61581
210125;201506;3603;11485;3452;11321;244;630;3032;10238;3276;10868
210130;201506;4323;12870;4057;12509;307;1013;3369;10400;3676;11413
210135;201506;1692;4966;1492;4685;114;354;1218;3869;1332;4223
210140;201506;17458;55793;15138;52563;2814;10057;9484;34243;12298;44300
210150;201506;4512;11212;4068;10664;75;198;3793;9942;3868;10140
210160;201506;17543;55812;16520;54315;1616;4684;13451;45807;15067;50491
210170;201506;14142;50592;13783;50131;833;2788;12231;45396;13064;48184
210173;201506;1935;8032;1882;7935;113;577;1653;6934;1766;7511
210177;201506;3034;9518;2872;9327;186;664;2496;8117;2682;8781
210180;201506;1557;4753;1452;4594;80;299;1219;3820;1299;4119
210190;201506;4917;15605;4559;14979;254;1113;3582;11568;3836;12681
210193;201506;1412;4463;1276;4238;77;272;1064;3589;1141;3861
210197;201506;2093;6934;1935;6761;235;786;1517;5478;1752;6264
210200;201506;8740;29355;8092;28427;992;3246;6175;22630;7167;25876
210203;201506;6526;21206;6182;20766;399;1149;5488;18788;5887;19937
210207;201506;3051;10017;2851;9666;382;1193;2077;7301;2459;8494
210210;201506;8575;29032;8167;28523;130;568;7512;26596;7642;27164
210215;201506;1438;5684;1380;5595;122;569;1121;4554;1243;5123
210220;201506;6133;23529;5842;23069;430;1829;4824;19343;5254;21172
210230;201506;5162;17118;4789;16538;320;1149;4025;14054;4345;15203
210232;201506;12154;40291;10320;38042;1595;5984;7130;27808;8725;33792
210235;201506;3541;11150;3228;10746;199;762;2735;9160;2934;9922
210237;201506;2452;9285;2413;9229;55;253;2288;8750;2343;9003
210240;201506;3029;9564;2855;9322;161;504;2419;7986;2580;8490
210250;201506;5009;16211;4751;15880;121;513;4398;14672;4519;15185
210255;201506;2519;8073;2309;7695;378;1306;1610;5424;1988;6730
210260;201506;5385;17137;4893;16410;667;2148;3598;12445;4265;14593
210270;201506;5356;15308;4726;14429;116;501;4246;12909;4362;13410
210275;201506;3610;8917;3397;8688;61;95;3283;8497;3344;8592
210280;201506;5659;17000;4954;16085;292;1147;4003;12880;4295;14027
210290;201506;5650;18507;5168;17913;376;1244;4404;15611;4780;16855
210300;201506;37483;106341;30838;98180;2148;7049;24050;79570;26198;86619
210310;201506;2929;8270;2711;7982;99;248;2375;7041;2474;7289
210312;201506;2196;7067;2119;6960;76;326;1910;6255;1986;6581
210315;201506;2478;8544;2336;8343;163;682;1983;7093;2146;7775
210317;201506;4306;13016;4109;12767;235;696;3681;11600;3916;12296
210320;201506;19158;61096;17786;59435;969;3235;15384;52247;16353;55482
210325;201506;3596;11286;3216;10724;327;1170;2436;8223;2763;9393
210330;201506;36944;89042;28687;80292;3728;8212;20540;64736;24268;72948
210340;201506;11790;35759;10674;34365;1317;3417;7891;27452;9208;30869
210350;201506;10254;32047;9349;30799;639;2069;7633;25557;8272;27626
210355;201506;3943;14331;3639;13904;177;562;3250;12817;3427;13379
210360;201506;16937;50945;15501;48978;1179;3785;12493;40170;13672;43955
210370;201506;9514;22793;7970;21150;274;501;7170;19667;7444;20168
210375;201506;3233;9676;2694;9014;776;2688;1400;4851;2176;7539
210380;201506;6263;17605;5537;16630;435;1172;4613;14182;5048;15354
210390;201506;2841;10058;2592;9652;116;569;2232;8330;2348;8899
210400;201506;4984;15602;4774;15352;161;466;4405;14346;4566;14812
210405;201506;8485;23375;6862;21117;2117;6533;2832;9645;4949;16178
210407;201506;2062;7332;1805;6902;207;775;1322;5213;1529;5988
210408;201506;2354;9185;2206;9011;117;495;1933;8172;2050;8667
210409;201506;3775;13759;3568;13448;194;831;3013;11476;3207;12307
210410;201506;3517;11743;3391;11589;292;790;2913;10363;3205;11153
210420;201506;4100;13463;3768;12891;272;915;3068;10678;3340;11593
210430;201506;2203;6800;2127;6707;124;402;1857;5873;1981;6275
210440;201506;4115;12877;4004;12727;208;601;3611;11662;3819;12263
210450;201506;2906;9138;2598;8689;178;661;2119;7063;2297;7724
210455;201506;4155;12160;3659;11408;572;1800;2544;8207;3116;10007
210460;201506;3864;12493;3563;12070;152;612;3067;10433;3219;11045
210462;201506;1642;5908;1532;5704;107;460;1228;4604;1335;5064
210465;201506;2640;8712;2463;8480;293;807;1986;7166;2279;7973
210467;201506;6265;20705;5841;20207;386;1137;5040;17936;5426;19073
210470;201506;2060;5660;1587;4979;82;268;1246;3962;1328;4230
210480;201506;14093;46056;12298;43682;2898;10065;7470;28322;10368;38387
210490;201506;3523;10048;3129;9481;181;611;2596;7820;2777;8431
210500;201506;6411;26158;6141;25704;726;2878;4695;20412;5421;23290
210510;201506;6547;22331;6246;21976;332;854;5475;19970;5807;20824
210515;201506;3560;11739;3414;11568;119;365;3151;10822;3270;11187
210520;201506;2601;8117;2388;7824;106;351;2120;7021;2226;7372
210530;201506;37369;115646;30118;104702;7748;30388;13610;48407;21358;78795
210535;201506;3240;11265;3103;11057;140;504;2752;9920;2892;10424
210540;201506;13227;44551;11725;42268;2745;9572;6580;25734;9325;35306
210542;201506;5921;17313;5416;16763;331;777;4758;15231;5089;16008
210545;201506;2335;7594;2209;7390;78;370;1919;6392;1997;6762
210547;201506;3785;13293;3546;12903;283;957;2864;10701;3147;11658
210550;201506;6024;17779;5531;17268;275;654;5031;16139;5306;16793
210560;201506;4238;13198;3782;12465;214;808;3184;10461;3398;11269
210565;201506;1541;5329;1320;4989;121;573;963;3645;1084;4218
210570;201506;12669;35664;11327;34116;834;1830;9664;30239;10498;32069
210580;201506;3143;9564;2830;9177;344;879;2180;7713;2524;8592
210590;201506;4255;13202;3982;12879;265;892;3457;11282;3722;12174
210592;201506;2502;7834;2404;7678;65;259;2144;6848;2209;7107
210594;201506;2733;7696;2263;7025;128;375;1819;5792;1947;6167
210596;201506;2765;10274;2617;9999;274;1097;1978;7687;2252;8784
210598;201506;1922;5940;1780;5763;104;404;1548;4952;1652;5356
210600;201506;3268;9503;2892;8989;193;639;2360;7329;2553;7968
210610;201506;2737;8711;2470;8381;161;610;2094;7181;2255;7791
210620;201506;1955;6127;1809;5943;54;143;1656;5525;1710;5668
210630;201506;3674;13072;3243;12333;418;1672;2145;8392;2563;10064
210632;201506;4627;15978;4259;15458;392;1457;3445;12678;3837;14135
210635;201506;1918;6764;1827;6627;72;249;1656;6102;1728;6351
210637;201506;2771;9325;2577;9057;143;530;2179;7775;2322;8305
210640;201506;4253;15257;4174;15169;8;25;4083;14958;4091;14983
210650;201506;6921;21257;6765;21079;98;271;6569;20591;6667;20862
210660;201506;7847;23848;7280;23024;223;657;6773;21527;6996;22184
210663;201506;2690;7968;2533;7774;175;583;2149;6652;2324;7235
210667;201506;1803;6363;1715;6229;84;355;1494;5473;1578;5828
210670;201506;4494;16823;4303;16509;259;1096;3612;14062;3871;15158
210675;201506;4998;13972;4632;13525;333;871;3923;11722;4256;12593
210680;201506;4343;12216;3922;11709;208;564;3375;10203;3583;10767
210690;201506;7306;24225;6891;23785;260;767;6234;22166;6494;22933
210700;201506;2640;7894;2464;7701;426;1047;1715;6095;2141;7142
210710;201506;4801;15797;4564;15425;193;754;3965;13461;4158;14215
210720;201506;2538;9234;2385;9011;151;664;2085;7842;2236;8506
210725;201506;1111;4163;980;3928;139;592;592;2394;731;2986
210730;201506;1129;3615;1034;3483;100;293;810;2791;910;3084
210735;201506;4091;14370;3754;13794;688;2547;2506;9568;3194;12115
210740;201506;5002;14510;4729;14229;150;516;4324;12914;4474;13430
210745;201506;3896;11673;3639;11332;251;620;3109;9885;3360;10505
210750;201506;20593;55833;18290;53240;2028;5805;14424;42950;16452;48755
210760;201506;5993;16660;5626;16271;53;185;5472;15823;5525;16008
210770;201506;5848;16208;5156;15429;165;569;4706;14109;4871;14678
210780;201506;8578;28449;7854;27166;909;3333;5644;19914;6553;23247
210790;201506;4867;14865;4191;14117;294;741;3492;12359;3786;13100
210800;201506;4777;13747;4358;13238;180;544;3834;11793;4014;12337
210805;201506;3672;15536;3546;15311;156;767;3088;13485;3244;14252
210810;201506;5461;16779;5082;16310;368;666;4408;14928;4776;15594
210820;201506;8172;23481;7487;22536;1277;3713;5036;15618;6313;19331
210825;201506;5718;19526;5452;19168;451;1473;4533;16328;4984;17801
210830;201506;8492;25500;8104;25037;774;2100;6753;21509;7527;23609
210840;201506;3745;10308;3373;9751;213;557;2740;7966;2953;8523
210845;201506;5797;17981;5564;17727;150;346;5184;16879;5334;17225
210850;201506;6141;22072;5617;21164;794;3348;3885;14692;4679;18040
210860;201506;17510;52922;15929;50795;1445;4715;12665;41007;14110;45722
210870;201506;6081;20119;5532;19470;560;1818;4430;16075;4990;17893
210880;201506;4261;13788;4129;13604;207;709;3674;12184;3881;12893
210890;201506;5405;15892;4938;15350;413;1330;4118;13016;4531;14346
210900;201506;5046;15276;4185;13861;1402;4840;1401;4956;2803;9796
210905;201506;1875;5842;1714;5618;135;354;1377;4665;1512;5019
210910;201506;9030;28631;8233;27357;1348;4801;5580;18668;6928;23469
210920;201506;3149;10910;3030;10725;167;600;2603;9349;2770;9949
210923;201506;1497;5297;1386;5134;167;654;967;3703;1134;4357
210927;201506;4862;15370;4658;15157;25;84;4559;14902;4584;14986
210930;201506;2559;9272;2439;9118;146;722;2096;7778;2242;8500
210940;201506;2853;11107;2795;11004;209;822;2362;9406;2571;10228
210945;201506;5964;17791;5744;17561;243;301;5405;16990;5648;17291
210950;201506;5432;16673;4746;15593;476;1582;3524;11839;4000;13421
210955;201506;1914;6188;1685;5848;221;764;1167;4242;1388;5006
210960;201506;8855;29045;8483;28535;2329;7592;4967;17773;7296;25365
210970;201506;1431;5092;1265;4831;172;781;868;3320;1040;4101
210975;201506;1771;5972;1672;5798;143;556;1300;4535;1443;5091
210980;201506;9954;23691;9682;23397;669;1312;8575;21258;9244;22570
210990;201506;16965;50428;13616;46079;2924;10330;7847;27480;10771;37810
211000;201506;15926;51018;14198;48925;776;2958;12191;42709;12967;45667
211003;201506;4887;17287;4467;16668;372;1565;3441;13172;3813;14737
211010;201506;6634;23798;6397;23523;82;270;6125;22751;6207;23021
211020;201506;7457;23743;7272;23463;370;1215;6404;20793;6774;22008
211023;201506;2334;7881;2253;7734;151;561;1922;6656;2073;7217
211027;201506;2949;11430;2852;11278;270;950;2333;9551;2603;10501
211030;201506;4088;12317;3701;11906;574;1311;2891;10079;3465;11390
211040;201506;4308;16380;4163;16154;139;648;3673;14454;3812;15102
211050;201506;10248;26903;10050;26686;249;564;9619;25698;9868;26262
211060;201506;6055;21608;5890;21369;448;1618;5040;18584;5488;20202
211065;201506;1854;6186;1683;5968;72;253;1544;5537;1616;5790
211070;201506;8353;28438;7693;27332;495;1840;6354;22902;6849;24742
211080;201506;1419;4282;1163;3919;95;468;927;3024;1022;3492
211085;201506;1884;6535;1718;6252;294;1081;1155;4304;1449;5385
211090;201506;3583;10695;3364;10400;133;548;2920;8918;3053;9466
211100;201506;6708;17443;6532;17247;50;175;6344;16743;6394;16918
211102;201506;3103;11520;2939;11295;254;929;2506;9843;2760;10772
211105;201506;2707;8636;2321;8077;192;767;1854;6403;2046;7170
211107;201506;4550;14455;4116;13883;237;773;3498;12124;3735;12897
211110;201506;6453;19318;5248;17524;1071;3512;3139;11064;4210;14576
211120;201506;34519;95033;30589;90320;4842;13537;21865;67162;26707;80699
211125;201506;2123;6849;1907;6515;115;401;1632;5623;1747;6024
211130;201506;137238;386357;125354;371507;23106;68575;82935;251204;106041;319779
211140;201506;5447;17328;5090;16782;219;801;4389;14511;4608;15312
211150;201506;9981;29428;9183;28449;519;1783;7857;24415;8376;26198
211153;201506;3020;9161;2805;8906;401;1093;2200;7317;2601;8410
211157;201506;1240;3963;1057;3692;106;455;706;2536;812;2991
211160;201506;4091;13752;3514;12781;308;1449;2525;9046;2833;10495
211163;201506;1660;5555;1582;5442;51;175;1435;5031;1486;5206
211167;201506;1548;5090;1443;4938;29;112;1351;4653;1380;4765
211170;201506;6498;17281;6233;16978;114;354;5793;15748;5907;16102
211172;201506;2409;7141;2176;6798;137;542;1846;5682;1983;6224
211174;201506;2850;8319;2579;7982;82;358;2309;7063;2391;7421
211176;201506;4764;14835;4186;14108;461;1573;3129;10815;3590;12388
211178;201506;3639;9992;3512;9849;69;181;3338;9362;3407;9543
211180;201506;4348;15272;4089;14874;300;1182;3386;12508;3686;13690
211190;201506;2825;9542;2620;9254;87;405;2288;8110;2375;8515
211195;201506;1503;4573;1246;4254;81;227;1030;3679;1111;3906
211200;201506;2210;7429;1949;7081;293;950;1406;5454;1699;6404
211210;201506;7222;21859;6908;21436;409;1229;5987;18819;6396;20048
211220;201506;34643;100890;29846;94815;5851;19180;19177;62590;25028;81770
211223;201506;5279;15566;4810;14821;547;1705;3554;11145;4101;12850
211227;201506;1656;6056;1540;5881;131;589;1220;4695;1351;5284
211230;201506;8665;28528;7854;27197;982;3508;5753;20323;6735;23831
211240;201506;8135;28005;7771;27582;261;949;7208;25707;7469;26656
211245;201506;5528;16069;5468;15998;117;225;5247;15532;5364;15757
211250;201506;12964;44100;12200;43243;1489;3866;9780;37246;11269;41112
211260;201506;8543;26577;8280;26232;582;1842;7308;23301;7890;25143
211270;201506;10494;35992;9421;34661;560;2384;7704;28907;8264;31291
211280;201506;12708;37655;11973;36775;1114;2727;10031;32115;11145;34842
211285;201506;1780;6472;1574;6015;298;1217;815;3235;1113;4452
211290;201506;7299;24136;7058;23826;623;1800;5962;20685;6585;22485
211300;201506;8373;25343;7811;24573;230;714;7089;22484;7319;23198
211400;201506;11489;36066;10344;34552;2643;8758;5370;19836;8013;28594
220005;201506;1825;5277;1679;5061;68;276;1399;4114;1467;4390
220010;201506;1471;4180;1282;3902;79;299;959;2887;1038;3186
220020;201506;3374;10588;3179;10257;571;1883;2102;6797;2673;8680
220025;201506;2269;5556;2033;5211;44;128;1755;4445;1799;4573
220027;201506;1386;3759;1255;3592;69;190;1042;3013;1111;3203
220030;201506;3379;9454;3305;9338;178;598;2892;8104;3070;8702
220040;201506;7882;24616;7351;23715;1448;4822;4623;14910;6071;19732
220045;201506;1420;4589;1296;4361;84;348;985;3250;1069;3598
220050;201506;4615;13563;4001;12601;258;989;3196;9933;3454;10922
220060;201506;2005;5214;1904;5098;62;148;1737;4662;1799;4810
220070;201506;2493;7333;2248;6954;142;466;1822;5632;1964;6098
220080;201506;744;2299;703;2231;73;310;554;1682;627;1992
220090;201506;1828;4643;1554;4281;84;286;1330;3595;1414;3881
220095;201506;747;2023;700;1957;29;94;635;1748;664;1842
220100;201506;1407;4250;1181;3872;117;413;845;2779;962;3192
220105;201506;2230;7218;2003;6784;170;597;1490;5063;1660;5660
220110;201506;3423;10123;3217;9789;160;626;2755;8244;2915;8870
220115;201506;2407;8534;2316;8388;183;755;1984;7167;2167;7922
220117;201506;1386;3664;1127;3282;88;249;893;2616;981;2865
220120;201506;12364;35801;11498;34733;193;803;10809;32567;11002;33370
220130;201506;900;3073;780;2904;68;263;646;2421;714;2684
220140;201506;1652;4456;1478;4242;225;497;1166;3508;1391;4005
220150;201506;7073;22000;6705;21493;206;809;6032;19271;6238;20080
220155;201506;1113;3440;905;3046;62;265;607;1977;669;2242
220157;201506;1069;2710;946;2530;22;66;831;2205;853;2271
220160;201506;2773;8274;2436;7698;130;530;1928;6006;2058;6536
220170;201506;1388;4316;1217;4035;61;282;969;3162;1030;3444
220173;201506;2066;6278;1728;5629;55;268;1411;4538;1466;4806
220177;201506;1787;5249;1757;5204;64;199;1641;4864;1705;5063
220180;201506;1192;3210;1006;2876;34;128;741;2050;775;2178
220190;201506;4652;15443;4236;14878;583;1997;3225;11545;3808;13542
220191;201506;1445;4871;1371;4744;202;683;959;3349;1161;4032
220192;201506;1822;5119;1436;4427;127;416;996;3064;1123;3480
220194;201506;1728;5141;1546;4828;137;461;1143;3472;1280;3933
220196;201506;1987;5883;1833;5632;187;619;1394;4281;1581;4900
220198;201506;1347;3796;1056;3419;16;57;982;3215;998;3272
220200;201506;4419;15092;4200;14768;630;2259;3046;10860;3676;13119
220202;201506;2084;6469;1866;6074;50;244;1624;5181;1674;5425
220205;201506;2953;7578;2543;7024;55;231;2271;6181;2326;6412
220207;201506;875;2725;778;2556;78;307;587;1908;665;2215
220208;201506;1819;5900;1590;5499;218;861;1060;3663;1278;4524
220209;201506;1530;4711;1391;4489;60;260;1127;3615;1187;3875
220210;201506;1801;4790;1567;4438;45;177;1320;3667;1365;3844
220211;201506;1631;4794;1550;4688;90;367;1333;3975;1423;4342
220213;201506;1771;5106;1623;4834;52;198;1318;3846;1370;4044
220217;201506;1920;6286;1845;6199;30;84;1725;5880;1755;5964
220220;201506;11274;31594;10199;29975;915;2401;7422;22397;8337;24798
220225;201506;1064;3155;924;2966;37;157;779;2447;816;2604
220230;201506;5698;15427;4964;14418;156;439;4413;12894;4569;13333
220240;201506;2884;9029;2689;8692;186;697;2099;6757;2285;7454
220245;201506;1516;4064;1332;3801;48;144;1162;3351;1210;3495
220250;201506;3197;9123;2957;8766;64;221;2675;7942;2739;8163
220253;201506;1773;5297;1495;4813;150;551;1093;3502;1243;4053
220255;201506;1774;5040;1540;4655;75;313;1267;3722;1342;4035
220260;201506;4784;15328;4222;14293;334;1174;3199;10901;3533;12075
220265;201506;1339;4663;1218;4461;104;438;831;3090;935;3528
220270;201506;6805;22026;6573;21611;352;1625;5614;17966;5966;19591
220271;201506;1496;4203;1383;4030;74;194;1194;3532;1268;3726
220272;201506;1815;5541;1661;5269;84;341;1337;4193;1421;4534
220273;201506;1222;3558;1082;3314;94;297;798;2422;892;2719
220275;201506;2125;5459;1755;5008;34;138;1602;4502;1636;4640
220277;201506;2365;6638;2092;6218;112;389;1684;4997;1796;5386
220280;201506;1745;4583;1515;4204;119;414;1159;3123;1278;3537
220285;201506;1617;4395;1383;4070;43;157;1214;3596;1257;3753
220290;201506;6245;20790;5394;19628;501;2073;4075;14908;4576;16981
220300;201506;1957;6395;1736;6091;82;401;1422;4944;1504;5345
220310;201506;2532;8442;2249;8123;71;210;2030;7585;2101;7795
220320;201506;3362;9971;2843;9055;335;1179;2027;6452;2362;7631
220323;201506;1515;5362;1324;5083;142;582;1008;3933;1150;4515
220325;201506;1170;3802;1031;3527;90;371;742;2523;832;2894
220327;201506;1381;4413;1247;4188;53;268;1005;3317;1058;3585
220330;201506;3639;10053;3394;9749;143;409;3027;8750;3170;9159
220335;201506;2028;5965;1801;5695;73;242;1603;5121;1676;5363
220340;201506;1919;5342;1649;4939;128;416;1265;3763;1393;4179
220342;201506;1116;3756;1044;3643;83;339;832;2905;915;3244
220345;201506;2936;7741;2552;7150;53;150;2297;6425;2350;6575
220350;201506;4097;10867;3532;10006;205;625;2839;8027;3044;8652
220360;201506;1309;3679;1130;3392;109;371;846;2502;955;2873
220370;201506;9241;26497;8369;25381;369;1160;7481;22720;7850;23880
220375;201506;1559;4848;1442;4705;33;111;1355;4457;1388;4568
220380;201506;1419;3834;1213;3554;68;233;985;2855;1053;3088
220385;201506;836;2179;686;1935;23;82;560;1551;583;1633
220390;201506;9565;29731;8594;27940;2212;7562;3369;11047;5581;18609
220400;201506;1548;3637;1275;3223;43;150;1082;2653;1125;2803
220410;201506;1414;4005;1175;3658;93;366;910;2769;1003;3135
220415;201506;868;2363;777;2242;56;162;586;1679;642;1841
220420;201506;2206;6418;1911;5828;107;337;1534;4683;1641;5020
220430;201506;2585;7496;2501;7381;161;515;2147;6303;2308;6818
220435;201506;1612;4804;1479;4583;45;160;1223;3779;1268;3939
220440;201506;2492;8139;2302;7915;116;397;2020;6968;2136;7365
220450;201506;2352;7116;1985;6588;445;1567;1156;3835;1601;5402
220455;201506;1345;4284;1247;4148;46;161;1134;3804;1180;3965
220460;201506;961;2577;887;2488;40;121;783;2169;823;2290
220465;201506;2371;7869;2152;7540;533;1975;1245;4392;1778;6367
220470;201506;4070;12100;3692;11480;210;740;2872;8800;3082;9540
220480;201506;2598;7419;2306;6998;171;515;1815;5508;1986;6023
220490;201506;2347;6730;2173;6513;76;275;1942;5798;2018;6073
220500;201506;3398;9095;2846;8164;116;509;2316;6456;2432;6965
220510;201506;3038;8414;2276;7247;119;497;1656;5203;1775;5700
220515;201506;2013;4890;1748;4556;150;358;1414;3735;1564;4093
220520;201506;5254;14487;4822;13898;132;397;4352;12600;4484;12997
220525;201506;1348;3803;1252;3660;56;194;1060;3068;1116;3262
220527;201506;1421;4368;1267;4042;144;477;934;3040;1078;3517
220530;201506;1252;3702;1127;3519;67;278;955;2910;1022;3188
220535;201506;904;2726;856;2666;81;270;662;2050;743;2320
220540;201506;3550;11460;3378;11192;153;634;2883;9498;3036;10132
220545;201506;1435;4821;1368;4702;177;699;995;3357;1172;4056
220550;201506;9364;30183;8763;29203;1079;3788;6391;21386;7470;25174
220551;201506;1456;4795;1339;4609;82;370;1082;3687;1164;4057
220552;201506;1628;5142;1412;4733;94;454;1064;3417;1158;3871
220553;201506;1670;4901;1378;4458;62;228;1113;3646;1175;3874
220554;201506;838;2410;739;2265;72;228;574;1768;646;1996
220555;201506;2370;7014;2199;6799;54;203;1990;6145;2044;6348
220556;201506;1486;4611;1332;4322;68;281;1024;3260;1092;3541
220557;201506;1588;5177;1431;4874;172;655;977;3311;1149;3966
220558;201506;1077;3329;978;3157;74;318;727;2278;801;2596
220559;201506;1540;4326;1376;4058;39;144;1187;3487;1226;3631
220560;201506;1769;4353;1435;3902;67;188;1198;3230;1265;3418
220570;201506;7500;24002;7024;23216;1296;4269;4616;15678;5912;19947
220580;201506;6578;21324;6414;21129;304;913;5900;19679;6204;20592
220585;201506;2004;7188;1905;7002;127;515;1582;5830;1709;6345
220590;201506;1369;4115;1238;3931;206;682;830;2693;1036;3375
220595;201506;2404;7006;2198;6732;44;184;1991;6063;2035;6247
220600;201506;1308;3183;1063;2881;179;337;770;2246;949;2583
220605;201506;1994;5839;1708;5377;83;282;1361;4236;1444;4518
220610;201506;2734;8302;2632;8149;84;331;2352;7246;2436;7577
220620;201506;7884;26437;7630;26074;324;1342;6808;23248;7132;24590
220630;201506;408;1263;350;1153;60;207;192;639;252;846
220635;201506;1784;6308;1607;5921;114;549;1112;4039;1226;4588
220640;201506;2708;7882;2469;7548;135;468;2093;6375;2228;6843
220650;201506;2330;6696;2065;6241;119;421;1634;4872;1753;5293
220660;201506;2605;8232;2309;7846;175;797;1932;6407;2107;7204
220665;201506;1198;4169;1144;4074;34;166;1043;3695;1077;3861
220667;201506;1797;5943;1692;5806;56;199;1473;5088;1529;5287
220669;201506;1932;6258;1798;6018;272;1069;1213;4010;1485;5079
220670;201506;2076;6228;1880;5978;148;376;1591;5230;1739;5606
220672;201506;2553;7244;2419;7088;257;744;1983;5879;2240;6623
220675;201506;1319;3808;1230;3661;83;221;975;2921;1058;3142
220680;201506;2269;7345;2144;7176;165;550;1786;6048;1951;6598
220690;201506;1766;4891;1528;4509;100;319;1208;3588;1308;3907
220695;201506;933;2676;860;2555;44;148;669;1958;713;2106
220700;201506;8925;25472;7887;23878;592;2034;6124;18434;6716;20468
220710;201506;820;2402;682;2162;44;137;500;1593;544;1730
220720;201506;2088;5663;1982;5528;56;166;1778;4980;1834;5146
220730;201506;1416;3985;1213;3671;39;169;1021;3049;1060;3218
220735;201506;1034;2656;835;2309;40;140;684;1867;724;2007
220740;201506;1469;4611;1224;4287;123;417;979;3535;1102;3952
220750;201506;4021;11649;3757;11255;420;1061;2959;9164;3379;10225
220755;201506;1228;3469;1113;3276;53;184;900;2610;953;2794
220760;201506;2701;9387;2535;9168;115;491;2221;8082;2336;8573
220770;201506;22814;75919;20527;71514;6779;24786;7328;26328;14107;51114
220775;201506;1230;3254;1196;3216;10;19;1174;3166;1184;3185
220777;201506;1678;4665;1521;4431;98;272;1207;3498;1305;3770
220779;201506;1328;3571;1278;3498;36;132;1171;3138;1207;3270
220780;201506;6226;16387;5501;15335;382;1069;4524;12647;4906;13716
220785;201506;1325;3552;1262;3426;54;127;1146;3109;1200;3236
220790;201506;10023;31221;9351;30159;874;2998;7371;23689;8245;26687
220793;201506;856;2449;782;2336;37;137;668;1988;705;2125
220795;201506;1484;4157;1430;4080;72;206;1290;3696;1362;3902
220800;201506;16620;45887;15034;43643;989;3474;11638;33341;12627;36815
220810;201506;3379;9819;2922;9050;151;605;2328;7131;2479;7736
220820;201506;5404;14923;5002;14360;189;598;4504;12905;4693;13503
220830;201506;7607;21521;7104;20706;704;2062;5584;16417;6288;18479
220840;201506;14772;46676;13173;43493;3107;10458;6284;21214;9391;31672
220850;201506;2875;9907;2736;9735;136;541;2410;8631;2546;9172
220855;201506;638;1965;564;1834;44;169;416;1330;460;1499
220860;201506;973;2631;869;2467;46;169;718;2008;764;2177
220865;201506;2721;7438;2160;6499;94;459;1706;4931;1800;5390
220870;201506;2398;7895;2094;7499;84;343;1859;6657;1943;7000
220880;201506;4889;13088;4570;12710;134;404;4243;11825;4377;12229
220885;201506;1345;4818;1185;4525;102;484;883;3354;985;3838
220887;201506;1414;3534;1219;3261;20;61;1129;3013;1149;3074
220890;201506;1629;5708;1477;5450;121;434;1183;4482;1304;4916
220900;201506;1914;5467;1682;5032;67;190;1423;4263;1490;4453
220910;201506;1667;4974;1466;4683;58;177;1278;4133;1336;4310
220915;201506;1048;2967;895;2685;44;190;694;2024;738;2214
220920;201506;1369;4961;1253;4791;118;553;945;3565;1063;4118
220930;201506;1400;4680;1330;4578;66;272;1126;3896;1192;4168
220935;201506;1083;3307;947;3028;50;213;646;1978;696;2191
220937;201506;1558;4246;1311;3818;70;255;1012;2876;1082;3131
220940;201506;1424;4421;1314;4192;80;338;994;3117;1074;3455
220945;201506;456;1659;420;1590;45;198;296;1101;341;1299
220950;201506;1331;3320;978;2746;31;125;719;1964;750;2089
220955;201506;1476;4320;1292;4010;91;306;992;3068;1083;3374
220960;201506;912;2400;720;2079;14;52;575;1646;589;1698
220965;201506;1715;5125;1607;4968;64;301;1394;4220;1458;4521
220970;201506;2190;5794;1622;4884;151;461;1109;3362;1260;3823
220975;201506;671;2218;638;2173;30;133;589;1986;619;2119
220980;201506;1329;4070;1164;3787;94;359;848;2765;942;3124
220985;201506;1258;3677;1186;3571;103;380;891;2595;994;2975
220987;201506;1546;4885;1395;4625;91;404;1064;3438;1155;3842
220990;201506;1887;5405;1631;4980;52;245;1255;3737;1307;3982
220995;201506;1335;3853;998;3323;106;393;703;2374;809;2767
220997;201506;2241;7028;2124;6852;64;232;1963;6330;2027;6562
221000;201506;4466;13645;4110;13047;406;1505;3094;9705;3500;11210
221005;201506;1462;4604;1337;4365;492;1497;589;2079;1081;3576
221010;201506;1189;3192;1011;2957;51;156;854;2487;905;2643
221020;201506;1853;5724;1721;5487;83;344;1274;3988;1357;4332
221030;201506;1639;4708;1436;4386;74;307;1184;3571;1258;3878
221035;201506;1456;4033;1368;3926;53;123;1260;3672;1313;3795
221037;201506;638;1901;572;1790;21;87;432;1298;453;1385
221038;201506;633;1774;508;1562;41;126;328;1017;369;1143
221039;201506;927;2659;846;2542;50;202;715;2094;765;2296
221040;201506;4728;14538;4448;14079;227;802;3660;11658;3887;12460
221050;201506;3544;10858;3354;10601;175;649;2886;9081;3061;9730
221060;201506;8317;23990;7382;22506;709;2319;5527;16887;6236;19206
221062;201506;1299;4568;1210;4421;41;187;1080;3950;1121;4137
221063;201506;1068;3533;984;3372;257;825;548;2029;805;2854
221065;201506;2828;7848;2561;7421;183;536;2077;5978;2260;6514
221070;201506;3989;12466;3498;11646;166;670;2859;9520;3025;10190
221080;201506;3538;9296;3060;8656;134;431;2615;7407;2749;7838
221090;201506;1391;3832;1192;3511;33;143;991;2869;1024;3012
221093;201506;1724;5148;1614;4919;311;1019;903;2687;1214;3706
221095;201506;984;2657;883;2513;24;61;775;2222;799;2283
221097;201506;812;2288;676;2045;49;199;498;1460;547;1659
221100;201506;118146;346305;108570;330463;20677;67674;67328;201690;88005;269364
221110;201506;10298;32986;9708;32250;451;1759;8335;27609;8786;29368
221120;201506;4201;13720;3994;13366;837;2891;2636;8915;3473;11806
221130;201506;4633;13474;3943;12083;1199;3706;1742;5381;2941;9087
221135;201506;1514;4751;1402;4594;146;557;1145;3689;1291;4246
221140;201506;1387;3411;1255;3234;56;128;1085;2795;1141;2923
221150;201506;1243;3207;1025;2836;28;127;819;2224;847;2351
221160;201506;856;2252;804;2172;41;119;641;1749;682;1868
221170;201506;1161;3615;1077;3476;65;230;864;2778;929;3008
230010;201506;3331;9163;2780;8225;187;655;2171;6325;2358;6980
230015;201506;2888;9985;2701;9580;407;1692;1705;5916;2112;7608
230020;201506;14459;47326;13948;46431;731;2731;11818;39531;12549;42262
230030;201506;12392;35866;11260;34105;572;1962;9328;28174;9900;30136
230040;201506;4669;12847;3946;11633;293;1042;2950;8566;3243;9608
230050;201506;2627;9009;2071;7526;438;1653;832;3048;1270;4701
230060;201506;2164;6296;1868;5759;109;405;1372;4167;1481;4572
230070;201506;4511;12299;3850;11260;357;1155;2659;7874;3016;9029
230075;201506;8871;31936;8296;30786;615;3129;6520;23701;7135;26830
230080;201506;2437;6432;1982;5765;97;311;1642;4784;1739;5095
230090;201506;3788;11147;3373;10430;417;1436;2400;7419;2817;8855
230100;201506;16817;50503;15372;47861;2818;9450;9072;28398;11890;37848
230110;201506;13762;44021;12696;41803;2405;8460;7157;23283;9562;31743
230120;201506;8066;22336;6955;20713;792;2294;4767;15025;5559;17319
230125;201506;3002;8758;2473;7766;176;599;1815;5677;1991;6276
230130;201506;5926;19312;5010;17388;469;1923;3459;11835;3928;13758
230140;201506;3639;11624;3102;10662;415;1538;2025;7070;2440;8608
230150;201506;1704;5381;1471;4892;280;1044;852;2760;1132;3804
230160;201506;6551;19534;5790;18378;383;1486;4530;14268;4913;15754
230170;201506;6602;20531;5598;18673;365;1436;4092;13518;4457;14954
230180;201506;1792;5247;1587;4852;105;418;1163;3434;1268;3852
230185;201506;4212;13729;3805;12977;636;2202;2379;8412;3015;10614
230190;201506;13260;42217;11679;39042;2427;9040;5767;18964;8194;28004
230195;201506;5213;15974;4620;14987;272;1175;3666;11561;3938;12736
230200;201506;5571;16096;4984;14966;426;1384;3707;11041;4133;12425
230205;201506;4302;13700;3846;12920;273;1157;2804;9353;3077;10510
230210;201506;9181;26528;7996;24684;1743;5455;4476;14257;6219;19712
230220;201506;13337;38360;12028;36128;1258;4300;8696;25709;9954;30009
230230;201506;7678;24938;6956;23516;1018;3596;4448;15207;5466;18803
230240;201506;13882;39451;12295;36716;633;2347;9670;28366;10303;30713
230250;201506;10130;31389;9945;31113;480;1794;8178;25324;8658;27118
230260;201506;14800;49694;13723;47556;2462;9110;7815;27619;10277;36729
230270;201506;7466;22237;6454;20490;764;2685;4349;13930;5113;16615
230280;201506;20091;59879;17881;56188;2117;6800;12758;40429;14875;47229
230290;201506;4815;14765;4134;13401;561;1808;2764;9023;3325;10831
230300;201506;4467;13690;4250;13374;321;1228;3403;10563;3724;11791
230310;201506;4935;14684;4290;13614;287;1205;3181;9916;3468;11121
230320;201506;7149;22685;6548;21615;511;2082;4934;16141;5445;18223
230330;201506;4928;14468;4242;13137;336;1172;3022;9276;3358;10448
230340;201506;3488;11799;3188;11160;409;1644;2019;6885;2428;8529
230350;201506;18130;55532;16407;52601;2173;7719;9942;32459;12115;40178
230360;201506;3334;9566;2726;8432;289;1028;1826;5572;2115;6600
230365;201506;3074;8411;2684;7778;129;483;2160;6190;2289;6673
230370;201506;55393;179157;49934;169679;13553;48563;23157;80934;36710;129497
230380;201506;6661;19568;5642;17737;355;1246;4125;12960;4480;14206
230390;201506;3604;11312;3198;10619;283;1216;2255;7330;2538;8546
230393;201506;3303;10922;2817;9929;253;1209;1984;6721;2237;7930
230395;201506;5526;16457;4960;15475;763;2444;3091;9895;3854;12339
230400;201506;5399;16560;4705;15464;297;1311;3643;11749;3940;13060
230410;201506;14415;46070;12664;42348;1844;6605;7827;26188;9671;32793
230420;201506;24734;80220;22530;75758;5278;19161;10621;35523;15899;54684
230423;201506;4214;13926;3897;13295;282;1178;2978;10062;3260;11240
230425;201506;5620;18649;5148;17586;718;2599;3374;11560;4092;14159
230426;201506;2808;7859;2239;6784;109;450;1662;4908;1771;5358
230427;201506;1825;5482;1391;4539;153;521;849;2707;1002;3228
230428;201506;8735;27556;8332;26844;1337;4787;5174;16507;6511;21294
230430;201506;4570;14596;4247;13975;351;1441;3045;9747;3396;11188
230435;201506;4867;15740;4361;14835;814;3141;2362;7986;3176;11127
230440;201506;358198;1078685;329764;1029091;79488;263274;157151;492583;236639;755857
230445;201506;4598;12418;3867;11334;276;822;2807;8269;3083;9091
230450;201506;3600;11491;3121;10608;365;1527;2063;6908;2428;8435
230460;201506;1926;6393;1699;5977;168;695;1172;4068;1340;4763
230465;201506;4191;12512;3508;11277;266;1120;2372;7456;2638;8576
230470;201506;10884;39986;10109;38403;1172;4893;7259;27746;8431;32639
230480;201506;1459;4698;1244;4297;158;608;830;2863;988;3471
230490;201506;2615;7861;2250;7174;392;1364;1122;3436;1514;4800
230495;201506;5841;19424;5243;18398;766;3198;2987;10426;3753;13624
230500;201506;9555;33487;9113;32659;621;2683;7095;25470;7716;28153
230510;201506;1551;5497;1245;4719;325;1300;401;1586;726;2886
230520;201506;4896;15022;4387;14103;456;1686;2911;9303;3367;10989
230523;201506;14759;48088;12911;43846;3113;11639;3433;11831;6546;23470
230526;201506;4085;12467;3552;11557;288;1173;2632;8489;2920;9662
230530;201506;5406;17678;4886;16974;1021;3602;3139;11237;4160;14839
230533;201506;3966;11311;3566;10582;250;808;2773;8211;3023;9019
230535;201506;5620;16593;4916;15329;720;2232;3017;9729;3737;11961
230540;201506;18351;53330;16449;50342;789;3040;13590;41138;14379;44178
230550;201506;19954;59875;17887;55938;3639;12309;9463;29248;13102;41557
230560;201506;6696;19366;5935;17990;250;1035;4678;13905;4928;14940
230565;201506;3398;9545;2754;8321;149;552;2018;6052;2167;6604
230570;201506;3870;10400;3399;9819;134;505;2846;8162;2980;8667
230580;201506;10271;31218;9587;30257;477;1633;8451;26818;8928;28451
230590;201506;8943;28123;7789;25933;596;2530;5688;18448;6284;20978
230600;201506;3706;10419;2889;8789;192;653;1885;5721;2077;6374
230610;201506;6081;19761;5634;19047;742;2648;4005;13672;4747;16320
230620;201506;2204;6247;1752;5276;188;627;1040;3036;1228;3663
230625;201506;7996;25877;7135;23947;2110;7615;2172;7257;4282;14872
230630;201506;11490;36600;10446;34689;2713;8540;4938;17540;7651;26080
230640;201506;26337;86501;24379;83603;2706;10165;18542;63739;21248;73904
230650;201506;5000;15309;4493;14340;289;1183;3470;10822;3759;12005
230655;201506;9152;34543;8774;33885;745;3112;7120;27830;7865;30942
230660;201506;6227;19431;5316;17747;390;1679;4008;13142;4398;14821
230670;201506;6148;16582;4955;14552;194;748;3831;10944;4025;11692
230680;201506;2933;8521;2444;7612;378;1260;1421;4381;1799;5641
230690;201506;6283;20605;6181;20401;545;2208;4333;14030;4878;16238
230700;201506;9497;27149;8458;25330;742;2715;5991;17432;6733;20147
230710;201506;7529;24570;6546;22718;772;2741;4644;16313;5416;19054
230720;201506;1910;6028;1641;5511;212;756;1029;3493;1241;4249
230725;201506;3737;12658;3247;11450;773;2809;1297;4533;2070;7342
230730;201506;58325;176241;48206;159305;13190;48422;14863;50428;28053;98850
230740;201506;5960;18164;5471;17342;267;1142;4443;13846;4710;14988
230750;201506;8685;24960;7398;22891;455;1668;5727;17559;6182;19227
230760;201506;10585;31640;9829;30117;1067;3896;6922;20425;7989;24321
230763;201506;4317;13447;3927;12702;247;1162;3031;9488;3278;10650
230765;201506;39764;127459;35940;119833;9916;35944;12229;41005;22145;76949
230770;201506;24959;69388;22795;66415;2618;8173;16260;47488;18878;55661
230780;201506;6178;23891;5887;23241;1471;5969;2873;11925;4344;17894
230790;201506;2711;8793;2492;8412;264;981;1834;6213;2098;7194
230800;201506;7668;27246;6943;25653;1556;6236;3166;11582;4722;17818
230810;201506;12229;39902;11540;38720;954;3418;9220;31082;10174;34500
230820;201506;3406;11640;2972;10697;444;1850;1685;5961;2129;7811
230830;201506;7684;23454;6801;21830;626;2351;4878;15540;5504;17891
230835;201506;4112;10880;3355;9760;230;741;2554;7376;2784;8117
230837;201506;3181;10828;2771;10003;318;1376;1862;6596;2180;7972
230840;201506;9334;30486;8525;29089;777;2984;6406;22023;7183;25007
230850;201506;10254;31358;9384;30091;1064;3686;6753;21634;7817;25320
230860;201506;5323;15321;4703;14333;277;1011;3773;11436;4050;12447
230870;201506;19159;50833;16628;47042;903;2942;12820;36031;13723;38973
230880;201506;1943;6668;1821;6427;203;865;1231;4290;1434;5155
230890;201506;3963;14489;3650;13797;514;2337;2290;8428;2804;10765
230900;201506;3017;10032;2556;9055;541;1912;1271;4589;1812;6501
230910;201506;3202;9383;2588;8269;200;837;1852;5768;2052;6605
230920;201506;4681;13671;4379;13305;179;631;3871;11877;4050;12508
230930;201506;7605;22999;6710;21313;681;2306;4600;14743;5281;17049
230940;201506;7848;22420;6840;20870;366;1166;5482;16839;5848;18005
230945;201506;6207;18682;5358;17426;509;1884;3743;12361;4252;14245
230950;201506;7156;19399;6270;18235;357;1078;5049;14929;5406;16007
230960;201506;14154;43646;12850;41168;2723;9287;5989;19381;8712;28668
230970;201506;13663;42278;12079;39278;2435;8921;5599;17804;8034;26725
230980;201506;3006;9562;2645;8897;748;2557;1246;4405;1994;6962
230990;201506;1717;5160;1430;4586;142;598;932;2881;1074;3479
231000;201506;2899;7848;2279;6654;208;719;1447;4077;1655;4796
231010;201506;3244;8800;2678;7894;272;932;1922;5536;2194;6468
231020;201506;7994;26810;7566;25925;1353;4709;4696;16441;6049;21150
231025;201506;8045;24792;7293;23521;1047;3549;4767;15668;5814;19217
231030;201506;8123;26282;6833;23649;1219;4566;3877;13497;5096;18063
231040;201506;3136;10136;2792;9440;211;896;2012;6639;2223;7535
231050;201506;12264;34776;10423;31489;832;2839;7721;23178;8553;26017
231060;201506;2494;7995;2278;7614;183;832;1613;5240;1796;6072
231070;201506;8899;28222;8102;26631;1321;4623;4824;16009;6145;20632
231080;201506;4276;13399;3885;12725;206;968;2940;9296;3146;10264
231085;201506;4793;15019;4602;14763;635;1956;3371;11236;4006;13192
231090;201506;4192;11796;3389;10179;186;675;2374;7006;2560;7681
231095;201506;2292;7447;1963;6786;213;836;1320;4565;1533;5401
231100;201506;3228;9963;2689;8903;235;910;1905;6237;2140;7147
231110;201506;3764;12489;3679;12342;357;1364;2636;8823;2993;10187
231120;201506;2160;7229;2022;6949;316;1180;1302;4500;1618;5680
231123;201506;2161;5914;1824;5330;144;399;1413;4144;1557;4543
231126;201506;6489;18218;5397;16481;343;1328;3963;11926;4306;13254
231130;201506;19495;60118;17503;56787;3571;11955;10079;34167;13650;46122
231135;201506;4333;12848;3638;11657;313;1152;2585;8194;2898;9346
231140;201506;16871;53541;15003;50010;1384;6208;10048;32284;11432;38492
231150;201506;5888;16875;4946;15141;801;2674;2687;8093;3488;10767
231160;201506;5757;19477;5404;18791;900;3277;3557;12402;4457;15679
231170;201506;4389;14080;3919;13111;334;1407;2723;8876;3057;10283
231180;201506;14416;43200;12954;40313;2193;7413;7708;23606;9901;31019
231190;201506;4752;13386;4034;12317;271;979;3173;9551;3444;10530
231195;201506;4642;15723;3989;14420;401;1804;2829;10099;3230;11903
231200;201506;7867;26949;6854;24858;498;2458;4905;17373;5403;19831
231210;201506;5152;15903;4441;14920;273;1257;3470;11576;3743;12833
231220;201506;11971;35103;10732;32824;693;2647;7995;24020;8688;26667
231230;201506;8853;30143;8145;29033;775;3259;6209;22117;6984;25376
231240;201506;12227;38636;11005;36214;2265;7820;5587;18695;7852;26515
231250;201506;1962;5715;1353;4229;429;1308;280;888;709;2196
231260;201506;3732;10877;3349;10289;502;1537;2166;6785;2668;8322
231270;201506;7413;20552;6545;19179;407;1697;4948;14084;5355;15781
231280;201506;1798;5874;1674;5634;183;642;1178;4007;1361;4649
231290;201506;34264;117709;31023;110300;6695;26646;12992;45056;19687;71702
231300;201506;4690;13566;3802;11820;275;1073;2641;7974;2916;9047
231310;201506;7494;21369;6222;18756;968;3077;3507;10331;4475;13408
231320;201506;6967;21421;5950;19444;321;1357;4305;13991;4626;15348
231325;201506;2706;8116;2383;7582;264;871;1632;5307;1896;6178
231330;201506;12802;40443;10980;36894;1667;5677;6851;23324;8518;29001
231335;201506;5395;15450;4655;14115;238;945;3649;10788;3887;11733
231340;201506;17708;58265;16389;56276;1088;3688;13350;46881;14438;50569
231350;201506;13213;42542;12772;41902;1163;3658;10632;35466;11795;39124
231355;201506;4410;14236;4128;13773;267;1075;3238;10764;3505;11839
231360;201506;7703;24853;6922;23458;1486;4980;4085;14386;5571;19366
231370;201506;2502;6947;1960;6056;98;331;1472;4541;1570;4872
231375;201506;4197;14387;3919;13854;254;1183;3102;10802;3356;11985
231380;201506;5253;16873;4967;16480;665;2305;3456;11776;4121;14081
231390;201506;3439;10828;3176;10396;245;987;2359;7635;2604;8622
231395;201506;3962;12964;3596;12296;627;2219;2110;7286;2737;9505
231400;201506;9329;28586;8684;27318;637;2444;6333;19633;6970;22077
231410;201506;13669;46835;12649;45223;1139;4276;9801;35376;10940;39652
240010;201506;2480;7531;2092;6722;372;1325;997;3099;1369;4424
240020;201506;11127;35045;9858;32630;2274;8086;4765;15887;7039;23973
240030;201506;2417;7089;2368;7011;142;476;1996;5829;2138;6305
240040;201506;851;2533;717;2263;34;163;523;1568;557;1731
240050;201506;3509;9563;2998;8684;130;464;2399;6850;2529;7314
240060;201506;1412;4123;1267;3844;63;259;1019;2979;1082;3238
240070;201506;2656;7627;2496;7330;390;1205;1703;4963;2093;6168
240080;201506;3088;8289;2650;7710;241;695;2034;5930;2275;6625
240090;201506;2331;6316;1943;5617;57;220;1518;4276;1575;4496
240100;201506;8781;25213;7860;23346;708;2412;5512;15875;6220;18287
240110;201506;5331;16276;4698;15100;803;2880;2635;8142;3438;11022
240120;201506;2774;9436;2639;9171;417;1595;1725;5952;2142;7547
240130;201506;2843;7656;2436;7035;143;530;1922;5429;2065;5959
240140;201506;2260;6792;1929;6180;326;1231;1084;3362;1410;4593
240145;201506;6037;18906;5409;17808;1417;4999;2707;9036;4124;14035
240150;201506;1016;3074;827;2688;87;368;532;1650;619;2018
240160;201506;1464;4711;1270;4366;172;646;775;2746;947;3392
240165;201506;900;2873;787;2634;111;332;493;1743;604;2075
240170;201506;2443;7296;2135;6737;532;1849;997;3086;1529;4935
240180;201506;2714;8559;2441;8034;494;1728;1364;4587;1858;6315
240185;201506;1443;4821;1379;4706;115;430;1079;3695;1194;4125
240190;201506;989;3031;891;2858;49;215;676;2123;725;2338
240200;201506;14330;37237;11882;33944;2616;7659;5930;17479;8546;25138
240210;201506;2902;8166;2636;7793;182;643;2205;6453;2387;7096
240220;201506;7394;24408;6973;23799;555;2477;5551;18621;6106;21098
240230;201506;5615;15232;4958;14162;208;709;4151;11757;4359;12466
240240;201506;1848;5611;1279;4212;299;1118;249;699;548;1817
240250;201506;2767;8000;2593;7771;143;484;2161;6434;2304;6918
240260;201506;13048;43903;12333;42751;1973;7740;7933;27455;9906;35195
240270;201506;2295;7356;2113;7054;214;736;1617;5476;1831;6212
240280;201506;1587;4469;1415;4184;84;303;1137;3317;1221;3620
240290;201506;1377;4313;1203;3997;86;416;815;2585;901;3001
240300;201506;2277;6321;1664;5013;388;1255;605;1755;993;3010
240310;201506;9870;28230;8980;26841;1349;4408;4974;15029;6323;19437
240320;201506;2076;6152;1667;5309;71;308;1220;3729;1291;4037
240325;201506;38850;106097;30107;91941;9274;30564;7779;24135;17053;54699
240330;201506;1535;4605;1282;4102;118;471;835;2561;953;3032
240340;201506;1890;5355;1598;4897;178;588;1165;3561;1343;4149
240350;201506;1998;5902;1854;5711;132;480;1582;4844;1714;5324
240360;201506;7173;21474;6250;20093;1194;4119;3527;11690;4721;15809
240370;201506;2010;5525;1640;4869;206;624;1040;3096;1246;3720
240375;201506;876;2346;758;2160;120;406;461;1232;581;1638
240380;201506;2537;7529;1964;6252;277;914;993;3099;1270;4013
240390;201506;970;2656;809;2365;53;201;597;1680;650;1881
240400;201506;1362;3733;1138;3346;102;343;803;2302;905;2645
240410;201506;531;1720;487;1632;86;340;301;995;387;1335
240420;201506;4771;18183;4511;17619;1046;4297;2474;9897;3520;14194
240430;201506;3322;9435;3050;8974;153;600;2457;7036;2610;7636
240440;201506;2682;7046;2415;6623;628;1720;1246;3442;1874;5162
240450;201506;3651;10948;3181;10037;305;1254;2035;6085;2340;7339
240460;201506;2978;9132;2815;8919;210;853;2330;7238;2540;8091
240470;201506;3680;11404;2926;9800;690;2255;1455;4926;2145;7181
240480;201506;520;1348;415;1147;38;105;240;645;278;750
240485;201506;2109;6526;1852;6048;338;1181;1064;3531;1402;4712
240490;201506;1684;4267;1417;3864;50;176;1169;3094;1219;3270
240500;201506;2124;6159;1933;5867;147;514;1499;4509;1646;5023
240510;201506;1803;5392;1674;5177;161;522;1323;4117;1484;4639
240520;201506;1370;3908;1169;3599;124;466;858;2570;982;3036
240530;201506;2109;6721;1898;6381;300;1071;1303;4383;1603;5454
240540;201506;1735;5312;1652;5178;133;477;1302;4059;1435;4536
240550;201506;849;2406;734;2212;55;192;555;1637;610;1829
240560;201506;3274;9572;3067;9261;289;889;2441;7397;2730;8286
240570;201506;3118;8804;2414;7231;547;1803;891;2350;1438;4153
240580;201506;7788;24504;7250;23559;918;3246;5418;17462;6336;20708
240590;201506;799;2257;692;2064;40;163;519;1511;559;1674
240600;201506;1656;4855;1312;4148;171;633;733;2206;904;2839
240610;201506;4962;14033;4267;12735;514;1698;2636;7649;3150;9347
240615;201506;1049;3051;852;2674;149;490;475;1459;624;1949
240620;201506;1758;5522;1570;5211;183;598;1172;3950;1355;4548
240630;201506;2032;6278;1881;6015;169;461;1420;4722;1589;5183
240640;201506;916;2655;773;2417;56;262;538;1607;594;1869
240650;201506;3843;11695;3496;11202;208;753;2841;9155;3049;9908
240660;201506;2431;7843;2287;7635;221;770;1786;6006;2007;6776
240670;201506;2748;8216;2270;7214;292;1012;1274;3985;1566;4997
240680;201506;1518;4449;1224;3918;119;425;769;2441;888;2866
240690;201506;982;2752;850;2529;53;208;688;1988;741;2196
240700;201506;2782;8236;2285;7298;95;438;1730;5383;1825;5821
240710;201506;18972;49306;16553;45891;3052;8404;9983;28310;13035;36714
240720;201506;5387;15301;4969;14578;1540;4729;2359;6698;3899;11427
240725;201506;1109;3305;857;2746;78;263;491;1536;569;1799
240730;201506;2214;6681;1907;6118;138;482;1425;4562;1563;5044
240740;201506;2030;5948;1807;5543;176;668;1263;3745;1439;4413
240750;201506;2267;8420;2063;8036;489;2099;1044;4082;1533;6181
240760;201506;1312;3680;1119;3424;110;258;835;2746;945;3004
240770;201506;3148;9082;2822;8626;158;614;2373;7174;2531;7788
240780;201506;6359;17502;5078;15508;942;2953;2755;8628;3697;11581
240790;201506;900;2727;736;2447;45;182;503;1689;548;1871
240800;201506;37039;106495;32912;99516;8079;25578;14159;43228;22238;68806
240810;201506;91997;266315;84760;253839;22729;70712;39828;120379;62557;191091
240820;201506;6822;20434;5820;18863;1409;4963;2466;8306;3875;13269
240830;201506;8805;27524;8242;26679;414;1546;7063;22820;7477;24366
240840;201506;1256;3499;1051;3174;88;298;681;1991;769;2289
240850;201506;1309;3899;952;3080;163;568;457;1447;620;2015
240860;201506;1360;3816;1124;3398;70;251;856;2521;926;2772
240870;201506;1200;3300;979;2895;92;319;622;1735;714;2054
240880;201506;1171;3977;1101;3867;114;494;829;2848;943;3342
240890;201506;5296;15002;4476;13491;912;2983;2092;6165;3004;9148
240895;201506;2732;9339;2473;8883;275;1063;1743;6349;2018;7412
240910;201506;2814;8570;2495;7960;175;676;1885;5952;2060;6628
240920;201506;811;2644;707;2411;144;569;342;1114;486;1683
240930;201506;3542;9307;3118;8787;188;552;2544;7254;2732;7806
240933;201506;1406;4119;1254;3868;137;501;893;2696;1030;3197
240940;201506;6543;17932;5351;15870;948;2839;2947;8767;3895;11606
240950;201506;1034;3361;978;3267;70;321;761;2462;831;2783
240960;201506;795;2478;696;2284;86;298;466;1529;552;1827
240970;201506;2044;5641;1705;5070;130;467;1265;3666;1395;4133
240980;201506;3128;10264;2887;9811;553;2010;1778;6037;2331;8047
240990;201506;2942;8725;2753;8342;467;1523;1696;5076;2163;6599
241000;201506;1087;3026;923;2737;47;174;664;1943;711;2117
241010;201506;2970;9880;2715;9387;355;1514;1894;6326;2249;7840
241020;201506;2268;6282;1820;5417;160;517;1134;3264;1294;3781
241025;201506;1637;4958;1466;4637;93;385;1032;3189;1125;3574
241030;201506;2511;8347;2262;7867;187;818;1679;5788;1866;6606
241040;201506;2298;7881;2099;7523;232;918;1454;5263;1686;6181
241050;201506;1311;3874;1138;3578;57;230;877;2705;934;2935
241060;201506;888;2568;807;2426;58;180;611;1830;669;2010
241070;201506;881;2529;778;2351;80;276;529;1546;609;1822
241080;201506;1193;3521;992;3135;53;238;728;2244;781;2482
241090;201506;2186;6379;1858;5796;122;534;1449;4440;1571;4974
241100;201506;1187;3550;1018;3156;112;357;646;1983;758;2340
241105;201506;1173;3550;1067;3360;221;730;579;1844;800;2574
241110;201506;850;2664;704;2351;54;230;434;1425;488;1655
241120;201506;7449;22787;6774;21729;1377;4486;4173;13746;5550;18232
241140;201506;3423;9434;2958;8539;324;934;2047;5835;2371;6769
241142;201506;724;2176;536;1769;133;504;181;554;314;1058
241150;201506;5637;16666;5026;15629;633;2023;3379;10575;4012;12598
241160;201506;999;2965;937;2848;126;410;665;2018;791;2428
241170;201506;1162;3516;1064;3338;108;355;792;2488;900;2843
241180;201506;928;2617;761;2297;94;301;400;1163;494;1464
241190;201506;1216;3361;982;2898;74;270;617;1733;691;2003
241200;201506;19427;57044;17357;53724;4086;13604;8336;26051;12422;39655
241210;201506;1483;4224;1199;3633;192;648;632;1860;824;2508
241220;201506;7881;26130;7364;25159;1609;5858;4073;14062;5682;19920
241230;201506;3093;9069;2808;8648;166;634;2335;7085;2501;7719
241240;201506;1196;3510;873;2782;115;403;370;1179;485;1582
241250;201506;5903;18500;5001;16735;278;1431;3916;12734;4194;14165
241255;201506;1739;6680;1620;6415;388;1633;769;3114;1157;4747
241260;201506;5183;14022;4195;12490;259;1004;3065;8927;3324;9931
241270;201506;1892;5839;1667;5383;170;632;1096;3502;1266;4134
241280;201506;1987;5740;1800;5385;225;711;1236;3662;1461;4373
241290;201506;3199;8985;2650;8039;337;1095;1703;5126;2040;6221
241300;201506;1470;4242;1292;3930;73;231;953;2924;1026;3155
241310;201506;1592;4852;1470;4645;162;558;1067;3366;1229;3924
241320;201506;929;3162;848;2988;128;493;518;1823;646;2316
241330;201506;1474;4633;1361;4479;106;444;1113;3600;1219;4044
241335;201506;2717;8291;2523;7946;165;560;2108;6618;2273;7178
241340;201506;1880;5861;1615;5285;374;1325;733;2317;1107;3642
241350;201506;1959;6199;1772;5856;157;683;1305;4154;1462;4837
241355;201506;1387;3932;1150;3526;62;197;985;3022;1047;3219
241360;201506;2081;5666;1748;5041;81;258;1296;3600;1377;3858
241370;201506;1363;4159;1127;3680;165;605;608;1933;773;2538
241380;201506;694;1970;582;1745;100;318;323;956;423;1274
241390;201506;2794;9290;2606;8947;367;1404;1842;6302;2209;7706
241400;201506;3745;10993;3441;10590;360;1243;2638;8156;2998;9399
241410;201506;2628;7832;2345;7427;457;1564;1408;4406;1865;5970
241415;201506;1719;5198;1558;4937;109;428;1208;3767;1317;4195
241420;201506;2312;7978;2022;7496;654;2677;552;1989;1206;4666
241430;201506;574;1739;461;1482;50;179;278;864;328;1043
241440;201506;6380;22939;5987;22284;1237;4785;3850;14622;5087;19407
241445;201506;1073;3108;1010;3026;90;238;812;2567;902;2805
241450;201506;3228;8819;2827;8240;357;1147;1954;5659;2311;6806
241460;201506;3526;10293;3056;9374;246;875;2204;6589;2450;7464
241470;201506;1428;3936;1159;3597;146;533;808;2461;954;2994
241475;201506;1235;3787;1047;3395;53;248;777;2432;830;2680
241480;201506;2861;9497;2616;9098;950;3384;871;3263;1821;6647
241490;201506;661;1753;557;1599;42;117;339;951;381;1068
241500;201506;783;2470;673;2297;35;141;518;1750;553;1891
250010;201506;2750;8655;2365;7813;163;700;1773;5726;1936;6426
250020;201506;1693;4866;1303;4154;86;368;855;2617;941;2985
250030;201506;7319;21225;6814;20512;613;1874;5489;16648;6102;18522
250040;201506;4376;14669;4009;13899;663;2453;2507;8749;3170;11202
250050;201506;3452;10922;3255;10636;415;1477;2333;7564;2748;9041
250053;201506;1263;3773;1155;3629;159;511;788;2518;947;3029
250057;201506;648;2716;638;2706;18;40;600;2629;618;2669
250060;201506;5010;15276;4715;14836;413;1533;3775;11700;4188;13233
250070;201506;3933;12319;3667;11867;180;823;2966;9302;3146;10125
250073;201506;766;2359;680;2207;51;199;527;1691;578;1890
250077;201506;2268;6611;1897;6015;204;685;1155;3724;1359;4409
250080;201506;4249;12450;4078;12184;394;1196;3110;9163;3504;10359
250090;201506;2493;7336;2394;7166;101;337;2011;5952;2112;6289
250100;201506;3996;13156;3761;12745;364;1356;2883;9691;3247;11047
250110;201506;5349;16013;5042;15576;505;1807;3931;12000;4436;13807
250115;201506;529;1730;468;1592;29;154;301;953;330;1107
250120;201506;2010;6040;1739;5522;107;378;1340;4240;1447;4618
250130;201506;5509;17072;5164;16563;250;945;4478;14402;4728;15347
250135;201506;1084;3318;988;3152;82;286;714;2289;796;2575
250140;201506;2079;6860;1958;6686;180;712;1511;5204;1691;5916
250150;201506;5086;17099;4627;16249;381;1658;3367;11654;3748;13312
250153;201506;1467;4023;1286;3759;53;226;1093;3122;1146;3348
250157;201506;1744;5835;1597;5541;183;710;1137;3948;1320;4658
250160;201506;3266;9988;3151;9813;152;545;2839;8832;2991;9377
250170;201506;1549;4628;1413;4415;236;782;956;3020;1192;3802
250180;201506;15767;47223;15039;46098;1528;5712;11193;33375;12721;39087
250190;201506;4256;12335;3900;11771;668;2095;2435;7296;3103;9391
250200;201506;2219;6164;1734;5515;109;415;1431;4527;1540;4942
250205;201506;918;3129;850;2996;62;306;617;2150;679;2456
250210;201506;1532;5054;1409;4864;132;536;1053;3572;1185;4108
250215;201506;1376;4610;1314;4509;130;527;888;3013;1018;3540
250220;201506;784;2276;664;2121;37;134;573;1828;610;1962
250230;201506;1609;4068;1356;3657;86;269;1077;2795;1163;3064
250240;201506;2332;7862;2209;7629;137;524;1775;6133;1912;6657
250250;201506;4406;13235;3997;12697;219;733;3402;10876;3621;11609
250260;201506;1756;5383;1531;5025;94;393;1188;3857;1282;4250
250270;201506;1263;3997;1150;3854;108;357;883;3057;991;3414
250280;201506;3658;10912;3233;10265;454;1457;2346;7555;2800;9012
250290;201506;2011;5373;1684;4958;46;197;1490;4369;1536;4566
250300;201506;5474;16039;5177;15677;573;2384;4192;12106;4765;14490
250310;201506;1151;3551;1019;3337;107;405;788;2541;895;2946
250320;201506;8101;25121;7722;24408;1018;3651;5269;16221;6287;19872
250330;201506;2614;8030;2200;7452;167;680;1721;5763;1888;6443
250340;201506;1105;3269;998;3094;42;150;841;2585;883;2735
250350;201506;4405;12074;3875;11454;141;488;3434;10202;3575;10690
250355;201506;2008;6377;1839;6128;104;511;1483;4796;1587;5307
250360;201506;1948;5789;1812;5594;78;254;1514;4717;1592;4971
250370;201506;12181;35271;10820;33762;966;3150;9132;28675;10098;31825
250375;201506;1098;3426;1022;3315;50;197;881;2853;931;3050
250380;201506;1744;4952;1644;4825;91;330;1430;4175;1521;4505
250390;201506;1977;5258;1569;4578;181;530;1077;3153;1258;3683
250400;201506;69570;188558;57192;168815;14115;44011;25838;77043;39953;121054
250403;201506;1542;5048;1444;4915;232;893;920;3050;1152;3943
250407;201506;1205;3419;1034;3146;74;251;737;2177;811;2428
250410;201506;631;2029;556;1885;45;205;432;1431;477;1636
250415;201506;1742;5422;1583;5130;118;426;1203;3859;1321;4285
250420;201506;1282;3864;1184;3727;52;215;1014;3130;1066;3345
250430;201506;6156;17187;5824;16699;305;1034;4938;13967;5243;15001
250435;201506;1413;4358;1263;4087;163;598;848;2722;1011;3320
250440;201506;4507;13195;4181;12736;199;602;3488;10675;3687;11277
250450;201506;2029;5786;1809;5497;71;240;1618;4913;1689;5153
250460;201506;6465;19538;6033;18934;659;2171;4593;14595;5252;16766
250470;201506;1518;4223;1317;3945;128;448;897;2553;1025;3001
250480;201506;3827;11608;3534;11189;94;407;3114;9771;3208;10178
250485;201506;661;1694;545;1518;30;95;434;1179;464;1274
250490;201506;3805;12257;3711;12125;854;2898;2321;7578;3175;10476
250500;201506;1790;5411;1605;5109;359;1100;955;3153;1314;4253
250510;201506;4745;13675;4224;12918;198;710;3640;11118;3838;11828
250520;201506;1743;5354;1635;5177;255;921;1005;3095;1260;4016
250523;201506;1620;5270;1562;5180;236;864;1113;3682;1349;4546
250527;201506;1407;4273;1334;4182;27;123;1237;3847;1264;3970
250530;201506;647;1959;558;1848;25;79;489;1644;514;1723
250535;201506;1319;4169;1252;4035;60;270;1001;3150;1061;3420
250540;201506;2402;7087;2235;6898;44;194;2034;6202;2078;6396
250550;201506;919;3065;828;2922;57;255;643;2234;700;2489
250560;201506;1671;5288;1625;5222;94;358;1433;4571;1527;4929
250570;201506;2633;8404;2310;7787;179;749;1753;5796;1932;6545
250580;201506;1172;3149;975;2839;101;375;718;2008;819;2383
250590;201506;934;2900;863;2810;82;343;688;2169;770;2512
250600;201506;7381;21630;6904;20944;557;1652;5557;17078;6114;18730
250610;201506;3210;9537;2968;9180;320;1079;2184;6778;2504;7857
250620;201506;743;2179;657;2007;113;358;406;1223;519;1581
250625;201506;2323;7496;2283;7448;76;229;2154;7084;2230;7313
250630;201506;9729;30810;9097;29611;2022;6868;4972;16233;6994;23101
250640;201506;3555;10818;3371;10605;177;724;2939;9127;3116;9851
250650;201506;840;2493;752;2344;68;273;520;1562;588;1835
250660;201506;2265;5493;1733;4850;30;77;1633;4596;1663;4673
250670;201506;2480;8374;2364;8174;154;689;1931;6570;2085;7259
250680;201506;4817;13963;4597;13678;201;757;4022;11891;4223;12648
250690;201506;6037;15867;5776;15545;403;1146;5101;13655;5504;14801
250700;201506;5116;15032;4669;14392;742;2422;3087;9442;3829;11864
250710;201506;4343;13857;4018;13440;567;1970;2849;9721;3416;11691
250720;201506;2604;7696;2481;7495;95;396;2194;6559;2289;6955
250730;201506;3563;10947;3360;10656;322;1103;2487;7775;2809;8878
250740;201506;1999;5853;1765;5468;143;531;1330;4040;1473;4571
250750;201506;100383;286846;93349;276477;13610;44326;63273;184978;76883;229304
250760;201506;2243;6511;2019;6191;110;424;1702;5181;1812;5605
250770;201506;3911;13262;3682;12970;627;2373;2360;8322;2987;10695
250780;201506;1876;5506;1616;5037;189;726;1025;3059;1214;3785
250790;201506;2443;8038;2329;7864;505;1669;1441;5036;1946;6705
250800;201506;2679;7594;2378;7093;103;347;1961;5735;2064;6082
250810;201506;1386;4025;1186;3735;99;404;929;2870;1028;3274
250820;201506;1831;5777;1758;5682;57;235;1610;5180;1667;5415
250830;201506;5826;18759;5420;17945;662;2416;3611;11775;4273;14191
250840;201506;948;3028;821;2754;76;309;536;1762;612;2071
250850;201506;2053;6300;1839;5949;124;561;1404;4454;1528;5015
250855;201506;1084;3261;987;3112;71;294;759;2328;830;2622
250860;201506;3154;10360;2789;9684;688;2589;896;3114;1584;5703
250870;201506;1065;3123;979;2970;41;174;768;2260;809;2434
250880;201506;1380;3934;1216;3701;161;496;900;2761;1061;3257
250890;201506;9453;29076;8789;28165;1209;4740;6125;19019;7334;23759
250900;201506;2903;9456;2556;8781;269;899;1842;6387;2111;7286
250905;201506;2009;6451;1934;6351;306;1010;1411;4723;1717;5733
250910;201506;4978;14571;4734;14212;314;1064;3894;11621;4208;12685
250915;201506;1479;4540;1425;4464;109;305;1218;3902;1327;4207
250920;201506;3477;9973;3243;9613;447;1252;2222;6715;2669;7967
250930;201506;1999;6310;1879;6108;239;925;1345;4281;1584;5206
250933;201506;1137;3744;1098;3669;89;330;834;2815;923;3145
250937;201506;763;2364;672;2181;69;283;459;1463;528;1746
250939;201506;1585;4957;1479;4772;155;534;1034;3320;1189;3854
250940;201506;3747;11224;3514;10858;148;564;2942;9090;3090;9654
250950;201506;1238;3890;1113;3731;44;165;974;3286;1018;3451
250960;201506;1133;3674;1062;3572;89;351;842;2819;931;3170
250970;201506;8651;23792;7454;22016;912;2751;5294;15694;6206;18445
250980;201506;2636;7843;2396;7415;156;642;1732;5155;1888;5797
250990;201506;2022;6918;1834;6519;249;1032;1191;4134;1440;5166
251000;201506;2220;6678;2011;6362;92;383;1639;5134;1731;5517
251010;201506;2817;8198;2521;7741;110;394;2143;6591;2253;6985
251020;201506;1637;4790;1478;4591;89;308;1298;4034;1387;4342
251030;201506;1202;3375;1080;3160;85;286;761;2199;846;2485
251040;201506;1887;5950;1676;5608;131;644;1236;3980;1367;4624
251050;201506;1104;3213;954;2950;115;387;622;1911;737;2298
251060;201506;995;2350;785;2074;50;161;608;1576;658;1737
251065;201506;472;1442;420;1361;37;144;290;885;327;1029
251070;201506;649;1817;584;1729;53;215;452;1257;505;1472
251080;201506;20149;56766;18296;53714;4651;14252;9151;27388;13802;41640
251090;201506;3008;9413;2685;8791;209;799;1953;6305;2162;7104
251100;201506;974;3090;850;2862;109;432;522;1684;631;2116
251110;201506;2018;5920;1778;5465;169;553;1231;3750;1400;4303
251120;201506;6022;20575;5780;20146;664;2729;4403;15142;5067;17871
251130;201506;4107;10667;3700;10221;28;77;3597;9965;3625;10042
251140;201506;4289;13168;3991;12708;139;612;3297;10450;3436;11062
251150;201506;2644;8630;2411;8298;228;972;1807;6144;2035;7116
251160;201506;1740;5812;1681;5735;59;228;1537;5262;1596;5490
251170;201506;1417;4337;1347;4255;94;369;1125;3489;1219;3858
251180;201506;2667;8137;2435;7820;474;1523;1501;4881;1975;6404
251190;201506;4312;12123;4159;11955;188;528;3841;11081;4029;11609
251200;201506;3791;12338;3682;12211;77;288;3506;11648;3583;11936
251203;201506;1159;3827;1087;3669;72;343;804;2661;876;3004
251207;201506;1142;3559;984;3276;74;352;673;2129;747;2481
251210;201506;8051;22842;6891;21318;777;2347;5218;16594;5995;18941
251220;201506;1161;3103;972;2827;107;333;723;2111;830;2444
251230;201506;4693;14192;4248;13682;221;813;3825;12332;4046;13145
251240;201506;3183;10060;3045;9885;322;1082;2390;7753;2712;8835
251250;201506;10407;30784;9583;29562;1043;3794;7185;21673;8228;25467
251260;201506;546;1663;477;1572;26;90;358;1176;384;1266
251270;201506;4212;13579;3937;13238;150;663;3481;11675;3631;12338
251272;201506;1378;4180;1318;4096;103;342;1112;3467;1215;3809
251274;201506;884;2828;810;2692;88;363;581;1878;669;2241
251275;201506;1261;3705;1200;3617;92;384;907;2618;999;3002
251276;201506;1235;3858;1152;3703;96;365;839;2646;935;3011
251278;201506;582;1883;515;1743;64;256;339;1146;403;1402
251280;201506;2339;7244;2219;7047;160;609;1740;5422;1900;6031
251290;201506;5822;16229;5488;15827;620;2178;4196;11730;4816;13908
251300;201506;769;2610;712;2523;48;209;542;1895;590;2104
251310;201506;3159;9331;2903;8965;134;524;2373;7233;2507;7757
251315;201506;1600;5611;1532;5487;216;793;1028;3736;1244;4529
251320;201506;1926;5409;1529;4772;66;245;1113;3444;1179;3689
251330;201506;1863;4984;1610;4648;84;342;1382;3866;1466;4208
251335;201506;1029;3535;956;3405;90;420;683;2368;773;2788
251340;201506;3581;10074;3061;9286;232;919;2276;6656;2508;7575
251350;201506;1445;4475;1299;4256;124;466;947;3039;1071;3505
251360;201506;1800;5869;1648;5678;83;376;1412;4840;1495;5216
251365;201506;849;2493;683;2144;26;111;481;1466;507;1577
251370;201506;22079;70567;21535;69800;2168;8600;16953;53451;19121;62051
251380;201506;1406;4360;1205;4015;62;298;968;3107;1030;3405
251385;201506;839;2305;741;2148;82;248;513;1442;595;1690
251390;201506;5860;20395;5420;19651;1256;4773;3139;11500;4395;16273
251392;201506;1041;3101;944;2957;68;214;750;2365;818;2579
251394;201506;627;1912;517;1710;30;116;373;1221;403;1337
251396;201506;846;2397;742;2222;104;324;501;1475;605;1799
251398;201506;995;2933;858;2662;55;202;585;1794;640;1996
251400;201506;1197;3400;1037;3185;97;370;772;2304;869;2674
251410;201506;1417;3776;1279;3555;77;276;1045;2844;1122;3120
251420;201506;2059;5989;1817;5705;233;747;1300;4074;1533;4821
251430;201506;1692;6020;1553;5794;96;457;1292;4769;1388;5226
251440;201506;1317;3920;1092;3482;80;280;798;2533;878;2813
251445;201506;1569;4789;1493;4686;71;291;1280;3946;1351;4237
251450;201506;4732;14949;4339;14458;144;642;3729;12412;3873;13054
251455;201506;1154;3678;1029;3468;93;362;707;2379;800;2741
251460;201506;847;2596;800;2517;97;280;623;2006;720;2286
251465;201506;460;1449;401;1319;24;105;287;915;311;1020
251470;201506;1199;3512;987;3110;100;357;591;1861;691;2218
251480;201506;1001;2787;885;2597;27;129;729;2072;756;2201
251490;201506;1865;5641;1678;5362;221;831;1089;3444;1310;4275
251500;201506;1711;5611;1671;5544;157;608;1310;4279;1467;4887
251510;201506;2584;8502;2342;8008;434;1551;1330;4544;1764;6095
251520;201506;988;2750;883;2579;124;366;525;1540;649;1906
251530;201506;11767;33591;11218;32834;398;1608;9797;28182;10195;29790
251540;201506;2845;9248;2619;8794;209;869;2050;6802;2259;7671
251550;201506;3846;9645;3145;8765;103;379;2635;7234;2738;7613
251560;201506;773;2364;705;2247;104;399;415;1222;519;1621
251570;201506;1019;3019;835;2653;64;259;585;1814;649;2073
251580;201506;1989;5598;1843;5396;359;935;1242;3811;1601;4746
251590;201506;1596;5223;1542;5158;67;269;1364;4565;1431;4834
251593;201506;1095;3374;1008;3256;154;558;617;1945;771;2503
251597;201506;1970;6045;1884;5927;112;433;1583;4901;1695;5334
251600;201506;6628;19511;6186;18813;406;1391;5073;15351;5479;16742
251610;201506;3389;10130;3059;9673;338;1070;2211;7039;2549;8109
251615;201506;1141;3323;927;2957;80;326;645;2006;725;2332
251620;201506;15764;44309;13602;41681;1053;3363;10924;34016;11977;37379
251630;201506;4846;12407;4109;11438;290;882;3300;9121;3590;10003
251640;201506;2600;7580;2164;6831;147;581;1600;4991;1747;5572
251650;201506;4091;11863;3704;11355;238;793;3182;9768;3420;10561
251660;201506;3484;11521;3248;11116;177;872;2686;8956;2863;9828
251670;201506;4321;12917;3760;12174;55;171;3461;11329;3516;11500
251675;201506;734;2383;678;2300;146;529;383;1278;529;1807
251680;201506;2702;7779;2249;7062;118;509;1785;5489;1903;5998
251690;201506;3427;10504;3157;9996;209;781;2398;7476;2607;8257
251700;201506;1974;6378;1858;6230;109;460;1603;5359;1712;5819
251710;201506;940;2448;685;1971;84;287;389;1080;473;1367
251720;201506;1386;4286;1238;4037;81;358;973;3100;1054;3458
251740;201506;774;2193;616;1921;75;249;384;1199;459;1448
260005;201506;25499;62468;21864;57385;4712;12474;12430;32783;17142;45257
260010;201506;10006;26911;8119;24535;1100;3395;5273;16487;6373;19882
260020;201506;5753;16701;4896;15396;346;1168;3717;11827;4063;12995
260030;201506;5781;17008;5277;16239;394;1337;4125;12653;4519;13990
260040;201506;10168;24570;8452;22636;681;1530;6708;18733;7389;20263
260050;201506;11358;35289;10519;34322;562;1962;9200;30390;9762;32352
260060;201506;3918;11044;3495;10326;307;887;2646;7919;2953;8806
260070;201506;9808;28657;9141;27634;1546;5027;5990;17981;7536;23008
260080;201506;5418;14921;4805;14034;543;1701;3507;10144;4050;11845
260090;201506;5214;14617;4912;14180;999;2766;3376;10020;4375;12786
260100;201506;3307;9092;2890;8500;167;632;2401;7002;2568;7634
260105;201506;4781;13874;4558;13456;471;1605;3412;9842;3883;11447
260110;201506;21236;60468;19524;58399;882;2677;17259;51882;18141;54559
260120;201506;11413;35004;10397;33223;2626;8537;5425;18062;8051;26599
260130;201506;3219;9106;3020;8793;452;1280;2148;6365;2600;7645
260140;201506;13418;33608;11476;31265;893;2615;9186;25386;10079;28001
260150;201506;3147;8945;2807;8478;199;757;2233;6723;2432;7480
260160;201506;5801;18050;5145;17225;353;1440;4190;13985;4543;15425
260170;201506;17408;48306;16490;47072;1249;3795;13467;38467;14716;42262
260180;201506;3310;10187;3006;9749;203;759;2486;8031;2689;8790
260190;201506;16068;37908;14806;36335;550;1388;13013;31827;13563;33215
260200;201506;10676;30471;9837;29302;763;2474;8114;24314;8877;26788
260210;201506;11397;34818;10328;33254;624;2363;8524;27487;9148;29850
260220;201506;9390;27836;9068;27400;473;1804;7998;23847;8471;25651
260230;201506;9672;27973;8936;26974;470;1559;7443;22737;7913;24296
260240;201506;3046;9161;2609;8554;379;1341;1835;6045;2214;7386
260250;201506;2308;6360;2044;6017;115;356;1727;5085;1842;5441
260260;201506;12223;34372;11243;33048;1686;5310;8179;24435;9865;29745
260270;201506;3619;10534;3365;10156;299;1192;2489;7141;2788;8333
260280;201506;12964;42130;11915;40536;661;2416;10121;34811;10782;37227
260290;201506;30349;91490;28747;88744;4577;15677;18613;56380;23190;72057
260300;201506;8651;26307;7679;24855;466;1900;6095;19811;6561;21711
260310;201506;4768;14076;4361;13466;1307;3706;2288;7669;3595;11375
260320;201506;7005;23013;6498;22239;427;1590;5381;18564;5808;20154
260330;201506;2712;8739;2506;8390;155;668;1961;6496;2116;7164
260340;201506;1921;5655;1783;5444;86;330;1553;4692;1639;5022
260345;201506;23784;74619;22308;71735;5851;20934;9176;28164;15027;49098
260350;201506;4623;12719;4351;12304;253;817;3610;10125;3863;10942
260360;201506;2312;6882;2123;6590;198;763;1500;4599;1698;5362
260370;201506;5996;18552;5282;17266;545;2060;3785;12401;4330;14461
260380;201506;4831;15985;4433;15414;333;1331;3469;12085;3802;13416
260390;201506;4544;14338;3983;13295;379;1447;2838;9290;3217;10737
260392;201506;3564;11178;3279;10819;164;697;2870;9379;3034;10076
260400;201506;13667;39309;12999;38224;1847;6182;9079;26105;10926;32287
260410;201506;60259;173624;53622;163085;15594;49783;22818;70894;38412;120677
260415;201506;3969;12590;3420;11528;382;1575;2173;7100;2555;8675
260420;201506;12227;28023;10994;26720;343;918;9961;24186;10304;25104
260430;201506;2817;9273;2526;8778;270;1054;1744;6014;2014;7068
260440;201506;3254;9847;2898;9141;405;1442;1786;5448;2191;6890
260450;201506;4993;14822;4736;14433;221;782;4090;12486;4311;13268
260460;201506;5654;17391;5189;16587;894;3123;3183;9998;4077;13121
260470;201506;4797;14234;4495;13832;283;876;3847;12088;4130;12964
260480;201506;4047;11712;3611;11092;595;2027;2373;7307;2968;9334
260490;201506;5072;13582;4438;12518;356;1181;3507;9710;3863;10891
260500;201506;6270;17614;5558;16544;726;2212;3830;11397;4556;13609
260510;201506;8954;23862;8253;22999;313;869;7512;21053;7825;21922
260515;201506;4809;14732;3745;12562;313;1214;2364;7919;2677;9133
260520;201506;15931;42069;15335;41276;2475;6637;11160;30357;13635;36994
260530;201506;9994;30117;8803;28410;472;1586;7492;24445;7964;26031
260540;201506;5996;14901;5477;14351;703;1415;4374;11930;5077;13345
260545;201506;80;285;46;182;8;33;11;38;19;71
260550;201506;2785;9182;2390;8364;544;2155;999;3432;1543;5587
260560;201506;6506;16968;5863;16046;211;676;5176;14068;5387;14744
260570;201506;6755;22655;6246;21802;762;3002;4500;15745;5262;18747
260580;201506;3787;10597;3517;10159;195;692;2988;8446;3183;9138
260590;201506;6132;15490;5855;15169;254;561;5319;13965;5573;14526
260600;201506;26698;80021;24228;75844;2561;9331;17324;53616;19885;62947
260610;201506;6769;20274;6401;19734;1016;3315;4456;13625;5472;16940
260620;201506;16408;49554;15654;48211;2667;9142;9947;30091;12614;39233
260630;201506;2166;6536;1946;6169;153;609;1543;4798;1696;5407
260640;201506;17480;48211;16422;46737;2454;7321;11169;31785;13623;39106
260650;201506;5286;17045;4761;16155;477;1652;3610;12480;4087;14132
260660;201506;8258;22871;7414;21805;389;1235;6402;18830;6791;20065
260670;201506;2403;6543;1958;5926;192;655;1388;4205;1580;4860
260680;201506;22105;61508;20377;58530;4377;12976;10526;30048;14903;43024
260690;201506;3781;10228;3216;9332;135;516;2705;7756;2840;8272
260700;201506;5643;17144;5488;16981;46;96;5372;16774;5418;16870
260710;201506;1251;3776;1149;3632;92;350;887;2786;979;3136
260720;201506;16831;54940;15880;53315;3714;12881;8700;29676;12414;42557
260730;201506;6892;23049;6365;22197;909;3270;4545;16053;5454;19323
260740;201506;1320;3993;1146;3690;140;485;741;2402;881;2887
260750;201506;6579;20831;6004;20037;559;1699;4903;16739;5462;18438
260760;201506;4732;12809;4422;12407;281;854;3669;10322;3950;11176
260765;201506;7677;26196;7328;25657;960;4225;5276;17928;6236;22153
260770;201506;3938;10274;3568;9761;134;467;2953;7964;3087;8431
260775;201506;5240;15121;4962;14710;501;1805;3603;10364;4104;12169
260780;201506;3717;12043;3514;11659;718;2721;2029;6490;2747;9211
260790;201506;114121;287983;106638;276871;21172;56716;64334;166529;85506;223245
260795;201506;3045;9427;2760;8995;355;1292;1885;6175;2240;7467
260800;201506;4930;13239;4534;12693;168;682;4002;10878;4170;11560
260805;201506;4023;11632;3538;10894;425;1478;2377;7180;2802;8658
260810;201506;6842;19663;6665;19450;323;956;5964;17477;6287;18433
260820;201506;4366;12339;4001;11844;1007;3081;2198;6456;3205;9537
260825;201506;2865;9253;2605;8840;191;721;2076;7068;2267;7789
260830;201506;3745;12065;3363;11337;799;2577;1930;6827;2729;9404
260840;201506;4273;12302;3835;11662;262;1014;3115;9287;3377;10301
260845;201506;4304;12504;4002;11954;531;1683;2810;8413;3341;10096
260850;201506;5018;16538;4455;15286;932;3617;2141;7134;3073;10751
260860;201506;3351;10618;3042;10015;198;747;2373;7822;2571;8569
260870;201506;4270;11762;3819;11194;489;1305;2894;8730;3383;10035
260875;201506;6766;18473;6002;17304;991;2899;3886;11297;4877;14196
260880;201506;9291;28879;8569;27717;731;2422;6807;22250;7538;24672
260890;201506;13550;38792;12652;37424;957;3231;9802;28858;10759;32089
260900;201506;6066;18638;5205;16996;671;2530;3212;10377;3883;12907
260910;201506;3069;9248;2799;8850;204;738;2235;7108;2439;7846
260915;201506;4467;15153;4285;14902;80;353;4024;14027;4104;14380
260920;201506;3445;10371;3235;10079;422;1494;2405;7520;2827;9014
260930;201506;4031;12976;3551;12217;411;1510;2564;8921;2975;10431
260940;201506;13777;37093;12530;35048;1567;5210;8488;22959;10055;28169
260950;201506;6318;19641;5822;18698;822;3214;3413;10418;4235;13632
260960;201506;57557;161458;53130;154208;10666;33071;29566;85455;40232;118526
260970;201506;5004;15872;4615;15318;332;1398;3597;11814;3929;13212
260980;201506;3915;12679;3674;12384;147;591;3263;11015;3410;11606
260990;201506;17306;54372;15764;52335;1240;4162;12858;43477;14098;47639
261000;201506;16185;44124;13066;39251;2462;7816;6854;21235;9316;29051
261010;201506;2608;7343;2395;7081;147;312;2106;6421;2253;6733
261020;201506;5931;17552;5377;16702;471;1717;4203;12732;4674;14449
261030;201506;3432;11182;3200;10767;235;977;2560;8485;2795;9462
261040;201506;5314;17216;4677;16014;420;1693;3422;11623;3842;13316
261050;201506;8127;23570;7585;22620;1029;3068;5181;15456;6210;18524
261060;201506;12063;35805;11240;34296;1187;4190;8349;25013;9536;29203
261070;201506;51325;127402;45074;118533;7407;20062;28356;74851;35763;94913
261080;201506;5851;17248;5493;16712;374;1027;4658;14464;5032;15491
261090;201506;16686;45952;15361;44147;1421;4013;12132;35353;13553;39366
261100;201506;7834;24927;6997;23475;1347;4759;4018;13755;5365;18514
261110;201506;60652;179500;54369;170192;12478;41113;29863;95344;42341;136457
261120;201506;3639;9763;3215;9243;97;322;2887;8330;2984;8652
261130;201506;7101;18198;6681;17725;171;461;6209;16465;6380;16926
261140;201506;3260;9207;2955;8741;443;1512;1831;5283;2274;6795
261150;201506;5503;16308;5017;15550;491;1749;3866;11964;4357;13713
261153;201506;2063;6002;1675;5407;74;311;1258;4061;1332;4372
261160;201506;210812;546545;196606;526454;44581;122968;105571;287776;150152;410744
261170;201506;5853;16127;5344;15399;610;1775;4093;11956;4703;13731
261180;201506;9666;26852;9089;26047;783;2468;6890;19691;7673;22159
261190;201506;5218;16294;4883;15872;627;2664;3402;10621;4029;13285
261200;201506;3703;9264;3350;8831;425;1119;2573;6906;2998;8025
261210;201506;1952;5142;1843;5007;118;299;1637;4504;1755;4803
261220;201506;13105;41299;10946;36578;1979;7229;5516;18305;7495;25534
261230;201506;4409;13367;4047;12917;154;547;3552;11452;3706;11999
261240;201506;4835;14367;4504;13802;681;2031;3084;9645;3765;11676
261245;201506;3673;11514;3149;10588;186;862;2496;8230;2682;9092
261247;201506;3379;10354;2861;9404;272;1021;2040;6740;2312;7761
261250;201506;19961;53147;19005;51925;3553;9308;13621;38167;17174;47475
261255;201506;4091;12670;3723;12050;240;910;3103;10039;3343;10949
261260;201506;12174;34547;10913;33019;579;1679;9364;28657;9943;30336
261270;201506;3942;11450;3584;10889;506;1666;2372;7112;2878;8778
261280;201506;2552;7793;2323;7459;152;546;1872;5993;2024;6539
261290;201506;2935;8496;2684;8166;154;569;2232;6814;2386;7383
261300;201506;10830;35241;9491;32812;1557;6176;5726;19570;7283;25746
261310;201506;7490;22973;7059;22220;1647;5345;4069;12837;5716;18182
261320;201506;5664;17924;5262;17179;300;1114;4300;14093;4600;15207
261330;201506;5445;16069;5180;15705;497;1519;4122;12544;4619;14063
261340;201506;4213;13939;3995;13588;476;1994;2666;8972;3142;10966
261350;201506;8150;27161;7642;26295;396;1840;6175;20926;6571;22766
261360;201506;8248;21733;7368;20507;628;1881;5816;15939;6444;17820
261370;201506;20203;59885;18905;57898;3819;12411;11367;34832;15186;47243
261380;201506;4224;14329;3859;13603;578;2244;2566;9100;3144;11344
261390;201506;16043;49034;14490;46432;2197;7831;8997;28632;11194;36463
261400;201506;4894;16798;4385;15751;449;1830;3082;11103;3531;12933
261410;201506;8651;24496;7888;23317;1008;2988;5811;17451;6819;20439
261420;201506;7492;25410;7172;24959;1704;6695;4286;14641;5990;21336
261430;201506;3455;10863;3024;10254;290;989;2318;8032;2608;9021
261440;201506;1631;5171;1471;4931;63;292;1187;3913;1250;4205
261450;201506;14075;39899;13654;39378;437;1409;12531;36103;12968;37512
261460;201506;7242;21565;6792;20991;434;1199;5895;18611;6329;19810
261470;201506;4051;10934;3642;10421;140;456;3253;9285;3393;9741
261480;201506;3600;13041;3330;12564;356;1537;2466;9140;2822;10677
261485;201506;5041;15490;4582;14679;800;2979;2682;8386;3482;11365
261500;201506;5752;15963;5077;15061;497;1352;3878;11905;4375;13257
261510;201506;1968;6292;1820;6063;132;482;1423;4753;1555;5235
261520;201506;2675;8687;2452;8263;156;632;1697;5867;1853;6499
261530;201506;12312;39370;10823;36549;2335;8724;4679;15805;7014;24529
261540;201506;7527;24176;7167;23556;1519;4954;4475;15087;5994;20041
261550;201506;3456;9964;3270;9704;293;1138;2614;7514;2907;8652
261560;201506;7144;23255;6468;22379;1031;3756;4561;16050;5592;19806
261570;201506;3525;10746;3063;10009;442;1538;1986;6477;2428;8015
261580;201506;5716;18012;5096;17033;368;1473;4184;13972;4552;15445
261590;201506;2520;7164;2248;6759;212;672;1668;5068;1880;5740
261600;201506;5411;14672;4640;13604;378;1166;3596;10626;3974;11792
261610;201506;2462;7163;2095;6640;119;482;1677;5220;1796;5702
261618;201506;2526;7126;2322;6867;226;737;1794;5223;2020;5960
261620;201506;4284;13254;3975;12745;615;2055;2701;8748;3316;10803
261630;201506;7869;22966;6621;20636;999;3631;3725;11254;4724;14885
261640;201506;32326;82581;30052;79798;1982;4975;24910;68388;26892;73363
261650;201506;3689;11475;3424;11096;409;1447;2443;7939;2852;9386
270010;201506;4528;17098;4152;16371;482;2221;2813;11158;3295;13379
270020;201506;3844;11250;3616;10906;356;1224;2828;8401;3184;9625
270030;201506;40413;121378;37883;117336;9086;29107;21587;67641;30673;96748
270040;201506;10779;32681;10021;31719;2364;7187;5649;18783;8013;25970
270050;201506;4199;11993;3875;11588;354;1191;3066;9159;3420;10350
270060;201506;1673;5366;1577;5239;280;1032;1026;3429;1306;4461
270070;201506;4290;13323;3954;12875;173;797;3411;10895;3584;11692
270080;201506;1281;4080;1142;3800;180;691;715;2304;895;2995
270090;201506;2177;6745;2038;6469;59;280;1712;5275;1771;5555
270100;201506;5943;18405;5635;17882;978;3312;3659;11500;4637;14812
270110;201506;3187;8932;2879;8594;386;1130;1982;6331;2368;7461
270120;201506;3080;8887;2771;8492;86;322;2497;7692;2583;8014
270130;201506;4986;15486;4725;15189;471;1366;3896;12944;4367;14310
270135;201506;1748;4719;1644;4592;155;299;1415;4117;1570;4416
270140;201506;10574;25793;9165;24021;771;2895;7161;17591;7932;20486
270150;201506;2718;9136;2656;9056;112;434;2441;8321;2553;8755
270160;201506;5229;17322;4787;16769;281;1088;4050;14228;4331;15316
270170;201506;3924;12679;3592;12216;652;2595;2118;7087;2770;9682
270180;201506;2219;7463;2040;7218;119;596;1690;5906;1809;6502
270190;201506;1889;6200;1784;6054;124;497;1437;4926;1561;5423
270200;201506;2653;8896;2478;8650;219;918;1910;6597;2129;7515
270210;201506;4609;14287;4356;13921;322;1336;3576;11191;3898;12527
270220;201506;1438;4712;1351;4553;251;944;779;2572;1030;3516
270230;201506;11100;35466;9744;33264;1331;5513;6184;20549;7515;26062
270235;201506;6445;20803;6037;20140;371;1570;5040;16665;5411;18235
270240;201506;10020;29863;8586;27998;2013;6850;4454;14709;6467;21559
270250;201506;3349;8668;3071;8331;170;418;2714;7359;2884;7777
270255;201506;5030;15187;4007;13334;299;1233;2857;9353;3156;10586
270260;201506;5802;18984;5617;18716;534;2215;4614;15080;5148;17295
270270;201506;1228;3489;1127;3347;208;643;658;1923;866;2566
270280;201506;3621;10441;3298;9973;374;1222;2434;7332;2808;8554
270290;201506;8415;29348;7929;28496;783;3357;6130;21768;6913;25125
270300;201506;3577;11854;3253;11484;254;1013;2616;9244;2870;10257
270310;201506;7411;22598;6537;21191;272;1328;5486;17388;5758;18716
270320;201506;6455;20442;6220;20061;1110;4201;4016;12862;5126;17063
270330;201506;4598;15383;4284;14959;419;1633;3412;11973;3831;13606
270340;201506;1753;5422;1565;5171;137;497;1235;4080;1372;4577
270350;201506;1887;5307;1713;5093;165;562;1269;3786;1434;4348
270360;201506;2048;6366;1985;6291;177;497;1678;5476;1855;5973
270370;201506;1648;5400;1500;5144;146;600;1065;3675;1211;4275
270375;201506;2898;8365;2604;7937;283;1024;1855;5451;2138;6475
270380;201506;5830;17977;5480;17494;549;1754;4267;13893;4816;15647
270390;201506;1328;3666;1177;3450;101;350;872;2466;973;2816
270400;201506;6195;18728;5611;17891;440;1617;4056;12692;4496;14309
270410;201506;4927;15219;4597;14618;492;1712;3292;10354;3784;12066
270420;201506;5926;19009;5708;18711;304;1420;4696;15047;5000;16467
270430;201506;135527;394203;126470;380940;33077;104057;62340;191733;95417;295790
270440;201506;4767;14498;4409;13988;249;932;3614;11525;3863;12457
270450;201506;6355;19694;6096;19361;370;1512;5053;15860;5423;17372
270460;201506;3514;9438;3159;8968;208;712;2666;7459;2874;8171
270470;201506;10380;33513;9625;32281;1267;4397;6500;22235;7767;26632
270480;201506;3045;9438;2702;8827;279;1105;1833;5750;2112;6855
270490;201506;982;3192;928;3106;58;234;727;2406;785;2640
270500;201506;4986;17076;4723;16747;349;1418;3913;13916;4262;15334
270510;201506;6075;18274;5469;17444;707;2942;3986;12144;4693;15086
270520;201506;3642;11677;3393;11263;905;3261;1514;5091;2419;8352
270530;201506;1515;4487;1352;4265;167;546;903;2938;1070;3484
270540;201506;2063;7007;1878;6742;146;719;1496;5229;1642;5948
270550;201506;7134;21128;6269;19999;903;3028;4286;13984;5189;17012
270560;201506;3063;9303;2847;8977;376;1408;2020;6157;2396;7565
270570;201506;3961;12822;3635;12275;376;1613;2777;9146;3153;10759
270580;201506;1975;6497;1889;6378;220;775;1437;4925;1657;5700
270590;201506;1401;4728;1323;4594;34;163;1234;4256;1268;4419
270600;201506;2885;9664;2597;9203;205;1009;1985;6871;2190;7880
270610;201506;3254;10313;3020;9979;246;914;2435;7987;2681;8901
270620;201506;1388;4746;1313;4629;106;507;1068;3608;1174;4115
270630;201506;17381;49666;16119;47624;2349;6854;11299;34127;13648;40981
270640;201506;5953;18216;5328;17380;385;1580;4318;13843;4703;15423
270642;201506;2320;8139;2163;7899;278;1224;1568;5661;1846;6885
270644;201506;2638;7636;2354;7302;202;560;1929;6144;2131;6704
270650;201506;3800;12111;3634;11881;598;2486;2403;7472;3001;9958
270660;201506;2546;6432;1979;5627;120;430;1381;3902;1501;4332
270670;201506;16382;42844;14123;40231;1756;4743;10530;31186;12286;35929
270680;201506;4313;12845;4137;12651;167;443;3781;11706;3948;12149
270690;201506;9100;25209;8298;24291;2638;7425;4156;12961;6794;20386
270700;201506;696;2143;634;2037;86;344;432;1318;518;1662
270710;201506;5975;19560;5696;19199;549;2028;4620;15598;5169;17626
270720;201506;3335;11301;3046;10793;175;909;2459;8529;2634;9438
270730;201506;6425;19416;6091;19044;672;2147;4927;15618;5599;17765
270740;201506;2392;6848;2244;6643;297;1016;1644;4777;1941;5793
270750;201506;5108;16110;4722;15539;545;1961;3512;11528;4057;13489
270760;201506;3458;10462;3117;9891;238;858;2423;7677;2661;8535
270770;201506;19054;50173;15884;46354;3172;9253;9426;28761;12598;38014
270780;201506;1845;6089;1742;5916;212;811;1233;4190;1445;5001
270790;201506;1630;5074;1486;4852;347;1235;782;2490;1129;3725
270800;201506;11614;34246;10811;33199;859;2974;8865;27183;9724;30157
270810;201506;3389;10252;2644;8897;290;1179;1655;5569;1945;6748
270820;201506;1798;6052;1636;5787;257;1013;1059;3753;1316;4766
270830;201506;5598;16250;5079;15605;766;2733;3553;10943;4319;13676
270840;201506;7880;25816;7270;25048;369;1808;6263;21249;6632;23057
270850;201506;7506;24046;7277;23760;1300;5151;4990;15499;6290;20650
270860;201506;11549;32353;9859;30144;1208;4413;6858;20570;8066;24983
270870;201506;2259;6738;1855;5901;268;892;1144;3624;1412;4516
270880;201506;8186;26398;7682;25676;562;2319;6318;20857;6880;23176
270890;201506;2505;7604;2341;7310;286;1085;1700;5167;1986;6252
270895;201506;2934;10942;2789;10749;206;907;2361;9157;2567;10064
270900;201506;1950;5310;1575;4769;100;378;1204;3567;1304;3945
270910;201506;3484;11739;3300;11394;295;1313;2555;8606;2850;9919
270915;201506;9878;33099;8898;31378;1543;6301;5220;18123;6763;24424
270920;201506;6297;19756;5939;19253;201;997;5331;17004;5532;18001
270930;201506;17573;46876;14479;43055;2745;8411;8668;26717;11413;35128
270940;201506;5932;19809;5645;19495;595;2433;4377;15114;4972;17547
280010;201506;689;2062;596;1906;48;219;401;1220;449;1439
280020;201506;4915;14373;4207;13133;739;2472;2592;8019;3331;10491
280030;201506;72281;189948;62863;175976;16821;49446;28084;79660;44905;129106
280040;201506;3177;9824;2841;9331;295;1014;2111;7089;2406;8103
280050;201506;3844;12354;3559;11885;1177;4171;1409;4864;2586;9035
280060;201506;4383;14467;4060;13908;824;3034;2278;7931;3102;10965
280067;201506;7488;21295;6474;19837;796;2510;4489;13884;5285;16394
280070;201506;1902;6432;1802;6284;330;1203;1217;4297;1547;5500
280100;201506;3954;12274;3534;11548;795;2737;1876;6208;2671;8945
280110;201506;1422;4334;1310;4168;75;319;1092;3409;1167;3728
280120;201506;7788;24781;7204;23860;1109;3436;5041;17456;6150;20892
280130;201506;7482;21250;6827;20296;1187;3907;4352;12952;5539;16859
280140;201506;5600;15236;5072;14520;509;1451;3949;11410;4458;12861
280150;201506;3477;10510;3195;10030;407;1456;2156;6561;2563;8017
280160;201506;1411;4072;1250;3823;148;511;897;2722;1045;3233
280170;201506;4845;14331;4372;13647;448;1335;3383;10878;3831;12213
280190;201506;1096;3095;981;2908;66;258;754;2162;820;2420
280200;201506;1153;3480;1058;3341;143;566;728;2201;871;2767
280210;201506;13188;40369;11975;38657;2233;7457;7469;24689;9702;32146
280220;201506;1567;4800;1466;4644;90;341;1236;3869;1326;4210
280230;201506;3559;10587;3160;9956;447;1505;2005;6378;2452;7883
280240;201506;3493;10220;3151;9676;290;854;2422;7510;2712;8364
280250;201506;838;2191;690;1957;112;374;362;909;474;1283
280260;201506;2029;5412;1862;5203;86;265;1656;4659;1742;4924
280270;201506;2323;7196;2039;6767;129;512;1588;5208;1717;5720
280280;201506;4201;13670;3844;13078;889;2547;2152;8212;3041;10759
280290;201506;17318;53177;15603;50488;2222;7854;10241;33612;12463;41466
280300;201506;9621;29466;8981;28702;723;2499;7277;23450;8000;25949
280310;201506;1382;3899;1224;3647;75;304;869;2522;944;2826
280320;201506;8361;27130;7681;25949;1456;5447;4108;13810;5564;19257
280330;201506;4605;12881;4179;12257;358;1269;3398;9787;3756;11056
280340;201506;3842;11080;3614;10767;312;1002;2892;8770;3204;9772
280350;201506;22265;63018;19975;59613;2670;8255;13670;41454;16340;49709
280360;201506;5814;18242;5451;17675;1029;3780;3197;10162;4226;13942
280370;201506;1853;5191;1636;4848;144;473;1207;3528;1351;4001
280380;201506;1037;3120;949;2993;100;366;718;2253;818;2619
280390;201506;3217;9437;2750;8587;456;1485;1697;5276;2153;6761
280400;201506;4285;12386;3880;11817;1079;3177;2048;6604;3127;9781
280410;201506;2209;7069;1910;6497;276;1065;1113;3656;1389;4721
280420;201506;4224;12304;3922;11839;240;784;3339;10086;3579;10870
280430;201506;2263;5807;2055;5532;120;396;1635;4339;1755;4735
280440;201506;4888;14370;4558;13974;338;1060;3852;11874;4190;12934
280445;201506;2461;7031;2286;6738;93;371;1862;5388;1955;5759
280450;201506;8743;23890;8133;23132;566;1390;6893;20172;7459;21562
280460;201506;7126;18793;6389;17765;871;2536;4554;12850;5425;15386
280470;201506;1815;5532;1654;5267;197;630;1202;3867;1399;4497
280480;201506;30855;90790;29346;88629;4573;15863;19709;58122;24282;73985
280490;201506;3807;11505;3364;10708;301;1116;2477;7783;2778;8899
280500;201506;924;2450;845;2348;41;125;712;1936;753;2061
280510;201506;2736;7893;2365;7407;235;846;1765;5552;2000;6398
280520;201506;1751;4927;1596;4731;145;372;1311;3994;1456;4366
280530;201506;2218;6433;2081;6264;166;521;1742;5319;1908;5840
280540;201506;9286;25355;8672;24523;233;912;7754;21620;7987;22532
280550;201506;6984;18546;5946;16965;637;1894;4180;11922;4817;13816
280560;201506;7571;22375;7132;21724;396;1408;6016;18105;6412;19513
280570;201506;6543;17807;5718;16730;686;2254;3927;11372;4613;13626
280580;201506;5600;17333;4758;15868;853;2862;2838;9758;3691;12620
280590;201506;2361;7179;2200;6972;256;1097;1555;4791;1811;5888
280600;201506;3900;11917;3642;11531;348;1275;2734;8593;3082;9868
280610;201506;2497;6986;2294;6697;251;890;1596;4510;1847;5400
280620;201506;5190;15450;4522;14229;659;1911;2951;9659;3610;11570
280630;201506;3856;12496;3665;12221;357;1079;2973;10264;3330;11343
280640;201506;2203;6601;2098;6485;87;186;1958;6174;2045;6360
280650;201506;1131;3512;1019;3324;130;473;680;2206;810;2679
280660;201506;2689;7643;2564;7475;421;1147;1948;5789;2369;6936
280670;201506;16082;42120;14928;40573;2716;7701;9756;26407;12472;34108
280680;201506;2806;7607;2479;7109;176;577;1999;5694;2175;6271
280690;201506;1004;2839;877;2662;122;383;599;1806;721;2189
280700;201506;1115;3306;975;3092;71;224;744;2392;815;2616
280710;201506;11618;31103;10703;30060;766;1983;9086;25979;9852;27962
280720;201506;2297;6356;2083;6099;268;829;1459;4342;1727;5171
280730;201506;950;2822;894;2744;84;275;739;2264;823;2539
280740;201506;13190;35886;11452;33257;1707;4841;7475;22280;9182;27121
280750;201506;3576;10887;3249;10316;341;1188;2292;7303;2633;8491
280760;201506;5656;17369;5137;16641;682;2284;3497;11684;4179;13968
290010;201506;3106;6954;2220;5594;66;266;1771;4235;1837;4501
290020;201506;4508;15021;4430;14919;418;1188;3696;12758;4114;13946
290030;201506;3175;9985;3000;9720;530;1705;2039;6686;2569;8391
290035;201506;4730;12187;4084;11338;251;834;3254;9262;3505;10096
290040;201506;3870;10826;3374;10253;214;857;2713;8094;2927;8951
290050;201506;2581;8331;2280;7843;162;666;1760;6029;1922;6695
290060;201506;1350;3438;1128;3175;199;637;805;2199;1004;2836
290070;201506;32485;81971;27623;75934;6033;16415;14080;41166;20113;57581
290080;201506;6212;18440;5316;17275;607;1946;3995;13380;4602;15326
290090;201506;2301;4909;1785;4361;180;403;1469;3660;1649;4063
290100;201506;9793;27914;8569;25993;1118;3548;5618;17471;6736;21019
290110;201506;5127;15218;4867;14768;715;2370;3275;9802;3990;12172
290115;201506;4997;14844;4383;14027;295;978;3450;11291;3745;12269
290120;201506;6839;17886;5794;16639;263;849;5027;14393;5290;15242
290130;201506;4583;12070;3847;11159;222;802;3144;8914;3366;9716
290135;201506;4662;11907;4018;10921;287;995;2955;7651;3242;8646
290140;201506;4178;12988;3536;12121;222;834;3022;10424;3244;11258
290150;201506;2210;6603;2098;6417;241;785;1627;4914;1868;5699
290160;201506;3451;9305;3339;9167;227;457;2956;8243;3183;8700
290170;201506;2747;9210;2496;8824;179;821;2092;7288;2271;8109
290180;201506;2904;8474;2554;7931;209;755;1945;5998;2154;6753
290190;201506;3898;13068;3738;12812;270;1091;2867;9791;3137;10882
290195;201506;2222;6089;1897;5596;119;424;1533;4511;1652;4935
290200;201506;3803;11944;3400;11293;296;1014;2685;8994;2981;10008
290205;201506;3144;9418;2819;8919;323;1232;2016;6213;2339;7445
290210;201506;15585;43211;14396;41722;2821;7174;9518;29901;12339;37075
290220;201506;2281;6850;2163;6661;173;710;1672;4987;1845;5697
290225;201506;2958;7810;2730;7559;158;376;2479;6976;2637;7352
290230;201506;2295;7507;2222;7417;142;533;1892;6341;2034;6874
290240;201506;3839;10260;3466;9727;333;976;2584;7178;2917;8154
290250;201506;3731;11968;3276;11277;212;755;2661;9301;2873;10056
290260;201506;4909;14408;4272;13425;352;1228;3316;10424;3668;11652
290265;201506;3347;10616;3005;9991;174;726;2347;7755;2521;8481
290270;201506;12284;44421;11562;43316;1508;5954;8420;32115;9928;38069
290280;201506;5243;17262;4886;16678;391;1453;3793;13061;4184;14514
290290;201506;9763;30860;8736;29209;1423;4921;5740;19583;7163;24504
290300;201506;4569;13038;3250;10562;253;819;2189;7384;2442;8203
290310;201506;1505;4484;1336;4221;233;802;779;2449;1012;3251
290320;201506;27759;81707;23883;76522;5808;19673;12128;39875;17936;59548
290323;201506;3856;10390;3350;9831;179;584;2805;8198;2984;8782
290327;201506;4460;13654;3879;12582;608;2031;2456;8002;3064;10033
290330;201506;1869;4702;1735;4556;156;441;1490;3910;1646;4351
290340;201506;4846;15344;4551;14954;1368;4446;2422;8120;3790;12566
290350;201506;4745;14492;4042;13481;501;1713;2774;9527;3275;11240
290360;201506;4517;13788;3921;12992;183;670;3290;10998;3473;11668
290370;201506;4895;13820;4249;13003;457;1304;3387;10582;3844;11886
290380;201506;5623;16274;4876;15188;349;1225;3852;12052;4201;13277
290390;201506;14971;46327;13738;44447;2575;8458;8320;28155;10895;36613
290395;201506;2690;8722;2363;8136;173;760;1767;6066;1940;6826
290400;201506;3642;10785;3122;10047;288;939;2339;7570;2627;8509
290405;201506;4601;14605;3861;13186;548;1917;2391;8341;2939;10258
290410;201506;6166;17986;5000;16179;504;1918;3524;11098;4028;13016
290420;201506;3375;9660;2744;8805;224;788;2150;6902;2374;7690
290430;201506;3083;9852;2809;9374;504;1805;1746;5862;2250;7667
290440;201506;2952;7914;2435;7195;172;568;1893;5636;2065;6204
290450;201506;3349;9745;2904;9101;354;1193;2003;6278;2357;7471
290460;201506;13235;38690;11847;36396;3058;9852;5285;16177;8343;26029
290470;201506;4593;12651;3521;11086;736;2632;1769;5647;2505;8279
290475;201506;5044;17281;4580;16395;426;1910;3358;11863;3784;13773
290480;201506;2721;7056;2435;6686;386;1108;1584;4512;1970;5620
290485;201506;4863;15443;4245;14537;350;1640;3372;11314;3722;12954
290490;201506;8105;21427;7750;20962;601;1715;6468;17469;7069;19184
290500;201506;4491;13940;3629;12258;598;2204;1888;6347;2486;8551
290510;201506;3391;9816;2923;9169;165;616;2413;7610;2578;8226
290515;201506;3234;9462;2780;8837;231;705;2223;7246;2454;7951
290520;201506;12286;37602;9965;33312;884;3635;6320;20912;7204;24547
290530;201506;5199;15085;4497;14047;360;1104;3578;11291;3938;12395
290540;201506;3965;11469;3757;11206;458;1287;2919;8929;3377;10216
290550;201506;4525;12215;3959;11556;146;422;3604;10600;3750;11022
290560;201506;6006;17889;5302;16853;1230;4027;2986;9693;4216;13720
290570;201506;43104;119057;39151;113376;4598;13763;27698;80201;32296;93964
290580;201506;7089;24208;6676;23573;901;3246;4826;17502;5727;20748
290590;201506;7751;24164;6451;21951;370;1533;5059;17176;5429;18709
290600;201506;17506;53203;16140;51146;2470;7603;11319;37116;13789;44719
290610;201506;2534;8538;2111;7702;176;814;1511;5429;1687;6243
290620;201506;6572;19885;5961;18965;375;1263;4944;15735;5319;16998
290630;201506;8074;21365;7200;20422;634;1796;6003;17205;6637;19001
290640;201506;2701;7844;2150;6929;168;658;1609;5108;1777;5766
290650;201506;11282;32132;10521;31091;2231;6471;6586;20099;8817;26570
290660;201506;3644;10201;3135;9456;151;506;2436;7536;2587;8042
290670;201506;7101;21603;6363;20464;712;2262;4680;15497;5392;17759
290680;201506;10279;30537;9322;29372;430;1543;7895;24920;8325;26463
290682;201506;4570;13154;4054;12434;173;679;3400;10298;3573;10977
290685;201506;3730;8915;2456;7108;300;940;1485;4390;1785;5330
290687;201506;7814;21511;6102;19029;1403;4499;3160;10144;4563;14643
290689;201506;3199;9161;2722;8419;241;772;2104;6637;2345;7409
290690;201506;5609;16085;5036;15344;529;1697;3855;11843;4384;13540
290700;201506;2378;7411;2246;7210;192;684;1730;5583;1922;6267
290710;201506;8138;25400;7698;24692;442;1428;6327;20904;6769;22332
290720;201506;18851;55179;17056;52956;1461;4161;13972;44696;15433;48857
290730;201506;7230;20064;6490;19102;1065;3059;4356;12988;5421;16047
290740;201506;941;2785;792;2533;83;276;547;1780;630;2056
290750;201506;10496;29404;8846;26382;1658;5570;4654;13274;6312;18844
290755;201506;2423;6802;1989;6086;113;399;1482;4508;1595;4907
290760;201506;4330;12946;3499;11523;402;1233;2323;7835;2725;9068
290770;201506;2616;9143;2444;8917;114;551;1952;7130;2066;7681
290780;201506;9112;23036;7845;21243;795;1668;6007;17001;6802;18669
290790;201506;4374;13269;4061;12822;265;808;3426;10950;3691;11758
290800;201506;7451;15880;5939;14274;676;1391;4432;11328;5108;12719
290810;201506;5113;15999;4335;14755;233;873;3301;11375;3534;12248
290820;201506;5738;16050;5087;15172;451;1453;3897;11733;4348;13186
290830;201506;4314;11715;3940;11164;233;819;3103;8603;3336;9422
290840;201506;17658;49801;15685;46927;2485;7216;10477;32648;12962;39864
290850;201506;6402;18466;6180;18199;743;1975;5015;15338;5758;17313
290860;201506;5018;17151;4688;16742;555;2008;3549;13070;4104;15078
290870;201506;4790;14077;3852;12604;299;1212;2824;9199;3123;10411
290880;201506;1445;3932;1146;3448;84;259;806;2445;890;2704
290890;201506;7077;18649;6077;17539;673;1902;4783;14009;5456;15911
290900;201506;2604;7349;1899;6165;280;960;962;3144;1242;4104
290910;201506;4623;12718;3991;11815;145;500;3482;10267;3627;10767
290920;201506;4721;13927;4352;13393;300;845;3560;11106;3860;11951
290930;201506;7897;24413;6899;22761;536;2168;5257;17127;5793;19295
290940;201506;3445;11065;3205;10750;200;727;2773;9461;2973;10188
290950;201506;1589;4410;1411;4151;182;528;949;2828;1131;3356
290960;201506;5837;16566;5306;15872;204;715;4478;13470;4682;14185
290970;201506;3658;11676;3221;10925;357;1263;2164;7453;2521;8716
290980;201506;10347;29721;8763;26753;2415;7581;3032;9239;5447;16820
290990;201506;9199;27528;8041;25639;848;2862;5940;18817;6788;21679
291000;201506;3070;9344;2799;9001;245;846;2323;7531;2568;8377
291005;201506;14063;37547;12502;35440;1814;5288;8686;25050;10500;30338
291010;201506;3272;10241;2558;8703;282;993;1626;5589;1908;6582
291020;201506;1425;3756;1085;3158;128;415;638;1775;766;2190
291030;201506;2287;6234;1687;5051;173;569;1034;3035;1207;3604
291040;201506;5515;16678;4941;15882;426;1538;3893;12543;4319;14081
291050;201506;7816;25635;7064;24202;1830;7008;3484;11604;5314;18612
291060;201506;6090;22333;5743;21801;874;3738;3910;14737;4784;18475
291070;201506;16371;47155;14392;44288;1268;4027;10950;34047;12218;38074
291072;201506;22772;67276;18520;58832;4871;16767;6719;21617;11590;38384
291075;201506;5172;14604;4566;13771;283;713;3573;11119;3856;11832
291077;201506;1518;4303;1225;3832;109;377;815;2550;924;2927
291080;201506;79899;247366;71072;230204;23657;78314;19495;62449;43152;140763
291085;201506;5598;14876;4868;13916;480;1424;3899;11175;4379;12599
291090;201506;1578;3872;1376;3621;85;287;1134;2935;1219;3222
291100;201506;2846;7093;2246;6459;122;451;1805;5138;1927;5589
291110;201506;4811;17530;4394;16870;573;2544;3104;11745;3677;14289
291120;201506;7506;20098;6892;19196;856;2454;4974;13923;5830;16377
291125;201506;1861;3785;1415;3306;108;265;1116;2670;1224;2935
291130;201506;2893;8925;2434;8141;146;636;1805;5878;1951;6514
291140;201506;4326;12787;3854;11928;549;1703;2525;7907;3074;9610
291150;201506;2026;5297;1921;5177;126;393;1561;4144;1687;4537
291160;201506;5414;16710;4727;15612;1152;3816;2498;8362;3650;12178
291165;201506;2539;7139;1965;6058;58;247;1437;4312;1495;4559
291170;201506;21648;56267;18583;52266;974;3271;14018;39192;14992;42463
291180;201506;6515;16907;5234;15048;514;1646;3690;10583;4204;12229
291185;201506;3881;10570;3487;9987;309;905;2797;7957;3106;8862
291190;201506;7191;19773;6351;18622;540;1701;5083;14949;5623;16650
291200;201506;2946;8750;2367;7680;163;527;1652;5480;1815;6007
291210;201506;7348;17432;6246;16173;372;1071;4988;12918;5360;13989
291220;201506;4152;12907;3807;12364;490;1813;2699;8680;3189;10493
291230;201506;4110;10507;3673;10009;103;240;3384;9343;3487;9583
291240;201506;4672;12681;4030;11509;178;564;3244;9116;3422;9680
291250;201506;3720;11138;2879;9660;313;1081;1938;6628;2251;7709
291260;201506;1105;3232;1007;3100;60;247;834;2512;894;2759
291270;201506;4498;14427;4098;13683;1326;4629;1926;6497;3252;11126
291280;201506;2198;6068;1718;5327;402;1355;822;2445;1224;3800
291290;201506;5651;15630;4907;14683;857;2551;3022;9263;3879;11814
291300;201506;4414;12583;3491;11006;268;961;2531;7853;2799;8814
291310;201506;5449;15524;4696;14205;325;1067;3657;11041;3982;12108
291320;201506;6095;19338;5114;17445;1182;4373;2611;8806;3793;13179
291330;201506;1628;4842;1443;4541;143;522;1009;3105;1152;3627
291340;201506;3918;11461;3279;10565;184;671;2659;8548;2843;9219
291345;201506;3551;11241;3297;10946;209;639;2880;9831;3089;10470
291350;201506;5583;16490;4898;15299;296;1010;3892;12288;4188;13298
291360;201506;33557;93991;30469;89634;7576;22190;17386;52851;24962;75041
291370;201506;8532;24607;8053;24006;621;1915;6332;19160;6953;21075
291380;201506;3744;11391;3214;10528;231;839;2322;7782;2553;8621
291390;201506;10586;28569;9568;27383;1395;3803;7026;20474;8421;24277
291400;201506;16538;43230;13546;39155;2482;6843;8135;24916;10617;31759
291410;201506;3373;8761;2478;7426;155;622;1845;5349;2000;5971
291420;201506;2159;5874;1883;5542;112;387;1601;4673;1713;5060
291430;201506;3418;9896;3015;9373;168;735;2429;7385;2597;8120
291440;201506;6523;19926;5503;18159;539;1910;4031;13381;4570;15291
291450;201506;8224;24494;7298;23192;323;987;5868;19362;6191;20349
291460;201506;13207;39764;11787;37512;1883;6537;7200;23009;9083;29546
291465;201506;8066;22999;7185;22003;499;1671;5969;18335;6468;20006
291470;201506;15900;43132;13936;40753;1185;3325;10597;32121;11782;35446
291480;201506;34772;90764;29813;83882;4031;12611;18505;51743;22536;64354
291490;201506;4416;14291;4252;14068;426;1386;3439;11631;3865;13017
291500;201506;4302;12282;3644;11338;251;925;2845;8773;3096;9698
291510;201506;3598;10845;3292;10444;91;267;2995;9631;3086;9898
291520;201506;3934;10652;3416;9944;382;1192;2388;7034;2770;8226
291530;201506;2084;5963;1734;5420;398;1304;896;2904;1294;4208
291535;201506;4070;12112;3632;11486;230;792;2917;9311;3147;10103
291540;201506;2244;5268;1864;4871;161;306;1595;4327;1756;4633
291550;201506;5362;14486;4676;13538;1035;2850;2603;7767;3638;10617
291560;201506;18604;44278;13431;38260;1223;3423;10003;29585;11226;33008
291570;201506;2248;6099;2078;5884;166;396;1759;5130;1925;5526
291580;201506;5686;17258;5028;16259;565;2236;3600;11556;4165;13792
291590;201506;1828;5762;1630;5436;179;629;1192;4051;1371;4680
291600;201506;5694;15471;4152;13099;1053;3526;1764;5446;2817;8972
291610;201506;4923;15373;4760;15172;240;842;4208;13483;4448;14325
291620;201506;3037;7152;2402;6480;141;354;1926;5374;2067;5728
291630;201506;3184;7811;2675;7218;280;719;2061;5655;2341;6374
291640;201506;17516;47319;14156;42506;3512;11281;5065;15489;8577;26770
291650;201506;8016;23960;7390;23208;642;1669;6191;20095;6833;21764
291660;201506;2230;5881;1869;5337;141;495;1292;3566;1433;4061
291670;201506;1934;5441;1734;5154;135;416;1333;3986;1468;4402
291680;201506;4307;12477;3717;11499;718;2424;2108;6498;2826;8922
291685;201506;4757;11923;3935;10852;551;1442;2758;7922;3309;9364
291690;201506;4098;10923;3256;9567;234;654;2334;6893;2568;7547
291700;201506;9236;28814;8289;27158;897;2996;6184;20580;7081;23576
291710;201506;5320;13903;4312;12647;409;1325;3139;9231;3548;10556
291720;201506;4332;14374;3724;13131;351;1431;2614;9080;2965;10511
291730;201506;6109;18352;5509;17554;663;2221;4165;13523;4828;15744
291733;201506;2665;7703;2255;7154;242;832;1504;4868;1746;5700
291735;201506;2748;7680;2286;6995;132;482;1835;5563;1967;6045
291740;201506;3683;10945;3152;10162;279;1040;2393;7653;2672;8693
291750;201506;22817;58434;17536;50348;3962;11805;8786;25730;12748;37535
291760;201506;11437;36252;10114;33945;4035;14959;2996;9893;7031;24852
291770;201506;7684;22075;6595;20122;930;3069;4328;13052;5258;16121
291780;201506;4494;13603;4214;13125;344;1091;3389;10584;3733;11675
291790;201506;2681;8197;2537;8001;105;441;2178;6789;2283;7230
291800;201506;31309;86740;27655;81609;4782;14423;17192;52331;21974;66754
291810;201506;10741;29611;8923;27449;440;1614;7399;22730;7839;24344
291820;201506;3727;11033;3358;10499;260;865;2556;8047;2816;8912
291830;201506;4348;11549;3998;11056;482;1391;2972;8289;3454;9680
291835;201506;6362;19762;5070;17524;1384;5183;2527;8769;3911;13952
291840;201506;48449;134420;42381;127611;5995;17588;30811;95981;36806;113569
291845;201506;2946;8417;2621;8033;191;525;2295;7186;2486;7711
291850;201506;4694;13256;3819;11895;386;1105;2843;9140;3229;10245
291855;201506;1855;4688;1593;4357;174;592;1153;3022;1327;3614
291860;201506;2157;6167;1768;5428;116;438;1173;3534;1289;3972
291870;201506;1438;3816;1059;3137;87;306;680;1963;767;2269
291875;201506;2886;9082;2595;8635;158;664;1873;6105;2031;6769
291880;201506;4937;15712;4633;15211;408;1329;3651;12177;4059;13506
291890;201506;1375;3462;1140;3187;309;856;647;1904;956;2760
291900;201506;1307;3578;1082;3215;85;306;852;2512;937;2818
291905;201506;2831;7544;2187;6462;97;354;1645;4732;1742;5086
291910;201506;2774;7396;2327;6865;135;503;1947;5644;2082;6147
291915;201506;7186;21738;6016;19581;376;1295;4797;15729;5173;17024
291920;201506;30349;87589;27641;83737;5004;15720;16868;51860;21872;67580
291930;201506;2638;7710;2340;7246;202;699;1700;5208;1902;5907
291940;201506;3417;9706;2496;8036;329;1186;1400;4352;1729;5538
291950;201506;8893;29633;7985;28055;1332;4731;4689;16930;6021;21661
291955;201506;9910;29546;9333;28801;2135;6571;5565;17919;7700;24490
291960;201506;3229;9366;2631;8468;260;844;1869;6230;2129;7074
291970;201506;4032;12432;3740;11994;465;1592;2571;8308;3036;9900
291980;201506;11972;33982;9097;29828;1101;3708;6115;20564;7216;24272
291990;201506;2264;6827;2049;6534;124;427;1651;5393;1775;5820
291992;201506;2862;8743;2781;8581;399;1297;2067;6327;2466;7624
291995;201506;1967;5835;1797;5574;130;461;1487;4610;1617;5071
292000;201506;2426;6877;2143;6488;287;994;1493;4513;1780;5507
292010;201506;6493;16453;4987;14267;462;1273;3766;10877;4228;12150
292020;201506;4259;14504;3954;14009;649;2427;2804;9952;3453;12379
292030;201506;2091;6417;1848;6062;241;847;1057;3427;1298;4274
292040;201506;4424;12120;3802;11468;261;631;3268;10303;3529;10934
292045;201506;2923;10082;2848;9992;90;315;2690;9434;2780;9749
292050;201506;6431;19675;5555;17923;479;1853;3724;11863;4203;13716
292060;201506;11692;31382;10838;30304;1131;2895;8538;24109;9669;27004
292070;201506;4728;14487;4476;14192;406;1162;3741;12094;4147;13256
292080;201506;3640;9439;3034;8680;207;618;2515;7260;2722;7878
292090;201506;4141;10819;3530;10106;229;777;2961;8501;3190;9278
292100;201506;11125;30144;9300;27592;2601;8051;4071;12693;6672;20744
292105;201506;3037;9522;2718;9025;149;607;2204;7321;2353;7928
292110;201506;6818;17903;5213;15441;1263;3767;2741;8371;4004;12138
292120;201506;7968;22378;6705;20027;1384;4094;3658;11354;5042;15448
292130;201506;3048;8152;2614;7534;480;1298;1640;4870;2120;6168
292140;201506;5080;13153;4220;11975;933;2413;2645;7806;3578;10219
292145;201506;2513;7668;2246;7232;189;580;1682;5652;1871;6232
292150;201506;13054;39668;12011;37969;672;2368;9594;30506;10266;32874
292160;201506;2684;7746;2278;7228;126;429;1967;6274;2093;6703
292170;201506;9019;25591;7454;22912;963;3331;4763;14552;5726;17883
292180;201506;3333;9472;2536;8165;358;1139;1581;5199;1939;6338
292190;201506;3428;9603;2870;8786;593;1897;1703;5324;2296;7221
292200;201506;6572;20615;5621;18868;1630;5947;2095;7011;3725;12958
292205;201506;3915;12083;3519;11490;201;823;2849;9145;3050;9968
292210;201506;6532;17874;5458;16454;366;1302;4445;13420;4811;14722
292220;201506;1940;5338;1743;5050;509;1399;830;2458;1339;3857
292225;201506;3234;9973;2948;9567;184;677;2438;7932;2622;8609
292230;201506;6514;19379;6164;18811;421;1730;4787;14120;5208;15850
292240;201506;4745;14227;4233;13191;497;1609;2940;9061;3437;10670
292250;201506;5165;15885;4745;15106;1121;3705;2257;7245;3378;10950
292260;201506;3180;9484;2985;9217;195;640;2510;7771;2705;8411
292265;201506;3036;9465;2669;8830;164;680;1975;6453;2139;7133
292270;201506;4179;10646;3280;9607;200;674;2717;7997;2917;8671
292273;201506;2762;6555;2106;5748;222;568;1575;4536;1797;5104
292275;201506;1758;4679;1559;4386;217;640;1093;3103;1310;3743
292280;201506;2069;6056;1799;5749;164;476;1389;4705;1553;5181
292285;201506;2571;6970;2154;6371;142;509;1684;4944;1826;5453
292290;201506;7369;21982;6098;20250;409;1552;4717;15879;5126;17431
292300;201506;8232;24633;7110;23275;1698;5779;4099;13852;5797;19631
292303;201506;2821;8691;2592;8383;89;378;2247;7161;2336;7539
292305;201506;2991;8109;2818;7858;62;217;2611;7254;2673;7471
292310;201506;6006;17752;5580;17139;228;777;4658;14307;4886;15084
292320;201506;6673;19110;5701;17471;521;1702;4299;13163;4820;14865
292330;201506;2157;5886;1991;5645;176;562;1586;4442;1762;5004
292335;201506;5291;13756;4691;12963;436;1170;3857;10818;4293;11988
292340;201506;6451;18322;5417;16649;560;1712;3831;11894;4391;13606
292350;201506;2224;6646;1978;6286;176;678;1546;4873;1722;5551
292360;201506;5179;13801;4950;13327;204;398;4238;11981;4442;12379
292370;201506;8062;23818;7417;22919;751;1998;5904;18721;6655;20719
292380;201506;7311;21527;6717;20595;519;1550;5415;16760;5934;18310
292390;201506;3587;8133;3141;7647;108;197;2915;7190;3023;7387
292400;201506;21006;63057;19909;61374;2546;8122;14812;46094;17358;54216
292405;201506;4632;11659;3759;10545;231;608;3067;8679;3298;9287
292410;201506;1952;5228;1833;5093;131;355;1579;4395;1710;4750
292420;201506;3775;12270;3603;12042;186;637;3215;10834;3401;11471
292430;201506;5686;16904;4326;14944;310;1268;3203;11066;3513;12334
292440;201506;8591;28317;7887;27285;260;1048;7028;24578;7288;25626
292450;201506;4213;12478;3446;11246;334;1104;2474;8239;2808;9343
292460;201506;5294;15788;4568;14529;720;2438;2913;9290;3633;11728
292465;201506;2442;7300;2052;6651;198;746;1377;4523;1575;5269
292467;201506;1967;6291;1864;6126;324;1140;1251;4183;1575;5323
292470;201506;2952;7920;2455;7094;131;451;1939;5555;2070;6006
292480;201506;6155;16444;5298;15286;192;721;4666;13353;4858;14074
292490;201506;2450;6657;2017;6023;161;530;1556;4637;1717;5167
292500;201506;6652;19703;5622;17882;637;2140;3834;12369;4471;14509
292510;201506;12989;36596;11182;34038;882;2925;8647;26672;9529;29597
292520;201506;5681;16670;5043;15680;1240;3925;2661;8380;3901;12305
292525;201506;5405;14085;4568;13111;222;676;3863;11170;4085;11846
292530;201506;26572;76795;23475;72532;6193;19775;11611;36974;17804;56749
292540;201506;2870;8003;2531;7557;267;906;1973;5877;2240;6783
292550;201506;6681;20767;5850;19668;688;2451;4353;15018;5041;17469
292560;201506;4141;11432;3515;10523;218;869;2783;8182;3001;9051
292570;201506;3937;11772;3722;11545;78;191;3520;11144;3598;11335
292575;201506;6087;20500;5913;20220;740;2620;4633;15959;5373;18579
292580;201506;6876;20476;6485;19944;449;1405;5418;16786;5867;18191
292590;201506;7366;22184;6836;21404;572;1835;5541;17314;6113;19149
292593;201506;3130;8191;2611;7382;194;503;2080;5928;2274;6431
292595;201506;6036;16690;5319;15771;435;1399;4160;12418;4595;13817
292600;201506;10709;30064;9708;28785;942;2250;7664;23562;8606;25812
292610;201506;4559;12933;3719;11517;340;1092;2327;7488;2667;8580
292620;201506;6131;17836;5260;16823;144;477;4876;15719;5020;16196
292630;201506;9541;24007;7955;21595;736;2000;5755;15924;6491;17924
292640;201506;7830;25638;7212;24719;479;1779;5577;19368;6056;21147
292650;201506;4788;13094;4522;12742;377;795;3893;11283;4270;12078
292660;201506;10755;32372;9949;31202;1064;3463;7643;24282;8707;27745
292665;201506;2632;8054;2526;7914;49;107;2382;7573;2431;7680
292670;201506;3864;10767;2942;9191;220;757;1930;6017;2150;6774
292680;201506;3603;10878;3303;10379;399;1197;2474;7841;2873;9038
292690;201506;2984;8077;2164;6800;202;671;1503;4846;1705;5517
292700;201506;9229;27499;8113;25853;1125;3321;5447;18199;6572;21520
292710;201506;2059;6720;1945;6564;71;278;1724;5824;1795;6102
292720;201506;9347;23874;8044;22430;366;1135;6952;19531;7318;20666
292730;201506;3579;10753;3445;10553;336;1053;2639;8138;2975;9191
292740;201506;339986;914697;318872;884068;58943;173480;201101;553897;260044;727377
292750;201506;6538;17485;5573;16171;339;1043;4531;13200;4870;14243
292760;201506;4087;12801;3684;12081;468;1637;2437;8055;2905;9692
292770;201506;5665;17239;5218;16545;1021;3375;3259;10528;4280;13903
292780;201506;1941;4593;1480;4012;151;498;1058;2797;1209;3295
292790;201506;3215;8114;3077;7970;109;218;2887;7578;2996;7796
292800;201506;9133;27186;8398;25973;565;1936;6723;20745;7288;22681
292805;201506;2926;8355;2613;7925;368;1223;1894;5713;2262;6936
292810;201506;9505;28862;8099;26916;995;3421;5788;19677;6783;23098
292820;201506;7451;21203;5527;18438;315;1249;4382;14684;4697;15933
292830;201506;1870;5421;1670;5139;77;321;1416;4303;1493;4624
292840;201506;7680;23994;7184;23322;299;1153;6457;20847;6756;22000
292850;201506;3242;8453;2633;7518;358;1042;1610;4506;1968;5548
292860;201506;14873;39084;13662;37472;1216;3463;10681;29250;11897;32713
292870;201506;19333;52935;16842;49043;2278;7359;10114;29010;12392;36369
292880;201506;12810;36619;11382;34562;1312;4397;7887;23699;9199;28096
292890;201506;5537;18746;4953;17697;766;2916;3139;11364;3905;14280
292895;201506;2780;6824;2168;5901;273;700;1497;4102;1770;4802
292900;201506;2866;8887;2706;8634;226;983;1974;6018;2200;7001
292905;201506;4208;12249;3512;11274;205;641;2824;9249;3029;9890
292910;201506;5080;15194;4603;14324;668;2239;2855;8886;3523;11125
292920;201506;9028;26605;8513;25821;621;2244;6914;20402;7535;22646
292925;201506;5167;15687;4566;14819;436;1428;3415;11157;3851;12585
292930;201506;6574;21100;6256;20554;524;2242;4681;15045;5205;17287
292935;201506;2154;6092;1811;5720;118;363;1494;4901;1612;5264
292937;201506;3259;8321;2708;7638;274;856;2056;5721;2330;6577
292940;201506;3280;8975;2576;8003;296;937;1759;5672;2055;6609
292950;201506;8018;23629;7475;22715;659;2422;5525;16393;6184;18815
292960;201506;5143;13412;4450;12469;337;1039;3310;9179;3647;10218
292970;201506;4349;13017;3838;12340;156;655;3215;10341;3371;10996
292975;201506;3448;9291;3251;9036;343;886;2725;7700;3068;8586
292980;201506;3384;9103;2627;8034;251;879;1904;5780;2155;6659
292990;201506;11903;34285;10544;32198;449;1567;8865;27001;9314;28568
293000;201506;2804;7441;2486;7044;79;256;2114;6122;2193;6378
293010;201506;18198;50487;15505;46184;2515;8098;9382;27743;11897;35841
293015;201506;7539;25777;6626;24043;910;3719;4253;15351;5163;19070
293020;201506;9285;30883;8671;30027;391;1706;7403;25565;7794;27271
293030;201506;5618;16094;4407;14238;375;1204;3089;10472;3464;11676
293040;201506;3715;12258;3531;11914;190;676;3108;10470;3298;11146
293050;201506;20187;56150;17747;53035;2673;8263;11078;34150;13751;42413
293060;201506;4006;10332;3237;9094;276;830;2358;6547;2634;7377
293070;201506;21601;62549;18986;58461;4715;14702;9498;30241;14213;44943
293075;201506;3374;11193;3048;10733;231;887;2427;8624;2658;9511
293076;201506;3741;10381;3397;9917;216;587;2855;8527;3071;9114
293077;201506;4932;15276;4323;14456;1022;3594;2372;8083;3394;11677
293080;201506;4663;14680;4256;14040;235;1068;3471;11261;3706;12329
293090;201506;3369;10785;2792;9919;254;924;2066;7466;2320;8390
293100;201506;5891;17330;4846;15487;437;1470;3554;11527;3991;12997
293105;201506;3981;13176;3475;12203;508;1808;2293;8221;2801;10029
293110;201506;2019;5859;1793;5514;74;276;1499;4599;1573;4875
293120;201506;3878;12785;3639;12424;319;1004;2896;10142;3215;11146
293130;201506;4114;11610;3474;10901;157;550;3114;9896;3271;10446
293135;201506;31375;79235;23716;68438;4830;15822;10045;28610;14875;44432
293140;201506;2034;5893;1936;5755;152;554;1526;4401;1678;4955
293150;201506;5643;18571;4866;17046;860;3116;2971;10684;3831;13800
293160;201506;3770;9656;3464;9298;604;1187;2462;7176;3066;8363
293170;201506;3355;10012;3072;9595;354;1234;2209;6951;2563;8185
293180;201506;5227;14671;4189;13002;205;829;3279;9953;3484;10782
293190;201506;13989;42223;13030;40785;457;2114;11312;34806;11769;36920
293200;201506;6783;19211;5905;18041;242;872;4925;15109;5167;15981
293210;201506;5060;14617;4481;13631;322;1123;3411;10349;3733;11472
293220;201506;5150;15176;4490;14064;1145;3693;2003;6386;3148;10079
293230;201506;3863;11862;3528;11348;542;1881;2431;7853;2973;9734
293240;201506;4499;12166;3592;10672;161;512;2648;7859;2809;8371
293245;201506;4359;12479;3963;11887;367;1094;3011;9191;3378;10285
293250;201506;5891;16297;5338;15483;568;1691;3810;11049;4378;12740
293260;201506;4697;13994;3938;12897;297;1033;3004;9956;3301;10989
293270;201506;5671;15180;5295;14783;415;963;4638;13275;5053;14238
293280;201506;5387;15157;4599;14114;281;828;3661;11453;3942;12281
293290;201506;15602;51848;14592;49875;3514;12539;7285;25385;10799;37924
293300;201506;6970;16619;5868;15337;393;912;4639;12382;5032;13294
293305;201506;4846;12005;4142;11050;180;534;3515;9339;3695;9873
293310;201506;2547;6621;2066;5812;173;509;1474;4104;1647;4613
293315;201506;4434;11298;3780;10297;469;1251;2701;7482;3170;8733
293317;201506;2484;7236;2209;6735;199;623;1525;4693;1724;5316
293320;201506;8116;26977;7923;26740;603;2224;6713;22793;7316;25017
293325;201506;1912;5491;1580;4975;220;769;1052;3320;1272;4089
293330;201506;52615;166577;47003;156774;10243;36911;23522;79032;33765;115943
293340;201506;2714;7581;2111;6533;309;1007;1249;3793;1558;4800
293345;201506;3424;10060;2956;9416;281;797;2244;7461;2525;8258
293350;201506;6744;18996;6376;18571;349;835;5659;16906;6008;17741
293360;201506;13423;40790;12068;39083;608;2128;10503;34217;11111;36345
310010;201506;1138;3063;844;2612;167;644;362;1039;529;1683
310020;201506;3317;10341;2706;9083;673;2493;480;1446;1153;3939
310030;201506;2368;7468;1967;6769;464;1780;1046;3549;1510;5329
310040;201506;1026;2713;852;2483;74;260;653;1878;727;2138
310050;201506;1925;6616;1734;6183;323;1369;830;2882;1153;4251
310060;201506;3261;10446;2869;9937;335;1237;2161;7549;2496;8786
310070;201506;334;956;261;822;28;118;151;434;179;552
310080;201506;734;2230;588;1962;122;518;199;595;321;1113
310090;201506;4756;14069;4087;12885;584;2056;2503;7840;3087;9896
310100;201506;3387;10262;2822;9304;211;870;2169;7101;2380;7971
310110;201506;5084;14252;4306;13043;706;2512;2560;7567;3266;10079
310120;201506;543;1690;453;1518;141;594;183;488;324;1082
310130;201506;434;1311;390;1246;83;310;215;642;298;952
310140;201506;202;668;167;605;63;271;39;110;102;381
310150;201506;4780;14613;4166;13446;973;3498;1727;5450;2700;8948
310160;201506;7437;23150;6078;20694;1754;6572;1688;5614;3442;12186
310163;201506;957;3088;799;2770;209;785;274;931;483;1716
310170;201506;9219;26117;8305;24816;1281;3995;5491;16792;6772;20787
310180;201506;1642;4775;1378;4363;321;1135;636;1924;957;3059
310190;201506;2732;9052;2483;8639;694;2623;378;1310;1072;3933
310200;201506;1885;6148;1564;5489;361;1429;562;1933;923;3362
310205;201506;1122;3255;878;2864;162;537;481;1592;643;2129
310210;201506;2677;7957;2433;7595;256;899;1850;5771;2106;6670
310220;201506;1052;3268;983;3156;184;665;569;1773;753;2438
310230;201506;2657;8345;2221;7395;498;1951;997;3086;1495;5037
310240;201506;1054;3665;905;3396;149;635;458;1787;607;2422
310250;201506;871;2923;840;2869;152;636;502;1601;654;2237
310260;201506;3394;10754;2706;9324;705;2757;831;2622;1536;5379
310270;201506;2511;7276;2144;6734;184;690;1630;5081;1814;5771
310280;201506;2291;6210;1933;5675;328;1160;1014;2812;1342;3972
310285;201506;2101;7473;1965;7268;230;925;1527;5747;1757;6672
310290;201506;1279;3888;1189;3758;310;1121;585;1681;895;2802
310300;201506;1798;6072;1698;5879;448;1753;920;3086;1368;4839
310310;201506;379;1026;269;808;42;126;125;380;167;506
310320;201506;394;1263;330;1135;51;228;155;513;206;741
310330;201506;509;1273;353;986;32;107;159;390;191;497
310340;201506;8516;25682;7047;23178;1376;4749;3689;12478;5065;17227
310350;201506;14711;39509;10700;32714;2852;9758;2999;8828;5851;18586
310360;201506;435;1320;413;1289;43;173;295;870;338;1043
310370;201506;1451;4931;1369;4792;390;1389;712;2529;1102;3918
310375;201506;1372;3635;891;2783;135;492;354;1063;489;1555
310380;201506;386;1048;285;896;101;348;100;286;201;634
310390;201506;513;1829;441;1672;117;493;71;224;188;717
310400;201506;10429;29549;7876;25043;1987;6902;1967;6179;3954;13081
310410;201506;839;2755;556;2254;152;675;111;439;263;1114
310420;201506;5969;16986;3716;12062;697;2516;580;1663;1277;4179
310430;201506;1501;4985;1179;4323;328;1330;237;823;565;2153
310440;201506;560;1597;448;1411;93;344;186;551;279;895
310445;201506;1265;4115;1047;3708;156;598;637;2247;793;2845
310450;201506;4757;13431;3830;12112;574;1930;2528;8160;3102;10090
310460;201506;1639;5077;1386;4671;408;1501;296;1052;704;2553
310470;201506;3571;8982;3006;8286;272;725;2472;6920;2744;7645
310480;201506;1223;3604;936;3036;192;734;390;1158;582;1892
310490;201506;2988;9775;2580;8968;693;2728;1008;3418;1701;6146
310500;201506;1321;4481;1184;4183;292;1162;482;1640;774;2802
310510;201506;2253;7091;1773;6016;483;1777;337;1079;820;2856
310520;201506;1426;3754;1119;3263;90;274;725;2117;815;2391
310530;201506;905;2805;528;1809;80;293;74;227;154;520
310540;201506;3215;10537;2921;10028;804;2901;1251;4309;2055;7210
310550;201506;1241;3584;1006;3190;247;959;452;1294;699;2253
310560;201506;15830;48337;13329;43425;3740;13657;4172;12698;7912;26355
310570;201506;1223;3632;1053;3345;157;580;727;2253;884;2833
310590;201506;4324;12569;3432;10872;591;2071;1417;4281;2008;6352
310600;201506;1452;4836;1308;4520;352;1409;459;1434;811;2843
310610;201506;487;1632;432;1513;100;446;144;436;244;882
310620;201506;174736;535082;143697;474510;35012;130664;53883;167440;88895;298104
310630;201506;4044;12396;3746;11895;452;1670;2705;8461;3157;10131
310640;201506;1362;4088;1072;3568;338;1219;267;818;605;2037
310650;201506;2752;8790;2211;7853;380;1456;1239;4433;1619;5889
310660;201506;1391;4177;1203;3916;147;497;850;2748;997;3245
310665;201506;1272;3877;1133;3681;138;497;836;2752;974;3249
310670;201506;47598;146842;42546;136111;11126;38261;16154;49919;27280;88180
310680;201506;717;2069;644;1959;137;454;361;1071;498;1525
310690;201506;1390;4521;1123;4035;284;1179;344;1150;628;2329
310700;201506;587;1516;454;1330;124;420;231;634;355;1054
310710;201506;6636;21607;5164;19090;1229;5364;1060;3552;2289;8916
310720;201506;784;2376;706;2236;147;533;371;1126;518;1659
310730;201506;9469;29454;8390;27650;1611;5830;4952;16234;6563;22064
310740;201506;4952;15931;3983;14001;1103;4329;946;3148;2049;7477
310750;201506;1562;3865;1194;3398;183;542;781;2195;964;2737
310760;201506;637;1917;531;1749;115;409;208;684;323;1093
310770;201506;829;2616;646;2328;153;627;268;886;421;1513
310780;201506;3830;10626;3261;9623;539;1597;1972;5813;2511;7410
310790;201506;1932;6146;1731;5786;450;1582;796;2761;1246;4343
310800;201506;2843;8956;2171;7639;694;2799;235;764;929;3563
310810;201506;1302;3631;1167;3402;210;684;630;1755;840;2439
310820;201506;1373;3907;1008;3226;234;833;275;826;509;1659
310825;201506;2503;8377;1973;7435;130;679;1425;5282;1555;5961
310830;201506;1386;4497;1080;3873;323;1230;273;914;596;2144
310840;201506;2234;6915;1806;6164;560;2113;511;1632;1071;3745
310850;201506;1568;4612;1292;4255;193;702;902;2970;1095;3672
310855;201506;2928;9281;2520;8648;463;1727;1581;5489;2044;7216
310860;201506;7813;23892;6595;21745;995;3523;3775;12650;4770;16173
310870;201506;1008;2806;806;2481;150;498;413;1265;563;1763
310880;201506;1242;3764;933;3183;179;725;442;1481;621;2206
310890;201506;2741;8396;2129;7333;527;2066;553;1736;1080;3802
310900;201506;4068;13009;3254;11257;801;3119;1044;3289;1845;6408
310910;201506;2095;5929;1378;4535;303;1122;245;712;548;1834
310920;201506;1933;5740;1528;5143;364;1401;682;2263;1046;3664
310925;201506;908;2970;813;2803;306;1162;294;979;600;2141
310930;201506;6004;17105;4790;15287;873;2993;2722;8897;3595;11890
310940;201506;6383;18204;5322;16562;970;3179;2847;8859;3817;12038
310945;201506;1342;3724;1095;3382;180;669;659;1954;839;2623
310950;201506;2026;6457;1511;5317;416;1697;387;1194;803;2891
310960;201506;414;1340;339;1200;104;397;110;391;214;788
310970;201506;1485;4999;1074;4005;300;1251;149;469;449;1720
310980;201506;517;1255;319;919;38;135;145;358;183;493
310990;201506;1181;3925;993;3528;249;993;290;934;539;1927
311000;201506;3654;12398;3243;11548;888;3627;1143;3780;2031;7407
311010;201506;773;2559;717;2459;229;859;320;1052;549;1911
311020;201506;954;2873;765;2535;177;660;308;946;485;1606
311030;201506;1709;4784;1218;3855;308;1111;414;1169;722;2280
311040;201506;490;1653;427;1487;93;340;98;327;191;667
311050;201506;2281;7208;1984;6702;532;1996;860;2908;1392;4904
311060;201506;2243;6769;1704;5608;372;1376;442;1354;814;2730
311070;201506;1486;5154;1302;4804;335;1438;488;1756;823;3194
311080;201506;901;2684;790;2478;132;452;424;1249;556;1701
311090;201506;1572;5810;1323;5289;420;1883;256;986;676;2869
311100;201506;2227;7506;1847;6696;719;2822;364;1281;1083;4103
311110;201506;3989;9314;2733;7549;428;1302;1460;3976;1888;5278
311115;201506;1203;3548;1011;3257;117;485;663;2090;780;2575
311120;201506;8041;22613;6231;19384;1562;5451;1651;4688;3213;10139
311130;201506;2113;6635;1786;6169;436;1822;771;2486;1207;4308
311140;201506;1392;3735;1118;3363;122;444;771;2267;893;2711
311150;201506;1956;6557;1786;6285;334;1287;1052;3712;1386;4999
311160;201506;4869;16300;4083;14877;1453;5758;1178;4178;2631;9936
311170;201506;788;2399;624;2097;82;285;313;1099;395;1384
311180;201506;1490;4171;1117;3455;334;1123;261;733;595;1856
311190;201506;1057;3149;900;2839;201;738;297;835;498;1573
311200;201506;2189;6659;1790;5825;542;1968;390;1111;932;3079
311205;201506;1093;3569;933;3249;178;704;398;1386;576;2090
311210;201506;959;3086;885;2977;166;555;607;2110;773;2665
311220;201506;906;2842;726;2451;178;648;253;838;431;1486
311230;201506;8404;26008;6793;22907;1327;4859;2944;10168;4271;15027
311240;201506;1177;3547;942;3156;247;931;304;969;551;1900
311250;201506;914;2963;811;2803;235;933;268;790;503;1723
311260;201506;2780;7415;2065;6227;531;1776;668;1958;1199;3734
311265;201506;1335;3651;1037;3174;183;657;574;1720;757;2377
311270;201506;3435;10913;2985;10299;405;1754;2038;6822;2443;8576
311280;201506;1331;3668;885;2764;185;669;263;776;448;1445
311290;201506;2122;7048;1970;6719;429;1474;1102;3833;1531;5307
311300;201506;4626;15269;4115;14380;542;2185;2778;9738;3320;11923
311310;201506;539;1866;488;1772;96;418;200;681;296;1099
311320;201506;4132;13678;3626;12566;751;2982;1265;4128;2016;7110
311330;201506;5002;14967;4288;13807;1279;4608;1753;5569;3032;10177
311340;201506;12519;39481;11002;36586;3257;11717;3217;10568;6474;22285
311350;201506;2298;6603;1818;5680;335;1231;807;2305;1142;3536
311360;201506;1226;3375;938;3001;391;1326;198;620;589;1946
311370;201506;3915;11782;3319;10747;755;2983;1435;4233;2190;7216
311380;201506;466;1485;387;1344;109;420;123;416;232;836
311390;201506;1866;6788;1721;6565;712;3112;536;1887;1248;4999
311400;201506;1503;4775;1282;4363;263;1069;577;1786;840;2855
311410;201506;1834;6313;1658;6079;463;1861;856;3193;1319;5054
311420;201506;2065;6720;1478;5286;363;1406;268;741;631;2147
311430;201506;4046;12144;2786;9331;525;1925;330;1009;855;2934
311440;201506;2394;7701;1792;6556;589;2525;334;1171;923;3696
311450;201506;2040;7050;1711;6276;463;1873;383;1283;846;3156
311455;201506;1291;3430;1055;3047;225;718;557;1510;782;2228
311460;201506;701;2264;537;1927;121;530;124;409;245;939
311470;201506;558;1767;441;1522;112;479;137;424;249;903
311480;201506;787;2080;735;2014;182;479;428;1169;610;1648
311490;201506;263;994;236;917;73;302;83;305;156;607
311500;201506;478;1391;381;1208;97;348;167;519;264;867
311510;201506;3140;9658;2553;8536;859;3390;587;1798;1446;5188
311520;201506;648;2154;594;2036;213;786;212;697;425;1483
311530;201506;12162;31423;8488;25280;2013;7180;2360;6786;4373;13966
311535;201506;841;2451;553;1868;121;472;91;293;212;765
311540;201506;646;2257;608;2204;226;832;267;952;493;1784
311545;201506;2120;6570;1933;6337;207;795;1406;4566;1613;5361
311547;201506;1565;4368;1300;3951;100;337;870;2654;970;2991
311550;201506;2999;9555;2512;8560;538;2096;836;2770;1374;4866
311560;201506;265;683;222;628;37;120;128;341;165;461
311570;201506;2236;5538;1736;4903;117;344;1351;3904;1468;4248
311580;201506;2398;4986;1848;4347;540;1197;984;2445;1524;3642
311590;201506;453;1405;389;1311;108;426;133;436;241;862
311600;201506;1226;3692;1046;3450;199;653;646;2193;845;2846
311610;201506;3123;10909;2803;10338;912;3335;1216;4735;2128;8070
311615;201506;3088;9516;2562;8674;269;1060;1788;6075;2057;7135
311620;201506;442;1380;390;1298;90;334;217;710;307;1044
311630;201506;1437;4168;1183;3722;267;823;646;2068;913;2891
311640;201506;836;2631;690;2382;129;492;394;1329;523;1821
311650;201506;2303;6755;1930;6134;254;881;1103;3584;1357;4465
311660;201506;2495;8340;2007;7217;419;1676;267;780;686;2456
311670;201506;1561;4651;1288;4171;427;1532;455;1440;882;2972
311680;201506;2117;6660;1797;6139;414;1500;958;3287;1372;4787
311690;201506;559;1418;447;1285;54;173;342;976;396;1149
311700;201506;2262;6149;1888;5637;127;516;1494;4338;1621;4854
311710;201506;1720;5167;1257;4297;465;1786;333;1085;798;2871
311720;201506;398;1331;355;1242;66;257;173;585;239;842
311730;201506;5828;14638;3393;10310;932;3340;983;2408;1915;5748
311740;201506;938;2637;802;2473;287;861;421;1343;708;2204
311750;201506;4028;13127;3479;12242;656;2601;1897;6536;2553;9137
311760;201506;807;2701;746;2562;200;807;307;930;507;1737
311770;201506;2457;7689;1998;6840;480;1851;597;1929;1077;3780
311780;201506;1143;4114;960;3676;303;1322;218;766;521;2088
311783;201506;1979;6442;1665;5842;110;522;1234;4296;1344;4818
311787;201506;564;1942;410;1481;77;304;86;246;163;550
311790;201506;1493;4448;1095;3665;261;978;307;962;568;1940
311800;201506;4149;14020;3285;11590;605;2246;192;559;797;2805
311810;201506;1058;3482;973;3314;62;291;710;2374;772;2665
311820;201506;661;2111;543;1823;148;550;257;810;405;1360
311830;201506;8179;27604;6745;24080;2325;8961;909;2927;3234;11888
311840;201506;3216;9578;2800;8973;792;2886;1276;3953;2068;6839
311850;201506;307;898;262;825;67;230;117;359;184;589
311860;201506;50733;150731;43146;137023;10026;35144;19712;60367;29738;95511
311870;201506;2318;6749;1756;5679;378;1431;551;1598;929;3029
311880;201506;6962;20191;6181;19233;853;2534;4342;14067;5195;16601
311890;201506;1481;4473;1207;3928;295;1071;473;1482;768;2553
311900;201506;767;2389;684;2283;119;403;430;1512;549;1915
311910;201506;4550;13336;3729;12153;945;3369;1551;5032;2496;8401
311920;201506;1948;6386;1700;5959;182;726;1100;3852;1282;4578
311930;201506;3846;11094;3277;10195;1192;3935;1010;3084;2202;7019
311940;201506;11917;35999;9709;31485;2681;9550;1956;5893;4637;15443
311950;201506;2330;6738;1911;6158;167;611;1332;4231;1499;4842
311960;201506;378;1173;336;1080;79;317;144;380;223;697
311970;201506;397;1358;328;1213;78;336;75;265;153;601
311980;201506;667;1857;449;1462;71;248;175;569;246;817
311990;201506;456;1331;378;1206;140;491;129;376;269;867
311995;201506;1165;3540;717;2446;73;266;92;231;165;497
312000;201506;664;2009;597;1906;90;322;365;1160;455;1482
312010;201506;964;3129;824;2818;150;593;345;1139;495;1732
312015;201506;1498;4706;1294;4355;158;650;819;2731;977;3381
312020;201506;917;2872;792;2670;168;637;412;1384;580;2021
312030;201506;1790;5292;1609;5066;125;464;1291;4004;1416;4468
312040;201506;717;2667;618;2395;170;740;130;473;300;1213
312050;201506;1473;5057;1260;4587;328;1335;233;776;561;2111
312060;201506;759;2295;664;2156;286;995;205;603;491;1598
312070;201506;1043;3200;682;2413;168;640;230;801;398;1441
312080;201506;2636;7367;2076;6478;351;1314;1059;3069;1410;4383
312083;201506;982;2766;839;2556;127;446;528;1574;655;2020
312087;201506;2221;6755;1958;6369;258;899;1365;4519;1623;5418
312090;201506;9099;28449;7990;26542;2259;8116;3235;10477;5494;18593
312100;201506;1393;4653;1171;4301;262;1077;568;2076;830;3153
312110;201506;1137;3967;986;3637;320;1349;186;603;506;1952
312120;201506;756;2514;657;2309;160;677;220;663;380;1340
312125;201506;1187;3753;1052;3503;232;815;533;1821;765;2636
312130;201506;810;2354;627;1981;94;345;251;742;345;1087
312140;201506;974;3060;802;2660;159;590;256;723;415;1313
312150;201506;564;1606;477;1414;27;92;311;877;338;969
312160;201506;7644;25943;6853;24310;1922;7505;2512;8797;4434;16302
312170;201506;1012;2899;872;2661;103;337;530;1613;633;1950
312180;201506;1429;4337;1249;3984;284;967;489;1485;773;2452
312190;201506;631;1997;470;1671;151;591;88;297;239;888
312200;201506;4907;14181;4178;13049;504;1648;2866;8942;3370;10590
312210;201506;1062;2879;813;2497;215;736;324;937;539;1673
312220;201506;1873;6254;1699;6054;166;613;1383;5104;1549;5717
312230;201506;13655;42476;10642;36540;3875;14676;1790;5908;5665;20584
312235;201506;1775;5110;1476;4662;164;659;966;2992;1130;3651
312240;201506;969;3190;786;2798;186;729;248;821;434;1550
312245;201506;2310;6789;1999;6383;115;369;1647;5305;1762;5674
312247;201506;843;2541;659;2211;168;622;313;1065;481;1687
312250;201506;1215;3371;949;2924;177;641;401;1174;578;1815
312260;201506;945;2974;784;2721;140;563;477;1628;617;2191
312270;201506;692;2082;574;1861;94;400;255;736;349;1136
312280;201506;404;1377;360;1279;130;494;54;182;184;676
312290;201506;765;2512;706;2424;222;898;222;728;444;1626
312300;201506;962;3186;768;2722;177;702;91;244;268;946
312310;201506;929;3480;852;3294;248;1054;319;1186;567;2240
312320;201506;2197;6214;1690;5196;411;1383;357;860;768;2243
312330;201506;1007;2990;845;2749;148;569;588;1880;736;2449
312340;201506;322;833;282;778;35;139;221;571;256;710
312350;201506;339;853;306;814;30;90;255;659;285;749
312352;201506;1694;5405;1524;5136;414;1395;872;3046;1286;4441
312360;201506;2854;9243;2346;8167;546;2133;711;2397;1257;4530
312370;201506;1764;5606;1593;5328;574;2154;515;1601;1089;3755
312380;201506;1896;5401;1683;5095;131;418;1359;4195;1490;4613
312385;201506;1303;3870;1132;3592;124;501;775;2366;899;2867
312390;201506;2122;6892;1711;5997;486;1816;308;988;794;2804
312400;201506;3352;10764;2839;9779;1001;3586;872;3116;1873;6702
312410;201506;10503;34489;9368;32312;2316;8851;3786;12690;6102;21541
312420;201506;4047;12453;3828;12190;548;1743;2795;9137;3343;10880
312430;201506;7609;23015;6797;21636;1168;3808;4334;13990;5502;17798
312440;201506;702;2235;623;2098;147;538;314;1106;461;1644
312450;201506;1159;3925;935;3447;347;1359;300;1098;647;2457
312460;201506;378;1138;337;1091;90;327;165;524;255;851
312470;201506;712;1936;456;1429;88;305;139;420;227;725
312480;201506;1271;3503;1003;3197;258;919;508;1530;766;2449
312490;201506;2112;5533;1639;4843;248;823;908;2568;1156;3391
312500;201506;694;2135;613;2015;106;438;333;1073;439;1511
312510;201506;3152;9290;2457;7845;430;1592;1166;3454;1596;5046
312520;201506;285;978;231;873;66;265;77;296;143;561
312530;201506;607;1825;543;1733;82;338;342;1029;424;1367
312540;201506;1477;4631;1149;3983;247;916;551;1890;798;2806
312550;201506;692;2132;592;1915;129;426;258;791;387;1217
312560;201506;2069;5534;1755;5128;126;417;1398;4069;1524;4486
312570;201506;2645;7805;2196;7021;648;2219;635;1942;1283;4161
312580;201506;547;1792;452;1596;88;387;164;535;252;922
312590;201506;1818;6035;1580;5534;348;1429;614;1978;962;3407
312595;201506;2096;7043;1867;6509;474;1768;910;3130;1384;4898
312600;201506;789;2579;620;2245;111;520;314;1040;425;1560
312610;201506;7317;20851;5472;17469;1355;4870;1324;3912;2679;8782
312620;201506;2048;5996;1613;5402;142;538;1209;4132;1351;4670
312630;201506;376;1226;333;1145;88;353;147;470;235;823
312640;201506;572;1832;456;1594;96;380;151;471;247;851
312650;201506;2211;6501;1593;5278;169;619;914;3022;1083;3641
312660;201506;1393;3712;1128;3334;123;425;768;2239;891;2664
312670;201506;5866;17535;5024;16340;1316;4786;1997;6290;3313;11076
312675;201506;1366;4336;1129;3845;152;604;669;2228;821;2832
312680;201506;1498;4639;1318;4374;215;805;766;2448;981;3253
312690;201506;2238;5913;1785;5284;326;1077;1018;2892;1344;3969
312695;201506;832;3014;797;2969;151;545;533;2068;684;2613
312700;201506;1962;5781;1519;4892;208;761;764;2409;972;3170
312705;201506;1367;3846;1138;3471;126;426;784;2367;910;2793
312707;201506;1723;5276;1342;4551;199;782;692;2267;891;3049
312710;201506;7219;18836;4776;14689;1295;4566;1045;2927;2340;7493
312720;201506;768;2612;666;2396;159;641;243;812;402;1453
312730;201506;1998;4841;1433;4178;209;702;774;2249;983;2951
312733;201506;1676;4468;1255;3677;89;342;854;2390;943;2732
312735;201506;898;2538;782;2381;204;699;422;1234;626;1933
312737;201506;907;2272;649;1906;211;619;265;803;476;1422
312738;201506;565;1689;408;1361;107;424;133;396;240;820
312740;201506;453;1240;300;1051;93;363;78;279;171;642
312750;201506;1262;4525;1205;4415;271;1191;588;2055;859;3246
312760;201506;2204;7018;1695;6007;433;1716;383;1321;816;3037
312770;201506;41862;115635;32988;100900;8826;29379;9799;29126;18625;58505
312780;201506;2747;9580;2454;9089;464;1900;1327;5020;1791;6920
312790;201506;339;874;197;625;49;191;48;109;97;300
312800;201506;5195;17031;4286;15182;1358;5211;1172;4156;2530;9367
312810;201506;2193;6699;1534;5419;402;1541;279;913;681;2454
312820;201506;2059;5951;1843;5604;165;611;1222;3606;1387;4217
312825;201506;1373;3736;1197;3517;105;341;950;2780;1055;3121
312830;201506;2745;8538;1913;6825;488;1901;332;1154;820;3055
312840;201506;1216;3915;1029;3568;131;578;565;1883;696;2461
312850;201506;652;2089;529;1856;89;387;182;621;271;1008
312860;201506;1154;3372;906;2934;236;899;256;706;492;1605
312870;201506;5598;17242;3938;13819;842;3310;916;3076;1758;6386
312880;201506;1311;3916;1134;3625;174;624;657;2121;831;2745
312890;201506;1623;4842;1101;3710;316;1210;361;1179;677;2389
312900;201506;1278;3822;1133;3617;193;651;768;2503;961;3154
312910;201506;1624;3351;1050;2606;190;566;560;1264;750;1830
312920;201506;879;2789;741;2564;194;774;331;1090;525;1864
312930;201506;2265;6545;1956;6096;439;1428;950;3026;1389;4454
312940;201506;929;3022;806;2812;231;926;216;703;447;1629
312950;201506;3344;9300;2576;8136;867;2973;723;2223;1590;5196
312960;201506;2057;5912;1772;5548;274;833;1284;4146;1558;4979
312965;201506;1795;5710;1520;5207;240;920;882;3034;1122;3954
312970;201506;1029;3472;849;3177;292;1268;145;481;437;1749
312980;201506;17450;58901;16364;56541;5237;19908;6440;21180;11677;41088
312990;201506;439;1332;329;1142;111;436;105;360;216;796
313000;201506;533;1758;431;1555;112;526;163;511;275;1037
313005;201506;2629;8420;2300;7832;466;1618;1288;4437;1754;6055
313010;201506;3785;12081;3212;11092;866;3319;1350;4542;2216;7861
313020;201506;955;3124;811;2830;215;872;239;715;454;1587
313030;201506;1501;4045;1113;3514;244;931;498;1495;742;2426
313040;201506;882;2961;751;2615;138;556;286;918;424;1474
313050;201506;1854;5856;1459;5250;396;1596;423;1382;819;2978
313055;201506;1620;5242;1477;5044;136;500;1122;3881;1258;4381
313060;201506;644;2103;511;1770;163;578;59;202;222;780
313065;201506;1957;6345;1686;5915;300;1174;1178;4123;1478;5297
313070;201506;1155;3351;943;2972;223;814;434;1270;657;2084
313080;201506;482;1512;383;1318;90;367;127;372;217;739
313090;201506;5378;15469;4656;14336;937;3062;2710;8409;3647;11471
313100;201506;1117;3462;1014;3292;107;368;776;2533;883;2901
313110;201506;1758;4988;1310;4126;271;961;519;1509;790;2470
313115;201506;2508;8509;2386;8264;590;2346;1174;3799;1764;6145
313120;201506;3587;9692;3035;8950;846;2727;1594;4528;2440;7255
313130;201506;24003;72721;20531;65541;5044;17795;7659;22959;12703;40754
313140;201506;709;1831;542;1582;38;139;366;1048;404;1187
313150;201506;1496;4712;1276;4297;508;1855;312;1017;820;2872
313160;201506;1063;3192;931;2953;161;603;548;1685;709;2288
313170;201506;7991;27531;6570;24148;1812;7193;1337;4750;3149;11943
313180;201506;2486;6738;1961;5999;540;1836;715;2104;1255;3940
313190;201506;3121;10983;2572;9500;587;2396;753;2585;1340;4981
313200;201506;1296;4207;1143;3932;160;638;769;2611;929;3249
313210;201506;4535;13781;3748;12682;862;3306;1749;5669;2611;8975
313220;201506;1334;4024;982;3253;252;927;224;641;476;1568
313230;201506;2322;8309;2142;8039;332;1332;1448;5461;1780;6793
313240;201506;7945;24805;6398;22050;1488;5917;2491;8224;3979;14141
313250;201506;7217;22563;6363;21114;991;3429;3747;12587;4738;16016
313260;201506;625;1854;465;1527;79;300;117;344;196;644
313270;201506;5495;16254;4671;14897;843;2908;2703;8585;3546;11493
313280;201506;438;1448;332;1205;55;240;89;281;144;521
313290;201506;928;3249;763;2943;247;1044;143;480;390;1524
313300;201506;1915;6408;1577;5590;454;1757;249;764;703;2521
313310;201506;1145;3954;1011;3671;256;1052;190;615;446;1667
313320;201506;2485;7217;1911;6281;376;1361;827;2713;1203;4074
313330;201506;3839;12149;3214;11024;562;2223;1737;5844;2299;8067
313340;201506;2052;4962;1580;4273;317;882;864;2292;1181;3174
313350;201506;3267;10040;2527;8462;561;2093;484;1428;1045;3521
313360;201506;1247;3638;937;3116;256;1008;455;1405;711;2413
313370;201506;1203;4083;1112;3835;170;710;591;1904;761;2614
313375;201506;2245;5857;1510;4756;293;1152;517;1572;810;2724
313380;201506;5089;16108;4205;14271;1122;4246;1398;4465;2520;8711
313390;201506;912;3176;865;3108;107;437;580;2071;687;2508
313400;201506;3741;10337;3338;9880;242;693;2831;8549;3073;9242
313410;201506;1268;3607;1058;3309;222;780;604;1869;826;2649
313420;201506;20377;48432;12358;34807;2428;7692;2467;6602;4895;14294
313430;201506;1124;3496;872;2968;184;744;347;1092;531;1836
313440;201506;6398;14557;4378;12194;346;1083;2977;8280;3323;9363
313450;201506;684;1997;543;1716;121;474;188;530;309;1004
313460;201506;2293;7873;2013;7402;569;2361;599;2041;1168;4402
313470;201506;3261;9089;3029;8818;315;833;2463;7276;2778;8109
313480;201506;1125;3227;869;2787;138;526;364;1090;502;1616
313490;201506;1523;4652;966;3708;341;1397;140;520;481;1917
313500;201506;405;1264;359;1155;71;269;159;476;230;745
313505;201506;9063;26997;8377;26209;377;798;7683;24696;8060;25494
313507;201506;1390;3901;1210;3655;172;598;787;2388;959;2986
313510;201506;15578;44733;13532;41841;2208;7032;8210;25931;10418;32963
313520;201506;15226;45950;12547;41353;1607;6123;7929;25765;9536;31888
313530;201506;638;2031;519;1807;65;272;178;577;243;849
313535;201506;2560;7589;2237;7027;214;737;1598;4942;1812;5679
313540;201506;1071;3361;821;2716;225;813;197;583;422;1396
313545;201506;1298;4775;1170;4506;152;764;726;2634;878;3398
313550;201506;1886;6059;1662;5617;438;1565;772;2530;1210;4095
313560;201506;2240;5418;1883;5013;294;723;1351;3740;1645;4463
313570;201506;842;3024;728;2800;248;1020;247;929;495;1949
313580;201506;5995;16928;4941;15473;807;2727;3114;9828;3921;12555
313590;201506;1033;2936;793;2624;398;1435;214;678;612;2113
313600;201506;4035;12141;3491;11296;545;1944;2212;7228;2757;9172
313610;201506;1052;3210;896;2902;190;677;420;1330;610;2007
313620;201506;6056;18919;5257;17482;1552;5560;1808;5896;3360;11456
313630;201506;8246;23583;6376;20770;1311;4840;2799;9442;4110;14282
313640;201506;827;2450;638;2157;191;734;205;663;396;1397
313650;201506;2120;6866;1849;6427;271;1083;1234;4222;1505;5305
313652;201506;1011;3603;924;3437;162;669;553;2040;715;2709
313655;201506;954;3090;795;2820;136;593;457;1566;593;2159
313657;201506;1302;3982;1105;3674;116;525;799;2447;915;2972
313660;201506;866;2872;786;2731;171;703;379;1244;550;1947
313665;201506;3442;11217;3111;10508;696;2692;1457;4700;2153;7392
313670;201506;51644;145007;35197;116660;9319;34173;10249;33076;19568;67249
313680;201506;1110;3316;958;3076;158;562;601;1889;759;2451
313690;201506;904;3255;798;3012;226;895;289;1095;515;1990
313695;201506;1364;4498;1183;4170;127;501;819;2920;946;3421
313700;201506;3832;12674;3204;11853;537;2080;2149;8149;2686;10229
313710;201506;1311;3561;1024;3129;233;774;499;1474;732;2248
313720;201506;5249;17104;4269;14952;902;3560;1371;4416;2273;7976
313730;201506;1348;3580;1012;3163;196;677;548;1706;744;2383
313740;201506;2147;7682;1798;6821;548;2350;177;581;725;2931
313750;201506;2438;7370;2055;6649;566;2003;660;1979;1226;3982
313753;201506;1847;5448;1467;4781;384;1385;545;1739;929;3124
313760;201506;4465;14420;3688;12863;1059;4053;1018;3286;2077;7339
313770;201506;3476;11442;3172;10896;986;3665;1225;4071;2211;7736
313780;201506;3742;10362;2938;9158;509;1917;1333;4090;1842;6007
313790;201506;514;1767;490;1728;107;374;271;998;378;1372
313800;201506;1215;3354;1057;3111;135;453;687;2027;822;2480
313810;201506;1524;4449;1471;4377;81;232;1281;3897;1362;4129
313820;201506;13355;35676;10847;31649;1842;6395;5305;14880;7147;21275
313830;201506;421;1401;360;1273;96;393;114;393;210;786
313835;201506;927;3086;864;2991;167;654;498;1661;665;2315
313840;201506;7784;22352;6077;19433;1574;5599;1640;5072;3214;10671
313850;201506;1247;3383;1087;3100;237;812;546;1423;783;2235
313860;201506;2862;8638;2200;7193;543;1943;505;1572;1048;3515
313862;201506;1227;3078;807;2378;127;375;352;1066;479;1441
313865;201506;2285;7049;2062;6705;251;950;1468;4715;1719;5665
313867;201506;1121;3807;957;3466;328;1280;317;1176;645;2456
313868;201506;1610;5587;1405;5166;148;651;932;3398;1080;4049
313870;201506;864;2708;780;2570;230;883;236;671;466;1554
313880;201506;1656;5122;1471;4900;274;1126;903;2839;1177;3965
313890;201506;1894;5183;1580;4759;247;731;1045;3267;1292;3998
313900;201506;4236;15378;3838;14470;1199;5109;1129;4082;2328;9191
313910;201506;780;2614;662;2378;240;945;101;335;341;1280
313920;201506;3520;11476;3030;10589;498;1859;1782;6358;2280;8217
313925;201506;1922;5139;1394;4150;97;325;883;2616;980;2941
313930;201506;5324;17313;4368;15596;771;2947;2316;8432;3087;11379
313940;201506;8408;28107;7055;25908;2210;8949;2366;9030;4576;17979
313950;201506;4241;12149;3366;10705;1007;3720;1130;3180;2137;6900
313960;201506;5849;15137;4303;13008;1322;4428;1174;3314;2496;7742
313970;201506;1468;4212;1266;3981;147;521;814;2654;961;3175
313980;201506;1277;4025;1007;3542;282;1150;389;1355;671;2505
313990;201506;1896;7071;1633;6444;535;2338;375;1337;910;3675
314000;201506;7701;25088;6996;23735;1393;5668;3957;12785;5350;18453
314010;201506;1121;3183;919;2920;120;452;586;1812;706;2264
314015;201506;1303;4619;1126;4265;332;1357;378;1363;710;2720
314020;201506;526;1624;400;1353;101;389;99;302;200;691
314030;201506;875;2813;685;2383;107;419;238;808;345;1227
314040;201506;672;1911;555;1704;262;825;155;490;417;1315
314050;201506;1831;5670;1450;4902;344;1335;473;1441;817;2776
314053;201506;1540;4933;1388;4744;196;664;947;3388;1143;4052
314055;201506;2169;6544;1947;6215;105;414;1529;4933;1634;5347
314060;201506;1158;3560;917;3139;82;351;570;1906;652;2257
314070;201506;3898;12049;2985;10284;798;2959;699;2314;1497;5273
314080;201506;1910;5891;1266;4373;237;914;271;808;508;1722
314085;201506;1990;6666;1724;6299;480;1951;648;2328;1128;4279
314090;201506;3441;11719;3024;10913;835;3344;1097;4011;1932;7355
314100;201506;3446;8937;2923;8225;247;610;2386;6927;2633;7537
314110;201506;4306;13686;3762;12573;758;2971;1527;4685;2285;7656
314120;201506;1039;2514;537;1702;134;479;134;410;268;889
314130;201506;716;2051;379;1295;60;223;73;247;133;470
314140;201506;5030;15579;4239;14050;925;3301;1781;5821;2706;9122
314150;201506;1646;4494;1337;3981;231;795;689;2009;920;2804
314160;201506;2540;6598;1996;5876;182;611;1343;4076;1525;4687
314170;201506;1115;3364;908;2908;127;463;469;1436;596;1899
314180;201506;5784;18245;5018;17115;1284;4828;2308;8012;3592;12840
314190;201506;752;2189;603;1955;139;559;243;715;382;1274
314200;201506;3036;9549;2649;8848;316;1288;1785;5819;2101;7107
314210;201506;1987;5894;1765;5499;241;896;1104;3287;1345;4183
314220;201506;1732;5460;1367;4729;416;1616;286;853;702;2469
314225;201506;1325;3875;1167;3663;75;237;989;3151;1064;3388
314230;201506;665;2216;601;2095;146;574;251;844;397;1418
314240;201506;1162;3554;985;3291;157;526;597;2089;754;2615
314250;201506;557;1657;423;1379;92;340;140;400;232;740
314260;201506;1111;3949;1010;3728;291;1180;340;1206;631;2386
314270;201506;2915;9512;2500;8774;267;1073;1671;5907;1938;6980
314280;201506;3253;9035;2204;7006;546;2013;691;1902;1237;3915
314290;201506;5048;13915;4319;12741;1139;3564;2324;6755;3463;10319
314300;201506;1658;5502;1437;5001;399;1488;493;1637;892;3125
314310;201506;5621;16995;4803;15432;1447;5079;1532;4672;2979;9751
314315;201506;902;3498;832;3362;128;611;522;2119;650;2730
314320;201506;3193;8852;2353;7754;656;2417;1168;3889;1824;6306
314330;201506;53779;164333;47445;154130;13358;47333;18209;58233;31567;105566
314340;201506;2801;7684;1568;5206;355;1274;116;248;471;1522
314345;201506;1242;4215;1111;4008;289;1095;622;2257;911;3352
314350;201506;1402;4075;1118;3615;426;1524;276;835;702;2359
314360;201506;712;2212;469;1657;93;385;110;367;203;752
314370;201506;533;1865;492;1799;153;610;265;958;418;1568
314380;201506;1282;3838;882;3046;242;910;150;501;392;1411
314390;201506;14819;42853;11263;36192;2803;9825;2895;8585;5698;18410
314400;201506;4764;13857;3973;12741;1421;4749;1539;5093;2960;9842
314410;201506;2646;8319;2223;7474;620;2434;774;2420;1394;4854
314420;201506;754;2175;600;1953;50;227;412;1286;462;1513
314430;201506;6978;20732;6074;19012;1810;6222;1850;5802;3660;12024
314435;201506;1357;4346;1198;4063;129;559;752;2513;881;3072
314437;201506;1139;2947;956;2666;39;108;778;2158;817;2266
314440;201506;668;1940;501;1692;171;645;88;268;259;913
314450;201506;1602;4674;1349;4320;365;1381;618;1846;983;3227
314460;201506;4414;14820;3614;13109;950;3839;694;2385;1644;6224
314465;201506;2370;7411;2162;7067;141;604;1665;5330;1806;5934
314467;201506;1110;3099;927;2773;102;290;626;1906;728;2196
314470;201506;2474;7878;1990;6804;444;1785;546;1612;990;3397
314480;201506;6296;20838;4302;15501;680;2668;469;1432;1149;4100
314490;201506;989;2908;783;2499;202;714;315;943;517;1657
314500;201506;2173;6064;1592;5058;430;1471;647;1995;1077;3466
314505;201506;1890;5639;1763;5442;319;1096;1101;3402;1420;4498
314510;201506;1955;5343;1323;4437;445;1653;326;1060;771;2713
314520;201506;3414;12423;2671;10603;660;2981;401;1342;1061;4323
314530;201506;6562;23155;6173;22505;1161;4214;3653;13759;4814;17973
314535;201506;2806;7836;2413;7288;238;824;1829;5490;2067;6314
314537;201506;1252;3887;982;3410;160;668;544;1854;704;2522
314540;201506;430;1294;362;1151;85;309;120;340;205;649
314545;201506;1383;4253;1197;3975;178;681;780;2584;958;3265
314550;201506;630;1742;469;1523;90;382;196;582;286;964
314560;201506;5009;17349;4265;15517;871;3573;1198;4158;2069;7731
314570;201506;304;897;228;738;58;204;106;330;164;534
314580;201506;522;1761;417;1522;107;461;76;246;183;707
314585;201506;856;2805;612;2275;151;639;167;606;318;1245
314587;201506;1884;5873;1645;5453;358;1125;793;2742;1151;3867
314590;201506;3470;11748;2436;8965;435;1772;297;946;732;2718
314600;201506;2042;6798;1581;5882;489;2035;260;902;749;2937
314610;201506;7507;25726;6768;23993;1714;6882;2630;8747;4344;15629
314620;201506;1762;5104;1540;4819;174;503;1176;3770;1350;4273
314625;201506;1495;5094;1427;4974;189;769;1059;3582;1248;4351
314630;201506;5024;14849;4324;13751;341;1307;3229;10233;3570;11540
314640;201506;613;1687;472;1446;114;386;145;377;259;763
314650;201506;1212;3412;865;2803;164;636;330;955;494;1591
314655;201506;1626;4813;1201;3977;280;914;460;1530;740;2444
314660;201506;263;721;201;606;20;70;106;305;126;375
314670;201506;1625;4403;1268;3806;199;667;765;2294;964;2961
314675;201506;1804;5541;1537;5067;145;577;1059;3476;1204;4053
314690;201506;2545;8008;2082;7184;570;2278;526;1670;1096;3948
314700;201506;8910;31204;6827;26496;2188;9536;1193;4512;3381;14048
314710;201506;9248;28366;6407;22086;1260;4846;948;2965;2208;7811
314720;201506;2394;7851;2002;7024;497;1964;761;2610;1258;4574
314730;201506;2428;7264;1961;6579;575;2156;659;2111;1234;4267
314740;201506;3003;9637;2624;8907;600;2316;1097;3533;1697;5849
314750;201506;343;1077;287;948;46;178;137;427;183;605
314760;201506;1749;5872;1282;4702;224;946;266;833;490;1779
314770;201506;1204;3779;699;2378;77;318;105;267;182;585
314780;201506;315;820;220;693;56;206;96;294;152;500
314790;201506;12509;37005;9222;31242;3810;14735;1301;3834;5111;18569
314795;201506;1648;4749;1392;4339;135;556;1027;3046;1162;3602
314800;201506;12798;37178;9230;30077;2757;9814;1351;4154;4108;13968
314810;201506;13162;38439;10209;33264;3066;11134;2288;7373;5354;18507
314820;201506;1041;2829;699;2284;187;683;232;717;419;1400
314830;201506;1782;5862;1524;5427;492;1940;596;2131;1088;4071
314840;201506;1009;3644;824;3361;184;898;445;1777;629;2675
314850;201506;1989;5821;1606;5117;236;934;984;3003;1220;3937
314860;201506;3303;11097;2967;10511;656;2539;1601;5690;2257;8229
314870;201506;5559;17739;4880;16831;595;2421;3525;12177;4120;14598
314875;201506;1749;5841;1669;5721;319;1059;1213;4265;1532;5324
314880;201506;862;2391;739;2232;56;172;542;1700;598;1872
314890;201506;633;1898;433;1470;96;392;144;427;240;819
314900;201506;488;1483;389;1327;97;347;184;619;281;966
314910;201506;1656;5505;1360;5005;441;1837;400;1362;841;3199
314915;201506;2588;8078;2246;7572;200;809;1671;5534;1871;6343
314920;201506;599;1671;427;1407;67;263;220;667;287;930
314930;201506;5069;17044;4435;15662;1308;5050;1066;3661;2374;8711
314940;201506;404;1173;369;1112;79;261;189;539;268;800
314950;201506;344;1073;272;948;58;215;73;244;131;459
314960;201506;815;2538;632;2168;170;653;161;493;331;1146
314970;201506;530;1785;449;1646;103;440;123;432;226;872
314980;201506;1804;5573;1526;5082;469;1765;177;507;646;2272
314990;201506;2781;8764;2149;7382;628;2490;408;1175;1036;3665
314995;201506;1632;5050;1441;4755;179;712;950;3035;1129;3747
315000;201506;1066;3123;874;2805;125;479;539;1703;664;2182
315010;201506;467;1447;373;1249;100;401;135;386;235;787
315015;201506;2032;6259;1815;5999;256;869;1311;4518;1567;5387
315020;201506;809;2512;611;2076;105;408;289;943;394;1351
315030;201506;771;2312;620;2027;195;695;151;480;346;1175
315040;201506;892;2797;837;2683;157;534;513;1616;670;2150
315050;201506;1518;4373;1204;3859;278;1034;469;1445;747;2479
315053;201506;1090;3243;956;3013;166;650;442;1374;608;2024
315057;201506;1903;6365;1567;5849;287;1078;887;3438;1174;4516
315060;201506;905;2961;668;2437;161;656;149;545;310;1201
315070;201506;775;2319;677;2175;179;634;329;998;508;1632
315080;201506;3067;10377;2714;9627;616;2396;1304;4574;1920;6970
315090;201506;782;2802;691;2609;172;726;224;840;396;1566
315100;201506;1229;4135;912;3393;216;939;210;688;426;1627
315110;201506;1428;4415;1248;4061;299;1065;531;1703;830;2768
315120;201506;14598;34122;9923;28108;1607;4790;5192;15518;6799;20308
315130;201506;1522;4995;1357;4667;382;1478;411;1346;793;2824
315140;201506;2812;9251;2369;8325;612;2512;762;2383;1374;4895
315150;201506;4986;13477;3696;11301;777;2717;1367;4018;2144;6735
315160;201506;1319;3745;1110;3360;210;696;573;1661;783;2357
315170;201506;1458;4291;1211;3924;217;749;626;2207;843;2956
315180;201506;17012;48397;10066;33465;1962;7436;1828;5493;3790;12929
315190;201506;2188;5837;1837;5304;502;1536;923;2674;1425;4210
315200;201506;4257;14181;3491;12496;1020;4052;886;3025;1906;7077
315210;201506;8201;24063;6535;20733;1603;5654;2214;6708;3817;12362
315213;201506;1110;3576;1045;3488;68;221;887;3001;955;3222
315217;201506;2648;8990;2191;8200;311;1382;1279;4787;1590;6169
315220;201506;10027;29037;8368;26518;2345;7333;4044;13366;6389;20699
315230;201506;2748;7364;2458;7021;219;399;1954;6023;2173;6422
315240;201506;3114;9734;2728;9131;595;2190;1567;5145;2162;7335
315250;201506;10135;31060;7470;25942;2011;7842;2255;7777;4266;15619
315260;201506;1010;3170;738;2567;184;708;134;410;318;1118
315270;201506;727;2406;581;2105;134;544;149;487;283;1031
315280;201506;3240;9430;2226;7233;565;2017;472;1327;1037;3344
315290;201506;1387;3890;1028;3302;350;1218;159;489;509;1707
315300;201506;533;1382;364;1177;169;575;122;393;291;968
315310;201506;1290;4159;1089;3780;139;590;687;2279;826;2869
315320;201506;854;2654;688;2432;144;577;313;1140;457;1717
315330;201506;692;2496;436;1804;123;566;48;208;171;774
315340;201506;4018;11436;3268;10265;715;2525;1369;4184;2084;6709
315350;201506;1796;5015;1336;4340;251;850;735;2457;986;3307
315360;201506;1696;5607;1361;4752;269;1025;443;1434;712;2459
315370;201506;502;1494;429;1381;101;364;236;761;337;1125
315380;201506;222;764;175;652;46;194;32;96;78;290
315390;201506;1424;4896;1144;4248;323;1363;218;732;541;2095
315400;201506;4332;13095;3581;11650;769;2811;1609;5095;2378;7906
315410;201506;1986;5309;1666;4850;229;809;1060;3037;1289;3846
315415;201506;1138;3748;1039;3602;388;1368;445;1620;833;2988
315420;201506;1238;3973;940;3360;251;951;162;556;413;1507
315430;201506;3941;10636;2896;8881;727;2540;721;2086;1448;4626
315440;201506;911;2838;778;2604;138;527;404;1337;542;1864
315445;201506;2132;5973;1719;5381;192;734;1247;3844;1439;4578
315450;201506;2425;7734;2203;7399;476;1524;1342;4687;1818;6211
315460;201506;36750;120569;32492;111634;10628;39236;6989;22898;17617;62134
315470;201506;532;1582;444;1430;57;226;250;777;307;1003
315480;201506;1742;5290;1083;3773;210;828;184;607;394;1435
315490;201506;3169;8600;2481;7634;354;1288;1199;3578;1553;4866
315500;201506;473;1441;314;1067;51;207;114;325;165;532
315510;201506;1453;4113;1233;3774;81;283;935;2846;1016;3129
315520;201506;1120;3313;889;2995;132;499;551;1804;683;2303
315530;201506;565;1942;491;1767;207;807;139;458;346;1265
315540;201506;1211;3719;989;3332;198;807;333;1094;531;1901
315550;201506;1748;4924;1361;4401;441;1607;440;1375;881;2982
315560;201506;6740;22262;6082;21359;683;2740;4202;14823;4885;17563
315570;201506;2123;6644;1957;6386;392;1443;1070;3426;1462;4869
315580;201506;2592;7614;2024;6586;499;1880;624;1875;1123;3755
315590;201506;946;2737;843;2583;148;519;487;1438;635;1957
315600;201506;2572;9075;2092;8190;378;1566;1133;4626;1511;6192
315610;201506;1031;2968;835;2562;163;635;316;819;479;1454
315620;201506;319;1119;302;1089;87;299;160;610;247;909
315630;201506;932;2942;778;2656;184;683;207;673;391;1356
315640;201506;617;1790;500;1587;107;402;224;657;331;1059
315645;201506;884;2745;749;2455;278;984;190;596;468;1580
315650;201506;1917;5349;1592;4885;102;432;1196;3612;1298;4044
315660;201506;2611;6870;2201;6229;435;1228;1290;3664;1725;4892
315670;201506;10229;34262;9020;31927;2790;10717;3005;10436;5795;21153
315680;201506;3077;10336;2454;9057;872;3398;415;1515;1287;4913
315690;201506;3617;10344;2556;8422;691;2548;558;1840;1249;4388
315700;201506;7351;22971;6225;20732;1174;4466;2967;9474;4141;13940
315710;201506;1996;5694;1579;5038;162;637;959;3006;1121;3643
315720;201506;3453;10807;3044;10055;655;2529;1523;4786;2178;7315
315725;201506;1713;5146;1383;4709;394;1376;710;2470;1104;3846
315727;201506;640;1956;533;1736;117;423;224;697;341;1120
315730;201506;886;2708;798;2548;142;507;447;1399;589;1906
315733;201506;958;2942;864;2764;299;1034;261;788;560;1822
315737;201506;1350;4092;1046;3533;98;392;660;2254;758;2646
315740;201506;1076;3330;903;2983;172;692;458;1419;630;2111
315750;201506;1141;3543;1042;3373;84;315;771;2478;855;2793
315760;201506;1018;2767;979;2718;27;90;894;2476;921;2566
315765;201506;1436;4505;1310;4325;93;332;1048;3504;1141;3836
315770;201506;1630;5245;1432;4864;366;1393;445;1426;811;2819
315780;201506;23634;76993;21421;72250;6157;22300;6271;20872;12428;43172
315790;201506;3490;11751;3081;10931;351;1193;2051;7518;2402;8711
315800;201506;1547;5972;1257;5131;306;1400;242;946;548;2346
315810;201506;1436;4003;1228;3679;167;500;827;2460;994;2960
315820;201506;2683;9033;2372;8512;739;2732;1036;3837;1775;6569
315830;201506;1259;4217;1069;3795;156;692;330;1013;486;1705
315840;201506;838;2186;602;1778;96;313;193;531;289;844
315850;201506;1198;4270;1148;4167;282;1069;514;1822;796;2891
315860;201506;516;1793;394;1536;96;436;64;231;160;667
315870;201506;481;1432;398;1299;113;403;137;405;250;808
315880;201506;1164;3090;934;2791;209;742;336;929;545;1671
315890;201506;1571;5340;1381;5033;509;1965;615;2238;1124;4203
315895;201506;5148;15840;4617;14745;1061;3798;1948;5945;3009;9743
315900;201506;751;2338;722;2280;95;396;523;1527;618;1923
315910;201506;552;1867;513;1797;165;628;277;943;442;1571
315920;201506;1598;4442;979;3132;231;816;210;566;441;1382
315930;201506;1118;3057;860;2609;215;731;236;680;451;1411
315935;201506;1077;3579;967;3329;260;979;292;987;552;1966
315940;201506;677;2118;591;1945;150;571;254;787;404;1358
315950;201506;1178;3596;1066;3400;215;662;667;2173;882;2835
315960;201506;3029;9721;2182;8074;921;3914;113;290;1034;4204
315970;201506;789;2167;616;1921;56;159;445;1452;501;1611
315980;201506;4356;10542;2695;7750;685;2270;695;1660;1380;3930
315990;201506;4043;11797;3428;10829;624;2385;1829;5644;2453;8029
316000;201506;570;1728;485;1606;158;625;176;558;334;1183
316010;201506;564;1919;467;1725;95;419;168;545;263;964
316020;201506;1121;3609;932;3296;153;640;541;1908;694;2548
316030;201506;3676;10433;2654;8676;330;1191;1399;4728;1729;5919
316040;201506;3707;11694;2736;9605;456;1861;432;1173;888;3034
316045;201506;2147;6645;1947;6313;298;938;1337;4490;1635;5428
316050;201506;350;1106;278;992;53;200;146;500;199;700
316060;201506;754;2232;603;2008;92;412;340;1049;432;1461
316070;201506;5994;19076;5174;17218;1250;4667;2121;6704;3371;11371
316080;201506;753;2765;673;2562;155;674;104;394;259;1068
316090;201506;610;1799;399;1338;83;323;96;278;179;601
316095;201506;1435;4591;1241;4242;251;860;726;2536;977;3396
316100;201506;2851;9422;2122;7566;536;2194;382;1217;918;3411
316105;201506;968;2700;725;2302;194;670;274;874;468;1544
316110;201506;12217;42021;10917;39730;1386;5487;7303;27239;8689;32726
316120;201506;1206;3943;985;3391;268;998;295;927;563;1925
316130;201506;1479;3293;899;2480;139;449;465;1218;604;1667
316140;201506;1071;3120;817;2700;115;407;449;1501;564;1908
316150;201506;1500;4260;1363;4028;265;919;795;2330;1060;3249
316160;201506;1246;3709;967;3161;159;606;446;1435;605;2041
316165;201506;985;2649;811;2396;152;532;458;1324;610;1856
316170;201506;1421;4062;1067;3458;190;699;458;1389;648;2088
316180;201506;1407;4437;998;3522;250;1012;204;609;454;1621
316190;201506;2828;8799;1435;5053;288;1052;190;566;478;1618
316200;201506;4061;12969;3119;11097;750;3097;848;2880;1598;5977
316210;201506;4992;15894;4263;14518;1752;6326;728;2361;2480;8687
316220;201506;768;2375;541;1921;121;504;68;245;189;749
316225;201506;1190;3383;1027;3134;134;493;689;2022;823;2515
316230;201506;459;1300;356;1126;64;226;173;570;237;796
316240;201506;6843;20830;5866;19557;628;2157;4372;14747;5000;16904
316245;201506;3217;11153;2967;10740;237;1126;2308;8183;2545;9309
316250;201506;10104;30401;8318;26798;2588;9096;2342;7129;4930;16225
316255;201506;2603;7904;2277;7500;427;1477;1461;4823;1888;6300
316257;201506;1414;3956;1076;3354;216;765;403;1190;619;1955
316260;201506;1815;5131;1384;4490;142;519;823;2792;965;3311
316265;201506;1327;3684;968;2965;107;407;557;1622;664;2029
316270;201506;4343;14354;3976;13603;1000;3736;1772;5930;2772;9666
316280;201506;3336;10853;2989;10188;504;1925;1671;5650;2175;7575
316290;201506;3311;10432;2820;9481;584;2345;1194;3790;1778;6135
316292;201506;3429;11069;3075;10455;704;2648;1540;5004;2244;7652
316294;201506;874;2802;606;2194;129;557;58;191;187;748
316295;201506;1856;6306;1715;6023;312;1352;991;3245;1303;4597
316300;201506;1015;3117;856;2853;74;257;566;1919;640;2176
316310;201506;709;2108;497;1704;91;358;151;495;242;853
316320;201506;600;1910;483;1714;86;355;105;357;191;712
316330;201506;972;2974;760;2500;103;371;465;1496;568;1867
316340;201506;1010;3247;841;2904;216;891;314;984;530;1875
316350;201506;1404;4458;1248;4206;221;765;695;2409;916;3174
316360;201506;748;1956;582;1716;65;209;417;1218;482;1427
316370;201506;4489;14671;3882;13420;1124;4248;715;2480;1839;6728
316380;201506;1587;4280;1269;3835;102;340;898;2729;1000;3069
316390;201506;896;2656;746;2396;213;755;309;1001;522;1756
316400;201506;1360;4281;1081;3776;247;941;433;1468;680;2409
316410;201506;1098;3652;1018;3528;200;745;621;2153;821;2898
316420;201506;1898;6288;1698;6017;183;826;1146;3937;1329;4763
316430;201506;940;2873;709;2419;192;719;187;569;379;1288
316440;201506;700;2257;570;2058;216;901;132;457;348;1358
316443;201506;727;2129;595;1878;146;512;219;647;365;1159
316447;201506;1588;4843;1449;4650;96;295;1264;4113;1360;4408
316450;201506;2166;7312;1857;6720;274;1082;1184;4359;1458;5441
316460;201506;773;2408;704;2289;175;641;403;1236;578;1877
316470;201506;7607;24531;5994;21040;1563;6432;1737;5768;3300;12200
316480;201506;220;741;196;699;47;184;60;197;107;381
316490;201506;298;929;264;843;59;199;119;350;178;549
316500;201506;1103;3985;755;2914;140;588;32;109;172;697
316510;201506;849;3095;748;2888;258;1049;175;651;433;1700
316520;201506;1174;3553;964;3241;184;694;358;1072;542;1766
316530;201506;1134;3674;951;3300;222;959;352;1034;574;1993
316540;201506;1006;3246;906;3080;195;819;358;1127;553;1946
316550;201506;1219;4063;1137;3924;241;933;699;2401;940;3334
316553;201506;2020;7121;1591;6075;473;1991;353;1315;826;3306
316555;201506;2927;9953;2529;9488;214;823;1920;7308;2134;8131
316556;201506;613;1657;483;1426;44;167;336;943;380;1110
316557;201506;765;2778;729;2723;308;1240;169;570;477;1810
316560;201506;350;1204;300;1102;67;307;69;210;136;517
316570;201506;1379;4373;1208;4022;172;627;620;2056;792;2683
316580;201506;288;842;199;650;50;201;61;182;111;383
316590;201506;1522;4142;1107;3451;262;869;502;1449;764;2318
316600;201506;1031;3318;901;3057;297;1065;259;856;556;1921
316610;201506;600;2157;521;1999;106;460;312;1177;418;1637
316620;201506;2180;6728;1855;6121;359;1366;1048;3362;1407;4728
316630;201506;1567;5179;1346;4703;543;2002;375;1317;918;3319
316640;201506;195;613;168;555;33;142;71;197;104;339
316650;201506;919;3442;804;3257;168;691;450;1915;618;2606
316660;201506;210;547;108;327;13;54;29;68;42;122
316670;201506;1834;5315;1468;4643;560;1932;310;890;870;2822
316680;201506;1910;5225;1557;4726;230;744;1096;3308;1326;4052
316690;201506;1209;4029;1073;3730;317;1254;365;1219;682;2473
316695;201506;1133;3555;979;3255;91;319;646;2176;737;2495
316700;201506;366;1144;331;1084;65;270;179;520;244;790
316710;201506;3434;12915;2987;11942;1042;4450;800;3363;1842;7813
316720;201506;17430;56807;14481;50388;4434;16603;3117;10404;7551;27007
316730;201506;376;1155;322;1042;75;285;159;465;234;750
316740;201506;686;2305;609;2163;197;801;214;705;411;1506
316750;201506;425;1447;370;1327;80;340;127;417;207;757
316760;201506;3471;11637;2975;11024;1690;6365;851;3281;2541;9646
316770;201506;1299;3743;1162;3557;153;553;829;2506;982;3059
316780;201506;602;2037;529;1890;154;612;120;375;274;987
316790;201506;894;2555;656;2147;169;613;212;682;381;1295
316800;201506;6008;19791;5405;18637;1075;4230;2527;8280;3602;12510
316805;201506;865;2293;813;2223;86;223;670;1904;756;2127
316810;201506;623;1902;520;1696;145;520;214;661;359;1181
316820;201506;391;1023;231;744;51;188;38;109;89;297
316830;201506;604;2074;573;2013;171;669;248;835;419;1504
316840;201506;3013;9110;2626;8407;656;2401;1051;3187;1707;5588
316850;201506;2153;6485;1869;5983;316;1135;1070;3433;1386;4568
316860;201506;19177;60497;16468;55446;4011;15560;6887;22098;10898;37658
316870;201506;6424;20806;5303;18179;1606;6056;916;2939;2522;8995
316880;201506;812;2595;745;2478;229;880;271;838;500;1718
316890;201506;1359;3343;1064;2957;334;1072;520;1350;854;2422
316900;201506;2548;7819;2065;6792;512;1933;677;2001;1189;3934
316905;201506;459;1541;399;1411;136;508;134;469;270;977
316910;201506;779;2530;578;2119;161;621;121;450;282;1071
316920;201506;1711;4948;1343;4411;331;1221;440;1366;771;2587
316930;201506;9018;30692;7235;26658;1755;7183;1137;3813;2892;10996
316935;201506;5105;14926;3335;11309;896;3469;617;1858;1513;5327
316940;201506;7151;23485;5888;20771;1423;5424;1337;4509;2760;9933
316950;201506;1499;4319;1316;4060;136;517;921;2804;1057;3321
316960;201506;5184;13047;4108;11651;763;2364;2287;6387;3050;8751
316970;201506;3448;10976;3236;10640;886;3348;1156;3511;2042;6859
316980;201506;1067;3183;770;2673;293;1139;180;628;473;1767
316990;201506;9690;31309;8161;27716;2751;10186;792;2526;3543;12712
317000;201506;2796;9559;2693;9443;172;540;2151;8347;2323;8887
317005;201506;2612;8093;2333;7684;462;1533;1371;4587;1833;6120
317010;201506;31151;78424;19129;59086;4889;17031;4269;13610;9158;30641
317020;201506;58469;164591;35715;117225;7913;28714;7796;23619;15709;52333
317030;201506;808;2289;655;2049;80;315;398;1208;478;1523
317040;201506;10538;30820;8499;27125;2274;7952;3253;10282;5527;18234
317043;201506;778;2194;679;2070;102;302;456;1415;558;1717
317047;201506;1176;3085;855;2553;135;465;399;1177;534;1642
317050;201506;1573;5403;1245;4622;254;1062;517;1804;771;2866
317052;201506;2458;7750;2153;7283;193;753;1592;5350;1785;6103
317057;201506;1766;4963;1347;4230;151;584;762;2317;913;2901
317060;201506;417;1220;296;945;66;253;88;235;154;488
317065;201506;1265;4180;1148;3990;132;560;869;2969;1001;3529
317070;201506;10036;31470;6900;24306;1616;6420;1177;4075;2793;10495
317075;201506;1147;3473;947;3085;260;933;287;852;547;1785
317080;201506;6325;17574;5422;16054;1574;4963;1849;5285;3423;10248
317090;201506;4972;16545;4610;15943;650;2282;3209;11308;3859;13590
317100;201506;3181;8945;2498;7769;770;2643;911;2669;1681;5312
317103;201506;2041;7028;1714;6366;312;1467;807;2878;1119;4345
317107;201506;1381;4219;1173;3787;209;807;690;2084;899;2891
317110;201506;679;1726;406;1242;80;304;162;457;242;761
317115;201506;1165;3693;1000;3346;148;506;635;2158;783;2664
317120;201506;11687;38710;9554;33649;2502;9830;3369;11465;5871;21295
317130;201506;7872;23738;6683;21605;1433;5291;3013;9565;4446;14856
317140;201506;614;2072;581;2008;63;235;408;1432;471;1667
317150;201506;1018;2823;877;2660;94;309;616;1846;710;2155
317160;201506;3576;9558;2733;8447;267;914;1908;5881;2175;6795
317170;201506;1840;5126;1528;4632;89;371;998;2852;1087;3223
317180;201506;1888;6294;1493;5428;409;1608;377;1298;786;2906
317190;201506;1403;4022;1137;3659;128;439;793;2542;921;2981
317200;201506;4715;14944;4115;13731;1103;4086;1372;4354;2475;8440
317210;201506;1067;3216;880;2955;190;748;468;1553;658;2301
317220;201506;310;1094;299;1081;87;325;169;624;256;949
320010;201506;5529;17280;4790;15688;867;3019;2385;7791;3252;10810
320013;201506;2052;6009;1427;4794;218;756;677;2340;895;3096
320016;201506;3327;9361;2865;8682;404;1182;2010;6168;2414;7350
320020;201506;4004;12438;3427;11279;1027;3708;1188;3852;2215;7560
320030;201506;1639;5239;1307;4495;405;1482;438;1455;843;2937
320035;201506;1803;5343;1600;5041;421;1496;825;2457;1246;3953
320040;201506;3214;10497;2569;9026;601;2348;727;2444;1328;4792
320050;201506;1817;4949;1544;4447;339;1059;701;1900;1040;2959
320060;201506;12309;38832;9452;32258;2306;8649;2868;9195;5174;17844
320070;201506;1597;5169;1310;4490;318;1224;316;945;634;2169
320080;201506;5329;15168;4024;12539;1147;3797;1069;3287;2216;7084
320090;201506;8550;24792;6704;21100;1824;6174;2651;7963;4475;14137
320100;201506;3103;9389;2491;8166;592;2073;1072;3420;1664;5493
320110;201506;1400;4193;1238;3885;299;987;445;1366;744;2353
320115;201506;1829;6483;1655;6159;860;3366;458;1710;1318;5076
320120;201506;16659;51866;13254;45154;3763;14013;3801;12906;7564;26919
320130;201506;37528;120887;34077;113783;7756;29038;15753;50651;23509;79689
320140;201506;4171;13213;2931;10284;724;2829;303;973;1027;3802
320150;201506;17090;47019;12146;37571;3068;10352;1951;5746;5019;16098
320160;201506;5179;15978;4415;14535;1129;4248;1617;4845;2746;9093
320170;201506;1756;5656;1432;4930;406;1492;500;1725;906;3217
320180;201506;822;2677;717;2500;299;1087;203;725;502;1812
320190;201506;3885;13222;3050;11149;876;3430;763;2681;1639;6111
320200;201506;1092;3423;930;3128;234;843;374;1300;608;2143
320210;201506;5174;14411;4445;13082;964;3237;2213;6133;3177;9370
320220;201506;2861;8535;2210;7370;592;2168;842;2825;1434;4993
320225;201506;1517;5185;1222;4461;414;1632;228;841;642;2473
320230;201506;4333;14109;3801;13203;1253;4693;1329;4665;2582;9358
320240;201506;11954;35391;9288;30423;2620;9327;2392;7744;5012;17071
320245;201506;3889;13171;3590;12460;1189;4422;1127;3743;2316;8165
320250;201506;1804;5532;1283;4311;335;1280;261;753;596;2033
320255;201506;1883;6243;1600;5757;629;2468;589;2193;1218;4661
320260;201506;1070;3295;814;2673;213;766;207;563;420;1329
320265;201506;2539;7859;2200;7415;399;1393;1441;5010;1840;6403
320270;201506;2775;8338;2073;6917;490;1790;867;2843;1357;4633
320280;201506;7103;21534;6294;19964;1422;5036;2787;8438;4209;13474
320290;201506;1517;4951;1125;3953;366;1357;215;716;581;2073
320300;201506;4593;15254;4096;14169;1291;4745;1112;3787;2403;8532
320305;201506;4586;14717;4031;13454;980;3589;1824;5875;2804;9464
320310;201506;2012;6019;1718;5442;451;1521;698;2145;1149;3666
320313;201506;2332;6870;1609;5186;394;1496;280;768;674;2264
320316;201506;1914;5802;1595;5146;496;1688;630;1952;1126;3640
320320;201506;20095;62565;16356;55404;4627;17319;5692;18744;10319;36063
320330;201506;3255;9624;2783;8832;614;1895;1478;4938;2092;6833
320332;201506;5069;16988;4470;15867;1581;5977;1499;5382;3080;11359
320334;201506;1813;5865;1289;4688;391;1580;234;792;625;2372
320335;201506;2370;6996;1534;5084;423;1568;248;714;671;2282
320340;201506;5951;16218;4793;14228;1075;3480;2077;6152;3152;9632
320350;201506;5392;14334;4034;11869;934;2964;1529;4410;2463;7374
320360;201506;1772;4677;1289;3730;236;754;558;1483;794;2237
320370;201506;3346;10784;2706;9371;799;2864;932;3176;1731;6040
320380;201506;2508;7358;2196;6797;338;1201;1372;4137;1710;5338
320390;201506;7784;23306;6249;20099;1868;6618;1725;5187;3593;11805
320400;201506;4107;11901;3408;10846;999;3580;1325;3895;2324;7475
320405;201506;3973;11627;3539;10989;966;3262;1814;5443;2780;8705
320410;201506;5757;14867;4231;12931;986;3254;2111;6392;3097;9646
320420;201506;1792;5516;1319;4654;401;1555;261;909;662;2464
320425;201506;2058;5450;1738;4938;254;808;1059;2941;1313;3749
320430;201506;2344;6661;2055;6097;436;1394;1102;3166;1538;4560
320435;201506;2736;9129;2319;8256;1081;4004;669;2509;1750;6513
320440;201506;1222;4064;1076;3676;268;1029;379;1206;647;2235
320450;201506;2086;6515;1711;5743;484;1804;732;2345;1216;4149
320455;201506;4454;14903;3237;11857;968;3769;790;2834;1758;6603
320460;201506;2981;9404;2286;7940;593;2248;751;2468;1344;4716
320465;201506;1718;5349;1332;4466;278;1017;525;1695;803;2712
320470;201506;4559;13777;3127;10501;890;3269;480;1437;1370;4706
320480;201506;2021;6065;1697;5457;418;1521;656;2010;1074;3531
320490;201506;16256;50296;13478;44894;4305;15596;3871;12895;8176;28491
320495;201506;1231;3773;881;2983;335;1176;120;445;455;1621
320500;201506;47229;144004;40846;132152;10750;37998;18737;59118;29487;97116
320501;201506;4382;13781;3811;12888;1193;4556;1510;4913;2703;9469
320503;201506;1957;6593;1565;5712;579;2335;410;1300;989;3635
320506;201506;3779;11799;2559;8763;803;2940;210;629;1013;3569
320510;201506;8428;26354;7202;23873;1906;6906;3077;9935;4983;16841
320515;201506;2061;5838;1697;5081;470;1470;447;1267;917;2737
320517;201506;2224;7158;1795;6259;651;2495;384;1219;1035;3714
320520;201506;36597;111040;29729;97858;8303;30184;10903;35356;19206;65540
320530;201506;28789;87447;23847;77761;5388;20320;11017;33630;16405;53950
330010;201506;20140;61717;18217;57926;3537;12437;10516;32551;14053;44988
330015;201506;1839;5082;1570;4591;285;989;648;1797;933;2786
330020;201506;17211;50648;15671;48198;3221;10901;9151;27558;12372;38459
330022;201506;1773;5417;1521;4995;284;1107;813;2556;1097;3663
330023;201506;3279;10364;2963;9756;806;2896;1071;3333;1877;6229
330025;201506;4083;11288;3368;10188;794;2652;1829;5388;2623;8040
330030;201506;8214;27496;7241;25473;1713;6717;3280;10999;4993;17716
330040;201506;13037;37596;11175;34354;2586;8536;5594;16706;8180;25242
330045;201506;68098;190800;60381;179525;7744;25007;41707;122448;49451;147455
330050;201506;2676;8325;2370;7713;735;2687;701;2067;1436;4754
330060;201506;5749;16795;5030;15724;1172;4141;2698;8399;3870;12540
330070;201506;23671;71740;21005;67062;4908;17071;9726;30740;14634;47811
330080;201506;8427;23993;7863;23131;1131;3326;5376;16036;6507;19362
330090;201506;2798;7669;2545;7248;498;1590;1362;3767;1860;5357
330093;201506;2041;6023;1685;5339;393;1303;625;1988;1018;3291
330095;201506;1087;3678;962;3401;295;1193;209;648;504;1841
330100;201506;55806;178924;50799;170291;9685;36465;26881;90212;36566;126677
330110;201506;2422;7683;2170;7219;567;2060;720;2342;1287;4402
330115;201506;2143;6211;1923;5859;414;1435;993;2925;1407;4360
330120;201506;2517;7126;2226;6699;585;1973;1101;3175;1686;5148
330130;201506;3701;11897;3268;11111;872;3241;1469;4896;2341;8137
330140;201506;3141;9717;2841;9262;686;2439;1426;4658;2112;7097
330150;201506;2601;7667;1997;6430;460;1631;469;1473;929;3104
330160;201506;1190;3993;1079;3787;331;1307;428;1428;759;2735
330170;201506;109786;330252;101707;317508;17147;57310;66177;205899;83324;263209
330180;201506;1937;5808;1665;5305;180;735;1061;3186;1241;3921
330185;201506;7847;24678;6916;22839;1594;5727;3610;11735;5204;17462
330187;201506;3910;11246;3368;10335;492;1732;2266;6818;2758;8550
330190;201506;27241;78406;25361;75382;5198;16370;15830;46547;21028;62917
330200;201506;13865;44098;12422;41470;2975;10361;6385;21527;9360;31888
330205;201506;2443;6610;2109;6047;417;1350;1139;3157;1556;4507
330210;201506;4319;11455;3234;9439;921;2873;764;2187;1685;5060
330220;201506;10537;32295;9287;29611;2613;9115;2586;7618;5199;16733
330225;201506;4034;12505;3719;12003;419;1600;2588;8404;3007;10004
330227;201506;18390;52096;16404;49187;4188;13219;8653;25883;12841;39102
330230;201506;1445;4299;1306;4059;330;1157;556;1625;886;2782
330240;201506;18085;56329;15659;51496;5502;19736;3288;10190;8790;29926
330245;201506;1281;3997;1027;3488;262;970;215;711;477;1681
330250;201506;36400;106200;33189;100829;9843;30474;14497;44819;24340;75293
330260;201506;3708;11606;3223;10597;675;2490;1399;4298;2074;6788
330270;201506;15328;41322;11962;36368;3317;10932;4362;13140;7679;24072
330280;201506;2150;6509;1794;5778;333;1202;819;2450;1152;3652
330285;201506;18848;54583;17115;52069;3028;9983;10905;33003;13933;42986
330290;201506;3593;10010;3164;9380;553;1899;1924;5467;2477;7366
330300;201506;3538;11497;3248;10981;510;1988;1958;6494;2468;8482
330310;201506;2461;7032;2145;6496;398;1290;1126;3337;1524;4627
330320;201506;13900;41440;13018;40110;2091;7059;9154;27961;11245;35020
330330;201506;29196;82128;26087;77199;4633;15376;16346;47055;20979;62431
330340;201506;14697;43643;11625;37756;3289;11370;3383;10823;6672;22193
330350;201506;88736;270580;83569;262884;12854;41837;60022;189785;72876;231622
330360;201506;5709;17316;5520;17043;398;1383;4675;14379;5073;15762
330370;201506;3648;13009;3338;12312;1191;4603;1086;4037;2277;8640
330380;201506;4930;15854;4180;14408;959;3636;1886;6327;2845;9963
330385;201506;4117;14168;3779;13506;1230;4698;1418;5012;2648;9710
330390;201506;23381;77366;20931;72379;4985;19178;9831;33168;14816;52346
330395;201506;3029;8959;2746;8477;296;1097;1860;5576;2156;6673
330400;201506;2541;8195;2293;7753;384;1575;1298;4045;1682;5620
330410;201506;2936;9191;2489;8324;501;1828;1238;4098;1739;5926
330411;201506;2373;7378;2058;6698;281;1123;1179;3620;1460;4743
330412;201506;1358;4599;1102;4101;265;1139;430;1486;695;2625
330414;201506;26299;73214;22525;68125;4100;12645;14097;42985;18197;55630
330415;201506;3643;11149;3155;10273;832;2853;1297;4224;2129;7077
330420;201506;9662;28754;6681;22933;1724;6468;1150;3816;2874;10284
330430;201506;7839;23157;7003;21613;1531;5187;3493;10532;5024;15719
330440;201506;1958;6510;1648;5837;522;2076;346;1072;868;3148
330450;201506;1429;4762;1291;4520;320;1337;652;2208;972;3545
330452;201506;13444;39797;10604;34152;2861;10193;3735;11442;6596;21635
330455;201506;489254;1374131;407751;1243717;99485;322438;200289;606493;299774;928931
330460;201506;1297;4226;1172;4009;253;1006;572;1917;825;2923
330470;201506;4481;13757;4002;12858;1063;3793;1680;5216;2743;9009
330475;201506;8094;25184;7174;23598;2052;7445;2970;9577;5022;17022
330480;201506;6065;17949;5537;17177;1222;4134;2981;9108;4203;13242
330490;201506;106686;286775;97034;272971;9819;28623;75314;213474;85133;242097
330500;201506;5560;17293;5283;16784;685;2462;3704;11599;4389;14061
330510;201506;39215;122085;35748;116475;11013;36617;16881;56020;27894;92637
330513;201506;1541;4593;1396;4330;430;1341;540;1703;970;3044
330515;201506;3015;9392;2683;8774;820;2823;928;2980;1748;5803
330520;201506;12026;35647;10704;33325;2332;7764;5322;16368;7654;24132
330530;201506;1539;4616;1362;4277;351;1185;578;1769;929;2954
330540;201506;3190;9455;2704;8613;661;2312;1135;3485;1796;5797
330550;201506;8315;27672;7276;25729;3169;11764;1334;4693;4503;16457
330555;201506;10574;31378;9412;29685;1798;5830;5841;18826;7639;24656
330560;201506;4309;13084;3950;12447;826;2914;2036;6194;2862;9108
330570;201506;3725;10746;3174;9842;820;2632;1593;4999;2413;7631
330575;201506;5413;15616;4816;14592;846;2893;2991;8688;3837;11581
330580;201506;15397;48406;13150;43829;3597;12752;5131;17173;8728;29925
330590;201506;1761;5360;1633;5141;363;1241;952;2948;1315;4189
330600;201506;10898;31052;8690;27454;1304;4824;4737;14523;6041;19347
330610;201506;9276;29262;8477;27792;1677;6255;4636;14935;6313;21190
330615;201506;1691;5951;1528;5569;684;2634;359;1353;1043;3987
330620;201506;3834;13204;3461;12511;1217;4804;915;3340;2132;8144
330630;201506;22815;68364;18891;61248;3840;14261;9743;30114;13583;44375
350010;201506;2274;6810;1594;5412;398;1491;276;811;674;2302
350020;201506;510;1355;353;1055;69;237;174;491;243;728
350030;201506;4470;13926;3503;11900;1287;4812;752;2325;2039;7137
350040;201506;522;1792;410;1531;107;452;100;318;207;770
350050;201506;1130;3434;904;3022;209;804;303;924;512;1728
350055;201506;618;1889;557;1785;127;467;317;959;444;1426
350060;201506;102;330;86;301;27;110;33;104;60;214
350070;201506;3197;9984;2198;7764;502;1937;403;1230;905;3167
350075;201506;553;1853;452;1672;138;547;115;393;253;940
350080;201506;570;1594;404;1275;76;269;168;519;244;788
350090;201506;572;1556;405;1271;84;287;133;382;217;669
350100;201506;1951;6213;1420;5050;365;1444;371;1210;736;2654
350110;201506;482;1425;358;1144;55;203;170;508;225;711
350115;201506;1266;3909;1114;3563;229;864;567;1627;796;2491
350120;201506;597;1575;299;924;66;222;49;136;115;358
350130;201506;3401;10066;3039;9359;559;1971;1548;4440;2107;6411
350140;201506;625;1992;541;1839;109;427;239;777;348;1204
350150;201506;402;1351;359;1257;132;489;90;312;222;801
350160;201506;7045;21701;5241;17837;1454;5543;1979;6091;3433;11634
350170;201506;1838;6339;1598;5754;463;1807;374;1254;837;3061
350180;201506;1254;3354;879;2574;185;551;388;1100;573;1651
350190;201506;3224;10176;2695;9117;601;2456;1390;4281;1991;6737
350200;201506;342;1103;295;1022;61;234;126;427;187;661
350210;201506;6439;17002;4645;14005;1334;4512;1633;4624;2967;9136
350220;201506;2673;8373;2387;7863;686;2659;855;2506;1541;5165
350230;201506;731;2424;671;2321;183;704;262;894;445;1598
350240;201506;443;1395;406;1329;85;307;252;795;337;1102
350250;201506;2250;8183;2130;7944;776;3118;762;2782;1538;5900
350260;201506;1016;2693;723;2186;140;456;321;941;461;1397
350270;201506;5215;15916;4445;14247;868;2986;1967;6151;2835;9137
350275;201506;2006;6631;1790;6262;487;1864;661;2169;1148;4033
350280;201506;22054;55496;13790;40953;3097;9892;2986;8699;6083;18591
350290;201506;1622;5282;1276;4554;303;1206;311;1040;614;2246
350300;201506;423;1278;371;1181;75;246;186;579;261;825
350310;201506;909;2992;795;2728;140;545;353;1156;493;1701
350315;201506;557;1739;436;1476;75;316;125;387;200;703
350320;201506;12249;38399;10604;35061;2957;10396;1557;5216;4514;15612
350330;201506;13838;39556;9195;28645;1948;6189;3136;9206;5084;15395
350335;201506;358;1115;315;1029;45;137;188;628;233;765
350340;201506;1139;3416;807;2744;168;649;256;814;424;1463
350350;201506;778;2426;680;2263;145;574;251;826;396;1400
350360;201506;798;2705;674;2439;191;727;230;855;421;1582
350370;201506;742;2246;531;1761;99;364;102;296;201;660
350380;201506;3516;10874;2746;9592;960;3699;674;2150;1634;5849
350390;201506;8780;27516;7749;25603;2246;7789;3147;10139;5393;17928
350395;201506;335;957;181;635;30;121;43;141;73;262
350400;201506;7852;22364;6257;19454;1471;5151;2521;7421;3992;12572
350410;201506;7998;27595;6394;23994;1851;7704;1201;4211;3052;11915
350420;201506;582;1677;399;1344;85;343;43;107;128;450
350430;201506;763;2370;622;2111;136;539;296;948;432;1487
350440;201506;1283;4025;1173;3818;321;1111;569;1796;890;2907
350450;201506;7740;23029;5955;19474;1506;5318;1469;4487;2975;9805
350460;201506;1430;4038;954;3045;214;766;285;810;499;1576
350470;201506;254;689;204;605;41;146;107;290;148;436
350480;201506;801;2456;536;1849;80;307;79;220;159;527
350490;201506;2073;6038;1760;5598;460;1685;771;2263;1231;3948
350500;201506;581;1697;497;1566;114;386;217;666;331;1052
350510;201506;1028;3170;807;2672;153;601;307;918;460;1519
350520;201506;1034;3793;825;3328;231;1047;156;569;387;1616
350530;201506;2472;7286;2020;6347;624;2121;569;1610;1193;3731
350535;201506;1380;4229;1293;4063;100;407;1016;3108;1116;3515
350540;201506;1976;5499;1581;4794;447;1464;549;1625;996;3089
350550;201506;12010;32312;8249;25974;1805;6458;3013;9014;4818;15472
350560;201506;3542;11604;3190;10886;527;1934;1678;5784;2205;7718
350570;201506;19332;65028;17372;60667;5185;19486;6305;21097;11490;40583
350580;201506;1728;5383;1242;4269;274;1040;177;512;451;1552
350590;201506;4079;12640;3058;10524;819;3173;1020;3154;1839;6327
350600;201506;40778;100591;27258;78034;4444;13998;13216;35972;17660;49970
350610;201506;8109;23388;6285;20209;1346;4937;2839;8754;4185;13691
350620;201506;419;1189;322;1042;69;266;154;463;223;729
350630;201506;1669;4970;1291;4251;311;1204;329;948;640;2152
350635;201506;5724;17420;4401;14949;1124;4095;1677;5646;2801;9741
350640;201506;695;2194;511;1735;106;397;135;426;241;823
350650;201506;7027;21417;3884;13676;967;3751;378;1292;1345;5043
350660;201506;4215;12866;3651;11900;807;2881;1959;6270;2766;9151
350670;201506;1820;5617;1687;5356;338;1174;1010;3093;1348;4267
350680;201506;1170;3582;920;3072;222;876;384;1239;606;2115
350690;201506;918;2990;751;2656;191;755;221;705;412;1460
350700;201506;3151;10228;2514;8934;915;3475;741;2392;1656;5867
350710;201506;2469;7737;2202;7293;325;1184;1428;4679;1753;5863
350715;201506;880;2686;776;2505;243;884;266;759;509;1643
350720;201506;145;438;132;415;36;128;49;137;85;265
350730;201506;438;1619;418;1566;120;490;149;539;269;1029
350740;201506;2039;6302;1625;5347;336;1228;659;2030;995;3258
350745;201506;387;1186;294;969;49;189;139;411;188;600
350750;201506;10268;30945;7911;26195;1976;7230;1876;5750;3852;12980
350760;201506;12723;38378;10715;34669;2830;10206;4149;12592;6979;22798
350770;201506;758;2138;508;1643;78;288;222;682;300;970
350775;201506;549;1525;453;1371;75;265;259;761;334;1026
350780;201506;2186;6640;1647;5528;471;1744;232;736;703;2480
350790;201506;2026;6376;1535;5382;415;1574;356;1113;771;2687
350800;201506;3088;10254;2904;9944;507;2017;1818;6078;2325;8095
350810;201506;2247;6407;1828;5732;559;1892;647;1984;1206;3876
350820;201506;562;1510;406;1198;75;269;166;432;241;701
350830;201506;912;2824;633;2171;85;319;146;413;231;732
350840;201506;2405;8483;1970;7405;591;2442;345;1089;936;3531
350850;201506;6450;21414;5364;18961;1735;6497;1247;4225;2982;10722
350860;201506;3209;10084;3065;9879;279;1106;2423;7717;2702;8823
350870;201506;2575;8316;2188;7715;584;2289;1250;4432;1834;6721
350880;201506;1388;4547;1149;4043;298;1129;247;837;545;1966
350890;201506;668;1909;454;1451;80;305;105;255;185;560
350900;201506;4501;14976;3593;12885;961;3770;678;2245;1639;6015
350910;201506;848;2516;743;2310;258;846;263;772;521;1618
350920;201506;9971;28832;8994;27126;1288;4313;6048;17647;7336;21960
350925;201506;4741;14441;3929;12802;988;3446;1592;4792;2580;8238
350930;201506;1614;4370;1306;3840;150;501;885;2526;1035;3027
350940;201506;2102;6909;1924;6634;365;1508;1190;3948;1555;5456
350945;201506;863;2828;747;2585;136;567;373;1204;509;1771
350950;201506;69306;213439;56103;186069;13918;50765;22573;71393;36491;122158
350960;201506;4326;14471;3670;13085;618;2581;2147;7324;2765;9905
350970;201506;4418;15298;3747;13682;1224;4866;905;2953;2129;7819
350980;201506;604;1977;543;1872;228;837;182;626;410;1463
350990;201506;1754;5998;1504;5504;492;1938;413;1452;905;3390
350995;201506;808;2777;769;2703;125;555;468;1563;593;2118
351000;201506;3448;10279;2892;9215;397;1435;1510;4601;1907;6036
351010;201506;381;1101;256;834;81;296;78;252;159;548
351015;201506;871;2887;748;2658;202;800;315;1083;517;1883
351020;201506;7965;25251;6959;23680;1755;6381;3215;11004;4970;17385
351030;201506;1659;5936;1506;5570;370;1583;510;1743;880;3326
351040;201506;3416;10476;3117;9948;532;1988;1969;6004;2501;7992
351050;201506;12061;36239;8919;30322;2510;9365;2631;8737;5141;18102
351060;201506;34129;102233;27786;90425;6866;24472;11387;35911;18253;60383
351070;201506;1706;4753;1170;3784;353;1259;183;466;536;1725
351080;201506;2764;8071;2149;7299;547;2073;968;3153;1515;5226
351090;201506;392;1329;307;1151;67;297;73;269;140;566
351100;201506;1921;5904;1556;5176;474;1624;520;1788;994;3412
351110;201506;8037;20288;4396;14062;1039;3760;1049;3041;2088;6801
351120;201506;626;1818;507;1579;65;236;257;702;322;938
351130;201506;1003;2797;543;1851;91;360;101;307;192;667
351140;201506;1792;6183;1606;5774;519;2090;462;1548;981;3638
351150;201506;1831;6241;1364;5019;267;1075;304;970;571;2045
351160;201506;1391;4749;1237;4396;340;1356;423;1401;763;2757
351170;201506;1551;5022;1250;4342;259;970;540;1751;799;2721
351190;201506;764;2418;611;2034;123;423;131;401;254;824
351200;201506;2239;6563;1858;5797;398;1427;669;1869;1067;3296
351210;201506;1066;3226;829;2730;197;734;282;824;479;1558
351220;201506;3225;10777;2855;10018;599;2355;1372;4715;1971;7070
351230;201506;1799;5645;1538;5178;318;1258;845;2739;1163;3997
351240;201506;1067;3389;781;2740;204;788;182;552;386;1340
351250;201506;930;2649;655;2083;141;486;239;705;380;1191
351260;201506;965;2787;843;2534;191;640;357;1004;548;1644
351270;201506;385;1327;350;1261;89;377;147;473;236;850
351280;201506;5345;15792;3996;12880;922;3125;1360;4075;2282;7200
351290;201506;1051;3019;801;2524;194;641;306;908;500;1549
351300;201506;12194;40762;9243;34228;2443;9974;2919;10570;5362;20544
351310;201506;3279;10006;2658;8866;523;2072;1259;3837;1782;5909
351320;201506;930;3158;802;2863;211;861;225;679;436;1540
351330;201506;294;817;246;736;103;311;58;166;161;477
351340;201506;6131;20591;5347;19002;1498;5708;2211;7789;3709;13497
351350;201506;6999;22588;6029;20516;1788;6434;1955;6242;3743;12676
351360;201506;4212;13091;3849;12395;956;3409;1527;4615;2483;8024
351370;201506;2324;7186;1851;6209;477;1806;661;2028;1138;3834
351380;201506;36769;109681;33368;103185;6768;22918;15267;45574;22035;68492
351385;201506;196;609;183;584;43;145;92;277;135;422
351390;201506;1184;3847;1002;3471;290;1150;383;1184;673;2334
351400;201506;954;3151;891;3001;347;1223;302;1011;649;2234
351410;201506;2783;8395;2446;7783;428;1458;1396;4296;1824;5754
351420;201506;395;1137;266;878;59;212;64;200;123;412
351430;201506;858;2672;783;2544;82;284;578;1882;660;2166
351440;201506;3928;11598;3046;9662;822;2739;599;1684;1421;4423
351450;201506;1631;4567;1364;4189;348;1118;614;1980;962;3098
351460;201506;797;2427;670;2204;317;1087;186;579;503;1666
351470;201506;1083;3236;946;2968;261;927;357;1066;618;1993
351480;201506;2845;9240;2585;8806;493;2079;1350;4360;1843;6439
351490;201506;1912;6354;1694;5877;252;1076;968;3159;1220;4235
351492;201506;206;648;154;523;19;79;82;265;101;344
351495;201506;151;496;122;422;31;124;39;121;70;245
351500;201506;23037;67708;18136;58289;4971;17656;7031;21573;12002;39229
351510;201506;8423;26662;7039;23859;1716;6337;3384;11246;5100;17583
351512;201506;426;1233;350;1088;59;186;195;626;254;812
351515;201506;2355;7359;1721;5985;458;1707;468;1498;926;3205
351518;201506;2000;6359;1375;5171;351;1505;358;1224;709;2729
351519;201506;833;2468;642;2063;126;505;226;561;352;1066
351520;201506;822;2267;424;1490;69;283;64;205;133;488
351530;201506;389;1186;285;942;44;151;83;239;127;390
351535;201506;2380;6184;1876;5454;186;640;1278;3623;1464;4263
351540;201506;1854;5652;1526;5052;519;1910;252;767;771;2677
351550;201506;4726;13779;3369;11000;769;2876;1177;3665;1946;6541
351560;201506;402;1269;340;1134;79;300;61;196;140;496
351565;201506;211;704;192;655;47;193;84;260;131;453
351570;201506;11861;36911;10171;33462;2474;8793;5213;16689;7687;25482
351580;201506;363;966;237;703;57;170;67;181;124;351
351590;201506;440;1196;335;1000;54;191;123;331;177;522
351600;201506;1687;4627;1486;4319;230;771;786;2162;1016;2933
351610;201506;664;1811;506;1538;57;205;237;659;294;864
351620;201506;19205;61604;14627;52069;3416;13586;3509;10949;6925;24535
351630;201506;18220;58688;16613;55992;3897;13899;9432;31628;13329;45527
351640;201506;9862;30817;8225;27901;1688;6318;4424;14734;6112;21052
351650;201506;431;1282;213;719;45;164;34;99;79;263
351660;201506;744;2333;540;1820;127;449;132;392;259;841
351670;201506;3986;12304;3276;10777;586;2238;1572;4809;2158;7047
351680;201506;698;2117;443;1495;94;335;91;294;185;629
351685;201506;454;1344;371;1202;96;316;161;526;257;842
351690;201506;1104;3211;746;2384;147;519;193;506;340;1025
351700;201506;1273;3684;1113;3386;304;934;449;1338;753;2272
351710;201506;676;2198;557;1945;107;378;196;631;303;1009
351720;201506;1682;5125;1164;3844;231;828;375;1106;606;1934
351730;201506;1031;2943;831;2668;299;1108;282;849;581;1957
351740;201506;3992;10898;3161;9235;675;2110;1111;3081;1786;5191
351750;201506;1255;3989;911;3177;224;902;293;909;517;1811
351760;201506;3814;11921;3189;10549;861;3051;1143;3555;2004;6606
351770;201506;2312;7143;1923;6467;537;1903;852;2740;1389;4643
351780;201506;1554;4336;925;2940;181;630;238;704;419;1334
351790;201506;1089;3244;949;3031;313;1027;411;1329;724;2356
351800;201506;429;965;315;810;40;108;172;437;212;545
351810;201506;1088;3125;995;3007;187;637;689;2053;876;2690
351820;201506;2139;6770;1688;5905;510;1881;180;601;690;2482
351830;201506;4117;12970;3232;10899;585;2246;1559;4930;2144;7176
351840;201506;7530;25075;6526;23085;1847;7087;2327;7964;4174;15051
351850;201506;1676;4907;1265;4134;222;904;550;1587;772;2491
351860;201506;3409;10867;2999;10021;825;2997;1283;4033;2108;7030
351870;201506;31207;94346;26937;86559;6935;23840;13010;41221;19945;65061
351880;201506;110422;351081;95555;319975;28369;100801;29062;94630;57431;195431
351885;201506;550;1983;510;1897;142;565;231;824;373;1389
351890;201506;698;2077;531;1721;123;441;123;350;246;791
351900;201506;1310;3985;1116;3668;312;1094;365;1177;677;2271
351905;201506;461;1492;383;1352;68;300;206;665;274;965
351907;201506;16973;51123;14252;46071;2305;8749;8190;25436;10495;34185
351910;201506;988;3054;892;2898;192;728;418;1281;610;2009
351920;201506;1064;2936;936;2736;143;500;588;1652;731;2152
351925;201506;942;2870;817;2627;127;468;432;1280;559;1748
351930;201506;2780;9075;2593;8707;562;2315;1563;4808;2125;7123
351940;201506;937;2774;813;2551;184;622;431;1314;615;1936
351950;201506;1423;3896;1021;3148;144;488;534;1591;678;2079
351960;201506;4287;12538;3132;10439;776;2846;1278;4111;2054;6957
351970;201506;5567;20183;4936;18880;1560;6392;1703;6345;3263;12737
351980;201506;918;2730;695;2277;149;551;267;747;416;1298
351990;201506;1557;4395;1238;3775;295;1071;283;726;578;1797
352000;201506;2350;7551;2124;7089;486;1756;981;3091;1467;4847
352010;201506;1930;6449;1672;5848;441;1684;390;1307;831;2991
352020;201506;1452;4598;1259;4210;325;1200;468;1478;793;2678
352030;201506;4913;14431;4089;13206;1001;3375;2137;6990;3138;10365
352040;201506;2004;6680;1652;5875;374;1479;396;1276;770;2755
352042;201506;3016;8474;2017;6261;429;1493;959;2864;1388;4357
352044;201506;1397;4655;1056;3840;218;859;172;556;390;1415
352050;201506;7612;23762;5042;17951;1322;5215;930;2928;2252;8143
352060;201506;775;2257;666;2074;158;595;282;787;440;1382
352070;201506;669;1842;601;1737;193;582;237;683;430;1265
352080;201506;468;1323;336;1074;64;227;134;391;198;618
352090;201506;1687;5484;1328;4672;287;1112;286;884;573;1996
352100;201506;2457;7505;1775;6188;472;1861;565;1772;1037;3633
352110;201506;503;1802;441;1664;127;521;166;588;293;1109
352115;201506;424;1345;360;1207;76;278;152;466;228;744
352120;201506;929;2840;784;2597;156;597;408;1307;564;1904
352130;201506;1865;5337;1282;4173;354;1211;387;1158;741;2369
352140;201506;1623;4889;1063;3638;193;686;432;1428;625;2114
352150;201506;745;2265;576;1928;150;521;240;781;390;1302
352160;201506;1076;2971;877;2606;188;612;331;876;519;1488
352170;201506;2802;8405;2509;7835;537;1867;1320;3890;1857;5757
352180;201506;3481;9864;2917;8807;729;2401;1066;3023;1795;5424
352190;201506;1184;3584;1021;3248;209;790;406;1102;615;1892
352200;201506;396;1361;329;1230;51;217;188;712;239;929
352210;201506;17170;45709;13578;40460;2506;7864;7959;24163;10465;32027
352215;201506;563;1748;517;1686;70;264;308;993;378;1257
352220;201506;12626;41310;11276;38583;3698;13638;3614;12045;7312;25683
352230;201506;13121;44212;11344;40826;3372;13272;4247;14856;7619;28128
352240;201506;11403;33362;8785;28646;2687;9872;2901;8755;5588;18627
352250;201506;23261;74488;20275;68405;5731;20823;7274;24234;13005;45057
352260;201506;5446;15543;3395;11258;663;2511;1191;3653;1854;6164
352265;201506;889;2803;740;2542;83;366;446;1436;529;1802
352270;201506;2116;7180;1769;6403;518;1972;427;1462;945;3434
352280;201506;2347;7155;1928;6425;484;1848;655;2073;1139;3921
352290;201506;1187;3741;1023;3396;239;940;351;1016;590;1956
352300;201506;929;2742;739;2391;189;659;308;932;497;1591
352310;201506;33681;102403;28640;93909;7140;24847;16139;52994;23279;77841
352320;201506;5765;17637;4954;16091;1428;5028;1593;4668;3021;9696
352330;201506;1925;6205;1654;5823;564;2116;505;1744;1069;3860
352340;201506;5737;19076;4548;16396;1285;5009;821;2692;2106;7701
352350;201506;1574;5514;1422;5181;306;1238;555;1936;861;3174
352360;201506;1108;3458;972;3191;196;799;608;1873;804;2672
352370;201506;904;3079;820;2896;156;645;395;1320;551;1965
352380;201506;973;3078;841;2839;276;1068;228;720;504;1788
352390;201506;18197;50025;12052;38104;2251;8221;5589;16333;7840;24554
352400;201506;3892;10855;2384;7872;623;2198;690;2072;1313;4270
352410;201506;2924;8738;2421;7876;651;2242;841;2646;1492;4888
352420;201506;992;2812;878;2619;253;842;425;1221;678;2063
352430;201506;6530;19697;5414;17864;1834;6684;1604;5122;3438;11806
352440;201506;15945;48720;12849;42663;3334;11846;4612;14899;7946;26745
352450;201506;693;2034;457;1572;109;418;106;323;215;741
352460;201506;2395;7825;2018;7116;622;2417;551;1777;1173;4194
352470;201506;4564;12611;2697;8723;467;1699;924;2779;1391;4478
352480;201506;4917;13443;3811;11400;771;2699;1539;4202;2310;6901
352490;201506;723;2493;586;2149;111;464;134;440;245;904
352500;201506;7810;23612;7125;22526;3370;11619;2028;5574;5398;17193
352510;201506;3174;10328;2554;9055;831;3237;607;2045;1438;5282
352520;201506;2171;7585;1920;6994;478;1893;912;3248;1390;5141
352530;201506;7797;25015;5787;20449;1621;6123;853;2661;2474;8784
352540;201506;496;1548;378;1295;61;248;100;318;161;566
352550;201506;865;2870;579;2149;138;587;102;332;240;919
352560;201506;684;2039;499;1635;94;316;173;508;267;824
352570;201506;1741;5749;1290;4677;273;1137;270;878;543;2015
352580;201506;888;2587;754;2371;169;586;381;1151;550;1737
352585;201506;214;697;167;600;59;224;33;124;92;348
352590;201506;12113;37280;9693;32349;2338;8525;4577;14582;6915;23107
352600;201506;1640;5006;1456;4662;404;1418;611;1825;1015;3243
352610;201506;3372;10280;2814;9314;862;3194;836;2557;1698;5751
352620;201506;5174;16043;4823;15550;1000;3534;2968;9430;3968;12964
352630;201506;660;2129;618;2023;151;579;278;851;429;1430
352640;201506;2922;9016;2377;7852;359;1363;1200;3806;1559;5169
352650;201506;848;2482;624;2001;138;464;192;579;330;1043
352660;201506;1027;3473;797;2929;173;708;184;628;357;1336
352670;201506;10597;32077;6436;22672;1653;6307;872;2814;2525;9121
352680;201506;3227;11097;2496;9307;571;2364;675;2216;1246;4580
352690;201506;30350;84477;20931;65265;4113;14150;9445;28140;13558;42290
352700;201506;772;2314;632;2094;189;709;281;879;470;1588
352710;201506;5816;16934;4330;13961;1047;3818;1576;4781;2623;8599
352720;201506;7800;25297;7045;23716;2110;7325;2580;8590;4690;15915
352725;201506;420;1187;259;848;37;146;99;297;136;443
352730;201506;2357;7856;2081;7124;442;1667;730;2225;1172;3892
352740;201506;1951;5513;1562;4855;286;1066;878;2552;1164;3618
352750;201506;437;1244;247;817;48;180;56;150;104;330
352760;201506;1117;3839;978;3525;301;1153;392;1337;693;2490
352770;201506;727;2229;624;2030;135;496;270;834;405;1330
352780;201506;656;2157;541;1894;116;460;169;529;285;989
352790;201506;645;1850;472;1522;96;329;105;324;201;653
352800;201506;984;3534;720;2809;172;736;178;569;350;1305
352810;201506;1159;2997;758;2228;137;465;244;681;381;1146
352820;201506;610;1783;481;1587;161;571;107;343;268;914
352830;201506;523;1476;356;1123;62;215;58;144;120;359
352840;201506;3941;13485;3461;12455;1072;4100;1031;3645;2103;7745
352850;201506;8972;28040;7668;25738;2024;7309;2798;9189;4822;16498
352860;201506;852;2770;769;2581;209;769;254;775;463;1544
352870;201506;1000;2488;737;1998;84;321;435;1057;519;1378
352880;201506;2358;6722;1723;5389;357;1170;558;1620;915;2790
352885;201506;254;840;239;805;42;157;131;416;173;573
352890;201506;721;1929;538;1558;92;325;252;642;344;967
352900;201506;18903;55476;13906;45236;3029;10823;5360;16522;8389;27345
352910;201506;286;899;206;721;43;170;27;77;70;247
352920;201506;2551;7623;2039;6656;530;1951;790;2320;1320;4271
352930;201506;5940;18644;4706;15886;1289;4670;1016;3220;2305;7890
352940;201506;22456;73643;18723;64882;6415;23615;2838;9120;9253;32735
352950;201506;350;1065;231;818;63;266;53;151;116;417
352960;201506;630;1950;415;1450;70;284;64;208;134;492
352965;201506;311;900;250;785;64;232;49;132;113;364
352970;201506;3142;8018;2594;7227;316;934;1783;4997;2099;5931
352980;201506;1204;3612;1008;3317;238;797;567;1981;805;2778
352990;201506;3956;12662;3502;11859;988;3719;1318;4236;2306;7955
353000;201506;506;1388;296;916;50;163;51;131;101;294
353010;201506;3003;8403;2218;6863;530;1865;678;1871;1208;3736
353020;201506;4326;11800;2808;8485;411;1445;1100;2941;1511;4386
353030;201506;4194;12267;3471;10925;1010;3437;861;2510;1871;5947
353040;201506;666;1891;564;1723;158;545;194;552;352;1097
353050;201506;5069;16953;4244;15263;1283;4999;1518;5144;2801;10143
353060;201506;34245;106347;31919;102604;3859;15050;23298;72096;27157;87146
353070;201506;9380;30339;6923;24875;1894;7265;1749;6249;3643;13514
353080;201506;5235;16937;3677;13292;850;3393;875;2868;1725;6261
353090;201506;541;1779;484;1660;53;222;266;846;319;1068
353100;201506;241;646;125;393;32;109;26;74;58;183
353110;201506;7425;23029;6554;21515;1614;5674;3479;11419;5093;17093
353120;201506;625;1883;422;1413;110;431;115;321;225;752
353130;201506;2686;7849;2222;7113;746;2622;766;2323;1512;4945
353140;201506;2451;6676;1874;5542;486;1574;723;1953;1209;3527
353150;201506;1774;5414;1454;4852;434;1578;398;1293;832;2871
353160;201506;647;1862;452;1447;117;378;70;174;187;552
353170;201506;483;1605;437;1526;127;539;190;614;317;1153
353180;201506;7630;22090;5995;19014;912;3251;3298;10173;4210;13424
353190;201506;3567;10991;2973;9701;589;2167;1446;4377;2035;6544
353200;201506;960;3234;773;2792;243;961;202;693;445;1654
353205;201506;496;1581;415;1411;88;307;158;531;246;838
353210;201506;974;2485;733;2062;44;174;495;1349;539;1523
353215;201506;475;1507;410;1360;68;259;140;411;208;670
353220;201506;654;2013;525;1727;121;435;137;406;258;841
353230;201506;979;3092;894;2945;235;859;256;770;491;1629
353240;201506;2088;6694;1878;6284;466;1766;929;2922;1395;4688
353250;201506;1101;2981;858;2545;148;472;399;1139;547;1611
353260;201506;926;2533;699;2138;118;427;309;880;427;1307
353270;201506;652;1949;562;1773;157;541;194;558;351;1099
353280;201506;609;1962;513;1757;135;507;138;455;273;962
353282;201506;1638;5233;1538;5055;222;836;961;3005;1183;3841
353284;201506;342;941;203;645;39;125;53;173;92;298
353286;201506;149;443;104;340;17;50;14;49;31;99
353290;201506;541;1735;436;1543;103;401;219;742;322;1143
353300;201506;1526;4764;1280;4214;308;1163;465;1328;773;2491
353310;201506;222;662;191;603;55;197;73;200;128;397
353320;201506;526;1506;462;1399;85;292;258;747;343;1039
353325;201506;579;1915;468;1681;83;337;81;231;164;568
353330;201506;612;1769;404;1281;76;278;190;543;266;821
353340;201506;3028;8674;1984;6631;534;1921;622;1952;1156;3873
353350;201506;3240;9737;2702;8767;831;2890;1107;3429;1938;6319
353360;201506;391;1285;341;1173;53;223;203;664;256;887
353370;201506;654;2126;566;1911;82;320;320;1033;402;1353
353380;201506;339;1099;284;1000;63;275;116;365;179;640
353390;201506;5828;15617;4060;12419;802;2740;1484;4159;2286;6899
353400;201506;498;1490;405;1297;108;389;106;282;214;671
353410;201506;618;1805;505;1619;106;378;284;894;390;1272
353420;201506;580;1598;412;1224;109;316;135;377;244;693
353430;201506;2419;8305;1774;6540;432;1658;192;630;624;2288
353440;201506;59225;190528;50667;170846;14055;49867;17425;56885;31480;106752
353450;201506;442;1333;372;1194;89;326;148;441;237;767
353460;201506;3586;10001;3067;9110;461;1518;1512;4543;1973;6061
353470;201506;9601;28865;6873;23257;1568;5944;1675;5206;3243;11150
353475;201506;1680;4753;1138;3563;215;720;313;877;528;1597
353480;201506;1487;4409;1312;4073;245;831;752;2269;997;3100
353490;201506;1175;3256;915;2755;200;662;330;897;530;1559
353500;201506;971;2645;820;2379;261;778;338;964;599;1742
353510;201506;1121;3545;879;2946;191;719;245;684;436;1403
353520;201506;1102;3237;859;2810;193;724;337;1075;530;1799
353530;201506;2616;7730;2317;7198;436;1572;1213;3615;1649;5187
353540;201506;2010;6051;1748;5605;447;1535;741;2331;1188;3866
353550;201506;6224;17239;5368;15916;672;2418;3386;9545;4058;11963
353560;201506;2130;7034;1752;6322;445;1833;531;1799;976;3632
353570;201506;438;1357;363;1196;59;218;223;690;282;908
353580;201506;2249;7071;2060;6755;405;1526;1296;4175;1701;5701
353590;201506;707;2013;550;1734;157;526;169;536;326;1062
353600;201506;1736;4850;1556;4543;250;824;831;2348;1081;3172
353610;201506;592;1972;455;1668;88;381;116;381;204;762
353620;201506;2146;7022;1817;6366;504;1920;575;1856;1079;3776
353625;201506;291;788;187;608;40;144;57;179;97;323
353630;201506;1659;5655;1255;4610;243;963;163;516;406;1479
353640;201506;1377;3978;1117;3435;170;534;579;1724;749;2258
353650;201506;6924;20782;5161;17019;1109;3863;1726;5458;2835;9321
353657;201506;323;1010;286;934;52;191;104;318;156;509
353660;201506;1253;3218;912;2655;362;1153;161;334;523;1487
353670;201506;4027;12993;3407;11635;1037;4020;1046;3186;2083;7206
353680;201506;651;2175;586;2053;253;964;209;704;462;1668
353690;201506;543;1418;320;1007;60;229;109;278;169;507
353700;201506;2226;6867;1912;6222;361;1304;740;2251;1101;3555
353710;201506;2981;7246;1350;4488;300;1039;272;873;572;1912
353715;201506;448;1288;310;997;36;133;86;258;122;391
353720;201506;2046;6378;1761;5935;328;1276;971;3151;1299;4427
353730;201506;4455;13533;3445;11349;767;2741;933;2771;1700;5512
353740;201506;2076;6200;1625;5277;493;1677;449;1417;942;3094
353750;201506;822;2745;630;2288;135;557;170;602;305;1159
353760;201506;9091;26016;7338;23192;1507;5327;3918;12166;5425;17493
353770;201506;809;2449;479;1648;96;359;38;61;134;420
353780;201506;4476;15366;3868;14146;1370;5328;1046;3806;2416;9134
353790;201506;1851;6383;1522;5681;404;1720;304;1074;708;2794
353800;201506;15228;47543;12003;41481;3266;12393;4354;14609;7620;27002
353810;201506;1101;3451;857;2926;196;770;295;943;491;1713
353820;201506;1238;4224;1124;3959;280;1176;546;1748;826;2924
353830;201506;770;2067;596;1772;106;349;266;771;372;1120
353850;201506;1659;5268;1502;4976;312;1107;719;2304;1031;3411
353860;201506;2413;8035;1999;7071;530;2001;567;1940;1097;3941
353870;201506;24891;74186;17621;59448;3925;14624;5417;16471;9342;31095
353880;201506;2460;7754;2062;7063;285;1193;1165;3901;1450;5094
353890;201506;2707;6691;1864;5319;372;1157;894;2406;1266;3563
353900;201506;1065;3311;779;2692;173;671;200;614;373;1285
353910;201506;1192;4349;1154;4267;328;1292;663;2412;991;3704
353920;201506;2264;6697;1613;5281;356;1241;264;753;620;1994
353930;201506;4242;13442;3095;11213;843;3295;659;2328;1502;5623
353940;201506;1268;4012;1009;3434;180;701;401;1246;581;1947
353950;201506;3510;11124;3177;10542;464;1792;2044;6558;2508;8350
353960;201506;617;1937;471;1612;99;373;114;323;213;696
353970;201506;549;1616;481;1521;41;142;348;1095;389;1237
353980;201506;13487;40427;11625;36967;2619;8966;5832;18187;8451;27153
353990;201506;414;1273;372;1181;72;273;157;451;229;724
354000;201506;2008;5765;1349;4446;271;972;138;413;409;1385
354010;201506;359;1077;308;993;89;299;144;472;233;771
354020;201506;4680;14378;4106;13116;1101;3816;1572;4611;2673;8427
354025;201506;896;2528;690;2173;150;516;205;606;355;1122
354030;201506;535;1462;377;1193;71;250;167;483;238;733
354040;201506;800;2178;599;1805;72;269;324;895;396;1164
354050;201506;975;3148;841;2885;257;992;271;877;528;1869
354060;201506;5221;16109;3638;12588;896;3309;1153;3801;2049;7110
354070;201506;3089;10141;2659;9200;744;2793;525;1722;1269;4515
354075;201506;2130;7936;2007;7702;562;2385;899;3414;1461;5799
354080;201506;1702;5228;1208;4066;265;965;299;867;564;1832
354085;201506;310;798;279;754;20;73;220;576;240;649
354090;201506;1321;3908;1254;3801;131;435;931;2855;1062;3290
354100;201506;15881;53334;13317;48331;3403;13228;5947;21292;9350;34520
354105;201506;868;2677;757;2468;128;487;413;1268;541;1755
354110;201506;817;2278;666;2067;220;773;192;523;412;1296
354120;201506;1993;5493;1547;4652;301;1023;634;1741;935;2764
354130;201506;5996;17368;4675;14784;1879;6366;839;2278;2718;8644
354140;201506;25272;64354;15783;46963;3275;10644;5333;14591;8608;25235
354150;201506;4176;11264;3161;9459;632;2134;1477;4218;2109;6352
354160;201506;3652;11945;3086;10679;833;3149;1217;4036;2050;7185
354165;201506;327;1210;285;1109;85;372;95;349;180;721
354170;201506;1466;4551;1145;3806;212;798;423;1237;635;2035
354180;201506;501;1492;452;1390;64;238;256;703;320;941
354190;201506;1486;4825;1236;4269;346;1335;404;1308;750;2643
354200;201506;1100;3121;887;2718;149;525;357;966;506;1491
354210;201506;728;2392;631;2204;104;452;322;1034;426;1486
354220;201506;2919;8662;2528;7925;647;2250;1141;3427;1788;5677
354230;201506;628;2050;572;1953;103;391;269;896;372;1287
354240;201506;1229;4008;920;3275;176;710;195;620;371;1330
354250;201506;666;1953;453;1573;173;662;121;409;294;1071
354260;201506;7356;22298;6494;20816;1881;6546;2410;7575;4291;14121
354270;201506;1158;3994;1001;3628;261;1045;371;1329;632;2374
354280;201506;648;1980;604;1902;79;315;448;1347;527;1662
354290;201506;1055;3606;962;3423;228;886;379;1311;607;2197
354300;201506;3518;11754;3388;11508;873;3138;1720;5721;2593;8859
354310;201506;888;2770;676;2316;170;626;241;807;411;1433
354320;201506;772;2282;643;2031;162;576;206;571;368;1147
354323;201506;406;1149;314;975;72;249;104;282;176;531
354325;201506;1191;3965;1017;3539;200;802;406;1303;606;2105
354330;201506;6848;20876;5703;18578;1180;4328;2840;8733;4020;13061
354340;201506;26596;82987;21711;74181;7056;26170;7743;25569;14799;51739
354350;201506;1116;3303;1037;3158;294;1004;515;1461;809;2465
354360;201506;472;1478;331;1173;55;202;27;95;82;297
354370;201506;1220;4084;1071;3780;128;547;644;2201;772;2748
354380;201506;1096;3244;874;2854;260;1023;145;361;405;1384
354390;201506;12302;37633;8720;30170;1990;7532;2006;6584;3996;14116
354400;201506;1540;5290;1233;4562;267;1096;359;1246;626;2342
354410;201506;5558;16974;4628;15342;994;3584;2255;7374;3249;10958
354420;201506;1262;3804;964;3123;241;855;362;1091;603;1946
354425;201506;2674;7533;2242;6746;712;2300;553;1586;1265;3886
354430;201506;1275;4156;1171;3939;280;1061;518;1665;798;2726
354440;201506;523;1531;392;1266;48;180;187;553;235;733
354450;201506;429;1227;246;830;38;160;52;150;90;310
354460;201506;857;2353;643;1993;195;650;247;743;442;1393
354470;201506;552;1548;433;1307;56;214;206;557;262;771
354480;201506;727;2055;619;1881;102;361;345;993;447;1354
354490;201506;753;2499;579;2088;119;475;199;655;318;1130
354500;201506;2120;7085;1875;6626;708;2872;357;1116;1065;3988
354510;201506;728;2143;646;1997;115;356;393;1238;508;1594
354515;201506;313;1047;246;894;45;192;83;267;128;459
354520;201506;6874;22635;4072;14496;895;3657;1560;5173;2455;8830
354530;201506;2808;9844;2560;9320;664;2658;1177;4179;1841;6837
354540;201506;1252;3796;1032;3389;357;1302;181;522;538;1824
354550;201506;505;1563;428;1395;80;282;202;631;282;913
354560;201506;1581;4616;1103;3532;213;678;412;1252;625;1930
354570;201506;750;2223;535;1730;131;450;84;236;215;686
354580;201506;10293;29713;7973;25228;1606;5650;3399;10112;5005;15762
354600;201506;1595;5325;1407;4957;331;1389;672;2236;1003;3625
354610;201506;404;1147;243;778;36;107;47;123;83;230
354620;201506;394;1284;313;1138;82;361;136;458;218;819
354625;201506;275;914;217;790;48;188;56;197;104;385
354630;201506;1990;6705;1791;6274;806;2892;433;1436;1239;4328
354640;201506;3643;11860;2887;10199;685;2793;670;2111;1355;4904
354650;201506;888;2673;801;2508;106;386;522;1581;628;1967
354660;201506;2390;6963;1866;6052;343;1254;995;3214;1338;4468
354670;201506;1622;5265;1331;4549;352;1314;327;965;679;2279
354680;201506;4704;15593;4245;14632;1082;4039;1721;5751;2803;9790
354690;201506;779;2506;518;1846;91;332;147;491;238;823
354700;201506;1224;3432;821;2571;154;575;343;907;497;1482
354710;201506;549;1618;467;1464;79;289;205;574;284;863
354720;201506;216;595;155;472;52;151;41;125;93;276
354730;201506;7871;26010;6123;22252;1523;6059;2443;8565;3966;14624
354740;201506;252;762;156;545;25;97;28;90;53;187
354750;201506;2467;7509;1884;6463;573;2213;662;2170;1235;4383
354760;201506;2054;6587;1654;5708;477;1769;304;983;781;2752
354765;201506;245;674;155;494;21;74;25;73;46;147
354770;201506;2280;6360;1749;5468;676;2272;422;1241;1098;3513
354780;201506;42312;123001;37114;111591;7322;24757;19506;54761;26828;79518
354790;201506;794;2517;670;2293;128;499;327;1041;455;1540
354800;201506;1925;5652;1689;5321;428;1497;875;2731;1303;4228
354805;201506;956;2892;689;2291;76;271;144;435;220;706
354810;201506;602;1938;376;1363;70;296;71;196;141;492
354820;201506;1046;3607;897;3289;218;939;247;803;465;1742
354830;201506;397;1156;315;1008;89;307;148;439;237;746
354840;201506;680;1975;560;1757;130;446;265;804;395;1250
354850;201506;16354;51038;12161;42434;2869;11087;4546;14652;7415;25739
354860;201506;1373;4312;1181;3991;249;960;522;1682;771;2642
354870;201506;42891;131157;39053;123138;9748;32928;17830;55182;27578;88110
354880;201506;4139;11534;2487;8110;482;1775;683;1817;1165;3592
354890;201506;15994;47542;13381;42588;3525;12091;4599;14016;8124;26107
354900;201506;487;1431;381;1242;103;370;137;437;240;807
354910;201506;6574;19590;3708;13215;650;2587;254;812;904;3399
354920;201506;469;1363;329;1085;72;272;93;289;165;561
354925;201506;355;1025;217;749;35;138;31;83;66;221
354930;201506;222;611;165;514;38;125;78;235;116;360
354940;201506;2190;7729;1724;6486;614;2465;230;778;844;3243
354950;201506;1484;4755;1287;4452;166;699;774;2595;940;3294
354960;201506;777;2418;675;2247;160;608;274;868;434;1476
354970;201506;4107;13394;3571;12262;652;2608;1916;6302;2568;8910
354980;201506;33419;83014;19781;60049;3936;13420;6636;18636;10572;32056
354990;201506;45942;139244;37274;121484;7213;25843;18844;59244;26057;85087
354995;201506;1691;5208;1535;4987;347;1218;855;2759;1202;3977
355000;201506;1467;4752;1271;4402;402;1583;247;740;649;2323
355010;201506;3650;11231;2908;9595;780;2791;1123;3649;1903;6440
355020;201506;2754;9265;2150;8016;901;3649;484;1732;1385;5381
355030;201506;976773;2783964;850873;2534102;203793;662014;379512;1085535;583305;1747549
355040;201506;2590;7952;2279;7403;579;2061;1176;3722;1755;5783
355050;201506;1227;3765;986;3278;307;1071;196;643;503;1714
355060;201506;5210;17539;4179;15318;1035;4262;1034;3445;2069;7707
355070;201506;6728;20919;6008;19751;1319;5053;3175;9741;4494;14794
355080;201506;1179;4053;875;3313;177;788;120;352;297;1140
355090;201506;1153;4012;962;3572;207;833;389;1394;596;2227
355100;201506;20025;62515;16866;57231;4909;18234;7070;23410;11979;41644
355110;201506;1175;4005;1055;3741;322;1258;327;1112;649;2370
355120;201506;635;2004;537;1817;142;554;220;695;362;1249
355130;201506;611;1567;308;904;42;140;119;302;161;442
355140;201506;1078;3628;1031;3541;235;907;532;1839;767;2746
355150;201506;3329;9914;2813;9058;657;2250;1414;4519;2071;6769
355160;201506;1622;5220;1390;4855;490;1960;437;1367;927;3327
355170;201506;9885;27266;7002;22259;2146;7356;1729;5484;3875;12840
355180;201506;2904;8915;2404;7976;641;2508;799;2380;1440;4888
355190;201506;1297;4410;1095;3968;404;1557;347;1204;751;2761
355200;201506;792;2844;731;2717;307;1240;165;568;472;1808
355210;201506;2581;8491;2298;7886;523;2090;1127;3619;1650;5709
355220;201506;30762;95393;25379;84821;8932;31586;6468;20781;15400;52367
355230;201506;1389;3891;761;2489;128;426;185;545;313;971
355240;201506;26403;76321;18606;60419;4108;14593;6643;20380;10751;34973
355250;201506;26119;85398;23096;79535;6872;25124;9513;32277;16385;57401
355255;201506;828;2306;570;1764;115;379;154;440;269;819
355260;201506;1430;4049;1220;3706;290;1021;502;1344;792;2365
355270;201506;1565;4705;1494;4601;126;493;1227;3697;1353;4190
355280;201506;24157;71051;19997;63030;4192;14938;8831;26381;13023;41319
355290;201506;918;2877;761;2515;154;554;294;894;448;1448
355300;201506;1057;3452;862;3030;185;700;289;946;474;1646
355310;201506;1029;3157;856;2813;150;534;432;1418;582;1952
355320;201506;632;1950;540;1743;91;360;213;575;304;935
355330;201506;1815;5744;1306;4744;340;1389;424;1466;764;2855
355340;201506;2628;6912;2382;6495;409;1213;1463;3866;1872;5079
355350;201506;1303;4458;1080;3953;284;1160;336;1139;620;2299
355360;201506;1113;3638;1019;3451;172;624;699;2410;871;3034
355365;201506;272;865;226;775;53;217;63;202;116;419
355370;201506;7422;18429;5354;15885;1450;4697;2299;7010;3749;11707
355380;201506;3436;10373;2642;8520;637;2309;559;1473;1196;3782
355385;201506;867;2742;806;2644;288;1029;261;786;549;1815
355390;201506;839;2350;631;1945;137;482;276;743;413;1225
355395;201506;1871;5607;1402;4554;223;787;604;1800;827;2587
355400;201506;8836;29200;7652;26731;2312;8775;2518;8370;4830;17145
355410;201506;15223;51652;12736;46481;4375;17346;2915;10668;7290;28014
355420;201506;773;2714;709;2574;239;961;213;763;452;1724
355430;201506;3695;10446;3091;9417;589;2006;1611;4716;2200;6722
355440;201506;925;2918;712;2426;135;501;211;639;346;1140
355450;201506;3406;9988;1994;6717;405;1463;602;1862;1007;3325
355460;201506;607;1655;431;1341;86;331;146;373;232;704
355465;201506;399;1226;331;1097;75;270;85;275;160;545
355470;201506;827;2540;678;2259;150;559;293;925;443;1484
355475;201506;132;485;121;453;29;105;56;211;85;316
355480;201506;3164;11336;2938;10880;829;3269;1361;4978;2190;8247
355490;201506;993;2859;666;2186;137;477;127;388;264;865
355495;201506;707;2373;629;2206;134;528;234;783;368;1311
355500;201506;8147;23470;5267;17234;928;3406;1082;3170;2010;6576
355510;201506;2080;5572;1233;3856;209;787;385;1048;594;1835
355520;201506;451;1107;255;727;39;136;103;257;142;393
355530;201506;354;820;148;460;15;50;41;123;56;173
355535;201506;716;2195;570;1918;168;647;143;390;311;1037
355540;201506;8459;26802;7951;25953;1999;7023;4243;13452;6242;20475
355550;201506;772;2307;664;2143;152;566;318;985;470;1551
355560;201506;1328;3932;901;2988;184;705;160;394;344;1099
355570;201506;194;615;149;511;25;88;24;67;49;155
355580;201506;1129;3172;837;2612;186;659;339;1026;525;1685
355590;201506;228;601;189;530;26;78;112;311;138;389
355600;201506;1154;3643;971;3251;372;1339;246;790;618;2129
355610;201506;1437;4021;1214;3663;252;863;565;1626;817;2489
355620;201506;4137;13027;3313;11153;638;2462;1465;4546;2103;7008
355630;201506;3213;9216;1937;6551;375;1406;501;1587;876;2993
355635;201506;953;3122;818;2890;102;420;552;1953;654;2373
355640;201506;3367;10907;2573;9200;552;2226;387;1245;939;3471
355645;201506;3211;11267;2950;10818;502;2023;1841;6774;2343;8797
355650;201506;6515;19841;5570;18048;874;3355;3409;10396;4283;13751
355660;201506;1267;4012;1011;3480;230;964;402;1270;632;2234
355670;201506;2521;7931;1779;6191;378;1538;703;2181;1081;3719
355680;201506;1516;4979;1136;4098;366;1438;253;850;619;2288
355690;201506;414;1304;305;1118;192;750;25;72;217;822
355695;201506;321;968;189;619;11;34;19;37;30;71
355700;201506;5915;19985;5086;18075;1357;5160;1982;6756;3339;11916
355710;201506;11509;28910;7007;20705;1889;6055;1808;4990;3697;11045
355715;201506;266;799;168;576;39;143;30;90;69;233
355720;201506;1519;4974;1251;4382;358;1364;366;1124;724;2488
355730;201506;768;2589;649;2315;219;808;144;500;363;1308
410010;201506;1538;4840;1348;4448;313;1126;357;1135;670;2261
410020;201506;1165;3904;1042;3638;294;1093;402;1357;696;2450
410030;201506;1126;3827;936;3354;247;939;163;578;410;1517
410040;201506;10395;34347;9147;31866;2684;10517;2668;8876;5352;19393
410045;201506;963;2746;656;2138;156;551;175;545;331;1096
410050;201506;2333;6509;1451;4740;406;1406;198;595;604;2001
410060;201506;2218;6942;1965;6451;487;1728;821;2702;1308;4430
410070;201506;1806;5128;1387;4294;457;1564;291;783;748;2347
410080;201506;1250;3753;1034;3334;188;702;469;1402;657;2104
410090;201506;1064;3345;962;3151;261;965;325;1016;586;1981
410100;201506;2590;7892;1884;6244;486;1790;210;639;696;2429
410105;201506;420;1314;278;963;50;213;43;114;93;327
410110;201506;2487;7395;1992;6426;364;1344;681;2107;1045;3451
410115;201506;519;1412;399;1181;54;171;159;439;213;610
410120;201506;2571;8826;2407;8557;786;2971;1034;3718;1820;6689
410130;201506;1201;3858;1068;3541;372;1273;315;1003;687;2276
410140;201506;16597;43934;11049;33812;2492;8488;3202;9469;5694;17957
410150;201506;17325;43005;8430;25160;1702;5594;1471;3877;3173;9471
410160;201506;3044;9490;2736;8966;773;2814;1000;3290;1773;6104
410165;201506;746;2189;604;1890;143;483;256;744;399;1227
410170;201506;2107;6178;1664;5217;508;1776;379;1147;887;2923
410180;201506;9331;29789;7974;26795;1987;7309;3027;9551;5014;16860
410185;201506;579;1599;476;1409;118;356;173;484;291;840
410190;201506;2042;6010;1646;5122;401;1372;332;917;733;2289
410200;201506;3779;10580;2700;8383;612;2119;347;980;959;3099
410210;201506;2612;7774;1956;6339;345;1300;441;1177;786;2477
410220;201506;642;1835;471;1493;92;330;139;408;231;738
410230;201506;1518;4824;1314;4435;396;1531;500;1586;896;3117
410240;201506;4431;13424;3989;12509;1126;4055;1158;3477;2284;7532
410250;201506;2516;6992;1732;5368;428;1460;313;850;741;2310
410260;201506;1613;4909;1367;4442;345;1231;517;1623;862;2854
410270;201506;527;1501;414;1285;75;269;163;477;238;746
410275;201506;868;2608;600;2017;94;340;288;960;382;1300
410280;201506;2907;8518;2090;6797;434;1626;459;1357;893;2983
410290;201506;3369;10169;2845;9154;683;2371;1158;3739;1841;6110
410300;201506;677;1901;589;1719;89;298;279;731;368;1029
410302;201506;362;974;247;786;29;100;144;464;173;564
410304;201506;1250;4043;1124;3776;309;1091;448;1554;757;2645
410305;201506;1942;5158;1598;4620;390;1221;883;2547;1273;3768
410310;201506;2194;7163;1961;6748;446;1722;795;2697;1241;4419
410315;201506;638;1865;415;1421;82;306;129;407;211;713
410320;201506;1244;3692;741;2514;96;366;55;156;151;522
410322;201506;590;1761;410;1370;92;307;115;361;207;668
410330;201506;1369;3737;1123;3270;246;779;346;955;592;1734
410335;201506;980;2880;841;2630;186;634;324;955;510;1589
410337;201506;791;2106;575;1680;86;301;222;564;308;865
410340;201506;480;1419;325;1003;40;146;137;368;177;514
410345;201506;1817;5218;1317;4152;327;1119;385;1134;712;2253
410347;201506;727;1951;460;1450;70;264;155;475;225;739
410350;201506;939;2844;657;2247;138;548;100;290;238;838
410360;201506;3470;9897;2827;8754;548;1908;1184;3541;1732;5449
410370;201506;12441;36064;8987;28266;1897;6795;2545;7022;4442;13817
410380;201506;1217;3727;1076;3414;169;626;534;1599;703;2225
410390;201506;2808;8087;2197;6948;737;2523;560;1572;1297;4095
410395;201506;893;2945;787;2721;204;823;326;1079;530;1902
410400;201506;4152;13003;3521;11761;832;3168;1313;4195;2145;7363
410405;201506;959;2770;765;2400;171;628;288;868;459;1496
410410;201506;1287;4167;1223;4068;379;1477;449;1363;828;2840
410420;201506;7819;25345;6554;22452;1903;7075;1243;3781;3146;10856
410425;201506;3325;10530;2375;8361;463;1784;280;905;743;2689
410430;201506;15066;40810;10867;32887;2340;7896;3288;9492;5628;17388
410440;201506;3097;9798;2735;9093;712;2629;1140;3683;1852;6312
410442;201506;2768;9355;2439;8600;753;2794;702;2448;1455;5242
410445;201506;2271;7576;1962;7011;532;2143;679;2468;1211;4611
410450;201506;2151;6100;1664;5151;522;1682;244;648;766;2330
410460;201506;2179;6458;1765;5623;449;1514;562;1686;1011;3200
410465;201506;1942;6599;1613;5847;400;1624;588;1952;988;3576
410470;201506;1574;5074;1263;4346;293;1162;333;1101;626;2263
410480;201506;29625;84360;20411;64978;5302;18317;3579;10280;8881;28597
410490;201506;10910;34623;8421;29185;2219;8586;2218;7121;4437;15707
410500;201506;1641;5126;1340;4460;487;1799;358;1160;845;2959
410510;201506;2482;6556;1753;5095;356;1097;690;1797;1046;2894
410520;201506;3172;11018;2991;10637;949;3622;1114;3943;2063;7565
410530;201506;1671;4616;1265;3785;243;845;491;1337;734;2182
410540;201506;3202;9347;2147;7141;486;1707;666;2175;1152;3882
410550;201506;6351;18341;4253;13707;855;3095;662;1875;1517;4970
410560;201506;1393;4255;1057;3502;233;871;285;758;518;1629
410570;201506;2635;8416;2356;7931;647;2348;840;3033;1487;5381
410580;201506;22449;68897;18395;60638;5093;18673;4986;15155;10079;33828
410590;201506;1306;4092;778;2614;116;397;142;427;258;824
410600;201506;1946;5666;1560;4904;368;1193;626;1973;994;3166
410610;201506;778;2281;618;1959;100;371;233;698;333;1069
410620;201506;1588;5516;1179;4437;347;1402;142;498;489;1900
410630;201506;2555;7543;1876;6037;498;1758;377;1020;875;2778
410640;201506;4163;11608;3066;9484;836;3002;615;1742;1451;4744
410645;201506;1105;3873;1049;3790;474;1849;262;939;736;2788
410650;201506;2314;7118;1856;6133;606;2109;339;1041;945;3150
410655;201506;866;2536;678;2174;150;556;231;701;381;1257
410657;201506;722;2072;513;1615;110;396;189;520;299;916
410660;201506;2471;7111;1403;4658;301;1094;180;511;481;1605
410670;201506;974;2703;676;2075;141;465;201;537;342;1002
410680;201506;2764;9284;2228;7929;631;2221;729;2745;1360;4966
410685;201506;655;1889;571;1746;54;171;404;1249;458;1420
410690;201506;111074;321815;75949;247619;17166;61676;16657;48255;33823;109931
410700;201506;2282;7010;2102;6663;582;2013;894;2718;1476;4731
410710;201506;949;2848;664;2178;165;590;184;519;349;1109
410712;201506;819;2486;705;2270;273;961;213;708;486;1669
410715;201506;1002;3108;768;2571;162;612;273;846;435;1458
410720;201506;3367;9965;2441;8004;560;2089;599;1792;1159;3881
410725;201506;1070;2995;741;2342;114;361;126;337;240;698
410730;201506;536;1511;439;1340;140;484;119;356;259;840
410740;201506;884;2635;614;2074;108;423;270;904;378;1327
410750;201506;1872;5485;1522;4725;333;1108;474;1381;807;2489
410752;201506;307;852;184;596;38;147;68;189;106;336
410753;201506;450;1304;287;934;55;211;97;272;152;483
410754;201506;1038;3180;900;2942;83;291;594;2010;677;2301
410755;201506;825;2085;641;1793;82;262;382;1042;464;1304
410760;201506;2293;7025;2036;6550;587;2080;683;2115;1270;4195
410765;201506;16377;48473;11791;39119;2323;8684;1405;4213;3728;12897
410770;201506;932;2593;689;2103;202;675;159;446;361;1121
410773;201506;1365;3942;1160;3621;246;903;629;1870;875;2773
410775;201506;1553;4443;1451;4296;352;1123;690;2028;1042;3151
410780;201506;515;1412;358;1121;91;286;130;453;221;739
410785;201506;698;2222;566;1902;205;726;129;426;334;1152
410790;201506;555;1733;450;1487;92;336;83;205;175;541
410800;201506;2846;7131;2183;6061;488;1563;851;2178;1339;3741
410810;201506;318;971;255;829;43;161;111;361;154;522
410820;201506;928;2775;716;2287;181;634;137;385;318;1019
410830;201506;32252;93132;25946;82016;7625;26783;8821;26882;16446;53665
410832;201506;1057;3104;913;2832;124;465;509;1472;633;1937
410840;201506;6836;20153;4442;14934;1133;4132;511;1441;1644;5573
410845;201506;1337;3953;1110;3466;188;680;491;1455;679;2135
410850;201506;2787;8135;2481;7667;541;1925;1230;3758;1771;5683
410855;201506;571;1577;410;1232;89;307;149;390;238;697
410860;201506;3679;10354;2943;8969;553;1818;1217;3623;1770;5441
410865;201506;1630;5583;1520;5366;384;1462;828;2995;1212;4457
410870;201506;1265;3881;1165;3722;470;1595;462;1455;932;3050
410880;201506;4304;13047;3393;11302;770;2839;729;2229;1499;5068
410890;201506;1022;3238;785;2760;186;735;67;198;253;933
410895;201506;1105;3806;981;3506;333;1293;245;787;578;2080
410900;201506;872;2396;630;1982;119;461;208;578;327;1039
410910;201506;416;1105;354;999;52;168;198;539;250;707
410920;201506;819;2376;653;2070;169;606;243;737;412;1343
410930;201506;1798;5276;1514;4770;368;1396;586;1766;954;3162
410940;201506;20876;68282;18068;63031;5362;20446;5994;21092;11356;41538
410950;201506;1821;6017;1674;5750;299;1063;1058;3676;1357;4739
410960;201506;7262;20105;4647;15107;1441;5145;1041;3205;2482;8350
410965;201506;1036;3179;902;2922;280;957;366;1160;646;2117
410970;201506;4571;13694;3588;11726;1072;4034;696;2187;1768;6221
410975;201506;1598;4600;1280;4007;219;814;547;1690;766;2504
410980;201506;5635;15807;3357;11099;712;2610;503;1576;1215;4186
410990;201506;868;2530;531;1771;170;621;78;199;248;820
411000;201506;471;1412;331;1092;65;250;63;168;128;418
411005;201506;503;1486;320;1036;75;262;42;104;117;366
411007;201506;2271;7199;1977;6537;598;2135;652;2074;1250;4209
411010;201506;3871;13190;3429;12145;934;3690;647;2058;1581;5748
411020;201506;2579;8048;2295;7562;748;2765;733;2373;1481;5138
411030;201506;681;1846;511;1510;118;399;148;390;266;789
411040;201506;635;1843;310;1017;61;224;76;244;137;468
411050;201506;2131;7443;1891;6905;539;2183;299;974;838;3157
411060;201506;1689;5182;1386;4526;290;1044;204;574;494;1618
411065;201506;376;1131;289;954;57;197;107;340;164;537
411070;201506;5674;17313;4249;14324;1185;4402;718;2149;1903;6551
411080;201506;2164;6558;1919;6101;553;1971;555;1669;1108;3640
411090;201506;780;1897;557;1564;84;297;136;345;220;642
411095;201506;1636;4563;1168;3609;206;723;289;775;495;1498
411100;201506;1403;4050;1016;3267;170;639;176;472;346;1111
411110;201506;723;2131;450;1506;63;234;69;173;132;407
411120;201506;1775;5376;1348;4448;380;1400;416;1263;796;2663
411125;201506;4276;14009;4077;13602;1245;4486;1684;5447;2929;9933
411130;201506;739;2214;566;1827;133;458;168;561;301;1019
411140;201506;2130;7519;1827;6808;623;2434;509;1966;1132;4400
411150;201506;4563;12715;3505;10552;861;2896;712;1788;1573;4684
411155;201506;996;2762;782;2343;157;542;356;975;513;1517
411160;201506;245;710;200;620;36;126;72;204;108;330
411170;201506;701;2264;578;1973;131;491;208;673;339;1164
411180;201506;5775;17204;4735;15245;1163;4164;1569;4950;2732;9114
411190;201506;1485;4221;1228;3735;323;1140;331;869;654;2009
411200;201506;4491;13286;3601;11754;939;3456;1326;4121;2265;7577
411210;201506;2134;6114;1674;5265;560;1898;272;816;832;2714
411220;201506;1161;3294;919;2828;224;809;357;956;581;1765
411230;201506;1247;3484;775;2509;202;730;193;551;395;1281
411240;201506;1360;3276;745;2235;158;501;240;660;398;1161
411250;201506;2523;7342;2059;6502;546;1876;564;1736;1110;3612
411260;201506;309;840;204;653;27;90;98;307;125;397
411270;201506;1811;5752;1620;5392;350;1356;779;2464;1129;3820
411275;201506;1427;4252;1169;3653;300;999;277;796;577;1795
411280;201506;1562;4604;1133;3698;232;864;240;701;472;1565
411290;201506;811;2315;617;1890;157;501;212;626;369;1127
411295;201506;953;2694;855;2507;149;471;354;1055;503;1526
411300;201506;1283;3268;900;2513;93;293;376;977;469;1270
411310;201506;857;2388;669;2059;93;329;231;695;324;1024
411320;201506;5663;16457;4142;13470;1095;3758;825;2481;1920;6239
411325;201506;1509;4756;1314;4359;250;896;751;2503;1001;3399
411330;201506;3391;10582;2916;9682;1017;3732;803;2597;1820;6329
411340;201506;930;2733;584;1912;93;354;218;681;311;1035
411342;201506;745;2121;601;1827;155;508;195;525;350;1033
411345;201506;1000;3112;903;2921;242;860;414;1334;656;2194
411350;201506;2875;8492;1996;6670;528;1967;242;734;770;2701
411360;201506;547;1362;363;1044;45;166;175;427;220;593
411370;201506;46112;130182;35009;109427;6395;23219;13392;38667;19787;61886
411373;201506;1486;4634;1239;4143;296;1121;318;1050;614;2171
411375;201506;1093;3017;783;2391;164;516;195;538;359;1054
411380;201506;1307;3521;747;2275;126;416;220;617;346;1033
411390;201506;1784;5290;1508;4766;341;1195;504;1484;845;2679
411400;201506;2030;5858;1481;4649;288;1019;383;1091;671;2110
411410;201506;2201;6607;1668;5359;403;1467;420;1124;823;2591
411420;201506;4343;12554;3115;9777;586;2082;539;1323;1125;3405
411430;201506;3150;9827;2646;8927;744;2754;1123;3704;1867;6458
411435;201506;427;1389;346;1176;85;320;143;454;228;774
411440;201506;2632;8497;2347;7923;814;2929;625;2170;1439;5099
411450;201506;2296;6963;2069;6542;445;1464;1119;3609;1564;5073
411460;201506;3192;9450;1735;5999;356;1368;114;377;470;1745
411470;201506;856;2537;562;1831;91;314;92;252;183;566
411480;201506;4456;13326;3307;11100;966;3648;615;1919;1581;5567
411490;201506;1475;4483;1243;4054;324;1186;317;898;641;2084
411500;201506;1890;5125;1323;4088;300;1011;366;1084;666;2095
411510;201506;2141;6347;1700;5446;481;1697;340;921;821;2618
411520;201506;26894;72947;16005;49881;3234;11047;3442;9793;6676;20840
411530;201506;988;2801;675;2201;193;715;107;280;300;995
411535;201506;520;1551;250;902;38;159;27;80;65;239
411540;201506;3017;8115;2242;6630;337;1103;1085;3123;1422;4226
411545;201506;979;3305;894;3145;163;612;593;2120;756;2732
411550;201506;815;2213;653;1951;242;799;141;398;383;1197
411560;201506;2483;7408;1854;5925;384;1366;333;905;717;2271
411570;201506;6610;17901;4832;14940;1243;4362;1074;3331;2317;7693
411573;201506;896;2681;844;2590;154;508;517;1593;671;2101
411575;201506;1485;4667;1252;4159;247;870;474;1558;721;2428
411580;201506;3970;11274;2612;8449;437;1660;396;1040;833;2700
411585;201506;676;2224;396;1388;92;353;70;218;162;571
411590;201506;421;1277;360;1166;68;255;147;433;215;688
411600;201506;311;924;223;762;50;205;77;258;127;463
411605;201506;2067;5523;1363;4135;234;809;558;1601;792;2410
411610;201506;2200;6098;1894;5626;343;1095;1186;3481;1529;4576
411620;201506;2756;8769;2552;8414;738;2619;1142;3812;1880;6431
411630;201506;464;1207;275;910;49;203;51;159;100;362
411640;201506;501;1485;385;1237;67;227;139;399;206;626
411650;201506;202;655;162;577;41;178;48;147;89;325
411660;201506;834;2338;659;1997;131;434;281;842;412;1276
411670;201506;1243;3464;1030;3018;243;810;394;1066;637;1876
411680;201506;1428;4415;1287;4149;215;696;816;2739;1031;3435
411690;201506;3404;10084;2690;8718;723;2482;601;1966;1324;4448
411695;201506;758;2457;606;2126;146;558;182;632;328;1190
411700;201506;1835;5326;1283;4198;246;899;280;820;526;1719
411705;201506;2142;7268;1876;6735;430;1538;1005;3764;1435;5302
411710;201506;1825;5394;1424;4532;346;1189;332;988;678;2177
411720;201506;834;2439;626;1982;99;347;173;490;272;837
411721;201506;717;2177;613;1977;182;649;97;282;279;931
411722;201506;674;1983;481;1558;102;380;130;347;232;727
411725;201506;1388;4453;856;3067;199;765;157;549;356;1314
411727;201506;1950;5670;1519;4754;357;1224;496;1421;853;2645
411729;201506;550;1484;390;1187;130;423;80;205;210;628
411730;201506;5471;15782;4559;14038;1871;5900;1168;3610;3039;9510
411740;201506;622;1771;406;1267;69;242;143;416;212;658
411745;201506;925;2739;749;2375;162;551;232;708;394;1259
411750;201506;4646;13939;3490;11239;854;3052;807;2446;1661;5498
411760;201506;8100;23734;6956;21701;2266;7724;1944;5952;4210;13676
411770;201506;3413;11543;2851;10186;930;3579;560;1943;1490;5522
411780;201506;2606;8317;2479;8169;215;712;1928;6627;2143;7339
411790;201506;3044;8684;2215;7017;612;2235;695;2113;1307;4348
411800;201506;1451;4196;939;3048;137;510;170;455;307;965
411810;201506;1598;4693;1354;4204;306;1080;456;1269;762;2349
411820;201506;15331;48112;12603;42844;4387;15511;3251;11381;7638;26892
411830;201506;468;1251;369;1106;126;388;19;64;145;452
411840;201506;10291;29870;7683;24811;1974;6992;1692;5254;3666;12246
411845;201506;551;1695;368;1238;54;203;87;247;141;450
411850;201506;6584;19725;5467;17502;1429;4935;1563;4928;2992;9863
411860;201506;896;2771;728;2421;197;674;220;695;417;1369
411870;201506;926;3149;663;2424;108;458;166;564;274;1022
411880;201506;2203;6369;1794;5625;456;1669;446;1240;902;2909
411885;201506;864;2346;690;2012;134;492;220;553;354;1045
411890;201506;1167;3560;746;2528;117;455;107;287;224;742
411900;201506;971;3101;693;2409;178;626;107;377;285;1003
411910;201506;1255;4182;1002;3549;296;1138;277;905;573;2043
411915;201506;14415;40295;9405;29934;1928;6739;2187;6339;4115;13078
411920;201506;974;3291;844;2976;225;933;141;413;366;1346
411925;201506;598;1693;391;1296;98;330;105;329;203;659
411930;201506;6113;19980;5407;18637;2097;7708;1342;4542;3439;12250
411940;201506;3348;11138;2893;10173;770;2899;694;2337;1464;5236
411950;201506;11165;35549;9293;31826;2353;8755;4082;13764;6435;22519
411960;201506;5146;15407;4697;14552;1152;3974;2001;6022;3153;9996
411965;201506;606;1721;445;1455;86;333;160;534;246;867
411970;201506;777;2207;624;1966;177;608;218;677;395;1285
411980;201506;1568;4805;1343;4333;248;864;515;1651;763;2515
411990;201506;28589;93691;23952;83731;6634;25840;6674;22716;13308;48556
411995;201506;2632;8125;2257;7382;771;2861;547;1623;1318;4484
412000;201506;2173;5697;1720;4908;288;991;859;2218;1147;3209
412010;201506;708;2405;572;2092;122;466;119;406;241;872
412015;201506;660;1996;530;1714;102;347;251;808;353;1155
412020;201506;394;1132;266;854;64;234;98;284;162;518
412030;201506;707;2218;479;1679;76;304;121;377;197;681
412033;201506;741;2201;500;1618;96;357;121;346;217;703
412035;201506;1005;2770;690;2175;159;544;256;776;415;1320
412040;201506;612;1954;487;1663;109;404;165;527;274;931
412050;201506;1699;5000;1325;4253;267;968;285;878;552;1846
412060;201506;6664;22930;5987;21491;1849;7133;2037;7342;3886;14475
412065;201506;900;2701;705;2268;171;622;220;640;391;1262
412070;201506;1206;3275;962;2784;158;494;343;957;501;1451
412080;201506;1339;4122;775;2770;120;491;45;114;165;605
412085;201506;380;1095;155;523;39;145;36;106;75;251
412090;201506;4304;13918;4079;13511;677;2509;2615;8734;3292;11243
412100;201506;2087;6533;1757;5836;514;1866;485;1556;999;3422
412110;201506;1080;3085;724;2320;163;577;184;573;347;1150
412120;201506;1913;6464;1650;5843;443;1786;622;2000;1065;3786
412125;201506;777;2424;675;2240;147;529;265;853;412;1382
412130;201506;629;1884;464;1511;97;350;95;285;192;635
412135;201506;515;1454;356;1131;79;281;133;385;212;666
412140;201506;1576;4722;1279;4096;315;1080;303;940;618;2020
412150;201506;2941;8458;2470;7522;335;1182;1524;4516;1859;5698
412160;201506;1079;3430;656;2343;154;592;91;277;245;869
412170;201506;4451;13992;3601;12309;1047;3905;1280;4207;2327;8112
412175;201506;1338;4593;1155;4167;313;1258;465;1649;778;2907
412180;201506;1740;5375;1273;4439;329;1310;335;1091;664;2401
412190;201506;3109;9015;2344;7639;617;2208;668;2232;1285;4440
412200;201506;2288;7395;1580;5528;338;1304;495;1694;833;2998
412210;201506;724;2022;419;1377;79;306;56;172;135;478
412215;201506;3709;11420;3346;10772;665;2144;1980;6594;2645;8738
412217;201506;1096;3122;990;2937;132;492;676;1870;808;2362
412220;201506;5400;17877;5149;17408;1534;5404;2655;8999;4189;14403
412230;201506;2895;9614;2502;8823;638;2557;703;2310;1341;4867
412240;201506;9681;25031;5378;16765;1022;3621;939;2529;1961;6150
412250;201506;1913;5631;1628;5031;433;1492;349;914;782;2406
412260;201506;1310;3689;834;2650;133;501;281;806;414;1307
412265;201506;1043;3205;918;2989;202;770;433;1394;635;2164
412270;201506;800;2525;530;1848;111;439;134;428;245;867
412280;201506;603;1889;437;1521;200;747;45;146;245;893
412290;201506;1052;3009;808;2516;162;541;270;774;432;1315
412300;201506;1896;5725;1568;5073;462;1653;376;1174;838;2827
412310;201506;1094;3140;960;2933;124;401;568;1840;692;2241
412320;201506;803;2164;564;1731;123;430;193;571;316;1001
412330;201506;1675;4709;1274;3902;220;767;645;1932;865;2699
412340;201506;883;2754;575;1952;81;307;88;275;169;582
412350;201506;2456;7672;1983;6619;521;1882;255;725;776;2607
412360;201506;290;875;192;628;25;95;68;193;93;288
412370;201506;858;2637;681;2277;176;649;174;550;350;1199
412380;201506;1708;5338;1416;4657;354;1262;420;1310;774;2572
412382;201506;701;2011;482;1548;99;326;120;353;219;679
412385;201506;2465;7652;2163;6970;680;2288;557;1753;1237;4041
412390;201506;2191;6372;1974;6005;540;1829;745;2278;1285;4107
412395;201506;914;2572;729;2258;101;330;422;1289;523;1619
412400;201506;1028;3178;886;2892;257;892;249;821;506;1713
412402;201506;1963;5891;1587;5081;408;1461;365;983;773;2444
412405;201506;3619;10507;2251;7423;419;1586;234;647;653;2233
412410;201506;4867;15348;4172;14001;1328;5256;835;2566;2163;7822
412420;201506;392;1156;285;914;57;206;103;265;160;471
412430;201506;517;1449;390;1193;63;223;148;414;211;637
412440;201506;3541;10681;2894;9557;571;2063;1096;3637;1667;5700
412450;201506;320;1024;243;825;44;150;25;54;69;204
412460;201506;880;2595;642;2102;144;547;153;449;297;996
412470;201506;1877;6427;1639;5825;541;2002;521;1891;1062;3893
412480;201506;1367;4005;943;3066;194;669;126;321;320;990
412490;201506;939;2792;809;2517;162;539;240;679;402;1218
412500;201506;2006;5820;1674;5160;368;1271;427;1123;795;2394
412510;201506;2318;7713;1974;6860;541;2030;824;2843;1365;4873
412520;201506;1573;4466;1211;3724;320;1055;301;855;621;1910
412530;201506;691;2013;545;1681;120;379;142;406;262;785
412535;201506;614;1813;387;1268;90;312;79;228;169;540
412540;201506;1200;3461;930;2902;142;511;276;840;418;1351
412545;201506;862;2457;660;1989;109;385;222;559;331;944
412550;201506;27727;83130;18816;63054;4902;17703;3549;11026;8451;28729
412555;201506;328;991;224;744;44;165;43;114;87;279
412560;201506;5319;16808;4180;14381;1007;3984;986;3084;1993;7068
412570;201506;4414;13169;3050;10064;703;2643;568;1750;1271;4393
412575;201506;913;2786;712;2307;164;595;188;554;352;1149
412580;201506;1306;3605;941;2957;198;653;275;813;473;1466
412590;201506;430;1279;294;976;66;253;82;255;148;508
412600;201506;1447;4382;1127;3678;260;952;350;1052;610;2004
412610;201506;701;2107;485;1554;115;423;146;414;261;837
412620;201506;1194;3850;932;3269;252;998;146;449;398;1447
412625;201506;10904;30387;8175;25110;2017;6757;1505;4174;3522;10931
412627;201506;992;2990;664;2282;198;734;71;219;269;953
412630;201506;3334;10618;2807;9464;663;2337;876;2840;1539;5177
412635;201506;464;1402;309;1044;68;244;22;60;90;304
412640;201506;914;2711;614;2021;116;406;67;176;183;582
412650;201506;2000;5852;1633;5126;375;1349;524;1429;899;2778
412660;201506;2932;8552;2275;7187;454;1623;432;1208;886;2831
412665;201506;649;1682;339;1078;89;290;67;204;156;494
412667;201506;1569;4646;1231;3952;306;1092;248;729;554;1821
412670;201506;679;2115;460;1591;110;435;77;214;187;649
412680;201506;1365;4112;873;2981;162;610;224;679;386;1289
412690;201506;745;2285;555;1866;190;679;109;354;299;1033
412700;201506;1901;5872;1589;5390;565;2176;467;1509;1032;3685
412710;201506;8153;25439;6770;22555;1675;6187;1644;5108;3319;11295
412720;201506;1482;4597;1008;3369;184;673;185;495;369;1168
412730;201506;2301;6822;1454;4865;317;1192;178;432;495;1624
412740;201506;1484;4677;1152;3956;293;1128;218;738;511;1866
412750;201506;3828;11964;3400;11239;567;2244;2090;6726;2657;8970
412760;201506;2335;7665;2217;7465;562;2205;1122;3574;1684;5779
412770;201506;11664;32499;6795;21869;1117;4005;1261;3479;2378;7484
412780;201506;1290;4122;1125;3778;286;1032;391;1236;677;2268
412785;201506;2348;6849;1721;5522;435;1552;762;2370;1197;3922
412788;201506;1436;4594;1280;4271;279;1065;454;1337;733;2402
412790;201506;1193;3580;929;3043;210;765;228;655;438;1420
412795;201506;886;2483;730;2185;184;574;238;690;422;1264
412796;201506;2873;8905;2645;8473;684;2483;1063;3172;1747;5655
412800;201506;3250;9254;2429;7589;486;1705;803;2384;1289;4089
412810;201506;10776;29607;6025;19145;991;3513;1252;3291;2243;6804
412820;201506;7029;20711;5076;16855;1268;4579;1092;3635;2360;8214
412830;201506;347;1083;276;923;50;213;85;244;135;457
412840;201506;1955;5588;1558;4805;320;1100;364;1029;684;2129
412850;201506;2589;7768;2208;7138;429;1640;936;2823;1365;4463
412853;201506;1585;4506;1406;4175;155;573;818;2248;973;2821
412855;201506;1534;4391;1178;3628;303;1055;320;866;623;1921
412860;201506;1235;3562;1014;3144;216;750;438;1317;654;2067
412862;201506;788;2034;538;1544;85;267;201;533;286;800
412863;201506;1272;4264;1226;4187;189;700;845;2876;1034;3576
412865;201506;703;2162;522;1733;120;414;192;651;312;1065
412870;201506;921;2606;736;2303;242;832;173;505;415;1337
412880;201506;1085;3026;847;2602;210;716;222;604;432;1320
420005;201506;553;1653;365;1226;70;251;130;423;200;674
420010;201506;3249;9498;2649;8596;371;1289;1870;6191;2241;7480
420020;201506;808;2613;472;1711;64;276;55;165;119;441
420030;201506;543;1462;286;967;62;247;46;146;108;393
420040;201506;848;2612;534;1946;122;491;72;199;194;690
420050;201506;700;2139;509;1702;155;542;180;577;335;1119
420055;201506;241;739;148;513;30;112;24;68;54;180
420060;201506;248;843;173;645;43;182;25;83;68;265
420070;201506;1403;4473;1111;3762;177;660;547;1867;724;2527
420075;201506;197;567;107;356;22;86;32;95;54;181
420080;201506;641;2028;506;1746;164;610;121;408;285;1018
420090;201506;561;1910;400;1532;103;430;63;238;166;668
420100;201506;1338;4214;1205;4027;285;998;690;2313;975;3311
420110;201506;365;1218;323;1127;89;329;133;462;222;791
420120;201506;317;1098;269;999;90;371;63;215;153;586
420125;201506;311;1209;284;1148;93;396;98;371;191;767
420127;201506;551;1654;220;816;66;259;28;100;94;359
420130;201506;1986;6608;1645;5927;414;1640;480;1539;894;3179
420140;201506;5406;15818;3737;12609;956;3598;651;1967;1607;5565
420150;201506;776;2156;464;1515;100;364;156;454;256;818
420160;201506;304;869;192;627;34;124;52;156;86;280
420165;201506;218;690;134;468;25;99;33;103;58;202
420170;201506;213;650;139;504;46;207;19;45;65;252
420180;201506;437;1350;252;911;47;177;47;164;94;341
420190;201506;515;1541;276;986;50;203;45;137;95;340
420195;201506;1446;4165;1138;3670;291;1004;446;1433;737;2437
420200;201506;3023;9770;1897;7116;523;2219;301;997;824;3216
420205;201506;965;3191;843;2973;195;751;416;1460;611;2211
420207;201506;1539;4512;1058;3488;302;1131;256;752;558;1883
420208;201506;557;1560;334;1146;107;392;97;330;204;722
420209;201506;341;1074;213;761;40;163;68;227;108;390
420210;201506;1682;5137;1065;4011;236;1067;247;876;483;1943
420213;201506;853;3037;807;2926;153;581;508;1875;661;2456
420215;201506;417;1354;281;1013;76;299;44;145;120;444
420220;201506;201;700;179;656;46;197;62;175;108;372
420230;201506;4344;12880;3187;10720;663;2620;1375;4417;2038;7037
420240;201506;12643;34581;7591;25097;1243;5044;3061;8984;4304;14028
420243;201506;620;1898;491;1624;106;402;171;540;277;942
420245;201506;1160;3509;771;2672;170;659;192;580;362;1239
420250;201506;607;1962;572;1902;165;646;251;800;416;1446
420253;201506;571;1521;456;1359;79;250;252;785;331;1035
420257;201506;356;993;216;729;38;137;107;357;145;494
420260;201506;1291;4084;1083;3715;246;955;481;1648;727;2603
420270;201506;529;1625;157;577;28;116;35;109;63;225
420280;201506;2377;6339;1416;4557;280;1070;506;1454;786;2524
420285;201506;151;445;64;233;6;19;4;17;10;36
420287;201506;597;1837;503;1661;134;459;172;567;306;1026
420290;201506;6799;19988;4360;14442;897;3275;1281;3867;2178;7142
420300;201506;6617;20052;4289;15003;967;3758;809;2753;1776;6511
420310;201506;813;2331;749;2231;132;427;498;1440;630;1867
420315;201506;999;3222;791;2788;215;851;296;1012;511;1863
420320;201506;5542;17142;4557;15352;1274;4753;1812;5984;3086;10737
420325;201506;358;1174;335;1122;81;301;127;408;208;709
420330;201506;1122;3897;854;3177;219;901;211;678;430;1579
420340;201506;1499;4625;1122;3753;244;906;202;599;446;1505
420350;201506;1455;4462;1161;3874;291;1041;446;1462;737;2503
420360;201506;3316;10153;2180;7604;591;2330;288;824;879;3154
420370;201506;2003;5598;1589;4904;168;532;1255;3871;1423;4403
420380;201506;5318;16970;3810;13347;981;3789;921;3085;1902;6874
420390;201506;1731;4926;921;3178;187;744;199;566;386;1310
420395;201506;1647;5109;1129;3919;187;741;173;490;360;1231
420400;201506;1382;4044;964;3208;261;1037;255;747;516;1784
420410;201506;804;2150;546;1721;132;464;293;906;425;1370
420415;201506;482;1535;357;1225;115;420;104;339;219;759
420417;201506;798;2533;671;2221;114;397;348;1149;462;1546
420419;201506;411;1258;269;974;114;458;40;138;154;596
420420;201506;12307;36792;9405;30929;2904;10755;2531;7648;5435;18403
420425;201506;1377;3782;885;2782;96;369;366;1043;462;1412
420430;201506;3538;10791;2287;7899;523;2004;749;2516;1272;4520
420435;201506;307;934;201;697;41;173;97;318;138;491
420440;201506;1247;3501;657;2221;259;957;109;336;368;1293
420445;201506;338;1027;282;910;54;168;136;444;190;612
420450;201506;1123;3193;636;2167;123;460;138;402;261;862
420455;201506;2055;6245;1786;5776;345;1353;855;2678;1200;4031
420460;201506;9279;27446;6959;23286;1646;6418;2615;8273;4261;14691
420470;201506;1240;3338;762;2418;189;689;203;572;392;1261
420475;201506;130;391;68;240;19;69;9;27;28;96
420480;201506;4917;14495;3843;12553;1421;5196;545;1654;1966;6850
420490;201506;746;2015;429;1453;112;411;107;339;219;750
420500;201506;1873;5843;1459;5044;446;1718;623;2093;1069;3811
420510;201506;118;477;106;449;42;182;38;155;80;337
420515;201506;121;411;98;364;19;82;17;65;36;147
420517;201506;917;2806;802;2600;140;505;453;1435;593;1940
420519;201506;481;1320;351;1073;57;180;109;312;166;492
420520;201506;682;1731;472;1453;114;393;242;703;356;1096
420530;201506;1196;3958;902;3244;211;861;210;626;421;1487
420535;201506;281;848;158;572;45;192;9;25;54;217
420540;201506;22381;64719;15764;50291;4136;14535;4295;12262;8431;26797
420543;201506;428;1137;316;947;30;109;194;616;224;725
420545;201506;1691;5277;1353;4556;319;1238;439;1352;758;2590
420550;201506;4519;14452;3426;12015;860;3552;736;2225;1596;5777
420555;201506;448;1373;350;1173;103;389;110;339;213;728
420560;201506;572;1655;475;1470;83;270;238;726;321;996
420570;201506;2086;6729;1635;5666;459;1809;515;1647;974;3456
420580;201506;1357;4301;1094;3840;301;1192;459;1570;760;2762
420590;201506;3320;10117;2216;7531;491;1809;373;1110;864;2919
420600;201506;841;2777;758;2597;148;538;360;1275;508;1813
420610;201506;569;1775;341;1252;96;387;72;248;168;635
420620;201506;852;2610;718;2370;221;786;217;709;438;1495
420630;201506;1119;3473;786;2687;175;647;245;736;420;1383
420640;201506;752;2290;357;1324;87;359;24;71;111;430
420650;201506;2499;7255;1451;4958;257;1000;281;822;538;1822
420660;201506;524;1507;418;1306;79;285;192;578;271;863
420665;201506;787;2203;491;1611;82;283;138;406;220;689
420670;201506;1760;5351;1230;4182;239;945;251;737;490;1682
420675;201506;226;692;156;530;29;105;54;170;83;275
420680;201506;540;1315;326;983;63;214;108;301;171;515
420690;201506;898;3102;643;2374;117;446;153;513;270;959
420700;201506;3725;10717;2808;8849;644;2368;864;2531;1508;4899
420710;201506;615;2068;478;1789;139;582;158;558;297;1140
420720;201506;1685;4917;1352;4472;295;1053;822;2735;1117;3788
420730;201506;3520;10548;2856;9353;757;2718;1113;3470;1870;6188
420740;201506;865;2673;712;2387;226;808;323;1050;549;1858
420750;201506;2426;7669;1655;5821;298;1241;497;1508;795;2749
420757;201506;114;297;63;221;12;54;25;77;37;131
420760;201506;351;1077;236;775;47;180;56;150;103;330
420765;201506;591;1853;302;1118;57;237;52;167;109;404
420768;201506;1225;4264;949;3640;312;1268;321;1208;633;2476
420770;201506;711;2043;372;1303;74;307;87;272;161;579
420775;201506;719;2240;448;1533;126;447;96;300;222;747
420780;201506;1672;5058;1044;3497;255;928;202;599;457;1527
420785;201506;332;1005;237;757;38;137;76;216;114;353
420790;201506;1359;4673;1069;3959;294;1201;416;1440;710;2641
420800;201506;831;2381;447;1490;129;501;89;258;218;759
420810;201506;2432;8278;1912;7070;601;2532;472;1642;1073;4174
420820;201506;8679;27032;6213;22695;1806;7467;1791;6431;3597;13898
420830;201506;2625;8413;2190;7618;729;2766;758;2576;1487;5342
420840;201506;1051;3085;594;2140;156;628;138;433;294;1061
420845;201506;1392;4308;1033;3628;308;1243;239;762;547;2005
420850;201506;1784;5628;1065;4059;276;1203;150;546;426;1749
420860;201506;508;1423;321;1073;91;355;128;413;219;768
420870;201506;1240;3436;940;2998;321;1196;291;813;612;2009
420880;201506;1199;3972;924;3257;201;795;192;583;393;1378
420890;201506;13450;32690;5853;18653;1036;3719;1547;4176;2583;7895
420895;201506;244;665;123;399;33;103;13;35;46;138
420900;201506;2176;6038;1291;4296;274;1046;320;938;594;1984
420910;201506;21939;65374;14206;49364;2899;11591;4148;13313;7047;24904
420915;201506;588;2299;460;1935;113;521;213;856;326;1377
420917;201506;469;1442;222;713;52;200;84;217;136;417
420920;201506;199;558;90;305;28;99;13;41;41;140
420930;201506;19280;55464;15091;48331;3756;13438;5250;16191;9006;29629
420940;201506;4082;12208;3266;10465;862;3141;724;1933;1586;5074
420945;201506;216;691;138;502;31;135;31;104;62;239
420950;201506;631;1780;284;1063;39;185;36;115;75;300
420960;201506;1129;3271;939;2962;211;804;441;1275;652;2079
420970;201506;2532;8091;2195;7480;619;2412;827;2772;1446;5184
420980;201506;462;1369;339;1162;114;417;132;501;246;918
420985;201506;526;1511;264;937;56;239;73;234;129;473
420990;201506;908;2517;528;1808;102;409;163;494;265;903
421000;201506;592;2027;387;1489;83;358;65;205;148;563
421003;201506;712;1942;276;912;36;129;42;85;78;214
421005;201506;219;684;175;609;47;182;88;299;135;481
421010;201506;6065;17528;4180;14012;1128;4284;968;2863;2096;7147
421020;201506;523;1657;403;1424;67;239;199;743;266;982
421030;201506;953;3462;878;3277;260;1038;215;801;475;1839
421040;201506;743;2102;580;1827;130;465;278;829;408;1294
421050;201506;2013;5419;1145;3720;273;999;254;666;527;1665
421055;201506;238;718;138;471;35;129;38;102;73;231
421060;201506;514;1784;376;1386;75;308;129;444;204;752
421070;201506;772;2427;495;1746;107;434;111;371;218;805
421080;201506;552;1651;471;1521;99;332;278;878;377;1210
421085;201506;579;1526;305;1030;63;245;83;287;146;532
421090;201506;422;1188;249;809;41;148;99;292;140;440
421100;201506;936;2665;564;1854;147;501;116;344;263;845
421105;201506;1507;4642;1254;4194;296;1090;467;1575;763;2665
421110;201506;1190;4189;1057;3922;385;1534;261;909;646;2443
421120;201506;1560;4928;1071;3740;181;752;315;967;496;1719
421125;201506;426;1220;313;1014;94;349;102;294;196;643
421130;201506;3647;11916;3054;10814;1049;4155;966;3378;2015;7533
421140;201506;375;1115;291;933;59;202;100;292;159;494
421145;201506;591;1885;402;1368;64;239;162;533;226;772
421150;201506;567;1767;425;1518;98;387;169;598;267;985
421160;201506;1246;3535;629;2115;118;462;226;722;344;1184
421165;201506;290;1005;224;804;42;150;101;367;143;517
421170;201506;1566;4668;1272;4167;277;1010;750;2435;1027;3445
421175;201506;1262;3601;943;3091;218;905;370;1074;588;1979
421180;201506;626;1742;330;1114;83;324;87;244;170;568
421185;201506;429;1202;300;951;56;171;147;487;203;658
421187;201506;318;945;234;768;48;167;108;339;156;506
421189;201506;465;1424;403;1301;85;301;144;430;229;731
421190;201506;11679;34026;7183;24604;1655;6153;1521;4832;3176;10985
421200;201506;989;3277;834;2936;194;764;245;775;439;1539
421205;201506;251;776;186;649;44;181;46;133;90;314
421210;201506;1679;5122;1278;4128;340;1179;357;1087;697;2266
421220;201506;2173;7327;1877;6688;596;2339;453;1544;1049;3883
421223;201506;766;2202;502;1710;124;455;184;609;308;1064
421225;201506;1161;3629;959;3218;224;839;351;1142;575;1981
421227;201506;812;2691;712;2532;158;569;454;1652;612;2221
421230;201506;596;1961;522;1795;134;512;207;650;341;1162
421240;201506;479;1548;273;964;33;138;54;169;87;307
421250;201506;1867;5421;1191;4189;366;1443;277;898;643;2341
421260;201506;389;1118;120;451;25;95;29;101;54;196
421265;201506;609;1955;524;1793;122;443;206;688;328;1131
421270;201506;828;2239;430;1427;110;391;99;355;209;746
421280;201506;1690;5331;1357;4791;425;1680;460;1600;885;3280
421290;201506;1671;4399;887;2849;177;608;177;460;354;1068
421300;201506;315;961;251;826;77;292;96;294;173;586
421310;201506;317;1034;249;860;60;218;78;252;138;470
421315;201506;403;1193;227;811;42;155;24;86;66;241
421320;201506;546;1774;349;1253;60;230;44;108;104;338
421330;201506;576;1907;442;1648;158;670;70;250;228;920
421335;201506;594;1923;469;1679;114;452;95;353;209;805
421340;201506;1817;5275;1477;4720;213;834;894;2786;1107;3620
421350;201506;919;3022;729;2609;173;717;246;804;419;1521
421360;201506;3177;9145;1998;6834;424;1666;577;1798;1001;3464
421370;201506;815;2689;646;2314;185;750;213;718;398;1468
421380;201506;1072;3050;849;2624;160;553;398;1212;558;1765
421390;201506;148;432;78;267;12;38;34;122;46;160
421400;201506;321;1133;242;952;76;333;64;235;140;568
421410;201506;338;971;234;765;34;113;118;383;152;496
421415;201506;360;1194;173;642;45;177;40;127;85;304
421420;201506;954;2896;673;2236;137;501;176;512;313;1013
421430;201506;249;781;184;649;36;142;42;143;78;285
421440;201506;912;2615;596;2029;152;581;233;747;385;1328
421450;201506;584;1838;389;1419;95;389;60;192;155;581
421460;201506;651;1768;328;1151;57;240;77;255;134;495
421470;201506;456;1572;366;1366;99;400;139;503;238;903
421480;201506;2843;8160;1696;5961;390;1615;367;1101;757;2716
421490;201506;299;928;136;526;39;171;25;83;64;254
421500;201506;2386;8095;2012;7299;705;2908;393;1338;1098;4246
421505;201506;399;1336;350;1228;79;299;163;555;242;854
421507;201506;606;1856;396;1382;75;273;136;492;211;765
421510;201506;213;712;186;664;38;171;90;273;128;444
421520;201506;861;2289;555;1656;58;214;266;707;324;921
421530;201506;423;1295;243;890;41;188;80;286;121;474
421535;201506;726;2159;416;1498;76;307;178;590;254;897
421540;201506;376;1035;301;899;65;214;125;357;190;571
421545;201506;1047;3444;784;2898;215;930;181;602;396;1532
421550;201506;2050;6631;1734;6042;521;2096;479;1524;1000;3620
421555;201506;344;1040;138;501;24;96;19;64;43;160
421560;201506;204;615;88;312;23;94;21;72;44;166
421565;201506;979;2942;872;2770;324;1155;334;1007;658;2162
421567;201506;881;3228;755;2911;359;1440;149;558;508;1998
421568;201506;538;1685;368;1284;93;337;93;323;186;660
421569;201506;187;580;108;397;26;110;26;82;52;192
421570;201506;1376;4239;733;2649;198;802;153;524;351;1326
421575;201506;513;1713;449;1584;75;291;279;980;354;1271
421580;201506;3674;11576;2776;9576;752;2988;677;2017;1429;5005
421590;201506;239;743;191;648;29;99;101;339;130;438
421600;201506;610;1818;462;1512;122;434;101;294;223;728
421605;201506;634;1912;447;1550;90;370;119;364;209;734
421610;201506;1610;4365;1271;3800;194;677;700;2000;894;2677
421620;201506;4974;15014;3369;11643;998;3758;1063;3654;2061;7412
421625;201506;383;1112;181;626;28;101;40;142;68;243
421630;201506;2853;8467;1587;5444;377;1449;227;660;604;2109
421635;201506;274;829;165;552;23;90;82;252;105;342
421640;201506;1094;3296;831;2755;166;565;367;1171;533;1736
421650;201506;2260;7348;1847;6423;607;2404;291;850;898;3254
421660;201506;8892;28377;6949;24436;1868;7407;2172;7077;4040;14484
421670;201506;1111;3448;770;2669;230;881;208;681;438;1562
421680;201506;1257;4124;1081;3704;367;1338;211;672;578;2010
421690;201506;1931;6277;1462;5135;330;1289;212;657;542;1946
421700;201506;628;1817;334;1145;73;306;96;241;169;547
421710;201506;278;926;154;567;49;188;43;153;92;341
421715;201506;280;756;155;495;42;145;43;123;85;268
421720;201506;1824;5485;1172;4130;362;1417;260;841;622;2258
421725;201506;114;382;103;357;36;138;25;85;61;223
421730;201506;591;1708;272;948;52;195;54;150;106;345
421740;201506;748;2326;504;1744;113;468;99;240;212;708
421750;201506;1206;3317;795;2490;153;527;351;1012;504;1539
421755;201506;359;1085;238;786;53;204;74;219;127;423
421760;201506;677;2190;370;1343;75;306;125;428;200;734
421770;201506;3138;9355;2361;7785;695;2441;766;2522;1461;4963
421775;201506;612;1762;398;1373;85;315;119;385;204;700
421780;201506;1462;4828;1096;4011;316;1301;399;1373;715;2674
421790;201506;946;2580;542;1892;143;583;161;508;304;1091
421795;201506;361;1068;232;744;36;136;69;215;105;351
421800;201506;2714;8214;2029;6888;451;1769;822;2567;1273;4336
421810;201506;734;2324;545;1916;145;537;78;259;223;796
421820;201506;1178;3438;754;2563;131;494;172;516;303;1010
421825;201506;1527;4955;1419;4701;228;893;857;2701;1085;3594
421830;201506;2627;8965;2378;8470;551;2219;1135;3923;1686;6142
421835;201506;153;451;112;389;26;117;63;199;89;316
421840;201506;380;1243;299;1051;75;299;102;329;177;628
421850;201506;495;1463;305;1045;79;311;82;275;161;586
421860;201506;365;1119;228;821;38;145;46;143;84;288
421870;201506;4812;13583;3269;10468;922;3174;617;1887;1539;5061
421875;201506;442;1309;190;704;40;169;32;108;72;277
421880;201506;998;3103;759;2581;176;683;196;617;372;1300
421885;201506;335;1072;268;939;82;314;92;303;174;617
421890;201506;997;3336;840;3008;263;1081;275;929;538;2010
421895;201506;380;1243;338;1163;74;253;192;691;266;944
421900;201506;834;2575;620;2072;168;588;167;496;335;1084
421910;201506;554;1742;390;1376;81;337;102;307;183;644
421915;201506;579;1739;375;1246;72;247;103;299;175;546
421917;201506;584;1753;436;1502;125;520;147;463;272;983
421920;201506;819;2293;540;1908;236;884;178;624;414;1508
421930;201506;3465;9356;2060;6819;511;1901;384;1118;895;3019
421935;201506;795;2684;605;2256;140;596;213;743;353;1339
421940;201506;279;951;165;616;32;140;32;87;64;227
421950;201506;4193;11604;2126;7196;559;2026;354;1151;913;3177
421960;201506;241;739;189;621;46;164;46;131;92;295
421970;201506;2275;6531;1461;4766;519;1790;316;929;835;2719
421985;201506;512;1321;270;831;48;174;75;236;123;410
422000;201506;989;2940;807;2599;198;695;344;1127;542;1822
430003;201506;858;2500;665;2161;187;688;199;623;386;1311
430005;201506;288;907;237;801;45;163;129;423;174;586
430010;201506;2190;5975;1608;4956;405;1310;646;2013;1051;3323
430020;201506;794;1988;655;1789;80;252;457;1193;537;1445
430030;201506;1125;2942;846;2441;284;902;177;456;461;1358
430040;201506;11967;31003;9397;26652;2760;8337;2446;6657;5206;14994
430045;201506;761;2083;593;1742;114;361;297;848;411;1209
430047;201506;278;695;163;497;24;66;68;208;92;274
430050;201506;1192;3207;694;2190;132;450;182;533;314;983
430055;201506;311;859;181;562;29;100;83;244;112;344
430057;201506;73;163;27;73;5;13;6;11;11;24
430060;201506;16294;52403;14099;48492;3960;14428;6417;22407;10377;36835
430063;201506;1043;3065;844;2648;215;705;418;1340;633;2045
430064;201506;1620;4741;1316;4221;325;1067;591;1925;916;2992
430066;201506;176;439;129;365;11;40;74;194;85;234
430070;201506;602;1606;237;764;54;197;64;172;118;369
430080;201506;729;2125;476;1634;103;396;136;422;239;818
430085;201506;796;2136;531;1669;119;430;199;612;318;1042
430087;201506;1058;3202;990;3087;125;438;691;2087;816;2525
430090;201506;887;2335;326;1074;38;145;54;182;92;327
430100;201506;939;2507;561;1718;150;512;166;441;316;953
430105;201506;950;2865;666;2317;190;745;196;647;386;1392
430107;201506;268;884;194;673;41;155;56;179;97;334
430110;201506;1916;5499;1598;4995;452;1505;693;2124;1145;3629
430120;201506;1714;5085;1313;4249;263;897;691;2201;954;3098
430130;201506;4057;10583;3515;9787;697;2101;1798;4916;2495;7017
430140;201506;1289;3905;887;3013;257;901;281;927;538;1828
430150;201506;880;2332;585;1784;145;479;154;452;299;931
430155;201506;459;1316;282;945;39;140;109;355;148;495
430160;201506;16589;48714;14985;46046;2872;9772;8201;25149;11073;34921
430163;201506;1905;5670;1570;5049;289;1064;756;2434;1045;3498
430165;201506;461;1143;142;465;31;110;40;120;71;230
430170;201506;919;2578;383;1347;64;224;56;165;120;389
430175;201506;972;3061;782;2605;205;648;327;1170;532;1818
430180;201506;966;2618;786;2312;172;569;418;1175;590;1744
430185;201506;789;1966;406;1229;61;194;115;295;176;489
430187;201506;685;2030;516;1663;126;475;179;521;305;996
430190;201506;1788;5320;1554;4866;316;1134;882;2700;1198;3834
430192;201506;197;597;88;279;6;19;21;58;27;77
430195;201506;330;1006;84;298;9;33;5;19;14;52
430200;201506;1730;5495;1455;4917;414;1482;349;1160;763;2642
430205;201506;522;1498;394;1261;46;176;271;856;317;1032
430210;201506;6646;17818;3601;11371;725;2478;759;2181;1484;4659
430215;201506;372;1043;248;778;51;168;95;284;146;452
430220;201506;791;1981;312;1011;48;167;57;175;105;342
430222;201506;311;931;238;766;39;160;107;319;146;479
430223;201506;351;1018;306;952;69;219;182;586;251;805
430225;201506;47;126;27;83;6;16;8;20;14;36
430230;201506;1908;5718;1781;5589;213;517;1523;4984;1736;5501
430235;201506;290;944;229;795;61;234;60;185;121;419
430237;201506;537;1414;396;1164;45;153;251;718;296;871
430240;201506;998;2615;660;2028;143;519;273;779;416;1298
430245;201506;959;2993;737;2515;184;649;343;1207;527;1856
430250;201506;1420;3966;1240;3649;491;1531;288;827;779;2358
430258;201506;167;473;123;392;12;44;51;162;63;206
430260;201506;856;2404;579;1848;60;208;310;1019;370;1227
430265;201506;341;1043;262;868;66;216;30;82;96;298
430270;201506;3001;8397;2587;7718;431;1546;1510;4251;1941;5797
430280;201506;4703;12974;3870;11467;922;2878;1772;5219;2694;8097
430290;201506;2520;6657;2294;6355;181;520;1958;5473;2139;5993
430300;201506;9758;28800;7942;25312;2225;7561;3200;10437;5425;17998
430310;201506;7183;22097;5845;19536;1593;5808;2232;7056;3825;12864
430320;201506;896;2602;595;1984;116;344;287;1016;403;1360
430330;201506;795;2113;623;1780;170;500;268;702;438;1202
430340;201506;790;1987;445;1471;84;316;216;713;300;1029
430350;201506;6435;19979;5422;17813;1912;6617;1824;5860;3736;12477
430355;201506;374;927;145;441;31;102;19;46;50;148
430360;201506;1107;2889;909;2517;166;516;436;1123;602;1639
430367;201506;317;825;198;614;48;168;59;177;107;345
430370;201506;511;1460;384;1212;110;388;88;240;198;628
430380;201506;887;2267;464;1479;122;418;148;475;270;893
430390;201506;4585;13140;3203;10290;751;2592;707;2167;1458;4759
430400;201506;1460;3487;1011;2781;304;905;377;948;681;1853
430410;201506;712;1896;526;1581;96;300;256;775;352;1075
430420;201506;4113;11804;3164;9731;830;2663;1290;3903;2120;6566
430430;201506;844;2298;529;1698;154;529;139;430;293;959
430435;201506;2035;5511;1563;4668;351;1137;756;2228;1107;3365
430440;201506;4339;13467;3383;11357;658;2341;1607;5596;2265;7937
430450;201506;7842;21906;6112;18527;2165;6915;1429;4325;3594;11240
430460;201506;29353;86588;22436;74008;6268;22600;7480;24425;13748;47025
430461;201506;514;1389;163;511;26;87;34;99;60;186
430462;201506;316;908;232;759;84;302;58;175;142;477
430463;201506;4184;13292;3619;12230;822;3026;1783;6048;2605;9074
430465;201506;655;1767;548;1582;128;409;293;811;421;1220
430466;201506;3756;10421;3316;9729;648;2121;1913;5456;2561;7577
430467;201506;591;1744;510;1608;106;367;233;701;339;1068
430468;201506;1487;4212;1303;3938;443;1442;456;1345;899;2787
430469;201506;294;833;70;253;9;41;15;45;24;86
430470;201506;7747;20645;5437;16679;1612;5340;1026;3021;2638;8361
430471;201506;846;2773;760;2593;246;868;183;642;429;1510
430480;201506;1105;2906;572;1819;87;301;137;375;224;676
430485;201506;227;655;109;370;19;70;36;121;55;191
430490;201506;472;1334;328;1066;88;305;118;381;206;686
430495;201506;410;1209;260;891;46;173;57;179;103;352
430500;201506;1374;3792;1101;3322;325;1114;457;1325;782;2439
430510;201506;21000;62288;17027;54646;5877;20720;4851;14491;10728;35211
430511;201506;448;1361;197;679;20;77;29;83;49;160
430512;201506;1245;3226;1069;2921;277;797;374;1058;651;1855
430513;201506;770;2095;496;1510;97;303;219;668;316;971
430515;201506;517;1513;382;1225;68;222;193;620;261;842
430517;201506;1387;4396;1173;3953;238;828;679;2299;917;3127
430520;201506;1667;4623;1180;3622;313;1048;405;1146;718;2194
430530;201506;1007;2825;529;1714;84;316;139;407;223;723
430535;201506;2235;6864;1736;5827;399;1524;616;1986;1015;3510
430537;201506;516;1614;437;1452;56;187;309;1045;365;1232
430540;201506;797;1783;529;1418;97;270;310;820;407;1090
430543;201506;545;1410;479;1342;94;290;344;969;438;1259
430544;201506;716;2264;596;2007;120;434;310;1021;430;1455
430545;201506;1335;4274;1148;4045;387;1407;521;1941;908;3348
430550;201506;699;2027;453;1500;101;367;147;469;248;836
430558;201506;88;256;43;150;15;65;6;14;21;79
430560;201506;427;1050;247;735;27;89;82;232;109;321
430570;201506;1192;3043;757;2190;190;661;308;762;498;1423
430580;201506;1341;3425;775;2444;202;682;246;779;448;1461
430583;201506;162;445;54;180;4;15;4;13;8;28
430585;201506;373;974;242;695;62;206;103;260;165;466
430587;201506;227;688;193;623;56;193;62;205;118;398
430590;201506;1383;3858;1307;3736;189;602;950;2696;1139;3298
430593;201506;29;112;26;101;7;35;11;37;18;72
430595;201506;265;721;93;320;18;73;16;52;34;125
430597;201506;359;1046;257;809;46;166;74;189;120;355
430600;201506;2251;6089;1307;3996;253;829;427;1253;680;2082
430605;201506;1377;4171;1092;3590;241;889;432;1420;673;2309
430607;201506;827;2023;598;1671;89;257;359;1033;448;1290
430610;201506;8857;23558;6709;20138;1807;5934;2260;6715;4067;12649
430613;201506;267;648;116;347;28;76;25;62;53;138
430620;201506;775;2222;604;1862;152;509;247;708;399;1217
430630;201506;474;1445;234;776;47;153;34;97;81;250
430632;201506;761;2083;435;1352;79;283;192;542;271;825
430635;201506;707;1935;514;1567;107;359;249;745;356;1104
430637;201506;515;1476;453;1350;65;233;290;826;355;1059
430640;201506;1750;4605;771;2485;74;238;100;212;174;450
430642;201506;515;1351;309;972;55;183;122;375;177;558
430645;201506;250;622;102;307;19;57;23;74;42;131
430650;201506;1931;6260;1655;5705;346;1222;927;3268;1273;4490
430655;201506;202;575;170;509;33;111;71;176;104;287
430660;201506;5853;16524;4590;14295;1190;4045;1819;5614;3009;9659
430670;201506;520;1527;466;1423;37;110;353;1117;390;1227
430673;201506;723;1719;368;1112;86;270;139;411;225;681
430675;201506;293;854;130;419;24;85;48;145;72;230
430676;201506;3641;10957;3063;9942;839;2931;1074;3502;1913;6433
430680;201506;1169;3420;809;2641;159;575;264;762;423;1337
430690;201506;4523;12706;3594;10895;1134;3560;1071;3283;2205;6843
430692;201506;310;1017;223;844;27;107;138;513;165;620
430693;201506;1453;4038;970;3031;169;633;272;759;441;1392
430695;201506;559;1590;396;1250;81;298;156;440;237;738
430697;201506;491;1390;377;1191;110;344;143;486;253;830
430700;201506;9870;25556;4611;15215;860;3161;346;1086;1206;4247
430705;201506;306;924;268;861;84;296;77;219;161;515
430710;201506;1862;4721;1395;3937;308;943;572;1631;880;2574
430720;201506;929;2275;614;1816;157;510;224;657;381;1167
430730;201506;1775;4704;1237;3813;317;961;507;1635;824;2596
430740;201506;596;1652;347;1137;95;331;59;179;154;510
430745;201506;547;1536;296;910;51;178;60;159;111;337
430750;201506;1825;5002;1437;4319;304;1011;680;1942;984;2953
430755;201506;589;1552;379;1101;45;150;159;412;204;562
430760;201506;3337;8194;2332;6719;468;1547;1049;3113;1517;4660
430770;201506;6922;19879;5358;16968;1036;3575;2752;8643;3788;12218
430780;201506;2550;6728;1488;4682;303;1043;471;1424;774;2467
430781;201506;596;1724;409;1345;98;338;123;386;221;724
430783;201506;572;1411;381;1092;70;227;179;472;249;699
430786;201506;84;268;60;202;11;37;23;78;34;115
430790;201506;4702;12806;3175;9717;704;2414;1210;3422;1914;5836
430800;201506;881;2563;591;1877;123;426;200;598;323;1024
430805;201506;531;1467;366;1158;52;161;191;625;243;786
430807;201506;432;1245;291;925;58;216;83;244;141;460
430810;201506;776;2122;378;1236;63;229;69;198;132;427
430820;201506;1276;3946;880;2959;207;754;256;826;463;1580
430825;201506;441;1181;195;597;36;111;49;122;85;233
430830;201506;2153;6484;1968;6206;272;928;1372;4330;1644;5258
430840;201506;1004;3071;908;2887;229;742;429;1407;658;2149
430843;201506;107;314;55;183;12;43;18;56;30;99
430845;201506;347;1039;281;904;104;359;27;75;131;434
430850;201506;2920;8652;2459;7781;612;2098;930;2867;1542;4965
430860;201506;997;2679;509;1675;146;560;141;419;287;979
430865;201506;695;1834;636;1738;221;630;294;779;515;1409
430870;201506;723;2019;400;1322;106;363;85;248;191;611
430880;201506;1303;3654;941;2940;282;958;249;795;531;1753
430885;201506;258;648;153;491;22;78;86;273;108;351
430890;201506;1856;4862;1282;3765;127;448;487;1322;614;1770
430900;201506;3038;8013;2556;7179;547;1802;1308;3443;1855;5245
430905;201506;1078;3051;665;2152;173;604;156;474;329;1078
430910;201506;1635;4843;1162;3863;278;1025;458;1410;736;2435
430912;201506;535;1518;431;1336;57;210;267;808;324;1018
430915;201506;531;1692;370;1362;110;428;95;373;205;801
430920;201506;15909;48608;14073;45179;3343;11730;7968;24972;11311;36702
430925;201506;120;303;68;209;17;61;32;96;49;157
430930;201506;9782;28351;6874;22671;1892;6740;1925;6506;3817;13246
430940;201506;1274;3827;773;2589;134;498;194;591;328;1089
430950;201506;1242;3423;822;2549;184;635;303;851;487;1486
430955;201506;157;474;76;249;18;65;21;69;39;134
430957;201506;280;941;226;837;56;224;104;391;160;615
430960;201506;1455;3968;1192;3527;347;1131;482;1458;829;2589
430965;201506;1515;4386;1310;4036;91;343;1038;3142;1129;3485
430970;201506;561;1556;331;1064;66;229;92;282;158;511
430975;201506;666;2139;519;1793;89;333;262;906;351;1239
430980;201506;456;1137;273;858;68;240;96;269;164;509
430990;201506;623;1965;457;1559;115;418;105;322;220;740
430995;201506;639;1869;518;1625;182;597;182;553;364;1150
431000;201506;1779;4585;913;2822;177;625;114;288;291;913
431010;201506;2822;7983;1708;5700;340;1284;407;1183;747;2467
431020;201506;12991;31806;8322;23455;2077;6054;2379;6663;4456;12717
431030;201506;384;1125;197;682;46;181;43;142;89;323
431033;201506;2485;7301;2194;6862;566;1896;1089;3461;1655;5357
431036;201506;217;568;86;301;15;53;17;50;32;103
431040;201506;1029;2902;805;2528;193;689;380;1143;573;1832
431041;201506;573;1567;511;1482;154;446;232;711;386;1157
431043;201506;397;1275;285;1012;125;485;72;215;197;700
431046;201506;121;342;86;268;14;48;30;88;44;136
431050;201506;1858;4652;1424;3934;307;945;797;2146;1104;3091
431053;201506;645;2104;534;1863;158;604;140;500;298;1104
431055;201506;708;1922;652;1829;50;147;497;1395;547;1542
431057;201506;399;1166;240;825;55;198;63;207;118;405
431060;201506;5949;17327;5431;16612;1566;4715;2766;8822;4332;13537
431065;201506;552;1558;415;1271;70;243;193;551;263;794
431070;201506;755;2182;443;1476;98;341;85;246;183;587
431075;201506;297;905;206;708;34;127;63;226;97;353
431080;201506;634;1989;506;1713;112;439;125;392;237;831
431085;201506;957;2533;745;2146;129;399;429;1219;558;1618
431087;201506;635;1802;550;1633;73;213;365;1094;438;1307
431090;201506;550;1343;261;791;78;245;60;172;138;417
431100;201506;4055;11262;3297;9948;847;2762;1255;3792;2102;6554
431110;201506;1614;4241;1194;3404;252;767;519;1394;771;2161
431112;201506;630;1967;592;1905;165;547;287;904;452;1451
431113;201506;521;1512;397;1261;112;374;107;348;219;722
431115;201506;1471;4247;1280;3917;234;743;775;2377;1009;3120
431120;201506;2778;8537;2179;7335;637;2450;773;2400;1410;4850
431123;201506;531;1536;377;1237;80;284;203;678;283;962
431125;201506;1418;4294;1045;3493;316;1054;267;960;583;2014
431127;201506;239;631;56;186;5;14;4;11;9;25
431130;201506;3655;10330;2713;8619;591;2099;993;3115;1584;5214
431140;201506;4561;11253;2420;7584;425;1501;567;1515;992;3016
431142;201506;545;1600;481;1483;48;154;327;1029;375;1183
431150;201506;1211;3564;918;2987;205;734;351;1130;556;1864
431160;201506;1029;3001;868;2677;158;495;423;1398;581;1893
431162;201506;525;1379;244;827;34;144;33;86;67;230
431164;201506;168;470;49;181;12;46;3;8;15;54
431170;201506;792;2199;558;1761;154;508;164;506;318;1014
431171;201506;860;2540;730;2279;246;815;195;583;441;1398
431173;201506;520;1504;452;1386;104;336;265;815;369;1151
431175;201506;1135;3180;966;2905;304;968;341;1009;645;1977
431177;201506;913;2935;745;2606;241;942;317;1065;558;2007
431179;201506;370;809;86;254;12;44;18;40;30;84
431180;201506;2368;6842;1651;5317;387;1334;397;1165;784;2499
431190;201506;750;1958;386;1241;75;270;89;277;164;547
431198;201506;398;1316;352;1224;151;550;84;305;235;855
431200;201506;374;1055;109;377;20;63;3;10;23;73
431205;201506;336;1024;177;606;38;124;57;198;95;322
431210;201506;784;2133;659;1910;177;511;350;1045;527;1556
431213;201506;266;806;216;713;54;206;86;268;140;474
431215;201506;335;980;169;573;28;91;16;40;44;131
431217;201506;215;655;163;540;50;172;51;170;101;342
431220;201506;1011;2648;646;1919;82;267;332;911;414;1178
431225;201506;1365;3916;1129;3494;236;761;594;1848;830;2609
431230;201506;908;2608;673;2132;84;287;357;1096;441;1383
431235;201506;113;319;34;104;7;24;6;14;13;38
431237;201506;531;1576;421;1415;114;454;195;635;309;1089
431238;201506;44;140;35;119;8;32;11;36;19;68
431240;201506;2955;8859;2560;8217;858;2967;780;2479;1638;5446
431242;201506;386;1217;343;1141;101;353;100;339;201;692
431244;201506;438;1037;278;773;49;161;142;364;191;525
431245;201506;1144;3002;839;2446;123;379;501;1452;624;1831
431247;201506;204;598;154;498;52;174;47;150;99;324
431250;201506;1659;5226;1444;4925;414;1519;642;2203;1056;3722
431260;201506;381;1069;201;682;46;189;60;181;106;370
431261;201506;240;836;209;764;37;158;71;239;108;397
431262;201506;418;1129;184;600;24;101;80;255;104;356
431265;201506;1484;3864;819;2482;167;567;207;512;374;1079
431267;201506;169;471;138;416;27;97;77;217;104;314
431270;201506;2760;7063;1884;5638;509;1687;716;2149;1225;3836
431275;201506;234;713;129;462;34;125;16;44;50;169
431280;201506;289;813;116;397;17;71;24;60;41;131
431290;201506;365;1141;279;935;66;257;57;163;123;420
431295;201506;113;312;59;178;4;14;28;79;32;93
431300;201506;371;943;58;217;12;41;2;9;14;50
431301;201506;265;816;122;413;29;102;21;64;50;166
431303;201506;787;2074;465;1406;79;287;146;398;225;685
431306;201506;2307;6067;1540;4677;187;692;479;1247;666;1939
431308;201506;44;147;40;136;24;87;11;35;35;122
431310;201506;819;2427;491;1679;106;374;142;507;248;881
431320;201506;935;2540;499;1627;108;398;124;370;232;768
431330;201506;2787;6893;1301;4140;368;1314;129;360;497;1674
431333;201506;463;1217;205;604;33;103;61;155;94;258
431335;201506;68;199;52;159;16;52;12;24;28;76
431337;201506;2520;7672;1879;6331;454;1636;380;1183;834;2819
431339;201506;694;1903;475;1433;85;274;213;628;298;902
431340;201506;28136;74039;20179;60324;4717;15531;5991;17314;10708;32845
431342;201506;595;1531;488;1351;151;456;238;622;389;1078
431344;201506;411;1125;300;926;23;66;197;625;220;691
431346;201506;349;893;161;488;38;120;36;104;74;224
431349;201506;717;2061;486;1510;105;333;153;466;258;799
431350;201506;4144;12191;3418;10861;712;2576;1533;4660;2245;7236
431360;201506;756;1965;512;1554;133;433;150;457;283;890
431365;201506;1235;3672;1051;3361;296;1026;489;1598;785;2624
431370;201506;5288;14976;4195;13091;1171;3960;1403;4375;2574;8335
431380;201506;1001;3083;931;2936;130;439;624;1950;754;2389
431390;201506;3269;8628;1999;6202;414;1464;577;1593;991;3057
431395;201506;1303;3868;1100;3534;256;946;540;1669;796;2615
431400;201506;306;957;157;546;41;157;21;51;62;208
431402;201506;1321;3109;749;2103;152;462;372;1004;524;1466
431403;201506;286;833;204;686;56;208;36;116;92;324
431405;201506;4525;12666;3634;11362;759;2731;1793;5418;2552;8149
431406;201506;826;2528;612;2062;180;647;265;877;445;1524
431407;201506;603;1755;393;1312;99;332;100;301;199;633
431410;201506;15119;43931;10629;35083;3304;12168;1579;5122;4883;17290
431413;201506;224;553;105;333;11;38;40;120;51;158
431415;201506;785;2203;586;1840;135;494;242;685;377;1179
431417;201506;677;1665;541;1472;74;201;313;876;387;1077
431420;201506;1486;4121;1307;3847;271;831;670;2091;941;2922
431430;201506;551;1452;350;1047;64;204;117;310;181;514
431440;201506;25102;71013;20685;63824;6067;19910;7750;24664;13817;44574
431442;201506;150;416;98;288;19;61;14;25;33;86
431445;201506;512;1445;221;700;32;102;81;244;113;346
431446;201506;492;1435;352;1150;79;262;140;464;219;726
431447;201506;742;2071;527;1633;105;356;221;675;326;1031
431449;201506;864;2392;676;2058;77;251;401;1220;478;1471
431450;201506;2210;5596;1966;5236;343;999;1380;3606;1723;4605
431454;201506;63;220;54;197;14;51;21;83;35;134
431455;201506;733;1859;389;1110;113;321;105;281;218;602
431460;201506;3549;9830;3013;8808;847;2529;1018;3076;1865;5605
431470;201506;1956;5718;1519;4750;387;1194;581;1861;968;3055
431475;201506;179;517;43;167;7;29;3;11;10;40
431477;201506;740;1940;497;1465;60;185;282;812;342;997
431478;201506;270;691;104;309;22;66;20;53;42;119
431480;201506;3072;8489;2270;7040;594;2040;849;2524;1443;4564
431490;201506;115289;314147;98784;289435;13105;45282;68177;194687;81282;239969
431500;201506;839;2214;608;1778;125;355;303;876;428;1231
431505;201506;517;1243;374;1046;34;86;267;770;301;856
431507;201506;355;865;236;633;49;132;137;355;186;487
431510;201506;2182;5975;1728;5159;396;1279;731;2082;1127;3361
431513;201506;295;796;132;419;24;82;63;194;87;276
431514;201506;104;263;37;125;4;18;2;5;6;23
431515;201506;782;2263;534;1658;102;370;205;535;307;905
431517;201506;83;264;73;237;17;57;23;61;40;118
431520;201506;489;1370;276;886;41;149;66;200;107;349
431530;201506;4437;10559;3375;9311;1139;3387;1101;3194;2240;6581
431531;201506;297;843;191;623;39;131;70;232;109;363
431532;201506;525;1471;450;1306;124;378;180;517;304;895
431535;201506;383;1032;189;577;33;109;58;152;91;261
431540;201506;2189;7122;1922;6730;218;717;1312;4898;1530;5615
431545;201506;307;837;51;172;5;18;8;32;13;50
431550;201506;2388;6985;2112;6492;408;1427;1033;3082;1441;4509
431555;201506;737;1875;587;1639;115;323;351;992;466;1315
431560;201506;19963;60635;14640;50086;3944;14942;3843;13629;7787;28571
431570;201506;5440;15115;4795;14093;1310;3954;2338;6993;3648;10947
431575;201506;453;1154;316;925;53;185;86;218;139;403
431580;201506;702;1990;446;1427;92;337;155;445;247;782
431590;201506;1001;2728;628;1966;87;267;271;857;358;1124
431595;201506;518;1487;409;1260;74;225;199;619;273;844
431600;201506;2201;6264;1572;5048;337;1291;363;1020;700;2311
431610;201506;1598;4704;1207;3928;260;882;502;1619;762;2501
431620;201506;471;1410;241;783;64;224;99;292;163;516
431630;201506;1520;4051;1023;3040;276;849;380;1117;656;1966
431640;201506;6258;18022;5601;17004;1195;4120;3051;9132;4246;13252
431642;201506;527;1432;420;1240;63;218;201;566;264;784
431643;201506;178;449;146;395;20;64;72;167;92;231
431645;201506;1865;5337;1612;4921;319;1037;929;2838;1248;3875
431647;201506;187;541;126;393;27;89;25;62;52;151
431650;201506;304;942;214;762;34;141;49;148;83;289
431660;201506;1242;3467;772;2483;178;628;186;524;364;1152
431670;201506;1366;3629;1027;3013;226;748;433;1193;659;1941
431673;201506;231;650;136;446;29;105;29;82;58;187
431675;201506;646;1745;192;639;32;114;39;101;71;215
431680;201506;10405;28152;7638;23131;2075;6763;2130;6458;4205;13221
431690;201506;26449;73553;20794;64317;5879;19536;7769;24527;13648;44063
431695;201506;137;428;96;321;20;71;22;51;42;122
431697;201506;475;1348;417;1238;105;318;193;587;298;905
431700;201506;1644;4619;1380;4107;252;801;752;2175;1004;2976
431710;201506;13197;38231;10725;34041;3432;11738;2892;9533;6324;21271
431720;201506;7512;20684;5765;17323;1249;4158;2349;6859;3598;11017
431725;201506;12;35;9;29;1;4;4;11;5;15
431730;201506;4041;11961;3199;10401;890;3204;894;2965;1784;6169
431740;201506;5497;15475;4419;13482;1461;4936;931;2599;2392;7535
431750;201506;10040;28255;8568;25878;1834;6010;4274;13154;6108;19164
431755;201506;325;869;69;240;11;39;12;37;23;76
431760;201506;3955;11503;3190;10087;761;2634;1109;3338;1870;5972
431770;201506;2164;5762;1784;5160;357;1089;1000;2847;1357;3936
431775;201506;230;628;163;503;60;203;26;65;86;268
431780;201506;2541;6814;1931;5674;523;1639;468;1282;991;2921
431790;201506;1292;3965;1079;3549;203;713;607;2041;810;2754
431795;201506;435;1214;282;868;49;165;96;283;145;448
431800;201506;9230;27091;7321;23427;2267;7899;1576;4767;3843;12666
431805;201506;330;797;100;341;12;48;19;68;31;116
431810;201506;3713;10237;2905;8610;547;1768;1332;3866;1879;5634
431820;201506;2759;8558;2376;7802;520;1869;965;3075;1485;4944
431830;201506;11228;27814;8721;24082;2518;7536;3371;9339;5889;16875
431840;201506;2863;8504;2462;7808;626;2163;1114;3542;1740;5705
431842;201506;816;2033;376;1120;62;207;99;250;161;457
431843;201506;354;1026;295;922;37;127;158;481;195;608
431844;201506;252;694;127;417;23;89;34;94;57;183
431845;201506;535;1564;435;1354;40;131;283;896;323;1027
431846;201506;455;1343;384;1226;53;196;242;765;295;961
431848;201506;240;649;132;434;21;71;27;82;48;153
431849;201506;438;1065;97;293;22;70;18;38;40;108
431850;201506;5105;14756;4466;13543;1101;3566;1829;5481;2930;9047
431860;201506;844;2227;628;1858;102;345;314;864;416;1209
431861;201506;99;307;60;216;8;27;9;31;17;58
431862;201506;478;1562;384;1366;116;469;89;282;205;751
431870;201506;20272;57535;15497;48978;4008;13904;5054;15719;9062;29623
431880;201506;4527;13473;3593;11514;854;3016;1463;4553;2317;7569
431890;201506;5463;14723;4112;12372;1289;4144;1204;3668;2493;7812
431900;201506;1158;3320;781;2555;213;794;291;849;504;1643
431910;201506;1036;2447;482;1379;87;256;155;402;242;658
431912;201506;626;1773;484;1509;147;441;156;519;303;960
431915;201506;1484;3988;1122;3355;265;851;429;1263;694;2114
431920;201506;1399;3865;1234;3615;127;356;966;2862;1093;3218
431930;201506;1364;3729;1001;3124;242;739;463;1545;705;2284
431935;201506;74;229;59;198;17;66;21;62;38;128
431936;201506;410;1190;309;968;53;161;156;519;209;680
431937;201506;341;882;193;582;44;147;38;96;82;243
431940;201506;2742;7419;1765;5480;425;1422;479;1428;904;2850
431950;201506;1731;5283;1493;4865;311;1133;674;2095;985;3228
431960;201506;3226;9400;2828;8631;719;2344;959;2861;1678;5205
431970;201506;519;1414;271;868;43;162;69;196;112;358
431971;201506;119;334;89;281;15;47;33;90;48;137
431973;201506;498;1716;431;1573;56;216;264;1006;320;1222
431975;201506;95;210;16;61;5;23;3;10;8;33
431980;201506;1464;4214;1207;3697;280;931;405;1168;685;2099
431990;201506;8340;22899;6238;19371;1148;4148;2231;6468;3379;10616
432000;201506;10788;30245;8447;26132;2639;8603;2993;9212;5632;17815
432010;201506;2394;6789;1964;5997;439;1440;904;2720;1343;4160
432020;201506;2426;5969;1898;5272;225;693;1342;3701;1567;4394
432023;201506;567;1629;379;1218;85;308;116;333;201;641
432026;201506;1316;3923;968;3180;153;518;527;1721;680;2239
432030;201506;432;1258;328;1028;66;211;154;460;220;671
432032;201506;603;1562;394;1174;74;232;181;499;255;731
432035;201506;863;2648;760;2455;161;569;434;1387;595;1956
432040;201506;988;2335;485;1507;106;372;132;364;238;736
432045;201506;239;721;150;541;36;140;55;208;91;348
432050;201506;698;1945;598;1759;99;297;348;1059;447;1356
432055;201506;889;2666;714;2313;141;496;417;1317;558;1813
432057;201506;435;1091;331;913;42;119;220;583;262;702
432060;201506;530;1424;203;696;41;156;43;131;84;287
432065;201506;229;650;177;557;44;153;67;198;111;351
432067;201506;1015;3145;731;2515;156;575;362;1233;518;1808
432070;201506;2463;6713;1625;5011;388;1318;395;1110;783;2428
432080;201506;3921;11203;3356;10195;1025;3302;1198;3620;2223;6922
432085;201506;328;919;218;736;49;188;109;363;158;551
432090;201506;1569;4532;1244;3851;414;1365;435;1255;849;2620
432100;201506;1321;3817;673;2274;144;508;86;219;230;727
432110;201506;2778;8321;2078;6864;539;2004;290;820;829;2824
432120;201506;5319;15689;4496;14257;1661;5631;1417;4449;3078;10080
432130;201506;2616;7290;2096;6609;676;2304;860;2734;1536;5038
432132;201506;458;1299;232;778;27;103;85;268;112;371
432135;201506;728;2243;696;2181;94;331;515;1581;609;1912
432140;201506;2167;6749;1730;5908;421;1498;743;2629;1164;4127
432143;201506;1465;4320;1228;3920;256;832;637;2116;893;2948
432145;201506;1149;3538;709;2491;147;567;122;381;269;948
432146;201506;233;742;164;579;38;148;42;142;80;290
432147;201506;674;2090;499;1708;134;485;169;600;303;1085
432149;201506;372;1066;226;716;51;168;95;305;146;473
432150;201506;3913;10909;2870;9001;678;2358;901;2673;1579;5031
432160;201506;4499;14158;3915;13176;1215;4280;1517;5298;2732;9578
432162;201506;414;999;87;281;13;48;19;54;32;102
432163;201506;406;1075;95;300;5;17;8;23;13;40
432166;201506;751;2215;613;1930;92;341;316;947;408;1288
432170;201506;1030;3255;664;2438;131;489;121;428;252;917
432180;201506;3057;8029;2079;6338;576;1875;590;1764;1166;3639
432183;201506;443;1380;355;1197;153;540;72;234;225;774
432185;201506;947;2564;583;1874;123;410;241;769;364;1179
432190;201506;3493;9536;2378;7073;596;1873;687;1872;1283;3745
432195;201506;1288;3508;1060;3174;142;478;698;2040;840;2518
432200;201506;3405;10154;2717;8974;691;2485;1221;4098;1912;6583
432210;201506;452;1237;337;1047;76;271;145;408;221;679
432215;201506;900;2772;767;2558;142;447;473;1679;615;2126
432218;201506;301;798;216;633;43;126;78;202;121;328
432220;201506;4333;11365;3545;10152;371;1257;2307;6477;2678;7734
432225;201506;71;222;60;204;26;92;16;52;42;144
432230;201506;1129;3037;677;2047;167;554;195;481;362;1035
432232;201506;560;1615;434;1371;102;352;172;531;274;883
432234;201506;432;1175;285;844;67;199;92;255;159;454
432235;201506;80;236;44;153;11;52;7;22;18;74
432237;201506;485;1340;442;1273;25;103;341;954;366;1057
432240;201506;14617;46496;12316;43352;2204;9031;7118;25695;9322;34726
432250;201506;5127;17422;4629;16415;1679;6534;1435;5068;3114;11602
432252;201506;409;1170;301;985;65;232;160;527;225;759
432253;201506;1350;4262;908;3146;254;945;189;631;443;1576
432254;201506;819;2206;234;768;53;189;30;84;83;273
432255;201506;240;613;130;425;32;110;39;120;71;230
432260;201506;7793;19489;5385;15527;1225;3616;2203;6590;3428;10206
432270;201506;2668;7894;2240;7154;627;2045;897;2951;1524;4996
432280;201506;1352;3733;698;2278;116;414;166;469;282;883
432285;201506;184;589;57;200;11;44;10;26;21;70
432290;201506;604;1781;392;1295;92;309;127;413;219;722
432300;201506;24309;72234;21389;67257;4394;15001;12058;37549;16452;52550
432310;201506;879;2559;706;2265;146;532;381;1187;527;1719
432320;201506;258;657;128;398;27;82;27;75;54;157
432330;201506;317;840;128;427;16;55;12;35;28;90
432335;201506;216;625;95;327;21;78;9;26;30;104
432340;201506;369;914;176;537;34;110;58;170;92;280
432345;201506;687;1910;629;1815;91;338;385;1024;476;1362
432350;201506;436;1160;236;766;45;151;71;213;116;364
432360;201506;171;523;34;121;11;50;9;22;20;72
432370;201506;468;1306;367;1109;37;109;237;732;274;841
432375;201506;829;2090;646;1797;89;255;380;1075;469;1330
432377;201506;179;575;49;160;7;24;15;34;22;58
432380;201506;855;2892;759;2709;294;1169;274;903;568;2072
500020;201506;2330;6989;1758;5929;415;1642;682;2153;1097;3795
500025;201506;1229;2959;786;2184;105;298;441;1203;546;1501
500060;201506;6791;19974;5413;17717;723;2461;3537;12022;4260;14483
500070;201506;4232;12252;3496;10998;708;2563;1591;4914;2299;7477
500080;201506;1638;4776;1201;3989;334;1234;422;1415;756;2649
500085;201506;2294;6008;1653;5047;195;655;969;2852;1164;3507
500090;201506;2411;6900;1804;5806;367;1234;871;2874;1238;4108
500100;201506;2626;7690;2284;7084;554;2007;1041;3026;1595;5033
500110;201506;8751;25373;6952;22581;1129;3941;3738;12875;4867;16816
500124;201506;2051;6532;1767;6066;328;1049;976;3697;1304;4746
500150;201506;1452;3641;1054;2999;221;757;467;1137;688;1894
500190;201506;5025;12933;3904;11468;759;2396;2206;6640;2965;9036
500200;201506;2601;6479;1956;5383;377;1161;891;2356;1268;3517
500210;201506;4936;14590;4123;13307;908;3102;2007;6556;2915;9658
500215;201506;1673;5089;1335;4419;239;884;540;1710;779;2594
500220;201506;2971;9325;2448;8408;509;1872;969;3407;1478;5279
500230;201506;2717;6926;2045;5939;506;1610;898;2630;1404;4240
500240;201506;4820;14881;3420;12001;548;2082;1281;4764;1829;6846
500260;201506;2759;7082;2035;5934;322;1041;987;2716;1309;3757
500270;201506;123272;315840;78107;237645;19487;64282;18357;55016;37844;119298
500280;201506;1425;3834;1192;3525;115;364;888;2669;1003;3033
500290;201506;4338;10272;2628;7671;610;2034;856;2289;1466;4323
500295;201506;2647;7843;1775;5815;334;1218;439;1227;773;2445
500310;201506;853;2207;714;2007;162;537;342;893;504;1430
500315;201506;3207;9902;2674;9102;423;1486;1670;5875;2093;7361
500320;201506;16855;53501;13421;47077;4005;15123;4232;15676;8237;30799
500325;201506;4142;10662;3037;8928;650;2091;1527;4431;2177;6522
500330;201506;6578;17561;4904;14525;937;3006;2324;6756;3261;9762
500345;201506;2235;5858;1744;5073;293;956;970;2756;1263;3712
500348;201506;2438;6940;2131;6449;161;591;1621;4854;1782;5445
500350;201506;1274;3838;775;2697;107;401;232;835;339;1236
500370;201506;23561;71212;17744;60338;4077;15534;5556;18867;9633;34401
500375;201506;2953;8060;2172;6574;511;1640;726;2183;1237;3823
500380;201506;2977;8412;2480;7559;762;2412;908;2804;1670;5216
500390;201506;602;1277;374;956;37;116;248;589;285;705
500400;201506;1344;4048;1009;3258;238;855;271;776;509;1631
500410;201506;2313;6445;1844;5755;486;1691;830;2577;1316;4268
500430;201506;2548;7298;2016;6534;429;1576;892;2963;1321;4539
500440;201506;1414;3821;1069;3264;204;699;527;1549;731;2248
500450;201506;1996;6049;1509;5108;306;1182;294;847;600;2029
500460;201506;3694;11130;2874;9526;784;2897;680;2171;1464;5068
500470;201506;3062;8978;2114;6904;554;2012;320;935;874;2947
500480;201506;2008;6398;1867;6213;175;581;1512;5175;1687;5756
500490;201506;1021;2799;795;2412;226;774;238;706;464;1480
500500;201506;3648;11315;2858;10103;1113;4489;794;2748;1907;7237
500510;201506;864;2231;552;1685;75;254;245;682;320;936
500515;201506;1908;5072;1571;4621;270;810;898;2874;1168;3684
500520;201506;3071;10457;2729;9943;477;1877;1691;6285;2168;8162
500525;201506;1213;3842;976;3381;216;850;438;1540;654;2390
500540;201506;6179;17044;3591;12070;999;3941;550;1593;1549;5534
500560;201506;4750;15496;4305;14824;579;2215;3089;10647;3668;12862
500568;201506;4090;10353;2835;8453;591;2050;1153;3223;1744;5273
500570;201506;7632;20323;5059;15509;1380;4547;1271;3722;2651;8269
500580;201506;3714;10572;2956;9302;308;1031;2076;6583;2384;7614
500600;201506;3827;10257;2557;7849;582;1964;908;2740;1490;4704
500620;201506;7749;21844;5770;18192;1183;4115;2631;8321;3814;12436
500625;201506;748;2231;451;1565;99;380;123;405;222;785
500627;201506;512;1495;399;1298;90;305;106;368;196;673
500630;201506;6248;16997;4558;14160;1208;4183;1460;4363;2668;8546
500635;201506;2618;10043;2180;9345;322;1302;1355;6394;1677;7696
500640;201506;1661;3984;1266;3426;100;318;931;2484;1031;2802
500660;201506;19006;54390;14729;47395;4237;15398;4830;15354;9067;30752
500690;201506;2971;8445;2369;7660;918;3095;792;2787;1710;5882
500710;201506;3730;11016;3154;10053;675;2433;1515;4737;2190;7170
500720;201506;5977;15947;3846;12191;1059;3660;1051;3214;2110;6874
500730;201506;995;2774;703;2188;168;594;228;666;396;1260
500740;201506;3960;10921;3229;9557;462;1658;1424;4240;1886;5898
500750;201506;886;2477;786;2343;147;450;489;1508;636;1958
500755;201506;1243;3616;859;2804;192;709;236;634;428;1343
500769;201506;5145;13631;3113;9438;591;2030;742;1882;1333;3912
500770;201506;1790;5249;1335;4405;362;1337;409;1367;771;2704
500780;201506;1075;3141;877;2775;235;820;298;864;533;1684
500790;201506;9324;25838;7791;23186;1400;4822;4315;12366;5715;17188
500793;201506;2321;6672;1806;5776;447;1567;565;1618;1012;3185
500795;201506;2517;7323;2130;6781;264;733;1570;5279;1834;6012
500797;201506;883;2365;632;1936;109;362;232;658;341;1020
500800;201506;2789;7584;2177;6739;845;2970;655;2033;1500;5003
500830;201506;18530;50355;12697;39111;2757;9376;4012;11714;6769;21090
500840;201506;1404;3919;984;3082;132;459;435;1311;567;1770
510010;201506;1234;3778;1065;3490;297;974;517;1752;814;2726
510020;201506;3351;9566;2153;7128;484;1750;650;2016;1134;3766
510025;201506;8209;23828;6707;21146;1580;5572;2618;7705;4198;13277
510030;201506;1813;4966;1498;4469;359;1221;667;1845;1026;3066
510035;201506;868;2457;686;2200;125;404;398;1303;523;1707
510040;201506;1740;4764;1341;4170;248;870;709;2195;957;3065
510050;201506;1935;5597;1394;4563;374;1337;428;1381;802;2718
510060;201506;1592;4550;1199;3813;249;842;454;1387;703;2229
510080;201506;1152;3560;896;3063;274;1040;187;567;461;1607
510100;201506;681;1820;476;1419;55;179;219;617;274;796
510120;201506;328;684;192;515;19;53;116;317;135;370
510125;201506;3228;8455;2516;7193;453;1600;1051;2761;1504;4361
510130;201506;1926;5206;1552;4598;396;1242;572;1680;968;2922
510140;201506;2995;9561;2396;8626;955;3838;560;1789;1515;5627
510160;201506;1373;4595;1268;4450;145;580;941;3302;1086;3882
510170;201506;5686;16987;4639;15156;911;3325;2197;6946;3108;10271
510180;201506;12099;31603;8559;26013;2447;7835;2810;9424;5257;17259
510185;201506;1395;4075;1146;3751;159;484;765;2745;924;3229
510190;201506;2217;6577;1551;5553;366;1456;691;2542;1057;3998
510250;201506;14282;43501;12154;40408;3645;13151;5061;17285;8706;30436
510260;201506;2307;9163;2019;8561;628;2812;820;3853;1448;6665
510263;201506;4370;11655;3126;9605;780;2579;941;2747;1721;5326
510267;201506;5719;16473;4119;13091;959;3329;1227;3666;2186;6995
510268;201506;883;2547;749;2360;166;558;403;1271;569;1829
510269;201506;1025;3110;774;2629;249;886;208;707;457;1593
510270;201506;2687;8599;2332;7916;414;1459;1144;3909;1558;5368
510279;201506;2014;6236;1662;5451;473;1702;508;1480;981;3182
510285;201506;1396;4115;1093;3583;287;1022;395;1241;682;2263
510300;201506;3390;9997;2832;9184;231;869;2179;7098;2410;7967
510305;201506;1567;4828;1228;4167;311;1151;400;1328;711;2479
510310;201506;872;2625;729;2363;232;806;239;736;471;1542
510320;201506;3885;11239;3001;9588;859;3166;665;1954;1524;5120
510325;201506;5365;16940;4586;15882;1137;4060;2860;10188;3997;14248
510330;201506;2922;9175;2367;8193;598;2335;845;2874;1443;5209
510335;201506;4931;14834;4057;13708;561;1850;2883;10314;3444;12164
510336;201506;581;1768;457;1531;94;347;230;754;324;1101
510337;201506;2173;7090;1799;6366;698;2505;483;1865;1181;4370
510340;201506;68986;194622;52547;168834;19091;67647;11135;37230;30226;104877
510343;201506;1092;3189;960;3005;94;303;735;2351;829;2654
510345;201506;1692;4971;1377;4398;318;1080;496;1519;814;2599
510350;201506;3525;9670;2739;8566;680;2275;1307;4236;1987;6511
510360;201506;1817;4491;1184;3714;139;527;820;2515;959;3042
510370;201506;1080;3723;952;3529;215;846;576;2173;791;3019
510380;201506;549;1663;381;1321;144;542;50;145;194;687
510385;201506;986;3641;733;3058;116;511;342;1538;458;2049
510390;201506;1137;3459;1042;3344;278;724;649;2336;927;3060
510395;201506;850;2127;652;1852;111;351;278;901;389;1252
510410;201506;3951;12875;3533;12062;866;3106;1840;6375;2706;9481
510420;201506;2430;6228;1768;5121;218;789;921;2610;1139;3399
510450;201506;606;1648;445;1397;103;372;167;500;270;872
510452;201506;650;2081;456;1646;100;399;190;664;290;1063
510454;201506;873;2784;747;2549;119;422;472;1661;591;2083
510455;201506;987;3025;731;2499;155;609;227;727;382;1336
510460;201506;2262;5956;1756;5224;244;906;1042;2934;1286;3840
510480;201506;4617;12308;3281;9834;804;2515;787;2190;1591;4705
510490;201506;1448;4682;1277;4421;249;1012;780;2611;1029;3623
510500;201506;1550;4575;1059;3607;259;1018;405;1315;664;2333
510510;201506;2808;9739;2442;9092;826;3375;893;3265;1719;6640
510515;201506;6407;19558;4903;16262;1158;4284;1248;3886;2406;8170
510517;201506;1788;5280;1478;4722;481;1596;510;1629;991;3225
510520;201506;2151;5097;1558;4344;77;253;1134;3261;1211;3514
510523;201506;1054;3130;915;2904;153;498;601;1958;754;2456
510525;201506;7973;20445;5257;16152;1120;3634;1982;6044;3102;9678
510530;201506;546;1545;458;1421;64;273;275;804;339;1077
510550;201506;2607;8572;2184;7792;639;2466;762;2687;1401;5153
510558;201506;2049;5866;1701;5354;390;1351;803;2565;1193;3916
510560;201506;1719;5384;1169;4426;348;1437;276;1062;624;2499
510562;201506;5419;16074;4265;13743;1237;4423;1226;3936;2463;8359
510590;201506;3010;7943;2431;7199;580;1776;1205;3670;1785;5446
510600;201506;1589;4097;1062;3231;195;651;446;1269;641;1920
510610;201506;2826;8062;2406;7475;175;612;1888;5890;2063;6502
510615;201506;2360;7181;1988;6588;587;2084;941;3166;1528;5250
510617;201506;608;1829;498;1630;51;163;374;1272;425;1435
510618;201506;1444;4203;1036;3396;201;776;469;1466;670;2242
510619;201506;818;2257;484;1628;78;288;76;210;154;498
510620;201506;1500;3698;828;2680;228;836;148;440;376;1276
510621;201506;980;3388;868;3147;226;912;299;1023;525;1935
510622;201506;3923;11893;2706;9264;690;2591;376;1031;1066;3622
510623;201506;3594;10201;2879;8923;786;2623;1164;3488;1950;6111
510624;201506;1352;4037;978;3313;207;799;318;959;525;1758
510625;201506;2299;6550;1783;5666;474;1673;414;1250;888;2923
510626;201506;1562;4190;1032;3449;322;1212;353;1186;675;2398
510627;201506;775;2178;510;1624;129;459;128;398;257;857
510628;201506;1654;4070;1180;3431;130;417;829;2403;959;2820
510629;201506;1867;5972;1528;5239;458;1759;499;1632;957;3391
510630;201506;2581;8675;1964;7398;522;2216;417;1547;939;3763
510631;201506;404;1143;362;1075;50;154;251;734;301;888
510637;201506;2758;7990;2376;7373;630;2111;1024;3154;1654;5265
510642;201506;4843;15779;4175;14814;1248;4853;1878;6906;3126;11759
510645;201506;965;2189;610;1705;188;516;195;586;383;1102
510650;201506;6271;21093;5739;20453;1164;4165;3948;14764;5112;18929
510665;201506;1342;3671;914;2855;227;737;301;918;528;1655
510670;201506;409;934;224;669;27;107;100;280;127;387
510675;201506;6473;20412;5230;17960;1544;6008;1288;4182;2832;10190
510677;201506;2220;5784;1738;5167;224;684;1261;3911;1485;4595
510680;201506;790;2379;628;2058;129;461;218;650;347;1111
510682;201506;2313;7186;1780;6185;463;1813;450;1467;913;3280
510685;201506;956;2549;784;2316;79;275;552;1602;631;1877
510700;201506;4364;11341;2990;9364;656;2138;1513;4873;2169;7011
510704;201506;9145;24500;7559;21974;1536;4997;3981;11271;5517;16268
510706;201506;1901;5795;1382;4968;328;1202;717;2677;1045;3879
510710;201506;3544;9856;2528;7797;641;2084;637;1740;1278;3824
510715;201506;710;1754;441;1268;98;313;155;403;253;716
510718;201506;2182;5567;1522;4832;665;2192;500;1675;1165;3867
510719;201506;458;1036;283;805;33;136;127;331;160;467
510720;201506;1334;3105;990;2691;218;680;530;1374;748;2054
510724;201506;816;2463;675;2198;149;548;341;1044;490;1592
510726;201506;653;1713;497;1457;104;325;189;517;293;842
510729;201506;783;1964;482;1432;119;402;186;542;305;944
510730;201506;2566;7723;2105;6914;568;2096;746;2339;1314;4435
510735;201506;1150;3779;905;3380;216;900;430;1593;646;2493
510740;201506;1140;2792;826;2332;198;545;429;1258;627;1803
510757;201506;669;2280;556;2046;174;669;213;804;387;1473
510760;201506;29468;77649;20730;63023;6099;20165;5827;17305;11926;37470
510770;201506;4437;11527;3819;10807;396;1073;2597;8217;2993;9290
510774;201506;434;1184;360;1069;77;268;168;518;245;786
510775;201506;783;2252;655;2048;223;749;210;642;433;1391
510776;201506;525;1472;408;1232;89;292;190;563;279;855
510777;201506;1654;4859;1230;4274;182;676;909;3206;1091;3882
510779;201506;714;2086;526;1740;86;306;233;793;319;1099
510780;201506;3789;11290;3174;10331;774;2612;1454;4966;2228;7578
510785;201506;1901;5454;1466;4722;494;1662;377;1239;871;2901
510787;201506;2171;6582;1731;5802;646;2278;389;1228;1035;3506
510788;201506;518;1386;378;1170;165;502;99;346;264;848
510790;201506;15902;46187;10756;36335;2553;9905;1289;4139;3842;14044
510792;201506;7452;22774;5249;18426;1161;4631;1051;3397;2212;8028
510794;201506;1259;3953;1036;3553;380;1429;295;930;675;2359
510795;201506;8899;26939;6541;22390;1831;6916;1588;5498;3419;12414
510800;201506;1717;4787;1377;4314;338;1186;598;1736;936;2922
510805;201506;1941;5448;1591;4942;197;634;1146;3596;1343;4230
510810;201506;695;1683;535;1471;143;403;249;659;392;1062
510820;201506;780;1848;536;1486;98;322;212;515;310;837
510830;201506;658;2093;559;1944;154;576;275;1036;429;1612
510835;201506;660;1988;494;1655;138;522;179;539;317;1061
510840;201506;50227;122801;39170;108709;8894;26022;19876;56881;28770;82903
510850;201506;1488;4259;1102;3587;367;1327;190;484;557;1811
510860;201506;2444;7916;1804;6564;684;2703;101;329;785;3032
510880;201506;698;2293;601;2127;187;718;263;956;450;1674
510885;201506;622;1745;500;1582;88;318;214;679;302;997
510890;201506;877;2744;710;2473;217;867;260;803;477;1670
510895;201506;1118;3471;952;3154;260;987;401;1251;661;2238
520005;201506;1317;4210;1181;4013;344;1225;540;1867;884;3092
520010;201506;1717;5773;1420;5148;550;2285;293;943;843;3228
520013;201506;3775;10366;2812;8629;645;2078;1070;3267;1715;5345
520015;201506;446;1290;367;1166;93;316;148;477;241;793
520017;201506;1122;3353;947;3069;253;899;374;1128;627;2027
520020;201506;400;1067;313;942;70;226;147;444;217;670
520025;201506;25518;79958;24460;78727;2513;8625;20263;65473;22776;74098
520030;201506;4607;14493;3924;13384;876;3281;1867;6395;2743;9676
520050;201506;339;919;275;811;26;78;194;575;220;653
520055;201506;773;2326;656;2094;126;393;342;1126;468;1519
520060;201506;1435;4442;1227;4026;261;982;499;1564;760;2546
520080;201506;1745;5252;1497;4903;346;1106;832;2870;1178;3976
520082;201506;934;2745;831;2580;149;425;514;1711;663;2136
520085;201506;969;2963;826;2685;173;587;273;875;446;1462
520090;201506;973;2274;725;1953;171;426;369;1065;540;1491
520110;201506;42498;123437;33029;109049;12176;45585;7131;22914;19307;68499
520120;201506;242;634;148;468;32;126;35;103;67;229
520130;201506;3566;10120;3225;9602;812;2644;1559;4575;2371;7219
520140;201506;43604;140790;38010;130316;13264;49688;8679;28879;21943;78567
520145;201506;434;1131;331;982;81;258;135;381;216;639
520150;201506;654;1748;538;1613;135;435;285;847;420;1282
520160;201506;821;2341;674;2119;213;707;202;635;415;1342
520170;201506;4081;9620;3235;8662;304;835;2592;7091;2896;7926
520180;201506;2069;6080;1693;5465;399;1505;678;2085;1077;3590
520215;201506;1943;5022;1646;4567;224;648;1054;2963;1278;3611
520235;201506;762;1990;573;1713;137;462;248;699;385;1161
520250;201506;1367;4152;1084;3665;295;1094;405;1373;700;2467
520260;201506;788;2017;543;1567;81;249;230;636;311;885
520280;201506;542;1599;499;1539;187;612;179;620;366;1232
520310;201506;1124;2716;847;2316;221;606;350;1041;571;1647
520320;201506;1786;5573;1464;4939;152;539;913;3153;1065;3692
520330;201506;2756;8472;2098;7343;615;2410;412;1339;1027;3749
520340;201506;1860;4627;1411;4076;202;524;1002;3033;1204;3557
520350;201506;3197;8883;2549;7690;644;2193;1094;3153;1738;5346
520355;201506;1102;3695;1000;3531;342;1315;397;1345;739;2660
520357;201506;781;2128;663;1945;47;153;492;1430;539;1583
520360;201506;666;1924;592;1805;117;376;289;908;406;1284
520380;201506;1312;3528;882;2712;163;533;346;1042;509;1575
520390;201506;1026;2505;637;1984;180;669;236;646;416;1315
520393;201506;575;1455;469;1300;66;190;303;834;369;1024
520396;201506;742;2359;630;2141;77;308;427;1444;504;1752
520400;201506;1716;4884;1469;4543;235;796;971;2979;1206;3775
520410;201506;1521;3808;1133;3280;259;820;613;1744;872;2564
520420;201506;340;947;249;760;48;160;79;218;127;378
520425;201506;1234;3366;1064;3064;289;898;550;1552;839;2450
520430;201506;2092;5460;1343;4094;296;1006;451;1231;747;2237
520440;201506;3684;9472;2511;7457;789;2567;603;1781;1392;4348
520450;201506;10512;29525;7472;23917;1838;6452;1009;2940;2847;9392
520455;201506;687;2054;559;1835;183;665;174;563;357;1228
520460;201506;871;2501;705;2221;137;494;352;1066;489;1560
520465;201506;806;2249;691;2109;121;416;422;1276;543;1692
520470;201506;1795;5793;1613;5504;361;1240;1033;3688;1394;4928
520480;201506;968;2789;750;2436;137;489;377;1173;514;1662
520485;201506;1264;4007;1090;3715;305;1164;574;1941;879;3105
520490;201506;3908;12271;3135;11029;960;3513;1358;4904;2318;8417
520495;201506;1267;3513;1098;3296;95;290;911;2778;1006;3068
520500;201506;1485;4202;1309;3937;383;1213;582;1741;965;2954
520505;201506;852;2397;728;2212;167;523;399;1222;566;1745
520510;201506;10501;29303;7246;23998;1921;7025;2017;6733;3938;13758
520520;201506;1095;3049;866;2713;271;886;313;997;584;1883
520530;201506;2152;6928;1815;6352;589;2113;629;2308;1218;4421
520540;201506;3021;8542;2311;7215;628;2104;564;1692;1192;3796
520545;201506;1156;3477;956;3073;224;776;308;941;532;1717
520547;201506;749;2367;646;2179;239;856;206;656;445;1512
520549;201506;9657;27872;7953;25742;2333;7928;3964;12953;6297;20881
520551;201506;3586;10828;3300;10440;890;3070;1951;6159;2841;9229
520552;201506;804;2469;743;2380;121;432;494;1585;615;2017
520570;201506;537;1548;388;1284;153;540;83;259;236;799
520580;201506;3239;8238;2229;6763;650;2237;844;2475;1494;4712
520590;201506;1458;4077;1155;3567;276;883;302;862;578;1745
520620;201506;7273;22842;6602;21857;1506;5269;3847;12873;5353;18142
520630;201506;774;2020;569;1716;123;371;269;821;392;1192
520640;201506;2796;7834;2313;7043;682;2177;944;2952;1626;5129
520650;201506;833;2302;643;1939;155;522;307;908;462;1430
520660;201506;361;1079;295;975;104;379;94;296;198;675
520670;201506;887;2684;809;2572;53;151;696;2253;749;2404
520680;201506;637;1781;518;1615;133;427;236;748;369;1175
520690;201506;396;1011;278;839;55;144;125;411;180;555
520710;201506;534;1369;320;941;7;16;187;541;194;557
520725;201506;1710;4321;1282;3670;253;789;745;2109;998;2898
520735;201506;763;2168;564;1781;144;522;181;543;325;1065
520740;201506;1700;4825;1386;4407;287;1032;702;2177;989;3209
520750;201506;621;1675;487;1473;101;311;263;824;364;1135
520753;201506;1302;3726;1214;3593;149;407;898;2797;1047;3204
520760;201506;929;2499;796;2323;126;397;551;1649;677;2046
520780;201506;2039;4945;1659;4433;168;404;1200;3259;1368;3663
520790;201506;2745;7356;2267;6675;277;792;1638;5013;1915;5805
520800;201506;15586;45534;13656;43224;2786;8554;8590;28927;11376;37481
520810;201506;1025;2576;831;2351;137;384;587;1752;724;2136
520815;201506;559;1801;417;1511;179;741;24;65;203;806
520830;201506;1565;4217;1322;3963;48;143;1156;3490;1204;3633
520840;201506;1477;4826;1240;4383;406;1594;266;944;672;2538
520850;201506;656;1977;511;1741;142;540;231;768;373;1308
520860;201506;6958;19708;5167;17016;1411;5051;2107;7106;3518;12157
520870;201506;113122;303768;76956;242325;21585;75442;18789;56253;40374;131695
520880;201506;7265;20791;5343;17825;1632;6139;835;2708;2467;8847
520890;201506;4006;11314;3309;10160;714;2373;1612;4932;2326;7305
520910;201506;3741;11018;2752;9063;882;3096;492;1553;1374;4649
520915;201506;856;2428;644;2028;135;460;279;843;414;1303
520920;201506;3430;9242;2400;7589;572;1941;809;2636;1381;4577
520929;201506;559;1543;432;1345;95;296;241;776;336;1072
520940;201506;1035;3033;872;2791;93;346;631;2001;724;2347
520945;201506;721;1718;574;1475;183;435;247;642;430;1077
520960;201506;866;2588;704;2286;86;272;355;1191;441;1463
520970;201506;3254;9648;2713;8687;656;2320;894;2766;1550;5086
520980;201506;834;2367;761;2258;246;803;376;1082;622;1885
520990;201506;2968;9711;2810;9484;530;1851;1836;6399;2366;8250
520993;201506;1107;2885;882;2536;73;227;603;1734;676;1961
520995;201506;2588;7070;2345;6754;358;1026;1689;4930;2047;5956
521000;201506;7170;21713;6020;19666;1546;5737;2180;6771;3726;12508
521010;201506;3896;11648;3131;10214;790;2771;1130;3708;1920;6479
521015;201506;673;1869;561;1690;136;386;277;853;413;1239
521020;201506;3946;11179;2776;8801;762;2610;448;1229;1210;3839
521030;201506;608;1598;516;1450;103;289;272;776;375;1065
521040;201506;5898;16092;5043;14826;1777;5337;2074;6497;3851;11834
521056;201506;915;2800;762;2546;256;906;301;1066;557;1972
521060;201506;1322;3511;1069;3122;263;732;456;1396;719;2128
521080;201506;1224;2897;744;2099;106;374;294;686;400;1060
521090;201506;3180;8447;2432;7480;757;2447;968;3100;1725;5547
521100;201506;1647;3976;1391;3694;240;617;952;2657;1192;3274
521120;201506;4454;12467;3688;11357;887;2922;1657;5145;2544;8067
521130;201506;1071;2920;819;2449;139;510;464;1346;603;1856
521140;201506;1020;3242;872;2944;271;971;255;855;526;1826
521150;201506;13035;33619;8236;24458;2758;8825;2082;6054;4840;14879
521160;201506;835;2004;518;1445;107;320;228;608;335;928
521170;201506;1265;3032;971;2627;216;604;544;1435;760;2039
521180;201506;6651;21976;6028;20830;2158;7965;1787;6216;3945;14181
521190;201506;9766;27701;6612;22042;1802;6439;1696;5665;3498;12104
521200;201506;745;1956;627;1771;73;234;394;1079;467;1313
521205;201506;611;1777;476;1531;53;189;261;830;314;1019
521210;201506;925;2542;638;1998;214;769;184;466;398;1235
521220;201506;4051;10817;3124;9570;943;3166;1212;3683;2155;6849
521225;201506;379;937;299;843;36;93;211;626;247;719
521230;201506;1219;3833;1113;3618;361;1279;540;1691;901;2970
521250;201506;27966;90001;25254;85847;10552;38408;7684;26292;18236;64700
521260;201506;770;1901;624;1656;99;337;379;928;478;1265
521270;201506;1860;5739;1708;5512;157;402;1332;4519;1489;4921
521280;201506;1895;5823;1555;5153;475;1673;489;1594;964;3267
521290;201506;539;1530;402;1307;104;389;160;507;264;896
521295;201506;1114;2938;978;2751;115;331;770;2200;885;2531
521300;201506;1980;5529;1684;5049;295;879;961;2947;1256;3826
521305;201506;803;2219;656;1999;120;345;372;1178;492;1523
521308;201506;4780;14224;3817;12371;932;3175;1710;5463;2642;8638
521310;201506;7851;23344;5835;19500;1631;5919;1322;4093;2953;10012
521340;201506;261;758;229;703;34;121;148;442;182;563
521350;201506;1955;5314;1636;4839;225;680;1135;3442;1360;4122
521370;201506;1013;3020;804;2655;234;847;225;714;459;1561
521375;201506;1336;3937;1120;3561;272;962;512;1534;784;2496
521377;201506;1070;2787;1013;2723;76;148;889;2476;965;2624
521380;201506;5037;14240;3626;11615;683;2332;805;2659;1488;4991
521385;201506;512;1400;440;1308;105;340;243;709;348;1049
521390;201506;917;2481;717;2209;183;645;242;736;425;1381
521400;201506;2211;6139;2003;5885;276;898;1527;4489;1803;5387
521405;201506;1382;3930;1090;3407;310;1079;494;1541;804;2620
521410;201506;728;2223;659;2115;238;741;290;1002;528;1743
521440;201506;1405;3999;1287;3744;146;459;893;2501;1039;2960
521450;201506;4517;14158;3652;12524;1139;4249;812;2699;1951;6948
521460;201506;6694;19742;5765;18200;1419;4919;2860;8899;4279;13818
521470;201506;739;2073;549;1705;137;478;103;306;240;784
521480;201506;417;1239;290;958;63;211;112;368;175;579
521483;201506;2852;7405;2185;6273;591;1756;662;1846;1253;3602
521486;201506;1562;4040;1328;3693;133;396;1002;2765;1135;3161
521487;201506;633;1620;435;1289;127;386;81;229;208;615
521490;201506;769;2265;630;2037;67;295;426;1345;493;1640
521500;201506;1346;4294;1056;3648;207;810;332;1001;539;1811
521520;201506;901;2141;686;1852;178;478;328;945;506;1423
521523;201506;12156;44924;11303;43425;4349;17935;1688;7179;6037;25114
521525;201506;1047;2737;922;2572;104;358;665;1803;769;2161
521530;201506;1673;4806;1050;3520;238;857;188;575;426;1432
521540;201506;976;2664;677;2151;164;618;213;628;377;1246
521550;201506;1024;2621;884;2391;227;665;441;1142;668;1807
521560;201506;4337;13930;3633;12945;1362;5345;1178;4096;2540;9441
521565;201506;685;1747;582;1622;93;231;391;1121;484;1352
521570;201506;4596;12919;3140;9973;808;2774;911;2866;1719;5640
521580;201506;591;1372;407;1122;111;340;141;370;252;710
521590;201506;649;1852;518;1635;155;548;102;315;257;863
521600;201506;564;1483;394;1199;104;342;107;285;211;627
521630;201506;1553;3930;1125;3298;280;983;229;546;509;1529
521640;201506;2031;5236;1602;4649;457;1442;652;1945;1109;3387
521645;201506;605;1776;471;1475;72;248;196;563;268;811
521680;201506;1480;4713;1247;4241;631;2316;200;631;831;2947
521690;201506;568;1676;503;1559;116;425;230;647;346;1072
521710;201506;2650;8167;2234;7311;498;1715;972;3174;1470;4889
521720;201506;1935;5464;1619;4979;304;963;1012;3085;1316;4048
521730;201506;3847;12585;3412;11747;1346;5128;842;2634;2188;7762
521740;201506;3463;9481;2716;8463;846;2869;1205;3961;2051;6830
521760;201506;12899;42634;11524;40320;2619;10137;5720;20212;8339;30349
521770;201506;2714;7948;2205;7010;811;2777;644;1942;1455;4719
521800;201506;7787;23020;6684;21201;2103;7128;2558;8381;4661;15509
521805;201506;898;2054;644;1687;157;375;353;1006;510;1381
521810;201506;818;2158;631;1868;149;477;284;852;433;1329
521830;201506;5347;17117;4839;16375;865;3224;3149;10624;4014;13848
521839;201506;744;2058;561;1714;110;375;185;534;295;909
521850;201506;6675;18083;5109;15267;1199;3796;1647;4502;2846;8298
521860;201506;1888;5275;1480;4596;348;1206;475;1418;823;2624
521870;201506;498;1700;435;1551;125;482;120;406;245;888
521878;201506;721;2139;528;1728;112;414;228;721;340;1135
521880;201506;25044;64063;16515;50204;4524;14815;5137;15740;9661;30555
521890;201506;3620;10886;2894;9481;937;3299;671;2121;1608;5420
521900;201506;1443;3741;1069;3208;253;820;391;1088;644;1908
521910;201506;1041;2843;922;2703;179;562;536;1629;715;2191
521920;201506;350;1042;296;943;102;370;77;208;179;578
521925;201506;648;1947;554;1778;98;338;231;683;329;1021
521930;201506;3922;12634;3486;11794;1138;4075;841;2822;1979;6897
521935;201506;642;1849;571;1719;157;477;277;814;434;1291
521940;201506;1033;2870;843;2565;225;736;356;1059;581;1795
521945;201506;653;2181;611;2122;104;335;418;1557;522;1892
521950;201506;624;1718;498;1524;101;348;256;788;357;1136
521960;201506;804;2334;639;2037;139;505;269;828;408;1333
521970;201506;2424;6894;2140;6533;273;854;1586;4963;1859;5817
521971;201506;1092;2921;798;2377;167;518;236;657;403;1175
521973;201506;917;2896;758;2587;176;650;264;885;440;1535
521975;201506;12780;35089;11879;34034;1937;5809;8481;24299;10418;30108
521980;201506;1920;5598;1695;5324;250;692;1310;4308;1560;5000
521990;201506;1060;3148;907;2911;119;441;577;1844;696;2285
522000;201506;2342;6343;1696;5521;247;908;1003;3367;1250;4275
522005;201506;419;1024;279;798;80;222;90;264;170;486
522010;201506;3145;9202;2630;8354;951;3150;601;1887;1552;5037
522015;201506;885;2674;749;2464;171;586;388;1278;559;1864
522020;201506;5285;13832;4364;12607;982;2972;2558;7445;3540;10417
522026;201506;627;1690;456;1487;124;447;161;537;285;984
522028;201506;525;1556;432;1351;82;267;265;817;347;1084
522040;201506;2698;6648;2046;5829;483;1434;1111;3188;1594;4622
522045;201506;14949;48685;12486;43625;3812;14669;2558;8650;6370;23319
522050;201506;1137;3210;858;2708;234;794;293;835;527;1629
522060;201506;2818;8482;2215;7553;642;2438;1041;3476;1683;5914
522068;201506;1602;5100;1474;4955;145;424;1176;4161;1321;4585
522070;201506;789;2375;709;2249;77;305;506;1590;583;1895
522100;201506;643;1872;565;1752;205;713;249;723;454;1436
522108;201506;913;2778;774;2576;68;257;596;1968;664;2225
522119;201506;1399;4314;1192;4001;256;915;625;2152;881;3067
522130;201506;469;1361;410;1291;133;442;209;657;342;1099
522140;201506;17876;49206;14702;43998;4308;13940;5007;14318;9315;28258
522145;201506;825;2312;739;2176;317;982;213;641;530;1623
522150;201506;923;2591;809;2403;243;734;313;915;556;1649
522155;201506;810;2327;711;2176;127;374;467;1482;594;1856
522157;201506;695;1972;593;1825;53;194;469;1431;522;1625
522160;201506;6167;17421;4418;14275;1467;5297;544;1583;2011;6880
522170;201506;3161;8823;2580;7867;844;2651;713;2214;1557;4865
522180;201506;357;1037;279;908;90;316;96;325;186;641
522185;201506;16354;48035;13900;44835;3448;11844;7460;24303;10908;36147
522190;201506;975;2455;751;2112;118;348;409;1170;527;1518
522200;201506;1681;5415;1436;4896;430;1610;410;1303;840;2913
522205;201506;1457;4178;1188;3744;298;1005;551;1692;849;2697
522220;201506;1388;3728;1116;3394;274;841;554;1859;828;2700
522230;201506;1198;3429;1032;3166;123;431;680;2088;803;2519
530010;201506;241333;759313;214190;710479;60128;221106;73871;240023;133999;461129
110001;201505;3911;12406;3255;11394;744;2776;1787;6292;2531;9068
110002;201505;13212;40112;10769;35802;3174;11604;4116;13470;7290;25074
110003;201505;887;2840;795;2674;232;815;220;698;452;1513
110004;201505;10327;32709;8565;29112;2808;10365;2106;7073;4914;17438
110005;201505;1943;6293;1763;5950;634;2212;727;2438;1361;4650
110006;201505;2255;6646;1533;5355;495;1870;294;897;789;2767
110007;201505;1390;4264;1310;4150;315;1104;630;2208;945;3312
110008;201505;2417;8200;2282;8005;398;1290;1708;6289;2106;7579
110009;201505;4826;14424;3931;13003;1073;3958;1627;5185;2700;9143
110010;201505;7941;23216;6933;21930;1682;5106;3940;13613;5622;18719
110011;201505;8674;26548;7288;24037;2423;8474;2756;8966;5179;17440
110012;201505;14339;43199;12078;39014;3814;13008;3914;12621;7728;25629
110013;201505;5501;16954;4427;15283;1534;5517;1557;5547;3091;11064
110014;201505;4490;12836;3694;11671;749;2465;2291;7329;3040;9794
110015;201505;5189;15587;3863;13226;1214;4575;1092;3693;2306;8268
110018;201505;4504;12718;3479;11356;940;3512;1483;4624;2423;8136
110020;201505;59204;166510;45711;148358;9980;34287;23921;79712;33901;113999
110025;201505;4330;12576;3570;11195;617;2055;2301;7181;2918;9236
110026;201505;662;2063;615;1994;157;516;369;1208;526;1724
110028;201505;7776;22258;5629;18619;1547;5649;1019;3157;2566;8806
110029;201505;1375;4118;1187;3785;356;1185;511;1652;867;2837
110030;201505;10358;28503;8152;25501;2026;6916;3843;12280;5869;19196
110032;201505;4105;13041;3631;12045;1150;3975;1260;4112;2410;8087
110033;201505;5439;17270;4993;16585;1540;5024;2402;8510;3942;13534
110034;201505;3626;9574;3078;8898;576;1587;2246;6636;2822;8223
110037;201505;2103;7042;1800;6465;478;1829;861;3061;1339;4890
110040;201505;3540;11171;3145;10480;943;3428;1448;4741;2391;8169
110045;201505;5270;17326;4640;16565;1462;5672;2429;8603;3891;14275
110050;201505;1742;5514;1471;5079;429;1528;779;2752;1208;4280
110060;201505;841;2800;733;2585;238;951;259;888;497;1839
110070;201505;2046;6828;1941;6613;479;1739;1118;3787;1597;5526
110080;201505;3909;11332;3541;10908;470;1358;2764;8852;3234;10210
110090;201505;796;2388;652;2132;181;676;290;876;471;1552
110092;201505;1385;4680;1297;4566;198;735;897;3260;1095;3995
110094;201505;3524;10785;3222;10352;999;3329;1584;5190;2583;8519
110100;201505;2326;7350;2081;6926;618;2164;1071;3549;1689;5713
110110;201505;1732;5473;1586;5289;694;2432;541;1850;1235;4282
110120;201505;1838;5934;1460;5099;461;1685;365;1268;826;2953
110130;201505;2695;7666;1997;6552;677;2348;573;1866;1250;4214
110140;201505;2563;8450;2250;7870;531;1992;1173;4115;1704;6107
110143;201505;1298;4113;1017;3614;264;992;487;1708;751;2700
110145;201505;1051;3025;882;2754;195;667;513;1579;708;2246
110146;201505;445;1387;393;1311;85;291;220;744;305;1035
110147;201505;851;2449;655;2117;176;612;240;696;416;1308
110148;201505;1355;4029;1007;3315;324;1134;220;672;544;1806
110149;201505;3607;10672;2898;9546;884;2943;1433;4870;2317;7813
110150;201505;2509;7471;2188;7003;341;1171;1340;4399;1681;5570
110155;201505;883;2771;813;2609;232;798;419;1313;651;2111
110160;201505;2208;6823;1821;6120;577;1999;763;2590;1340;4589
110170;201505;3139;8790;2325;7375;531;1789;1259;3966;1790;5755
110175;201505;1808;5388;1355;4811;231;897;796;2896;1027;3793
110180;201505;1522;4468;1267;4083;288;945;763;2520;1051;3465
120001;201505;2857;9965;2694;9690;508;1963;1742;6378;2250;8341
120005;201505;1485;6271;1448;6210;133;608;1164;5111;1297;5719
120010;201505;4477;15693;4248;15320;680;2397;3085;11479;3765;13876
120013;201505;1777;7040;1707;6936;395;1570;1084;4688;1479;6258
120017;201505;2057;7388;1922;7147;525;1996;915;3710;1440;5706
120020;201505;14160;63130;13745;62337;2082;9211;10158;47996;12240;57207
120025;201505;2642;9141;2548;9008;489;1864;1666;5964;2155;7828
120030;201505;6199;24487;6080;24352;284;1086;5536;22484;5820;23570
120032;201505;1441;6932;1383;6793;198;1154;990;4876;1188;6030
120033;201505;3456;13882;3429;13836;168;706;3148;12817;3316;13523
120034;201505;1976;8236;1913;8144;171;882;1583;6685;1754;7567
120035;201505;2900;13600;2859;13513;202;996;2490;11970;2692;12966
120038;201505;2664;9763;2547;9537;645;2504;1431;5471;2076;7975
120039;201505;1583;8212;1549;8131;185;1031;1227;6532;1412;7563
120040;201505;46904;167199;42681;158863;11108;44242;21237;80547;32345;124789
120042;201505;2881;12426;2741;12115;391;1879;1964;8838;2355;10717
120043;201505;891;4291;862;4241;63;280;734;3742;797;4022
120045;201505;4311;14804;4241;14710;672;2424;3320;11619;3992;14043
120050;201505;7948;33191;7607;32445;1261;5255;5168;23216;6429;28471
120060;201505;7332;33445;7221;33248;570;2909;6120;28607;6690;31516
120070;201505;2716;10267;2647;10113;468;1756;1805;7163;2273;8919
120080;201505;3634;13836;3478;13584;504;1967;2657;10678;3161;12645
130002;201505;2997;12498;2840;12238;199;988;2375;10284;2574;11272
130006;201505;1923;8161;1692;7741;263;1348;1161;5371;1424;6719
130008;201505;2105;8464;2006;8296;142;635;1690;7069;1832;7704
130010;201505;2869;9623;2500;9198;182;645;2181;8165;2363;8810
130014;201505;3282;10700;2898;10117;478;1782;1904;6723;2382;8505
130020;201505;2640;9586;2630;9574;23;79;2592;9455;2615;9534
130030;201505;7227;27517;6969;27213;562;1858;6015;24306;6577;26164
130040;201505;3783;11635;3406;11146;267;979;2878;9540;3145;10519
130050;201505;6281;24961;5680;24074;511;2059;4445;19838;4956;21897
130060;201505;5591;26179;5366;25802;454;2407;4412;21397;4866;23804
130063;201505;3543;15671;3480;15589;260;1122;3051;13942;3311;15064
130068;201505;3100;12990;2816;12424;388;1816;1894;8490;2282;10306
130070;201505;6731;21937;6017;21048;647;2233;4752;17087;5399;19320
130080;201505;5008;22555;4784;22219;804;3967;3360;16000;4164;19967
130083;201505;2173;8628;2054;8448;310;1456;1450;5969;1760;7425
130090;201505;2592;9365;2509;9249;131;556;2265;8366;2396;8922
130100;201505;5574;20900;5359;20619;232;1015;4921;18951;5153;19966
130110;201505;6604;21441;6196;20955;685;2123;5065;17719;5750;19842
130115;201505;4324;15388;4124;15123;81;257;3921;14492;4002;14749
130120;201505;14049;53618;13389;52767;1218;4511;11307;45824;12525;50335
130130;201505;3702;15454;3645;15346;292;1326;3103;13200;3395;14526
130140;201505;6242;24281;6168;24195;101;241;6035;23878;6136;24119
130150;201505;3415;13253;3344;13164;153;738;3054;11964;3207;12702
130160;201505;4135;17042;4025;16897;286;1101;3626;15446;3912;16547
130165;201505;2858;11795;2742;11600;313;1401;2189;9367;2502;10768
130170;201505;9030;32825;8093;31672;1035;4143;6245;25139;7280;29282
130180;201505;3468;11198;3384;11080;117;297;3149;10445;3266;10742
130185;201505;10760;35156;9805;34061;920;2879;8150;29545;9070;32424
130190;201505;17299;59249;15194;56551;2800;10437;10089;39287;12889;49724
130195;201505;1910;7992;1851;7907;106;450;1646;7133;1752;7583
130200;201505;1990;7126;1849;6899;495;1823;1103;4246;1598;6069
130210;201505;1176;4648;1112;4559;106;497;927;3824;1033;4321
130220;201505;1966;8123;1798;7802;328;1610;1044;4561;1372;6171
130230;201505;3631;16378;3425;16045;357;1633;2677;13095;3034;14728
130240;201505;8428;32331;7819;31434;377;1784;6869;27890;7246;29674
130250;201505;19430;67879;18384;66524;2557;8937;13916;52525;16473;61462
130255;201505;4208;14799;3983;14446;132;410;3662;13540;3794;13950
130260;201505;250091;817271;225679;776938;64038;232210;108487;380570;172525;612780
130270;201505;7105;29888;6548;28986;889;4079;4874;22269;5763;26348
130280;201505;3252;13123;3165;13002;121;444;2905;12200;3026;12644
130290;201505;11203;39485;10815;39026;156;279;10394;38205;10550;38484
130300;201505;4305;16887;4114;16584;292;1362;3470;14040;3762;15402
130310;201505;5139;19229;4733;18728;354;1402;3977;16101;4331;17503
130320;201505;2974;10445;2713;10087;358;1359;1982;7566;2340;8925
130330;201505;3511;12948;3277;12636;192;847;2831;11009;3023;11856
130340;201505;17875;68582;16706;67051;2985;11616;11921;50029;14906;61645
130350;201505;3236;13414;3166;13320;268;1250;2687;11409;2955;12659
130353;201505;5904;18092;5158;17126;1178;3798;3176;11339;4354;15137
130356;201505;4503;16145;4255;15788;377;1242;3491;13549;3868;14791
130360;201505;3169;9038;2928;8780;34;63;2839;8638;2873;8701
130370;201505;5259;20599;4521;19622;275;1483;3759;16384;4034;17867
130380;201505;7571;31437;7278;31040;474;2169;6356;27387;6830;29556
130390;201505;4839;21625;4509;21048;453;2308;3504;16689;3957;18997
130395;201505;2071;7463;1826;6961;285;1174;1178;4435;1463;5609
130400;201505;2100;7950;2019;7839;135;562;1787;6986;1922;7548
130406;201505;10418;39440;9374;37889;2226;9289;5716;23863;7942;33152
130410;201505;3936;14989;3581;14327;1089;4670;1602;6595;2691;11265
130420;201505;10364;43943;9966;43288;2639;11023;6321;28910;8960;39933
130423;201505;3213;12488;3033;12247;255;1195;2564;10381;2819;11576
130426;201505;2121;9231;2058;9128;282;1252;1583;7232;1865;8484
130430;201505;3409;12189;3266;11984;407;1569;2506;9341;2913;10910
130440;201505;3548;12984;3403;12827;184;652;3084;11817;3268;12469
140002;201505;1651;5296;1548;5173;155;507;1195;4106;1350;4613
140005;201505;3095;9001;2925;8818;80;170;2793;8521;2873;8691
140010;201505;52030;157548;44192;145422;10873;38463;21295;71980;32168;110443
140015;201505;2927;9431;2762;9218;340;929;2178;7628;2518;8557
140017;201505;3286;10137;2980;9754;282;823;2375;8088;2657;8911
140020;201505;4538;15428;4239;15016;422;1430;3388;12369;3810;13799
140023;201505;2135;7250;1891;6871;252;967;1323;4914;1575;5881
140028;201505;2175;5928;2085;5821;73;151;1910;5373;1983;5524
140030;201505;3709;11639;3512;11375;429;1094;2833;9560;3262;10654
140040;201505;1611;7545;1567;7440;114;645;1265;6050;1379;6695
140045;201505;2476;9168;2269;8872;471;1649;1473;6322;1944;7971
140047;201505;5462;15328;4866;14543;1416;4324;2384;7565;3800;11889
140050;201505;1526;4799;1385;4614;221;760;948;3218;1169;3978
140060;201505;1511;4662;1365;4433;280;955;891;2958;1171;3913
140070;201505;1468;7684;1427;7543;94;583;1211;6394;1305;6977
150010;201505;34085;106688;32362;104430;1983;6585;27838;91023;29821;97608
150013;201505;1678;4914;1547;4769;158;467;1235;3898;1393;4365
150020;201505;12332;41325;11947;40803;974;3263;10268;35607;11242;38870
150030;201505;6639;28543;6434;28236;602;2280;5438;24772;6040;27052
150034;201505;4314;11973;4105;11718;225;575;3710;10726;3935;11301
150040;201505;12692;41934;10952;39817;2161;7272;7465;29154;9626;36426
150050;201505;5787;22238;5581;21889;345;1516;4811;19014;5156;20530
150060;201505;16862;53546;15614;51708;2685;8503;10963;37603;13648;46106
150070;201505;5943;24346;5339;23688;385;1857;4620;20743;5005;22600
150080;201505;67608;177803;57529;164559;9845;26935;37164;110691;47009;137626
150085;201505;5192;17995;4937;17646;547;1683;4020;14965;4567;16648
150090;201505;9920;38288;9418;37576;849;3270;7734;31640;8583;34910
150095;201505;5258;17551;4783;16854;415;1351;3870;14138;4285;15489
150100;201505;3289;12326;3100;12010;191;926;2569;9857;2760;10783
150110;201505;3289;16289;3278;16264;139;620;3061;15372;3200;15992
150120;201505;6089;23413;5936;23148;681;2574;4789;19011;5470;21585
150125;201505;761;2235;682;2138;123;431;454;1387;577;1818
150130;201505;21684;66116;20193;64051;1869;5675;16011;52090;17880;57765
150140;201505;154058;442782;146684;433460;15083;43480;120114;360634;135197;404114
150145;201505;4545;14520;4173;14045;610;2083;3151;10820;3761;12903
150150;201505;11155;35077;10355;33852;1704;5756;7236;23989;8940;29745
150157;201505;3130;9466;2739;8915;353;1262;2023;6688;2376;7950
150160;201505;3039;9886;2837;9592;803;2699;1618;5717;2421;8416
150170;201505;22185;81410;20750;79214;3466;13315;14767;57576;18233;70891
150172;201505;3026;10477;2704;9958;429;1615;1900;7182;2329;8797
150175;201505;1974;5957;1867;5841;124;309;1611;5275;1735;5584
150178;201505;10258;32031;9239;30906;765;2486;7461;25975;8226;28461
150180;201505;18088;72604;17399;71688;1437;6353;14630;60986;16067;67339
150190;201505;7238;23575;6863;23075;368;873;6028;21034;6396;21907
150195;201505;5124;17073;4760;16483;324;1203;4009;14012;4333;15215
150200;201505;5279;16988;5062;16739;140;432;4710;15776;4850;16208
150210;201505;24274;91713;23468;90584;2279;8087;19319;77414;21598;85501
150215;201505;6513;20506;5628;19137;1537;5534;2535;8736;4072;14270
150220;201505;12566;39242;11243;37172;2538;8659;5975;20208;8513;28867
150230;201505;11240;37346;10006;35569;1200;4845;7335;26142;8535;30987
150240;201505;35411;105396;31190;98291;10194;33376;11145;36502;21339;69878
150250;201505;4058;16466;3920;16264;530;2242;2998;12814;3528;15056
150260;201505;2114;8490;2012;8305;397;1683;1256;5333;1653;7016
150270;201505;8765;27087;7025;24912;1583;5917;4267;15478;5850;21395
150275;201505;5846;21308;5555;20860;727;2759;4205;16155;4932;18914
150276;201505;2111;6338;1904;6059;402;1361;1356;4325;1758;5686
150277;201505;4962;15388;4307;14576;724;2456;3027;10619;3751;13075
150280;201505;5812;25911;5649;25552;1106;4983;3791;17727;4897;22710
150285;201505;2676;10779;2554;10554;524;2232;1610;6917;2134;9149
150290;201505;9715;28835;9311;28380;732;1753;8042;25483;8774;27236
150293;201505;9558;26529;7393;23474;2228;7552;2790;9579;5018;17131
150295;201505;6845;20758;5699;19405;1214;4010;3632;13284;4846;17294
150300;201505;1805;6361;1732;6272;123;416;1429;5356;1552;5772
150304;201505;4060;12782;3556;12066;574;1992;2409;8414;2983;10406
150307;201505;6518;21993;6039;21327;404;1301;5091;18311;5495;19612
150309;201505;6363;22127;5845;21385;1248;4499;3872;14896;5120;19395
150310;201505;5786;25799;5616;25511;635;2947;4499;20860;5134;23807
150320;201505;9151;21603;8510;20945;475;775;7643;19494;8118;20269
150330;201505;13655;47230;12749;45916;1537;5414;9776;36345;11313;41759
150340;201505;2372;7744;2198;7485;315;1128;1607;5549;1922;6677
150345;201505;6552;22117;6140;21568;599;2063;4993;17977;5592;20040
150350;201505;7734;24576;7236;23929;1120;3208;5371;18526;6491;21734
150360;201505;20910;65851;18349;62527;2854;9741;12799;45173;15653;54914
150370;201505;9561;35689;9083;35060;1130;3860;7401;29752;8531;33612
150375;201505;2792;12163;2724;12070;237;979;2361;10734;2598;11713
150380;201505;9793;28786;8726;27331;660;2147;7277;23129;7937;25276
150390;201505;7806;33752;7372;32968;1377;5968;4882;22781;6259;28749
150400;201505;5770;22952;5529;22447;522;2085;4340;18089;4862;20174
150405;201505;8161;24891;7294;23822;1368;3736;5019;17861;6387;21597
150410;201505;1635;6365;1556;6207;244;1067;1030;4186;1274;5253
150420;201505;36187;123397;31071;115015;9135;36496;12656;48832;21791;85328
150430;201505;7011;24017;6681;23484;936;3151;4859;17620;5795;20771
150440;201505;5424;18936;5215;18650;945;3243;3723;13772;4668;17015
150442;201505;20021;59739;18292;57232;3278;10541;11969;38273;15247;48814
150445;201505;5076;17810;4722;17240;615;2180;3543;13298;4158;15478
150450;201505;4271;20589;4109;20351;347;1740;3466;17514;3813;19254
150460;201505;6437;25003;5889;24359;335;1556;5165;21793;5500;23349
150470;201505;17239;52770;16588;51995;559;1326;15518;49486;16077;50812
150475;201505;2284;7975;2106;7749;231;831;1727;6533;1958;7364
150480;201505;13577;46762;12747;45534;1179;4375;10505;38049;11684;42424
150490;201505;6778;26092;6625;25868;291;1128;6009;23760;6300;24888
150495;201505;5005;18486;4887;18329;158;573;4588;17362;4746;17935
150497;201505;2893;10435;2605;9907;800;3217;1278;4878;2078;8095
150500;201505;3161;8779;2930;8446;337;970;2212;6385;2549;7355
150503;201505;3812;11833;3296;11192;1121;3885;1697;6063;2818;9948
150506;201505;11375;40075;10333;38590;2316;8141;6670;26605;8986;34746
150510;201505;9620;37767;8884;36407;1366;5717;6176;26263;7542;31980
150520;201505;6681;26008;6588;25884;194;574;6256;24929;6450;25503
150530;201505;11905;41425;10779;39720;1179;4100;8267;31264;9446;35364
150540;201505;4584;14161;4156;13559;293;991;3467;11349;3760;12340
150543;201505;5387;16891;4866;16132;1031;3562;3128;10582;4159;14144
150548;201505;8699;28065;8176;27410;310;940;7516;25535;7826;26475
150549;201505;2143;6945;1991;6773;70;173;1826;6371;1896;6544
150550;201505;19971;63114;17456;58797;5366;18660;7098;24486;12464;43146
150553;201505;22318;77096;18702;69459;7075;28093;4796;17989;11871;46082
150555;201505;1642;5128;1461;4865;110;407;1173;3932;1283;4339
150560;201505;1934;6279;1829;6052;254;859;1257;4166;1511;5025
150563;201505;2932;9550;2718;9171;661;2397;1510;5118;2171;7515
150565;201505;3672;12755;3356;12263;197;847;2773;10249;2970;11096
150570;201505;5606;20883;5487;20686;373;1429;4665;17969;5038;19398
150580;201505;9546;39833;9331;39577;599;2239;8325;36240;8924;38479
150590;201505;5656;22896;5508;22718;91;261;5303;22121;5394;22382
150600;201505;7901;30544;7629;30153;392;1511;6860;27575;7252;29086
150610;201505;2395;8215;2192;7803;261;1024;1522;5365;1783;6389
150611;201505;2700;9556;2528;9211;228;911;1961;7178;2189;8089
150613;201505;11928;36531;10304;34179;3431;11819;4750;16302;8181;28121
150616;201505;3092;9438;2427;8408;620;2379;1023;3412;1643;5791
150618;201505;6462;22468;6030;21693;1725;6428;3135;11458;4860;17886
150619;201505;5153;17811;4830;17320;558;2229;3631;13053;4189;15282
150620;201505;6371;22977;5827;22290;755;2814;4652;18373;5407;21187
150630;201505;5674;17192;5391;16857;385;1197;4647;14823;5032;16020
150635;201505;4114;13563;3800;12955;803;2842;2107;7378;2910;10220
150640;201505;1754;5447;1702;5382;198;585;1389;4595;1587;5180
150650;201505;12540;38038;11192;35744;3023;9836;5266;17409;8289;27245
150655;201505;4991;16894;4747;16468;637;2258;3512;12370;4149;14628
150658;201505;4268;13409;3857;12818;920;3408;2336;7729;3256;11137
150660;201505;5602;17835;5105;17139;1270;4176;2900;10148;4170;14324
150670;201505;6472;17964;5422;16646;985;3171;3860;12161;4845;15332
150680;201505;54389;198349;48464;188019;14930;59907;20960;86901;35890;146808
150690;201505;2016;6298;1825;5990;334;1031;1170;3999;1504;5030
150700;201505;6201;19067;5682;18411;1056;3509;3823;12700;4879;16209
150710;201505;4271;14291;3825;13571;432;1540;2862;10391;3294;11931
150715;201505;5021;15934;4388;14977;534;1934;3312;11478;3846;13412
150720;201505;6453;26427;6081;25760;886;3783;4419;19464;5305;23247
150730;201505;9311;32282;8870;31606;957;3316;7263;26511;8220;29827
150740;201505;3733;11910;3353;11235;562;1993;2048;6923;2610;8916
150745;201505;5365;17012;4942;16421;1101;3825;3196;10633;4297;14458
150746;201505;1410;4603;1343;4488;192;689;934;3155;1126;3844
150747;201505;5360;16792;4727;16000;453;1321;3652;13162;4105;14483
150750;201505;3065;10347;2904;10149;166;588;2570;9080;2736;9668
150760;201505;10919;35707;10262;34844;2138;7309;6669;23359;8807;30668
150770;201505;5839;22131;5444;21310;565;2109;4396;18153;4961;20262
150775;201505;1181;3603;1037;3349;211;835;584;1824;795;2659
150780;201505;3173;10502;3127;10452;55;137;3007;10150;3062;10287
150790;201505;5078;16336;4683;15863;382;1327;3840;13591;4222;14918
150795;201505;15868;49183;14250;46845;2923;9430;9036;30878;11959;40308
150796;201505;2974;8899;2731;8617;370;1123;2098;6871;2468;7994
150797;201505;3728;12595;3473;12210;142;554;3069;10874;3211;11428
150800;201505;13787;45971;12693;44639;2581;8478;8754;32550;11335;41028
150803;201505;6632;24055;6241;23430;680;2622;4787;18366;5467;20988
150805;201505;2739;9632;2555;9354;324;1147;1912;7194;2236;8341
150808;201505;5935;20061;5032;18379;2090;8186;956;3511;3046;11697
150810;201505;19219;60224;16344;56722;2290;7503;11662;42861;13952;50364
150812;201505;5335;16791;4907;16089;500;2035;3607;11414;4107;13449
150815;201505;8580;27906;7745;26887;797;2672;6386;22752;7183;25424
150820;201505;11397;32328;10089;30893;690;1393;8750;27968;9440;29361
150830;201505;13047;48952;11983;47336;609;2644;10043;41071;10652;43715
150835;201505;2022;7198;1875;6894;471;1829;904;3348;1375;5177
150840;201505;6740;20448;5596;18631;1288;4655;2854;9435;4142;14090
160005;201505;694;2552;652;2481;73;334;486;1822;559;2156
160010;201505;1413;4694;1409;4689;74;160;1306;4463;1380;4623
160015;201505;1707;6324;1665;6259;108;378;1466;5645;1574;6023
160020;201505;2033;7179;1890;6985;234;855;1422;5462;1656;6317
160021;201505;946;4084;916;4030;146;720;653;2910;799;3630
160023;201505;1076;4244;1061;4220;77;257;934;3816;1011;4073
160025;201505;1259;3869;1247;3856;9;31;1231;3809;1240;3840
160027;201505;8253;24812;7653;24151;2732;8150;3983;13703;6715;21853
160030;201505;44426;159437;39776;150797;9424;35525;22861;91193;32285;126718
160040;201505;4193;16437;4098;16297;115;535;3848;15306;3963;15841
160050;201505;3213;12112;2916;11713;1305;5197;1222;5254;2527;10451
160053;201505;2638;10241;2574;10143;573;2331;1720;6937;2293;9268
160055;201505;661;2590;649;2578;90;392;504;2012;594;2404
160060;201505;15643;53204;14665;52104;2935;9864;10225;37852;13160;47716
160070;201505;2441;9512;2343;9366;136;571;2066;8343;2202;8914
160080;201505;2569;9623;2558;9611;30;101;2514;9480;2544;9581
170025;201505;544;1813;500;1752;147;516;260;960;407;1476
170030;201505;1172;3829;1033;3578;311;1101;385;1361;696;2462
170035;201505;1523;4462;1225;3921;374;1284;421;1365;795;2649
170040;201505;1870;6081;1654;5786;276;1103;1049;3773;1325;4876
170070;201505;1988;5179;1545;4616;377;1239;840;2524;1217;3763
170100;201505;2504;7264;2203;6795;255;829;1711;5273;1966;6102
170105;201505;760;2395;613;2096;116;467;308;1004;424;1471
170110;201505;1086;3387;934;3139;218;794;456;1533;674;2327
170130;201505;1399;4372;1211;4053;305;1061;621;2166;926;3227
170190;201505;1593;4668;1211;4059;503;1619;270;1039;773;2658
170200;201505;1636;4636;1094;3596;268;971;328;1032;596;2003
170210;201505;31750;91429;25640;81408;7601;26150;8116;26823;15717;52973
170215;201505;1184;3710;1019;3456;85;340;779;2630;864;2970
170220;201505;5823;19947;5372;19135;1154;4369;3092;11109;4246;15478
170230;201505;1478;4760;1234;4298;265;1080;592;1968;857;3048
170240;201505;2730;8244;2303;7612;305;1189;1584;5202;1889;6391
170255;201505;3643;11522;3022;10503;889;3110;1279;4689;2168;7799
170270;201505;1058;2653;735;2209;93;301;486;1447;579;1748
170290;201505;2721;8528;2546;8320;157;384;2248;7637;2405;8021
170300;201505;1966;6102;1643;5573;216;834;1076;3664;1292;4498
170305;201505;774;2352;624;2079;108;391;336;1136;444;1527
170307;201505;1088;3786;910;3455;180;745;478;1905;658;2650
170310;201505;1641;4525;1252;3887;298;976;606;1930;904;2906
170320;201505;1114;3244;820;2722;208;728;308;1045;516;1773
170330;201505;757;2475;692;2370;100;389;500;1688;600;2077
170360;201505;446;1453;382;1344;89;336;177;604;266;940
170370;201505;1381;3987;1103;3538;240;873;551;1762;791;2635
170380;201505;1856;5992;1509;5441;295;1232;811;2880;1106;4112
170382;201505;558;1854;484;1736;115;474;269;947;384;1421
170384;201505;1560;6382;1457;6203;348;1591;859;3703;1207;5294
170386;201505;952;2803;825;2615;196;695;434;1390;630;2085
170388;201505;648;1934;532;1738;115;447;216;671;331;1118
170389;201505;919;3085;840;2954;89;354;615;2151;704;2505
170390;201505;1331;3859;1151;3631;128;426;857;2764;985;3190
170410;201505;520;1666;457;1551;52;218;299;991;351;1209
170460;201505;503;1366;355;1115;83;295;121;370;204;665
170510;201505;777;2614;636;2349;86;381;338;1221;424;1602
170550;201505;6548;18955;4968;16155;1642;5911;917;2904;2559;8815
170555;201505;1362;3932;1070;3479;232;828;545;1789;777;2617
170560;201505;1007;3368;799;3101;172;723;469;1885;641;2608
170600;201505;1338;3837;1193;3641;250;750;777;2467;1027;3217
170610;201505;1676;5089;1306;4502;143;584;813;2804;956;3388
170625;201505;436;1354;342;1174;67;243;100;346;167;589
170650;201505;1269;4043;1099;3743;272;1010;480;1681;752;2691
170700;201505;4074;13087;3343;11866;699;2728;1569;5804;2268;8532
170710;201505;1852;5440;1496;4800;230;776;927;3034;1157;3810
170720;201505;1875;5026;1550;4520;322;853;972;2982;1294;3835
170730;201505;1047;2990;849;2686;228;776;386;1228;614;2004
170740;201505;2238;7979;1982;7535;284;1204;1363;5237;1647;6441
170755;201505;845;2595;696;2282;166;612;236;746;402;1358
170765;201505;1381;3745;1087;3265;292;927;483;1492;775;2419
170770;201505;1764;5981;1618;5717;277;1054;1011;3612;1288;4666
170820;201505;3786;12056;3395;11422;833;2979;1605;5512;2438;8491
170825;201505;768;2304;609;1991;118;417;254;812;372;1229
170830;201505;1399;4097;1242;3868;24;41;1147;3632;1171;3673
170900;201505;2702;9452;2556;9202;250;888;2024;7480;2274;8368
170930;201505;3708;11505;3171;10581;1001;3596;1095;3682;2096;7278
170950;201505;14236;40948;10529;34478;3490;12921;2178;6876;5668;19797
170980;201505;501;1507;378;1296;91;349;156;503;247;852
171050;201505;1452;4966;1332;4746;82;337;1106;3953;1188;4290
171070;201505;1579;4895;1441;4699;297;985;892;2997;1189;3982
171090;201505;1008;2806;844;2576;78;249;607;1848;685;2097
171110;201505;615;1791;466;1531;126;458;204;628;330;1086
171150;201505;872;2501;640;2093;119;428;361;1189;480;1617
171180;201505;691;2068;492;1660;125;440;193;694;318;1134
171190;201505;1774;6399;1542;5930;329;1364;759;3019;1088;4383
171195;201505;839;2974;729;2752;98;419;418;1606;516;2025
171200;201505;711;2277;589;2044;155;604;240;767;395;1371
171215;201505;458;1359;354;1156;66;239;148;492;214;731
171240;201505;757;2646;698;2532;86;362;479;1773;565;2135
171245;201505;665;2163;544;1880;123;474;183;586;306;1060
171250;201505;1126;3247;898;2870;149;554;542;1643;691;2197
171270;201505;435;1775;404;1717;131;543;167;784;298;1327
171280;201505;918;2777;780;2568;184;599;403;1446;587;2045
171320;201505;3935;11905;3343;10902;890;2959;1645;5478;2535;8437
171330;201505;2944;8652;2433;7855;635;2210;1121;3590;1756;5800
171360;201505;1471;4711;1275;4411;198;690;839;2980;1037;3670
171370;201505;723;2053;627;1919;137;456;340;1022;477;1478
171380;201505;1323;4320;1122;3945;428;1526;390;1403;818;2929
171395;201505;896;2712;710;2369;154;621;329;1037;483;1658
171420;201505;2268;6836;1762;5937;431;1550;681;2268;1112;3818
171430;201505;1055;3258;888;2988;217;733;465;1567;682;2300
171488;201505;2544;7768;2257;7363;536;1740;1247;4243;1783;5983
171500;201505;803;2460;695;2259;89;264;466;1571;555;1835
171510;201505;919;3210;820;3052;89;379;578;2189;667;2568
171515;201505;511;1471;399;1287;60;200;220;705;280;905
171525;201505;617;2026;522;1861;104;426;284;991;388;1417
171550;201505;320;1066;250;928;89;372;38;149;127;521
171570;201505;1232;3925;1091;3656;187;651;739;2483;926;3134
171575;201505;1869;5374;1455;4596;277;897;691;2245;968;3142
171610;201505;5658;18643;4887;17267;1412;5496;1684;5848;3096;11344
171620;201505;2582;7608;2270;7174;120;442;1915;6082;2035;6524
171630;201505;884;2841;733;2580;238;914;273;930;511;1844
171650;201505;2308;7104;1813;6149;475;1757;675;2289;1150;4046
171660;201505;2477;6841;1926;5868;271;888;1149;3528;1420;4416
171665;201505;1454;4336;1196;3931;184;663;730;2487;914;3150
171670;201505;2085;5888;1724;5312;453;1569;799;2333;1252;3902
171700;201505;1092;3565;955;3305;140;563;622;2126;762;2689
171720;201505;742;2197;624;1991;217;721;245;801;462;1522
171750;201505;1188;3739;978;3313;279;1001;340;1162;619;2163
171780;201505;1273;3435;934;2970;118;416;535;1746;653;2162
171790;201505;1559;5135;1341;4829;244;844;865;3278;1109;4122
171800;201505;669;2105;591;2001;79;296;423;1453;502;1749
171820;201505;10035;29713;8642;27826;1736;6096;5052;16357;6788;22453
171830;201505;1489;5522;1349;5224;360;1453;623;2420;983;3873
171840;201505;812;2282;710;2141;46;137;587;1796;633;1933
171845;201505;796;2149;608;1837;110;373;317;934;427;1307
171850;201505;979;3456;866;3230;112;482;532;1988;644;2470
171855;201505;1150;3632;1043;3432;90;355;790;2540;880;2895
171865;201505;486;1559;414;1442;100;386;207;698;307;1084
171870;201505;721;2197;584;1957;133;483;248;874;381;1357
171875;201505;1367;4240;1122;3869;122;509;783;2651;905;3160
171880;201505;881;3233;859;3196;85;331;690;2627;775;2958
171884;201505;945;2643;687;2258;155;577;218;810;373;1387
171886;201505;1469;4815;1211;4273;378;1466;353;1213;731;2679
171888;201505;691;2102;567;1876;68;245;331;1124;399;1369
171889;201505;509;1630;472;1568;95;330;282;956;377;1286
171890;201505;1170;3718;1008;3495;137;539;666;2328;803;2867
171900;201505;507;1888;451;1779;124;496;222;883;346;1379
172000;201505;599;1961;520;1813;85;329;296;1031;381;1360
172010;201505;1186;4163;1111;4037;107;453;869;3165;976;3618
172015;201505;350;1355;297;1262;57;244;166;740;223;984
172020;201505;2311;7733;2140;7461;270;995;1517;5356;1787;6351
172025;201505;753;2150;580;1852;67;244;328;1061;395;1305
172030;201505;1128;3752;1001;3530;102;443;719;2519;821;2962
172049;201505;1346;3583;1022;3026;135;415;770;2321;905;2736
172065;201505;1239;3463;1057;3250;64;210;953;2959;1017;3169
172080;201505;2578;7934;2178;7239;241;937;1477;4844;1718;5781
172085;201505;520;1425;376;1155;62;197;125;373;187;570
172090;201505;3203;9685;2597;8777;358;1335;1779;6111;2137;7446
172093;201505;603;1861;477;1652;125;542;236;780;361;1322
172097;201505;680;1996;542;1779;134;447;218;749;352;1196
172100;201505;30428;95971;24784;85435;7649;29323;6755;22903;14404;52226
172110;201505;1709;6336;1535;6061;191;788;1125;4575;1316;5363
172120;201505;5344;16272;4443;15087;552;1944;3178;11074;3730;13018
172125;201505;299;889;238;794;42;161;106;353;148;514
172130;201505;550;1534;441;1357;47;172;295;924;342;1096
172208;201505;2157;6518;1953;6217;360;1255;1115;3567;1475;4822
172210;201505;2426;7586;2182;7198;491;1764;1235;4013;1726;5777
210005;201505;22234;69532;18958;64537;5707;20898;8230;28332;13937;49230
210010;201505;1638;5858;1459;5588;147;602;1116;4360;1263;4962
210015;201505;3296;10538;2973;10063;184;414;2585;9082;2769;9496
210020;201505;6963;17252;6552;16755;260;711;5905;15085;6165;15796
210030;201505;5657;18806;5303;18321;379;1668;4395;15117;4774;16785
210040;201505;1887;5404;1722;5215;126;412;1436;4356;1562;4768
210043;201505;6501;18784;5706;17765;532;1587;4396;14274;4928;15861
210047;201505;6590;25527;6057;24633;741;3289;4371;17987;5112;21276
210050;201505;2382;8659;1965;7954;663;2797;779;3303;1442;6100
210055;201505;1710;5845;1577;5660;164;612;1215;4414;1379;5026
210060;201505;7512;28535;6891;27480;717;3172;5112;20786;5829;23958
210070;201505;6974;20772;6483;20177;176;611;5873;18403;6049;19014
210080;201505;3706;12826;3630;12732;49;205;3468;12198;3517;12403
210083;201505;4315;14981;4025;14670;106;312;3808;14098;3914;14410
210087;201505;2868;8605;2631;8309;219;701;2207;7084;2426;7785
210090;201505;9962;32561;9467;31781;408;1596;8299;27960;8707;29556
210095;201505;5909;21969;5733;21726;433;1681;4849;18710;5282;20391
210100;201505;7203;21616;6683;21007;615;2154;5495;17216;6110;19370
210110;201505;3006;10576;2911;10458;112;479;2619;9456;2731;9935
210120;201505;26246;72568;22468;68145;2685;6976;17055;54682;19740;61658
210125;201505;3598;11504;3450;11345;239;610;3054;10344;3293;10954
210130;201505;4318;12866;4063;12521;308;1023;3380;10429;3688;11452
210135;201505;1689;4958;1495;4690;115;362;1231;3918;1346;4280
210140;201505;17400;55695;15097;52477;2829;10121;9442;34111;12271;44232
210150;201505;4508;11251;4071;10715;73;185;3792;9987;3865;10172
210160;201505;17513;55818;16499;54330;1647;4798;13424;45793;15071;50591
210170;201505;14126;50713;13777;50262;805;2620;12331;45979;13136;48599
210173;201505;1926;7987;1879;7904;104;489;1678;7080;1782;7569
210177;201505;3021;9499;2862;9311;190;679;2481;8084;2671;8763
210180;201505;1552;4749;1447;4591;78;284;1232;3900;1310;4184
210190;201505;4916;15619;4570;15016;258;1137;3628;11731;3886;12868
210193;201505;1413;4471;1277;4246;76;264;1069;3613;1145;3877
210197;201505;2084;6901;1929;6734;215;680;1562;5673;1777;6353
210200;201505;8731;29377;8089;28459;990;3241;6178;22678;7168;25919
210203;201505;6488;21180;6151;20750;392;1130;5481;18845;5873;19975
210207;201505;3054;10033;2856;9685;379;1186;2085;7326;2464;8512
210210;201505;8553;29030;8157;28534;130;573;7505;26618;7635;27191
210215;201505;1442;5728;1385;5640;123;564;1134;4634;1257;5198
210220;201505;6114;23511;5828;23062;425;1753;4833;19486;5258;21239
210230;201505;5140;17100;4769;16524;318;1145;4022;14092;4340;15237
210232;201505;12088;40191;10284;37977;1616;6065;7122;27859;8738;33924
210235;201505;3529;11110;3225;10722;178;663;2783;9336;2961;9999
210237;201505;2452;9288;2416;9239;37;125;2328;8969;2365;9094
210240;201505;3016;9544;2849;9312;165;514;2423;8019;2588;8533
210250;201505;5012;16209;4753;15877;123;511;4416;14751;4539;15262
210255;201505;2516;8062;2307;7685;380;1322;1608;5406;1988;6728
210260;201505;5383;17120;4898;16413;677;2192;3607;12473;4284;14665
210270;201505;5343;15272;4732;14425;111;462;4272;12997;4383;13459
210275;201505;3610;8923;3404;8704;62;97;3293;8522;3355;8619
210280;201505;5653;17026;4967;16142;292;1117;4112;13347;4404;14464
210290;201505;5649;18510;5171;17924;376;1241;4412;15645;4788;16886
210300;201505;37183;106128;30765;98242;2119;6926;24251;80519;26370;87445
210310;201505;2916;8321;2722;8065;101;257;2415;7223;2516;7480
210312;201505;2181;7049;2115;6955;79;333;1917;6309;1996;6642
210315;201505;2465;8531;2337;8351;121;480;2044;7362;2165;7842
210317;201505;4307;13032;4110;12783;236;704;3682;11613;3918;12317
210320;201505;19146;61120;17804;59505;947;3024;15662;53457;16609;56481
210325;201505;3582;11259;3205;10700;334;1189;2425;8206;2759;9395
210330;201505;36834;88968;28630;80284;3661;7985;20731;65388;24392;73373
210340;201505;11759;35733;10650;34347;1331;3471;7883;27460;9214;30931
210350;201505;10235;32134;9363;30937;633;2079;7764;26101;8397;28180
210355;201505;3937;14338;3638;13919;161;476;3290;13007;3451;13483
210360;201505;16907;50887;15483;48938;1174;3771;12514;40268;13688;44039
210370;201505;9458;22764;7977;21190;262;467;7226;19843;7488;20310
210375;201505;3235;9689;2702;9041;779;2701;1423;4933;2202;7634
210380;201505;6242;17578;5537;16640;440;1175;4642;14317;5082;15492
210390;201505;2844;10063;2596;9658;114;542;2247;8398;2361;8940
210400;201505;4976;15564;4765;15313;161;465;4395;14302;4556;14767
210405;201505;8458;23313;6838;21062;2074;6367;2889;9881;4963;16248
210407;201505;2059;7335;1814;6931;199;720;1400;5552;1599;6272
210408;201505;2353;9171;2205;8997;90;333;1970;8353;2060;8686
210409;201505;3770;13749;3564;13440;194;823;3030;11559;3224;12382
210410;201505;3517;11724;3390;11570;281;754;2926;10370;3207;11124
210420;201505;4098;13509;3777;12958;262;885;3117;10894;3379;11779
210430;201505;2198;6800;2129;6718;119;383;1891;5991;2010;6374
210440;201505;4110;12887;4006;12744;207;601;3613;11676;3820;12277
210450;201505;2896;9142;2599;8711;179;679;2141;7151;2320;7830
210455;201505;4139;12133;3650;11392;572;1800;2535;8187;3107;9987
210460;201505;3857;12492;3563;12087;145;577;3103;10587;3248;11164
210462;201505;1643;5916;1534;5713;104;450;1241;4655;1345;5105
210465;201505;2644;8718;2470;8492;288;784;2001;7216;2289;8000
210467;201505;6251;20652;5838;20171;374;1067;5078;18087;5452;19154
210470;201505;2055;5666;1585;4989;81;264;1277;4096;1358;4360
210480;201505;14066;46037;12284;43681;3001;10452;7357;27928;10358;38380
210490;201505;3489;10068;3129;9554;179;603;2627;8001;2806;8604
210500;201505;6406;26163;6142;25720;725;2879;4731;20586;5456;23465
210510;201505;6548;22338;6247;21983;330;838;5494;20061;5824;20899
210515;201505;3547;11901;3412;11741;126;364;3167;11076;3293;11440
210520;201505;2604;8127;2391;7834;106;351;2123;7031;2229;7382
210530;201505;37120;115132;29987;104383;7745;30402;13620;48520;21365;78922
210535;201505;3244;11377;3115;11189;127;466;2790;10120;2917;10586
210540;201505;13222;44592;11728;42315;2750;9592;6573;25731;9323;35323
210542;201505;5910;17427;5406;16878;325;791;4762;15360;5087;16151
210545;201505;2331;7591;2208;7392;82;392;1919;6390;2001;6782
210547;201505;3769;13266;3534;12884;287;980;2851;10674;3138;11654
210550;201505;5969;17596;5485;17095;249;540;5029;16134;5278;16674
210560;201505;4233;13186;3780;12460;217;823;3181;10447;3398;11270
210565;201505;1539;5338;1321;5004;114;545;979;3729;1093;4274
210570;201505;12605;35561;11292;34044;830;1822;9647;30219;10477;32041
210580;201505;3154;9577;2841;9190;344;874;2195;7753;2539;8627
210590;201505;4263;13296;3997;12979;241;785;3528;11593;3769;12378
210592;201505;2483;7772;2387;7620;64;254;2146;6851;2210;7105
210594;201505;2726;7724;2266;7069;127;344;1852;5965;1979;6309
210596;201505;2771;10298;2623;10023;276;1106;1983;7707;2259;8813
210598;201505;1925;5987;1785;5812;102;392;1592;5158;1694;5550
210600;201505;3265;9501;2890;8988;196;652;2364;7350;2560;8002
210610;201505;2738;8721;2476;8400;159;603;2108;7236;2267;7839
210620;201505;1942;6057;1799;5877;49;122;1657;5508;1706;5630
210630;201505;3665;13059;3237;12326;423;1699;2147;8413;2570;10112
210632;201505;4631;16013;4271;15506;391;1455;3481;12824;3872;14279
210635;201505;1921;6778;1829;6639;71;248;1661;6119;1732;6367
210637;201505;2783;9384;2591;9120;144;532;2216;7920;2360;8452
210640;201505;4266;15237;4190;15153;10;38;4101;14937;4111;14975
210650;201505;6902;21251;6751;21078;93;258;6562;20615;6655;20873
210660;201505;7827;23807;7271;22999;211;579;6780;21598;6991;22177
210663;201505;2680;7917;2522;7722;171;570;2146;6627;2317;7197
210667;201505;1801;6375;1715;6243;86;369;1503;5514;1589;5883
210670;201505;4485;16804;4302;16505;261;1105;3633;14151;3894;15256
210675;201505;4981;13947;4617;13502;330;869;3935;11773;4265;12642
210680;201505;4336;12259;3930;11777;203;550;3431;10439;3634;10989
210690;201505;7277;24117;6862;23675;261;776;6214;22065;6475;22841
210700;201505;2632;7897;2456;7705;435;1080;1708;6097;2143;7177
210710;201505;4801;15828;4573;15471;180;695;4018;13674;4198;14369
210720;201505;2541;9263;2388;9040;150;661;2094;7893;2244;8554
210725;201505;1105;4138;969;3896;138;597;586;2373;724;2970
210730;201505;1124;3620;1037;3505;90;253;858;2974;948;3227
210735;201505;4075;14375;3750;13823;695;2575;2517;9650;3212;12225
210740;201505;5000;14583;4735;14315;135;455;4507;13662;4642;14117
210745;201505;3891;11657;3635;11317;250;611;3107;9880;3357;10491
210750;201505;20535;55785;18259;53231;2019;5786;14501;43291;16520;49077
210760;201505;5998;16691;5647;16322;45;142;5524;15999;5569;16141
210770;201505;5820;16239;5145;15477;159;532;4710;14223;4869;14755
210780;201505;8548;28358;7834;27100;903;3312;5635;19876;6538;23188
210790;201505;4855;14823;4180;14078;292;734;3500;12379;3792;13113
210800;201505;4775;13840;4395;13399;139;409;3993;12346;4132;12755
210805;201505;3664;15533;3540;15314;138;612;3124;13741;3262;14353
210810;201505;5452;16780;5091;16341;371;657;4474;15175;4845;15832
210820;201505;8154;23444;7479;22519;1292;3785;5067;15721;6359;19506
210825;201505;5715;19461;5468;19149;367;1160;4719;16931;5086;18091
210830;201505;8480;25545;8095;25085;783;2119;6739;21546;7522;23665
210840;201505;3734;10303;3375;9770;215;553;2743;7998;2958;8551
210845;201505;5774;17941;5543;17689;157;365;5156;16824;5313;17189
210850;201505;6139;22116;5630;21238;763;3213;4023;15288;4786;18501
210860;201505;17473;52869;15918;50783;1446;4730;12672;41057;14118;45787
210870;201505;6076;20115;5530;19473;551;1774;4461;16205;5012;17979
210880;201505;4261;13822;4134;13645;180;578;3744;12498;3924;13076
210890;201505;5407;15904;4940;15361;411;1328;4129;13053;4540;14381
210900;201505;5023;15242;4186;13881;1424;4898;1458;5180;2882;10078
210905;201505;1867;5841;1717;5639;127;321;1422;4850;1549;5171
210910;201505;9018;28624;8235;27382;1367;4843;5655;18978;7022;23821
210920;201505;3153;10942;3036;10759;166;593;2618;9428;2784;10021
210923;201505;1492;5321;1384;5162;166;637;988;3848;1154;4485
210927;201505;4834;15299;4633;15089;22;72;4541;14858;4563;14930
210930;201505;2556;9286;2436;9132;148;735;2095;7794;2243;8529
210940;201505;2852;11120;2795;11020;211;832;2363;9426;2574;10258
210945;201505;5980;17775;5765;17554;240;280;5468;17148;5708;17428
210950;201505;5402;16641;4746;15610;473;1589;3567;11994;4040;13583
210955;201505;1908;6177;1684;5846;240;823;1164;4251;1404;5074
210960;201505;8842;29040;8482;28547;2381;7760;5003;17968;7384;25728
210970;201505;1430;5111;1269;4861;175;799;880;3383;1055;4182
210975;201505;1766;5984;1680;5834;135;507;1345;4723;1480;5230
210980;201505;9916;23608;9647;23317;674;1304;8539;21195;9213;22499
210990;201505;16925;50330;13600;46037;2928;10355;7954;27875;10882;38230
211000;201505;15924;51125;14218;49060;728;2671;12401;43636;13129;46307
211003;201505;4837;17154;4427;16552;362;1523;3434;13182;3796;14705
211010;201505;6603;23660;6369;23391;83;272;6110;22670;6193;22942
211020;201505;7456;23710;7279;23445;351;1147;6471;20992;6822;22139
211023;201505;2339;7892;2258;7745;136;487;1950;6766;2086;7253
211027;201505;2945;11431;2849;11282;258;916;2355;9634;2613;10550
211030;201505;4074;12307;3686;11895;583;1345;2875;10033;3458;11378
211040;201505;4295;16325;4159;16115;129;559;3711;14635;3840;15194
211050;201505;10224;26927;10036;26720;248;544;9622;25798;9870;26342
211060;201505;6039;21582;5884;21356;438;1547;5059;18694;5497;20241
211065;201505;1844;6186;1677;5975;33;95;1602;5786;1635;5881
211070;201505;8345;28395;7695;27308;490;1812;6374;22958;6864;24770
211080;201505;1413;4270;1158;3908;99;490;924;3016;1023;3506
211085;201505;1885;6550;1724;6281;262;948;1217;4557;1479;5505
211090;201505;3583;10741;3366;10449;125;506;2956;9092;3081;9598
211100;201505;6695;17458;6526;17269;51;183;6335;16750;6386;16933
211102;201505;3107;11515;2944;11292;257;938;2509;9836;2766;10774
211105;201505;2708;8634;2329;8098;180;720;1891;6534;2071;7254
211107;201505;4543;14446;4115;13884;238;764;3515;12205;3753;12969
211110;201505;6395;19212;5200;17440;1025;3390;3162;11152;4187;14542
211120;201505;34261;94322;30355;89651;4773;13340;21803;66993;26576;80333
211125;201505;2124;6875;1909;6542;113;403;1641;5677;1754;6080
211130;201505;136864;385815;125262;371436;23058;68523;83764;254070;106822;322593
211140;201505;5446;17343;5094;16806;218;791;4406;14584;4624;15375
211150;201505;9962;29418;9188;28476;515;1738;7932;24727;8447;26465
211153;201505;3001;9181;2795;8937;392;1047;2222;7475;2614;8522
211157;201505;1240;3977;1058;3709;111;482;717;2591;828;3073
211160;201505;4085;13768;3517;12816;317;1474;2582;9320;2899;10794
211163;201505;1658;5559;1580;5446;51;176;1433;5034;1484;5210
211167;201505;1532;5052;1428;4902;28;108;1337;4622;1365;4730
211170;201505;6503;17324;6244;17030;113;349;5830;15894;5943;16243
211172;201505;2402;7133;2172;6793;139;552;1847;5686;1986;6238
211174;201505;2840;8307;2571;7973;77;326;2319;7135;2396;7461
211176;201505;4805;14986;4249;14300;457;1541;3239;11222;3696;12763
211178;201505;3545;9896;3472;9818;58;121;3346;9516;3404;9637
211180;201505;4338;15257;4089;14873;296;1153;3406;12590;3702;13743
211190;201505;2822;9530;2623;9255;78;348;2326;8260;2404;8608
211195;201505;1499;4582;1245;4269;81;236;1032;3696;1113;3932
211200;201505;2193;7413;1937;7071;269;858;1434;5580;1703;6438
211210;201505;7183;21762;6876;21350;395;1212;5987;18818;6382;20030
211220;201505;34529;100673;29788;94676;5823;19112;19178;62617;25001;81729
211223;201505;5250;15529;4796;14813;536;1685;3598;11311;4134;12996
211227;201505;1656;6071;1540;5896;134;607;1220;4710;1354;5317
211230;201505;8666;28553;7854;27223;987;3532;5748;20322;6735;23854
211240;201505;8140;28018;7777;27596;260;945;7214;25723;7474;26668
211245;201505;5523;16052;5464;15983;105;194;5262;15567;5367;15761
211250;201505;12906;44120;12166;43292;1484;3845;9780;37395;11264;41240
211260;201505;8535;26608;8284;26279;574;1807;7332;23431;7906;25238
211270;201505;10495;36052;9439;34748;563;2392;7761;29143;8324;31535
211280;201505;12690;37690;11968;36829;1094;2651;10097;32414;11191;35065
211285;201505;1766;6461;1570;6023;321;1317;808;3232;1129;4549
211290;201505;7294;24147;7066;23860;619;1780;6014;20881;6633;22661
211300;201505;8330;25300;7779;24550;238;761;7054;22428;7292;23189
211400;201505;11498;36139;10372;34664;2636;8717;5488;20309;8124;29026
220005;201505;1822;5279;1679;5067;70;288;1399;4115;1469;4403
220010;201505;1464;4169;1282;3906;85;320;964;2905;1049;3225
220020;201505;3374;10586;3175;10251;574;1899;2113;6835;2687;8734
220025;201505;2266;5558;2037;5222;45;132;1781;4526;1826;4658
220027;201505;1379;3743;1253;3584;73;196;1052;3048;1125;3244
220030;201505;3382;9479;3313;9369;180;603;2904;8153;3084;8756
220040;201505;7855;24544;7334;23664;1428;4756;4646;15004;6074;19760
220045;201505;1420;4586;1297;4360;85;352;986;3249;1071;3601
220050;201505;4610;13601;4016;12681;252;957;3264;10194;3516;11151
220060;201505;2000;5242;1912;5143;58;147;1765;4766;1823;4913
220070;201505;2483;7328;2248;6965;146;491;1822;5636;1968;6127
220080;201505;744;2303;704;2238;72;297;559;1716;631;2013
220090;201505;1823;4641;1555;4289;83;279;1337;3627;1420;3906
220095;201505;746;2018;704;1960;26;79;654;1809;680;1888
220100;201505;1402;4259;1186;3900;121;425;863;2864;984;3289
220105;201505;2215;7198;1999;6785;169;598;1488;5072;1657;5670
220110;201505;3420;10105;3214;9771;163;638;2749;8214;2912;8852
220115;201505;2397;8517;2307;8378;187;761;1973;7154;2160;7915
220117;201505;1386;3678;1133;3308;91;263;900;2642;991;2905
220120;201505;12349;35875;11517;34852;187;757;10870;32863;11057;33620
220130;201505;898;3091;782;2931;59;198;660;2516;719;2714
220140;201505;1640;4430;1470;4223;224;476;1173;3552;1397;4028
220150;201505;7053;21992;6697;21510;196;762;6107;19605;6303;20367
220155;201505;1111;3445;911;3070;70;298;627;2050;697;2348
220157;201505;1068;2707;951;2536;23;71;838;2213;861;2284
220160;201505;2764;8285;2432;7720;133;546;1945;6106;2078;6652
220170;201505;1382;4314;1217;4044;62;281;992;3270;1054;3551
220173;201505;2061;6274;1734;5644;58;286;1422;4572;1480;4858
220177;201505;1777;5222;1747;5177;62;190;1637;4859;1699;5049
220180;201505;1190;3210;1010;2893;35;132;759;2110;794;2242
220190;201505;4645;15415;4232;14859;564;1902;3275;11738;3839;13640
220191;201505;1442;4905;1375;4788;186;645;1019;3579;1205;4224
220192;201505;1817;5143;1437;4462;130;431;1000;3105;1130;3536
220194;201505;1720;5121;1553;4844;145;503;1173;3563;1318;4066
220196;201505;1988;5897;1835;5650;188;624;1400;4311;1588;4935
220198;201505;1347;3806;1060;3437;17;59;989;3243;1006;3302
220200;201505;4397;15034;4185;14725;631;2275;3032;10805;3663;13080
220202;201505;2067;6454;1867;6094;48;224;1644;5298;1692;5522
220205;201505;2941;7577;2555;7057;48;184;2313;6335;2361;6519
220207;201505;874;2729;779;2564;78;307;587;1912;665;2219
220208;201505;1813;5900;1587;5505;219;874;1081;3736;1300;4610
220209;201505;1522;4703;1388;4490;60;261;1126;3617;1186;3878
220210;201505;1779;4780;1564;4467;47;184;1332;3751;1379;3935
220211;201505;1631;4795;1551;4692;91;372;1334;3975;1425;4347
220213;201505;1770;5109;1637;4872;50;191;1360;3980;1410;4171
220217;201505;1915;6291;1839;6202;26;62;1734;5925;1760;5987
220220;201505;11249;31616;10204;30044;926;2457;7550;22846;8476;25303
220225;201505;1065;3168;930;2984;39;169;804;2540;843;2709
220230;201505;5693;15406;4978;14432;160;443;4464;13041;4624;13484
220240;201505;2874;9016;2683;8691;186;697;2101;6781;2287;7478
220245;201505;1498;4039;1331;3805;47;136;1166;3381;1213;3517
220250;201505;3186;9094;2970;8776;62;198;2721;8085;2783;8283
220253;201505;1772;5293;1495;4811;147;554;1100;3519;1247;4073
220255;201505;1775;5041;1544;4665;78;327;1274;3741;1352;4068
220260;201505;4781;15328;4227;14314;337;1185;3212;10967;3549;12152
220265;201505;1339;4702;1229;4528;102;437;863;3223;965;3660
220270;201505;6792;22042;6583;21680;338;1561;5686;18282;6024;19843
220271;201505;1499;4232;1398;4085;62;148;1234;3678;1296;3826
220272;201505;1812;5553;1668;5303;82;335;1346;4238;1428;4573
220273;201505;1220;3591;1095;3378;91;291;840;2577;931;2868
220275;201505;2099;5443;1752;5025;27;93;1628;4649;1655;4742
220277;201505;2357;6630;2116;6264;116;390;1729;5139;1845;5529
220280;201505;1743;4594;1513;4213;117;411;1160;3139;1277;3550
220285;201505;1597;4375;1378;4070;44;169;1212;3605;1256;3774
220290;201505;6227;20774;5392;19638;507;2100;4096;15005;4603;17105
220300;201505;1958;6403;1740;6104;85;404;1453;5071;1538;5475
220310;201505;2527;8443;2246;8127;69;198;2046;7663;2115;7861
220320;201505;3360;9971;2842;9056;335;1184;2032;6464;2367;7648
220323;201505;1508;5349;1319;5076;144;593;1000;3908;1144;4501
220325;201505;1169;3806;1035;3542;94;390;756;2576;850;2966
220327;201505;1377;4410;1248;4195;57;286;1008;3335;1065;3621
220330;201505;3641;10113;3404;9817;139;391;3053;8871;3192;9262
220335;201505;2029;5964;1802;5695;68;219;1611;5147;1679;5366
220340;201505;1918;5346;1650;4949;127;421;1273;3785;1400;4206
220342;201505;1103;3738;1041;3647;81;336;849;2987;930;3323
220345;201505;2939;7753;2555;7162;53;150;2301;6438;2354;6588
220350;201505;4069;10843;3532;10028;196;601;2871;8134;3067;8735
220360;201505;1297;3676;1133;3408;110;376;850;2522;960;2898
220370;201505;9206;26441;8341;25332;362;1100;7497;22863;7859;23963
220375;201505;1552;4870;1435;4727;35;124;1346;4466;1381;4590
220380;201505;1420;3833;1215;3555;66;218;993;2883;1059;3101
220385;201505;818;2149;677;1919;26;95;558;1546;584;1641
220390;201505;9533;29721;8588;27977;2222;7617;3368;11072;5590;18689
220400;201505;1542;3629;1272;3220;42;148;1081;2653;1123;2801
220410;201505;1413;4006;1177;3667;96;376;913;2786;1009;3162
220415;201505;868;2363;777;2242;60;173;588;1692;648;1865
220420;201505;2196;6392;1910;5819;107;333;1545;4725;1652;5058
220430;201505;2575;7482;2490;7366;152;483;2146;6325;2298;6808
220435;201505;1607;4787;1485;4587;41;135;1271;3936;1312;4071
220440;201505;2493;8146;2304;7923;115;387;2026;6999;2141;7386
220450;201505;2350;7139;1996;6627;449;1599;1164;3862;1613;5461
220455;201505;1343;4290;1250;4162;45;148;1143;3851;1188;3999
220460;201505;960;2588;885;2496;36;101;798;2245;834;2346
220465;201505;2370;7865;2153;7536;520;1926;1281;4524;1801;6450
220470;201505;4064;12092;3697;11493;213;759;2892;8865;3105;9624
220480;201505;2582;7418;2307;7027;165;498;1852;5659;2017;6157
220490;201505;2345;6741;2172;6525;73;266;1950;5848;2023;6114
220500;201505;3398;9098;2852;8177;116;507;2331;6499;2447;7006
220510;201505;3028;8404;2270;7245;117;498;1672;5272;1789;5770
220515;201505;2016;4907;1755;4580;147;348;1429;3787;1576;4135
220520;201505;5264;14551;4841;13979;132;399;4391;12753;4523;13152
220525;201505;1346;3818;1252;3678;58;205;1069;3106;1127;3311
220527;201505;1419;4372;1268;4051;136;444;946;3088;1082;3532
220530;201505;1252;3700;1129;3520;67;266;962;2937;1029;3203
220535;201505;907;2746;859;2688;80;269;674;2099;754;2368
220540;201505;3536;11482;3371;11229;153;625;2908;9662;3061;10287
220545;201505;1428;4815;1363;4700;168;675;1011;3420;1179;4095
220550;201505;9348;30203;8763;29249;1081;3783;6447;21662;7528;25445
220551;201505;1449;4779;1336;4596;83;375;1080;3674;1163;4049
220552;201505;1625;5140;1413;4737;96;463;1074;3455;1170;3918
220553;201505;1667;4897;1377;4457;62;229;1114;3654;1176;3883
220554;201505;831;2395;735;2256;71;226;570;1759;641;1985
220555;201505;2363;6992;2195;6785;51;188;1993;6161;2044;6349
220556;201505;1486;4619;1335;4337;67;278;1042;3334;1109;3612
220557;201505;1574;5156;1421;4865;172;656;970;3306;1142;3962
220558;201505;1074;3320;978;3153;73;312;728;2282;801;2594
220559;201505;1531;4289;1376;4041;41;155;1192;3485;1233;3640
220560;201505;1763;4343;1443;3917;70;199;1225;3305;1295;3504
220570;201505;7491;23978;7024;23212;1292;4271;4651;15775;5943;20046
220580;201505;6580;21344;6416;21149;305;914;5902;19702;6207;20616
220585;201505;1997;7192;1903;7016;118;475;1615;5985;1733;6460
220590;201505;1364;4140;1233;3956;200;664;850;2790;1050;3454
220595;201505;2405;7006;2203;6738;43;172;2003;6101;2046;6273
220600;201505;1297;3166;1060;2874;182;355;766;2230;948;2585
220605;201505;1997;5874;1740;5480;83;268;1433;4512;1516;4780
220610;201505;2725;8321;2628;8175;87;345;2360;7303;2447;7648
220620;201505;7873;26469;7623;26109;315;1288;6839;23430;7154;24718
220630;201505;406;1254;349;1146;60;207;191;635;251;842
220635;201505;1780;6315;1610;5942;120;578;1114;4050;1234;4628
220640;201505;2694;7860;2466;7544;134;462;2103;6418;2237;6880
220650;201505;2330;6705;2075;6268;115;396;1674;5019;1789;5415
220660;201505;2600;8226;2309;7845;179;805;1935;6426;2114;7231
220665;201505;1197;4168;1145;4075;36;172;1043;3696;1079;3868
220667;201505;1800;5951;1694;5812;55;198;1482;5125;1537;5323
220669;201505;1927;6257;1795;6021;272;1068;1217;4037;1489;5105
220670;201505;2078;6276;1886;6031;143;354;1620;5380;1763;5734
220672;201505;2553;7237;2419;7082;257;750;1990;5893;2247;6643
220675;201505;1316;3801;1229;3658;86;232;976;2923;1062;3155
220680;201505;2256;7321;2139;7163;167;561;1790;6069;1957;6630
220690;201505;1762;4895;1525;4516;100;327;1208;3597;1308;3924
220695;201505;930;2680;862;2569;45;159;684;2010;729;2169
220700;201505;8869;25449;7894;23955;595;2044;6178;18655;6773;20699
220710;201505;819;2404;683;2170;47;150;498;1592;545;1742
220720;201505;2087;5678;1981;5543;56;166;1783;5016;1839;5182
220730;201505;1409;3971;1211;3664;42;177;1017;3038;1059;3215
220735;201505;1032;2659;835;2316;40;142;684;1872;724;2014
220740;201505;1466;4612;1222;4289;126;428;979;3546;1105;3974
220750;201505;4008;11638;3753;11259;422;1065;2975;9239;3397;10304
220755;201505;1228;3502;1117;3315;56;201;917;2684;973;2885
220760;201505;2699;9406;2535;9191;117;505;2225;8117;2342;8622
220770;201505;22742;75785;20510;71498;6767;24779;7417;26674;14184;51453
220775;201505;1221;3217;1187;3179;9;16;1167;3135;1176;3151
220777;201505;1678;4680;1526;4453;97;266;1228;3567;1325;3833
220779;201505;1323;3572;1282;3518;34;120;1187;3208;1221;3328
220780;201505;6220;16370;5515;15356;374;1002;4581;12849;4955;13851
220785;201505;1319;3555;1281;3478;53;123;1193;3253;1246;3376
220790;201505;10000;31227;9337;30189;878;3022;7395;23842;8273;26864
220793;201505;853;2452;781;2340;39;146;668;1987;707;2133
220795;201505;1479;4140;1426;4064;73;213;1282;3664;1355;3877
220800;201505;16574;45847;15034;43694;1005;3569;11713;33637;12718;37206
220810;201505;3375;9833;2930;9089;153;613;2333;7162;2486;7775
220820;201505;5376;14897;4996;14361;186;599;4508;12938;4694;13537
220830;201505;7584;21523;7109;20754;701;2055;5609;16544;6310;18599
220840;201505;14731;46643;13159;43516;3120;10556;6301;21278;9421;31834
220850;201505;2860;9882;2731;9723;138;539;2408;8642;2546;9181
220855;201505;638;1968;566;1842;45;171;419;1345;464;1516
220860;201505;971;2627;870;2469;46;169;717;2005;763;2174
220865;201505;2718;7448;2168;6536;95;468;1744;5075;1839;5543
220870;201505;2388;7889;2102;7523;76;292;1909;6858;1985;7150
220880;201505;4884;13132;4581;12780;132;419;4260;11893;4392;12312
220885;201505;1346;4811;1187;4519;107;500;896;3400;1003;3900
220887;201505;1408;3535;1215;3266;21;66;1138;3064;1159;3130
220890;201505;1630;5725;1482;5473;118;413;1207;4594;1325;5007
220900;201505;1907;5459;1682;5035;70;197;1422;4267;1492;4464
220910;201505;1669;4986;1474;4702;60;191;1286;4142;1346;4333
220915;201505;1047;2975;900;2703;45;194;698;2045;743;2239
220920;201505;1352;4936;1242;4774;117;545;939;3570;1056;4115
220930;201505;1399;4675;1330;4574;67;278;1130;3906;1197;4184
220935;201505;1081;3311;964;3066;56;246;687;2108;743;2354
220937;201505;1555;4250;1310;3825;68;251;1023;2918;1091;3169
220940;201505;1422;4419;1314;4193;78;331;1007;3158;1085;3489
220945;201505;455;1652;421;1587;44;193;300;1113;344;1306
220950;201505;1328;3316;981;2756;31;124;730;2002;761;2126
220955;201505;1479;4312;1299;4009;96;328;1002;3084;1098;3412
220960;201505;909;2401;725;2093;17;67;581;1660;598;1727
220965;201505;1707;5131;1609;4993;60;276;1408;4299;1468;4575
220970;201505;2184;5807;1628;4918;151;473;1123;3420;1274;3893
220975;201505;665;2244;638;2212;31;130;590;2034;621;2164
220980;201505;1321;4052;1160;3773;98;370;846;2759;944;3129
220985;201505;1259;3669;1185;3561;101;375;897;2608;998;2983
220987;201505;1543;4891;1400;4644;94;419;1068;3453;1162;3872
220990;201505;1887;5417;1638;5004;49;217;1286;3863;1335;4080
220995;201505;1328;3855;1003;3345;92;350;738;2497;830;2847
220997;201505;2231;7014;2127;6864;62;208;1984;6422;2046;6630
221000;201505;4452;13639;4106;13060;427;1580;3087;9706;3514;11286
221005;201505;1459;4602;1342;4376;490;1497;597;2093;1087;3590
221010;201505;1184;3207;1017;2989;50;148;889;2618;939;2766
221020;201505;1851;5731;1725;5505;95;410;1317;4124;1412;4534
221030;201505;1638;4708;1439;4400;79;330;1190;3590;1269;3920
221035;201505;1454;4039;1366;3932;52;115;1262;3690;1314;3805
221037;201505;639;1909;574;1800;22;93;441;1330;463;1423
221038;201505;634;1787;511;1577;42;128;332;1037;374;1165
221039;201505;928;2668;847;2551;51;214;725;2124;776;2338
221040;201505;4726;14551;4452;14105;228;809;3683;11748;3911;12557
221050;201505;3534;10864;3348;10613;165;611;2904;9182;3069;9793
221060;201505;8261;23868;7380;22489;716;2329;5623;17238;6339;19567
221062;201505;1305;4565;1221;4431;28;106;1116;4088;1144;4194
221063;201505;1064;3524;985;3375;263;848;574;2126;837;2974
221065;201505;2824;7881;2578;7502;192;566;2120;6155;2312;6721
221070;201505;3981;12501;3512;11727;160;639;2909;9736;3069;10375
221080;201505;3520;9294;3062;8678;139;442;2630;7469;2769;7911
221090;201505;1385;3810;1190;3494;33;143;987;2846;1020;2989
221093;201505;1724;5150;1621;4938;318;1040;920;2741;1238;3781
221095;201505;983;2659;886;2523;25;68;779;2233;804;2301
221097;201505;813;2292;687;2071;52;209;509;1494;561;1703
221100;201505;118139;346405;108612;330658;20656;67644;67485;202193;88141;269837
221110;201505;10269;32981;9700;32280;442;1674;8494;28342;8936;30016
221120;201505;4195;13715;3991;13365;843;2915;2643;8949;3486;11864
221130;201505;4602;13411;3939;12081;1218;3771;1729;5334;2947;9105
221135;201505;1498;4750;1395;4607;149;571;1138;3709;1287;4280
221140;201505;1380;3423;1260;3266;56;131;1124;2921;1180;3052
221150;201505;1243;3205;1026;2837;27;122;819;2223;846;2345
221160;201505;856;2257;806;2180;41;119;647;1771;688;1890
221170;201505;1159;3612;1075;3473;65;231;868;2794;933;3025
230010;201505;3322;9160;2785;8247;157;541;2280;6707;2437;7248
230015;201505;2889;9999;2705;9602;403;1675;1716;5969;2119;7644
230020;201505;14420;47289;13933;46446;688;2536;11908;39963;12596;42499
230030;201505;12359;35866;11261;34160;575;1971;9436;28592;10011;30563
230040;201505;4659;12865;3943;11662;271;956;3018;8852;3289;9808
230050;201505;2620;8989;2072;7532;436;1661;847;3092;1283;4753
230060;201505;2160;6280;1879;5780;113;419;1402;4254;1515;4673
230070;201505;4504;12292;3850;11265;349;1129;2685;7953;3034;9082
230075;201505;8868;32012;8305;30887;620;3115;6622;24183;7242;27298
230080;201505;2431;6435;1978;5768;91;288;1651;4828;1742;5116
230090;201505;3772;11168;3366;10475;380;1288;2472;7746;2852;9034
230100;201505;16785;50483;15340;47835;2859;9621;9033;28297;11892;37918
230110;201505;13742;44048;12693;41867;2379;8430;7217;23515;9596;31945
230120;201505;8041;22258;6950;20683;780;2246;4820;15201;5600;17447
230125;201505;2991;8747;2478;7782;181;616;1825;5714;2006;6330
230130;201505;5887;19262;4998;17392;493;2056;3440;11767;3933;13823
230140;201505;3636;11655;3101;10692;405;1492;2080;7330;2485;8822
230150;201505;1700;5379;1474;4905;277;1033;874;2832;1151;3865
230160;201505;6519;19514;5785;18406;388;1495;4551;14398;4939;15893
230170;201505;6589;20539;5606;18734;375;1494;4145;13746;4520;15240
230180;201505;1785;5246;1583;4859;103;402;1180;3513;1283;3915
230185;201505;4205;13750;3804;13010;651;2270;2390;8471;3041;10741
230190;201505;13206;42081;11672;39017;2432;9083;5811;19109;8243;28192
230195;201505;5204;15963;4615;14989;265;1153;3679;11629;3944;12782
230200;201505;5544;16065;4967;14951;434;1420;3699;11057;4133;12477
230205;201505;4298;13691;3848;12919;268;1145;2832;9460;3100;10605
230210;201505;9165;26537;7991;24725;1789;5631;4487;14346;6276;19977
230220;201505;13335;38410;12043;36211;1255;4304;8767;25970;10022;30274
230230;201505;7664;24901;6948;23486;1020;3605;4449;15212;5469;18817
230240;201505;13854;39436;12308;36779;619;2276;9774;28786;10393;31062
230250;201505;10115;31444;9944;31196;427;1587;8495;26532;8922;28119
230260;201505;14748;49678;13687;47588;2466;9135;7937;28178;10403;37313
230270;201505;7444;22214;6441;20480;757;2668;4375;14026;5132;16694
230280;201505;20046;59850;17865;56213;2156;6903;12788;40643;14944;47546
230290;201505;4827;14825;4152;13473;566;1834;2802;9157;3368;10991
230300;201505;4472;13726;4256;13411;325;1245;3423;10649;3748;11894
230310;201505;4919;14661;4290;13621;287;1195;3205;10018;3492;11213
230320;201505;7135;22705;6551;21664;505;2060;5005;16436;5510;18496
230330;201505;4913;14455;4238;13145;333;1168;3063;9423;3396;10591
230340;201505;3475;11779;3188;11170;425;1708;2055;7029;2480;8737
230350;201505;18060;55460;16359;52562;2209;7834;10161;33367;12370;41201
230360;201505;3325;9581;2728;8471;300;1069;1838;5649;2138;6718
230365;201505;3082;8494;2695;7865;126;471;2197;6364;2323;6835
230370;201505;55040;178556;49740;169390;13563;48743;23279;81504;36842;130247
230380;201505;6652;19572;5657;17792;357;1255;4184;13172;4541;14427
230390;201505;3601;11333;3200;10649;297;1277;2282;7438;2579;8715
230393;201505;3297;10920;2816;9938;257;1235;1989;6743;2246;7978
230395;201505;5473;16390;4912;15414;772;2487;3076;9906;3848;12393
230400;201505;5397;16575;4700;15478;293;1292;3655;11831;3948;13123
230410;201505;14417;46098;12682;42423;1845;6625;7863;26317;9708;32942
230420;201505;24714;80276;22542;75908;5274;19173;10806;36285;16080;55458
230423;201505;4193;13906;3882;13287;284;1189;2985;10132;3269;11321
230425;201505;5614;18671;5158;17649;717;2603;3417;11731;4134;14334
230426;201505;2801;7853;2236;6788;111;463;1683;4985;1794;5448
230427;201505;1822;5479;1396;4555;151;525;878;2796;1029;3321
230428;201505;8670;27516;8283;26836;1351;4914;5197;16658;6548;21572
230430;201505;4565;14598;4254;14006;360;1480;3084;9915;3444;11395
230435;201505;4831;15697;4339;14826;809;3149;2389;8104;3198;11253
230440;201505;355975;1075253;328459;1027340;79196;263349;157765;495833;236961;759182
230445;201505;4588;12405;3865;11342;263;741;2883;8599;3146;9340
230450;201505;3587;11458;3116;10597;361;1505;2082;6991;2443;8496
230460;201505;1926;6429;1701;6016;177;735;1180;4138;1357;4873
230465;201505;4204;12556;3535;11349;276;1171;2446;7694;2722;8865
230470;201505;10837;39865;10089;38357;1166;4880;7309;27926;8475;32806
230480;201505;1456;4691;1242;4293;164;639;819;2829;983;3468
230490;201505;2593;7803;2243;7153;388;1368;1161;3569;1549;4937
230495;201505;5823;19397;5250;18436;781;3286;3041;10646;3822;13932
230500;201505;9561;33579;9134;32788;623;2683;7218;26004;7841;28687
230510;201505;1546;5518;1255;4790;329;1341;422;1681;751;3022
230520;201505;4877;15013;4374;14109;460;1720;2928;9394;3388;11114
230523;201505;14706;48033;12896;43879;3138;11776;3481;12054;6619;23830
230526;201505;4072;12469;3548;11577;284;1145;2647;8593;2931;9738
230530;201505;5391;17651;4880;16960;1011;3554;3181;11423;4192;14977
230533;201505;3964;11333;3565;10605;247;808;2772;8224;3019;9032
230535;201505;5604;16575;4913;15340;682;2116;3147;10167;3829;12283
230540;201505;18299;53299;16439;50390;723;2860;13848;42077;14571;44937
230550;201505;19911;59849;17892;56013;3680;12492;9588;29747;13268;42239
230560;201505;6698;19408;5962;18080;247;1006;4798;14348;5045;15354
230565;201505;3392;9541;2748;8321;153;564;2018;6059;2171;6623
230570;201505;3866;10406;3397;9828;135;512;2863;8216;2998;8728
230580;201505;10259;31243;9590;30299;457;1521;8508;27084;8965;28605
230590;201505;8931;28102;7793;25940;601;2563;5727;18593;6328;21156
230600;201505;3693;10404;2880;8782;190;643;1892;5778;2082;6421
230610;201505;6063;19806;5634;19126;732;2602;4058;13954;4790;16556
230620;201505;2200;6257;1753;5298;192;649;1048;3077;1240;3726
230625;201505;7948;25788;7106;23900;2112;7645;2187;7341;4299;14986
230630;201505;11478;36732;10464;34886;2756;8734;4990;17818;7746;26552
230640;201505;26296;86372;24358;83523;2704;10170;18617;64013;21321;74183
230650;201505;4983;15292;4480;14328;288;1186;3462;10813;3750;11999
230655;201505;9108;34444;8747;33824;698;2851;7240;28423;7938;31274
230660;201505;6213;19414;5311;17744;386;1646;4014;13200;4400;14846
230670;201505;6145;16583;4959;14561;192;743;3840;10976;4032;11719
230680;201505;2932;8544;2450;7645;372;1239;1453;4511;1825;5750
230690;201505;6277;20607;6176;20402;546;2218;4339;14067;4885;16285
230700;201505;9463;27153;8447;25375;735;2700;6026;17628;6761;20328
230710;201505;7521;24545;6553;22738;787;2787;4670;16422;5457;19209
230720;201505;1914;6057;1656;5567;208;739;1101;3763;1309;4502
230725;201505;3741;12673;3273;11538;770;2787;1364;4821;2134;7608
230730;201505;58015;175668;48046;159049;13192;48395;15352;52201;28544;100596
230740;201505;5966;18233;5491;17443;274;1180;4532;14187;4806;15367
230750;201505;8644;24879;7377;22852;454;1662;5773;17765;6227;19427
230760;201505;10515;31487;9783;30008;1057;3874;6920;20425;7977;24299
230763;201505;4317;13455;3928;12714;250;1175;3031;9496;3281;10671
230765;201505;39654;127305;35918;119878;9947;36121;12302;41344;22249;77465
230770;201505;24907;69340;22794;66453;2568;8009;16459;48153;19027;56162
230780;201505;6162;23865;5876;23232;1476;5982;2892;12046;4368;18028
230790;201505;2698;8792;2483;8418;260;964;1843;6271;2103;7235
230800;201505;7639;27254;6946;25733;1558;6239;3232;11909;4790;18148
230810;201505;12190;39839;11527;38713;938;3308;9350;31665;10288;34973
230820;201505;3404;11644;2980;10732;441;1832;1731;6141;2172;7973
230830;201505;7667;23431;6802;21842;616;2302;4913;15674;5529;17976
230835;201505;4108;10931;3388;9882;222;722;2681;7818;2903;8540
230837;201505;3180;10824;2775;10009;318;1364;1876;6665;2194;8029
230840;201505;9306;30472;8512;29106;768;2947;6464;22286;7232;25233
230850;201505;10236;31349;9392;30136;1045;3629;6892;22121;7937;25750
230860;201505;5304;15297;4701;14342;282;1025;3771;11436;4053;12461
230870;201505;19112;50880;16639;47169;930;3036;13026;36763;13956;39799
230880;201505;1932;6656;1815;6425;207;889;1226;4287;1433;5176
230890;201505;3959;14519;3655;13844;529;2417;2345;8655;2874;11072
230900;201505;3020;10082;2564;9122;531;1877;1309;4756;1840;6633
230910;201505;3200;9390;2590;8281;197;807;1889;5923;2086;6730
230920;201505;4650;13641;4350;13280;173;617;3871;11934;4044;12551
230930;201505;7586;22999;6704;21342;685;2322;4617;14832;5302;17154
230940;201505;7823;22397;6835;20901;368;1174;5527;17034;5895;18208
230945;201505;6240;18778;5399;17544;520;1942;3811;12569;4331;14511
230950;201505;7139;19430;6264;18281;366;1118;5022;14893;5388;16011
230960;201505;14037;43394;12751;40945;2728;9367;6003;19494;8731;28861
230970;201505;13550;41998;11997;39051;2441;8945;5582;17808;8023;26753
230980;201505;2996;9540;2636;8879;751;2578;1249;4411;2000;6989
230990;201505;1713;5155;1428;4584;145;597;944;2938;1089;3535
231000;201505;2889;7830;2280;6663;213;734;1463;4143;1676;4877
231010;201505;3246;8823;2685;7925;260;896;1974;5730;2234;6626
231020;201505;7981;26806;7566;25951;1345;4696;4730;16585;6075;21281
231025;201505;8015;24777;7274;23530;1051;3582;4787;15791;5838;19373
231030;201505;8088;26242;6825;23667;1202;4516;3908;13637;5110;18153
231040;201505;3136;10144;2795;9453;225;955;2021;6665;2246;7620
231050;201505;12261;34846;10449;31617;825;2808;7777;23425;8602;26233
231060;201505;2483;7961;2269;7585;179;813;1629;5312;1808;6125
231070;201505;8887;28246;8101;26675;1325;4645;4833;16073;6158;20718
231080;201505;4258;13386;3873;12725;207;965;2931;9311;3138;10276
231085;201505;4752;14957;4579;14720;605;1867;3418;11423;4023;13290
231090;201505;4188;11804;3407;10234;182;665;2419;7147;2601;7812
231095;201505;2273;7393;1945;6733;206;806;1316;4566;1522;5372
231100;201505;3219;9967;2690;8925;229;884;1915;6290;2144;7174
231110;201505;3773;12553;3690;12410;361;1387;2721;9138;3082;10525
231120;201505;2152;7204;2016;6930;314;1166;1313;4546;1627;5712
231123;201505;2167;5939;1840;5379;139;367;1441;4252;1580;4619
231126;201505;6475;18246;5407;16565;345;1331;4060;12323;4405;13654
231130;201505;19358;59916;17399;56631;3581;11994;10097;34385;13678;46379
231135;201505;4324;12861;3644;11697;313;1171;2640;8416;2953;9587
231140;201505;16889;53601;15017;50066;1388;6225;10068;32354;11456;38579
231150;201505;5866;16850;4923;15117;798;2669;2710;8176;3508;10845
231160;201505;5763;19517;5413;18838;909;3317;3581;12503;4490;15820
231170;201505;4382;14101;3926;13156;334;1427;2751;8995;3085;10422
231180;201505;14402;43175;12958;40336;2182;7371;7795;23917;9977;31288
231190;201505;4746;13384;4039;12347;272;996;3188;9602;3460;10598
231195;201505;4618;15683;3985;14426;398;1780;2842;10191;3240;11971
231200;201505;7850;26943;6854;24896;505;2489;4975;17683;5480;20172
231210;201505;5156;15939;4452;14967;256;1146;3532;11848;3788;12994
231220;201505;11880;34985;10693;32804;708;2717;7990;24101;8698;26818
231230;201505;8800;30048;8108;28965;766;3204;6246;22346;7012;25550
231240;201505;12161;38580;10970;36227;2236;7800;5665;19037;7901;26837
231250;201505;1965;5730;1369;4280;434;1309;304;985;738;2294
231260;201505;3730;10865;3350;10284;497;1522;2195;6878;2692;8400
231270;201505;7391;20565;6536;19206;412;1713;4981;14256;5393;15969
231280;201505;1788;5854;1667;5623;169;583;1195;4091;1364;4674
231290;201505;34151;117701;30988;110504;6805;27145;13314;46520;20119;73665
231300;201505;4688;13579;3803;11840;280;1101;2668;8079;2948;9180
231310;201505;7469;21327;6230;18793;974;3105;3557;10510;4531;13615
231320;201505;6956;21452;5970;19548;320;1342;4373;14297;4693;15639
231325;201505;2705;8134;2392;7618;257;862;1654;5380;1911;6242
231330;201505;12758;40341;10969;36850;1673;5709;6915;23546;8588;29255
231335;201505;5377;15436;4651;14136;243;968;3683;10944;3926;11912
231340;201505;17644;58163;16395;56301;1053;3538;13527;47572;14580;51110
231350;201505;13124;42459;12726;41885;1156;3615;10630;35637;11786;39252
231355;201505;4403;14251;4128;13800;230;898;3349;11212;3579;12110
231360;201505;7618;24723;6869;23386;1511;5086;4055;14343;5566;19429
231370;201505;2501;6971;1962;6090;88;296;1500;4660;1588;4956
231375;201505;4200;14403;3932;13893;260;1189;3168;11060;3428;12249
231380;201505;5242;16891;4963;16506;670;2313;3479;11908;4149;14221
231390;201505;3432;10826;3172;10402;242;1000;2377;7698;2619;8698
231395;201505;3944;12978;3611;12384;629;2233;2172;7555;2801;9788
231400;201505;9317;28609;8682;27362;639;2474;6439;20028;7078;22502
231410;201505;13622;46710;12613;45115;1109;4166;9831;35501;10940;39667
240010;201505;2475;7536;2093;6735;372;1335;1011;3133;1383;4468
240020;201505;11092;35015;9841;32648;2289;8164;4769;15965;7058;24129
240030;201505;2417;7110;2371;7037;150;512;2015;5911;2165;6423
240040;201505;847;2523;718;2266;33;155;520;1566;553;1721
240050;201505;3495;9533;2994;8673;129;466;2409;6889;2538;7355
240060;201505;1408;4115;1265;3840;61;247;1030;3028;1091;3275
240070;201505;2642;7579;2488;7300;383;1186;1703;4956;2086;6142
240080;201505;3072;8280;2639;7709;237;668;2038;5989;2275;6657
240090;201505;2323;6300;1940;5606;57;225;1541;4349;1598;4574
240100;201505;8773;25181;7876;23364;697;2390;5652;16314;6349;18704
240110;201505;5322;16253;4697;15091;809;2914;2679;8294;3488;11208
240120;201505;2771;9446;2649;9213;426;1618;1780;6191;2206;7809
240130;201505;2834;7647;2430;7034;139;515;1922;5447;2061;5962
240140;201505;2243;6752;1915;6147;328;1235;1083;3378;1411;4613
240145;201505;6019;18884;5398;17800;1407;5034;2722;9074;4129;14108
240150;201505;1010;3051;825;2676;86;362;530;1641;616;2003
240160;201505;1452;4690;1265;4362;171;645;779;2766;950;3411
240165;201505;899;2866;787;2629;112;335;496;1756;608;2091
240170;201505;2440;7290;2136;6741;544;1901;995;3067;1539;4968
240180;201505;2698;8535;2440;8043;505;1777;1376;4638;1881;6415
240185;201505;1436;4824;1378;4719;114;421;1092;3764;1206;4185
240190;201505;988;3033;892;2862;48;207;684;2151;732;2358
240200;201505;14304;37226;11889;34021;2606;7629;6112;18160;8718;25789
240210;201505;2891;8147;2632;7782;181;635;2204;6458;2385;7093
240220;201505;7415;24431;7010;23847;533;2331;5711;19185;6244;21516
240230;201505;5587;15219;4948;14173;215;736;4148;11776;4363;12512
240240;201505;1847;5616;1284;4230;301;1121;252;708;553;1829
240250;201505;2758;7998;2593;7780;140;473;2180;6515;2320;6988
240260;201505;13042;43944;12340;42817;1972;7740;8049;27946;10021;35686
240270;201505;2294;7370;2114;7073;205;696;1638;5571;1843;6267
240280;201505;1580;4457;1410;4175;81;296;1137;3322;1218;3618
240290;201505;1375;4317;1204;4010;90;428;823;2628;913;3056
240300;201505;2272;6310;1659;5005;403;1308;598;1741;1001;3049
240310;201505;9816;28134;8935;26757;1368;4515;5014;15187;6382;19702
240320;201505;2076;6163;1678;5349;76;341;1228;3765;1304;4106
240325;201505;38739;105975;30073;92015;9340;30842;7914;24693;17254;55535
240330;201505;1522;4570;1282;4099;123;495;840;2588;963;3083
240340;201505;1884;5347;1594;4892;179;592;1162;3557;1341;4149
240350;201505;1994;5898;1854;5712;126;464;1596;4888;1722;5352
240360;201505;7158;21462;6248;20109;1188;4106;3568;11858;4756;15964
240370;201505;1998;5493;1633;4848;200;609;1050;3118;1250;3727
240375;201505;874;2343;761;2165;123;418;474;1274;597;1692
240380;201505;2532;7530;1971;6275;286;946;1007;3153;1293;4099
240390;201505;967;2650;809;2361;54;206;600;1689;654;1895
240400;201505;1354;3725;1141;3362;108;354;813;2346;921;2700
240410;201505;528;1719;486;1637;88;349;301;1004;389;1353
240420;201505;4773;18241;4516;17686;1057;4370;2513;10095;3570;14465
240430;201505;3310;9417;3049;8979;158;623;2470;7094;2628;7717
240440;201505;2667;7032;2408;6622;602;1652;1284;3546;1886;5198
240450;201505;3633;10904;3182;10042;309;1273;2063;6183;2372;7456
240460;201505;2975;9115;2810;8901;213;871;2326;7214;2539;8085
240470;201505;3679;11391;2928;9788;591;1976;1564;5252;2155;7228
240480;201505;515;1339;412;1134;37;104;240;648;277;752
240485;201505;2105;6511;1853;6047;342;1197;1075;3572;1417;4769
240490;201505;1676;4266;1418;3875;52;178;1170;3105;1222;3283
240500;201505;2109;6130;1919;5837;148;521;1490;4491;1638;5012
240510;201505;1795;5400;1666;5184;169;554;1309;4098;1478;4652
240520;201505;1367;3908;1168;3604;125;471;870;2624;995;3095
240530;201505;2117;6749;1907;6414;291;1028;1326;4477;1617;5505
240540;201505;1734;5330;1654;5201;137;493;1304;4078;1441;4571
240550;201505;847;2400;735;2211;56;193;566;1668;622;1861
240560;201505;3277;9577;3077;9289;275;835;2507;7629;2782;8464
240570;201505;3109;8778;2424;7250;546;1784;913;2428;1459;4212
240580;201505;7741;24418;7226;23515;926;3285;5410;17492;6336;20777
240590;201505;800;2260;694;2071;40;164;525;1528;565;1692
240600;201505;1656;4857;1312;4149;175;657;737;2219;912;2876
240610;201505;4945;14008;4258;12726;518;1715;2645;7695;3163;9410
240615;201505;1048;3047;851;2669;148;492;476;1458;624;1950
240620;201505;1757;5526;1571;5217;192;634;1187;4004;1379;4638
240630;201505;2012;6260;1866;6009;161;447;1426;4779;1587;5226
240640;201505;901;2633;762;2397;58;270;539;1622;597;1892
240650;201505;3809;11632;3472;11156;219;791;2831;9169;3050;9960
240660;201505;2417;7824;2281;7625;225;777;1786;6029;2011;6806
240670;201505;2729;8193;2262;7212;294;1033;1279;4013;1573;5046
240680;201505;1515;4450;1221;3919;120;428;771;2463;891;2891
240690;201505;983;2758;851;2535;54;212;688;1990;742;2202
240700;201505;2772;8241;2287;7330;98;462;1747;5462;1845;5924
240710;201505;18913;49099;16544;45798;3010;8266;10149;28785;13159;37051
240720;201505;5357;15281;4977;14620;1561;4836;2395;6814;3956;11650
240725;201505;1104;3295;854;2740;78;264;490;1536;568;1800
240730;201505;2210;6676;1907;6122;137;483;1429;4575;1566;5058
240740;201505;2024;5932;1810;5550;174;653;1271;3777;1445;4430
240750;201505;2257;8414;2056;8037;482;2101;1058;4157;1540;6258
240760;201505;1312;3690;1119;3432;109;251;840;2772;949;3023
240770;201505;3134;9090;2811;8642;157;605;2384;7264;2541;7869
240780;201505;6360;17544;5093;15576;960;3016;2843;8961;3803;11977
240790;201505;900;2743;736;2463;39;168;529;1786;568;1954
240800;201505;36894;106258;32848;99454;8052;25604;14281;43663;22333;69267
240810;201505;91429;265178;84417;253084;22651;70614;40048;121169;62699;191783
240820;201505;6825;20444;5827;18884;1408;4972;2502;8427;3910;13399
240830;201505;8785;27531;8234;26704;394;1423;7137;23196;7531;24619
240840;201505;1257;3503;1053;3178;92;312;681;1990;773;2302
240850;201505;1303;3876;949;3065;165;570;457;1443;622;2013
240860;201505;1352;3817;1122;3410;73;261;853;2531;926;2792
240870;201505;1188;3275;976;2887;91;312;624;1750;715;2062
240880;201505;1168;3977;1102;3876;115;494;844;2909;959;3403
240890;201505;5279;14976;4473;13497;899;2951;2145;6353;3044;9304
240895;201505;2729;9347;2477;8907;273;1048;1768;6465;2041;7513
240910;201505;2792;8535;2478;7936;176;676;1886;5989;2062;6665
240920;201505;810;2651;707;2419;146;578;345;1126;491;1704
240930;201505;3531;9315;3116;8804;185;533;2569;7374;2754;7907
240933;201505;1393;4095;1240;3840;135;496;883;2675;1018;3171
240940;201505;6536;17978;5356;15945;941;2867;2979;8885;3920;11752
240950;201505;1036;3378;980;3284;73;325;767;2500;840;2825
240960;201505;794;2488;696;2296;93;333;475;1573;568;1906
240970;201505;2045;5643;1709;5078;126;452;1272;3697;1398;4149
240980;201505;3112;10234;2876;9787;548;2001;1779;6047;2327;8048
240990;201505;2945;8740;2757;8359;470;1537;1709;5125;2179;6662
241000;201505;1085;3028;922;2738;50;190;677;1988;727;2178
241010;201505;2963;9881;2713;9401;348;1478;1925;6467;2273;7945
241020;201505;2267;6289;1827;5442;146;485;1165;3362;1311;3847
241025;201505;1631;4968;1462;4652;94;397;1025;3184;1119;3581
241030;201505;2504;8367;2269;7919;175;750;1749;6095;1924;6845
241040;201505;2302;7917;2106;7562;236;939;1482;5381;1718;6320
241050;201505;1309;3862;1137;3568;60;250;887;2723;947;2973
241060;201505;887;2569;807;2432;53;149;628;1909;681;2058
241070;201505;882;2533;780;2356;81;281;531;1552;612;1833
241080;201505;1186;3508;990;3131;55;245;723;2231;778;2476
241090;201505;2189;6396;1863;5816;124;540;1463;4495;1587;5035
241100;201505;1190;3562;1026;3180;115;366;653;2007;768;2373
241105;201505;1167;3542;1063;3354;215;714;595;1905;810;2619
241110;201505;849;2672;704;2360;56;245;445;1460;501;1705
241120;201505;7445;22771;6781;21737;1386;4541;4223;13893;5609;18434
241140;201505;3425;9454;2966;8574;323;954;2082;5942;2405;6896
241142;201505;724;2175;538;1773;136;520;177;534;313;1054
241150;201505;5630;16702;5027;15678;638;2044;3469;10943;4107;12987
241160;201505;993;2943;933;2831;125;410;672;2039;797;2449
241170;201505;1154;3496;1062;3330;106;348;794;2497;900;2845
241180;201505;931;2628;763;2305;93;296;405;1183;498;1479
241190;201505;1214;3356;979;2889;72;261;621;1748;693;2009
241200;201505;19362;56981;17358;53778;4037;13461;8556;26802;12593;40263
241210;201505;1476;4226;1198;3649;199;674;633;1871;832;2545
241220;201505;7784;25920;7296;25007;1582;5789;4131;14321;5713;20110
241230;201505;3084;9067;2811;8671;163;618;2361;7204;2524;7822
241240;201505;1196;3507;906;2873;120;408;414;1345;534;1753
241250;201505;5891;18475;5001;16743;279;1426;3940;12854;4219;14280
241255;201505;1736;6686;1622;6437;399;1688;780;3172;1179;4860
241260;201505;5175;14021;4205;12518;264;1014;3100;9057;3364;10071
241270;201505;1881;5807;1665;5380;175;654;1086;3466;1261;4120
241280;201505;1982;5729;1801;5389;228;724;1244;3683;1472;4407
241290;201505;3185;8996;2655;8089;360;1185;1700;5155;2060;6340
241300;201505;1467;4260;1293;3957;70;215;972;3020;1042;3235
241310;201505;1584;4838;1462;4631;169;571;1063;3378;1232;3949
241320;201505;922;3138;841;2964;134;524;511;1794;645;2318
241330;201505;1470;4653;1360;4505;100;400;1145;3768;1245;4168
241335;201505;2702;8267;2517;7937;152;512;2136;6734;2288;7246
241340;201505;1876;5857;1621;5308;382;1366;754;2395;1136;3761
241350;201505;1951;6196;1766;5854;154;672;1312;4194;1466;4866
241355;201505;1382;3930;1154;3537;65;209;999;3074;1064;3283
241360;201505;2055;5620;1734;5018;72;235;1305;3645;1377;3880
241370;201505;1364;4180;1130;3698;173;627;606;1938;779;2565
241380;201505;695;1973;583;1748;101;322;327;970;428;1292
241390;201505;2790;9301;2605;8961;367;1392;1874;6450;2241;7842
241400;201505;3741;11007;3440;10608;364;1273;2658;8246;3022;9519
241410;201505;2626;7830;2346;7429;452;1552;1427;4467;1879;6019
241415;201505;1711;5182;1553;4926;107;427;1205;3756;1312;4183
241420;201505;2307;7961;2020;7487;659;2693;563;2031;1222;4724
241430;201505;569;1725;458;1475;48;172;280;873;328;1045
241440;201505;6318;22798;5939;22184;1228;4764;3845;14665;5073;19429
241445;201505;1067;3097;1003;3014;89;234;810;2566;899;2800
241450;201505;3222;8822;2824;8246;363;1163;1961;5704;2324;6867
241460;201505;3513;10289;3054;9388;243;892;2241;6736;2484;7628
241470;201505;1424;3928;1156;3590;131;487;839;2563;970;3050
241475;201505;1235;3794;1064;3448;52;251;805;2528;857;2779
241480;201505;2851;9526;2613;9138;934;3328;925;3507;1859;6835
241490;201505;656;1756;553;1605;43;123;341;982;384;1105
241500;201505;777;2468;675;2304;29;118;535;1816;564;1934
250010;201505;2707;8568;2367;7842;168;730;1818;5904;1986;6634
250020;201505;1693;4872;1307;4172;90;389;875;2689;965;3078
250030;201505;7311;21227;6816;20528;619;1880;5515;16779;6134;18659
250040;201505;4361;14669;4003;13921;660;2451;2528;8858;3188;11309
250050;201505;3449;10945;3256;10666;393;1399;2411;7868;2804;9267
250053;201505;1260;3765;1152;3621;158;507;789;2519;947;3026
250057;201505;645;2731;635;2721;18;40;599;2649;617;2689
250060;201505;4981;15193;4697;14778;419;1552;3786;11757;4205;13309
250070;201505;3929;12316;3667;11871;189;853;3013;9471;3202;10324
250073;201505;767;2354;683;2208;51;199;529;1692;580;1891
250077;201505;2260;6620;1896;6040;217;736;1178;3831;1395;4567
250080;201505;4232;12488;4079;12264;389;1194;3206;9579;3595;10773
250090;201505;2496;7351;2400;7187;99;328;2027;6011;2126;6339
250100;201505;3993;13180;3763;12779;369;1390;2937;9946;3306;11336
250110;201505;5342;16006;5045;15587;506;1800;3962;12115;4468;13915
250115;201505;528;1732;468;1596;29;155;299;949;328;1104
250120;201505;2004;6041;1739;5536;106;372;1354;4310;1460;4682
250130;201505;5503;17072;5174;16592;244;854;4563;14764;4807;15618
250135;201505;1071;3300;976;3135;79;272;713;2310;792;2582
250140;201505;2067;6837;1945;6662;179;698;1516;5251;1695;5949
250150;201505;5079;17085;4622;16236;384;1664;3371;11673;3755;13337
250153;201505;1459;4017;1283;3758;58;245;1094;3136;1152;3381
250157;201505;1739;5824;1596;5538;189;721;1131;3943;1320;4664
250160;201505;3263;10005;3150;9834;153;544;2849;8894;3002;9438
250170;201505;1548;4617;1414;4407;240;785;960;3035;1200;3820
250180;201505;15668;47140;14991;46093;1548;5807;11227;33603;12775;39410
250190;201505;4243;12319;3897;11774;666;2117;2472;7409;3138;9526
250200;201505;2217;6173;1731;5520;109;417;1433;4544;1542;4961
250205;201505;916;3125;849;2994;64;317;618;2151;682;2468
250210;201505;1527;5070;1411;4892;137;575;1068;3641;1205;4216
250215;201505;1367;4597;1307;4498;136;546;907;3105;1043;3651
250220;201505;782;2278;662;2124;37;134;572;1829;609;1963
250230;201505;1607;4076;1358;3672;86;275;1093;2857;1179;3132
250240;201505;2325;7852;2202;7619;135;519;1776;6149;1911;6668
250250;201505;4384;13220;3984;12694;212;718;3441;11040;3653;11758
250260;201505;1754;5378;1532;5026;94;391;1193;3872;1287;4263
250270;201505;1260;3990;1149;3850;108;357;884;3058;992;3415
250280;201505;3632;10881;3225;10266;464;1484;2331;7545;2795;9029
250290;201505;2013;5404;1687;4988;47;201;1487;4378;1534;4579
250300;201505;5465;16031;5169;15670;554;2290;4205;12199;4759;14489
250310;201505;1151;3556;1019;3342;107;405;790;2551;897;2956
250320;201505;8075;25070;7698;24359;1011;3631;5255;16200;6266;19831
250330;201505;2600;8010;2197;7445;168;685;1715;5757;1883;6442
250340;201505;1099;3256;998;3094;36;123;867;2678;903;2801
250350;201505;4392;12080;3870;11472;129;454;3467;10348;3596;10802
250355;201505;2008;6363;1843;6118;106;523;1486;4786;1592;5309
250360;201505;1947;5788;1813;5596;79;257;1517;4727;1596;4984
250370;201505;12157;35282;10822;33800;940;2999;9196;28982;10136;31981
250375;201505;1103;3444;1027;3333;50;197;890;2887;940;3084
250380;201505;1734;4938;1640;4819;89;317;1441;4223;1530;4540
250390;201505;1972;5254;1568;4582;182;528;1076;3166;1258;3694
250400;201505;69329;188090;57149;168740;13968;43702;26487;79148;40455;122850
250403;201505;1543;5078;1449;4955;223;852;998;3383;1221;4235
250407;201505;1205;3438;1035;3164;73;246;760;2271;833;2517
250410;201505;632;2035;557;1891;45;203;438;1460;483;1663
250415;201505;1744;5441;1585;5148;115;423;1223;3932;1338;4355
250420;201505;1262;3835;1173;3709;52;212;1008;3130;1060;3342
250430;201505;6118;17131;5799;16661;299;1021;4959;14063;5258;15084
250435;201505;1414;4366;1265;4098;160;585;860;2768;1020;3353
250440;201505;4501;13184;4184;12743;200;598;3555;10908;3755;11506
250450;201505;2033;5827;1815;5541;77;260;1655;5075;1732;5335
250460;201505;6439;19474;6013;18879;675;2240;4571;14528;5246;16768
250470;201505;1515;4221;1319;3948;113;418;945;2695;1058;3113
250480;201505;3827;11615;3542;11210;84;362;3171;9984;3255;10346
250485;201505;664;1689;548;1513;32;103;434;1164;466;1267
250490;201505;3794;12290;3705;12165;854;2904;2362;7768;3216;10672
250500;201505;1785;5406;1606;5118;354;1096;982;3244;1336;4340
250510;201505;4710;13618;4205;12885;200;732;3627;11102;3827;11834
250520;201505;1741;5353;1634;5177;250;905;1015;3135;1265;4040
250523;201505;1617;5271;1562;5186;231;833;1144;3815;1375;4648
250527;201505;1405;4279;1332;4188;27;126;1242;3878;1269;4004
250530;201505;648;1960;559;1849;25;79;490;1645;515;1724
250535;201505;1314;4184;1249;4052;68;302;1006;3194;1074;3496
250540;201505;2378;7167;2233;7008;28;91;2127;6710;2155;6801
250550;201505;918;3062;827;2919;60;268;643;2230;703;2498
250560;201505;1672;5314;1628;5251;73;263;1481;4777;1554;5040
250570;201505;2610;8379;2294;7776;176;729;1755;5855;1931;6584
250580;201505;1163;3133;966;2825;98;364;705;1978;803;2342
250590;201505;932;2909;862;2820;71;299;709;2264;780;2563
250600;201505;7365;21654;6905;20999;489;1433;5729;17699;6218;19132
250610;201505;3214;9560;2978;9214;322;1092;2205;6836;2527;7928
250620;201505;737;2177;654;2010;112;359;408;1240;520;1599
250625;201505;2315;7463;2277;7417;45;106;2182;7182;2227;7288
250630;201505;9683;30753;9105;29668;1996;6822;5092;16649;7088;23471
250640;201505;3554;10866;3378;10662;166;680;2976;9288;3142;9968
250650;201505;837;2496;751;2349;70;285;516;1552;586;1837
250660;201505;2219;5490;1692;4855;30;78;1593;4599;1623;4677
250670;201505;2480;8367;2365;8169;155;694;1932;6564;2087;7258
250680;201505;4800;13935;4599;13673;186;677;4116;12230;4302;12907
250690;201505;6017;15905;5767;15594;391;1125;5114;13756;5505;14881
250700;201505;5099;15008;4664;14392;724;2384;3135;9610;3859;11994
250710;201505;4325;13853;4001;13436;539;1861;2892;9935;3431;11796
250720;201505;2598;7690;2478;7493;94;393;2199;6572;2293;6965
250730;201505;3561;11004;3365;10725;330;1171;2533;7966;2863;9137
250740;201505;1994;5862;1766;5484;148;545;1352;4138;1500;4683
250750;201505;100046;286712;93182;276635;13557;44373;63764;187111;77321;231484
250760;201505;2244;6524;2021;6206;110;429;1713;5220;1823;5649
250770;201505;3877;13209;3655;12928;638;2430;2397;8516;3035;10946
250780;201505;1878;5526;1621;5064;188;732;1038;3102;1226;3834
250790;201505;2437;8037;2332;7883;505;1659;1477;5167;1982;6826
250800;201505;2676;7599;2382;7111;104;349;1973;5775;2077;6124
250810;201505;1387;4033;1193;3756;100;411;944;2918;1044;3329
250820;201505;1822;5776;1758;5690;56;230;1610;5190;1666;5420
250830;201505;5801;18784;5407;17999;636;2374;3684;12085;4320;14459
250840;201505;950;3039;821;2758;75;302;544;1797;619;2099
250850;201505;2054;6309;1839;5953;128;575;1408;4467;1536;5042
250855;201505;1085;3265;991;3121;75;310;759;2321;834;2631
250860;201505;3142;10318;2786;9669;685;2616;935;3231;1620;5847
250870;201505;1059;3111;974;2962;48;205;766;2258;814;2463
250880;201505;1380;3944;1217;3712;162;500;907;2793;1069;3293
250890;201505;9415;29048;8760;28154;1192;4662;6210;19444;7402;24106
250900;201505;2899;9453;2558;8790;267;890;1849;6418;2116;7308
250905;201505;1994;6417;1923;6324;299;986;1420;4762;1719;5748
250910;201505;4989;14635;4759;14302;308;1042;3987;11938;4295;12980
250915;201505;1483;4537;1429;4461;105;294;1235;3943;1340;4237
250920;201505;3476;10027;3267;9718;434;1220;2397;7390;2831;8610
250930;201505;2003;6333;1883;6131;245;949;1359;4337;1604;5286
250933;201505;1136;3753;1098;3681;89;336;839;2840;928;3176
250937;201505;758;2357;667;2173;70;284;454;1457;524;1741
250939;201505;1582;4954;1476;4769;154;530;1035;3325;1189;3855
250940;201505;3733;11210;3505;10852;142;551;2957;9182;3099;9733
250950;201505;1232;3869;1110;3715;42;155;976;3293;1018;3448
250960;201505;1134;3687;1066;3592;89;350;850;2849;939;3199
250970;201505;8624;23776;7461;22074;920;2792;5347;15896;6267;18688
250980;201505;2629;7838;2399;7427;157;637;1742;5203;1899;5840
250990;201505;2022;6941;1845;6574;243;1030;1249;4357;1492;5387
251000;201505;2222;6722;2020;6419;93;367;1675;5313;1768;5680
251010;201505;2803;8176;2516;7730;121;434;2143;6594;2264;7028
251020;201505;1633;4782;1476;4588;86;302;1300;4042;1386;4344
251030;201505;1202;3381;1081;3166;83;278;778;2265;861;2543
251040;201505;1885;5957;1678;5623;135;669;1240;3994;1375;4663
251050;201505;1100;3220;956;2965;122;404;624;1932;746;2336
251060;201505;990;2339;785;2069;46;148;612;1584;658;1732
251065;201505;469;1443;425;1381;46;172;311;980;357;1152
251070;201505;644;1806;582;1722;49;202;458;1277;507;1479
251080;201505;20091;56764;18256;53749;4697;14441;9157;27539;13854;41980
251090;201505;3003;9410;2680;8790;206;794;1966;6363;2172;7157
251100;201505;973;3092;850;2868;111;443;520;1681;631;2124
251110;201505;2017;5927;1779;5475;169;559;1246;3805;1415;4364
251120;201505;5997;20491;5760;20070;674;2777;4405;15146;5079;17923
251130;201505;4098;10686;3693;10241;28;84;3590;9978;3618;10062
251140;201505;4291;13213;3997;12766;133;577;3335;10623;3468;11200
251150;201505;2634;8633;2401;8302;228;976;1830;6276;2058;7252
251160;201505;1736;5819;1678;5743;59;230;1535;5274;1594;5504
251170;201505;1407;4333;1343;4257;94;361;1141;3579;1235;3940
251180;201505;2667;8176;2446;7880;493;1596;1535;5017;2028;6613
251190;201505;4291;12082;4141;11917;185;524;3827;11052;4012;11576
251200;201505;3838;12453;3718;12310;82;303;3524;11696;3606;11999
251203;201505;1160;3860;1088;3702;73;346;818;2739;891;3085
251207;201505;1142;3579;985;3296;80;372;687;2211;767;2583
251210;201505;8007;22750;6874;21272;779;2366;5218;16584;5997;18950
251220;201505;1154;3091;967;2818;106;332;730;2139;836;2471
251230;201505;4670;14189;4229;13686;217;805;3816;12365;4033;13170
251240;201505;3164;10062;3036;9899;301;1010;2443;7981;2744;8991
251250;201505;10377;30719;9564;29515;1042;3786;7250;21907;8292;25693
251260;201505;547;1668;478;1577;23;81;366;1207;389;1288
251270;201505;4210;13576;3943;13249;141;624;3536;11856;3677;12480
251272;201505;1379;4204;1319;4120;106;350;1110;3483;1216;3833
251274;201505;883;2834;811;2702;91;380;587;1904;678;2284
251275;201505;1261;3709;1200;3621;90;380;909;2626;999;3006
251276;201505;1237;3867;1161;3727;97;376;874;2765;971;3141
251278;201505;582;1885;515;1745;64;254;342;1163;406;1417
251280;201505;2334;7258;2219;7072;167;644;1768;5538;1935;6182
251290;201505;5805;16255;5488;15879;604;2079;4288;12146;4892;14225
251300;201505;771;2613;717;2533;48;209;544;1895;592;2104
251310;201505;3163;9355;2911;8999;138;537;2412;7392;2550;7929
251315;201505;1599;5625;1535;5512;218;806;1048;3827;1266;4633
251320;201505;1918;5420;1530;4798;66;246;1140;3558;1206;3804
251330;201505;1859;4980;1616;4664;73;308;1429;4023;1502;4331
251335;201505;1031;3539;961;3412;87;405;696;2416;783;2821
251340;201505;3575;10071;3058;9292;227;905;2293;6735;2520;7640
251350;201505;1445;4490;1302;4277;126;468;953;3082;1079;3550
251360;201505;1808;5906;1659;5722;76;337;1436;4948;1512;5285
251365;201505;849;2502;684;2155;27;115;484;1483;511;1598
251370;201505;22015;70504;21485;69764;2218;8809;17024;53837;19242;62646
251380;201505;1399;4363;1204;4034;58;275;987;3211;1045;3486
251385;201505;839;2322;741;2165;81;243;533;1525;614;1768
251390;201505;5854;20387;5422;19665;1249;4759;3159;11580;4408;16339
251392;201505;1034;3085;938;2942;68;212;744;2351;812;2563
251394;201505;627;1913;517;1711;31;120;373;1222;404;1342
251396;201505;843;2386;740;2213;105;329;503;1480;608;1809
251398;201505;994;2947;861;2686;58;215;600;1860;658;2075
251400;201505;1192;3393;1036;3184;95;369;775;2311;870;2680
251410;201505;1405;3754;1274;3539;74;260;1046;2853;1120;3113
251420;201505;2063;6065;1825;5787;177;607;1418;4482;1595;5089
251430;201505;1685;6023;1559;5823;95;447;1314;4880;1409;5327
251440;201505;1316;3914;1091;3476;81;280;801;2540;882;2820
251445;201505;1569;4804;1493;4701;64;264;1307;4059;1371;4323
251450;201505;4702;14910;4323;14442;142;636;3771;12609;3913;13245
251455;201505;1152;3682;1029;3476;93;365;707;2380;800;2745
251460;201505;839;2600;794;2527;100;302;619;2013;719;2315
251465;201505;457;1438;399;1310;25;108;285;905;310;1013
251470;201505;1197;3505;988;3110;102;370;601;1888;703;2258
251480;201505;1001;2792;886;2603;27;128;748;2129;775;2257
251490;201505;1858;5633;1676;5363;224;836;1098;3486;1322;4322
251500;201505;1707;5598;1669;5535;150;575;1340;4395;1490;4970
251510;201505;2581;8522;2344;8038;409;1464;1399;4810;1808;6274
251520;201505;989;2759;887;2596;131;393;527;1550;658;1943
251530;201505;11754;33592;11222;32858;410;1644;9893;28538;10303;30182
251540;201505;2838;9249;2617;8805;206;860;2060;6854;2266;7714
251550;201505;3845;9644;3152;8778;98;354;2657;7295;2755;7649
251560;201505;771;2361;704;2246;108;413;412;1215;520;1628
251570;201505;1013;3013;828;2644;73;292;594;1864;667;2156
251580;201505;1980;5583;1841;5390;353;916;1259;3864;1612;4780
251590;201505;1590;5239;1537;5174;67;260;1370;4630;1437;4890
251593;201505;1094;3376;1007;3258;153;552;619;1957;772;2509
251597;201505;1971;6062;1885;5944;115;449;1579;4899;1694;5348
251600;201505;6613;19480;6176;18788;408;1392;5091;15425;5499;16817
251610;201505;3371;10100;3051;9661;332;1047;2237;7140;2569;8187
251615;201505;1136;3325;922;2959;82;338;644;2022;726;2360
251620;201505;15802;44419;13656;41808;1072;3437;10958;34051;12030;37488
251630;201505;4838;12426;4122;11496;297;912;3349;9295;3646;10207
251640;201505;2602;7597;2172;6866;155;614;1605;5016;1760;5630
251650;201505;4074;11886;3715;11423;242;798;3216;9934;3458;10732
251660;201505;3471;11542;3239;11143;183;906;2688;9013;2871;9919
251670;201505;4286;12911;3758;12203;58;182;3465;11378;3523;11560
251675;201505;728;2383;674;2303;148;543;391;1315;539;1858
251680;201505;2692;7761;2245;7051;108;454;1819;5629;1927;6083
251690;201505;3417;10483;3152;9993;212;794;2392;7463;2604;8257
251700;201505;1971;6378;1857;6232;105;436;1612;5412;1717;5848
251710;201505;937;2441;685;1969;84;286;389;1080;473;1366
251720;201505;1392;4282;1248;4039;76;330;1015;3228;1091;3558
251740;201505;774;2197;618;1931;75;249;386;1207;461;1456
260005;201505;25371;62203;21804;57238;4729;12506;12485;32952;17214;45458
260010;201505;9958;26815;8078;24466;1028;3194;5400;16901;6428;20095
260020;201505;5737;16689;4900;15421;342;1156;3777;12043;4119;13199
260030;201505;5762;16976;5260;16212;403;1376;4116;12653;4519;14029
260040;201505;10142;24528;8431;22606;671;1500;6751;18883;7422;20383
260050;201505;11310;35221;10488;34277;561;1955;9217;30499;9778;32454
260060;201505;3904;11033;3498;10345;305;873;2697;8113;3002;8986
260070;201505;9744;28586;9118;27642;1598;5221;6049;18248;7647;23469
260080;201505;5381;14887;4773;14009;514;1654;3569;10370;4083;12024
260090;201505;5198;14580;4913;14172;1026;2829;3375;10030;4401;12859
260100;201505;3292;9049;2881;8464;161;619;2420;7062;2581;7681
260105;201505;4763;13886;4547;13483;504;1697;3399;9898;3903;11595
260110;201505;21181;60474;19491;58436;870;2617;17282;52136;18152;54753
260120;201505;11344;34821;10362;33103;2648;8604;5442;18121;8090;26725
260130;201505;3210;9071;3020;8779;444;1244;2178;6468;2622;7712
260140;201505;13419;33667;11478;31327;897;2638;9214;25515;10111;28153
260150;201505;3147;8959;2812;8500;196;728;2274;6885;2470;7613
260160;201505;5800;18044;5157;17246;332;1318;4319;14505;4651;15823
260170;201505;17395;48333;16498;47137;1242;3764;13541;38764;14783;42528
260180;201505;3313;10226;3013;9791;204;778;2500;8081;2704;8859
260190;201505;15999;37806;14773;36285;533;1352;13068;32039;13601;33391
260200;201505;10638;30488;9818;29341;771;2501;8093;24339;8864;26840
260210;201505;11332;34731;10295;33226;605;2311;8569;27726;9174;30037
260220;201505;9349;27793;9031;27360;485;1879;7970;23802;8455;25681
260230;201505;9636;27939;8926;26985;451;1485;7549;23143;8000;24628
260240;201505;3040;9161;2604;8556;371;1310;1859;6158;2230;7468
260250;201505;2290;6337;2036;6009;117;367;1731;5116;1848;5483
260260;201505;12159;34231;11237;33011;1683;5294;8214;24571;9897;29865
260270;201505;3576;10581;3346;10244;298;1203;2610;7756;2908;8959
260280;201505;12930;42133;11898;40559;657;2449;10170;35027;10827;37476
260290;201505;30108;90878;28588;88310;4451;15330;18910;57438;23361;72768
260300;201505;8638;26291;7682;24868;469;1934;6128;19901;6597;21835
260310;201505;4738;14008;4340;13413;1326;3769;2268;7605;3594;11374
260320;201505;6985;23052;6491;22298;422;1540;5419;18813;5841;20353
260330;201505;2701;8730;2497;8384;153;653;1968;6554;2121;7207
260340;201505;1917;5673;1780;5463;85;322;1571;4783;1656;5105
260345;201505;23653;74410;22202;71597;5810;20853;9355;28850;15165;49703
260350;201505;4595;12688;4334;12301;267;858;3606;10178;3873;11036
260360;201505;2296;6849;2110;6562;208;799;1512;4644;1720;5443
260370;201505;5992;18585;5290;17325;531;2023;3866;12723;4397;14746
260380;201505;4828;15969;4434;15414;343;1369;3479;12117;3822;13486
260390;201505;4522;14337;3977;13328;375;1439;2849;9370;3224;10809
260392;201505;3561;11185;3296;10857;123;520;2968;9750;3091;10270
260400;201505;13593;39191;12943;38139;1864;6250;9061;26108;10925;32358
260410;201505;58896;171447;53149;162319;15497;49643;23364;72862;38861;122505
260415;201505;3952;12578;3413;11541;397;1650;2188;7165;2585;8815
260420;201505;12212;27997;10993;26710;344;913;10001;24335;10345;25248
260430;201505;2818;9272;2527;8784;270;1044;1802;6249;2072;7293
260440;201505;3225;9814;2889;9148;409;1480;1802;5516;2211;6996
260450;201505;4973;14778;4718;14394;219;779;4082;12460;4301;13239
260460;201505;5655;17388;5196;16607;902;3157;3210;10075;4112;13232
260470;201505;4785;14200;4490;13807;281;870;3870;12130;4151;13000
260480;201505;4024;11683;3610;11097;602;2026;2389;7389;2991;9415
260490;201505;5053;13565;4430;12525;366;1222;3509;9733;3875;10955
260500;201505;6236;17542;5555;16525;704;2147;3892;11588;4596;13735
260510;201505;8925;23824;8259;23018;273;709;7626;21460;7899;22169
260515;201505;4803;14728;3753;12593;315;1219;2401;8058;2716;9277
260520;201505;15882;42000;15300;41228;2536;6802;11128;30335;13664;37137
260530;201505;9989;30115;8813;28439;463;1518;7529;24616;7992;26134
260540;201505;5977;14887;5457;14335;685;1377;4375;11963;5060;13340
260545;201505;80;285;47;184;8;33;11;38;19;71
260550;201505;2765;9123;2382;8336;548;2177;1016;3498;1564;5675
260560;201505;6512;17030;5879;16126;204;638;5244;14340;5448;14978
260570;201505;6728;22636;6220;21785;793;3132;4492;15800;5285;18932
260580;201505;3781;10592;3525;10183;196;695;3008;8505;3204;9200
260590;201505;6112;15484;5843;15172;256;572;5309;13969;5565;14541
260600;201505;26544;79803;24155;75766;2576;9422;17397;54007;19973;63429
260610;201505;6775;20283;6410;19753;1026;3349;4473;13690;5499;17039
260620;201505;16339;49453;15622;48201;2639;9080;10082;30600;12721;39680
260630;201505;2168;6539;1948;6172;153;609;1544;4800;1697;5409
260640;201505;17442;48122;16404;46683;2422;7251;11280;32125;13702;39376
260650;201505;5233;16957;4738;16127;493;1691;3617;12572;4110;14263
260660;201505;8258;22918;7432;21883;394;1241;6501;19224;6895;20465
260670;201505;2398;6545;1963;5944;197;679;1404;4249;1601;4928
260680;201505;22038;61378;20371;58524;4408;13073;10599;30304;15007;43377
260690;201505;3742;10163;3202;9315;132;511;2702;7769;2834;8280
260700;201505;5652;17247;5505;17092;43;79;5395;16913;5438;16992
260710;201505;1239;3754;1141;3617;90;347;890;2799;980;3146
260720;201505;16765;54843;15832;53260;3731;12973;8776;30074;12507;43047
260730;201505;6879;23034;6357;22188;898;3223;4576;16200;5474;19423
260740;201505;1323;4006;1148;3701;146;517;740;2392;886;2909
260750;201505;6565;20974;6015;20231;520;1593;5006;17225;5526;18818
260760;201505;4713;12764;4410;12377;277;839;3673;10338;3950;11177
260765;201505;7627;26103;7295;25593;945;4142;5341;18260;6286;22402
260770;201505;3928;10276;3566;9777;129;449;2984;8068;3113;8517
260775;201505;5215;15074;4945;14678;502;1816;3622;10431;4124;12247
260780;201505;3703;12030;3521;11705;725;2729;2137;6947;2862;9676
260790;201505;113450;286695;106335;276237;20893;56169;65050;168570;85943;224739
260795;201505;3042;9477;2765;9055;369;1352;1907;6282;2276;7634
260800;201505;4902;13191;4513;12659;164;667;3990;10876;4154;11543
260805;201505;4013;11637;3561;10958;422;1437;2506;7679;2928;9116
260810;201505;6836;19703;6668;19502;316;918;6039;17790;6355;18708
260820;201505;4360;12364;4007;11887;1015;3125;2249;6634;3264;9759
260825;201505;2856;9249;2603;8851;186;698;2104;7177;2290;7875
260830;201505;3720;12007;3349;11303;819;2652;1923;6819;2742;9471
260840;201505;4259;12294;3837;11675;277;1089;3139;9352;3416;10441
260845;201505;4303;12514;4004;11971;528;1677;2822;8458;3350;10135
260850;201505;4971;16473;4430;15277;955;3736;2159;7271;3114;11007
260860;201505;3316;10563;3031;10010;198;743;2398;7944;2596;8687
260870;201505;4246;11755;3813;11221;492;1327;2887;8746;3379;10073
260875;201505;6759;18478;6005;17321;1000;2939;3883;11286;4883;14225
260880;201505;9229;28750;8542;27659;712;2350;6896;22608;7608;24958
260890;201505;13512;38736;12628;37390;951;3218;9835;29003;10786;32221
260900;201505;6043;18640;5197;17027;701;2625;3225;10480;3926;13105
260910;201505;3067;9234;2800;8844;203;732;2263;7191;2466;7923
260915;201505;4475;15159;4299;14914;64;275;4070;14179;4134;14454
260920;201505;3453;10418;3265;10163;401;1375;2514;7930;2915;9305
260930;201505;4010;12870;3543;12139;409;1501;2564;8888;2973;10389
260940;201505;13707;36962;12488;34974;1554;5183;8548;23189;10102;28372
260950;201505;6286;19596;5804;18675;781;3107;3495;10696;4276;13803
260960;201505;57220;160780;52904;153732;10626;32964;29593;85709;40219;118673
260970;201505;4991;15877;4613;15344;340;1435;3610;11865;3950;13300
260980;201505;3888;12671;3656;12387;147;557;3277;11155;3424;11712
260990;201505;17251;54299;15752;52324;1265;4186;12889;43666;14154;47852
261000;201505;16139;44103;13047;39283;2478;7918;6917;21474;9395;29392
261010;201505;2600;7367;2393;7111;145;319;2117;6486;2262;6805
261020;201505;5970;17617;5426;16790;463;1690;4276;12908;4739;14598
261030;201505;3408;11162;3189;10770;240;1001;2571;8563;2811;9564
261040;201505;5305;17196;4685;16033;426;1718;3438;11674;3864;13392
261050;201505;8126;23587;7590;22647;1015;3015;5207;15562;6222;18577
261060;201505;12048;35858;11235;34365;1211;4283;8468;25537;9679;29820
261070;201505;50685;126210;44636;117662;7523;20455;28118;74453;35641;94908
261080;201505;5851;17288;5493;16751;372;1027;4666;14513;5038;15540
261090;201505;16634;45922;15329;44142;1416;4003;12162;35531;13578;39534
261100;201505;7808;24879;6991;23465;1288;4550;4129;14155;5417;18705
261110;201505;60307;178914;54228;169961;12369;40713;30374;97308;42743;138021
261120;201505;3630;9764;3218;9259;97;329;2884;8322;2981;8651
261130;201505;7062;18205;6686;17789;148;377;6294;16799;6442;17176
261140;201505;3254;9212;2954;8757;461;1552;1854;5407;2315;6959
261150;201505;5496;16342;5011;15583;520;1840;3827;11891;4347;13731
261153;201505;2057;6024;1673;5435;73;297;1298;4240;1371;4537
261160;201505;210009;544949;196284;525764;44255;122076;106888;291759;151143;413835
261170;201505;5807;16055;5317;15356;619;1819;4072;11910;4691;13729
261180;201505;9636;26892;9099;26153;735;2327;7101;20466;7836;22793
261190;201505;5225;16367;4896;15959;613;2654;3508;11029;4121;13683
261200;201505;3707;9268;3359;8840;437;1148;2564;6863;3001;8011
261210;201505;1932;5117;1843;5006;113;284;1654;4551;1767;4835
261220;201505;12981;41063;10856;36428;1975;7262;5514;18390;7489;25652
261230;201505;4391;13301;4032;12854;157;543;3551;11446;3708;11989
261240;201505;4812;14340;4489;13792;684;2047;3091;9693;3775;11740
261245;201505;3665;11528;3158;10636;185;854;2517;8335;2702;9189
261247;201505;3378;10369;2862;9422;276;1024;2053;6809;2329;7833
261250;201505;19883;53039;19004;51920;3527;9259;13778;38602;17305;47861
261255;201505;4098;12694;3734;12082;240;896;3141;10189;3381;11085
261260;201505;12135;34492;10917;33045;514;1325;9622;29758;10136;31083
261270;201505;3916;11399;3562;10847;504;1670;2365;7119;2869;8789
261280;201505;2550;7807;2323;7477;156;555;1883;6062;2039;6617
261290;201505;2929;8517;2690;8206;148;552;2265;6946;2413;7498
261300;201505;10789;35205;9486;32850;1567;6238;5766;19747;7333;25985
261310;201505;7469;22954;7049;22226;1639;5321;4097;12972;5736;18293
261320;201505;5657;17916;5262;17187;308;1144;4303;14114;4611;15258
261330;201505;5437;16080;5179;15720;499;1551;4137;12594;4636;14145
261340;201505;4199;13921;3989;13584;480;1990;2685;9084;3165;11074
261350;201505;8117;27146;7627;26322;400;1819;6217;21193;6617;23012
261360;201505;8201;21701;7346;20512;649;1922;5810;16028;6459;17950
261370;201505;20128;59747;18857;57812;3822;12498;11443;35072;15265;47570
261380;201505;4207;14343;3854;13646;567;2206;2596;9260;3163;11466
261390;201505;15975;48880;14468;46379;2182;7810;9078;28919;11260;36729
261400;201505;4881;16824;4385;15810;473;1939;3129;11313;3602;13252
261410;201505;8604;24489;7869;23352;1003;2988;5825;17563;6828;20551
261420;201505;7462;25351;7145;24903;1714;6747;4272;14616;5986;21363
261430;201505;3432;10844;3016;10256;291;985;2315;8060;2606;9045
261440;201505;1632;5175;1476;4942;66;299;1218;4035;1284;4334
261450;201505;14038;39942;13628;39438;444;1423;12575;36388;13019;37811
261460;201505;7218;21671;6783;21122;423;1135;5974;19081;6397;20216
261470;201505;4035;10902;3639;10412;138;448;3252;9279;3390;9727
261480;201505;3592;13032;3338;12591;359;1544;2504;9300;2863;10844
261485;201505;5022;15465;4573;14680;804;2984;2689;8458;3493;11442
261500;201505;5717;15908;5053;15024;504;1377;3893;11975;4397;13352
261510;201505;1966;6324;1820;6099;125;458;1463;4932;1588;5390
261520;201505;2666;8670;2438;8229;152;615;1709;5912;1861;6527
261530;201505;12281;39357;10807;36572;2398;8960;4681;15848;7079;24808
261540;201505;7489;24103;7145;23520;1487;4857;4555;15377;6042;20234
261550;201505;3445;9956;3269;9711;294;1131;2673;7748;2967;8879
261560;201505;7121;23190;6453;22328;1052;3842;4590;16169;5642;20011
261570;201505;3505;10714;3056;10012;445;1549;1999;6544;2444;8093
261580;201505;5699;17961;5094;17010;367;1465;4194;13995;4561;15460
261590;201505;2512;7168;2252;6789;214;683;1697;5190;1911;5873
261600;201505;5402;14653;4631;13591;382;1164;3593;10641;3975;11805
261610;201505;2454;7174;2097;6664;116;462;1700;5321;1816;5783
261618;201505;2513;7136;2321;6893;212;692;1840;5396;2052;6088
261620;201505;4275;13232;3976;12743;593;1993;2758;8908;3351;10901
261630;201505;7865;22979;6632;20688;1041;3778;3753;11371;4794;15149
261640;201505;32174;82512;29920;79761;1963;4957;24961;68750;26924;73707
261650;201505;3680;11473;3430;11119;423;1488;2489;8112;2912;9600
270010;201505;4531;17120;4156;16399;491;2249;2822;11218;3313;13467
270020;201505;3834;11286;3608;10945;354;1217;2845;8530;3199;9747
270030;201505;40391;121416;37899;117445;9011;28834;21786;68441;30797;97275
270040;201505;10714;32556;9985;31648;2352;7144;5684;18938;8036;26082
270050;201505;4191;11972;3871;11571;356;1204;3070;9157;3426;10361
270060;201505;1668;5358;1573;5232;280;1035;1024;3427;1304;4462
270070;201505;4295;13342;3963;12897;172;787;3433;10982;3605;11769
270080;201505;1275;4076;1138;3798;177;685;717;2316;894;3001
270090;201505;2171;6742;2048;6503;49;208;1764;5493;1813;5701
270100;201505;5958;18475;5676;18012;988;3352;3804;12019;4792;15371
270110;201505;3171;8936;2867;8602;386;1175;1992;6371;2378;7546
270120;201505;3053;8866;2769;8497;86;324;2498;7700;2584;8024
270130;201505;4972;15512;4733;15242;440;1245;3969;13217;4409;14462
270135;201505;1748;4767;1659;4658;136;232;1465;4294;1601;4526
270140;201505;10534;25774;9160;24041;770;2886;7227;17855;7997;20741
270150;201505;2708;9198;2649;9122;118;463;2435;8391;2553;8854
270160;201505;5204;17250;4771;16712;266;998;4071;14336;4337;15334
270170;201505;3910;12704;3584;12251;655;2629;2122;7133;2777;9762
270180;201505;2220;7485;2043;7243;121;607;1697;5939;1818;6546
270190;201505;1886;6181;1783;6036;125;505;1438;4913;1563;5418
270200;201505;2652;8894;2480;8652;220;927;1917;6618;2137;7545
270210;201505;4617;14411;4381;14085;306;1266;3712;11786;4018;13052
270220;201505;1432;4696;1345;4537;249;931;779;2589;1028;3520
270230;201505;11090;35600;9757;33443;1345;5607;6321;21199;7666;26806
270235;201505;6432;20768;6032;20123;366;1558;5050;16692;5416;18250
270240;201505;9986;29778;8579;27948;2013;6819;4468;14762;6481;21581
270250;201505;3342;8646;3073;8322;142;325;2811;7674;2953;7999
270255;201505;5034;15189;4015;13345;297;1228;2883;9432;3180;10660
270260;201505;5798;18980;5614;18713;542;2245;4622;15122;5164;17367
270270;201505;1226;3491;1126;3350;208;644;656;1923;864;2567
270280;201505;3622;10457;3308;10005;379;1239;2450;7392;2829;8631
270290;201505;8417;29349;7943;28523;779;3303;6223;22171;7002;25474
270300;201505;3579;11899;3264;11549;217;853;2756;9836;2973;10689
270310;201505;7370;22526;6517;21152;276;1352;5480;17391;5756;18743
270320;201505;6442;20430;6207;20050;1132;4277;4008;12880;5140;17157
270330;201505;4592;15394;4286;14981;415;1621;3431;12056;3846;13677
270340;201505;1752;5437;1566;5188;140;512;1242;4117;1382;4629
270350;201505;1891;5354;1724;5147;170;564;1300;3930;1470;4494
270360;201505;2047;6394;1984;6319;177;505;1696;5553;1873;6058
270370;201505;1642;5394;1495;5139;141;573;1071;3719;1212;4292
270375;201505;2893;8421;2611;8013;301;1127;1854;5474;2155;6601
270380;201505;5815;17953;5475;17482;545;1763;4295;13978;4840;15741
270390;201505;1328;3676;1179;3465;108;380;877;2482;985;2862
270400;201505;6130;18632;5561;17813;439;1628;4023;12667;4462;14295
270410;201505;4899;15197;4579;14614;490;1726;3305;10438;3795;12164
270420;201505;5905;19006;5694;18721;311;1456;4721;15189;5032;16645
270430;201505;134925;392671;126256;380114;32817;103059;63384;195025;96201;298084
270440;201505;4746;14486;4397;13987;241;904;3618;11580;3859;12484
270450;201505;6348;19697;6095;19375;367;1497;5111;16090;5478;17587
270460;201505;3506;9430;3153;8963;206;707;2661;7457;2867;8164
270470;201505;10348;33579;9648;32458;1260;4357;6701;23089;7961;27446
270480;201505;3043;9462;2711;8871;289;1174;1855;5837;2144;7011
270490;201505;968;3185;920;3116;60;244;733;2462;793;2706
270500;201505;4981;17218;4732;16904;347;1351;3973;14315;4320;15666
270510;201505;6081;18321;5476;17492;709;2967;4000;12204;4709;15171
270520;201505;3641;11703;3403;11311;887;3216;1602;5388;2489;8604
270530;201505;1508;4464;1344;4240;167;550;900;2921;1067;3471
270540;201505;2056;7012;1872;6748;149;723;1502;5294;1651;6017
270550;201505;7132;21142;6273;20023;901;3021;4317;14117;5218;17138
270560;201505;3056;9335;2846;9013;406;1547;2017;6152;2423;7699
270570;201505;3955;12805;3630;12259;379;1627;2771;9121;3150;10748
270580;201505;1961;6484;1877;6368;229;818;1426;4914;1655;5732
270590;201505;1401;4745;1324;4614;35;167;1236;4278;1271;4445
270600;201505;2877;9654;2590;9195;205;1016;1994;6921;2199;7937
270610;201505;3240;10299;3005;9964;253;954;2427;7990;2680;8944
270620;201505;1383;4745;1314;4640;108;525;1076;3645;1184;4170
270630;201505;17342;49580;16103;47580;2357;6851;11322;34224;13679;41075
270640;201505;5938;18221;5318;17393;384;1575;4329;13939;4713;15514
270642;201505;2319;8150;2163;7913;278;1213;1589;5771;1867;6984
270644;201505;2627;7607;2351;7297;195;544;1968;6270;2163;6814
270650;201505;3798;12136;3634;11910;611;2540;2410;7531;3021;10071
270660;201505;2551;6459;1989;5664;123;446;1418;4034;1541;4480
270670;201505;16343;42793;14096;40190;1757;4768;10510;31158;12267;35926
270680;201505;4306;12839;4131;12646;168;448;3775;11697;3943;12145
270690;201505;9060;25159;8272;24259;2612;7356;4211;13188;6823;20544
270700;201505;693;2144;632;2040;88;356;435;1339;523;1695
270710;201505;5946;19637;5674;19285;569;2093;4594;15692;5163;17785
270720;201505;3331;11295;3046;10793;182;938;2469;8570;2651;9508
270730;201505;6422;19540;6095;19175;675;2173;4969;15863;5644;18036
270740;201505;2386;6839;2240;6637;298;1026;1640;4760;1938;5786
270750;201505;5084;16105;4711;15557;482;1730;3644;12079;4126;13809
270760;201505;3456;10453;3116;9883;239;860;2424;7683;2663;8543
270770;201505;18913;49950;15824;46233;3155;9249;9464;28879;12619;38128
270780;201505;1845;6113;1746;5946;213;797;1247;4258;1460;5055
270790;201505;1632;5096;1491;4879;345;1220;792;2537;1137;3757
270800;201505;11583;34156;10791;33124;851;2915;8905;27361;9756;30276
270810;201505;3391;10264;2652;8921;289;1179;1689;5688;1978;6867
270820;201505;1800;6062;1641;5801;254;1007;1073;3797;1327;4804
270830;201505;5585;16410;5065;15764;855;3105;3431;10666;4286;13771
270840;201505;7856;25846;7253;25091;381;1877;6238;21241;6619;23118
270850;201505;7493;24080;7269;23804;1297;5165;5035;15724;6332;20889
270860;201505;11530;32287;9855;30103;1202;4395;6903;20700;8105;25095
270870;201505;2259;6748;1855;5911;264;885;1150;3644;1414;4529
270880;201505;8199;26455;7700;25741;556;2308;6384;21092;6940;23400
270890;201505;2499;7590;2334;7295;288;1089;1707;5201;1995;6290
270895;201505;2934;10954;2791;10765;208;922;2359;9153;2567;10075
270900;201505;1949;5311;1574;4770;106;392;1197;3559;1303;3951
270910;201505;3471;11717;3294;11381;298;1325;2554;8602;2852;9927
270915;201505;9859;33137;8893;31435;1564;6398;5249;18316;6813;24714
270920;201505;6302;19791;5952;19300;187;922;5407;17305;5594;18227
270930;201505;17560;46884;14474;43074;2725;8395;8735;26927;11460;35322
270940;201505;5923;19808;5641;19499;585;2340;4392;15237;4977;17577
280010;201505;686;2056;594;1903;48;220;405;1236;453;1456
280020;201505;4887;14353;4207;13162;711;2395;2679;8326;3390;10721
280030;201505;71962;189447;62777;175895;16594;48881;28812;81867;45406;130748
280040;201505;3172;9825;2839;9338;289;978;2135;7210;2424;8188
280050;201505;3835;12335;3552;11873;1170;4149;1423;4910;2593;9059
280060;201505;4376;14480;4069;13960;835;3093;2331;8136;3166;11229
280067;201505;7509;21408;6510;19982;766;2410;4608;14301;5374;16711
280070;201505;1906;6453;1807;6306;336;1228;1224;4328;1560;5556
280100;201505;3945;12252;3526;11528;801;2770;1881;6229;2682;8999
280110;201505;1414;4328;1306;4166;69;293;1105;3477;1174;3770
280120;201505;7759;24760;7182;23855;1102;3415;5070;17634;6172;21049
280130;201505;7465;21269;6829;20361;1174;3866;4408;13193;5582;17059
280140;201505;5581;15221;5061;14517;504;1452;3995;11584;4499;13036
280150;201505;3467;10493;3189;10018;411;1480;2158;6581;2569;8061
280160;201505;1410;4071;1260;3846;140;488;930;2831;1070;3319
280170;201505;4826;14290;4361;13617;458;1351;3384;10888;3842;12239
280190;201505;1096;3104;985;2925;67;265;769;2206;836;2471
280200;201505;1150;3470;1053;3329;147;577;727;2208;874;2785
280210;201505;13151;40395;11971;38741;2218;7451;7724;25662;9942;33113
280220;201505;1561;4807;1463;4656;87;334;1257;3975;1344;4309
280230;201505;3545;10571;3148;9944;457;1553;1991;6352;2448;7905
280240;201505;3486;10227;3152;9701;274;808;2468;7681;2742;8489
280250;201505;840;2202;695;1976;115;393;375;948;490;1341
280260;201505;2021;5401;1859;5199;87;266;1653;4655;1740;4921
280270;201505;2316;7184;2033;6755;129;516;1584;5198;1713;5714
280280;201505;4182;13657;3837;13077;892;2550;2144;8226;3036;10776
280290;201505;17276;53138;15573;50467;2243;7959;10332;34015;12575;41974
280300;201505;9612;29745;8989;29014;687;2389;7512;24625;8199;27014
280310;201505;1371;3868;1221;3632;73;299;872;2527;945;2826
280320;201505;8344;27121;7699;26022;1448;5420;4218;14241;5666;19661
280330;201505;4590;12863;4178;12262;364;1286;3420;9886;3784;11172
280340;201505;3833;11057;3609;10753;306;981;2899;8800;3205;9781
280350;201505;22238;63018;19994;59718;2607;8053;13925;42355;16532;50408
280360;201505;5802;18247;5450;17701;1037;3826;3235;10321;4272;14147
280370;201505;1840;5161;1633;4830;140;461;1243;3632;1383;4093
280380;201505;1027;3098;941;2978;97;362;721;2278;818;2640
280390;201505;3213;9433;2756;8600;457;1474;1708;5332;2165;6806
280400;201505;4277;12379;3884;11833;1073;3139;2112;6849;3185;9988
280410;201505;2204;7085;1913;6530;293;1154;1132;3722;1425;4876
280420;201505;4229;12335;3935;11885;232;752;3389;10267;3621;11019
280430;201505;2271;5860;2075;5610;126;423;1708;4592;1834;5015
280440;201505;4883;14343;4565;13963;327;999;3919;12110;4246;13109
280445;201505;2455;7033;2288;6757;91;348;1892;5513;1983;5861
280450;201505;8727;23944;8136;23217;527;1262;6995;20553;7522;21815
280460;201505;7105;18817;6382;17817;855;2518;4621;13098;5476;15616
280470;201505;1809;5534;1654;5282;191;610;1221;3948;1412;4558
280480;201505;30792;90730;29329;88656;4561;15850;19850;58676;24411;74526
280490;201505;3798;11507;3360;10719;310;1143;2494;7883;2804;9026
280500;201505;923;2458;847;2362;32;92;738;2038;770;2130
280510;201505;2729;7886;2358;7399;241;870;1780;5644;2021;6514
280520;201505;1743;4930;1589;4736;146;373;1307;4018;1453;4391
280530;201505;2209;6425;2075;6261;164;523;1742;5336;1906;5859
280540;201505;9282;25361;8700;24586;233;913;7870;22019;8103;22932
280550;201505;6968;18527;5949;16971;648;1934;4201;11984;4849;13918
280560;201505;7529;22303;7099;21669;385;1369;6046;18294;6431;19663
280570;201505;6528;17820;5734;16796;684;2239;4010;11698;4694;13937
280580;201505;5589;17316;4751;15857;864;2896;2878;9917;3742;12813
280590;201505;2342;7149;2183;6946;253;1091;1571;4870;1824;5961
280600;201505;3898;11924;3641;11539;349;1276;2747;8646;3096;9922
280610;201505;2498;7016;2306;6753;254;908;1650;4704;1904;5612
280620;201505;5154;15412;4503;14224;661;1901;2954;9731;3615;11632
280630;201505;3865;12524;3676;12254;364;1108;2991;10324;3355;11432
280640;201505;2199;6601;2094;6485;81;163;1960;6197;2041;6360
280650;201505;1129;3521;1019;3335;138;510;686;2242;824;2752
280660;201505;2672;7610;2548;7443;421;1162;1937;5761;2358;6923
280670;201505;16022;42012;14928;40565;2719;7704;9863;26753;12582;34457
280680;201505;2797;7590;2472;7099;168;547;2014;5759;2182;6306
280690;201505;1001;2834;874;2657;123;392;596;1796;719;2188
280700;201505;1106;3300;967;3087;69;215;746;2416;815;2631
280710;201505;11558;31053;10664;30031;757;1963;9088;26036;9845;27999
280720;201505;2273;6326;2068;6080;244;718;1474;4450;1718;5168
280730;201505;951;2827;897;2751;81;259;751;2307;832;2566
280740;201505;13147;35786;11433;33223;1700;4824;7569;22608;9269;27432
280750;201505;3562;10865;3250;10327;329;1154;2321;7402;2650;8556
280760;201505;5657;17420;5152;16718;679;2276;3580;12028;4259;14304
290010;201505;3111;6981;2229;5628;66;266;1781;4273;1847;4539
290020;201505;4511;15134;4439;15043;385;1035;3838;13412;4223;14447
290030;201505;3164;9976;2990;9710;516;1660;2061;6776;2577;8436
290035;201505;4717;12217;4100;11408;257;830;3300;9442;3557;10272
290040;201505;3837;10809;3357;10260;206;817;2748;8292;2954;9109
290050;201505;2567;8336;2281;7884;160;648;1804;6240;1964;6888
290060;201505;1351;3449;1130;3189;199;634;808;2218;1007;2852
290070;201505;32327;81688;27512;75763;5978;16319;14274;41847;20252;58166
290080;201505;6185;18393;5303;17244;611;1958;3987;13372;4598;15330
290090;201505;2292;4922;1783;4382;174;396;1486;3730;1660;4126
290100;201505;9746;27865;8546;25990;1098;3476;5674;17729;6772;21205
290110;201505;5116;15225;4866;14795;707;2346;3321;9987;4028;12333
290115;201505;4966;14785;4365;13983;296;982;3436;11257;3732;12239
290120;201505;6739;17811;5806;16694;259;801;5099;14658;5358;15459
290130;201505;4572;12059;3847;11159;228;820;3158;8970;3386;9790
290135;201505;4645;11920;4035;10983;280;966;3034;7927;3314;8893
290140;201505;4163;12983;3525;12121;213;810;3030;10475;3243;11285
290150;201505;2212;6612;2102;6435;177;558;1759;5395;1936;5953
290160;201505;3450;9333;3346;9207;202;370;3062;8625;3264;8995
290170;201505;2746;9228;2504;8863;170;754;2151;7544;2321;8298
290180;201505;2902;8481;2561;7955;212;769;1956;6037;2168;6806
290190;201505;3901;13116;3748;12876;287;1153;2941;10115;3228;11268
290195;201505;2220;6106;1899;5624;123;441;1539;4548;1662;4989
290200;201505;3793;11931;3398;11291;288;979;2696;9039;2984;10018
290205;201505;3122;9397;2808;8920;322;1238;2042;6347;2364;7585
290210;201505;15587;43205;14409;41741;2836;7214;9551;30010;12387;37224
290220;201505;2282;6868;2171;6693;171;702;1695;5078;1866;5780
290225;201505;2954;7813;2731;7571;158;374;2483;7004;2641;7378
290230;201505;2287;7525;2215;7436;146;552;1906;6433;2052;6985
290240;201505;3826;10229;3464;9724;345;1036;2601;7210;2946;8246
290250;201505;3716;11928;3268;11245;216;766;2646;9250;2862;10016
290260;201505;4897;14415;4273;13456;342;1191;3352;10596;3694;11787
290265;201505;3324;10578;2990;9970;176;733;2344;7783;2520;8516
290270;201505;12262;44374;11548;43285;1526;6030;8455;32264;9981;38294
290280;201505;5214;17186;4873;16631;393;1463;3794;13046;4187;14509
290290;201505;9709;30752;8716;29155;1426;4946;5745;19614;7171;24560
290300;201505;4560;13060;3248;10601;262;844;2219;7550;2481;8394
290310;201505;1499;4480;1333;4225;238;823;777;2453;1015;3276
290320;201505;27613;81556;23822;76499;5760;19479;12298;40571;18058;60050
290323;201505;3836;10345;3331;9787;183;597;2792;8175;2975;8772
290327;201505;4426;13621;3862;12587;599;2007;2488;8163;3087;10170
290330;201505;1861;4705;1730;4562;159;462;1486;3901;1645;4363
290340;201505;4816;15293;4532;14915;1372;4476;2427;8149;3799;12625
290350;201505;4734;14481;4038;13482;503;1719;2783;9558;3286;11277
290360;201505;4498;13789;3910;13006;171;607;3332;11229;3503;11836
290370;201505;4888;13831;4259;13042;456;1289;3427;10735;3883;12024
290380;201505;5577;16207;4854;15160;341;1185;3855;12114;4196;13299
290390;201505;14906;46262;13710;44435;2627;8636;8260;28009;10887;36645
290395;201505;2687;8726;2367;8153;171;763;1791;6147;1962;6910
290400;201505;3635;10803;3121;10082;279;902;2378;7752;2657;8654
290405;201505;4580;14583;3877;13243;537;1914;2450;8544;2987;10458
290410;201505;6150;18034;5011;16272;498;1890;3637;11597;4135;13487
290420;201505;3350;9644;2737;8812;225;798;2167;6985;2392;7783
290430;201505;3073;9843;2804;9376;509;1831;1748;5872;2257;7703
290440;201505;2936;7891;2435;7196;179;585;1936;5812;2115;6397
290450;201505;3332;9733;2905;9121;365;1219;2020;6381;2385;7600
290460;201505;13202;38651;11829;36399;3082;9974;5287;16222;8369;26196
290470;201505;4587;12668;3525;11118;745;2669;1785;5708;2530;8377
290475;201505;5017;17245;4573;16401;433;1936;3351;11866;3784;13802
290480;201505;2708;7043;2416;6667;382;1095;1576;4503;1958;5598
290485;201505;4862;15457;4245;14553;361;1687;3403;11448;3764;13135
290490;201505;8091;21420;7751;20982;595;1691;6508;17610;7103;19301
290500;201505;4475;13920;3621;12262;598;2220;1920;6476;2518;8696
290510;201505;3380;9834;2920;9199;168;632;2422;7671;2590;8303
290515;201505;3225;9446;2776;8830;228;704;2227;7257;2455;7961
290520;201505;12274;37620;9979;33410;891;3686;6365;21098;7256;24784
290530;201505;5184;15053;4494;14035;364;1127;3601;11364;3965;12491
290540;201505;3960;11459;3754;11201;452;1271;2932;8975;3384;10246
290550;201505;4502;12181;3937;11522;145;420;3585;10565;3730;10985
290560;201505;5955;17798;5272;16795;1199;3955;2981;9706;4180;13661
290570;201505;42803;118556;39021;113140;4598;13868;27773;80464;32371;94332
290580;201505;7049;24137;6643;23508;909;3294;4834;17556;5743;20850
290590;201505;7743;24175;6461;22010;390;1623;5105;17351;5495;18974
290600;201505;17417;53062;16068;51037;2507;7738;11208;36827;13715;44565
290610;201505;2528;8547;2116;7730;181;833;1517;5458;1698;6291
290620;201505;6541;19922;5964;19068;365;1245;4983;15949;5348;17194
290630;201505;8016;21300;7185;20412;631;1782;6022;17306;6653;19088
290640;201505;2693;7835;2149;6935;162;637;1616;5141;1778;5778
290650;201505;11245;32065;10489;31030;2238;6500;6561;20063;8799;26563
290660;201505;3616;10164;3126;9452;158;534;2448;7580;2606;8114
290670;201505;7069;21518;6359;20426;728;2307;4703;15573;5431;17880
290680;201505;10233;30460;9329;29377;420;1475;8022;25394;8442;26869
290682;201505;4558;13146;4050;12439;166;650;3409;10348;3575;10998
290685;201505;3714;8913;2465;7150;302;947;1502;4457;1804;5404
290687;201505;7783;21435;6097;18996;1391;4476;3197;10273;4588;14749
290689;201505;3187;9150;2715;8419;239;762;2103;6657;2342;7419
290690;201505;5571;16069;5035;15392;510;1639;3939;12159;4449;13798
290700;201505;2370;7387;2241;7192;203;728;1724;5560;1927;6288
290710;201505;8092;25356;7687;24704;445;1424;6376;21133;6821;22557
290720;201505;18786;55166;17000;52955;1419;3942;14122;45391;15541;49333
290730;201505;7200;20061;6492;19141;1040;2956;4465;13414;5505;16370
290740;201505;931;2767;788;2525;82;272;541;1768;623;2040
290750;201505;10470;29383;8836;26396;1671;5675;4713;13450;6384;19125
290755;201505;2421;6802;1993;6099;111;388;1504;4587;1615;4975
290760;201505;4322;12923;3502;11528;401;1235;2342;7904;2743;9139
290770;201505;2615;9173;2444;8949;106;501;2000;7376;2106;7877
290780;201505;9065;22980;7823;21225;787;1676;6021;17067;6808;18743
290790;201505;4364;13267;4055;12826;271;823;3425;10979;3696;11802
290800;201505;7423;15847;5939;14276;682;1408;4448;11375;5130;12783
290810;201505;5074;15928;4313;14721;240;901;3291;11390;3531;12291
290820;201505;5726;16034;5088;15187;448;1430;3930;11871;4378;13301
290830;201505;4284;11676;3918;11133;227;820;3190;8885;3417;9705
290840;201505;17606;49739;15665;46938;2488;7193;10569;33052;13057;40245
290850;201505;6390;18486;6180;18232;730;1940;5035;15425;5765;17365
290860;201505;4998;17123;4678;16725;573;2087;3545;13061;4118;15148
290870;201505;4744;14023;3848;12628;307;1241;2853;9339;3160;10580
290880;201505;1443;3940;1146;3458;83;254;812;2473;895;2727
290890;201505;7058;18684;6063;17581;670;1905;4807;14165;5477;16070
290900;201505;2597;7338;1895;6159;281;961;957;3135;1238;4096
290910;201505;4606;12710;3995;11840;140;482;3504;10357;3644;10839
290920;201505;4716;13975;4363;13466;286;792;3620;11339;3906;12131
290930;201505;7785;24232;6829;22640;547;2206;5210;17059;5757;19265
290940;201505;3430;11055;3202;10750;195;683;2787;9544;2982;10227
290950;201505;1584;4436;1411;4191;193;571;970;2938;1163;3509
290960;201505;5811;16530;5289;15846;211;746;4473;13472;4684;14218
290970;201505;3623;11621;3215;10919;357;1256;2172;7498;2529;8754
290980;201505;10300;29612;8741;26703;2408;7591;3075;9388;5483;16979
290990;201505;9176;27517;8040;25663;841;2858;5975;18958;6816;21816
291000;201505;3069;9342;2803;9002;246;847;2330;7550;2576;8397
291005;201505;14021;37528;12497;35475;1798;5243;8722;25207;10520;30450
291010;201505;3254;10230;2555;8724;286;1021;1631;5623;1917;6644
291020;201505;1426;3758;1087;3160;130;431;649;1801;779;2232
291030;201505;2282;6236;1695;5080;170;569;1038;3045;1208;3614
291040;201505;5491;16645;4932;15871;436;1576;3902;12585;4338;14161
291050;201505;7767;25579;7022;24162;1847;7091;3438;11506;5285;18597
291060;201505;6059;22304;5736;21823;842;3632;3995;15131;4837;18763
291070;201505;16348;47168;14387;44333;1273;4038;11012;34335;12285;38373
291072;201505;22592;66958;18456;58749;4897;16879;6770;21896;11667;38775
291075;201505;5176;14646;4576;13828;275;684;3646;11404;3921;12088
291077;201505;1523;4327;1236;3868;111;392;835;2613;946;3005
291080;201505;79535;246517;70963;229916;23655;78494;19802;63494;43457;141988
291085;201505;5576;14874;4873;13962;479;1374;3941;11390;4420;12764
291090;201505;1574;3866;1373;3615;94;326;1129;2914;1223;3240
291100;201505;2843;7100;2257;6485;123;457;1833;5220;1956;5677
291110;201505;4802;17511;4400;16873;565;2513;3127;11826;3692;14339
291120;201505;7482;20066;6876;19175;861;2488;4974;13936;5835;16424
291125;201505;1846;3768;1413;3303;107;262;1119;2682;1226;2944
291130;201505;2863;8859;2424;8112;150;644;1808;5913;1958;6557
291140;201505;4310;12755;3848;11913;560;1761;2531;7927;3091;9688
291150;201505;2023;5308;1919;5189;130;406;1554;4141;1684;4547
291160;201505;5395;16683;4718;15607;1162;3873;2521;8443;3683;12316
291165;201505;2535;7165;1969;6099;66;291;1453;4374;1519;4665
291170;201505;21617;56162;18594;52230;934;3147;14263;39859;15197;43006
291180;201505;6510;16931;5238;15092;534;1711;3700;10658;4234;12369
291185;201505;3875;10584;3499;10042;306;895;2843;8132;3149;9027
291190;201505;7158;19763;6336;18649;538;1676;5120;15162;5658;16838
291200;201505;2922;8720;2363;7682;163;538;1660;5517;1823;6055
291210;201505;7334;17423;6233;16173;378;1093;5024;13050;5402;14143
291220;201505;4114;12818;3781;12301;477;1779;2761;8902;3238;10681
291230;201505;4097;10545;3669;10061;101;232;3389;9411;3490;9643
291240;201505;4662;12670;4026;11508;178;572;3262;9184;3440;9756
291250;201505;3712;11107;2880;9659;316;1096;1937;6609;2253;7705
291260;201505;1102;3230;1006;3100;59;241;833;2515;892;2756
291270;201505;4479;14457;4091;13732;1298;4547;1986;6743;3284;11290
291280;201505;2267;6182;1752;5406;407;1353;864;2586;1271;3939
291290;201505;5639;15738;4919;14829;826;2475;3161;9807;3987;12282
291300;201505;4369;12556;3526;11114;281;1021;2569;7954;2850;8975
291310;201505;5437;15513;4694;14214;327;1076;3684;11145;4011;12221
291320;201505;6055;19255;5119;17450;1188;4401;2656;8956;3844;13357
291330;201505;1623;4830;1440;4533;144;526;1012;3114;1156;3640
291340;201505;3905;11443;3275;10559;191;708;2665;8578;2856;9286
291345;201505;3554;11256;3305;10969;203;604;2906;9929;3109;10533
291350;201505;5546;16399;4882;15248;303;1029;3896;12308;4199;13337
291360;201505;33416;93804;30388;89530;7542;22074;17421;53080;24963;75154
291370;201505;8492;24636;8024;24057;613;1858;6418;19611;7031;21469
291380;201505;3749;11441;3235;10614;225;807;2364;7946;2589;8753
291390;201505;10555;28505;9543;27329;1357;3679;7149;20889;8506;24568
291400;201505;16493;43167;13550;39186;2438;6720;8289;25394;10727;32114
291410;201505;3363;8784;2486;7496;169;694;1876;5497;2045;6191
291420;201505;2162;5873;1886;5541;107;360;1629;4779;1736;5139
291430;201505;3404;9872;3006;9353;170;738;2428;7410;2598;8148
291440;201505;6496;19878;5503;18162;538;1913;4034;13385;4572;15298
291450;201505;8202;24605;7294;23333;307;954;5970;19824;6277;20778
291460;201505;13128;39609;11717;37374;1877;6550;7234;23181;9111;29731
291465;201505;8048;22971;7179;21995;529;1774;6006;18446;6535;20220
291470;201505;15856;43090;13916;40738;1189;3342;10599;32201;11788;35543
291480;201505;34471;90264;29680;83649;3973;12537;18768;52489;22741;65026
291490;201505;4406;14298;4254;14092;394;1260;3528;11986;3922;13246
291500;201505;4293;12323;3654;11402;256;937;2896;9006;3152;9943
291510;201505;3583;10812;3270;10400;89;260;2996;9642;3085;9902
291520;201505;3926;10629;3410;9925;379;1160;2393;7071;2772;8231
291530;201505;2077;5954;1736;5429;404;1335;906;2940;1310;4275
291535;201505;4067;12133;3633;11512;227;781;2936;9400;3163;10181
291540;201505;2229;5243;1857;4857;156;291;1593;4328;1749;4619
291550;201505;5316;14452;4654;13546;1051;2957;2629;7885;3680;10842
291560;201505;18516;44344;13429;38421;1238;3478;10055;29865;11293;33343
291570;201505;2244;6119;2086;5921;156;359;1795;5246;1951;5605
291580;201505;5679;17265;5036;16306;572;2267;3643;11736;4215;14003
291590;201505;1831;5784;1634;5458;177;619;1208;4123;1385;4742
291600;201505;5683;15493;4155;13149;1039;3531;1805;5607;2844;9138
291610;201505;4920;15383;4758;15183;253;899;4178;13391;4431;14290
291620;201505;3034;7167;2406;6504;140;346;1948;5462;2088;5808
291630;201505;3164;7768;2664;7188;274;685;2086;5754;2360;6439
291640;201505;17450;47166;14140;42456;3536;11343;5147;15743;8683;27086
291650;201505;8002;23946;7381;23197;640;1682;6196;20114;6836;21796
291660;201505;2236;5899;1878;5363;147;516;1300;3593;1447;4109
291670;201505;1888;5349;1697;5076;129;414;1316;3945;1445;4359
291680;201505;4294;12479;3714;11515;731;2481;2105;6497;2836;8978
291685;201505;4749;11886;3937;10831;553;1448;2778;7953;3331;9401
291690;201505;4074;10919;3262;9631;244;708;2343;6958;2587;7666
291700;201505;9238;28841;8304;27212;883;2957;6260;20861;7143;23818
291710;201505;5297;13927;4312;12700;430;1430;3186;9415;3616;10845
291720;201505;4321;14377;3718;13146;353;1454;2634;9186;2987;10640
291730;201505;6059;18247;5474;17472;660;2211;4161;13547;4821;15758
291733;201505;2653;7691;2250;7152;243;840;1516;4906;1759;5746
291735;201505;2738;7661;2280;6981;132;480;1833;5558;1965;6038
291740;201505;3667;10928;3142;10152;279;1038;2390;7661;2669;8699
291750;201505;22759;58394;17527;50404;3952;11805;8855;26019;12807;37824
291760;201505;11425;36257;10118;33982;4060;15078;3034;10037;7094;25115
291770;201505;7662;22032;6592;20126;942;3116;4341;13119;5283;16235
291780;201505;4491;13607;4208;13120;353;1121;3367;10523;3720;11644
291790;201505;2669;8182;2528;7991;110;459;2172;6794;2282;7253
291800;201505;31056;86379;27494;81371;4796;14510;17170;52482;21966;66992
291810;201505;10727;29678;8935;27557;444;1622;7504;23200;7948;24822
291820;201505;3727;11049;3368;10532;253;835;2604;8216;2857;9051
291830;201505;4323;11512;3982;11033;471;1361;2983;8339;3454;9700
291835;201505;6348;19784;5086;17620;1393;5203;2587;8996;3980;14199
291840;201505;48271;134060;42258;127340;5886;17252;31026;96772;36912;114024
291845;201505;2939;8421;2612;8035;185;510;2297;7212;2482;7722
291850;201505;4698;13273;3840;11955;381;1086;2914;9378;3295;10464
291855;201505;1837;4686;1579;4360;180;620;1151;3044;1331;3664
291860;201505;2155;6177;1771;5451;126;478;1183;3571;1309;4049
291870;201505;1431;3820;1060;3158;94;336;681;1983;775;2319
291875;201505;2883;9080;2594;8639;160;674;1885;6154;2045;6828
291880;201505;4931;15685;4638;15203;388;1243;3732;12443;4120;13686
291890;201505;1371;3460;1141;3192;306;854;653;1920;959;2774
291900;201505;1308;3602;1084;3241;85;313;860;2551;945;2864
291905;201505;2834;7566;2202;6504;99;368;1669;4811;1768;5179
291910;201505;2757;7374;2314;6845;138;517;1944;5664;2082;6181
291915;201505;7157;21690;6010;19574;397;1382;4845;15928;5242;17310
291920;201505;30317;87617;27643;83819;5089;16035;16849;51851;21938;67886
291930;201505;2634;7742;2344;7286;207;726;1721;5301;1928;6027
291940;201505;3415;9723;2508;8080;347;1258;1422;4415;1769;5673
291950;201505;8805;29454;7946;27987;1339;4773;4704;17006;6043;21779
291955;201505;9765;29224;9210;28500;2121;6534;5513;17781;7634;24315
291960;201505;3208;9346;2630;8487;255;841;1878;6257;2133;7098
291970;201505;4023;12488;3748;12087;461;1571;2658;8707;3119;10278
291980;201505;11935;33937;9065;29792;1114;3790;6153;20744;7267;24534
291990;201505;2265;6830;2050;6537;126;429;1649;5390;1775;5819
291992;201505;2850;8718;2769;8555;387;1251;2086;6405;2473;7656
291995;201505;1931;5810;1792;5581;136;490;1468;4554;1604;5044
292000;201505;2411;6869;2130;6480;299;1049;1495;4534;1794;5583
292010;201505;6481;16452;4992;14294;463;1285;3794;10960;4257;12245
292020;201505;4246;14471;3945;13982;654;2427;2800;9979;3454;12406
292030;201505;2091;6425;1848;6068;237;840;1091;3553;1328;4393
292040;201505;4396;12089;3782;11446;253;613;3267;10315;3520;10928
292045;201505;2929;10089;2854;9999;88;303;2700;9455;2788;9758
292050;201505;6399;19645;5544;17946;470;1854;3777;12074;4247;13928
292060;201505;11675;31424;10863;30414;1057;2734;8804;24967;9861;27701
292070;201505;4695;14446;4465;14176;401;1138;3741;12114;4142;13252
292080;201505;3634;9453;3043;8716;208;627;2526;7288;2734;7915
292090;201505;4133;10829;3532;10131;231;763;3002;8669;3233;9432
292100;201505;11071;30059;9272;27532;2623;8111;4054;12657;6677;20768
292105;201505;3016;9478;2711;9010;150;613;2211;7353;2361;7966
292110;201505;6809;17895;5226;15476;1221;3644;2813;8602;4034;12246
292120;201505;7928;22372;6720;20124;1377;4112;3714;11566;5091;15678
292130;201505;3030;8127;2609;7529;477;1292;1682;5020;2159;6312
292140;201505;5073;13144;4228;11995;932;2403;2669;7882;3601;10285
292145;201505;2498;7654;2250;7267;149;445;1759;5946;1908;6391
292150;201505;13018;39708;11996;38046;680;2408;9627;30761;10307;33169
292160;201505;2669;7749;2274;7243;113;357;2002;6450;2115;6807
292170;201505;8959;25475;7435;22879;968;3365;4769;14625;5737;17990
292180;201505;3317;9449;2540;8189;357;1144;1623;5350;1980;6494
292190;201505;3416;9576;2866;8774;575;1838;1727;5398;2302;7236
292200;201505;6496;20497;5585;18817;1605;5882;2136;7185;3741;13067
292205;201505;3911;12132;3525;11562;209;858;2875;9301;3084;10159
292210;201505;6514;17866;5450;16460;364;1290;4452;13477;4816;14767
292220;201505;1942;5348;1763;5093;424;1164;973;2855;1397;4019
292225;201505;3227;9953;2945;9554;181;665;2443;7956;2624;8621
292230;201505;6489;19354;6148;18802;423;1730;4808;14264;5231;15994
292240;201505;4725;14187;4220;13162;498;1616;2930;9043;3428;10659
292250;201505;5158;15889;4748;15131;1111;3704;2295;7364;3406;11068
292260;201505;3170;9479;2986;9228;195;640;2531;7843;2726;8483
292265;201505;3024;9456;2667;8839;173;717;1977;6472;2150;7189
292270;201505;4170;10664;3275;9629;201;688;2718;8025;2919;8713
292273;201505;2736;6547;2099;5768;225;576;1579;4575;1804;5151
292275;201505;1762;4697;1563;4404;217;641;1098;3121;1315;3762
292280;201505;2064;6087;1807;5803;161;469;1399;4764;1560;5233
292285;201505;2567;7006;2173;6451;146;504;1730;5148;1876;5652
292290;201505;7351;21956;6086;20238;413;1574;4741;15994;5154;17568
292300;201505;8184;24507;7067;23151;1677;5697;4130;13980;5807;19677
292303;201505;2810;8681;2596;8402;86;368;2297;7369;2383;7737
292305;201505;2982;8110;2824;7885;57;188;2646;7383;2703;7571
292310;201505;5976;17728;5572;17149;229;805;4688;14426;4917;15231
292320;201505;6645;19111;5711;17545;533;1777;4362;13420;4895;15197
292330;201505;2152;5893;1994;5666;177;569;1592;4470;1769;5039
292335;201505;5269;13717;4684;12944;442;1184;3859;10820;4301;12004
292340;201505;6436;18311;5416;16664;556;1702;3854;11991;4410;13693
292350;201505;2222;6660;1988;6322;181;696;1584;5035;1765;5731
292360;201505;5160;13781;4941;13323;198;377;4267;12103;4465;12480
292370;201505;8016;23807;7410;22960;761;2042;5916;18829;6677;20871
292380;201505;7272;21443;6700;20559;492;1466;5506;17081;5998;18547
292390;201505;3559;8112;3135;7652;104;184;2920;7230;3024;7414
292400;201505;20960;62948;19880;61295;2567;8209;14785;45989;17352;54198
292405;201505;4612;11652;3754;10564;237;631;3070;8717;3307;9348
292410;201505;1954;5245;1837;5112;128;322;1612;4534;1740;4856
292420;201505;3777;12276;3622;12085;123;366;3378;11414;3501;11780
292430;201505;5674;16882;4327;14948;309;1254;3212;11101;3521;12355
292440;201505;8596;28373;7893;27341;262;1053;7033;24631;7295;25684
292450;201505;4204;12486;3444;11270;325;1096;2500;8334;2825;9430
292460;201505;5276;15760;4556;14508;739;2512;2887;9221;3626;11733
292465;201505;2433;7309;2044;6662;198;754;1398;4624;1596;5378
292467;201505;1958;6284;1856;6120;318;1121;1259;4223;1577;5344
292470;201505;2938;7899;2455;7101;134;463;1943;5563;2077;6026
292480;201505;6138;16411;5306;15286;194;715;4680;13398;4874;14113
292490;201505;2447;6659;2019;6039;162;538;1560;4652;1722;5190
292500;201505;6626;19653;5622;17885;623;2112;3922;12681;4545;14793
292510;201505;12908;36477;11140;33971;890;2942;8714;26986;9604;29928
292520;201505;5681;16704;5057;15743;1247;3958;2688;8477;3935;12435
292525;201505;5382;14039;4557;13077;223;678;3856;11166;4079;11844
292530;201505;26443;76638;23434;72558;6195;19885;11761;37531;17956;57416
292540;201505;2860;8005;2530;7571;262;887;1989;5956;2251;6843
292550;201505;6606;20688;5814;19635;688;2460;4339;15018;5027;17478
292560;201505;4125;11395;3505;10497;214;848;2806;8266;3020;9114
292570;201505;3920;11738;3714;11521;77;190;3517;11125;3594;11315
292575;201505;6059;20437;5888;20160;744;2634;4619;15920;5363;18554
292580;201505;6853;20480;6475;19974;453;1409;5446;16967;5899;18376
292590;201505;7323;22144;6817;21399;581;1863;5517;17296;6098;19159
292593;201505;3126;8188;2617;7399;195;507;2088;5955;2283;6462
292595;201505;6025;16701;5315;15790;431;1389;4176;12496;4607;13885
292600;201505;10659;29978;9707;28775;919;2160;7820;24085;8739;26245
292610;201505;4535;12931;3707;11543;344;1121;2364;7662;2708;8783
292620;201505;6102;17785;5236;16778;144;473;4847;15658;4991;16131
292630;201505;9523;23970;7959;21595;722;1953;5803;16076;6525;18029
292640;201505;7809;25685;7209;24806;480;1764;5699;19946;6179;21710
292650;201505;4763;13134;4523;12828;365;712;3963;11692;4328;12404
292660;201505;10704;32277;9913;31131;1055;3424;7667;24411;8722;27835
292665;201505;2635;8066;2535;7932;47;96;2401;7631;2448;7727
292670;201505;3852;10759;2940;9203;230;798;1950;6115;2180;6913
292680;201505;3588;10858;3293;10370;383;1153;2508;7969;2891;9122
292690;201505;2973;8066;2158;6798;203;674;1513;4886;1716;5560
292700;201505;9224;27538;8114;25906;1132;3321;5556;18637;6688;21958
292710;201505;2052;6711;1938;6555;65;261;1735;5882;1800;6143
292720;201505;9308;23899;8012;22464;367;1129;6959;19672;7326;20801
292730;201505;3562;10723;3433;10534;340;1054;2664;8263;3004;9317
292740;201505;338418;911733;317966;882307;58855;173535;201767;556501;260622;730036
292750;201505;6520;17478;5572;16194;329;1006;4584;13407;4913;14413
292760;201505;4074;12789;3683;12094;478;1675;2444;8091;2922;9766
292770;201505;5650;17212;5212;16534;1024;3394;3271;10561;4295;13955
292780;201505;1936;4595;1479;4019;160;537;1074;2864;1234;3401
292790;201505;3219;8505;3086;8366;107;213;2890;7953;2997;8166
292800;201505;9111;27200;8393;26016;563;1933;6776;20972;7339;22905
292805;201505;2979;8504;2665;8068;386;1271;1927;5810;2313;7081
292810;201505;9423;28736;8063;26861;1009;3494;5824;19839;6833;23333
292820;201505;7402;21113;5502;18382;308;1201;4392;14780;4700;15981
292830;201505;1871;5436;1674;5158;77;322;1419;4317;1496;4639
292840;201505;7688;24025;7192;23353;298;1148;6466;20883;6764;22031
292850;201505;3245;8464;2642;7543;364;1074;1628;4548;1992;5622
292860;201505;14767;38932;13583;37364;1219;3496;10705;29453;11924;32949
292870;201505;19290;52813;16836;49011;2280;7346;10311;29688;12591;37034
292880;201505;12756;36576;11353;34573;1328;4456;7914;23875;9242;28331
292890;201505;5490;18691;4924;17673;786;3030;3099;11261;3885;14291
292895;201505;2779;6827;2171;5909;278;721;1506;4130;1784;4851
292900;201505;2859;8870;2706;8634;228;991;1989;6079;2217;7070
292905;201505;4192;12253;3521;11334;197;600;2893;9540;3090;10140
292910;201505;5070;15190;4601;14334;680;2301;2871;8951;3551;11252
292920;201505;8965;26534;8501;25894;647;2336;6920;20562;7567;22898
292925;201505;5160;15698;4568;14843;449;1462;3445;11304;3894;12766
292930;201505;6536;21014;6227;20492;523;2243;4711;15186;5234;17429
292935;201505;2152;6139;1810;5768;105;274;1508;5043;1613;5317
292937;201505;3261;8330;2711;7649;275;864;2061;5736;2336;6600
292940;201505;3280;8962;2580;8000;297;936;1761;5674;2058;6610
292950;201505;7992;23548;7479;22695;663;2428;5590;16606;6253;19034
292960;201505;5110;13383;4449;12498;352;1087;3325;9260;3677;10347
292970;201505;4333;13010;3839;12367;146;612;3263;10541;3409;11153
292975;201505;3434;9283;3241;9030;318;794;2746;7804;3064;8598
292980;201505;3373;9097;2629;8050;251;885;1912;5806;2163;6691
292990;201505;11871;34272;10531;32215;449;1570;8893;27160;9342;28730
293000;201505;2783;7414;2458;7008;79;259;2130;6161;2209;6420
293010;201505;18172;50529;15522;46316;2512;8135;9519;28231;12031;36366
293015;201505;7529;25795;6639;24110;938;3810;4278;15478;5216;19288
293020;201505;9263;30867;8660;30029;397;1715;7440;25752;7837;27467
293030;201505;5599;16131;4417;14328;354;1130;3151;10743;3505;11873
293040;201505;3718;12271;3537;11932;185;663;3133;10562;3318;11225
293050;201505;20083;55948;17650;52843;2614;8101;11231;34667;13845;42768
293060;201505;4000;10324;3239;9100;282;854;2367;6593;2649;7447
293070;201505;21499;62327;18931;58311;4720;14741;9505;30273;14225;45014
293075;201505;3366;11198;3046;10755;227;872;2451;8752;2678;9624
293076;201505;3732;10352;3396;9900;223;608;2851;8499;3074;9107
293077;201505;4893;15228;4313;14446;1020;3591;2393;8184;3413;11775
293080;201505;4657;14680;4257;14053;239;1090;3481;11292;3720;12382
293090;201505;3365;10780;2799;9933;246;872;2109;7642;2355;8514
293100;201505;5873;17295;4837;15472;440;1470;3559;11554;3999;13024
293105;201505;3975;13175;3476;12219;498;1784;2322;8336;2820;10120
293110;201505;2015;5855;1792;5514;74;269;1510;4642;1584;4911
293120;201505;3866;12772;3633;12423;319;1011;2895;10154;3214;11165
293130;201505;4095;11570;3459;10865;154;538;3107;9892;3261;10430
293135;201505;31194;78716;23569;68042;4780;15764;10167;28999;14947;44763
293140;201505;2032;5896;1936;5760;151;553;1546;4472;1697;5025
293150;201505;5640;18577;4878;17088;872;3161;2987;10744;3859;13905
293160;201505;3769;9723;3477;9380;603;1195;2490;7282;3093;8477
293170;201505;3340;9996;3059;9582;367;1279;2211;6975;2578;8254
293180;201505;5200;14632;4187;13014;209;843;3336;10189;3545;11032
293190;201505;13970;42321;13049;40946;452;2093;11432;35300;11884;37393
293200;201505;6760;19178;5879;18006;253;893;4944;15222;5197;16115
293210;201505;5050;14627;4489;13673;321;1123;3439;10464;3760;11587
293220;201505;5119;15122;4472;14035;1141;3686;2058;6574;3199;10260
293230;201505;3846;11825;3518;11321;554;1914;2431;7853;2985;9767
293240;201505;4492;12227;3584;10736;159;511;2689;8063;2848;8574
293245;201505;4345;12460;3958;11885;375;1109;3032;9289;3407;10398
293250;201505;5871;16341;5334;15550;583;1779;3819;11129;4402;12908
293260;201505;4670;13963;3935;12898;304;1068;2997;9932;3301;11000
293270;201505;5678;15226;5312;14841;405;920;4690;13453;5095;14373
293280;201505;5374;15147;4594;14119;278;816;3683;11549;3961;12365
293290;201505;15582;51872;14608;49987;3543;12652;7399;25834;10942;38486
293300;201505;6953;16608;5861;15346;394;928;4683;12522;5077;13450
293305;201505;4838;12011;4140;11063;183;556;3526;9388;3709;9944
293310;201505;2526;6570;2063;5793;174;517;1492;4158;1666;4675
293315;201505;4417;11278;3783;10312;479;1289;2711;7513;3190;8802
293317;201505;2478;7215;2205;6718;201;632;1522;4671;1723;5303
293320;201505;8098;26925;7909;26698;591;2176;6754;22946;7345;25122
293325;201505;1910;5494;1582;4986;219;771;1058;3348;1277;4119
293330;201505;52511;166333;46992;156759;10158;36612;23812;80083;33970;116695
293340;201505;2709;7620;2110;6579;302;1012;1315;4031;1617;5043
293345;201505;3407;10044;2944;9404;281;808;2238;7463;2519;8271
293350;201505;6750;18971;6389;18556;342;795;5709;17026;6051;17821
293360;201505;13418;40859;12079;39175;566;1924;10608;34699;11174;36623
310010;201505;1138;3071;842;2616;165;642;364;1050;529;1692
310020;201505;3294;10310;2702;9095;694;2589;483;1447;1177;4036
310030;201505;2358;7459;1969;6780;472;1824;1044;3537;1516;5361
310040;201505;1014;2704;842;2477;69;243;648;1891;717;2134
310050;201505;1922;6623;1731;6190;325;1380;834;2910;1159;4290
310060;201505;3239;10414;2853;9911;332;1236;2173;7605;2505;8841
310070;201505;329;938;255;801;29;121;146;418;175;539
310080;201505;727;2204;581;1937;119;504;198;590;317;1094
310090;201505;4741;14071;4086;12910;585;2041;2530;7975;3115;10016
310100;201505;3380;10234;2825;9297;219;891;2177;7117;2396;8008
310110;201505;5076;14255;4317;13081;707;2524;2625;7799;3332;10323
310120;201505;509;1581;434;1450;138;585;182;488;320;1073
310130;201505;432;1308;389;1244;83;319;220;655;303;974
310140;201505;202;669;167;606;64;276;39;110;103;386
310150;201505;4776;14615;4178;13488;971;3505;1780;5641;2751;9146
310160;201505;7414;23076;6079;20696;1748;6567;1840;6181;3588;12748
310163;201505;932;3044;784;2742;211;813;274;931;485;1744
310170;201505;9187;26048;8306;24807;1283;3988;5537;16947;6820;20935
310180;201505;1631;4759;1367;4346;323;1153;635;1936;958;3089
310190;201505;2727;9051;2482;8651;701;2659;372;1291;1073;3950
310200;201505;1876;6119;1562;5480;373;1479;569;1952;942;3431
310205;201505;1117;3244;882;2874;167;552;486;1611;653;2163
310210;201505;2661;8011;2434;7680;266;958;1862;5867;2128;6825
310220;201505;1055;3276;986;3163;187;670;573;1788;760;2458
310230;201505;2653;8358;2217;7406;503;1979;1001;3118;1504;5097
310240;201505;1055;3671;908;3407;148;636;470;1824;618;2460
310250;201505;869;2928;839;2875;156;651;506;1628;662;2279
310260;201505;3379;10719;2726;9391;714;2785;869;2776;1583;5561
310270;201505;2510;7326;2174;6830;160;551;1747;5531;1907;6082
310280;201505;2276;6209;1940;5709;332;1198;1054;2956;1386;4154
310285;201505;2093;7470;1958;7265;218;887;1535;5794;1753;6681
310290;201505;1277;3897;1187;3765;310;1124;589;1702;899;2826
310300;201505;1789;6056;1690;5864;448;1758;929;3125;1377;4883
310310;201505;380;1032;269;811;40;125;132;396;172;521
310320;201505;390;1256;327;1129;53;240;152;503;205;743
310330;201505;505;1264;354;990;29;100;163;403;192;503
310340;201505;8481;25650;7051;23219;1365;4711;3787;12857;5152;17568
310350;201505;14597;39294;10624;32566;2850;9749;2983;8848;5833;18597
310360;201505;433;1325;413;1298;43;171;304;916;347;1087
310370;201505;1448;4936;1371;4809;385;1383;730;2596;1115;3979
310375;201505;1362;3615;889;2782;133;484;356;1073;489;1557
310380;201505;382;1035;282;887;98;341;102;290;200;631
310390;201505;513;1827;441;1670;116;488;72;226;188;714
310400;201505;10359;29423;7841;24974;1986;6929;1990;6264;3976;13193
310410;201505;838;2748;556;2248;153;676;108;425;261;1101
310420;201505;5967;17003;3719;12072;702;2530;587;1681;1289;4211
310430;201505;1496;4975;1178;4324;329;1340;245;857;574;2197
310440;201505;555;1590;447;1412;93;351;190;561;283;912
310445;201505;1268;4116;1049;3708;158;600;640;2260;798;2860
310450;201505;4733;13398;3825;12112;592;2000;2528;8176;3120;10176
310460;201505;1633;5075;1386;4675;410;1509;293;1042;703;2551
310470;201505;3517;8916;2960;8224;270;735;2443;6883;2713;7618
310480;201505;1224;3618;948;3074;212;826;409;1213;621;2039
310490;201505;2970;9760;2569;8972;704;2780;1012;3452;1716;6232
310500;201505;1317;4479;1188;4201;291;1165;497;1701;788;2866
310510;201505;2250;7102;1791;6074;492;1815;346;1110;838;2925
310520;201505;1424;3759;1121;3273;87;268;731;2135;818;2403
310530;201505;904;2801;529;1813;79;285;75;233;154;518
310540;201505;3195;10478;2915;10012;811;2945;1276;4403;2087;7348
310550;201505;1230;3575;1001;3189;249;969;453;1310;702;2279
310560;201505;15757;48195;13283;43351;3747;13723;4190;12786;7937;26509
310570;201505;1214;3635;1063;3394;158;578;756;2372;914;2950
310590;201505;4296;12525;3418;10858;587;2088;1413;4284;2000;6372
310600;201505;1447;4830;1309;4533;373;1494;458;1441;831;2935
310610;201505;491;1655;437;1538;105;470;147;449;252;919
310620;201505;174044;533958;143438;474494;35230;131952;54471;170124;89701;302076
310630;201505;4002;12337;3720;11862;466;1731;2692;8457;3158;10188
310640;201505;1360;4087;1069;3563;342;1237;266;819;608;2056
310650;201505;2741;8814;2216;7908;373;1462;1269;4576;1642;6038
310660;201505;1395;4192;1209;3933;150;505;863;2791;1013;3296
310665;201505;1269;3901;1133;3708;143;501;833;2787;976;3288
310670;201505;47417;146479;42524;136114;11102;38236;16376;50743;27478;88979
310680;201505;715;2072;645;1967;142;470;358;1065;500;1535
310690;201505;1389;4527;1124;4046;297;1238;338;1125;635;2363
310700;201505;583;1507;452;1327;127;429;226;623;353;1052
310710;201505;6618;21575;5165;19128;1231;5379;1117;3787;2348;9166
310720;201505;783;2375;705;2235;155;566;365;1101;520;1667
310730;201505;9447;29476;8378;27692;1614;5879;5060;16670;6674;22549
310740;201505;4923;15877;3983;14023;1111;4368;973;3269;2084;7637
310750;201505;1561;3889;1202;3431;163;478;832;2369;995;2847
310760;201505;630;1886;521;1711;117;415;206;672;323;1087
310770;201505;827;2611;645;2324;155;634;264;869;419;1503
310780;201505;3818;10616;3255;9623;549;1630;1972;5833;2521;7463
310790;201505;1930;6140;1730;5784;452;1590;798;2761;1250;4351
310800;201505;2824;8904;2157;7601;709;2863;241;788;950;3651
310810;201505;1290;3607;1156;3378;210;679;629;1766;839;2445
310820;201505;1370;3922;1015;3264;236;863;295;898;531;1761
310825;201505;2500;8380;1975;7444;132;688;1443;5345;1575;6033
310830;201505;1389;4526;1087;3914;324;1237;281;953;605;2190
310840;201505;2221;6888;1807;6172;594;2251;510;1633;1104;3884
310850;201505;1558;4622;1290;4275;182;680;936;3094;1118;3774
310855;201505;2917;9266;2515;8641;470;1754;1582;5498;2052;7252
310860;201505;7784;23872;6603;21807;1011;3582;3808;12794;4819;16376
310870;201505;1005;2798;807;2476;154;513;421;1278;575;1791
310880;201505;1240;3767;935;3194;175;715;459;1537;634;2252
310890;201505;2737;8374;2132;7329;536;2107;570;1786;1106;3893
310900;201505;4037;12924;3245;11224;819;3193;1057;3340;1876;6533
310910;201505;2080;5905;1381;4564;310;1161;265;786;575;1947
310920;201505;1918;5731;1528;5161;360;1368;691;2323;1051;3691
310925;201505;903;2968;811;2805;312;1189;295;987;607;2176
310930;201505;5958;17062;4765;15271;871;2996;2727;8951;3598;11947
310940;201505;6366;18220;5317;16600;987;3283;2883;8999;3870;12282
310945;201505;1337;3718;1095;3383;182;678;667;1971;849;2649
310950;201505;2011;6415;1506;5301;425;1735;392;1214;817;2949
310960;201505;414;1347;339;1207;104;401;113;405;217;806
310970;201505;1478;4976;1066;3982;306;1281;139;437;445;1718
310980;201505;510;1247;316;914;41;149;145;363;186;512
310990;201505;1167;3890;985;3508;250;998;289;940;539;1938
311000;201505;3655;12413;3246;11571;900;3692;1149;3802;2049;7494
311010;201505;773;2563;719;2467;226;846;327;1077;553;1923
311020;201505;948;2857;762;2528;173;651;313;969;486;1620
311030;201505;1701;4784;1220;3870;307;1106;418;1188;725;2294
311040;201505;489;1650;428;1492;94;345;98;327;192;672
311050;201505;2278;7216;1982;6712;536;2014;861;2923;1397;4937
311060;201505;2216;6705;1685;5556;372;1382;434;1324;806;2706
311070;201505;1482;5168;1298;4818;335;1445;494;1801;829;3246
311080;201505;899;2676;800;2502;129;443;477;1446;606;1889
311090;201505;1581;5846;1332;5327;437;1961;254;977;691;2938
311100;201505;2212;7480;1847;6704;722;2843;370;1306;1092;4149
311110;201505;3977;9305;2727;7551;434;1322;1460;3989;1894;5311
311115;201505;1206;3559;1020;3282;113;469;673;2122;786;2591
311120;201505;8021;22601;6224;19401;1593;5567;1650;4708;3243;10275
311130;201505;2110;6630;1783;6169;443;1855;789;2567;1232;4422
311140;201505;1390;3743;1137;3423;126;454;811;2400;937;2854
311150;201505;1948;6565;1787;6306;339;1308;1048;3716;1387;5024
311160;201505;4861;16312;4085;14912;1474;5867;1180;4208;2654;10075
311170;201505;785;2395;621;2091;82;286;310;1091;392;1377
311180;201505;1481;4160;1111;3448;333;1124;256;724;589;1848
311190;201505;1054;3155;896;2842;200;736;300;852;500;1588
311200;201505;2181;6652;1796;5851;546;1979;398;1143;944;3122
311205;201505;1086;3558;932;3250;190;759;393;1370;583;2129
311210;201505;957;3089;884;2981;165;554;611;2131;776;2685
311220;201505;902;2839;728;2465;179;650;255;846;434;1496
311230;201505;8381;25934;6829;22992;1325;4839;3059;10584;4384;15423
311240;201505;1173;3536;944;3163;255;973;312;992;567;1965
311250;201505;910;2962;809;2807;235;937;267;785;502;1722
311260;201505;2779;7420;2069;6238;543;1817;684;2008;1227;3825
311265;201505;1339;3669;1045;3203;181;656;595;1795;776;2451
311270;201505;3426;10920;2982;10312;408;1772;2058;6904;2466;8676
311280;201505;1319;3625;890;2775;189;681;269;795;458;1476
311290;201505;2122;7061;1974;6750;427;1470;1126;3926;1553;5396
311300;201505;4612;15295;4117;14439;543;2195;2824;9970;3367;12165
311310;201505;539;1865;490;1776;101;438;204;692;305;1130
311320;201505;4123;13674;3632;12602;773;3088;1283;4197;2056;7285
311330;201505;4975;14913;4283;13801;1291;4644;1755;5593;3046;10237
311340;201505;12458;39386;10979;36573;3299;11919;3280;10819;6579;22738
311350;201505;2280;6611;1823;5747;358;1347;825;2398;1183;3745
311360;201505;1223;3371;936;3002;400;1370;203;638;603;2008
311370;201505;3912;11782;3327;10769;761;3001;1453;4287;2214;7288
311380;201505;459;1474;383;1339;112;447;127;436;239;883
311390;201505;1857;6766;1716;6549;714;3114;547;1950;1261;5064
311400;201505;1497;4773;1284;4372;268;1087;581;1799;849;2886
311410;201505;1825;6325;1658;6107;458;1849;880;3308;1338;5157
311420;201505;2038;6632;1477;5278;371;1443;272;755;643;2198
311430;201505;4019;12078;2775;9315;529;1941;351;1078;880;3019
311440;201505;2374;7678;1788;6558;613;2645;344;1193;957;3838
311450;201505;2043;7051;1719;6304;486;1975;395;1324;881;3299
311455;201505;1289;3436;1056;3065;229;740;565;1542;794;2282
311460;201505;698;2254;537;1927;118;523;126;413;244;936
311470;201505;558;1772;445;1537;112;482;138;427;250;909
311480;201505;784;2080;732;2013;178;470;428;1171;606;1641
311490;201505;260;992;234;918;73;304;83;312;156;616
311500;201505;474;1380;377;1197;93;333;169;531;262;864
311510;201505;3131;9653;2541;8527;869;3445;592;1812;1461;5257
311520;201505;644;2146;594;2039;214;796;216;710;430;1506
311530;201505;12128;31351;8479;25253;2016;7207;2396;6883;4412;14090
311535;201505;835;2428;554;1865;121;475;87;275;208;750
311540;201505;647;2258;609;2205;230;866;279;987;509;1853
311545;201505;2116;6610;1936;6385;219;862;1434;4704;1653;5566
311547;201505;1560;4360;1297;3946;104;355;868;2646;972;3001
311550;201505;3005;9618;2538;8675;577;2253;859;2865;1436;5118
311560;201505;262;669;219;614;37;118;128;339;165;457
311570;201505;2225;5534;1740;4924;114;329;1375;3998;1489;4327
311580;201505;2363;4963;1845;4362;558;1249;983;2455;1541;3704
311590;201505;447;1390;386;1304;106;414;131;433;237;847
311600;201505;1214;3674;1039;3438;200;660;653;2228;853;2888
311610;201505;3121;10919;2806;10360;915;3345;1246;4867;2161;8212
311615;201505;3083;9499;2565;8673;283;1129;1784;6047;2067;7176
311620;201505;443;1385;393;1306;89;330;228;747;317;1077
311630;201505;1432;4171;1189;3744;261;799;662;2133;923;2932
311640;201505;839;2640;693;2391;131;503;396;1333;527;1836
311650;201505;2292;6748;1936;6168;254;866;1147;3776;1401;4642
311660;201505;2479;8285;2007;7213;423;1693;279;826;702;2519
311670;201505;1553;4642;1289;4180;443;1587;475;1519;918;3106
311680;201505;2111;6684;1806;6200;421;1516;994;3458;1415;4974
311690;201505;562;1437;453;1307;53;173;348;994;401;1167
311700;201505;2257;6160;1891;5660;130;531;1510;4399;1640;4930
311710;201505;1717;5168;1259;4311;471;1817;340;1110;811;2927
311720;201505;397;1325;354;1238;65;254;173;584;238;838
311730;201505;5748;14561;3375;10334;954;3435;981;2436;1935;5871
311740;201505;940;2649;805;2487;295;889;423;1354;718;2243
311750;201505;4022;13138;3493;12305;649;2605;1990;6920;2639;9525
311760;201505;805;2694;749;2577;199;805;319;977;518;1782
311770;201505;2455;7679;2004;6849;489;1878;609;1969;1098;3847
311780;201505;1138;4105;959;3681;303;1318;220;784;523;2102
311783;201505;1966;6428;1662;5845;105;492;1239;4337;1344;4829
311787;201505;562;1939;416;1508;76;306;91;266;167;572
311790;201505;1479;4403;1085;3629;268;998;302;944;570;1942
311800;201505;4137;13989;3241;11462;614;2284;195;570;809;2854
311810;201505;1058;3548;994;3431;40;200;829;2839;869;3039
311820;201505;663;2120;544;1828;151;566;259;815;410;1381
311830;201505;8105;27421;6717;24018;2320;8970;925;2995;3245;11965
311840;201505;3205;9559;2790;8957;790;2891;1282;3982;2072;6873
311850;201505;305;897;261;826;68;236;118;365;186;601
311860;201505;50242;149664;42875;136401;10052;35354;19661;60324;29713;95678
311870;201505;2310;6757;1755;5703;377;1443;570;1667;947;3110
311880;201505;6943;20257;6184;19345;872;2616;4385;14301;5257;16917
311890;201505;1471;4463;1203;3924;297;1079;475;1487;772;2566
311900;201505;769;2395;687;2290;121;407;436;1533;557;1940
311910;201505;4527;13295;3725;12154;939;3372;1612;5243;2551;8615
311920;201505;1942;6392;1700;5980;177;716;1155;4067;1332;4783
311930;201505;3836;11090;3276;10210;1200;3966;1010;3085;2210;7051
311940;201505;12006;36358;9834;31943;2791;9964;2049;6227;4840;16191
311950;201505;2327;6778;1924;6225;162;594;1397;4474;1559;5068
311960;201505;372;1150;332;1067;74;301;164;451;238;752
311970;201505;395;1352;326;1207;78;336;74;264;152;600
311980;201505;660;1829;446;1446;67;234;180;581;247;815
311990;201505;453;1323;376;1199;137;481;130;380;267;861
311995;201505;1162;3525;720;2445;78;289;98;244;176;533
312000;201505;665;2020;599;1918;87;314;373;1190;460;1504
312010;201505;964;3150;833;2861;153;601;363;1220;516;1821
312015;201505;1495;4706;1294;4363;156;647;828;2763;984;3410
312020;201505;897;2807;774;2611;164;622;410;1393;574;2015
312030;201505;1784;5297;1612;5084;126;464;1315;4102;1441;4566
312040;201505;719;2684;622;2416;173;759;133;484;306;1243
312050;201505;1471;5065;1274;4649;356;1461;245;824;601;2285
312060;201505;755;2291;662;2159;294;1027;205;602;499;1629
312070;201505;1041;3204;684;2425;164;627;239;837;403;1464
312080;201505;2629;7355;2073;6475;355;1331;1054;3057;1409;4388
312083;201505;976;2758;835;2552;127;450;524;1566;651;2016
312087;201505;2215;6792;1955;6411;256;902;1392;4656;1648;5558
312090;201505;9063;28392;7981;26545;2292;8286;3282;10657;5574;18943
312100;201505;1391;4654;1175;4314;256;1048;589;2176;845;3224
312110;201505;1135;3966;986;3639;324;1368;185;600;509;1968
312120;201505;752;2506;655;2310;161;679;219;663;380;1342
312125;201505;1176;3724;1045;3479;233;818;541;1855;774;2673
312130;201505;798;2336;623;1982;97;356;259;778;356;1134
312140;201505;988;3116;810;2697;163;609;263;750;426;1359
312150;201505;579;1638;488;1442;34;117;332;950;366;1067
312160;201505;7621;25942;6846;24347;1933;7571;2543;8944;4476;16515
312170;201505;990;2882;868;2663;102;334;540;1662;642;1996
312180;201505;1426;4332;1252;3999;290;1000;506;1544;796;2544
312190;201505;631;2006;472;1687;165;657;88;290;253;947
312200;201505;4908;14231;4206;13162;484;1609;2979;9328;3463;10937
312210;201505;1059;2888;815;2512;212;726;333;967;545;1693
312220;201505;1860;6224;1685;6023;160;604;1378;5084;1538;5688
312230;201505;13593;42356;10635;36547;3918;14856;1838;6114;5756;20970
312235;201505;1770;5099;1473;4658;160;634;986;3084;1146;3718
312240;201505;968;3195;792;2826;191;760;248;821;439;1581
312245;201505;2301;6786;1992;6384;113;364;1651;5339;1764;5703
312247;201505;835;2522;659;2210;170;640;315;1066;485;1706
312250;201505;1205;3359;949;2929;178;648;412;1214;590;1862
312260;201505;940;2966;783;2725;147;597;477;1625;624;2222
312270;201505;689;2071;567;1840;93;397;253;729;346;1126
312280;201505;405;1375;361;1277;135;514;53;172;188;686
312290;201505;753;2481;696;2395;223;902;211;695;434;1597
312300;201505;957;3173;770;2735;180;720;98;269;278;989
312310;201505;925;3473;854;3305;243;1033;344;1289;587;2322
312320;201505;2192;6213;1698;5219;419;1412;369;894;788;2306
312330;201505;1008;2994;844;2751;147;564;588;1889;735;2453
312340;201505;314;816;278;769;34;135;219;567;253;702
312350;201505;338;851;306;814;31;94;256;664;287;758
312352;201505;1689;5404;1522;5135;416;1405;878;3077;1294;4482
312360;201505;2820;9164;2333;8141;547;2143;711;2407;1258;4550
312370;201505;1759;5605;1595;5344;580;2180;509;1582;1089;3762
312380;201505;1891;5419;1683;5117;135;427;1359;4217;1494;4644
312385;201505;1301;3885;1133;3611;129;537;794;2436;923;2973
312390;201505;2109;6885;1706;6005;492;1835;307;993;799;2828
312400;201505;3341;10738;2835;9777;1016;3654;908;3251;1924;6905
312410;201505;10437;34315;9325;32198;2334;8932;3787;12756;6121;21688
312420;201505;4034;12437;3816;12178;540;1713;2815;9222;3355;10935
312430;201505;7479;22848;6783;21693;1152;3760;4448;14460;5600;18220
312440;201505;698;2231;622;2101;138;509;327;1151;465;1660
312450;201505;1146;3885;927;3420;352;1368;305;1119;657;2487
312460;201505;377;1136;337;1090;90;327;166;525;256;852
312470;201505;710;1932;455;1431;92;328;135;397;227;725
312480;201505;1263;3513;1005;3220;267;955;517;1583;784;2538
312490;201505;2093;5497;1636;4828;253;837;916;2585;1169;3422
312500;201505;684;2134;611;2026;114;476;333;1078;447;1554
312510;201505;3099;9152;2423;7748;431;1597;1149;3404;1580;5001
312520;201505;285;978;231;873;66;265;78;301;144;566
312530;201505;607;1834;544;1743;83;343;346;1048;429;1391
312540;201505;1475;4625;1152;3988;249;924;568;1945;817;2869
312550;201505;692;2135;597;1927;133;443;261;794;394;1237
312560;201505;2058;5545;1752;5148;132;448;1405;4112;1537;4560
312570;201505;2635;7795;2199;7033;649;2223;645;1980;1294;4203
312580;201505;543;1788;449;1595;86;391;166;548;252;939
312590;201505;1808;6005;1577;5529;370;1512;608;1960;978;3472
312595;201505;2091;7025;1864;6495;480;1790;906;3117;1386;4907
312600;201505;781;2554;619;2240;118;546;315;1040;433;1586
312610;201505;7296;20797;5474;17483;1363;4904;1339;3956;2702;8860
312620;201505;2045;6010;1610;5417;132;493;1250;4303;1382;4796
312630;201505;372;1212;329;1131;79;310;158;527;237;837
312640;201505;570;1826;457;1595;97;394;164;511;261;905
312650;201505;2207;6506;1591;5282;172;635;925;3057;1097;3692
312660;201505;1390;3724;1132;3357;120;417;773;2266;893;2683
312670;201505;5870;17644;5035;16464;1311;4816;2118;6708;3429;11524
312675;201505;1366;4358;1138;3889;160;631;674;2254;834;2885
312680;201505;1500;4670;1320;4405;213;809;813;2630;1026;3439
312690;201505;2220;5901;1780;5284;342;1133;1006;2865;1348;3998
312695;201505;830;3019;796;2975;149;548;545;2114;694;2662
312700;201505;1954;5770;1518;4901;212;773;771;2445;983;3218
312705;201505;1366;3845;1142;3478;126;418;795;2410;921;2828
312707;201505;1729;5300;1358;4598;199;782;707;2315;906;3097
312710;201505;7096;18638;4728;14588;1300;4605;1032;2899;2332;7504
312720;201505;764;2591;661;2370;159;637;242;806;401;1443
312730;201505;1988;4828;1431;4169;208;706;800;2330;1008;3036
312733;201505;1682;4486;1271;3719;89;341;871;2439;960;2780
312735;201505;892;2533;777;2376;206;705;422;1245;628;1950
312737;201505;910;2288;654;1929;219;640;266;815;485;1455
312738;201505;554;1670;404;1362;108;423;132;404;240;827
312740;201505;462;1276;306;1081;94;372;80;285;174;657
312750;201505;1258;4513;1201;4402;270;1186;592;2079;862;3265
312760;201505;2203;7013;1695;6008;432;1720;384;1328;816;3048
312770;201505;41600;115206;32961;100911;8852;29569;9947;29610;18799;59179
312780;201505;2752;9645;2465;9168;461;1882;1387;5297;1848;7179
312790;201505;339;874;199;626;51;200;50;115;101;315
312800;201505;5171;17007;4280;15196;1363;5249;1201;4270;2564;9519
312810;201505;2182;6667;1529;5404;408;1574;281;918;689;2492
312820;201505;2055;5955;1844;5618;161;596;1235;3665;1396;4261
312825;201505;1366;3718;1189;3497;98;302;952;2803;1050;3105
312830;201505;2739;8544;1914;6851;493;1938;342;1190;835;3128
312840;201505;1209;3899;1025;3562;134;594;563;1875;697;2469
312850;201505;647;2089;528;1862;94;406;189;643;283;1049
312860;201505;1146;3367;902;2936;235;905;259;722;494;1627
312870;201505;5509;17044;3959;13901;863;3405;960;3234;1823;6639
312880;201505;1312;3916;1134;3624;175;623;658;2125;833;2748
312890;201505;1605;4810;1087;3680;319;1214;355;1170;674;2384
312900;201505;1272;3813;1131;3621;197;667;776;2536;973;3203
312910;201505;1607;3324;1045;2602;190;570;560;1272;750;1842
312920;201505;873;2782;744;2581;197;795;357;1188;554;1983
312930;201505;2268;6582;1963;6142;451;1460;998;3230;1449;4690
312940;201505;924;3018;806;2818;237;957;217;710;454;1667
312950;201505;3335;9305;2591;8204;879;3010;766;2383;1645;5393
312960;201505;2018;5879;1763;5551;272;835;1286;4172;1558;5007
312965;201505;1788;5717;1516;5222;240;911;894;3123;1134;4034
312970;201505;997;3385;829;3118;299;1305;146;486;445;1791
312980;201505;17248;58372;16191;56082;5180;19756;6383;21053;11563;40809
312990;201505;437;1332;332;1153;111;435;109;373;220;808
313000;201505;533;1765;432;1564;118;546;161;509;279;1055
313005;201505;2618;8416;2299;7846;455;1577;1310;4543;1765;6120
313010;201505;3759;12016;3202;11068;871;3354;1370;4629;2241;7983
313020;201505;956;3134;812;2840;217;886;240;719;457;1605
313030;201505;1491;4028;1106;3502;248;944;502;1513;750;2457
313040;201505;868;2928;744;2598;142;575;285;923;427;1498
313050;201505;1826;5839;1466;5300;430;1749;503;1707;933;3456
313055;201505;1605;5210;1465;5018;138;506;1115;3876;1253;4382
313060;201505;642;2100;512;1772;166;593;60;200;226;793
313065;201505;1952;6362;1683;5936;288;1147;1194;4202;1482;5349
313070;201505;1154;3350;941;2971;223;815;438;1284;661;2099
313080;201505;484;1519;388;1331;90;370;131;386;221;756
313090;201505;5383;15542;4685;14457;837;2732;2972;9304;3809;12036
313100;201505;1109;3455;1009;3294;102;344;777;2561;879;2905
313110;201505;1746;4957;1299;4094;275;983;515;1490;790;2473
313115;201505;2507;8519;2385;8274;589;2344;1177;3818;1766;6162
313120;201505;3569;9704;3037;8993;848;2764;1648;4693;2496;7457
313130;201505;23842;72270;20427;65224;5035;17765;7632;22921;12667;40686
313140;201505;706;1824;539;1575;39;142;365;1049;404;1191
313150;201505;1478;4672;1267;4278;512;1866;321;1065;833;2931
313160;201505;1062;3197;929;2955;162;613;557;1719;719;2332
313170;201505;7914;27416;6567;24201;1838;7326;1331;4731;3169;12057
313180;201505;2479;6732;1957;6000;544;1852;714;2109;1258;3961
313190;201505;3081;10892;2556;9467;578;2395;783;2705;1361;5100
313200;201505;1294;4215;1144;3951;161;643;788;2693;949;3336
313210;201505;4522;13797;3742;12713;861;3334;1806;5892;2667;9226
313220;201505;1325;3991;969;3210;254;956;231;658;485;1614
313230;201505;2324;8321;2146;8057;333;1348;1458;5499;1791;6847
313240;201505;7857;24646;6368;22019;1497;5952;2528;8446;4025;14398
313250;201505;7205;22593;6384;21232;1003;3473;3811;12883;4814;16356
313260;201505;625;1855;469;1543;82;315;118;350;200;665
313270;201505;5482;16219;4680;14906;824;2839;2797;8893;3621;11732
313280;201505;438;1447;333;1207;56;246;88;273;144;519
313290;201505;930;3255;766;2951;246;1047;147;490;393;1537
313300;201505;1906;6403;1586;5625;465;1802;249;771;714;2573
313310;201505;1138;3936;1007;3661;256;1054;192;625;448;1679
313320;201505;2476;7219;1910;6298;375;1372;839;2762;1214;4134
313330;201505;3824;12162;3214;11056;590;2324;1738;5884;2328;8208
313340;201505;2052;4963;1585;4287;313;867;884;2355;1197;3222
313350;201505;3260;10049;2529;8497;573;2154;486;1447;1059;3601
313360;201505;1245;3650;938;3135;259;1023;452;1404;711;2427
313370;201505;1200;4076;1116;3845;175;739;591;1894;766;2633
313375;201505;2233;5837;1507;4753;303;1193;519;1582;822;2775
313380;201505;5037;15975;4169;14182;1115;4242;1409;4508;2524;8750
313390;201505;902;3167;862;3114;103;430;590;2119;693;2549
313400;201505;3685;10286;3319;9871;255;756;2802;8494;3057;9250
313410;201505;1272;3617;1064;3324;220;777;613;1889;833;2666
313420;201505;20309;48306;12362;34797;2457;7808;2483;6646;4940;14454
313430;201505;1120;3481;869;2957;184;742;346;1092;530;1834
313440;201505;6356;14469;4341;12116;351;1079;2988;8352;3339;9431
313450;201505;684;2004;545;1725;123;481;190;538;313;1019
313460;201505;2285;7873;2013;7414;580;2411;597;2049;1177;4460
313470;201505;3261;9111;3035;8853;305;798;2514;7482;2819;8280
313480;201505;1121;3211;866;2775;140;531;365;1091;505;1622
313490;201505;1521;4653;969;3717;346;1422;143;534;489;1956
313500;201505;404;1257;368;1179;70;264;179;539;249;803
313505;201505;9001;26965;8334;26199;350;694;7694;24862;8044;25556
313507;201505;1382;3891;1204;3649;182;632;786;2399;968;3031
313510;201505;15541;44716;13530;41907;2195;6962;8452;26900;10647;33862
313520;201505;15198;45950;12556;41442;1619;6176;7991;26037;9610;32213
313530;201505;631;2012;513;1790;66;274;175;564;241;838
313535;201505;2548;7567;2231;7021;216;741;1606;4999;1822;5740
313540;201505;1070;3359;819;2714;230;834;199;593;429;1427
313545;201505;1295;4769;1169;4503;160;796;734;2673;894;3469
313550;201505;1879;6053;1662;5625;434;1557;791;2600;1225;4157
313560;201505;2226;5408;1885;5026;284;704;1371;3795;1655;4499
313570;201505;834;3002;728;2803;254;1050;267;996;521;2046
313580;201505;5980;16933;4946;15513;807;2737;3185;10090;3992;12827
313590;201505;1033;2935;798;2639;405;1454;214;679;619;2133
313600;201505;4031;12154;3499;11330;548;1965;2223;7265;2771;9230
313610;201505;1040;3186;887;2886;188;670;414;1325;602;1995
313620;201505;6032;18865;5249;17473;1554;5592;1820;5923;3374;11515
313630;201505;8185;23501;6370;20777;1335;4956;2809;9489;4144;14445
313640;201505;827;2460;642;2171;197;750;207;671;404;1421
313650;201505;2118;6881;1852;6450;270;1070;1255;4315;1525;5385
313652;201505;1008;3603;924;3444;159;652;562;2088;721;2740
313655;201505;950;3095;793;2827;137;595;467;1610;604;2205
313657;201505;1292;3975;1103;3684;128;583;798;2446;926;3029
313660;201505;866;2870;786;2729;172;710;380;1240;552;1950
313665;201505;3395;11116;3090;10468;686;2664;1476;4798;2162;7462
313670;201505;51328;144344;35078;116449;9383;34505;10297;33343;19680;67848
313680;201505;1107;3336;962;3107;152;536;630;2010;782;2546
313690;201505;895;3223;793;2993;221;880;293;1111;514;1991
313695;201505;1360;4492;1180;4165;131;508;817;2924;948;3432
313700;201505;3828;12679;3209;11867;540;2082;2156;8176;2696;10258
313710;201505;1301;3555;1022;3136;242;801;502;1499;744;2300
313720;201505;5229;17062;4273;14977;915;3623;1391;4479;2306;8102
313730;201505;1346;3567;1005;3142;198;683;547;1697;745;2380
313740;201505;2141;7672;1799;6838;556;2401;191;636;747;3037
313750;201505;2434;7370;2056;6661;581;2064;655;1959;1236;4023
313753;201505;1841;5435;1469;4793;399;1456;552;1755;951;3211
313760;201505;4467;14447;3698;12911;1082;4166;1028;3336;2110;7502
313770;201505;3470;11447;3167;10903;1008;3756;1192;3955;2200;7711
313780;201505;3715;10314;2915;9119;511;1933;1344;4128;1855;6061
313790;201505;512;1752;488;1713;107;372;270;988;377;1360
313800;201505;1206;3349;1048;3105;134;455;687;2037;821;2492
313810;201505;1511;4437;1463;4371;80;231;1275;3890;1355;4121
313820;201505;13202;35303;10769;31448;1844;6414;5338;15074;7182;21488
313830;201505;420;1400;359;1272;97;398;113;390;210;788
313835;201505;925;3085;865;2998;170;660;512;1718;682;2378
313840;201505;7775;22341;6074;19439;1596;5703;1652;5122;3248;10825
313850;201505;1247;3405;1091;3133;240;829;559;1485;799;2314
313860;201505;2849;8609;2216;7238;552;1985;507;1558;1059;3543
313862;201505;1223;3073;806;2377;133;394;343;1037;476;1431
313865;201505;2280;7051;2064;6720;244;904;1492;4831;1736;5735
313867;201505;1116;3789;955;3464;330;1286;322;1198;652;2484
313868;201505;1607;5601;1406;5183;146;658;948;3461;1094;4119
313870;201505;861;2711;778;2574;232;896;242;689;474;1585
313880;201505;1656;5117;1472;4896;270;1106;911;2863;1181;3969
313890;201505;1888;5185;1578;4765;243;729;1044;3266;1287;3995
313900;201505;4218;15353;3829;14470;1218;5229;1164;4212;2382;9441
313910;201505;775;2609;659;2373;245;963;101;335;346;1298
313920;201505;3500;11449;3032;10613;483;1803;1840;6604;2323;8407
313925;201505;1921;5147;1390;4147;97;321;901;2685;998;3006
313930;201505;5316;17382;4389;15730;775;2968;2413;8860;3188;11828
313940;201505;8367;28012;7036;25876;2242;9089;2412;9207;4654;18296
313950;201505;4222;12125;3371;10733;1013;3757;1161;3300;2174;7057
313960;201505;5821;15105;4293;13001;1336;4492;1170;3312;2506;7804
313970;201505;1455;4185;1249;3947;151;529;824;2709;975;3238
313980;201505;1272;4012;1006;3540;285;1163;382;1329;667;2492
313990;201505;1892;7072;1634;6462;539;2360;383;1372;922;3732
314000;201505;7659;25064;6985;23795;1433;5859;4089;13354;5522;19213
314010;201505;1112;3178;921;2940;120;463;596;1855;716;2318
314015;201505;1271;4566;1125;4272;339;1395;384;1418;723;2813
314020;201505;526;1630;407;1378;105;406;101;313;206;719
314030;201505;871;2808;686;2393;111;441;250;851;361;1292
314040;201505;674;1915;560;1713;269;833;157;496;426;1329
314050;201505;1823;5669;1447;4908;353;1379;480;1475;833;2854
314053;201505;1531;4928;1386;4751;189;631;969;3480;1158;4111
314055;201505;2138;6493;1937;6198;106;417;1535;4969;1641;5386
314060;201505;1155;3558;919;3145;84;355;576;1941;660;2296
314070;201505;3877;11994;2987;10297;808;3026;716;2353;1524;5379
314080;201505;1899;5862;1261;4358;242;949;273;817;515;1766
314085;201505;1979;6665;1719;6308;493;2001;661;2398;1154;4399
314090;201505;3423;11651;3016;10874;847;3386;1120;4106;1967;7492
314100;201505;3432;8949;2911;8240;251;640;2378;6920;2629;7560
314110;201505;4300;13694;3766;12609;787;3091;1523;4679;2310;7770
314120;201505;1027;2498;536;1700;132;472;138;426;270;898
314130;201505;716;2053;379;1297;61;227;73;246;134;473
314140;201505;5039;15627;4265;14152;926;3307;1851;6097;2777;9404
314150;201505;1643;4490;1341;3985;235;807;689;2008;924;2815
314160;201505;2525;6623;1993;5925;175;579;1444;4475;1619;5054
314170;201505;1108;3350;908;2914;127;481;487;1499;614;1980
314180;201505;5790;18268;5022;17136;1285;4834;2310;8024;3595;12858
314190;201505;748;2176;598;1938;141;563;247;739;388;1302
314200;201505;3015;9521;2638;8838;324;1317;1780;5825;2104;7142
314210;201505;1974;5871;1758;5490;238;886;1111;3316;1349;4202
314220;201505;1729;5455;1368;4741;429;1678;287;854;716;2532
314225;201505;1317;3862;1164;3657;74;230;1001;3196;1075;3426
314230;201505;662;2217;602;2107;146;572;252;849;398;1421
314240;201505;1156;3570;981;3311;155;510;632;2246;787;2756
314250;201505;557;1667;426;1393;98;378;145;412;243;790
314260;201505;1110;3948;1014;3742;292;1181;347;1232;639;2413
314270;201505;2911;9545;2508;8829;268;1071;1721;6120;1989;7191
314280;201505;3243;9044;2213;7059;565;2102;694;1918;1259;4020
314290;201505;5029;13903;4318;12767;1131;3589;2381;6927;3512;10516
314300;201505;1661;5521;1451;5050;413;1538;503;1675;916;3213
314310;201505;5577;16903;4768;15349;1456;5122;1518;4643;2974;9765
314315;201505;899;3487;831;3357;130;621;516;2098;646;2719
314320;201505;3172;8807;2340;7720;655;2422;1157;3851;1812;6273
314330;201505;53350;163498;47309;153820;13452;47822;18573;59548;32025;107370
314340;201505;2767;7617;1565;5203;358;1283;121;254;479;1537
314345;201505;1244;4234;1113;4026;295;1125;625;2276;920;3401
314350;201505;1406;4077;1126;3628;429;1532;299;917;728;2449
314360;201505;708;2210;467;1658;95;407;114;384;209;791
314370;201505;530;1857;490;1792;150;595;262;950;412;1545
314380;201505;1268;3800;878;3033;239;900;151;513;390;1413
314390;201505;14794;42833;11274;36244;2851;10046;2932;8711;5783;18757
314400;201505;4756;13834;3967;12725;1416;4736;1569;5204;2985;9940
314410;201505;2631;8296;2225;7484;630;2466;776;2425;1406;4891
314420;201505;755;2193;603;1979;58;265;424;1336;482;1601
314430;201505;6945;20679;6055;18984;1805;6220;1851;5817;3656;12037
314435;201505;1360;4355;1204;4082;134;582;754;2513;888;3095
314437;201505;1137;2949;967;2703;41;116;810;2265;851;2381
314440;201505;669;1947;504;1705;177;670;88;268;265;938
314450;201505;1601;4668;1353;4319;381;1437;639;1907;1020;3344
314460;201505;4408;14820;3631;13177;964;3894;700;2418;1664;6312
314465;201505;2367;7428;2166;7101;146;622;1673;5381;1819;6003
314467;201505;1106;3090;922;2763;105;302;619;1889;724;2191
314470;201505;2451;7847;1965;6770;458;1850;523;1565;981;3415
314480;201505;6264;20799;4323;15634;697;2749;464;1418;1161;4167
314490;201505;994;2919;790;2516;209;737;319;964;528;1701
314500;201505;2159;6025;1585;5038;431;1473;644;1984;1075;3457
314505;201505;1883;5641;1758;5447;318;1094;1101;3424;1419;4518
314510;201505;1954;5350;1325;4451;448;1666;328;1070;776;2736
314520;201505;3380;12326;2657;10560;659;2979;397;1332;1056;4311
314530;201505;6558;23212;6178;22583;1148;4207;3715;14023;4863;18230
314535;201505;2796;7825;2411;7290;230;791;1843;5556;2073;6347
314537;201505;1250;3886;982;3413;162;677;547;1867;709;2544
314540;201505;423;1292;362;1167;88;325;119;343;207;668
314545;201505;1375;4243;1195;3977;194;753;762;2516;956;3269
314550;201505;631;1749;474;1535;92;391;199;587;291;978
314560;201505;4986;17307;4266;15542;887;3648;1205;4179;2092;7827
314570;201505;301;892;227;738;61;215;103;320;164;535
314580;201505;519;1752;415;1515;107;459;78;256;185;715
314585;201505;854;2793;611;2270;150;639;169;611;319;1250
314587;201505;1874;5850;1641;5440;353;1112;799;2764;1152;3876
314590;201505;3469;11772;2444;9023;437;1791;301;978;738;2769
314600;201505;2063;6893;1604;5986;519;2166;274;953;793;3119
314610;201505;7454;25594;6740;23951;1721;6930;2629;8770;4350;15700
314620;201505;1758;5104;1537;4822;174;499;1189;3836;1363;4335
314625;201505;1495;5101;1436;5005;175;686;1105;3799;1280;4485
314630;201505;5008;14842;4322;13765;361;1372;3245;10330;3606;11702
314640;201505;606;1671;469;1436;116;396;144;375;260;771
314650;201505;1207;3404;864;2805;167;651;333;972;500;1623
314655;201505;1627;4846;1218;4049;273;919;513;1709;786;2628
314660;201505;261;713;200;599;20;65;105;303;125;368
314670;201505;1615;4382;1267;3795;189;631;769;2306;958;2937
314675;201505;1804;5538;1539;5068;148;590;1057;3463;1205;4053
314690;201505;2543;8014;2096;7236;565;2274;548;1740;1113;4014
314700;201505;8826;31034;6799;26479;2214;9660;1224;4684;3438;14344
314710;201505;9176;28156;6384;22032;1259;4863;942;2945;2201;7808
314720;201505;2373;7791;1990;6989;499;1987;776;2671;1275;4658
314730;201505;2421;7234;1956;6565;589;2221;652;2086;1241;4307
314740;201505;2986;9604;2620;8908;607;2342;1101;3571;1708;5913
314750;201505;341;1074;291;961;46;183;146;453;192;636
314760;201505;1737;5835;1278;4696;232;989;281;889;513;1878
314770;201505;1207;3782;716;2427;74;308;112;281;186;589
314780;201505;309;816;219;698;61;235;93;285;154;520
314790;201505;12462;36934;9193;31228;3808;14776;1326;3940;5134;18716
314795;201505;1635;4746;1384;4345;134;559;1030;3090;1164;3649
314800;201505;12695;36983;9238;30130;2764;9843;1400;4329;4164;14172
314810;201505;13133;38421;10220;33336;3108;11327;2326;7523;5434;18850
314820;201505;1037;2817;698;2284;187;685;235;723;422;1408
314830;201505;1779;5860;1524;5434;497;1955;604;2174;1101;4129
314840;201505;1004;3638;821;3358;187;914;442;1771;629;2685
314850;201505;1972;5805;1603;5133;235;929;988;3043;1223;3972
314860;201505;3297;11078;2970;10529;630;2457;1690;6022;2320;8479
314870;201505;5544;17773;4885;16902;608;2448;3558;12368;4166;14816
314875;201505;1750;5868;1673;5757;332;1108;1213;4282;1545;5390
314880;201505;854;2380;739;2229;54;167;546;1707;600;1874
314890;201505;630;1891;433;1472;97;396;143;427;240;823
314900;201505;484;1480;387;1327;98;351;182;619;280;970
314910;201505;1640;5483;1351;4993;450;1881;393;1344;843;3225
314915;201505;2585;8123;2255;7644;211;862;1715;5728;1926;6590
314920;201505;599;1679;429;1421;73;287;221;678;294;965
314930;201505;5053;17003;4435;15662;1315;5105;1096;3771;2411;8876
314940;201505;404;1191;372;1135;82;275;196;565;278;840
314950;201505;339;1069;272;948;59;220;71;242;130;462
314960;201505;806;2516;625;2155;174;673;158;483;332;1156
314970;201505;520;1766;445;1633;103;435;121;427;224;862
314980;201505;1804;5577;1530;5096;477;1789;182;524;659;2313
314990;201505;2773;8736;2145;7368;636;2521;403;1161;1039;3682
314995;201505;1622;5017;1436;4733;176;697;962;3084;1138;3781
315000;201505;1068;3121;877;2803;139;531;531;1663;670;2194
315010;201505;466;1445;374;1252;101;407;136;387;237;794
315015;201505;2028;6240;1814;5984;255;861;1317;4532;1572;5393
315020;201505;807;2513;609;2076;103;402;295;970;398;1372
315030;201505;766;2295;619;2022;196;701;155;493;351;1194
315040;201505;893;2804;841;2695;152;511;530;1675;682;2186
315050;201505;1508;4350;1198;3844;286;1055;462;1426;748;2481
315053;201505;1087;3239;954;3012;177;700;442;1372;619;2072
315057;201505;1896;6369;1562;5854;287;1088;896;3504;1183;4592
315060;201505;905;2957;668;2433;163;662;149;542;312;1204
315070;201505;758;2267;662;2128;176;624;326;992;502;1616
315080;201505;3065;10399;2720;9676;630;2471;1322;4645;1952;7116
315090;201505;781;2808;693;2623;163;683;247;941;410;1624
315100;201505;1222;4122;912;3397;219;952;212;697;431;1649
315110;201505;1422;4406;1247;4065;299;1072;542;1741;841;2813
315120;201505;14556;34054;9902;28078;1620;4850;5205;15554;6825;20404
315130;201505;1510;4954;1348;4636;387;1502;411;1347;798;2849
315140;201505;2799;9235;2362;8317;621;2550;775;2431;1396;4981
315150;201505;4971;13453;3712;11351;797;2807;1394;4090;2191;6897
315160;201505;1317;3749;1110;3370;211;697;573;1672;784;2369
315170;201505;1450;4269;1207;3914;214;737;632;2233;846;2970
315180;201505;16533;47352;10095;33600;2024;7712;1884;5711;3908;13423
315190;201505;2179;5831;1832;5311;502;1551;917;2662;1419;4213
315200;201505;4241;14150;3485;12493;1018;4049;897;3069;1915;7118
315210;201505;8169;23987;6528;20725;1616;5703;2240;6812;3856;12515
315213;201505;1109;3592;1050;3515;68;213;916;3128;984;3341
315217;201505;2644;8997;2194;8224;320;1420;1285;4824;1605;6244
315220;201505;10010;29023;8365;26536;2303;7205;4155;13773;6458;20978
315230;201505;2738;7341;2450;6998;212;354;1983;6158;2195;6512
315240;201505;3106;9747;2727;9156;588;2176;1596;5251;2184;7427
315250;201505;10032;30771;7401;25740;2016;7900;2236;7711;4252;15611
315260;201505;997;3139;732;2548;196;763;133;398;329;1161
315270;201505;716;2381;580;2100;134;543;155;511;289;1054
315280;201505;3208;9360;2231;7245;568;2028;480;1350;1048;3378
315290;201505;1384;3888;1029;3311;360;1261;165;507;525;1768
315300;201505;527;1371;366;1177;176;596;122;389;298;985
315310;201505;1283;4159;1086;3792;137;578;690;2318;827;2896
315320;201505;851;2674;688;2455;149;603;321;1186;470;1789
315330;201505;690;2490;435;1802;123;564;46;200;169;764
315340;201505;3997;11443;3267;10307;720;2548;1398;4324;2118;6872
315350;201505;1787;4991;1336;4335;253;849;751;2516;1004;3365
315360;201505;1694;5594;1375;4788;280;1065;458;1476;738;2541
315370;201505;486;1457;417;1353;88;314;252;818;340;1132
315380;201505;219;755;174;647;45;191;38;123;83;314
315390;201505;1420;4878;1146;4245;328;1383;230;773;558;2156
315400;201505;4305;13030;3572;11629;769;2819;1647;5231;2416;8050
315410;201505;1967;5253;1655;4802;235;840;1054;2984;1289;3824
315415;201505;1127;3740;1036;3605;389;1372;447;1632;836;3004
315420;201505;1235;3971;937;3356;251;958;161;553;412;1511
315430;201505;3933;10630;2897;8894;744;2625;735;2132;1479;4757
315440;201505;912;2847;782;2623;141;548;411;1362;552;1910
315445;201505;2130;5993;1726;5418;181;698;1279;3967;1460;4665
315450;201505;2425;7756;2203;7421;482;1562;1362;4784;1844;6346
315460;201505;36565;120170;32457;111609;10655;39403;7140;23531;17795;62934
315470;201505;531;1583;442;1430;58;231;251;787;309;1018
315480;201505;1737;5288;1084;3778;213;840;186;612;399;1452
315490;201505;3147;8552;2471;7607;354;1298;1241;3724;1595;5022
315500;201505;475;1446;316;1070;54;227;117;333;171;560
315510;201505;1449;4118;1234;3785;75;255;945;2901;1020;3156
315520;201505;1116;3310;886;2993;135;508;551;1817;686;2325
315530;201505;562;1932;488;1757;203;786;151;508;354;1294
315540;201505;1210;3719;990;3343;199;817;347;1147;546;1964
315550;201505;1745;4937;1363;4420;442;1626;451;1409;893;3035
315560;201505;6726;22247;6069;21348;676;2710;4296;15244;4972;17954
315570;201505;2114;6621;1958;6386;414;1524;1070;3432;1484;4956
315580;201505;2564;7566;2023;6592;489;1903;694;2080;1183;3983
315590;201505;945;2734;842;2580;145;509;498;1475;643;1984
315600;201505;2567;9083;2096;8218;375;1550;1140;4674;1515;6224
315610;201505;1021;2945;830;2548;162;633;314;816;476;1449
315620;201505;317;1115;300;1085;88;304;162;619;250;923
315630;201505;917;2897;769;2626;185;681;210;688;395;1369
315640;201505;617;1787;501;1586;110;414;223;648;333;1062
315645;201505;872;2728;750;2462;285;1015;190;602;475;1617
315650;201505;1910;5340;1591;4887;100;426;1202;3632;1302;4058
315660;201505;2604;6863;2202;6234;448;1279;1279;3630;1727;4909
315670;201505;10200;34191;9011;31897;2800;10760;3042;10554;5842;21314
315680;201505;3059;10300;2450;9056;879;3442;418;1519;1297;4961
315690;201505;3603;10292;2557;8424;696;2576;579;1927;1275;4503
315700;201505;7342;22968;6228;20756;1181;4501;2999;9600;4180;14101
315710;201505;1975;5671;1569;5032;168;669;953;3002;1121;3671
315720;201505;3439;10777;3035;10042;665;2601;1520;4774;2185;7375
315725;201505;1708;5137;1380;4702;400;1396;703;2446;1103;3842
315727;201505;635;1948;531;1735;117;422;229;721;346;1143
315730;201505;884;2712;800;2562;144;506;468;1481;612;1987
315733;201505;954;2938;861;2762;306;1058;258;784;564;1842
315737;201505;1333;4089;1049;3570;97;394;675;2328;772;2722
315740;201505;1077;3344;908;3006;175;705;475;1485;650;2190
315750;201505;1135;3540;1043;3388;85;325;781;2517;866;2842
315760;201505;1013;2773;975;2725;24;76;908;2539;932;2615
315765;201505;1420;4452;1305;4285;94;335;1044;3464;1138;3799
315770;201505;1623;5226;1433;4863;364;1379;455;1468;819;2847
315780;201505;23540;76822;21398;72286;6250;22692;6323;21160;12573;43852
315790;201505;3479;11739;3077;10928;355;1209;2054;7542;2409;8751
315800;201505;1547;5969;1263;5143;314;1427;251;986;565;2413
315810;201505;1430;4005;1226;3688;168;514;822;2453;990;2967
315820;201505;2688;9081;2378;8561;746;2769;1056;3923;1802;6692
315830;201505;1250;4203;1062;3780;169;744;319;980;488;1724
315840;201505;832;2179;601;1780;98;322;197;543;295;865
315850;201505;1198;4278;1149;4176;285;1084;513;1818;798;2902
315860;201505;511;1787;391;1537;102;473;66;243;168;716
315870;201505;480;1434;400;1309;114;412;136;400;250;812
315880;201505;1134;3048;936;2799;212;758;361;1000;573;1758
315890;201505;1564;5328;1378;5035;509;1963;618;2261;1127;4224
315895;201505;5125;15796;4623;14781;1071;3841;2008;6183;3079;10024
315900;201505;746;2327;717;2269;96;398;516;1512;612;1910
315910;201505;551;1866;512;1796;168;640;279;949;447;1589
315920;201505;1589;4436;981;3158;236;840;206;574;442;1414
315930;201505;1116;3046;863;2608;217;734;258;751;475;1485
315935;201505;1074;3572;968;3340;267;1004;298;1014;565;2018
315940;201505;675;2117;591;1947;157;594;251;780;408;1374
315950;201505;1168;3578;1061;3392;217;668;668;2193;885;2861
315960;201505;2993;9652;2165;8032;967;4126;111;285;1078;4411
315970;201505;785;2171;616;1933;61;176;450;1476;511;1652
315980;201505;4351;10527;2700;7762;695;2306;699;1682;1394;3988
315990;201505;4025;11758;3420;10808;622;2376;1856;5735;2478;8111
316000;201505;566;1725;484;1606;159;629;174;551;333;1180
316010;201505;561;1909;469;1728;90;402;172;558;262;960
316020;201505;1119;3606;931;3296;154;644;541;1912;695;2556
316030;201505;3625;10398;2652;8728;332;1202;1411;4822;1743;6024
316040;201505;3689;11649;2735;9602;457;1865;419;1117;876;2982
316045;201505;2144;6787;1954;6471;278;872;1390;4813;1668;5685
316050;201505;351;1105;278;988;52;198;155;530;207;728
316060;201505;743;2215;594;1992;95;420;337;1054;432;1474
316070;201505;5974;19077;5162;17233;1253;4701;2132;6777;3385;11478
316080;201505;747;2757;672;2568;162;704;106;415;268;1119
316090;201505;614;1807;405;1351;80;304;101;295;181;599
316095;201505;1430;4578;1240;4236;252;873;734;2561;986;3434
316100;201505;2842;9398;2125;7591;549;2264;378;1203;927;3467
316105;201505;964;2690;723;2294;197;686;269;858;466;1544
316110;201505;12167;42012;10885;39744;1389;5541;7366;27544;8755;33085
316120;201505;1207;3942;990;3405;271;1015;303;952;574;1967
316130;201505;1467;3257;886;2450;141;457;465;1221;606;1678
316140;201505;1067;3113;818;2707;113;400;459;1544;572;1944
316150;201505;1490;4261;1368;4057;262;912;812;2401;1074;3313
316160;201505;1245;3718;967;3174;159;617;448;1443;607;2060
316165;201505;983;2658;814;2410;146;513;497;1455;643;1968
316170;201505;1405;4028;1056;3430;195;721;448;1365;643;2086
316180;201505;1391;4383;988;3483;247;999;206;618;453;1617
316190;201505;2822;8785;1440;5075;294;1085;187;564;481;1649
316200;201505;4060;13003;3118;11119;754;3115;856;2934;1610;6049
316210;201505;4971;15817;4256;14480;1783;6442;752;2437;2535;8879
316220;201505;760;2349;538;1916;126;533;68;243;194;776
316225;201505;1190;3380;1027;3132;136;497;688;2018;824;2515
316230;201505;459;1298;357;1128;62;219;176;579;238;798
316240;201505;6838;20901;5871;19649;606;2069;4503;15324;5109;17393
316245;201505;3204;11126;2958;10721;229;1094;2334;8318;2563;9412
316250;201505;10012;30302;8307;26843;2611;9217;2377;7274;4988;16491
316255;201505;2597;7909;2275;7511;408;1402;1500;4987;1908;6389
316257;201505;1408;3953;1078;3365;223;784;409;1214;632;1998
316260;201505;1803;5125;1380;4494;146;533;831;2827;977;3360
316265;201505;1327;3692;968;2970;106;406;561;1635;667;2041
316270;201505;4339;14353;3974;13605;1002;3739;1801;6053;2803;9792
316280;201505;3320;10822;2975;10157;507;1957;1701;5767;2208;7724
316290;201505;3289;10390;2808;9461;591;2377;1204;3837;1795;6214
316292;201505;3407;11031;3057;10431;704;2648;1528;4982;2232;7630
316294;201505;869;2797;603;2188;130;568;57;188;187;756
316295;201505;1831;6228;1697;5963;315;1369;976;3185;1291;4554
316300;201505;1014;3122;859;2863;73;254;584;1983;657;2237
316310;201505;695;2077;494;1693;93;369;149;483;242;852
316320;201505;594;1900;480;1709;92;379;105;352;197;731
316330;201505;971;2975;761;2504;104;377;473;1537;577;1914
316340;201505;1003;3226;834;2882;218;901;311;975;529;1876
316350;201505;1396;4448;1245;4203;223;769;694;2412;917;3181
316360;201505;749;1958;584;1724;63;196;432;1277;495;1473
316370;201505;4418;14472;3841;13321;1133;4298;740;2563;1873;6861
316380;201505;1576;4276;1269;3848;105;354;903;2756;1008;3110
316390;201505;892;2647;744;2390;214;760;314;1016;528;1776
316400;201505;1351;4281;1085;3807;247;940;452;1554;699;2494
316410;201505;1092;3663;1016;3545;193;719;630;2214;823;2933
316420;201505;1898;6309;1700;6044;189;856;1157;3990;1346;4846
316430;201505;940;2866;712;2428;183;694;217;668;400;1362
316440;201505;699;2254;573;2067;218;908;137;473;355;1381
316443;201505;723;2128;592;1878;147;516;223;664;370;1180
316447;201505;1574;4823;1438;4633;100;312;1250;4082;1350;4394
316450;201505;2158;7328;1858;6763;293;1187;1188;4380;1481;5567
316460;201505;759;2387;693;2273;168;623;405;1256;573;1879
316470;201505;7594;24519;5996;21067;1586;6516;1767;5905;3353;12421
316480;201505;220;745;197;706;49;192;63;207;112;399
316490;201505;294;925;261;840;61;211;122;367;183;578
316500;201505;1102;3990;758;2934;150;628;31;107;181;735
316510;201505;849;3094;747;2883;259;1052;172;640;431;1692
316520;201505;1173;3554;966;3251;187;714;365;1097;552;1811
316530;201505;1130;3667;948;3294;227;987;353;1032;580;2019
316540;201505;1010;3273;910;3106;193;824;367;1156;560;1980
316550;201505;1219;4081;1140;3949;236;929;715;2455;951;3384
316553;201505;2005;7063;1589;6059;474;1983;366;1371;840;3354
316555;201505;2925;10051;2540;9615;207;773;2007;7769;2214;8542
316556;201505;608;1658;482;1431;44;169;337;956;381;1125
316557;201505;759;2761;724;2709;317;1278;171;579;488;1857
316560;201505;349;1204;301;1108;69;314;70;213;139;527
316570;201505;1373;4357;1202;4007;177;643;621;2067;798;2710
316580;201505;285;828;201;648;52;202;60;176;112;378
316590;201505;1513;4154;1115;3491;219;773;596;1772;815;2545
316600;201505;1020;3282;891;3024;301;1080;253;841;554;1921
316610;201505;599;2151;520;1993;107;459;317;1200;424;1659
316620;201505;2164;6694;1846;6096;362;1370;1046;3361;1408;4731
316630;201505;1564;5174;1343;4698;549;2031;372;1310;921;3341
316640;201505;195;619;170;565;33;142;71;202;104;344
316650;201505;920;3468;808;3288;175;728;453;1936;628;2664
316660;201505;208;541;106;321;13;54;28;65;41;119
316670;201505;1841;5346;1469;4660;553;1916;324;936;877;2852
316680;201505;1905;5244;1558;4754;217;711;1121;3410;1338;4121
316690;201505;1207;4030;1080;3770;338;1355;388;1305;726;2660
316695;201505;1136;3587;990;3304;83;286;683;2326;766;2612
316700;201505;362;1138;327;1078;64;265;179;529;243;794
316710;201505;3416;12852;2977;11895;1025;4376;828;3482;1853;7858
316720;201505;17381;56723;14489;50458;4461;16753;3136;10484;7597;27237
316730;201505;374;1155;323;1049;71;276;169;499;240;775
316740;201505;676;2279;599;2136;201;809;204;683;405;1492
316750;201505;425;1446;374;1336;84;351;129;427;213;778
316760;201505;3446;11580;2957;10983;1705;6425;838;3258;2543;9683
316770;201505;1295;3758;1161;3577;157;558;821;2511;978;3069
316780;201505;600;2038;527;1893;158;637;119;374;277;1011
316790;201505;887;2545;650;2138;173;617;206;679;379;1296
316800;201505;6006;19833;5444;18786;1106;4391;2687;8857;3793;13248
316805;201505;857;2287;806;2218;90;233;661;1893;751;2126
316810;201505;618;1883;522;1696;156;565;230;718;386;1283
316820;201505;389;1023;232;749;51;191;37;106;88;297
316830;201505;603;2068;571;2004;175;676;246;832;421;1508
316840;201505;3004;9099;2626;8414;671;2466;1048;3174;1719;5640
316850;201505;2139;6468;1873;6006;322;1157;1107;3573;1429;4730
316860;201505;19068;60377;16426;55443;4030;15703;6947;22331;10977;38034
316870;201505;6400;20718;5316;18207;1621;6091;929;2991;2550;9082
316880;201505;803;2591;738;2476;233;897;274;866;507;1763
316890;201505;1344;3321;1055;2942;332;1067;515;1352;847;2419
316900;201505;2538;7819;2066;6821;516;1974;705;2102;1221;4076
316905;201505;459;1540;399;1410;141;523;133;467;274;990
316910;201505;774;2529;577;2126;153;588;133;505;286;1093
316920;201505;1701;4953;1347;4437;332;1218;461;1456;793;2674
316930;201505;8999;30685;7282;26830;1805;7402;1170;3945;2975;11347
316935;201505;5050;14818;3340;11346;903;3506;628;1910;1531;5416
316940;201505;7133;23465;5887;20789;1448;5584;1390;4671;2838;10255
316950;201505;1489;4319;1314;4070;143;550;923;2824;1066;3374
316960;201505;5153;12988;4100;11642;759;2361;2330;6548;3089;8909
316970;201505;3437;10971;3231;10654;926;3516;1143;3478;2069;6994
316980;201505;1060;3153;764;2645;297;1157;180;625;477;1782
316990;201505;9620;31147;8155;27755;2840;10593;846;2715;3686;13308
317000;201505;2790;9545;2691;9434;154;470;2174;8446;2328;8916
317005;201505;2602;8073;2329;7676;456;1500;1397;4687;1853;6187
317010;201505;31004;78108;19085;58957;4884;16986;4304;13753;9188;30739
317020;201505;57855;163247;35566;116890;7972;29050;8029;24471;16001;53521
317030;201505;808;2292;657;2055;80;315;400;1214;480;1529
317040;201505;10457;30652;8461;27048;2270;7969;3287;10400;5557;18369
317043;201505;766;2167;679;2061;98;288;465;1446;563;1734
317047;201505;1173;3086;854;2559;136;470;401;1187;537;1657
317050;201505;1567;5391;1244;4627;257;1088;531;1864;788;2952
317052;201505;2462;7802;2164;7353;192;757;1635;5534;1827;6291
317057;201505;1763;4956;1354;4246;150;579;774;2349;924;2928
317060;201505;411;1211;294;942;64;249;92;251;156;500
317065;201505;1261;4178;1145;3990;131;545;882;3043;1013;3588
317070;201505;9869;31044;6861;24207;1621;6450;1217;4247;2838;10697
317075;201505;1147;3481;954;3110;268;965;310;931;578;1896
317080;201505;6286;17524;5398;16023;1561;4940;1894;5452;3455;10392
317090;201505;4962;16568;4611;15988;664;2341;3214;11368;3878;13709
317100;201505;3166;8919;2498;7776;769;2661;943;2764;1712;5425
317103;201505;2037;7061;1716;6407;321;1501;817;2959;1138;4460
317107;201505;1374;4211;1169;3786;213;829;682;2062;895;2891
317110;201505;676;1727;408;1249;83;312;168;475;251;787
317115;201505;1161;3677;1002;3343;150;514;638;2160;788;2674
317120;201505;11566;38399;9484;33447;2505;9870;3365;11458;5870;21328
317130;201505;7805;23638;6677;21628;1449;5368;3056;9729;4505;15097
317140;201505;614;2076;582;2014;63;235;411;1445;474;1680
317150;201505;1012;2822;873;2662;98;342;617;1847;715;2189
317160;201505;3565;9546;2721;8436;274;954;1913;5909;2187;6863
317170;201505;1832;5116;1529;4636;93;385;1011;2894;1104;3279
317180;201505;1882;6279;1491;5426;411;1613;381;1324;792;2937
317190;201505;1399;4014;1138;3659;132;441;801;2585;933;3026
317200;201505;4697;14919;4109;13738;1126;4187;1382;4394;2508;8581
317210;201505;1070;3239;883;2978;190;755;476;1585;666;2340
317220;201505;309;1091;298;1078;84;315;170;628;254;943
320010;201505;5501;17220;4781;15669;866;3014;2396;7853;3262;10867
320013;201505;2046;6001;1430;4807;218;768;700;2422;918;3190
320016;201505;3320;9369;2864;8700;405;1186;2021;6230;2426;7416
320020;201505;3989;12389;3417;11242;1038;3760;1210;3907;2248;7667
320030;201505;1632;5229;1305;4500;402;1471;438;1466;840;2937
320035;201505;1808;5357;1604;5053;423;1505;826;2458;1249;3963
320040;201505;3193;10453;2552;8993;604;2352;712;2415;1316;4767
320050;201505;1812;4940;1548;4462;322;1008;761;2094;1083;3102
320060;201505;12291;38770;9468;32302;2308;8664;2905;9314;5213;17978
320070;201505;1584;5139;1301;4470;318;1227;311;925;629;2152
320080;201505;5402;15497;4153;12950;1199;3984;1137;3496;2336;7480
320090;201505;8527;24759;6699;21096;1825;6161;2703;8159;4528;14320
320100;201505;3094;9361;2504;8195;594;2079;1134;3639;1728;5718
320110;201505;1398;4197;1240;3896;301;997;450;1391;751;2388
320115;201505;1825;6480;1653;6161;864;3383;460;1727;1324;5110
320120;201505;16543;51604;13172;44959;3768;14047;3782;12907;7550;26954
320130;201505;37283;120269;33894;113283;7776;29155;15675;50469;23451;79624
320140;201505;4142;13145;2921;10277;722;2837;292;933;1014;3770
320150;201505;17147;47231;12235;37879;3114;10547;2018;5961;5132;16508
320160;201505;5164;15941;4422;14559;1131;4245;1645;4955;2776;9200
320170;201505;1743;5627;1423;4904;409;1502;495;1710;904;3212
320180;201505;821;2684;717;2508;300;1099;215;763;515;1862
320190;201505;3883;13225;3066;11220;886;3457;808;2872;1694;6329
320200;201505;1087;3410;928;3124;232;840;379;1316;611;2156
320210;201505;5154;14375;4436;13064;956;3241;2258;6249;3214;9490
320220;201505;2843;8497;2200;7351;588;2162;850;2866;1438;5028
320225;201505;1513;5186;1222;4469;422;1667;232;866;654;2533
320230;201505;4306;14039;3782;13147;1278;4783;1319;4635;2597;9418
320240;201505;11878;35231;9226;30295;2608;9321;2390;7779;4998;17100
320245;201505;3883;13178;3593;12493;1187;4421;1140;3791;2327;8212
320250;201505;1783;5470;1269;4264;319;1216;263;769;582;1985
320255;201505;1883;6257;1606;5785;634;2479;588;2197;1222;4676
320260;201505;1074;3299;821;2688;210;764;209;568;419;1332
320265;201505;2528;7835;2194;7399;384;1344;1453;5058;1837;6402
320270;201505;2766;8301;2062;6885;489;1775;877;2884;1366;4659
320280;201505;7078;21478;6282;19939;1421;5034;2801;8486;4222;13520
320290;201505;1515;4952;1133;3988;369;1372;219;737;588;2109
320300;201505;4567;15212;4098;14183;1295;4774;1124;3835;2419;8609
320305;201505;4545;14636;4007;13416;981;3599;1820;5899;2801;9498
320310;201505;2005;6001;1717;5441;451;1526;709;2185;1160;3711
320313;201505;2313;6828;1601;5175;387;1478;284;783;671;2261
320316;201505;1912;5804;1593;5148;498;1696;628;1949;1126;3645
320320;201505;19981;62346;16319;55343;4611;17310;5739;18950;10350;36260
320330;201505;3235;9599;2775;8829;578;1782;1534;5133;2112;6915
320332;201505;5036;16904;4449;15808;1554;5875;1530;5510;3084;11385
320334;201505;1793;5803;1276;4645;395;1606;232;782;627;2388
320335;201505;2364;6984;1530;5082;427;1586;253;735;680;2321
320340;201505;5899;16121;4755;14170;1075;3502;2098;6225;3173;9727
320350;201505;5377;14308;4022;11848;930;2948;1540;4459;2470;7407
320360;201505;1761;4640;1287;3715;228;724;577;1540;805;2264
320370;201505;3337;10767;2704;9370;802;2880;946;3230;1748;6110
320380;201505;2506;7370;2198;6817;334;1177;1382;4187;1716;5364
320390;201505;7662;23006;6198;19960;1896;6741;1783;5357;3679;12098
320400;201505;4097;11878;3403;10836;1008;3619;1329;3907;2337;7526
320405;201505;3931;11562;3505;10939;972;3315;1830;5539;2802;8854
320410;201505;5736;14792;4224;12886;977;3204;2154;6542;3131;9746
320420;201505;1749;5378;1285;4541;395;1531;245;856;640;2387
320425;201505;2055;5474;1740;4968;255;819;1072;3006;1327;3825
320430;201505;2330;6638;2045;6085;439;1401;1089;3149;1528;4550
320435;201505;2724;9091;2314;8240;1075;3978;677;2548;1752;6526
320440;201505;1222;4063;1081;3690;266;1023;380;1205;646;2228
320450;201505;2074;6475;1703;5715;481;1787;731;2344;1212;4131
320455;201505;4447;14891;3238;11865;982;3835;794;2846;1776;6681
320460;201505;2975;9400;2288;7957;606;2310;760;2508;1366;4818
320465;201505;1698;5314;1331;4472;292;1078;511;1646;803;2724
320470;201505;4511;13684;3119;10494;886;3257;477;1438;1363;4695
320480;201505;2023;6070;1699;5461;420;1542;673;2065;1093;3607
320490;201505;16183;50101;13428;44745;4297;15553;3893;12982;8190;28535
320495;201505;1213;3724;881;2978;335;1181;125;461;460;1642
320500;201505;46931;143309;40631;131595;10771;38072;18626;58894;29397;96966
320501;201505;4337;13695;3800;12855;1188;4531;1536;5018;2724;9549
320503;201505;1925;6508;1543;5646;562;2263;403;1287;965;3550
320506;201505;3745;11727;2552;8751;800;2934;213;648;1013;3582
320510;201505;8345;26131;7126;23672;1905;6906;3044;9867;4949;16773
320515;201505;2062;5858;1706;5120;466;1460;484;1386;950;2846
320517;201505;2222;7166;1793;6268;656;2516;393;1255;1049;3771
320520;201505;36113;109896;29453;97094;8305;30273;10836;35180;19141;65453
320530;201505;28698;87296;23811;77743;5418;20496;11056;33840;16474;54336
330010;201505;19963;61312;18109;57651;3473;12273;10633;33018;14106;45291
330015;201505;1832;5074;1566;4587;283;987;652;1810;935;2797
330020;201505;17156;50564;15640;48152;3219;10906;9140;27559;12359;38465
330022;201505;1752;5389;1513;4990;289;1125;828;2632;1117;3757
330023;201505;3217;10228;2940;9684;796;2869;1079;3356;1875;6225
330025;201505;4051;11212;3347;10131;783;2620;1850;5480;2633;8100
330030;201505;8210;27537;7251;25537;1748;6885;3312;11125;5060;18010
330040;201505;12938;37293;11099;34107;2596;8579;5555;16586;8151;25165
330045;201505;67549;189787;60135;179021;7683;24886;41917;123373;49600;148259
330050;201505;2678;8343;2377;7742;742;2726;705;2072;1447;4798
330060;201505;5724;16790;5015;15736;1175;4165;2762;8678;3937;12843
330070;201505;23547;71468;20923;66873;4903;17113;9728;30757;14631;47870
330080;201505;8392;23899;7844;23072;1131;3315;5384;16076;6515;19391
330090;201505;2783;7652;2541;7251;498;1592;1385;3853;1883;5445
330093;201505;2034;6000;1686;5334;389;1290;618;1958;1007;3248
330095;201505;1082;3656;963;3397;303;1229;203;629;506;1858
330100;201505;55758;178852;50851;170433;9813;36940;27164;91328;36977;128268
330110;201505;2406;7654;2164;7210;577;2116;730;2379;1307;4495
330115;201505;2140;6219;1931;5882;427;1483;1002;2944;1429;4427
330120;201505;2483;7066;2212;6682;601;2016;1087;3164;1688;5180
330130;201505;3677;11861;3257;11096;880;3269;1461;4894;2341;8163
330140;201505;3137;9709;2842;9268;698;2490;1452;4751;2150;7241
330150;201505;2585;7609;1988;6397;464;1639;470;1474;934;3113
330160;201505;1181;3972;1070;3766;336;1324;418;1401;754;2725
330170;201505;109424;329360;101581;317089;16900;56567;66986;208615;83886;265182
330180;201505;1935;5804;1668;5309;184;755;1067;3199;1251;3954
330185;201505;7804;24603;6891;22806;1586;5688;3603;11773;5189;17461
330187;201505;3889;11191;3360;10311;494;1738;2267;6819;2761;8557
330190;201505;27031;77964;25198;75014;5141;16233;15777;46481;20918;62714
330200;201505;13765;43812;12353;41253;2954;10258;6436;21739;9390;31997
330205;201505;2433;6581;2107;6029;433;1408;1138;3142;1571;4550
330210;201505;4336;11502;3269;9541;946;2969;796;2287;1742;5256
330220;201505;10481;32202;9283;29619;2629;9180;2666;7907;5295;17087
330225;201505;4016;12542;3729;12100;386;1476;2734;9001;3120;10477
330227;201505;18308;51933;16348;49070;4180;13193;8624;25834;12804;39027
330230;201505;1442;4299;1307;4066;335;1182;557;1622;892;2804
330240;201505;17939;55968;15574;51269;5491;19743;3247;10072;8738;29815
330245;201505;1280;3998;1041;3540;273;1016;235;793;508;1809
330250;201505;36213;105804;33101;100630;9797;30413;14622;45194;24419;75607
330260;201505;3712;11629;3233;10630;671;2486;1418;4358;2089;6844
330270;201505;15163;41047;11900;36258;3309;10924;4360;13190;7669;24114
330280;201505;2130;6467;1789;5773;327;1177;823;2468;1150;3645
330285;201505;18783;54470;17083;52023;3008;9945;10960;33226;13968;43171
330290;201505;3588;9982;3173;9385;563;1933;1947;5520;2510;7453
330300;201505;3532;11478;3242;10964;512;1997;1959;6510;2471;8507
330310;201505;2457;7008;2161;6509;396;1260;1187;3537;1583;4797
330320;201505;13838;41264;12970;39961;2067;6989;9160;27985;11227;34974
330330;201505;29148;82111;26093;77293;4638;15434;16466;47523;21104;62957
330340;201505;14568;43341;11585;37653;3309;11457;3389;10878;6698;22335
330350;201505;88770;271100;83693;263557;12857;41769;60366;191306;73223;233075
330360;201505;5672;17290;5505;17059;388;1342;4718;14579;5106;15921
330370;201505;3629;12986;3332;12334;1202;4686;1101;4102;2303;8788
330380;201505;4886;15745;4160;14350;954;3620;1912;6444;2866;10064
330385;201505;4099;14138;3778;13514;1240;4746;1436;5082;2676;9828
330390;201505;23271;77143;20887;72310;4951;19100;9918;33502;14869;52602
330395;201505;3022;8944;2746;8475;302;1118;1867;5611;2169;6729
330400;201505;2493;8086;2264;7676;373;1541;1301;4082;1674;5623
330410;201505;2929;9170;2489;8326;507;1853;1251;4149;1758;6002
330411;201505;2355;7352;2052;6702;281;1136;1186;3660;1467;4796
330412;201505;1353;4590;1099;4101;259;1122;435;1516;694;2638
330414;201505;26216;73130;22517;68190;4090;12637;14262;43579;18352;56216
330415;201505;3634;11144;3155;10286;830;2857;1308;4271;2138;7128
330420;201505;9590;28601;6667;22899;1744;6554;1132;3750;2876;10304
330430;201505;7814;23104;7023;21679;1548;5250;3552;10741;5100;15991
330440;201505;1955;6518;1652;5869;533;2144;359;1115;892;3259
330450;201505;1424;4761;1289;4528;326;1365;661;2250;987;3615
330452;201505;13333;39545;10543;34022;2836;10122;3732;11496;6568;21618
330455;201505;485067;1365407;405670;1238846;99417;323178;200567;608597;299984;931775
330460;201505;1295;4231;1172;4020;260;1041;577;1939;837;2980
330470;201505;4441;13667;3968;12785;1074;3853;1656;5132;2730;8985
330475;201505;8072;25148;7176;23611;2055;7464;3051;9874;5106;17338
330480;201505;6045;17916;5517;17141;1236;4197;2943;8985;4179;13182
330490;201505;105294;284403;96108;271273;9647;28263;75033;213377;84680;241640
330500;201505;5545;17240;5268;16732;683;2449;3694;11575;4377;14024
330510;201505;39061;121839;35731;116502;11018;36714;17134;56961;28152;93675
330513;201505;1537;4583;1398;4333;443;1388;556;1760;999;3148
330515;201505;3006;9377;2683;8775;824;2837;923;2967;1747;5804
330520;201505;11998;35602;10698;33320;2328;7764;5342;16457;7670;24221
330530;201505;1536;4614;1363;4283;346;1179;585;1789;931;2968
330540;201505;3165;9416;2689;8591;667;2339;1129;3481;1796;5820
330550;201505;8294;27627;7266;25716;3171;11824;1386;4873;4557;16697
330555;201505;10514;31244;9372;29593;1782;5780;5841;18861;7623;24641
330560;201505;4292;13067;3948;12463;833;2952;2057;6273;2890;9225
330570;201505;3724;10748;3187;9878;822;2636;1606;5041;2428;7677
330575;201505;5399;15632;4817;14643;851;2944;3022;8813;3873;11757
330580;201505;15342;48292;13125;43783;3590;12742;5134;17224;8724;29966
330590;201505;1757;5358;1631;5143;350;1192;980;3054;1330;4246
330600;201505;10891;31061;8725;27561;1308;4854;4849;14876;6157;19730
330610;201505;9233;29186;8452;27763;1677;6257;4659;15074;6336;21331
330615;201505;1683;5937;1523;5565;669;2580;386;1468;1055;4048
330620;201505;3798;13106;3444;12450;1219;4798;922;3387;2141;8185
330630;201505;22658;68098;18813;61117;3852;14329;9708;30091;13560;44420
350010;201505;2266;6796;1600;5428;407;1519;279;816;686;2335
350020;201505;506;1342;350;1045;70;239;170;477;240;716
350030;201505;4448;13873;3500;11897;1286;4824;761;2365;2047;7189
350040;201505;519;1783;406;1517;105;439;102;328;207;767
350050;201505;1128;3434;905;3021;209;801;313;959;522;1760
350055;201505;612;1875;556;1784;127;466;318;970;445;1436
350060;201505;102;330;86;301;27;110;33;104;60;214
350070;201505;3149;9885;2193;7755;499;1934;404;1235;903;3169
350075;201505;546;1830;450;1661;135;536;118;404;253;940
350080;201505;568;1592;406;1283;73;259;174;540;247;799
350090;201505;566;1558;402;1274;84;287;129;375;213;662
350100;201505;1946;6207;1421;5064;358;1426;377;1239;735;2665
350110;201505;480;1422;356;1141;58;215;166;495;224;710
350115;201505;1266;3934;1121;3607;229;882;577;1659;806;2541
350120;201505;588;1558;293;914;64;215;45;124;109;339
350130;201505;3387;10037;3034;9350;559;1972;1547;4433;2106;6405
350140;201505;624;1984;540;1833;109;428;243;785;352;1213
350150;201505;396;1335;355;1244;126;471;96;332;222;803
350160;201505;7014;21625;5230;17807;1445;5506;1987;6137;3432;11643
350170;201505;1833;6333;1597;5755;463;1813;379;1271;842;3084
350180;201505;1253;3357;883;2590;197;596;383;1083;580;1679
350190;201505;3217;10187;2697;9161;606;2507;1409;4367;2015;6874
350200;201505;342;1107;296;1027;62;237;125;426;187;663
350210;201505;6434;17027;4652;14052;1336;4530;1641;4662;2977;9192
350220;201505;2672;8371;2391;7873;694;2694;870;2552;1564;5246
350230;201505;727;2418;670;2323;185;711;259;885;444;1596
350240;201505;443;1397;406;1331;85;307;253;800;338;1107
350250;201505;2245;8176;2134;7954;792;3172;765;2798;1557;5970
350260;201505;1013;2688;722;2185;138;446;334;985;472;1431
350270;201505;5221;15962;4496;14426;880;3011;2054;6477;2934;9488
350275;201505;1978;6544;1768;6192;477;1837;658;2153;1135;3990
350280;201505;21962;55346;13805;41007;3115;9959;3067;8979;6182;18938
350290;201505;1585;5200;1266;4514;301;1191;307;1024;608;2215
350300;201505;418;1273;366;1176;72;240;187;591;259;831
350310;201505;899;2969;787;2708;137;538;358;1182;495;1720
350315;201505;555;1726;442;1484;74;314;134;408;208;722
350320;201505;12230;38350;10590;35025;2973;10473;1571;5268;4544;15741
350330;201505;13769;39473;9203;28729;1967;6268;3173;9334;5140;15602
350335;201505;353;1102;314;1026;47;143;183;615;230;758
350340;201505;1125;3375;809;2752;180;702;262;833;442;1535
350350;201505;777;2434;680;2275;147;583;253;846;400;1429
350360;201505;784;2655;664;2398;184;699;231;859;415;1558
350370;201505;726;2202;530;1757;99;361;102;298;201;659
350380;201505;3500;10847;2742;9581;953;3679;681;2172;1634;5851
350390;201505;8721;27440;7711;25562;2221;7732;3198;10345;5419;18077
350395;201505;330;941;180;629;30;121;43;141;73;262
350400;201505;7817;22271;6242;19405;1480;5184;2513;7398;3993;12582
350410;201505;7880;27268;6349;23837;1849;7688;1216;4278;3065;11966
350420;201505;580;1682;399;1349;86;357;45;112;131;469
350430;201505;758;2370;620;2120;136;545;295;959;431;1504
350440;201505;1280;4018;1173;3816;325;1122;569;1795;894;2917
350450;201505;7667;22845;5915;19360;1511;5339;1470;4515;2981;9854
350460;201505;1428;4032;955;3049;215;772;285;815;500;1587
350470;201505;252;685;203;603;41;150;106;287;147;437
350480;201505;796;2444;539;1855;83;314;82;231;165;545
350490;201505;2069;6035;1762;5602;471;1721;769;2261;1240;3982
350500;201505;581;1701;499;1578;115;389;220;674;335;1063
350510;201505;1028;3173;808;2677;151;599;309;919;460;1518
350520;201505;1029;3773;822;3310;223;1016;163;592;386;1608
350530;201505;2458;7261;2008;6326;626;2134;560;1600;1186;3734
350535;201505;1380;4242;1297;4089;87;362;1043;3215;1130;3577
350540;201505;1962;5474;1579;4796;448;1459;555;1658;1003;3117
350550;201505;11950;32180;8238;25929;1770;6353;3070;9205;4840;15558
350560;201505;3528;11597;3182;10894;532;1966;1687;5849;2219;7815
350570;201505;19229;64791;17308;60530;5159;19435;6339;21237;11498;40672
350580;201505;1720;5374;1238;4263;276;1058;175;505;451;1563
350590;201505;4061;12589;3046;10491;822;3183;1020;3170;1842;6353
350600;201505;40581;100106;27238;77947;4447;13989;13346;36433;17793;50422
350610;201505;8086;23340;6260;20158;1341;4920;2839;8784;4180;13704
350620;201505;420;1196;324;1051;69;268;158;477;227;745
350630;201505;1694;5076;1314;4343;329;1270;319;921;648;2191
350635;201505;5645;17240;4354;14827;1127;4116;1654;5581;2781;9697
350640;201505;665;2113;507;1718;109;402;133;423;242;825
350650;201505;6963;21234;3846;13563;965;3755;365;1262;1330;5017
350660;201505;4170;12793;3615;11843;809;2916;1930;6194;2739;9110
350670;201505;1814;5609;1684;5355;334;1162;1020;3129;1354;4291
350680;201505;1164;3567;919;3066;221;877;382;1230;603;2107
350690;201505;921;3016;755;2683;194;763;235;772;429;1535
350700;201505;2864;9678;2504;8885;975;3724;797;2553;1772;6277
350710;201505;2451;7681;2200;7266;311;1126;1461;4785;1772;5911
350715;201505;881;2692;776;2508;248;905;270;773;518;1678
350720;201505;144;435;131;412;38;135;48;134;86;269
350730;201505;438;1620;417;1566;119;486;152;551;271;1037
350740;201505;2037;6301;1632;5374;336;1236;681;2091;1017;3327
350745;201505;383;1169;291;957;49;188;137;403;186;591
350750;201505;10217;30818;7884;26129;1975;7249;1897;5818;3872;13067
350760;201505;12602;38068;10654;34468;2812;10158;4241;12891;7053;23049
350770;201505;759;2140;510;1648;78;288;225;694;303;982
350775;201505;544;1523;451;1373;76;269;256;753;332;1022
350780;201505;2186;6641;1651;5539;471;1735;232;741;703;2476
350790;201505;2015;6353;1532;5375;418;1594;358;1118;776;2712
350800;201505;3069;10195;2884;9884;505;2009;1812;6066;2317;8075
350810;201505;2224;6380;1814;5717;560;1908;648;1988;1208;3896
350820;201505;562;1510;408;1201;73;259;178;468;251;727
350830;201505;910;2826;632;2176;89;336;141;394;230;730
350840;201505;2386;8435;1959;7385;589;2447;349;1104;938;3551
350850;201505;6447;21418;5366;18979;1730;6478;1255;4265;2985;10743
350860;201505;3193;10072;3054;9877;282;1117;2433;7790;2715;8907
350870;201505;2564;8311;2187;7725;583;2286;1258;4468;1841;6754
350880;201505;1382;4543;1147;4046;301;1144;249;858;550;2002
350890;201505;664;1899;455;1456;81;309;104;253;185;562
350900;201505;4493;14965;3599;12902;974;3806;687;2269;1661;6075
350910;201505;836;2502;739;2307;258;852;264;780;522;1632
350920;201505;9912;28728;8985;27117;1310;4377;6082;17811;7392;22188
350925;201505;4707;14363;3919;12770;994;3488;1598;4807;2592;8295
350930;201505;1605;4351;1306;3840;146;501;905;2583;1051;3084
350940;201505;2099;6900;1922;6625;360;1480;1195;3967;1555;5447
350945;201505;858;2822;745;2586;130;542;369;1196;499;1738
350950;201505;68560;211467;55682;184958;13871;50768;22464;71242;36335;122010
350960;201505;4312;14416;3672;13079;608;2538;2185;7468;2793;10006
350970;201505;4399;15248;3750;13694;1225;4880;924;3028;2149;7908
350980;201505;602;1978;541;1873;229;847;181;625;410;1472
350990;201505;1744;5984;1500;5508;500;1982;405;1430;905;3412
350995;201505;802;2755;764;2682;124;553;468;1560;592;2113
351000;201505;3431;10242;2887;9204;398;1445;1531;4690;1929;6135
351010;201505;378;1102;256;839;84;309;77;250;161;559
351015;201505;867;2879;744;2650;203;801;315;1098;518;1899
351020;201505;7948;25280;6959;23746;1772;6479;3290;11331;5062;17810
351030;201505;1642;5885;1498;5552;356;1528;536;1847;892;3375
351040;201505;3399;10436;3109;9930;518;1946;1986;6071;2504;8017
351050;201505;11756;35516;8776;29885;2514;9405;2610;8686;5124;18091
351060;201505;33809;101507;27594;89949;6874;24544;11244;35562;18118;60106
351070;201505;1709;4763;1175;3797;353;1258;191;495;544;1753
351080;201505;2751;8052;2138;7279;552;2113;974;3188;1526;5301
351090;201505;392;1336;312;1173;70;308;71;263;141;571
351100;201505;1914;5899;1560;5199;475;1646;521;1781;996;3427
351110;201505;8100;20534;4464;14318;1077;3915;1083;3155;2160;7070
351120;201505;618;1789;502;1554;68;252;263;715;331;967
351130;201505;978;2746;534;1821;91;358;101;308;192;666
351140;201505;1785;6165;1605;5772;530;2150;464;1558;994;3708
351150;201505;1819;6204;1361;5013;271;1107;308;976;579;2083
351160;201505;1382;4718;1232;4383;335;1339;438;1458;773;2797
351170;201505;1545;5003;1248;4335;264;987;536;1740;800;2727
351190;201505;776;2475;628;2106;128;447;134;409;262;856
351200;201505;2239;6563;1863;5818;394;1410;682;1920;1076;3330
351210;201505;1055;3176;823;2698;204;765;278;805;482;1570
351220;201505;3211;10752;2837;9982;597;2359;1384;4779;1981;7138
351230;201505;1786;5630;1535;5185;316;1250;874;2861;1190;4111
351240;201505;1062;3371;776;2725;207;797;185;566;392;1363
351250;201505;925;2639;653;2083;138;476;241;718;379;1194
351260;201505;962;2788;841;2534;187;626;358;1007;545;1633
351270;201505;380;1314;345;1248;89;377;142;460;231;837
351280;201505;5310;15720;3971;12832;931;3173;1333;3992;2264;7165
351290;201505;1038;2991;793;2502;193;640;302;893;495;1533
351300;201505;11975;40192;9135;33896;2430;9938;2889;10498;5319;20436
351310;201505;3274;9998;2662;8888;526;2096;1283;3932;1809;6028
351320;201505;921;3138;796;2855;211;862;222;677;433;1539
351330;201505;293;816;246;736;104;315;59;171;163;486
351340;201505;6121;20589;5350;19026;1499;5739;2238;7873;3737;13612
351350;201505;6943;22426;6001;20422;1779;6397;1960;6278;3739;12675
351360;201505;4198;13094;3854;12445;954;3423;1609;4925;2563;8348
351370;201505;2307;7168;1844;6213;477;1822;650;2009;1127;3831
351380;201505;36726;109666;33382;103293;6796;23054;15275;45644;22071;68698
351385;201505;196;610;183;585;40;134;95;289;135;423
351390;201505;1180;3833;1000;3462;301;1188;377;1161;678;2349
351400;201505;957;3160;895;3011;353;1234;312;1052;665;2286
351410;201505;2780;8402;2455;7819;431;1469;1408;4336;1839;5805
351420;201505;395;1139;268;884;61;217;64;201;125;418
351430;201505;850;2657;776;2531;81;277;588;1926;669;2203
351440;201505;3914;11565;3038;9647;833;2782;595;1672;1428;4454
351450;201505;1613;4518;1358;4166;348;1121;624;2005;972;3126
351460;201505;793;2425;669;2208;316;1083;189;602;505;1685
351470;201505;1080;3236;948;2976;265;933;353;1063;618;1996
351480;201505;2842;9259;2587;8834;504;2145;1353;4377;1857;6522
351490;201505;1913;6371;1704;5923;246;1062;1004;3312;1250;4374
351492;201505;203;639;152;517;21;88;78;250;99;338
351495;201505;150;494;121;420;31;124;40;126;71;250
351500;201505;22685;66817;17914;57672;4942;17571;6964;21413;11906;38984
351510;201505;8317;26441;6974;23731;1704;6314;3368;11271;5072;17585
351512;201505;422;1220;346;1075;58;187;194;619;252;806
351515;201505;2339;7315;1720;5981;457;1708;473;1517;930;3225
351518;201505;1974;6291;1361;5143;357;1549;343;1176;700;2725
351519;201505;822;2444;635;2058;126;505;235;606;361;1111
351520;201505;822;2264;422;1484;71;290;63;200;134;490
351530;201505;383;1168;288;955;45;153;84;243;129;396
351535;201505;2379;6204;1887;5501;185;646;1301;3707;1486;4353
351540;201505;1835;5630;1519;5049;532;1972;255;780;787;2752
351550;201505;4700;13716;3373;11005;768;2881;1181;3683;1949;6564
351560;201505;402;1264;343;1135;80;303;63;198;143;501
351565;201505;207;689;189;642;46;187;83;257;129;444
351570;201505;11716;36482;10067;33153;2466;8793;5166;16543;7632;25336
351580;201505;361;970;236;709;56;167;68;192;124;359
351590;201505;432;1185;327;988;57;201;112;307;169;508
351600;201505;1678;4604;1483;4303;224;758;803;2200;1027;2958
351610;201505;662;1807;505;1530;60;221;236;653;296;874
351620;201505;19080;61233;14574;51888;3433;13657;3531;11020;6964;24677
351630;201505;18056;58357;16515;55784;3877;13827;9482;31956;13359;45783
351640;201505;9758;30571;8153;27714;1679;6300;4383;14637;6062;20937
351650;201505;427;1263;210;703;46;162;32;97;78;259
351660;201505;748;2346;552;1855;131;463;148;442;279;905
351670;201505;3992;12334;3288;10820;589;2272;1598;4900;2187;7172
351680;201505;699;2122;445;1504;94;335;92;298;186;633
351685;201505;450;1340;367;1198;95;317;162;533;257;850
351690;201505;1096;3203;743;2389;149;530;194;520;343;1050
351700;201505;1266;3662;1106;3364;309;945;450;1356;759;2301
351710;201505;672;2180;555;1932;114;410;197;630;311;1040
351720;201505;1673;5099;1159;3829;228;816;376;1105;604;1921
351730;201505;1025;2936;830;2669;294;1096;291;878;585;1974
351740;201505;3971;10872;3154;9246;672;2106;1117;3112;1789;5218
351750;201505;1246;3976;909;3178;222;894;298;932;520;1826
351760;201505;3805;11920;3191;10571;854;3030;1175;3668;2029;6698
351770;201505;2310;7143;1927;6485;540;1917;896;2904;1436;4821
351780;201505;1553;4334;929;2946;190;656;240;715;430;1371
351790;201505;1085;3228;949;3025;314;1031;410;1319;724;2350
351800;201505;424;959;311;805;42;112;168;428;210;540
351810;201505;1088;3128;995;3010;187;637;689;2056;876;2693
351820;201505;2128;6730;1683;5889;523;1939;187;625;710;2564
351830;201505;4098;12921;3225;10883;587;2248;1569;4982;2156;7230
351840;201505;7518;25036;6525;23073;1861;7121;2329;7996;4190;15117
351850;201505;1638;4846;1248;4112;224;914;532;1554;756;2468
351860;201505;3383;10782;2993;9989;829;3007;1297;4093;2126;7100
351870;201505;31124;94255;26981;86760;6897;23779;13243;42001;20140;65780
351880;201505;109263;348136;94822;318024;28160;100218;28981;94714;57141;194932
351885;201505;550;1982;511;1896;142;565;239;849;381;1414
351890;201505;695;2072;530;1723;124;443;127;369;251;812
351900;201505;1302;3982;1114;3686;308;1089;389;1277;697;2366
351905;201505;460;1500;385;1368;67;302;214;705;281;1007
351907;201505;16794;50692;14149;45814;2309;8759;8137;25344;10446;34103
351910;201505;982;3044;886;2887;189;725;424;1306;613;2031
351920;201505;1060;2925;934;2730;140;487;595;1673;735;2160
351925;201505;936;2848;820;2627;122;455;446;1317;568;1772
351930;201505;2748;9007;2564;8642;561;2312;1531;4727;2092;7039
351940;201505;930;2749;815;2545;177;594;459;1398;636;1992
351950;201505;1422;3889;1022;3145;144;487;538;1604;682;2091
351960;201505;4203;12345;3109;10364;784;2882;1307;4210;2091;7092
351970;201505;5559;20188;4934;18901;1563;6419;1705;6382;3268;12801
351980;201505;915;2718;698;2283;141;531;285;794;426;1325
351990;201505;1549;4383;1237;3786;296;1087;295;755;591;1842
352000;201505;2345;7553;2133;7136;517;1870;982;3107;1499;4977
352010;201505;1918;6410;1674;5845;444;1693;399;1333;843;3026
352020;201505;1429;4545;1241;4166;323;1198;458;1452;781;2650
352030;201505;4867;14372;4053;13166;991;3379;2152;7088;3143;10467
352040;201505;1981;6613;1638;5840;372;1468;402;1304;774;2772
352042;201505;2972;8389;2016;6287;430;1498;962;2891;1392;4389
352044;201505;1389;4646;1061;3867;227;906;194;627;421;1533
352050;201505;7825;25004;5421;19547;1510;6085;1047;3232;2557;9317
352060;201505;775;2255;670;2083;163;612;285;799;448;1411
352070;201505;667;1843;600;1739;196;597;238;690;434;1287
352080;201505;468;1327;341;1094;68;244;137;400;205;644
352090;201505;1704;5542;1346;4751;294;1145;300;921;594;2066
352100;201505;2436;7449;1759;6146;464;1838;557;1744;1021;3582
352110;201505;504;1807;442;1669;128;526;167;593;295;1119
352115;201505;418;1327;359;1205;75;284;158;489;233;773
352120;201505;920;2818;780;2585;148;569;420;1355;568;1924
352130;201505;1865;5333;1291;4195;360;1220;394;1184;754;2404
352140;201505;1614;4869;1063;3644;200;722;442;1468;642;2190
352150;201505;741;2255;577;1930;148;517;250;810;398;1327
352160;201505;1076;2983;882;2631;189;621;344;917;533;1538
352170;201505;2790;8414;2506;7860;551;1930;1340;3974;1891;5904
352180;201505;3475;9855;2919;8819;728;2398;1107;3134;1835;5532
352190;201505;1171;3549;1026;3257;205;772;435;1199;640;1971
352200;201505;394;1367;328;1239;51;220;190;728;241;948
352210;201505;17112;45626;13567;40467;2498;7835;8027;24439;10525;32274
352215;201505;568;1769;523;1709;76;296;315;1010;391;1306
352220;201505;12595;41284;11276;38611;3703;13669;3653;12182;7356;25851
352230;201505;13060;44075;11319;40773;3361;13257;4312;15105;7673;28362
352240;201505;11056;32554;8629;28180;2675;9859;2904;8790;5579;18649
352250;201505;23107;74071;20222;68251;5722;20850;7341;24444;13063;45294
352260;201505;5426;15504;3380;11234;665;2532;1177;3622;1842;6154
352265;201505;892;2826;748;2578;88;393;462;1503;550;1896
352270;201505;2105;7151;1759;6374;521;1983;418;1430;939;3413
352280;201505;2381;7267;1961;6537;487;1863;664;2102;1151;3965
352290;201505;1187;3750;1025;3410;247;971;352;1029;599;2000
352300;201505;926;2732;741;2397;185;645;318;973;503;1618
352310;201505;33449;102089;28595;93962;7124;24885;16205;53316;23329;78201
352320;201505;5753;17635;4961;16140;1457;5163;1595;4686;3052;9849
352330;201505;1905;6164;1647;5804;572;2159;506;1743;1078;3902
352340;201505;5726;19067;4556;16431;1299;5055;824;2716;2123;7771
352350;201505;1559;5487;1405;5147;312;1257;547;1923;859;3180
352360;201505;1106;3457;971;3192;200;817;604;1860;804;2677
352370;201505;897;3066;814;2887;154;641;398;1340;552;1981
352380;201505;970;3076;841;2848;283;1104;230;731;513;1835
352390;201505;18082;49780;12016;38031;2248;8223;5616;16458;7864;24681
352400;201505;3874;10842;2387;7917;619;2180;694;2122;1313;4302
352410;201505;2997;8871;2435;7917;662;2296;837;2642;1499;4938
352420;201505;990;2815;881;2632;257;857;425;1224;682;2081
352430;201505;6471;19587;5396;17849;1841;6736;1652;5315;3493;12051
352440;201505;15758;48247;12734;42351;3286;11703;4628;15026;7914;26729
352450;201505;691;2030;459;1576;110;420;106;322;216;742
352460;201505;2379;7799;2015;7117;636;2478;553;1804;1189;4282
352470;201505;4538;12549;2681;8692;463;1679;937;2855;1400;4534
352480;201505;4901;13434;3821;11448;777;2740;1562;4271;2339;7011
352490;201505;721;2498;586;2161;111;467;136;454;247;921
352500;201505;7821;23685;7166;22652;3396;11733;2064;5667;5460;17400
352510;201505;3157;10286;2541;9021;832;3262;606;2032;1438;5294
352520;201505;2166;7554;1918;6976;480;1909;915;3243;1395;5152
352530;201505;7722;24806;5762;20374;1628;6195;870;2709;2498;8904
352540;201505;492;1547;374;1287;59;243;104;336;163;579
352550;201505;868;2897;584;2178;144;620;99;322;243;942
352560;201505;683;2033;503;1649;95;324;174;512;269;836
352570;201505;1722;5678;1273;4611;276;1156;269;866;545;2022
352580;201505;882;2580;749;2363;181;640;371;1110;552;1750
352585;201505;215;703;168;606;61;232;32;122;93;354
352590;201505;11528;36100;9601;32082;2351;8575;4671;14933;7022;23508
352600;201505;1631;4997;1456;4676;406;1429;626;1896;1032;3325
352610;201505;3348;10213;2798;9257;861;3184;832;2539;1693;5723
352620;201505;5145;15996;4812;15545;998;3513;3036;9724;4034;13237
352630;201505;657;2122;615;2018;150;563;286;895;436;1458
352640;201505;2905;8990;2366;7841;365;1388;1189;3795;1554;5183
352650;201505;842;2463;625;1999;134;454;196;591;330;1045
352660;201505;1021;3455;796;2922;172;702;185;627;357;1329
352670;201505;10564;32113;6442;22766;1669;6370;890;2896;2559;9266
352680;201505;3204;10989;2485;9247;571;2359;681;2227;1252;4586
352690;201505;30118;84071;20854;65162;4111;14201;9477;28338;13588;42539
352700;201505;770;2309;630;2090;189;715;284;889;473;1604
352710;201505;5761;16814;4298;13890;1058;3874;1566;4779;2624;8653
352720;201505;7743;25138;7027;23650;2108;7334;2589;8611;4697;15945
352725;201505;419;1186;261;857;37;147;100;302;137;449
352730;201505;2325;7764;2057;7056;442;1668;723;2226;1165;3894
352740;201505;1918;5449;1547;4815;293;1101;871;2535;1164;3636
352750;201505;408;1183;243;808;47;176;55;154;102;330
352760;201505;1103;3807;975;3519;293;1136;406;1388;699;2524
352770;201505;722;2219;625;2034;135;497;276;858;411;1355
352780;201505;650;2139;541;1899;122;487;168;526;290;1013
352790;201505;641;1836;471;1520;99;344;113;349;212;693
352800;201505;971;3483;713;2775;173;739;175;553;348;1292
352810;201505;1148;2979;761;2243;137;481;247;687;384;1168
352820;201505;605;1769;478;1577;159;569;106;340;265;909
352830;201505;519;1475;354;1125;64;222;56;139;120;361
352840;201505;3907;13412;3440;12409;1065;4081;1034;3676;2099;7757
352850;201505;8907;27922;7644;25709;2004;7245;2828;9350;4832;16595
352860;201505;851;2774;770;2589;207;761;263;812;470;1573
352870;201505;1006;2493;747;2009;80;299;447;1081;527;1380
352880;201505;2309;6626;1700;5339;363;1199;537;1557;900;2756
352885;201505;254;839;240;808;43;167;133;419;176;586
352890;201505;718;1927;537;1560;93;330;254;650;347;980
352900;201505;18808;55219;13847;45048;3022;10800;5353;16510;8375;27310
352910;201505;282;890;204;714;46;183;25;73;71;256
352920;201505;2545;7609;2037;6652;531;1960;792;2331;1323;4291
352930;201505;5923;18600;4714;15921;1301;4739;1042;3310;2343;8049
352940;201505;23541;77539;19851;68915;6829;25148;3148;10232;9977;35380
352950;201505;346;1053;230;812;62;260;53;151;115;411
352960;201505;630;1955;417;1460;72;292;68;221;140;513
352965;201505;312;903;251;788;64;232;49;132;113;364
352970;201505;3110;7969;2579;7199;317;938;1774;4985;2091;5923
352980;201505;1191;3557;995;3262;236;796;569;1977;805;2773
352990;201505;3931;12601;3487;11815;997;3756;1306;4174;2303;7930
353000;201505;500;1374;298;919;52;170;47;114;99;284
353010;201505;2996;8389;2220;6877;541;1921;698;1929;1239;3850
353020;201505;4298;11755;2813;8521;409;1418;1110;3003;1519;4421
353030;201505;4188;12255;3469;10920;1005;3428;875;2550;1880;5978
353040;201505;667;1896;563;1726;155;532;201;579;356;1111
353050;201505;5053;16926;4232;15245;1307;5133;1512;5112;2819;10245
353060;201505;33955;105804;31721;102265;3826;14976;23339;72574;27165;87550
353070;201505;9302;30133;6880;24760;1906;7348;1749;6252;3655;13600
353080;201505;5176;16797;3640;13200;849;3409;865;2835;1714;6244
353090;201505;536;1763;482;1651;52;228;275;874;327;1102
353100;201505;241;649;126;400;32;112;27;78;59;190
353110;201505;7384;22944;6530;21459;1591;5579;3519;11599;5110;17178
353120;201505;594;1814;414;1392;108;422;112;315;220;737
353130;201505;2659;7769;2213;7068;749;2645;769;2311;1518;4956
353140;201505;2421;6581;1856;5474;483;1553;711;1925;1194;3478
353150;201505;1772;5427;1455;4869;434;1582;401;1319;835;2901
353160;201505;639;1840;450;1441;116;372;67;170;183;542
353170;201505;480;1604;433;1526;126;537;191;625;317;1162
353180;201505;7473;21710;5894;18757;895;3203;3299;10251;4194;13454
353190;201505;3479;10811;2976;9706;583;2149;1464;4441;2047;6590
353200;201505;947;3187;773;2778;250;980;210;723;460;1703
353205;201505;491;1566;409;1392;84;287;162;554;246;841
353210;201505;967;2467;732;2058;39;149;526;1460;565;1609
353215;201505;477;1511;415;1374;72;277;142;419;214;696
353220;201505;652;2008;524;1725;121;432;142;430;263;862
353230;201505;976;3089;892;2943;233;852;256;775;489;1627
353240;201505;2069;6634;1862;6228;469;1781;912;2860;1381;4641
353250;201505;1090;2956;852;2534;152;483;391;1119;543;1602
353260;201505;920;2516;699;2138;114;410;317;913;431;1323
353270;201505;646;1936;558;1762;157;540;190;545;347;1085
353280;201505;609;1965;515;1772;135;511;140;463;275;974
353282;201505;1619;5178;1529;5023;230;870;952;2979;1182;3849
353284;201505;337;929;205;652;41;128;54;176;95;304
353286;201505;149;443;105;344;19;57;14;49;33;106
353290;201505;529;1698;427;1515;107;420;211;713;318;1133
353300;201505;1527;4764;1284;4228;312;1187;474;1356;786;2543
353310;201505;220;657;190;600;54;193;74;203;128;396
353320;201505;522;1497;457;1388;85;290;255;746;340;1036
353325;201505;567;1901;469;1686;80;328;80;238;160;566
353330;201505;596;1714;397;1260;77;284;188;535;265;819
353340;201505;3000;8633;1991;6646;557;2016;654;2081;1211;4097
353350;201505;3210;9669;2697;8750;852;2979;1113;3440;1965;6419
353360;201505;390;1289;340;1177;53;222;202;669;255;891
353370;201505;654;2132;573;1936;82;317;333;1094;415;1411
353380;201505;339;1102;284;1003;65;284;118;374;183;658
353390;201505;5796;15534;4065;12432;792;2710;1509;4245;2301;6955
353400;201505;498;1486;409;1306;111;401;109;287;220;688
353410;201505;617;1804;508;1629;111;395;285;904;396;1299
353420;201505;581;1600;413;1226;108;313;137;382;245;695
353430;201505;2407;8286;1764;6518;434;1686;188;620;622;2306
353440;201505;58968;189825;50627;170696;14079;49994;17499;57166;31578;107160
353450;201505;442;1342;374;1209;87;320;154;470;241;790
353460;201505;3587;10005;3083;9151;466;1526;1560;4700;2026;6226
353470;201505;9535;28710;6845;23181;1566;5956;1677;5224;3243;11180
353475;201505;1668;4736;1139;3582;218;742;316;883;534;1625
353480;201505;1482;4407;1309;4076;249;861;759;2292;1008;3153
353490;201505;1173;3250;914;2753;202;673;332;898;534;1571
353500;201505;951;2613;809;2366;254;773;336;962;590;1735
353510;201505;1100;3480;863;2891;186;711;248;687;434;1398
353520;201505;1079;3189;847;2781;197;735;328;1053;525;1788
353530;201505;2600;7705;2312;7190;438;1584;1227;3664;1665;5248
353540;201505;2008;6058;1752;5624;458;1577;750;2374;1208;3951
353550;201505;6210;17202;5369;15911;670;2412;3407;9621;4077;12033
353560;201505;2128;7028;1759;6344;448;1832;545;1851;993;3683
353570;201505;434;1341;361;1186;58;216;225;694;283;910
353580;201505;2240;7068;2060;6763;409;1543;1301;4195;1710;5738
353590;201505;702;2001;549;1732;160;536;168;535;328;1071
353600;201505;1730;4846;1558;4555;249;820;864;2464;1113;3284
353610;201505;590;1974;454;1674;97;428;126;418;223;846
353620;201505;2182;7139;1857;6500;514;1948;600;1962;1114;3910
353625;201505;291;785;188;606;41;149;62;192;103;341
353630;201505;1658;5657;1264;4643;248;980;171;544;419;1524
353640;201505;1371;3969;1117;3440;178;552;582;1748;760;2300
353650;201505;6881;20698;5139;17004;1115;3950;1728;5470;2843;9420
353657;201505;323;1004;286;928;51;187;106;320;157;507
353660;201505;1255;3227;916;2671;364;1167;163;340;527;1507
353670;201505;4003;12952;3386;11610;1030;4007;1057;3248;2087;7255
353680;201505;650;2176;585;2054;255;974;208;703;463;1677
353690;201505;547;1430;327;1024;60;229;115;297;175;526
353700;201505;2189;6786;1885;6159;364;1323;735;2251;1099;3574
353710;201505;2970;7211;1350;4481;299;1031;280;900;579;1931
353715;201505;449;1298;315;1022;41;150;88;268;129;418
353720;201505;2041;6392;1764;5973;323;1271;1002;3282;1325;4553
353730;201505;4456;13582;3463;11435;780;2803;947;2816;1727;5619
353740;201505;2081;6225;1630;5305;492;1678;459;1463;951;3141
353750;201505;813;2720;626;2276;135;560;177;627;312;1187
353760;201505;8985;25832;7294;23112;1518;5355;3915;12217;5433;17572
353770;201505;807;2450;483;1667;103;389;39;63;142;452
353780;201505;4457;15314;3866;14141;1393;5413;1065;3892;2458;9305
353790;201505;1846;6391;1524;5708;415;1776;318;1123;733;2899
353800;201505;15161;47440;11999;41558;3266;12483;4460;15005;7726;27488
353810;201505;1078;3405;844;2902;193;753;293;955;486;1708
353820;201505;1228;4209;1117;3947;278;1171;545;1751;823;2922
353830;201505;767;2069;600;1781;105;340;270;788;375;1128
353850;201505;1653;5257;1498;4973;312;1114;726;2325;1038;3439
353860;201505;2408;8053;2002;7106;532;2029;568;1947;1100;3976
353870;201505;24445;73147;17447;58938;3861;14433;5432;16586;9293;31019
353880;201505;2451;7743;2054;7057;286;1213;1160;3898;1446;5111
353890;201505;2687;6654;1860;5310;372;1161;893;2413;1265;3574
353900;201505;1059;3314;777;2701;177;691;196;602;373;1293
353910;201505;1183;4318;1146;4241;329;1307;660;2390;989;3697
353920;201505;2241;6665;1609;5281;370;1299;277;791;647;2090
353930;201505;4203;13367;3069;11161;846;3304;640;2275;1486;5579
353940;201505;1266;4000;1020;3455;184;722;427;1321;611;2043
353950;201505;3498;11114;3178;10559;452;1756;2086;6730;2538;8486
353960;201505;617;1936;475;1624;98;365;116;332;214;697
353970;201505;548;1619;479;1523;41;151;353;1115;394;1266
353980;201505;13386;40187;11566;36809;2593;8896;5861;18282;8454;27178
353990;201505;417;1282;375;1190;74;281;157;451;231;732
354000;201505;1993;5721;1347;4432;280;1005;138;406;418;1411
354010;201505;360;1080;309;996;90;302;144;472;234;774
354020;201505;4659;14326;4105;13111;1115;3901;1609;4737;2724;8638
354025;201505;900;2542;697;2196;158;543;208;615;366;1158
354030;201505;528;1444;373;1183;74;262;163;479;237;741
354040;201505;798;2171;601;1808;71;267;330;911;401;1178
354050;201505;972;3141;839;2881;261;1006;269;873;530;1879
354060;201505;5211;16127;3663;12702;901;3357;1211;4022;2112;7379
354070;201505;3080;10127;2659;9209;760;2860;535;1770;1295;4630
354075;201505;2123;7921;2003;7697;568;2414;911;3463;1479;5877
354080;201505;1702;5237;1213;4090;269;977;300;871;569;1848
354085;201505;306;787;275;743;21;79;217;565;238;644
354090;201505;1315;3889;1248;3782;129;433;939;2886;1068;3319
354100;201505;15839;53230;13296;48274;3401;13217;5962;21391;9363;34608
354105;201505;859;2651;749;2445;127;486;405;1249;532;1735
354110;201505;812;2277;662;2067;211;747;198;556;409;1303
354120;201505;1986;5480;1547;4659;301;1022;637;1759;938;2781
354130;201505;5924;17235;4663;14765;1886;6398;861;2341;2747;8739
354140;201505;25171;64123;15759;46864;3214;10439;5481;15063;8695;25502
354150;201505;4165;11247;3168;9483;647;2198;1481;4223;2128;6421
354160;201505;3654;11971;3101;10743;839;3180;1229;4080;2068;7260
354165;201505;380;1374;339;1278;103;438;102;364;205;802
354170;201505;1460;4543;1149;3829;215;817;429;1257;644;2074
354180;201505;495;1498;456;1414;61;235;265;736;326;971
354190;201505;1463;4774;1227;4254;344;1327;396;1289;740;2616
354200;201505;1097;3120;891;2738;154;548;371;1014;525;1562
354210;201505;725;2392;629;2205;109;482;315;1004;424;1486
354220;201505;2908;8664;2527;7940;650;2264;1142;3435;1792;5699
354230;201505;628;2067;577;1982;111;426;280;942;391;1368
354240;201505;1223;3996;920;3283;178;712;199;638;377;1350
354250;201505;663;1950;454;1579;178;686;123;413;301;1099
354260;201505;7294;22255;6497;20901;1874;6560;2482;7864;4356;14424
354270;201505;1157;3999;1003;3644;270;1090;374;1344;644;2434
354280;201505;644;1971;600;1893;80;330;445;1336;525;1666
354290;201505;1051;3602;959;3422;236;915;372;1299;608;2214
354300;201505;3528;11807;3399;11562;893;3226;1731;5768;2624;8994
354310;201505;886;2774;676;2329;176;653;238;808;414;1461
354320;201505;770;2279;646;2039;161;571;207;577;368;1148
354323;201505;404;1143;312;968;72;250;104;284;176;534
354325;201505;1193;3972;1025;3567;204;816;413;1325;617;2141
354330;201505;6817;20823;5696;18584;1173;4334;2871;8841;4044;13175
354340;201505;26452;82644;21605;73936;7034;26125;7734;25613;14768;51738
354350;201505;1111;3295;1034;3153;281;958;524;1499;805;2457
354360;201505;462;1451;331;1172;55;202;26;90;81;292
354370;201505;1217;4082;1069;3783;136;600;659;2261;795;2861
354380;201505;1086;3215;865;2825;256;1007;142;359;398;1366
354390;201505;12168;37358;8668;30048;1986;7527;2017;6642;4003;14169
354400;201505;1518;5204;1219;4496;263;1065;370;1298;633;2363
354410;201505;5535;16931;4629;15359;979;3540;2301;7544;3280;11084
354420;201505;1260;3801;971;3150;247;874;360;1086;607;1960
354425;201505;2663;7509;2239;6734;718;2324;560;1617;1278;3941
354430;201505;1266;4129;1176;3944;286;1089;525;1686;811;2775
354440;201505;523;1534;395;1277;49;186;194;583;243;769
354450;201505;429;1230;246;833;39;165;52;150;91;315
354460;201505;856;2349;643;1989;198;662;249;747;447;1409
354470;201505;548;1541;432;1308;57;225;203;541;260;766
354480;201505;723;2055;621;1893;107;377;349;1016;456;1393
354490;201505;745;2474;577;2076;121;486;196;639;317;1125
354500;201505;2110;7056;1868;6603;711;2898;364;1132;1075;4030
354510;201505;722;2139;640;1993;110;347;395;1252;505;1599
354515;201505;315;1058;248;905;46;196;82;265;128;461
354520;201505;6813;22490;4040;14428;886;3650;1547;5144;2433;8794
354530;201505;2787;9797;2555;9322;676;2724;1218;4353;1894;7077
354540;201505;1253;3800;1033;3394;363;1325;184;533;547;1858
354550;201505;505;1565;429;1398;80;282;204;637;284;919
354560;201505;1534;4515;1102;3537;223;718;410;1261;633;1979
354570;201505;737;2199;533;1745;135;473;84;239;219;712
354580;201505;10228;29583;7976;25244;1625;5741;3435;10248;5060;15989
354600;201505;1586;5309;1401;4947;332;1402;670;2236;1002;3638
354610;201505;397;1138;250;802;36;110;50;135;86;245
354620;201505;389;1268;311;1130;84;371;131;440;215;811
354625;201505;272;908;216;788;47;185;57;202;104;387
354630;201505;1979;6665;1776;6227;812;2899;446;1493;1258;4392
354640;201505;3631;11828;2889;10215;689;2818;671;2117;1360;4935
354650;201505;888;2673;802;2511;104;370;527;1608;631;1978
354660;201505;2367;6912;1859;6031;346;1264;999;3228;1345;4492
354670;201505;1629;5288;1339;4575;360;1335;334;985;694;2320
354680;201505;4682;15576;4231;14635;1083;4065;1706;5716;2789;9781
354690;201505;777;2498;522;1859;88;325;151;498;239;823
354700;201505;1220;3419;822;2575;154;572;343;908;497;1480
354710;201505;539;1598;458;1444;80;298;203;572;283;870
354720;201505;216;595;155;472;52;151;41;125;93;276
354730;201505;7799;25799;6091;22143;1519;6054;2451;8598;3970;14652
354740;201505;251;757;162;561;28;108;33;104;61;212
354750;201505;2445;7450;1886;6469;588;2279;669;2203;1257;4482
354760;201505;2053;6596;1658;5725;484;1800;314;1010;798;2810
354765;201505;239;661;150;483;24;85;25;73;49;158
354770;201505;2266;6359;1747;5496;680;2308;415;1238;1095;3546
354780;201505;41438;120985;36569;110334;7277;24750;19186;54155;26463;78905
354790;201505;789;2510;668;2293;135;539;328;1041;463;1580
354800;201505;1910;5611;1678;5287;419;1472;903;2821;1322;4293
354805;201505;950;2865;688;2274;75;272;144;424;219;696
354810;201505;603;1935;375;1357;73;312;71;191;144;503
354820;201505;1042;3599;899;3299;218;948;255;833;473;1781
354830;201505;392;1138;311;992;87;305;146;425;233;730
354840;201505;680;1971;561;1757;131;450;266;803;397;1253
354850;201505;16142;50583;12097;42309;2919;11406;4530;14612;7449;26018
354860;201505;1366;4307;1184;3999;249;966;539;1750;788;2716
354870;201505;42739;130810;38951;122906;9725;32900;17817;55203;27542;88103
354880;201505;4073;11401;2475;8088;489;1790;683;1829;1172;3619
354890;201505;15907;47376;13323;42490;3525;12081;4596;14106;8121;26187
354900;201505;486;1430;381;1246;105;379;134;428;239;807
354910;201505;6552;19543;3723;13275;654;2621;267;864;921;3485
354920;201505;467;1361;328;1086;74;277;89;274;163;551
354925;201505;353;1009;217;737;37;148;32;81;69;229
354930;201505;215;593;158;496;35;117;76;230;111;347
354940;201505;2221;7863;1759;6628;631;2531;235;791;866;3322
354950;201505;1476;4747;1290;4477;169;714;820;2786;989;3500
354960;201505;768;2416;670;2258;165;633;274;887;439;1520
354970;201505;4092;13356;3565;12246;648;2596;1949;6407;2597;9003
354980;201505;33299;82730;19689;59822;3957;13527;6599;18553;10556;32080
354990;201505;45420;138089;37151;121239;7225;26020;19038;60007;26263;86027
354995;201505;1685;5193;1528;4971;342;1213;858;2767;1200;3980
355000;201505;1462;4741;1266;4392;400;1580;246;737;646;2317
355010;201505;3625;11205;2901;9612;775;2777;1141;3729;1916;6506
355020;201505;2734;9211;2144;7995;902;3638;485;1753;1387;5391
355030;201505;964951;2758121;843574;2517555;202447;659344;378027;1085015;580474;1744359
355040;201505;2578;7923;2273;7388;556;1980;1216;3870;1772;5850
355050;201505;1230;3775;992;3298;310;1075;206;684;516;1759
355060;201505;5163;17428;4156;15266;1042;4295;1022;3399;2064;7694
355070;201505;6710;20887;6001;19741;1312;5037;3181;9772;4493;14809
355080;201505;1179;4055;874;3310;190;845;120;355;310;1200
355090;201505;1135;3961;958;3554;203;824;396;1419;599;2243
355100;201505;19925;62260;16784;57004;4892;18165;7023;23309;11915;41474
355110;201505;1169;4000;1054;3748;324;1266;334;1151;658;2417
355120;201505;634;2008;540;1831;140;548;228;724;368;1272
355130;201505;599;1539;305;900;43;143;119;303;162;446
355140;201505;1074;3614;1029;3530;239;916;529;1830;768;2746
355150;201505;3247;9717;2756;8904;645;2233;1388;4447;2033;6680
355160;201505;1601;5168;1379;4825;491;1957;431;1359;922;3316
355170;201505;9781;27080;6970;22171;2160;7415;1741;5511;3901;12926
355180;201505;2886;8865;2400;7959;648;2516;818;2455;1466;4971
355190;201505;1295;4407;1098;3978;409;1571;351;1228;760;2799
355200;201505;784;2827;724;2705;302;1225;169;594;471;1819
355210;201505;2560;8442;2294;7888;534;2153;1144;3682;1678;5835
355220;201505;30308;94235;25078;84039;8859;31468;6505;21058;15364;52526
355230;201505;1387;3887;762;2495;127;421;182;535;309;956
355240;201505;26243;75962;18557;60286;4067;14478;6711;20568;10778;35046
355250;201505;25830;84755;22947;79155;6865;25120;9498;32340;16363;57460
355255;201505;824;2309;577;1793;114;385;159;445;273;830
355260;201505;1426;4040;1222;3715;301;1067;505;1358;806;2425
355270;201505;1540;4662;1471;4562;128;509;1201;3641;1329;4150
355280;201505;23904;70447;19884;62705;4183;14935;8830;26427;13013;41362
355290;201505;914;2874;762;2522;153;549;296;904;449;1453
355300;201505;1044;3407;855;2998;187;706;281;925;468;1631
355310;201505;1024;3156;858;2833;152;547;444;1469;596;2016
355320;201505;631;1959;539;1749;95;380;208;563;303;943
355330;201505;1803;5715;1304;4744;343;1404;430;1500;773;2904
355340;201505;2608;6868;2375;6478;415;1232;1461;3865;1876;5097
355350;201505;1297;4440;1086;3967;288;1174;342;1166;630;2340
355360;201505;1113;3648;1020;3462;169;615;706;2439;875;3054
355365;201505;272;865;226;775;51;206;65;211;116;417
355370;201505;7371;18341;5318;15817;1442;4708;2305;7028;3747;11736
355380;201505;3425;10339;2644;8529;655;2372;565;1492;1220;3864
355385;201505;860;2729;801;2633;289;1039;265;809;554;1848
355390;201505;838;2352;641;1976;139;485;290;789;429;1274
355395;201505;1854;5567;1397;4551;222;799;606;1805;828;2604
355400;201505;8781;29086;7633;26724;2331;8896;2561;8547;4892;17443
355410;201505;14872;50877;12598;46096;4380;17413;2950;10820;7330;28233
355420;201505;772;2719;709;2580;240;971;215;771;455;1742
355430;201505;3651;10359;3072;9378;582;2002;1602;4698;2184;6700
355440;201505;915;2891;708;2406;139;519;217;652;356;1171
355450;201505;3264;9672;1969;6653;408;1484;603;1878;1011;3362
355460;201505;600;1642;429;1338;83;315;148;385;231;700
355465;201505;398;1221;333;1102;78;286;86;278;164;564
355470;201505;829;2554;680;2272;151;567;296;941;447;1508
355475;201505;129;474;118;442;29;105;53;200;82;305
355480;201505;3163;11345;2947;10913;839;3324;1376;5034;2215;8358
355490;201505;993;2849;665;2180;133;455;128;393;261;848
355495;201505;704;2369;629;2209;136;544;234;780;370;1324
355500;201505;8132;23418;5270;17242;939;3439;1093;3218;2032;6657
355510;201505;2072;5576;1239;3895;213;803;399;1101;612;1904
355520;201505;452;1111;255;729;38;131;105;263;143;394
355530;201505;344;800;147;454;16;55;40;120;56;175
355535;201505;717;2201;575;1937;167;640;147;409;314;1049
355540;201505;8434;26737;7951;25938;2009;7061;4279;13596;6288;20657
355550;201505;766;2288;659;2127;151;564;315;972;466;1536
355560;201505;1319;3908;909;3013;191;738;167;413;358;1151
355570;201505;192;606;147;503;26;92;23;61;49;153
355580;201505;1110;3147;840;2630;192;686;361;1103;553;1789
355590;201505;230;611;192;541;27;82;114;318;141;400
355600;201505;1145;3627;962;3235;382;1395;234;744;616;2139
355610;201505;1418;3963;1196;3606;251;857;562;1624;813;2481
355620;201505;4108;12946;3293;11094;650;2513;1448;4501;2098;7014
355630;201505;3196;9168;1934;6530;369;1387;503;1583;872;2970
355635;201505;948;3104;816;2877;104;430;553;1952;657;2382
355640;201505;3351;10869;2577;9208;558;2251;389;1248;947;3499
355645;201505;3193;11211;2941;10781;506;2033;1845;6801;2351;8834
355650;201505;6542;19938;5598;18154;869;3350;3435;10493;4304;13843
355660;201505;1260;3991;1009;3471;231;968;403;1270;634;2238
355670;201505;2497;7881;1761;6155;380;1560;690;2130;1070;3690
355680;201505;1509;4965;1136;4105;368;1450;256;860;624;2310
355690;201505;409;1285;300;1099;192;751;24;67;216;818
355695;201505;321;965;194;636;11;32;19;37;30;69
355700;201505;5875;19881;5060;18000;1355;5157;1983;6775;3338;11932
355710;201505;11490;28894;7019;20755;1882;6050;1844;5088;3726;11138
355715;201505;265;803;171;590;39;148;33;97;72;245
355720;201505;1526;5007;1264;4436;367;1408;371;1148;738;2556
355730;201505;740;2509;634;2267;214;786;137;485;351;1271
410010;201505;1534;4826;1352;4457;318;1151;369;1175;687;2326
410020;201505;1152;3862;1034;3617;286;1074;409;1374;695;2448
410030;201505;1120;3809;932;3341;250;955;162;572;412;1527
410040;201505;10256;33985;9045;31569;2678;10517;2627;8755;5305;19272
410045;201505;987;2790;684;2190;172;603;200;592;372;1195
410050;201505;2310;6460;1446;4739;400;1392;211;640;611;2032
410060;201505;2201;6899;1954;6419;493;1756;837;2758;1330;4514
410070;201505;1788;5094;1373;4260;458;1580;282;747;740;2327
410080;201505;1243;3742;1034;3338;186;698;480;1443;666;2141
410090;201505;1057;3316;954;3124;259;953;324;1019;583;1972
410100;201505;2569;7840;1871;6207;491;1812;207;632;698;2444
410105;201505;421;1316;281;971;51;217;44;118;95;335
410110;201505;2475;7357;1995;6435;379;1395;690;2130;1069;3525
410115;201505;517;1409;397;1180;59;189;155;431;214;620
410120;201505;2557;8795;2398;8533;792;2989;1044;3758;1836;6747
410130;201505;1198;3853;1064;3534;365;1252;321;1025;686;2277
410140;201505;16409;43530;11007;33732;2496;8531;3296;9801;5792;18332
410150;201505;17274;42862;8410;25098;1706;5588;1487;3927;3193;9515
410160;201505;3026;9457;2716;8930;773;2840;1017;3361;1790;6201
410165;201505;748;2190;599;1877;147;487;254;750;401;1237
410170;201505;2082;6120;1654;5191;506;1777;388;1166;894;2943
410180;201505;9195;29411;7873;26496;1963;7298;3041;9561;5004;16859
410185;201505;574;1581;475;1398;118;356;180;501;298;857
410190;201505;2024;5977;1644;5121;409;1390;356;1000;765;2390
410200;201505;3758;10546;2694;8379;607;2102;357;1002;964;3104
410210;201505;2581;7707;1940;6308;353;1331;440;1179;793;2510
410220;201505;639;1826;468;1484;92;330;137;404;229;734
410230;201505;1507;4813;1305;4436;405;1577;496;1588;901;3165
410240;201505;4395;13351;3957;12440;1124;4061;1194;3600;2318;7661
410250;201505;2507;6994;1723;5364;454;1558;311;863;765;2421
410260;201505;1601;4885;1360;4427;342;1225;521;1638;863;2863
410270;201505;524;1488;411;1273;73;259;165;487;238;746
410275;201505;865;2600;601;2017;90;320;292;976;382;1296
410280;201505;2892;8500;2087;6799;426;1608;457;1348;883;2956
410290;201505;3365;10170;2854;9190;687;2410;1192;3835;1879;6245
410300;201505;675;1891;587;1709;86;288;281;740;367;1028
410302;201505;362;974;248;787;29;100;145;465;174;565
410304;201505;1244;4020;1119;3758;313;1106;448;1552;761;2658
410305;201505;1938;5146;1599;4619;387;1205;913;2633;1300;3838
410310;201505;2174;7128;1941;6710;448;1734;789;2693;1237;4427
410315;201505;632;1847;411;1411;82;306;127;401;209;707
410320;201505;1246;3701;761;2577;107;411;55;154;162;565
410322;201505;590;1771;414;1386;98;330;118;371;216;701
410330;201505;1355;3710;1111;3244;245;780;346;960;591;1740
410335;201505;972;2869;834;2623;186;645;323;965;509;1610
410337;201505;788;2097;584;1698;86;300;232;588;318;888
410340;201505;483;1435;329;1021;41;151;135;366;176;517
410345;201505;1864;5414;1381;4399;357;1243;392;1157;749;2400
410347;201505;726;1961;460;1460;73;276;150;465;223;741
410350;201505;931;2817;650;2224;138;551;100;289;238;840
410360;201505;3423;9799;2802;8701;556;1927;1174;3524;1730;5451
410370;201505;12348;35852;8950;28201;1909;6859;2547;7063;4456;13922
410380;201505;1209;3719;1066;3402;168;625;545;1641;713;2266
410390;201505;2802;8073;2210;6972;754;2590;571;1605;1325;4195
410395;201505;895;2957;791;2736;199;809;344;1144;543;1953
410400;201505;4121;12946;3507;11753;839;3219;1304;4173;2143;7392
410405;201505;961;2777;770;2411;175;634;300;904;475;1538
410410;201505;1278;4159;1214;4063;390;1517;428;1308;818;2825
410420;201505;7789;25320;6549;22491;1931;7205;1263;3855;3194;11060
410425;201505;3325;10545;2389;8411;470;1817;285;931;755;2748
410430;201505;15028;40805;10875;32992;2378;8065;3314;9626;5692;17691
410440;201505;3088;9787;2727;9085;706;2616;1154;3736;1860;6352
410442;201505;2757;9332;2434;8589;755;2818;716;2505;1471;5323
410445;201505;2267;7554;1962;6999;533;2139;702;2579;1235;4718
410450;201505;2195;6235;1704;5282;535;1724;257;680;792;2404
410460;201505;2175;6469;1774;5679;454;1540;591;1781;1045;3321
410465;201505;1925;6584;1600;5843;415;1716;596;1983;1011;3699
410470;201505;1548;4993;1239;4272;295;1172;320;1066;615;2238
410480;201505;29390;83741;20497;65121;5423;18740;3710;10712;9133;29452
410490;201505;10881;34589;8468;29344;2279;8821;2278;7326;4557;16147
410500;201505;1635;5106;1339;4448;489;1805;365;1183;854;2988
410510;201505;2470;6535;1750;5091;368;1141;691;1818;1059;2959
410520;201505;3153;10974;2976;10606;962;3675;1105;3923;2067;7598
410530;201505;1649;4557;1257;3757;241;831;495;1356;736;2187
410540;201505;3189;9332;2148;7156;488;1722;683;2252;1171;3974
410550;201505;6295;18215;4244;13704;867;3160;675;1926;1542;5086
410560;201505;1393;4272;1064;3527;238;883;287;770;525;1653
410570;201505;2608;8381;2331;7899;652;2361;855;3117;1507;5478
410580;201505;22212;68333;18271;60307;5100;18725;4943;15046;10043;33771
410590;201505;1308;4111;782;2640;117;413;143;419;260;832
410600;201505;1931;5652;1560;4920;367;1205;639;2028;1006;3233
410610;201505;777;2296;625;1994;107;400;241;727;348;1127
410620;201505;1574;5466;1171;4410;353;1429;152;543;505;1972
410630;201505;2541;7510;1871;6024;490;1736;390;1074;880;2810
410640;201505;4711;13186;3501;10882;1005;3622;722;2042;1727;5664
410645;201505;1106;3874;1051;3791;477;1866;269;956;746;2822
410650;201505;2310;7105;1854;6123;615;2128;341;1055;956;3183
410655;201505;859;2521;675;2166;152;564;232;709;384;1273
410657;201505;717;2064;514;1623;110;400;186;515;296;915
410660;201505;2434;6996;1414;4665;309;1111;207;574;516;1685
410670;201505;959;2667;672;2062;144;476;194;521;338;997
410680;201505;2749;9268;2220;7927;630;2235;732;2769;1362;5004
410685;201505;651;1878;567;1735;53;167;407;1261;460;1428
410690;201505;110011;318948;75567;246406;17218;61885;16797;48746;34015;110631
410700;201505;2272;6991;2097;6655;586;2019;898;2740;1484;4759
410710;201505;943;2837;663;2173;167;604;187;525;354;1129
410712;201505;817;2482;705;2271;276;974;213;707;489;1681
410715;201505;996;3100;768;2577;165;629;282;884;447;1513
410720;201505;3358;9958;2446;8030;578;2144;611;1848;1189;3992
410725;201505;1068;3000;747;2364;117;377;127;340;244;717
410730;201505;526;1499;439;1340;140;484;118;356;258;840
410740;201505;883;2634;619;2089;116;459;277;933;393;1392
410750;201505;1863;5465;1517;4715;342;1135;473;1374;815;2509
410752;201505;307;857;187;608;37;144;71;201;108;345
410753;201505;450;1310;290;945;58;227;101;288;159;515
410754;201505;1030;3166;895;2935;89;325;595;2014;684;2339
410755;201505;823;2081;639;1789;83;268;382;1041;465;1309
410760;201505;2260;6967;2013;6509;586;2079;689;2135;1275;4214
410765;201505;16306;48398;11780;39179;2377;8933;1446;4370;3823;13303
410770;201505;921;2550;684;2078;200;664;169;475;369;1139
410773;201505;1363;3941;1159;3621;248;913;631;1875;879;2788
410775;201505;1549;4457;1449;4314;344;1080;725;2161;1069;3241
410780;201505;521;1442;373;1175;92;287;141;493;233;780
410785;201505;697;2229;566;1914;210;755;124;407;334;1162
410790;201505;543;1691;442;1455;91;334;85;210;176;544
410800;201505;2828;7103;2175;6050;508;1634;869;2240;1377;3874
410810;201505;316;973;255;835;43;162;109;356;152;518
410820;201505;925;2772;714;2286;183;643;141;398;324;1041
410830;201505;32064;92869;25880;82005;7643;26938;8912;27282;16555;54220
410832;201505;1046;3084;908;2828;128;476;516;1514;644;1990
410840;201505;6803;20060;4477;15030;1182;4301;538;1512;1720;5813
410845;201505;1342;3977;1118;3492;190;678;505;1513;695;2191
410850;201505;2785;8150;2482;7690;548;1962;1264;3867;1812;5829
410855;201505;572;1580;412;1239;95;328;152;395;247;723
410860;201505;3666;10337;2936;8962;546;1814;1250;3733;1796;5547
410865;201505;1627;5586;1518;5372;383;1461;833;3018;1216;4479
410870;201505;1255;3860;1157;3704;493;1671;436;1372;929;3043
410880;201505;4287;13020;3399;11339;771;2847;745;2281;1516;5128
410890;201505;1017;3237;786;2771;193;763;69;209;262;972
410895;201505;1103;3815;980;3518;341;1326;262;852;603;2178
410900;201505;858;2365;621;1961;123;485;206;569;329;1054
410910;201505;415;1106;354;1003;52;169;196;536;248;705
410920;201505;795;2338;636;2047;162;584;248;761;410;1345
410930;201505;1806;5304;1525;4804;372;1417;597;1800;969;3217
410940;201505;20717;67981;18000;62933;5364;20545;6175;21783;11539;42328
410950;201505;1815;6003;1674;5754;300;1074;1063;3690;1363;4764
410960;201505;7223;20034;4643;15123;1445;5185;1093;3395;2538;8580
410965;201505;1033;3169;900;2918;293;1003;355;1121;648;2124
410970;201505;4536;13620;3567;11679;1088;4104;696;2191;1784;6295
410975;201505;1587;4572;1282;4005;224;834;552;1698;776;2532
410980;201505;5603;15737;3337;11060;723;2665;506;1591;1229;4256
410990;201505;866;2524;531;1774;170;626;79;200;249;826
411000;201505;465;1393;326;1075;68;258;59;155;127;413
411005;201505;503;1486;320;1036;77;267;42;104;119;371
411007;201505;2253;7168;1969;6525;606;2153;646;2072;1252;4225
411010;201505;3827;13089;3392;12061;945;3762;664;2121;1609;5883
411020;201505;2572;8071;2296;7600;765;2850;740;2414;1505;5264
411030;201505;674;1832;514;1521;122;415;158;415;280;830
411040;201505;634;1832;308;1004;61;224;74;231;135;455
411050;201505;2126;7443;1885;6902;558;2255;297;984;855;3239
411060;201505;1668;5121;1373;4489;295;1060;192;550;487;1610
411065;201505;374;1124;287;947;56;193;106;336;162;529
411070;201505;5594;17154;4222;14268;1180;4412;717;2151;1897;6563
411080;201505;2157;6558;1917;6111;550;1964;565;1701;1115;3665
411090;201505;769;1874;550;1550;86;310;136;345;222;655
411095;201505;1626;4553;1175;3644;215;753;289;787;504;1540
411100;201505;1397;4049;1021;3295;179;677;183;506;362;1183
411110;201505;722;2139;451;1515;65;241;70;180;135;421
411120;201505;1765;5347;1340;4427;379;1396;408;1245;787;2641
411125;201505;4240;13918;4056;13543;1249;4509;1704;5526;2953;10035
411130;201505;738;2219;571;1850;136;470;171;574;307;1044
411140;201505;2119;7492;1820;6791;632;2467;510;1978;1142;4445
411150;201505;4546;12678;3503;10562;880;2965;713;1790;1593;4755
411155;201505;983;2723;771;2316;160;559;347;948;507;1507
411160;201505;243;708;198;618;37;127;72;205;109;332
411170;201505;692;2251;575;1978;134;508;205;667;339;1175
411180;201505;5741;17140;4727;15230;1165;4178;1593;5033;2758;9211
411190;201505;1466;4163;1209;3679;314;1114;334;873;648;1987
411200;201505;4473;13237;3595;11735;941;3482;1367;4258;2308;7740
411210;201505;2127;6097;1674;5265;573;1948;274;822;847;2770
411220;201505;1160;3286;919;2826;221;800;360;964;581;1764
411230;201505;1227;3439;775;2515;199;730;196;551;395;1281
411240;201505;1339;3228;733;2211;155;495;237;663;392;1158
411250;201505;2511;7335;2060;6522;543;1873;576;1775;1119;3648
411260;201505;304;827;199;640;29;102;95;299;124;401
411270;201505;1788;5680;1604;5335;349;1351;783;2468;1132;3819
411275;201505;1421;4238;1173;3668;312;1045;282;815;594;1860
411280;201505;1540;4553;1119;3666;234;873;237;697;471;1570
411290;201505;806;2291;619;1886;156;498;216;629;372;1127
411295;201505;929;2637;842;2466;147;463;361;1079;508;1542
411300;201505;1281;3276;905;2536;92;290;382;1003;474;1293
411310;201505;852;2382;669;2063;95;339;237;719;332;1058
411320;201505;5661;16493;4158;13557;1132;3892;855;2591;1987;6483
411325;201505;1514;4768;1319;4375;244;882;777;2589;1021;3471
411330;201505;3370;10542;2900;9655;1007;3711;819;2665;1826;6376
411340;201505;926;2717;585;1914;103;389;220;688;323;1077
411342;201505;729;2090;597;1814;152;500;192;512;344;1012
411345;201505;994;3094;898;2906;243;867;424;1373;667;2240
411350;201505;2855;8459;1986;6658;530;1978;243;736;773;2714
411360;201505;552;1374;364;1047;41;152;175;428;216;580
411370;201505;46077;130290;35048;109695;6509;23701;13363;38584;19872;62285
411373;201505;1474;4600;1229;4118;300;1129;323;1070;623;2199
411375;201505;1091;3017;792;2416;171;546;212;588;383;1134
411380;201505;1303;3504;751;2287;122;405;222;630;344;1035
411390;201505;1767;5239;1511;4766;338;1175;541;1611;879;2786
411400;201505;2016;5841;1486;4679;294;1038;390;1120;684;2158
411410;201505;2178;6545;1654;5303;406;1477;423;1133;829;2610
411420;201505;4305;12454;3107;9747;594;2118;540;1317;1134;3435
411430;201505;3109;9732;2613;8847;749;2793;1101;3639;1850;6432
411435;201505;425;1378;345;1167;84;309;143;456;227;765
411440;201505;2619;8470;2348;7934;833;2997;646;2251;1479;5248
411450;201505;2281;6934;2055;6515;444;1471;1131;3639;1575;5110
411460;201505;3300;9726;1866;6324;412;1572;210;589;622;2161
411470;201505;851;2529;561;1834;95;338;95;265;190;603
411480;201505;4412;13247;3293;11074;993;3761;626;1965;1619;5726
411490;201505;1459;4445;1227;4015;341;1261;322;914;663;2175
411500;201505;1874;5110;1308;4069;303;1042;353;1051;656;2093
411510;201505;2131;6331;1695;5440;484;1720;347;950;831;2670
411520;201505;26713;72541;15960;49792;3265;11182;3453;9857;6718;21039
411530;201505;977;2787;664;2183;197;738;103;268;300;1006
411535;201505;520;1560;247;904;40;171;25;74;65;245
411540;201505;2981;8042;2224;6605;342;1129;1091;3166;1433;4295
411545;201505;972;3285;888;3126;164;616;590;2110;754;2726
411550;201505;811;2199;650;1941;240;794;147;417;387;1211
411560;201505;2468;7364;1864;5964;404;1425;340;943;744;2368
411570;201505;6568;17854;4812;14923;1248;4390;1089;3401;2337;7791
411573;201505;892;2697;841;2607;147;489;524;1639;671;2128
411575;201505;1465;4617;1242;4136;246;866;479;1587;725;2453
411580;201505;3948;11221;2605;8435;455;1765;397;1029;852;2794
411585;201505;646;2133;385;1356;94;365;71;228;165;593
411590;201505;424;1295;364;1186;69;257;149;448;218;705
411600;201505;305;903;220;746;48;200;80;258;128;458
411605;201505;2045;5491;1354;4133;234;811;561;1631;795;2442
411610;201505;2193;6083;1892;5622;344;1106;1214;3575;1558;4681
411620;201505;2721;8694;2527;8355;742;2636;1148;3847;1890;6483
411630;201505;457;1187;269;889;50;206;51;155;101;361
411640;201505;499;1479;384;1238;68;234;139;400;207;634
411650;201505;201;653;165;586;40;173;50;155;90;328
411660;201505;830;2328;658;1993;133;443;278;833;411;1276
411670;201505;1237;3443;1035;3016;241;800;407;1094;648;1894
411680;201505;1417;4422;1279;4163;208;669;856;2929;1064;3598
411690;201505;3394;10077;2706;8774;752;2597;605;1974;1357;4571
411695;201505;756;2456;608;2141;153;586;186;654;339;1240
411700;201505;1834;5336;1294;4242;254;943;295;867;549;1810
411705;201505;2136;7254;1873;6724;426;1525;1014;3794;1440;5319
411710;201505;1792;5321;1390;4458;345;1202;337;997;682;2199
411720;201505;824;2413;618;1961;102;360;169;482;271;842
411721;201505;719;2184;616;1987;183;650;102;298;285;948
411722;201505;667;1963;479;1550;101;383;134;358;235;741
411725;201505;1383;4445;865;3103;205;777;169;593;374;1370
411727;201505;1930;5637;1516;4761;359;1233;516;1491;875;2724
411729;201505;544;1471;387;1179;128;419;81;205;209;624
411730;201505;5449;15776;4574;14130;1930;6123;1182;3670;3112;9793
411740;201505;624;1779;407;1274;69;242;144;422;213;664
411745;201505;919;2728;744;2363;164;554;228;702;392;1256
411750;201505;4598;13813;3457;11150;864;3112;788;2369;1652;5481
411760;201505;8022;23567;6935;21668;2275;7763;2002;6185;4277;13948
411770;201505;3390;11513;2845;10188;944;3650;569;1995;1513;5645
411780;201505;2610;8441;2493;8315;182;547;2068;7295;2250;7842
411790;201505;3006;8609;2201;7009;597;2212;714;2176;1311;4388
411800;201505;1437;4140;924;2995;141;526;166;435;307;961
411810;201505;1584;4662;1346;4184;312;1109;460;1268;772;2377
411820;201505;15269;47983;12597;42848;4381;15510;3284;11525;7665;27035
411830;201505;463;1240;375;1115;142;440;21;70;163;510
411840;201505;10210;29722;7685;24843;1978;7028;1725;5370;3703;12398
411845;201505;548;1684;373;1246;57;218;92;266;149;484
411850;201505;6528;19597;5440;17437;1418;4916;1586;5019;3004;9935
411860;201505;890;2763;721;2411;197;685;215;674;412;1359
411870;201505;916;3145;662;2450;104;438;174;611;278;1049
411880;201505;2190;6323;1786;5591;462;1685;438;1200;900;2885
411885;201505;851;2332;681;2007;131;490;225;574;356;1064
411890;201505;1152;3519;743;2523;119;468;114;314;233;782
411900;201505;971;3103;697;2424;182;638;109;379;291;1017
411910;201505;1236;4149;997;3552;306;1184;277;910;583;2094
411915;201505;14184;39706;9332;29694;1925;6744;2209;6431;4134;13175
411920;201505;967;3276;839;2964;228;946;141;412;369;1358
411925;201505;596;1687;395;1310;101;347;110;348;211;695
411930;201505;6089;19916;5391;18595;2041;7491;1429;4884;3470;12375
411940;201505;3323;11071;2875;10132;779;2923;694;2374;1473;5297
411950;201505;11284;35910;9435;32251;2418;9001;4167;13997;6585;22998
411960;201505;5144;15437;4704;14601;1165;4036;2021;6100;3186;10136
411965;201505;606;1720;446;1459;88;340;162;543;250;883
411970;201505;774;2192;622;1954;172;594;216;663;388;1257
411980;201505;1550;4759;1329;4296;243;847;519;1670;762;2517
411990;201505;28305;92998;23817;83434;6673;26070;6682;22868;13355;48938
411995;201505;2586;8036;2227;7318;774;2884;536;1604;1310;4488
412000;201505;2169;5699;1727;4937;292;1011;871;2260;1163;3271
412010;201505;706;2386;571;2076;121;461;119;399;240;860
412015;201505;659;1992;530;1713;102;346;250;803;352;1149
412020;201505;396;1134;268;856;67;242;99;288;166;530
412030;201505;706;2215;478;1677;76;307;123;386;199;693
412033;201505;735;2199;500;1631;98;370;119;346;217;716
412035;201505;1006;2783;700;2208;166;572;271;818;437;1390
412040;201505;603;1916;482;1633;112;413;166;525;278;938
412050;201505;1700;5026;1321;4262;279;1015;279;869;558;1884
412060;201505;6618;22877;5973;21520;1831;7108;2122;7682;3953;14790
412065;201505;903;2717;708;2283;171;628;225;661;396;1289
412070;201505;1200;3263;961;2788;152;479;352;987;504;1466
412080;201505;1349;4156;789;2827;128;533;48;122;176;655
412085;201505;372;1068;152;516;40;151;36;105;76;256
412090;201505;4287;13938;4068;13541;664;2473;2657;8929;3321;11402
412100;201505;2036;6433;1734;5809;521;1902;489;1581;1010;3483
412110;201505;1071;3061;718;2303;158;558;188;587;346;1145
412120;201505;1912;6466;1658;5872;447;1814;637;2055;1084;3869
412125;201505;770;2423;671;2248;149;547;270;879;419;1426
412130;201505;623;1866;461;1503;101;368;101;304;202;672
412135;201505;512;1444;355;1124;81;289;134;389;215;678
412140;201505;1562;4683;1272;4074;320;1094;306;954;626;2048
412150;201505;2987;8651;2538;7760;338;1197;1567;4657;1905;5854
412160;201505;1072;3411;653;2330;160;622;88;270;248;892
412170;201505;4432;13999;3590;12331;1064;3995;1297;4311;2361;8306
412175;201505;1337;4593;1163;4187;320;1294;477;1674;797;2968
412180;201505;1732;5358;1270;4436;328;1299;343;1128;671;2427
412190;201505;3079;8954;2334;7625;632;2265;673;2246;1305;4511
412200;201505;2279;7379;1583;5545;352;1356;502;1716;854;3072
412210;201505;721;2016;417;1376;82;320;55;172;137;492
412215;201505;3655;11300;3308;10681;643;2077;2004;6700;2647;8777
412217;201505;1091;3111;995;2943;134;501;687;1905;821;2406
412220;201505;5379;17821;5135;17375;1547;5465;2688;9122;4235;14587
412230;201505;2882;9604;2493;8826;639;2567;724;2401;1363;4968
412240;201505;9633;24917;5374;16735;1022;3616;942;2550;1964;6166
412250;201505;1902;5603;1625;5029;424;1463;356;936;780;2399
412260;201505;1301;3661;834;2644;136;515;277;784;413;1299
412265;201505;1033;3189;907;2968;189;731;448;1441;637;2172
412270;201505;778;2458;526;1832;113;441;135;432;248;873
412280;201505;607;1899;445;1545;206;762;45;145;251;907
412290;201505;1052;3019;813;2542;158;539;275;790;433;1329
412300;201505;1891;5713;1571;5081;468;1678;383;1191;851;2869
412310;201505;1093;3148;970;2963;121;381;601;1957;722;2338
412320;201505;797;2172;567;1757;138;485;183;552;321;1037
412330;201505;1660;4672;1280;3916;225;783;654;1961;879;2744
412340;201505;883;2757;580;1969;81;302;92;295;173;597
412350;201505;2445;7656;1982;6632;527;1911;269;767;796;2678
412360;201505;288;869;191;625;25;95;68;193;93;288
412370;201505;850;2610;677;2265;179;665;181;572;360;1237
412380;201505;1706;5332;1423;4679;361;1286;423;1322;784;2608
412382;201505;697;1999;481;1544;97;324;126;373;223;697
412385;201505;2451;7641;2157;6977;668;2250;578;1829;1246;4079
412390;201505;2179;6351;1967;5998;548;1878;753;2296;1301;4174
412395;201505;914;2569;731;2265;99;322;433;1332;532;1654
412400;201505;1022;3166;881;2885;256;888;259;865;515;1753
412402;201505;1961;5902;1584;5100;409;1482;377;1032;786;2514
412405;201505;3595;10482;2251;7457;426;1621;246;702;672;2323
412410;201505;4821;15228;4145;13919;1344;5333;846;2609;2190;7942
412420;201505;390;1150;283;907;57;206;106;276;163;482
412430;201505;512;1438;386;1184;66;236;146;409;212;645
412440;201505;3523;10649;2893;9562;566;2043;1136;3787;1702;5830
412450;201505;316;1014;243;831;46;161;34;81;80;242
412460;201505;869;2573;638;2099;147;564;166;490;313;1054
412470;201505;1866;6386;1632;5797;542;2016;527;1902;1069;3918
412480;201505;1353;3966;938;3049;190;657;127;326;317;983
412490;201505;931;2770;809;2514;167;552;252;718;419;1270
412500;201505;1995;5823;1672;5180;382;1335;428;1129;810;2464
412510;201505;2306;7690;1976;6871;546;2053;836;2887;1382;4940
412520;201505;1567;4461;1213;3734;317;1050;306;881;623;1931
412530;201505;674;1959;541;1670;116;361;150;436;266;797
412535;201505;610;1797;384;1256;94;328;78;219;172;547
412540;201505;1196;3462;926;2898;146;531;274;829;420;1360
412545;201505;859;2444;662;2000;106;380;236;598;342;978
412550;201505;27476;82592;18755;62987;4937;17907;3565;11126;8502;29033
412555;201505;326;989;224;746;44;165;43;115;87;280
412560;201505;5290;16739;4169;14381;1012;4013;986;3112;1998;7125
412570;201505;4405;13173;3065;10121;715;2692;576;1770;1291;4462
412575;201505;909;2782;714;2318;164;597;192;569;356;1166
412580;201505;1283;3540;926;2909;196;646;260;768;456;1414
412590;201505;422;1244;289;953;64;241;84;272;148;513
412600;201505;1447;4403;1132;3720;277;1014;351;1072;628;2086
412610;201505;688;2069;481;1537;116;438;150;416;266;854
412620;201505;1192;3860;939;3300;252;993;148;465;400;1458
412625;201505;10837;30206;8154;25056;2043;6855;1526;4262;3569;11117
412627;201505;988;2989;662;2288;207;777;66;205;273;982
412630;201505;3316;10585;2811;9480;672;2391;890;2896;1562;5287
412635;201505;460;1399;305;1039;71;258;22;63;93;321
412640;201505;906;2694;621;2059;124;440;72;193;196;633
412650;201505;1994;5852;1630;5130;382;1388;525;1435;907;2823
412660;201505;2898;8471;2270;7166;461;1640;448;1255;909;2895
412665;201505;648;1672;335;1059;91;298;67;204;158;502
412667;201505;1559;4639;1235;3981;311;1134;256;762;567;1896
412670;201505;674;2095;455;1571;107;423;75;206;182;629
412680;201505;1357;4086;873;2982;164;619;234;715;398;1334
412690;201505;738;2276;552;1863;191;690;110;358;301;1048
412700;201505;1879;5846;1573;5372;566;2183;479;1565;1045;3748
412710;201505;8136;25456;6771;22624;1697;6309;1664;5198;3361;11507
412720;201505;1482;4604;1016;3397;190;694;188;511;378;1205
412730;201505;2281;6789;1457;4880;323;1224;175;426;498;1650
412740;201505;1429;4576;1136;3929;292;1131;222;759;514;1890
412750;201505;3820;11970;3401;11267;563;2210;2153;6995;2716;9205
412760;201505;2319;7625;2204;7432;567;2227;1113;3556;1680;5783
412770;201505;11565;32258;6801;21870;1116;4010;1261;3503;2377;7513
412780;201505;1281;4099;1121;3771;288;1046;390;1235;678;2281
412785;201505;2340;6834;1716;5513;411;1476;783;2435;1194;3911
412788;201505;1437;4623;1288;4314;280;1069;470;1407;750;2476
412790;201505;1179;3547;935;3053;215;785;242;698;457;1483
412795;201505;874;2466;725;2181;189;591;230;675;419;1266
412796;201505;2850;8855;2626;8431;692;2522;1064;3175;1756;5697
412800;201505;3235;9213;2422;7566;494;1733;811;2409;1305;4142
412810;201505;10652;29308;5976;19018;1005;3565;1232;3265;2237;6830
412820;201505;6967;20579;5037;16785;1279;4642;1100;3675;2379;8317
412830;201505;348;1083;279;931;51;215;86;247;137;462
412840;201505;1953;5596;1563;4823;324;1110;366;1042;690;2152
412850;201505;2590;7769;2214;7157;426;1623;966;2926;1392;4549
412853;201505;1550;4408;1385;4119;156;587;815;2235;971;2822
412855;201505;1528;4388;1175;3632;307;1073;321;875;628;1948
412860;201505;1231;3553;1015;3149;222;777;434;1310;656;2087
412862;201505;775;2004;537;1542;87;272;208;553;295;825
412863;201505;1271;4264;1226;4190;188;699;847;2880;1035;3579
412865;201505;699;2154;521;1732;116;404;193;662;309;1066
412870;201505;919;2603;738;2306;246;849;180;526;426;1375
412880;201505;1080;3010;843;2587;214;730;225;614;439;1344
420005;201505;551;1649;362;1219;70;252;129;421;199;673
420010;201505;3231;9468;2639;8576;354;1226;1905;6340;2259;7566
420020;201505;809;2627;474;1728;66;289;55;167;121;456
420030;201505;541;1457;284;962;63;252;44;141;107;393
420040;201505;840;2587;527;1925;127;509;72;200;199;709
420050;201505;725;2218;540;1795;163;571;192;607;355;1178
420055;201505;247;752;157;536;32;118;28;81;60;199
420060;201505;248;843;173;645;45;191;25;82;70;273
420070;201505;1400;4474;1114;3782;184;681;558;1931;742;2612
420075;201505;196;565;108;361;22;86;32;95;54;181
420080;201505;634;2016;503;1741;163;609;122;414;285;1023
420090;201505;543;1858;402;1544;108;451;68;257;176;708
420100;201505;1338;4233;1206;4048;292;1032;694;2335;986;3367
420110;201505;360;1208;318;1117;90;335;130;457;220;792
420120;201505;317;1095;269;996;89;366;63;215;152;581
420125;201505;307;1197;281;1140;93;390;95;359;188;749
420127;201505;549;1648;220;813;67;260;27;96;94;356
420130;201505;1979;6605;1650;5963;425;1693;490;1577;915;3270
420140;201505;5407;15819;3743;12622;973;3664;650;1973;1623;5637
420150;201505;776;2159;464;1518;101;372;157;458;258;830
420160;201505;305;873;193;631;35;128;52;156;87;284
420165;201505;217;686;133;464;25;99;33;102;58;201
420170;201505;213;653;140;508;46;207;19;45;65;252
420180;201505;435;1343;252;911;46;174;49;174;95;348
420190;201505;513;1535;276;985;49;198;45;137;94;335
420195;201505;1442;4163;1145;3700;292;1011;467;1511;759;2522
420200;201505;3012;9751;1895;7111;529;2247;307;1018;836;3265
420205;201505;966;3196;845;2980;197;764;415;1451;612;2215
420207;201505;1517;4459;1045;3461;303;1145;263;777;566;1922
420208;201505;551;1557;334;1157;109;408;97;332;206;740
420209;201505;343;1085;215;772;43;179;71;240;114;419
420210;201505;1637;5006;1034;3903;229;1059;228;800;457;1859
420213;201505;852;3041;807;2933;150;564;514;1913;664;2477
420215;201505;415;1351;281;1013;76;297;46;151;122;448
420220;201505;199;691;177;647;46;197;62;174;108;371
420230;201505;4333;12850;3179;10694;666;2631;1380;4435;2046;7066
420240;201505;12544;34301;7541;24956;1243;5058;3071;9030;4314;14088
420243;201505;617;1889;487;1611;104;402;173;546;277;948
420245;201505;1139;3459;760;2637;164;634;190;575;354;1209
420250;201505;607;1965;572;1905;165;646;251;801;416;1447
420253;201505;569;1516;454;1354;81;255;248;775;329;1030
420257;201505;353;991;219;740;39;142;109;362;148;504
420260;201505;1286;4078;1082;3716;249;975;485;1659;734;2634
420270;201505;522;1608;153;568;27;110;34;109;61;219
420280;201505;2416;6463;1463;4711;287;1100;529;1510;816;2610
420285;201505;156;461;66;240;5;17;4;17;9;34
420287;201505;598;1844;506;1671;134;462;175;575;309;1037
420290;201505;6766;19915;4348;14416;895;3265;1304;3970;2199;7235
420300;201505;6548;19968;4299;15135;985;3846;821;2839;1806;6685
420310;201505;810;2326;746;2226;131;424;498;1442;629;1866
420315;201505;992;3206;791;2790;219;860;303;1048;522;1908
420320;201505;5466;16961;4524;15266;1262;4731;1832;6052;3094;10783
420325;201505;358;1174;336;1128;81;301;128;414;209;715
420330;201505;1116;3886;853;3175;223;923;212;681;435;1604
420340;201505;1496;4631;1132;3797;247;920;216;651;463;1571
420350;201505;1427;4420;1156;3874;293;1047;463;1542;756;2589
420360;201505;3263;10045;2192;7625;593;2339;293;845;886;3184
420370;201505;2001;5596;1613;4977;163;500;1305;4060;1468;4560
420380;201505;5243;16806;3800;13334;993;3852;929;3128;1922;6980
420390;201505;1722;4904;921;3171;192;759;197;556;389;1315
420395;201505;1634;5090;1128;3918;189;753;171;481;360;1234
420400;201505;1377;4027;961;3198;261;1044;260;761;521;1805
420410;201505;805;2150;547;1721;134;472;292;900;426;1372
420415;201505;471;1500;347;1192;117;426;98;319;215;745
420417;201505;791;2514;665;2205;114;397;344;1141;458;1538
420419;201505;410;1259;268;974;115;466;40;136;155;602
420420;201505;12222;36621;9377;30891;2909;10798;2575;7843;5484;18641
420425;201505;1364;3747;879;2763;100;385;359;1013;459;1398
420430;201505;3510;10727;2266;7842;523;2006;741;2501;1264;4507
420435;201505;296;913;202;699;42;176;98;321;140;497
420440;201505;1245;3499;658;2228;261;967;108;333;369;1300
420445;201505;336;1024;289;932;61;202;149;484;210;686
420450;201505;1110;3149;634;2142;120;442;136;392;256;834
420455;201505;2031;6216;1780;5784;355;1400;860;2706;1215;4106
420460;201505;9240;27369;6940;23255;1632;6390;2626;8325;4258;14715
420470;201505;1237;3325;764;2419;193;701;208;592;401;1293
420475;201505;132;401;70;250;20;75;9;27;29;102
420480;201505;4846;14344;3818;12518;1447;5336;527;1604;1974;6940
420490;201505;748;2025;431;1463;115;418;109;348;224;766
420500;201505;1867;5841;1458;5056;450;1746;631;2130;1081;3876
420510;201505;118;478;106;450;43;186;38;155;81;341
420515;201505;119;404;96;357;18;78;17;65;35;143
420517;201505;904;2803;804;2617;143;526;470;1495;613;2021
420519;201505;484;1335;354;1090;58;187;112;321;170;508
420520;201505;678;1727;476;1459;122;428;253;746;375;1174
420530;201505;1189;3940;900;3238;218;889;213;633;431;1522
420535;201505;275;831;157;563;44;181;9;25;53;206
420540;201505;22194;64301;15667;50081;4138;14584;4292;12308;8430;26892
420543;201505;430;1144;317;952;30;109;194;619;224;728
420545;201505;1681;5250;1346;4539;324;1257;442;1369;766;2626
420550;201505;4495;14425;3431;12061;858;3555;782;2410;1640;5965
420555;201505;447;1378;352;1185;103;390;111;345;214;735
420560;201505;566;1636;474;1459;84;272;238;725;322;997
420570;201505;2073;6703;1647;5701;460;1811;535;1717;995;3528
420580;201505;1355;4313;1101;3870;305;1210;478;1643;783;2853
420590;201505;3292;10050;2221;7559;496;1842;397;1192;893;3034
420600;201505;821;2732;747;2566;149;547;352;1249;501;1796
420610;201505;557;1745;336;1237;93;378;72;246;165;624
420620;201505;853;2610;722;2375;223;792;220;713;443;1505
420630;201505;1113;3459;784;2684;176;656;243;731;419;1387
420640;201505;752;2300;360;1346;89;374;29;89;118;463
420650;201505;2483;7236;1447;4958;257;1006;278;818;535;1824
420660;201505;521;1500;417;1306;80;292;193;579;273;871
420665;201505;786;2205;492;1615;81;278;139;409;220;687
420670;201505;1738;5335;1232;4204;243;951;252;745;495;1696
420675;201505;226;691;156;529;31;113;54;170;85;283
420680;201505;537;1304;325;978;64;217;109;302;173;519
420690;201505;896;3096;645;2374;119;452;157;520;276;972
420700;201505;3724;10722;2815;8874;654;2407;877;2585;1531;4992
420710;201505;614;2071;479;1797;142;594;158;567;300;1161
420720;201505;1678;4909;1348;4466;290;1027;824;2758;1114;3785
420730;201505;3502;10502;2847;9329;759;2743;1119;3499;1878;6242
420740;201505;865;2688;711;2399;220;786;333;1100;553;1886
420750;201505;2406;7618;1650;5812;298;1249;506;1551;804;2800
420757;201505;114;301;63;225;13;59;24;76;37;135
420760;201505;346;1065;235;773;47;180;56;150;103;330
420765;201505;588;1848;299;1111;59;246;49;157;108;403
420768;201505;1222;4257;949;3641;311;1267;327;1234;638;2501
420770;201505;711;2038;373;1299;74;307;91;283;165;590
420775;201505;701;2217;448;1533;127;451;96;300;223;751
420780;201505;1664;5048;1056;3535;254;929;202;594;456;1523
420785;201505;328;995;233;748;38;138;76;214;114;352
420790;201505;1354;4670;1066;3957;299;1232;422;1464;721;2696
420800;201505;830;2376;450;1497;134;517;89;258;223;775
420810;201505;2423;8272;1911;7081;611;2583;473;1654;1084;4237
420820;201505;8564;26912;6210;22720;1799;7442;1807;6523;3606;13965
420830;201505;2591;8333;2166;7555;730;2779;755;2575;1485;5354
420840;201505;1044;3054;596;2137;158;639;148;463;306;1102
420845;201505;1370;4273;1029;3623;305;1240;239;763;544;2003
420850;201505;1766;5571;1058;4031;281;1221;149;545;430;1766
420860;201505;502;1414;317;1066;91;357;134;445;225;802
420870;201505;1240;3445;941;3010;321;1201;298;838;619;2039
420880;201505;1191;3964;925;3276;201;792;196;609;397;1401
420890;201505;13349;32393;5891;18721;1053;3753;1650;4501;2703;8254
420895;201505;244;665;123;398;34;107;13;35;47;142
420900;201505;2173;6049;1302;4338;281;1070;319;940;600;2010
420910;201505;21837;65150;14188;49337;2910;11638;4182;13469;7092;25107
420915;201505;585;2291;459;1932;115;530;213;853;328;1383
420917;201505;469;1443;222;714;53;203;83;215;136;418
420920;201505;200;559;89;303;29;102;13;41;42;143
420930;201505;19179;55329;15102;48442;3831;13787;5312;16418;9143;30205
420940;201505;4068;12181;3266;10476;863;3152;729;1948;1592;5100
420945;201505;215;690;137;501;30;130;30;104;60;234
420950;201505;631;1783;284;1066;40;190;35;112;75;302
420960;201505;1128;3268;938;2959;210;800;442;1284;652;2084
420970;201505;2510;8057;2183;7467;604;2333;894;3053;1498;5386
420980;201505;459;1364;339;1164;116;425;132;501;248;926
420985;201505;524;1508;265;941;59;247;75;240;134;487
420990;201505;908;2517;532;1821;103;410;165;501;268;911
421000;201505;586;2001;384;1473;83;355;64;200;147;555
421003;201505;708;1936;274;909;39;143;42;88;81;231
421005;201505;221;690;177;615;47;182;90;305;137;487
421010;201505;6059;17507;4177;14002;1134;4325;981;2895;2115;7220
421020;201505;523;1664;406;1440;69;250;203;760;272;1010
421030;201505;949;3466;875;3282;262;1049;225;844;487;1893
421040;201505;734;2083;571;1809;126;458;270;807;396;1265
421050;201505;2011;5425;1154;3766;282;1040;260;692;542;1732
421055;201505;236;713;135;464;37;139;37;103;74;242
421060;201505;515;1787;378;1392;73;299;132;457;205;756
421070;201505;770;2421;500;1758;118;479;112;373;230;852
421080;201505;540;1639;468;1520;95;321;279;889;374;1210
421085;201505;578;1535;305;1039;66;254;81;289;147;543
421090;201505;423;1190;250;811;42;153;100;297;142;450
421100;201505;952;2746;598;1973;154;516;124;382;278;898
421105;201505;1491;4610;1243;4171;296;1097;477;1623;773;2720
421110;201505;1175;4157;1051;3913;391;1566;269;953;660;2519
421120;201505;1554;4902;1069;3729;179;743;320;981;499;1724
421125;201505;425;1213;313;1010;92;340;110;326;202;666
421130;201505;3552;11609;2972;10534;1029;4088;946;3311;1975;7399
421140;201505;375;1118;290;932;57;197;102;297;159;494
421145;201505;588;1872;401;1359;63;236;167;544;230;780
421150;201505;559;1749;419;1502;100;397;163;581;263;978
421160;201505;1240;3519;630;2115;120;467;230;731;350;1198
421165;201505;289;1003;224;804;42;148;101;368;143;516
421170;201505;1558;4648;1267;4155;274;1004;748;2428;1022;3432
421175;201505;1251;3568;938;3070;218;909;372;1079;590;1988
421180;201505;613;1716;327;1111;79;306;90;260;169;566
421185;201505;426;1193;300;948;55;167;148;488;203;655
421187;201505;318;956;234;779;48;167;111;363;159;530
421189;201505;463;1428;405;1316;85;301;152;466;237;767
421190;201505;11494;33618;7139;24486;1653;6157;1533;4890;3186;11047
421200;201505;987;3272;839;2954;205;806;256;818;461;1624
421205;201505;251;777;187;652;45;190;45;126;90;316
421210;201505;1680;5129;1294;4180;353;1223;371;1130;724;2353
421220;201505;2168;7333;1875;6701;613;2418;468;1617;1081;4035
421223;201505;768;2208;505;1719;125;458;184;610;309;1068
421225;201505;1156;3605;954;3198;220;817;357;1167;577;1984
421227;201505;812;2693;712;2534;156;563;455;1657;611;2220
421230;201505;593;1949;520;1789;133;509;210;667;343;1176
421240;201505;479;1551;276;975;35;149;57;176;92;325
421250;201505;1866;5429;1194;4210;368;1457;277;902;645;2359
421260;201505;388;1116;120;452;25;95;29;102;54;197
421265;201505;602;1942;517;1778;121;439;201;679;322;1118
421270;201505;823;2226;428;1423;114;403;99;358;213;761
421280;201505;1692;5336;1358;4795;426;1683;460;1600;886;3283
421290;201505;1668;4395;887;2848;183;628;181;481;364;1109
421300;201505;312;956;250;824;74;278;100;312;174;590
421310;201505;317;1034;249;860;60;218;78;252;138;470
421315;201505;402;1197;226;813;41;151;24;86;65;237
421320;201505;544;1778;349;1263;60;237;46;118;106;355
421330;201505;569;1885;437;1631;157;665;70;254;227;919
421335;201505;594;1927;474;1698;117;463;99;372;216;835
421340;201505;1782;5239;1467;4719;215;839;897;2829;1112;3668
421350;201505;920;3034;732;2624;175;726;246;807;421;1533
421360;201505;3177;9151;1999;6842;429;1681;587;1831;1016;3512
421370;201505;798;2633;639;2281;184;749;212;704;396;1453
421380;201505;1059;3036;845;2631;163;566;399;1227;562;1793
421390;201505;150;440;79;273;12;38;35;128;47;166
421400;201505;316;1130;241;957;77;336;63;237;140;573
421410;201505;337;968;233;762;33;109;120;393;153;502
421415;201505;358;1181;175;650;45;181;44;144;89;325
421420;201505;946;2876;665;2216;136;501;169;495;305;996
421430;201505;248;782;188;663;38;151;44;152;82;303
421440;201505;913;2617;600;2037;153;586;235;748;388;1334
421450;201505;583;1837;388;1418;97;398;60;191;157;589
421460;201505;651;1768;328;1151;56;238;78;257;134;495
421470;201505;454;1572;363;1363;98;394;144;528;242;922
421480;201505;2825;8126;1687;5945;392;1618;378;1155;770;2773
421490;201505;299;928;136;526;39;171;25;83;64;254
421500;201505;2392;8134;2029;7369;726;2983;406;1402;1132;4385
421505;201505;398;1328;350;1222;80;301;163;552;243;853
421507;201505;606;1861;399;1396;74;270;140;504;214;774
421510;201505;209;699;183;653;37;166;90;277;127;443
421520;201505;861;2286;561;1667;57;222;282;741;339;963
421530;201505;422;1296;242;891;41;188;81;291;122;479
421535;201505;719;2135;412;1484;72;289;188;635;260;924
421540;201505;374;1024;299;888;65;212;123;348;188;560
421545;201505;1036;3418;781;2892;216;935;178;591;394;1526
421550;201505;2024;6602;1724;6046;533;2165;495;1598;1028;3763
421555;201505;345;1042;139;503;25;98;19;64;44;162
421560;201505;232;723;107;383;23;94;23;78;46;172
421565;201505;975;2932;870;2763;323;1153;334;1007;657;2160
421567;201505;884;3242;758;2925;362;1456;148;555;510;2011
421568;201505;537;1693;373;1308;96;352;97;344;193;696
421569;201505;187;581;107;396;26;110;26;86;52;196
421570;201505;1363;4205;728;2632;202;817;148;504;350;1321
421575;201505;510;1704;446;1575;74;290;276;968;350;1258
421580;201505;3664;11579;2788;9641;799;3179;679;2029;1478;5208
421590;201505;239;744;192;652;31;107;103;347;134;454
421600;201505;609;1812;462;1509;125;453;102;293;227;746
421605;201505;635;1918;448;1556;93;387;118;361;211;748
421610;201505;1601;4339;1277;3815;190;656;730;2100;920;2756
421620;201505;4924;14871;3343;11546;989;3715;1072;3694;2061;7409
421625;201505;382;1115;184;635;31;116;48;168;79;284
421630;201505;2826;8404;1573;5408;382;1496;232;674;614;2170
421635;201505;273;827;165;553;23;90;82;253;105;343
421640;201505;1086;3282;828;2748;155;526;410;1341;565;1867
421650;201505;2251;7331;1845;6424;614;2436;294;871;908;3307
421660;201505;8830;28198;6898;24278;1857;7371;2163;7064;4020;14435
421670;201505;1106;3448;771;2688;230;893;212;698;442;1591
421680;201505;1254;4128;1080;3712;375;1384;209;666;584;2050
421690;201505;1929;6303;1471;5187;335;1309;216;678;551;1987
421700;201505;621;1796;329;1125;73;303;94;239;167;542
421710;201505;274;916;153;563;48;186;44;159;92;345
421715;201505;280;756;155;495;42;145;43;123;85;268
421720;201505;1807;5463;1172;4150;383;1510;265;866;648;2376
421725;201505;113;380;104;360;36;140;26;87;62;227
421730;201505;590;1715;273;959;56;215;54;151;110;366
421740;201505;736;2273;498;1712;114;468;100;245;214;713
421750;201505;1197;3302;796;2498;160;559;356;1019;516;1578
421755;201505;360;1091;239;792;54;210;74;219;128;429
421760;201505;658;2162;369;1332;76;312;126;419;202;731
421770;201505;3115;9315;2347;7761;690;2438;759;2502;1449;4940
421775;201505;608;1752;395;1367;85;316;118;382;203;698
421780;201505;1450;4790;1085;3973;310;1276;393;1351;703;2627
421790;201505;947;2581;545;1901;144;591;165;519;309;1110
421795;201505;359;1064;232;748;35;133;70;219;105;352
421800;201505;2698;8181;2020;6871;447;1761;819;2571;1266;4332
421810;201505;734;2328;546;1922;147;546;77;254;224;800
421820;201505;1180;3442;764;2597;131;501;183;541;314;1042
421825;201505;1522;4976;1420;4738;233;926;869;2766;1102;3692
421830;201505;2627;9006;2391;8537;553;2257;1160;4012;1713;6269
421835;201505;154;456;113;394;26;117;65;208;91;325
421840;201505;377;1235;297;1046;74;297;101;326;175;623
421850;201505;485;1423;301;1022;77;295;82;273;159;568
421860;201505;368;1130;231;832;39;147;47;149;86;296
421870;201505;4807;13577;3281;10505;940;3237;629;1921;1569;5158
421875;201505;443;1321;195;732;44;193;34;116;78;309
421880;201505;985;3072;758;2575;176;694;198;611;374;1305
421885;201505;333;1071;269;946;80;302;91;304;171;606
421890;201505;985;3317;835;3001;261;1076;270;915;531;1991
421895;201505;374;1233;334;1156;73;251;194;699;267;950
421900;201505;812;2512;613;2049;173;611;166;496;339;1107
421910;201505;548;1717;388;1361;77;313;109;334;186;647
421915;201505;576;1726;380;1261;78;270;101;291;179;561
421917;201505;581;1748;439;1505;125;516;155;486;280;1002
421920;201505;813;2282;539;1906;233;873;182;639;415;1512
421930;201505;3457;9355;2056;6830;515;1928;388;1145;903;3073
421935;201505;796;2694;609;2276;143;618;214;748;357;1366
421940;201505;277;949;164;616;30;135;33;91;63;226
421950;201505;4173;11572;2126;7205;557;2018;359;1180;916;3198
421960;201505;240;737;189;622;48;171;48;139;96;310
421970;201505;2248;6470;1460;4757;522;1804;324;957;846;2761
421985;201505;511;1315;271;831;48;173;81;257;129;430
422000;201505;980;2908;800;2573;194;670;340;1119;534;1789
430003;201505;861;2506;668;2167;187;688;203;631;390;1319
430005;201505;288;915;238;810;45;164;131;437;176;601
430010;201505;2179;5968;1613;4982;405;1314;650;2035;1055;3349
430020;201505;796;2002;660;1808;77;244;467;1228;544;1472
430030;201505;1125;2940;846;2439;284;901;177;456;461;1357
430040;201505;11951;30953;9461;26783;2815;8488;2552;6983;5367;15471
430045;201505;756;2083;595;1757;108;345;318;924;426;1269
430047;201505;275;685;163;496;24;67;69;211;93;278
430050;201505;1183;3185;695;2189;134;459;186;541;320;1000
430055;201505;311;862;183;571;29;101;86;256;115;357
430057;201505;72;160;26;70;5;13;6;11;11;24
430060;201505;16215;52230;14073;48428;3959;14445;6532;22798;10491;37243
430063;201505;1040;3061;841;2642;218;715;412;1323;630;2038
430064;201505;1624;4759;1329;4260;351;1165;599;1945;950;3110
430066;201505;176;439;130;368;12;43;76;201;88;244
430070;201505;601;1608;242;781;53;188;67;185;120;373
430080;201505;719;2100;474;1631;106;408;141;443;247;851
430085;201505;780;2113;529;1671;123;442;199;608;322;1050
430087;201505;1050;3187;986;3078;125;436;699;2124;824;2560
430090;201505;887;2336;327;1076;43;168;58;190;101;358
430100;201505;939;2508;561;1719;156;529;166;445;322;974
430105;201505;920;2806;666;2315;189;746;191;624;380;1370
430107;201505;265;879;194;674;40;151;57;182;97;333
430110;201505;1897;5456;1598;4994;449;1507;701;2133;1150;3640
430120;201505;1713;5087;1312;4251;265;910;695;2214;960;3124
430130;201505;4051;10581;3525;9811;686;2071;1875;5150;2561;7221
430140;201505;1281;3878;885;3007;256;891;287;952;543;1843
430150;201505;878;2328;585;1784;148;488;155;454;303;942
430155;201505;458;1319;286;961;38;134;115;382;153;516
430160;201505;16461;48501;14955;46050;2861;9830;8389;25770;11250;35600
430163;201505;1875;5606;1550;5009;289;1046;757;2467;1046;3513
430165;201505;459;1139;141;463;30;107;40;119;70;226
430170;201505;911;2565;384;1352;69;247;58;171;127;418
430175;201505;971;3062;782;2608;198;608;333;1205;531;1813
430180;201505;964;2616;789;2327;172;574;423;1193;595;1767
430185;201505;789;1969;406;1232;60;188;116;300;176;488
430187;201505;681;2027;518;1676;126;478;180;526;306;1004
430190;201505;1795;5354;1561;4900;316;1135;888;2731;1204;3866
430192;201505;196;595;88;279;6;19;21;58;27;77
430195;201505;326;993;85;300;9;32;6;22;15;54
430200;201505;1725;5499;1454;4928;422;1518;348;1153;770;2671
430205;201505;517;1477;390;1242;47;180;266;830;313;1010
430210;201505;6631;17806;3609;11413;731;2496;772;2243;1503;4739
430215;201505;369;1041;250;786;49;164;104;308;153;472
430220;201505;788;1974;309;1003;47;165;56;173;103;338
430222;201505;304;908;235;760;38;155;107;325;145;480
430223;201505;350;1016;306;951;65;202;188;609;253;811
430225;201505;47;126;27;83;6;16;8;20;14;36
430230;201505;1910;5895;1785;5769;204;505;1539;5177;1743;5682
430235;201505;280;918;220;773;59;229;54;171;113;400
430237;201505;532;1408;393;1160;44;157;252;719;296;876
430240;201505;993;2606;658;2023;144;529;273;780;417;1309
430245;201505;954;2979;735;2510;184;645;340;1198;524;1843
430250;201505;1416;3971;1241;3668;503;1574;293;856;796;2430
430258;201505;167;473;123;392;12;44;52;166;64;210
430260;201505;855;2408;582;1858;63;219;311;1024;374;1243
430265;201505;340;1039;264;874;70;229;32;91;102;320
430270;201505;2968;8348;2586;7720;441;1583;1516;4266;1957;5849
430280;201505;4668;12904;3851;11428;913;2854;1778;5258;2691;8112
430290;201505;2509;6667;2291;6380;182;518;1968;5549;2150;6067
430300;201505;9651;28591;7857;25146;2245;7682;3160;10348;5405;18030
430310;201505;7155;22075;5843;19572;1578;5772;2262;7187;3840;12959
430320;201505;886;2570;588;1961;116;339;285;1013;401;1352
430330;201505;792;2108;621;1776;170;501;271;712;441;1213
430340;201505;790;1985;445;1469;83;313;216;713;299;1026
430350;201505;6409;19920;5412;17796;1913;6636;1830;5881;3743;12517
430355;201505;369;914;143;430;31;102;21;48;52;150
430360;201505;1103;2883;919;2543;167;519;449;1159;616;1678
430367;201505;316;820;197;609;45;157;60;179;105;336
430370;201505;509;1455;384;1212;111;391;88;239;199;630
430380;201505;885;2268;468;1495;123;424;165;535;288;959
430390;201505;4553;13080;3206;10315;764;2640;755;2335;1519;4975
430400;201505;1457;3481;1010;2787;308;924;390;984;698;1908
430410;201505;714;1902;531;1591;99;313;263;797;362;1110
430420;201505;4082;11747;3154;9711;827;2674;1299;3929;2126;6603
430430;201505;843;2295;531;1702;152;522;141;435;293;957
430435;201505;2017;5477;1557;4652;345;1118;766;2260;1111;3378
430440;201505;4329;13459;3379;11364;636;2265;1653;5755;2289;8020
430450;201505;7850;21973;6132;18617;2199;7068;1469;4458;3668;11526
430460;201505;29187;86182;22385;73863;6246;22507;7586;24864;13832;47371
430461;201505;511;1384;163;509;26;87;37;110;63;197
430462;201505;313;897;230;749;84;302;58;176;142;478
430463;201505;4159;13241;3604;12202;820;3040;1778;6034;2598;9074
430465;201505;657;1780;552;1599;127;413;308;854;435;1267
430466;201505;3740;10408;3310;9734;641;2117;1915;5471;2556;7588
430467;201505;590;1749;509;1613;105;367;238;721;343;1088
430468;201505;1491;4224;1307;3950;446;1456;459;1352;905;2808
430469;201505;277;782;70;254;9;41;16;51;25;92
430470;201505;7740;20618;5444;16692;1617;5367;1079;3198;2696;8565
430471;201505;841;2763;756;2587;247;872;183;645;430;1517
430480;201505;1083;2854;567;1805;82;276;137;382;219;658
430485;201505;227;657;109;372;20;73;36;121;56;194
430490;201505;469;1327;325;1059;86;297;120;393;206;690
430495;201505;406;1196;258;883;49;184;58;178;107;362
430500;201505;1372;3797;1099;3329;330;1129;461;1348;791;2477
430510;201505;20750;61742;16894;54326;5856;20693;4900;14718;10756;35411
430511;201505;459;1382;199;684;21;81;30;84;51;165
430512;201505;1241;3219;1072;2929;278;798;382;1077;660;1875
430513;201505;772;2099;498;1516;96;298;223;680;319;978
430515;201505;517;1520;383;1235;66;217;194;628;260;845
430517;201505;1381;4381;1169;3941;234;818;680;2301;914;3119
430520;201505;1659;4628;1185;3652;317;1073;432;1236;749;2309
430530;201505;1002;2809;529;1708;87;324;142;414;229;738
430535;201505;2211;6832;1728;5816;403;1558;612;1980;1015;3538
430537;201505;519;1624;440;1462;56;181;314;1068;370;1249
430540;201505;791;1773;527;1417;97;275;311;821;408;1096
430543;201505;546;1411;480;1343;95;294;347;975;442;1269
430544;201505;712;2258;592;2001;121;439;309;1022;430;1461
430545;201505;1330;4254;1145;4030;381;1379;540;2028;921;3407
430550;201505;697;2030;452;1508;107;397;148;479;255;876
430558;201505;88;256;43;150;15;65;6;14;21;79
430560;201505;425;1054;249;746;29;98;82;234;111;332
430570;201505;1188;3029;762;2202;193;658;313;780;506;1438
430580;201505;1313;3398;768;2432;209;708;236;753;445;1461
430583;201505;162;446;54;181;4;15;3;11;7;26
430585;201505;372;973;244;702;64;212;105;266;169;478
430587;201505;227;687;193;622;57;196;66;219;123;415
430590;201505;1379;3846;1307;3733;200;637;945;2675;1145;3312
430593;201505;27;105;24;94;6;32;10;33;16;65
430595;201505;265;722;93;321;18;73;16;52;34;125
430597;201505;357;1034;256;799;45;160;77;202;122;362
430600;201505;2243;6073;1299;3985;260;853;412;1220;672;2073
430605;201505;1375;4172;1093;3601;241;882;448;1490;689;2372
430607;201505;818;2017;597;1679;97;286;354;1015;451;1301
430610;201505;8834;23521;6722;20182;1802;5926;2358;7045;4160;12971
430613;201505;267;652;117;353;28;74;26;67;54;141
430620;201505;772;2221;602;1862;150;516;252;722;402;1238
430630;201505;472;1433;236;778;48;155;36;106;84;261
430632;201505;759;2081;435;1351;81;296;201;571;282;867
430635;201505;709;1941;516;1573;108;362;249;747;357;1109
430637;201505;516;1481;454;1355;65;233;290;828;355;1061
430640;201505;1735;4577;768;2481;72;234;102;220;174;454
430642;201505;514;1352;310;978;57;192;122;376;179;568
430645;201505;239;604;101;308;17;52;26;86;43;138
430650;201505;1922;6260;1654;5723;333;1179;965;3428;1298;4607
430655;201505;202;575;170;509;33;111;71;176;104;287
430660;201505;5836;16495;4576;14276;1181;4036;1825;5653;3006;9689
430670;201505;515;1514;462;1411;36;109;350;1106;386;1215
430673;201505;717;1713;365;1110;84;269;139;412;223;681
430675;201505;293;854;130;419;24;85;48;145;72;230
430676;201505;3619;10904;3056;9924;849;2959;1075;3513;1924;6472
430680;201505;1162;3428;827;2697;170;626;287;829;457;1455
430690;201505;4502;12679;3588;10898;1135;3598;1117;3447;2252;7045
430692;201505;312;1029;225;856;27;107;142;535;169;642
430693;201505;1455;4044;975;3047;174;654;275;769;449;1423
430695;201505;554;1571;388;1225;84;310;149;414;233;724
430697;201505;487;1378;374;1183;111;343;142;483;253;826
430700;201505;9823;25462;4623;15246;878;3221;356;1121;1234;4342
430705;201505;304;923;267;861;83;292;77;223;160;515
430710;201505;1863;4737;1401;3962;307;945;586;1678;893;2623
430720;201505;928;2280;618;1832;164;533;230;679;394;1212
430730;201505;1773;4712;1247;3841;320;978;527;1706;847;2684
430740;201505;596;1653;346;1136;94;330;59;179;153;509
430745;201505;547;1537;301;926;54;188;61;160;115;348
430750;201505;1817;4978;1440;4327;303;1008;693;1989;996;2997
430755;201505;585;1548;374;1099;41;144;165;431;206;575
430760;201505;3316;8108;2317;6668;461;1514;1067;3188;1528;4702
430770;201505;6852;19701;5334;16915;1031;3585;2766;8688;3797;12273
430780;201505;2540;6711;1484;4672;299;1032;471;1421;770;2453
430781;201505;593;1715;410;1348;97;336;126;396;223;732
430783;201505;571;1401;382;1090;74;242;183;478;257;720
430786;201505;86;278;62;212;11;38;24;82;35;120
430790;201505;4685;12774;3166;9705;697;2407;1215;3438;1912;5845
430800;201505;872;2534;582;1851;124;426;198;595;322;1021
430805;201505;527;1455;370;1169;50;152;200;656;250;808
430807;201505;424;1222;284;905;58;220;81;236;139;456
430810;201505;767;2106;379;1238;62;228;66;184;128;412
430820;201505;1251;3891;871;2936;211;773;249;793;460;1566
430825;201505;441;1181;197;606;31;102;63;161;94;263
430830;201505;2160;6538;1979;6270;251;849;1416;4509;1667;5358
430840;201505;995;3044;901;2865;226;735;429;1407;655;2142
430843;201505;107;314;55;183;12;43;18;56;30;99
430845;201505;346;1040;279;900;107;369;30;86;137;455
430850;201505;2901;8608;2453;7773;618;2143;938;2900;1556;5043
430860;201505;1036;2819;562;1868;166;644;151;444;317;1088
430865;201505;693;1829;634;1733;220;630;301;799;521;1429
430870;201505;719;2015;399;1331;107;370;91;279;198;649
430880;201505;1295;3637;939;2935;286;971;249;798;535;1769
430885;201505;233;612;144;471;24;86;76;246;100;332
430890;201505;1850;4850;1277;3752;114;398;500;1365;614;1763
430900;201505;3033;8002;2568;7209;543;1779;1346;3565;1889;5344
430905;201505;1077;3056;667;2162;177;624;157;480;334;1104
430910;201505;1631;4837;1161;3861;277;1026;461;1420;738;2446
430912;201505;535;1520;433;1344;59;216;267;813;326;1029
430915;201505;523;1675;363;1346;112;441;96;377;208;818
430920;201505;15627;47798;13841;44460;3318;11639;7856;24680;11174;36319
430925;201505;120;303;68;209;17;61;32;96;49;157
430930;201505;9744;28313;6876;22720;1901;6785;1946;6601;3847;13386
430940;201505;1252;3750;764;2552;129;493;207;637;336;1130
430950;201505;1243;3440;836;2599;188;653;316;896;504;1549
430955;201505;151;457;75;246;17;61;21;69;38;130
430957;201505;282;947;228;843;55;220;108;404;163;624
430960;201505;1408;3878;1179;3488;346;1127;471;1425;817;2552
430965;201505;1511;4389;1309;4048;84;316;1073;3290;1157;3606
430970;201505;561;1556;335;1080;69;245;91;279;160;524
430975;201505;667;2149;520;1803;89;331;265;917;354;1248
430980;201505;453;1133;274;863;71;256;96;267;167;523
430990;201505;620;1960;456;1559;119;433;108;333;227;766
430995;201505;639;1873;520;1634;181;595;190;582;371;1177
431000;201505;1768;4556;913;2822;185;644;116;295;301;939
431010;201505;2815;7969;1720;5740;348;1326;430;1258;778;2584
431020;201505;12926;31734;8343;23550;2071;6044;2439;6885;4510;12929
431030;201505;384;1123;201;690;49;191;45;147;94;338
431033;201505;2455;7212;2177;6799;546;1810;1119;3553;1665;5363
431036;201505;217;568;86;301;15;53;17;50;32;103
431040;201505;1023;2892;804;2525;201;715;384;1162;585;1877
431041;201505;567;1559;506;1474;140;407;243;746;383;1153
431043;201505;397;1276;285;1013;131;513;76;233;207;746
431046;201505;121;342;86;268;14;48;30;88;44;136
431050;201505;1855;4651;1420;3932;308;953;792;2132;1100;3085
431053;201505;644;2111;533;1871;161;617;145;520;306;1137
431055;201505;708;1923;651;1829;49;145;495;1394;544;1539
431057;201505;398;1162;238;816;52;188;66;217;118;405
431060;201505;5921;17291;5428;16618;1556;4688;2845;9096;4401;13784
431065;201505;549;1548;413;1263;70;247;197;562;267;809
431070;201505;757;2200;452;1522;94;333;94;280;188;613
431075;201505;295;893;204;696;34;127;61;214;95;341
431080;201505;624;1977;496;1698;117;461;115;374;232;835
431085;201505;956;2540;758;2185;124;396;467;1316;591;1712
431087;201505;635;1810;553;1650;75;217;363;1092;438;1309
431090;201505;547;1334;261;789;81;254;59;169;140;423
431100;201505;4053;11251;3298;9947;851;2769;1264;3824;2115;6593
431110;201505;1611;4241;1192;3406;246;751;530;1436;776;2187
431112;201505;632;1971;595;1911;167;552;293;921;460;1473
431113;201505;521;1508;397;1257;113;377;104;336;217;713
431115;201505;1466;4245;1281;3928;232;755;791;2414;1023;3169
431120;201505;2754;8479;2167;7307;613;2338;817;2585;1430;4923
431123;201505;530;1525;377;1229;78;278;204;675;282;953
431125;201505;1409;4288;1038;3492;310;1044;281;1016;591;2060
431127;201505;237;624;59;194;5;14;5;12;10;26
431130;201505;3638;10310;2720;8665;608;2181;1020;3205;1628;5386
431140;201505;4496;11100;2395;7518;419;1496;560;1496;979;2992
431142;201505;544;1601;481;1486;47;153;327;1029;374;1182
431150;201505;1207;3561;918;2990;202;721;354;1143;556;1864
431160;201505;1024;3002;864;2679;157;499;423;1406;580;1905
431162;201505;523;1369;245;824;33;135;35;94;68;229
431164;201505;166;466;50;185;14;53;3;9;17;62
431170;201505;788;2198;557;1765;155;517;166;513;321;1030
431171;201505;858;2537;731;2284;248;817;194;582;442;1399
431173;201505;509;1490;452;1384;105;340;263;807;368;1147
431175;201505;1127;3158;964;2894;307;978;348;1037;655;2015
431177;201505;909;2936;742;2608;243;955;315;1064;558;2019
431179;201505;366;794;85;250;11;39;19;41;30;80
431180;201505;2359;6820;1646;5305;389;1346;408;1204;797;2550
431190;201505;749;1969;393;1276;78;282;87;279;165;561
431198;201505;396;1308;352;1222;153;555;82;294;235;849
431200;201505;373;1054;110;380;20;63;3;10;23;73
431205;201505;338;1030;179;612;36;115;60;209;96;324
431210;201505;780;2137;660;1921;180;521;356;1058;536;1579
431213;201505;266;802;217;710;55;209;85;260;140;469
431215;201505;334;979;170;577;28;91;16;42;44;133
431217;201505;214;651;164;539;52;181;50;164;102;345
431220;201505;1009;2639;648;1914;84;272;337;919;421;1191
431225;201505;1353;3890;1131;3504;232;758;616;1918;848;2676
431230;201505;909;2621;680;2160;82;287;373;1146;455;1433
431235;201505;112;318;35;108;7;24;7;18;14;42
431237;201505;526;1566;417;1407;120;471;188;621;308;1092
431238;201505;43;136;33;111;9;35;10;32;19;67
431240;201505;2930;8815;2538;8171;859;2969;769;2445;1628;5414
431242;201505;381;1208;339;1132;102;361;91;311;193;672
431244;201505;437;1035;280;776;48;157;144;368;192;525
431245;201505;1131;2984;836;2446;118;367;518;1512;636;1879
431247;201505;205;606;155;506;52;174;48;158;100;332
431250;201505;1656;5217;1441;4918;413;1523;659;2266;1072;3789
431260;201505;378;1063;201;681;45;185;59;178;104;363
431261;201505;233;812;202;739;37;161;72;245;109;406
431262;201505;414;1119;181;592;25;107;75;238;100;345
431265;201505;1482;3868;824;2501;166;565;221;552;387;1117
431267;201505;165;465;135;411;25;92;80;233;105;325
431270;201505;2732;7015;1883;5641;509;1671;735;2224;1244;3895
431275;201505;235;720;130;468;32;117;19;56;51;173
431280;201505;287;807;119;407;20;82;24;62;44;144
431290;201505;365;1147;279;940;66;260;59;171;125;431
431295;201505;113;312;59;178;5;18;28;79;33;97
431300;201505;366;921;59;217;13;48;3;7;16;55
431301;201505;260;801;122;413;29;102;21;64;50;166
431303;201505;786;2065;466;1405;80;291;150;409;230;700
431306;201505;2270;5992;1534;4657;187;700;475;1223;662;1923
431308;201505;44;148;40;137;24;87;11;36;35;123
431310;201505;783;2331;491;1682;105;371;145;519;250;890
431320;201505;938;2553;503;1644;110;406;125;375;235;781
431330;201505;2753;6823;1296;4122;372;1325;132;367;504;1692
431333;201505;462;1218;210;620;40;129;66;167;106;296
431335;201505;66;190;50;150;14;43;12;24;26;67
431337;201505;2484;7585;1865;6289;455;1649;385;1206;840;2855
431339;201505;690;1899;472;1430;85;274;212;630;297;904
431340;201505;28072;73952;20196;60413;4736;15608;6103;17687;10839;33295
431342;201505;591;1527;486;1350;146;444;246;649;392;1093
431344;201505;412;1130;301;931;22;63;198;628;220;691
431346;201505;349;892;161;487;37;116;37;107;74;223
431349;201505;717;2068;487;1522;109;347;157;486;266;833
431350;201505;4130;12169;3425;10886;702;2550;1592;4864;2294;7414
431360;201505;756;1964;511;1550;133;433;150;456;283;889
431365;201505;1236;3674;1051;3363;300;1041;488;1594;788;2635
431370;201505;5264;14935;4199;13112;1175;3963;1429;4478;2604;8441
431380;201505;1015;3125;947;2982;136;458;644;2006;780;2464
431390;201505;3269;8639;2004;6225;418;1476;582;1613;1000;3089
431395;201505;1280;3825;1092;3517;260;950;543;1693;803;2643
431400;201505;297;934;157;550;43;163;20;50;63;213
431402;201505;1322;3122;753;2122;152;459;375;1024;527;1483
431403;201505;287;834;204;686;56;208;37;118;93;326
431405;201505;4497;12572;3612;11286;770;2778;1797;5432;2567;8210
431406;201505;827;2530;614;2067;179;646;267;879;446;1525
431407;201505;603;1754;398;1325;103;346;100;299;203;645
431410;201505;15017;43714;10635;35121;3312;12191;1619;5272;4931;17463
431413;201505;225;556;106;336;11;38;41;123;52;161
431415;201505;785;2204;588;1847;138;507;245;693;383;1200
431417;201505;675;1666;539;1472;75;205;313;878;388;1083
431420;201505;1483;4129;1304;3853;270;836;670;2097;940;2933
431430;201505;553;1459;358;1072;68;209;121;326;189;535
431440;201505;25022;70869;20640;63746;6042;19831;7798;24861;13840;44692
431442;201505;147;413;97;289;20;64;13;25;33;89
431445;201505;508;1433;222;705;33;106;82;248;115;354
431446;201505;493;1436;355;1158;77;254;146;482;223;736
431447;201505;744;2086;531;1650;106;361;232;720;338;1081
431449;201505;859;2384;676;2061;74;250;413;1267;487;1517
431450;201505;2197;5569;1959;5217;344;1003;1377;3597;1721;4600
431454;201505;61;210;50;184;13;49;19;73;32;122
431455;201505;733;1863;392;1120;118;337;104;280;222;617
431460;201505;3536;9806;3011;8806;861;2579;1031;3115;1892;5694
431470;201505;1960;5755;1537;4823;396;1227;602;1946;998;3173
431475;201505;179;518;42;164;7;28;3;11;10;39
431477;201505;733;1928;495;1461;63;196;283;814;346;1010
431478;201505;270;691;104;309;24;72;22;57;46;129
431480;201505;3054;8449;2269;7036;599;2050;849;2516;1448;4566
431490;201505;114878;313557;98595;289219;13065;45121;68283;195395;81348;240516
431500;201505;833;2207;611;1787;120;345;316;916;436;1261
431505;201505;506;1231;376;1051;35;90;277;799;312;889
431507;201505;353;862;241;650;40;111;151;392;191;503
431510;201505;2175;5974;1740;5205;393;1277;769;2200;1162;3477
431513;201505;293;793;131;419;25;85;62;195;87;280
431514;201505;104;263;37;125;4;18;2;5;6;23
431515;201505;776;2255;532;1656;102;371;196;508;298;879
431517;201505;84;268;75;245;23;79;24;67;47;146
431520;201505;481;1353;277;887;41;145;70;216;111;361
431530;201505;4417;10529;3375;9315;1136;3372;1155;3365;2291;6737
431531;201505;299;851;194;633;42;144;74;242;116;386
431532;201505;522;1468;448;1308;123;379;181;522;304;901
431535;201505;377;1012;187;566;32;103;58;151;90;254
431540;201505;2188;7139;1932;6769;224;731;1325;4957;1549;5688
431545;201505;308;841;54;181;5;20;8;32;13;52
431550;201505;2381;6969;2114;6493;408;1432;1058;3158;1466;4590
431555;201505;735;1885;586;1651;123;344;345;990;468;1334
431560;201505;19801;60243;14540;49833;3957;15034;3877;13789;7834;28823
431570;201505;5425;15164;4800;14182;1344;4088;2388;7175;3732;11263
431575;201505;450;1147;315;921;50;177;92;235;142;412
431580;201505;697;1978;443;1419;95;350;153;437;248;787
431590;201505;1002;2734;646;2009;86;270;285;891;371;1161
431595;201505;514;1482;406;1257;78;238;188;582;266;820
431600;201505;2191;6236;1567;5035;338;1291;359;1007;697;2298
431610;201505;1583;4675;1220;3957;267;895;521;1700;788;2595
431620;201505;466;1402;245;799;63;214;101;309;164;523
431630;201505;1523;4070;1033;3076;284;879;388;1138;672;2017
431640;201505;6212;17958;5569;16966;1200;4154;3067;9216;4267;13370
431642;201505;525;1434;421;1245;60;206;205;583;265;789
431643;201505;177;449;147;398;20;64;73;171;93;235
431645;201505;1858;5340;1609;4931;314;1024;938;2875;1252;3899
431647;201505;184;532;124;387;29;96;26;67;55;163
431650;201505;297;920;210;747;35;143;48;143;83;286
431660;201505;1237;3460;776;2498;180;635;194;543;374;1178
431670;201505;1365;3638;1032;3035;230;759;456;1271;686;2030
431673;201505;232;659;138;458;29;108;32;94;61;202
431675;201505;644;1744;191;639;32;114;40;103;72;217
431680;201505;10367;28089;7635;23158;2062;6741;2180;6634;4242;13375
431690;201505;26323;73354;20762;64298;5877;19582;7878;24916;13755;44498
431695;201505;133;421;94;322;22;82;22;47;44;129
431697;201505;472;1342;414;1232;105;318;193;588;298;906
431700;201505;1639;4612;1384;4116;257;814;761;2212;1018;3026
431710;201505;13154;38167;10702;34024;3437;11784;2952;9739;6389;21523
431720;201505;7480;20619;5783;17376;1254;4176;2439;7154;3693;11330
431725;201505;12;35;9;29;1;4;4;11;5;15
431730;201505;4023;11928;3190;10384;895;3240;905;3006;1800;6246
431740;201505;5446;15380;4418;13493;1479;5000;955;2661;2434;7661
431750;201505;10008;28217;8562;25898;1826;6001;4342;13412;6168;19413
431755;201505;324;861;67;233;11;39;11;33;22;72
431760;201505;3945;11492;3191;10094;760;2630;1111;3350;1871;5980
431770;201505;2164;5776;1789;5182;363;1108;1011;2892;1374;4000
431775;201505;230;629;164;505;62;211;29;73;91;284
431780;201505;2527;6791;1925;5677;516;1640;484;1336;1000;2976
431790;201505;1286;3958;1075;3549;205;725;617;2082;822;2807
431795;201505;434;1208;280;859;47;158;100;297;147;455
431800;201505;9201;27012;7317;23407;2271;7903;1631;4955;3902;12858
431805;201505;329;793;98;333;12;48;18;63;30;111
431810;201505;3704;10231;2907;8625;552;1787;1361;3970;1913;5757
431820;201505;2750;8541;2374;7792;534;1916;950;3010;1484;4926
431830;201505;11174;27729;8685;24023;2527;7583;3360;9316;5887;16899
431840;201505;2838;8457;2448;7780;628;2186;1112;3530;1740;5716
431842;201505;816;2038;386;1155;64;222;107;272;171;494
431843;201505;349;1019;296;925;37;127;162;497;199;624
431844;201505;246;678;127;424;24;92;34;101;58;193
431845;201505;535;1576;441;1381;44;149;287;908;331;1057
431846;201505;455;1344;383;1224;55;205;242;762;297;967
431848;201505;230;628;128;429;22;81;23;70;45;151
431849;201505;436;1069;98;298;23;75;18;38;41;113
431850;201505;5087;14737;4455;13541;1097;3565;1843;5534;2940;9099
431860;201505;843;2228;627;1858;89;310;351;989;440;1299
431861;201505;97;300;59;212;9;31;7;23;16;54
431862;201505;472;1538;380;1350;118;471;87;278;205;749
431870;201505;20139;57192;15410;48731;4001;13898;5022;15624;9023;29522
431880;201505;4520;13463;3598;11535;867;3065;1478;4617;2345;7682
431890;201505;5447;14694;4105;12369;1294;4154;1216;3717;2510;7871
431900;201505;1131;3241;770;2517;212;802;289;834;501;1636
431910;201505;1038;2461;486;1399;89;266;162;428;251;694
431912;201505;627;1776;483;1505;146;436;161;536;307;972
431915;201505;1480;3989;1125;3370;267;869;439;1302;706;2171
431920;201505;1398;3874;1244;3648;131;364;997;2969;1128;3333
431930;201505;1363;3730;1015;3164;250;768;495;1645;745;2413
431935;201505;75;232;60;201;17;66;22;65;39;131
431936;201505;409;1196;312;979;50;148;165;552;215;700
431937;201505;339;874;191;574;45;147;38;96;83;243
431940;201505;2736;7404;1769;5489;434;1460;484;1440;918;2900
431950;201505;1718;5253;1480;4834;302;1102;674;2104;976;3206
431960;201505;3216;9395;2828;8645;729;2393;974;2930;1703;5323
431970;201505;516;1406;267;853;39;146;72;205;111;351
431971;201505;120;337;91;288;16;51;34;93;50;144
431973;201505;495;1717;432;1585;55;208;271;1042;326;1250
431975;201505;95;210;16;61;5;23;3;10;8;33
431980;201505;1452;4198;1210;3716;289;980;412;1186;701;2166
431990;201505;8331;22898;6279;19491;1159;4179;2285;6656;3444;10835
432000;201505;10704;30033;8400;26001;2628;8603;3015;9268;5643;17871
432010;201505;2383;6800;1961;6028;441;1456;916;2774;1357;4230
432020;201505;2424;5968;1897;5275;228;708;1345;3714;1573;4422
432023;201505;561;1612;376;1208;89;327;119;342;208;669
432026;201505;1316;3924;972;3191;158;540;540;1765;698;2305
432030;201505;428;1247;326;1021;66;211;152;453;218;664
432032;201505;600;1549;401;1179;74;241;191;520;265;761
432035;201505;850;2624;749;2435;130;470;471;1515;601;1985
432040;201505;975;2308;484;1506;106;379;131;360;237;739
432045;201505;239;724;150;544;35;138;56;213;91;351
432050;201505;695;1941;595;1755;98;298;350;1061;448;1359
432055;201505;889;2669;716;2319;141;495;419;1324;560;1819
432057;201505;431;1089;330;915;39;113;223;592;262;705
432060;201505;508;1386;205;701;42;162;45;136;87;298
432065;201505;230;654;179;562;44;153;68;200;112;353
432067;201505;1005;3122;728;2509;153;553;372;1288;525;1841
432070;201505;2451;6683;1643;5061;416;1439;415;1151;831;2590
432080;201505;3887;11116;3325;10110;1019;3291;1215;3659;2234;6950
432085;201505;327;918;218;737;48;185;111;372;159;557
432090;201505;1550;4494;1238;3844;418;1393;432;1252;850;2645
432100;201505;1315;3804;681;2305;150;535;94;239;244;774
432110;201505;2774;8324;2089;6904;552;2047;295;841;847;2888
432120;201505;5302;15649;4480;14219;1660;5634;1425;4490;3085;10124
432130;201505;2594;7223;2079;6549;666;2275;873;2772;1539;5047
432132;201505;458;1294;233;783;26;98;86;273;112;371
432135;201505;726;2246;694;2184;94;333;513;1582;607;1915
432140;201505;2159;6756;1732;5939;432;1563;758;2676;1190;4239
432143;201505;1452;4285;1219;3895;261;851;631;2103;892;2954
432145;201505;1125;3468;701;2457;145;560;122;377;267;937
432146;201505;233;742;164;579;39;151;42;142;81;293
432147;201505;674;2118;504;1746;134;484;179;655;313;1139
432149;201505;371;1070;224;716;55;184;91;296;146;480
432150;201505;3891;10870;2867;9010;679;2363;908;2707;1587;5070
432160;201505;4429;14001;3870;13072;1212;4302;1528;5366;2740;9668
432162;201505;411;995;86;279;13;48;19;54;32;102
432163;201505;406;1075;95;300;5;17;8;23;13;40
432166;201505;747;2203;609;1918;93;347;313;935;406;1282
432170;201505;1014;3206;652;2395;127;468;121;422;248;890
432180;201505;3054;8045;2093;6398;588;1921;607;1829;1195;3750
432183;201505;439;1372;356;1205;157;558;73;241;230;799
432185;201505;938;2531;575;1846;115;400;248;783;363;1183
432190;201505;3480;9516;2376;7086;600;1890;684;1875;1284;3765
432195;201505;1280;3497;1058;3177;142;477;710;2093;852;2570
432200;201505;3401;10165;2713;8984;688;2486;1233;4147;1921;6633
432210;201505;451;1236;340;1058;74;275;160;461;234;736
432215;201505;899;2770;767;2557;141;444;474;1681;615;2125
432218;201505;299;800;220;648;41;124;82;214;123;338
432220;201505;4320;11337;3549;10158;362;1219;2371;6694;2733;7913
432225;201505;71;222;60;204;26;92;16;52;42;144
432230;201505;1130;3040;678;2050;165;546;200;497;365;1043
432232;201505;557;1601;433;1361;104;364;178;545;282;909
432234;201505;431;1175;286;847;70;212;95;264;165;476
432235;201505;80;235;45;157;11;53;6;16;17;69
432237;201505;483;1343;443;1281;21;86;352;995;373;1081
432240;201505;14557;46470;12301;43412;2207;9027;7205;26135;9412;35162
432250;201505;5091;17373;4632;16455;1711;6667;1453;5150;3164;11817
432252;201505;404;1162;298;979;64;229;161;529;225;758
432253;201505;1344;4248;916;3179;257;945;204;687;461;1632
432254;201505;811;2186;233;764;52;184;30;84;82;268
432255;201505;240;617;131;435;35;122;40;129;75;251
432260;201505;7737;19394;5372;15508;1220;3633;2236;6684;3456;10317
432270;201505;2654;7862;2230;7132;619;2022;912;3015;1531;5037
432280;201505;1331;3682;689;2257;113;394;158;450;271;844
432285;201505;183;585;57;201;13;54;10;26;23;80
432290;201505;602;1782;391;1296;91;308;130;422;221;730
432300;201505;24138;71826;21278;66959;4406;15059;11975;37345;16381;52404
432310;201505;858;2518;689;2231;139;509;373;1175;512;1684
432320;201505;258;659;129;403;27;82;27;77;54;159
432330;201505;317;843;128;430;17;60;11;33;28;93
432335;201505;216;625;95;327;21;78;9;26;30;104
432340;201505;371;921;178;544;35;113;59;174;94;287
432345;201505;683;1893;625;1798;90;335;382;1009;472;1344
432350;201505;440;1181;244;802;50;175;75;224;125;399
432360;201505;165;501;32;112;8;36;9;22;17;58
432370;201505;462;1297;364;1104;35;103;241;750;276;853
432375;201505;828;2096;649;1810;90;264;390;1107;480;1371
432377;201505;175;562;50;164;7;25;15;34;22;59
432380;201505;847;2869;752;2688;298;1190;265;866;563;2056
500020;201505;2313;6969;1748;5914;417;1657;680;2153;1097;3810
500025;201505;1219;2929;784;2171;104;293;444;1207;548;1500
500060;201505;6759;19877;5390;17637;749;2528;3517;11979;4266;14507
500070;201505;4191;12175;3476;10952;729;2655;1587;4900;2316;7555
500080;201505;1640;4794;1207;4019;337;1248;432;1465;769;2713
500085;201505;2277;5989;1652;5049;191;647;969;2848;1160;3495
500090;201505;2408;6889;1810;5816;375;1262;877;2890;1252;4152
500100;201505;2590;7624;2305;7146;580;2110;1076;3151;1656;5261
500110;201505;8672;25274;6935;22589;1116;3905;3766;13019;4882;16924
500124;201505;2048;6516;1772;6066;328;1064;1010;3792;1338;4856
500150;201505;1443;3618;1052;2993;215;732;474;1162;689;1894
500190;201505;5000;12903;3889;11455;743;2355;2212;6667;2955;9022
500200;201505;2583;6465;1965;5412;356;1090;970;2598;1326;3688
500210;201505;4920;14581;4127;13342;913;3156;2046;6713;2959;9869
500215;201505;1667;5065;1339;4427;242;895;545;1725;787;2620
500220;201505;2947;9262;2436;8358;510;1882;949;3321;1459;5203
500230;201505;2705;6897;2040;5923;503;1603;908;2671;1411;4274
500240;201505;4809;14871;3432;12060;553;2110;1320;4916;1873;7026
500260;201505;2737;7043;2034;5921;318;1022;1001;2765;1319;3787
500270;201505;122334;313831;78113;237654;19656;64879;18731;56277;38387;121156
500280;201505;1422;3846;1191;3539;117;370;886;2678;1003;3048
500290;201505;4282;10180;2606;7612;618;2065;841;2237;1459;4302
500295;201505;2634;7812;1771;5799;329;1192;452;1274;781;2466
500310;201505;842;2183;709;1991;159;520;342;896;501;1416
500315;201505;3193;9866;2672;9082;446;1569;1684;5922;2130;7491
500320;201505;16730;53145;13377;46899;4029;15207;4292;15891;8321;31098
500325;201505;4117;10631;3027;8919;653;2115;1517;4398;2170;6513
500330;201505;6539;17482;4913;14539;974;3161;2425;7063;3399;10224
500345;201505;2232;5879;1746;5105;283;934;993;2849;1276;3783
500348;201505;2411;6881;2114;6409;161;585;1615;4861;1776;5446
500350;201505;1274;3847;785;2732;111;418;238;853;349;1271
500370;201505;23485;71041;17755;60338;4095;15607;5599;19008;9694;34615
500375;201505;2942;8048;2172;6585;529;1714;751;2268;1280;3982
500380;201505;2961;8377;2466;7525;757;2398;906;2803;1663;5201
500390;201505;606;1277;382;968;37;118;269;643;306;761
500400;201505;1343;4056;1010;3269;237;848;271;787;508;1635
500410;201505;2303;6421;1828;5716;495;1721;825;2558;1320;4279
500430;201505;2539;7295;2009;6537;418;1542;920;3072;1338;4614
500440;201505;1411;3837;1073;3297;210;722;538;1595;748;2317
500450;201505;1987;6039;1508;5113;311;1208;294;852;605;2060
500460;201505;3652;11059;2891;9598;795;2947;704;2265;1499;5212
500470;201505;3008;8884;2121;6947;557;2027;318;924;875;2951
500480;201505;1983;6340;1846;6160;172;567;1515;5199;1687;5766
500490;201505;1017;2810;800;2437;231;787;247;744;478;1531
500500;201505;3645;11337;2863;10137;1124;4534;814;2833;1938;7367
500510;201505;861;2222;548;1675;80;279;242;671;322;950
500515;201505;1890;5027;1558;4585;259;761;915;2940;1174;3701
500520;201505;3059;10417;2724;9923;478;1877;1701;6338;2179;8215
500525;201505;1202;3832;968;3375;212;826;437;1565;649;2391
500540;201505;6128;16977;3597;12114;1021;4037;556;1627;1577;5664
500560;201505;4731;15455;4297;14806;606;2319;3097;10690;3703;13009
500568;201505;4061;10298;2835;8479;589;2049;1193;3368;1782;5417
500570;201505;7586;20230;5061;15522;1389;4594;1307;3843;2696;8437
500580;201505;3695;10520;2951;9274;315;1060;2071;6546;2386;7606
500600;201505;3758;10086;2540;7812;581;1962;936;2852;1517;4814
500620;201505;7717;21745;5766;18145;1187;4139;2647;8361;3834;12500
500625;201505;746;2249;459;1597;103;402;124;409;227;811
500627;201505;504;1459;392;1263;78;256;124;428;202;684
500630;201505;6199;16888;4557;14174;1224;4256;1488;4476;2712;8732
500635;201505;2607;9996;2174;9309;321;1284;1364;6443;1685;7727
500640;201505;1658;3975;1269;3425;98;311;939;2506;1037;2817
500660;201505;18822;54019;14627;47147;4202;15282;4886;15583;9088;30865
500690;201505;2971;8456;2373;7676;926;3114;810;2865;1736;5979
500710;201505;3713;11010;3150;10073;664;2411;1563;4920;2227;7331
500720;201505;5940;15887;3851;12208;1059;3686;1067;3273;2126;6959
500730;201505;991;2764;703;2190;171;606;232;683;403;1289
500740;201505;3938;10869;3191;9474;471;1686;1422;4216;1893;5902
500750;201505;884;2484;794;2366;154;464;503;1562;657;2026
500755;201505;1241;3606;858;2798;191;701;248;680;439;1381
500769;201505;5077;13522;3113;9451;591;2045;746;1877;1337;3922
500770;201505;1787;5245;1336;4412;363;1344;412;1376;775;2720
500780;201505;1042;3062;860;2719;231;806;306;886;537;1692
500790;201505;9276;25749;7777;23159;1403;4866;4313;12354;5716;17220
500793;201505;2320;6675;1820;5826;441;1559;592;1708;1033;3267
500795;201505;2514;7311;2137;6797;260;702;1600;5397;1860;6099
500797;201505;873;2346;629;1932;105;353;239;692;344;1045
500800;201505;2764;7533;2160;6705;843;2965;667;2093;1510;5058
500830;201505;18139;49490;12486;38569;2762;9439;3942;11554;6704;20993
500840;201505;1402;3916;994;3115;136;468;458;1400;594;1868
510010;201505;1220;3755;1059;3481;310;1025;510;1741;820;2766
510020;201505;3303;9458;2131;7079;495;1791;637;1981;1132;3772
510025;201505;8136;23673;6697;21120;1586;5613;2712;8004;4298;13617
510030;201505;1808;4963;1494;4467;364;1238;661;1831;1025;3069
510035;201505;870;2471;691;2219;119;382;418;1379;537;1761
510040;201505;1729;4721;1331;4133;250;878;707;2187;957;3065
510050;201505;1921;5590;1390;4581;376;1356;441;1434;817;2790
510060;201505;1563;4469;1177;3750;252;851;439;1352;691;2203
510080;201505;1146;3538;896;3058;274;1037;199;608;473;1645
510100;201505;677;1813;475;1418;56;184;214;603;270;787
510120;201505;326;682;192;515;19;53;116;317;135;370
510125;201505;3201;8408;2508;7175;454;1611;1063;2800;1517;4411
510130;201505;1920;5192;1559;4623;399;1250;594;1761;993;3011
510140;201505;3001;9582;2402;8647;959;3848;562;1800;1521;5648
510160;201505;1372;4592;1272;4462;135;548;978;3424;1113;3972
510170;201505;5696;17078;4661;15272;927;3406;2212;7009;3139;10415
510180;201505;12014;31453;8529;25950;2440;7826;2838;9531;5278;17357
510185;201505;1396;4080;1149;3761;164;500;771;2771;935;3271
510190;201505;2207;6568;1545;5555;375;1487;669;2484;1044;3971
510250;201505;14189;43299;12103;40271;3604;13006;5158;17599;8762;30605
510260;201505;2294;9135;2016;8555;637;2863;810;3803;1447;6666
510263;201505;4341;11580;3115;9566;786;2587;954;2801;1740;5388
510267;201505;5691;16386;4114;13078;964;3350;1234;3686;2198;7036
510268;201505;870;2517;735;2326;160;538;393;1247;553;1785
510269;201505;1012;3084;772;2623;252;887;216;740;468;1627
510270;201505;2672;8550;2334;7910;417;1475;1162;3970;1579;5445
510279;201505;2006;6204;1707;5614;502;1810;536;1594;1038;3404
510285;201505;1405;4148;1104;3620;289;1031;408;1279;697;2310
510300;201505;3383;9946;2829;9146;219;820;2201;7158;2420;7978
510305;201505;1543;4750;1213;4113;313;1159;380;1262;693;2421
510310;201505;864;2609;723;2349;236;828;238;734;474;1562
510320;201505;3842;11128;2965;9480;855;3170;647;1891;1502;5061
510325;201505;5357;16970;4594;15940;1099;3924;2929;10459;4028;14383
510330;201505;2877;9105;2346;8157;589;2310;854;2921;1443;5231
510335;201505;4872;14713;4032;13625;559;1852;2879;10281;3438;12133
510336;201505;579;1760;457;1526;97;356;231;757;328;1113
510337;201505;2168;7093;1807;6402;706;2538;511;1980;1217;4518
510340;201505;68529;193704;52339;168382;19124;67813;11238;37660;30362;105473
510343;201505;1094;3214;964;3037;91;290;760;2459;851;2749
510345;201505;1676;4956;1381;4423;323;1102;496;1510;819;2612
510350;201505;3526;9687;2745;8594;682;2272;1328;4329;2010;6601
510360;201505;1813;4491;1187;3724;140;529;823;2523;963;3052
510370;201505;1071;3695;945;3504;214;845;573;2159;787;3004
510380;201505;546;1653;379;1313;137;518;50;144;187;662
510385;201505;983;3630;732;3049;117;508;342;1541;459;2049
510390;201505;1135;3462;1041;3348;269;704;656;2359;925;3063
510395;201505;849;2128;656;1867;109;349;301;974;410;1323
510410;201505;3919;12791;3517;12018;873;3141;1862;6459;2735;9600
510420;201505;2424;6230;1776;5151;222;797;940;2671;1162;3468
510450;201505;600;1630;444;1396;107;390;179;550;286;940
510452;201505;639;2050;446;1616;101;406;183;642;284;1048
510454;201505;875;2801;752;2578;117;410;480;1715;597;2125
510455;201505;982;3010;730;2495;154;610;237;762;391;1372
510460;201505;2247;5922;1762;5243;244;902;1081;3070;1325;3972
510480;201505;4616;12321;3294;9879;809;2542;795;2208;1604;4750
510490;201505;1439;4655;1271;4399;258;1044;776;2600;1034;3644
510500;201505;1546;4595;1069;3653;270;1065;438;1440;708;2505
510510;201505;2792;9702;2428;9061;818;3344;901;3301;1719;6645
510515;201505;6346;19429;4884;16221;1163;4320;1245;3873;2408;8193
510517;201505;1791;5287;1493;4768;498;1671;536;1728;1034;3399
510520;201505;2144;5095;1558;4350;77;253;1142;3296;1219;3549
510523;201505;1048;3123;911;2899;152;503;594;1932;746;2435
510525;201505;7916;20277;5225;16055;1118;3633;1976;6032;3094;9665
510530;201505;543;1539;458;1422;69;293;273;798;342;1091
510550;201505;2581;8523;2173;7770;626;2432;797;2833;1423;5265
510558;201505;2039;5855;1695;5355;390;1365;823;2632;1213;3997
510560;201505;1715;5386;1172;4447;354;1479;289;1112;643;2591
510562;201505;5374;16005;4269;13787;1270;4580;1272;4102;2542;8682
510590;201505;2955;7807;2393;7097;577;1781;1208;3682;1785;5463
510600;201505;1584;4069;1060;3217;193;642;455;1294;648;1936
510610;201505;2818;8055;2410;7486;183;650;1931;6038;2114;6688
510615;201505;2350;7160;1981;6575;586;2086;939;3163;1525;5249
510617;201505;604;1818;494;1620;50;163;372;1264;422;1427
510618;201505;1442;4200;1037;3407;204;783;469;1474;673;2257
510619;201505;814;2248;496;1661;83;315;82;229;165;544
510620;201505;1496;3684;829;2677;233;848;151;446;384;1294
510621;201505;996;3457;883;3216;235;950;306;1053;541;2003
510622;201505;3886;11771;2675;9153;679;2549;365;1001;1044;3550
510623;201505;3557;10119;2865;8886;787;2630;1189;3572;1976;6202
510624;201505;1356;4058;986;3338;202;779;331;1010;533;1789
510625;201505;2286;6533;1783;5677;482;1696;422;1281;904;2977
510626;201505;1568;4215;1039;3475;320;1201;373;1261;693;2462
510627;201505;771;2174;510;1630;128;453;129;405;257;858
510628;201505;1638;4047;1187;3438;116;375;885;2564;1001;2939
510629;201505;1868;5985;1533;5260;450;1728;515;1694;965;3422
510630;201505;2571;8635;1975;7420;559;2392;433;1624;992;4016
510631;201505;404;1142;364;1078;51;157;254;743;305;900
510637;201505;2748;7950;2369;7339;618;2075;1071;3290;1689;5365
510642;201505;4811;15726;4161;14789;1229;4766;1886;6962;3115;11728
510645;201505;961;2169;614;1699;196;539;204;606;400;1145
510650;201505;6252;21025;5723;20388;1139;4068;3952;14769;5091;18837
510665;201505;1331;3636;905;2827;230;756;299;904;529;1660
510670;201505;407;932;224;670;29;113;100;278;129;391
510675;201505;6419;20314;5202;17924;1559;6084;1305;4253;2864;10337
510677;201505;2222;5797;1740;5179;221;677;1266;3930;1487;4607
510680;201505;786;2361;625;2046;129;460;229;690;358;1150
510682;201505;2324;7226;1793;6236;465;1825;460;1504;925;3329
510685;201505;954;2548;794;2331;74;253;585;1696;659;1949
510700;201505;4358;11342;2998;9396;654;2121;1553;5013;2207;7134
510704;201505;9041;24234;7492;21768;1512;4922;4042;11505;5554;16427
510706;201505;1889;5734;1375;4920;322;1177;721;2670;1043;3847
510710;201505;3535;9843;2528;7800;649;2118;643;1757;1292;3875
510715;201505;690;1714;429;1236;91;289;158;416;249;705
510718;201505;2150;5520;1515;4820;651;2149;512;1723;1163;3872
510719;201505;457;1035;283;804;33;136;127;330;160;466
510720;201505;1328;3128;991;2726;210;654;572;1537;782;2191
510724;201505;818;2483;678;2220;152;562;340;1044;492;1606
510726;201505;653;1721;497;1465;107;340;186;510;293;850
510729;201505;778;1957;486;1449;120;403;195;577;315;980
510730;201505;2510;7577;2084;6826;566;2087;760;2356;1326;4443
510735;201505;1141;3760;899;3365;217;917;431;1600;648;2517
510740;201505;1141;2814;830;2359;203;565;444;1324;647;1889
510757;201505;669;2278;558;2050;175;672;212;799;387;1471
510760;201505;29214;77093;20727;62908;6133;20223;6008;17916;12141;38139
510770;201505;4430;11532;3816;10816;393;1053;2621;8341;3014;9394
510774;201505;434;1187;363;1078;78;271;169;519;247;790
510775;201505;784;2250;656;2046;225;766;221;677;446;1443
510776;201505;515;1439;409;1232;88;288;198;592;286;880
510777;201505;1648;4851;1224;4270;178;658;912;3232;1090;3890
510779;201505;712;2091;524;1742;86;309;234;797;320;1106
510780;201505;3775;11271;3160;10313;777;2627;1451;4964;2228;7591
510785;201505;1887;5417;1465;4714;495;1683;384;1256;879;2939
510787;201505;2141;6500;1714;5749;636;2240;393;1247;1029;3487
510788;201505;514;1375;378;1165;173;525;93;323;266;848
510790;201505;15852;46082;10760;36351;2579;10025;1279;4103;3858;14128
510792;201505;7317;22420;5195;18256;1153;4637;1076;3486;2229;8123
510794;201505;1260;3961;1036;3560;382;1439;293;919;675;2358
510795;201505;8835;26774;6493;22256;1811;6819;1605;5578;3416;12397
510800;201505;1725;4812;1385;4344;347;1215;604;1763;951;2978
510805;201505;1932;5453;1590;4959;170;546;1190;3751;1360;4297
510810;201505;694;1690;537;1485;139;394;261;696;400;1090
510820;201505;779;1849;535;1485;99;326;216;531;315;857
510830;201505;640;2051;543;1903;159;598;259;982;418;1580
510835;201505;660;2000;495;1668;140;534;178;540;318;1074
510840;201505;50161;122609;39175;108681;8814;25786;20176;57845;28990;83631
510850;201505;1480;4232;1104;3591;374;1359;191;489;565;1848
510860;201505;2498;8125;1856;6782;683;2714;130;453;813;3167
510880;201505;695;2283;598;2117;182;695;267;977;449;1672
510885;201505;623;1747;501;1586;83;302;225;718;308;1020
510890;201505;866;2722;704;2458;221;879;254;785;475;1664
510895;201505;1117;3471;951;3154;262;996;403;1261;665;2257
520005;201505;1261;4112;1148;3938;335;1190;526;1853;861;3043
520010;201505;1718;5784;1420;5154;549;2285;296;954;845;3239
520013;201505;3766;10346;2817;8637;645;2083;1102;3356;1747;5439
520015;201505;492;1393;394;1246;103;350;159;509;262;859
520017;201505;1118;3343;945;3062;254;909;376;1132;630;2041
520020;201505;398;1063;311;938;72;233;148;449;220;682
520025;201505;25300;79597;24306;78455;2414;8270;20337;66012;22751;74282
520030;201505;4581;14471;3927;13446;906;3396;1911;6616;2817;10012
520050;201505;336;915;275;812;26;78;195;579;221;657
520055;201505;777;2346;660;2114;127;397;343;1135;470;1532
520060;201505;1434;4448;1228;4037;260;982;507;1592;767;2574
520080;201505;1736;5230;1494;4892;342;1096;845;2916;1187;4012
520082;201505;914;2717;816;2560;147;416;513;1730;660;2146
520085;201505;968;2967;825;2689;176;598;275;888;451;1486
520090;201505;964;2254;716;1932;161;394;376;1087;537;1481
520110;201505;42219;122818;32907;108710;12177;45614;7328;23615;19505;69229
520120;201505;262;672;155;485;35;131;37;111;72;242
520130;201505;3526;10034;3207;9563;794;2595;1652;4884;2446;7479
520140;201505;43385;140358;37991;130370;13405;50325;9030;30222;22435;80547
520145;201505;432;1133;331;986;78;247;139;399;217;646
520150;201505;653;1747;537;1612;135;435;284;847;419;1282
520160;201505;817;2331;672;2111;213;707;201;631;414;1338
520170;201505;4045;9556;3228;8634;300;830;2594;7076;2894;7906
520180;201505;2021;5979;1669;5412;397;1502;683;2135;1080;3637
520215;201505;1931;5000;1637;4550;227;658;1041;2932;1268;3590
520235;201505;762;2000;574;1726;139;470;257;736;396;1206
520250;201505;1321;4067;1069;3636;302;1128;417;1430;719;2558
520260;201505;789;2024;550;1584;82;249;243;674;325;923
520280;201505;535;1582;494;1525;189;619;176;611;365;1230
520310;201505;1122;2726;851;2340;211;575;384;1160;595;1735
520320;201505;1772;5540;1457;4924;155;553;908;3140;1063;3693
520330;201505;2755;8476;2106;7365;629;2470;415;1345;1044;3815
520340;201505;1843;4640;1410;4111;195;505;1034;3175;1229;3680
520350;201505;3058;8572;2467;7471;644;2206;1081;3125;1725;5331
520355;201505;1099;3692;998;3531;349;1342;395;1349;744;2691
520357;201505;783;2144;667;1964;50;164;497;1454;547;1618
520360;201505;661;1916;593;1804;119;374;290;912;409;1286
520380;201505;1304;3515;882;2715;165;547;358;1082;523;1629
520390;201505;1022;2500;636;1983;173;653;247;681;420;1334
520393;201505;574;1460;470;1307;66;190;307;850;373;1040
520396;201505;740;2362;629;2146;79;312;435;1489;514;1801
520400;201505;1717;4884;1468;4541;234;792;969;2976;1203;3768
520410;201505;1512;3795;1127;3277;263;837;613;1763;876;2600
520420;201505;336;942;250;768;49;165;78;214;127;379
520425;201505;1212;3307;1052;3024;284;872;554;1575;838;2447
520430;201505;2085;5450;1346;4101;300;1033;461;1262;761;2295
520440;201505;3652;9391;2508;7436;788;2574;618;1820;1406;4394
520450;201505;10428;29375;7463;23916;1874;6589;1026;2996;2900;9585
520455;201505;680;2035;553;1818;183;659;177;586;360;1245
520460;201505;870;2499;705;2220;137;494;351;1063;488;1557
520465;201505;797;2229;686;2094;120;414;423;1277;543;1691
520470;201505;1792;5794;1613;5513;359;1225;1043;3726;1402;4951
520480;201505;961;2768;750;2437;136;481;383;1206;519;1687
520485;201505;1256;3977;1084;3689;301;1147;577;1947;878;3094
520490;201505;3882;12212;3119;10991;971;3577;1360;4910;2331;8487
520495;201505;1271;3556;1100;3337;96;297;922;2841;1018;3138
520500;201505;1481;4195;1308;3939;387;1227;590;1777;977;3004
520505;201505;851;2402;729;2225;170;540;409;1268;579;1808
520510;201505;10477;29240;7241;23966;1947;7129;2021;6743;3968;13872
520520;201505;1071;2997;856;2681;271;893;319;1017;590;1910
520530;201505;2143;6933;1820;6384;554;1992;710;2648;1264;4640
520540;201505;3017;8541;2315;7239;631;2107;573;1729;1204;3836
520545;201505;1152;3473;957;3080;225;784;312;956;537;1740
520547;201505;741;2353;640;2169;239;860;211;681;450;1541
520549;201505;9645;27853;7951;25751;2349;8015;3985;13039;6334;21054
520551;201505;3512;10644;3250;10298;852;2919;1980;6279;2832;9198
520552;201505;800;2457;742;2376;120;426;498;1607;618;2033
520570;201505;537;1552;389;1290;155;550;82;254;237;804
520580;201505;3196;8177;2213;6742;646;2239;835;2450;1481;4689
520590;201505;1450;4056;1157;3570;277;884;324;933;601;1817
520620;201505;7204;22766;6554;21813;1462;5176;3909;13141;5371;18317
520630;201505;771;2015;566;1709;126;389;265;800;391;1189
520640;201505;2786;7853;2321;7099;689;2221;968;3041;1657;5262
520650;201505;830;2299;641;1937;162;550;303;898;465;1448
520660;201505;357;1068;291;963;97;352;98;313;195;665
520670;201505;883;2676;808;2568;50;143;706;2287;756;2430
520680;201505;631;1781;513;1616;134;441;239;766;373;1207
520690;201505;398;1026;280;854;60;163;127;424;187;587
520710;201505;527;1354;328;964;5;10;188;547;193;557
520725;201505;1706;4330;1284;3690;274;855;732;2087;1006;2942
520735;201505;762;2174;565;1789;144;520;185;562;329;1082
520740;201505;1697;4826;1386;4413;286;1026;706;2201;992;3227
520750;201505;623;1693;491;1494;105;330;273;862;378;1192
520753;201505;1301;3726;1213;3593;150;411;899;2804;1049;3215
520760;201505;925;2499;797;2329;130;413;550;1647;680;2060
520780;201505;2035;4953;1663;4457;168;405;1225;3360;1393;3765
520790;201505;2729;7339;2272;6702;280;796;1654;5075;1934;5871
520800;201505;15482;45352;13587;43090;2756;8475;8629;29117;11385;37592
520810;201505;1010;2569;829;2357;136;385;598;1789;734;2174
520815;201505;559;1811;420;1523;186;772;23;64;209;836
520830;201505;1554;4194;1321;3952;39;89;1201;3663;1240;3752
520840;201505;1472;4813;1237;4374;409;1611;262;926;671;2537
520850;201505;653;1970;513;1746;141;537;235;778;376;1315
520860;201505;6914;19586;5149;16966;1396;4987;2132;7211;3528;12198
520870;201505;112298;302070;76539;241366;21458;75114;18887;56763;40345;131877
520880;201505;7224;20684;5316;17742;1601;6027;841;2735;2442;8762
520890;201505;3972;11248;3296;10125;709;2351;1617;4953;2326;7304
520910;201505;3712;10962;2740;9027;883;3114;495;1568;1378;4682
520915;201505;851;2417;640;2019;133;455;277;840;410;1295
520920;201505;3406;9189;2401;7578;577;1962;824;2677;1401;4639
520929;201505;560;1549;434;1352;97;301;240;772;337;1073
520940;201505;1036;3042;876;2805;95;351;637;2020;732;2371
520945;201505;718;1726;575;1494;175;439;266;691;441;1130
520960;201505;839;2527;688;2241;81;255;360;1210;441;1465
520970;201505;3244;9626;2712;8682;651;2297;927;2881;1578;5178
520980;201505;832;2366;760;2258;253;829;382;1096;635;1925
520990;201505;2952;9721;2794;9494;541;1897;1813;6379;2354;8276
520993;201505;1100;2880;883;2542;73;222;619;1794;692;2016
520995;201505;2575;7044;2335;6732;344;986;1696;4956;2040;5942
521000;201505;7142;21681;6031;19744;1566;5838;2358;7432;3924;13270
521010;201505;3886;11653;3143;10261;802;2829;1151;3797;1953;6626
521015;201505;671;1873;559;1694;132;374;292;917;424;1291
521020;201505;3935;11158;2785;8829;785;2705;469;1285;1254;3990
521030;201505;609;1601;517;1453;107;297;267;766;374;1063
521040;201505;5841;16025;5023;14803;1795;5388;2079;6532;3874;11920
521056;201505;904;2782;758;2538;255;904;304;1080;559;1984
521060;201505;1307;3494;1066;3117;263;732;457;1401;720;2133
521080;201505;1220;2896;742;2105;106;374;289;682;395;1056
521090;201505;3165;8431;2434;7496;765;2471;991;3192;1756;5663
521100;201505;1650;3990;1395;3710;240;618;956;2672;1196;3290
521120;201505;4451;12561;3721;11533;880;2903;1824;5754;2704;8657
521130;201505;1065;2911;816;2448;140;515;463;1351;603;1866
521140;201505;1017;3237;868;2936;275;994;254;853;529;1847
521150;201505;12989;33506;8208;24377;2736;8757;2113;6148;4849;14905
521160;201505;832;2004;518;1450;104;312;226;605;330;917
521170;201505;1256;3037;978;2656;222;622;559;1492;781;2114
521180;201505;6621;21897;6016;20802;2185;8067;1808;6296;3993;14363
521190;201505;9674;27552;6590;22025;1803;6451;1721;5778;3524;12229
521200;201505;747;1955;634;1784;76;244;402;1104;478;1348
521205;201505;611;1796;480;1560;55;198;272;883;327;1081
521210;201505;922;2531;637;1993;209;756;195;500;404;1256
521220;201505;4021;10775;3115;9563;940;3177;1230;3760;2170;6937
521225;201505;372;922;294;830;34;86;208;620;242;706
521230;201505;1214;3814;1108;3600;365;1287;533;1670;898;2957
521250;201505;27736;89503;25114;85527;10513;38361;7912;27195;18425;65556
521260;201505;768;1889;622;1644;97;331;380;926;477;1257
521270;201505;1855;5751;1704;5527;158;404;1326;4532;1484;4936
521280;201505;1882;5806;1551;5169;483;1720;490;1605;973;3325
521290;201505;534;1518;396;1292;107;409;157;494;264;903
521295;201505;1099;2915;973;2745;93;264;808;2320;901;2584
521300;201505;1959;5484;1674;5021;299;895;972;2986;1271;3881
521305;201505;800;2217;664;2022;124;360;397;1262;521;1622
521308;201505;4750;14149;3801;12319;918;3129;1731;5546;2649;8675
521310;201505;7784;23189;5813;19442;1641;5955;1319;4097;2960;10052
521340;201505;252;733;227;697;33;118;146;433;179;551
521350;201505;1944;5304;1633;4839;225;679;1137;3457;1362;4136
521370;201505;1011;3011;805;2657;237;859;231;736;468;1595
521375;201505;1330;3918;1118;3547;270;952;517;1547;787;2499
521377;201505;1044;2758;992;2701;72;139;876;2475;948;2614
521380;201505;5004;14141;3602;11544;682;2337;793;2626;1475;4963
521385;201505;510;1397;438;1305;101;329;244;713;345;1042
521390;201505;914;2468;715;2200;192;680;235;713;427;1393
521400;201505;2191;6092;1983;5838;268;869;1518;4479;1786;5348
521405;201505;1370;3898;1084;3385;316;1111;487;1514;803;2625
521410;201505;718;2217;654;2115;231;730;292;1011;523;1741
521440;201505;1405;3981;1309;3789;137;419;968;2742;1105;3161
521450;201505;4489;14079;3640;12484;1110;4163;868;2901;1978;7064
521460;201505;6645;19680;5757;18224;1419;4934;2876;8994;4295;13928
521470;201505;736;2072;551;1714;139;485;103;304;242;789
521480;201505;416;1236;290;958;66;224;112;365;178;589
521483;201505;2843;7386;2185;6271;592;1767;676;1890;1268;3657
521486;201505;1551;4004;1323;3667;130;388;1001;2752;1131;3140
521487;201505;635;1638;443;1325;122;372;102;303;224;675
521490;201505;772;2280;635;2054;68;288;442;1402;510;1690
521500;201505;1333;4272;1052;3647;202;802;340;1032;542;1834
521520;201505;900;2145;691;1862;186;500;326;932;512;1432
521523;201505;12082;44667;11255;43233;4416;18163;1805;7641;6221;25804
521525;201505;1052;2759;927;2594;104;358;672;1829;776;2187
521530;201505;1670;4798;1052;3525;248;896;186;566;434;1462
521540;201505;970;2644;676;2144;165;622;214;626;379;1248
521550;201505;1019;2608;884;2392;232;679;446;1158;678;1837
521560;201505;4334;13950;3636;12976;1385;5445;1173;4071;2558;9516
521565;201505;692;1770;593;1651;89;223;415;1193;504;1416
521570;201505;4520;12737;3118;9897;814;2789;929;2916;1743;5705
521580;201505;587;1367;406;1121;114;352;139;367;253;719
521590;201505;644;1860;520;1659;157;551;98;317;255;868
521600;201505;563;1474;393;1190;106;345;107;283;213;628
521630;201505;1533;3897;1119;3280;284;1000;215;496;499;1496
521640;201505;2017;5219;1594;4643;464;1478;666;1992;1130;3470
521645;201505;594;1748;467;1459;72;250;199;570;271;820
521680;201505;1467;4685;1241;4227;641;2349;201;638;842;2987
521690;201505;567;1679;504;1565;115;422;235;669;350;1091
521710;201505;2620;8063;2211;7231;492;1711;975;3172;1467;4883
521720;201505;1924;5436;1622;4991;309;980;1023;3128;1332;4108
521730;201505;3831;12562;3419;11785;1378;5276;860;2702;2238;7978
521740;201505;3400;9324;2681;8352;837;2841;1241;4069;2078;6910
521760;201505;12824;42497;11499;40310;2555;9955;5925;20993;8480;30948
521770;201505;2697;7905;2195;6979;819;2801;648;1951;1467;4752
521800;201505;7750;22971;6669;21202;2114;7181;2600;8544;4714;15725
521805;201505;895;2051;641;1684;157;375;349;1000;506;1375
521810;201505;709;1984;581;1783;136;453;297;904;433;1357
521830;201505;5156;16944;4730;16302;843;3171;3128;10772;3971;13943
521839;201505;741;2054;561;1714;108;375;187;535;295;910
521850;201505;6610;17986;5095;15266;1159;3650;1653;4528;2812;8178
521860;201505;1882;5255;1475;4583;343;1184;485;1449;828;2633
521870;201505;486;1683;431;1549;131;505;124;423;255;928
521878;201505;725;2150;530;1735;112;414;229;726;341;1140
521880;201505;24917;63740;16456;50023;4514;14796;5147;15775;9661;30571
521890;201505;3605;10859;2901;9499;943;3339;677;2126;1620;5465
521900;201505;1441;3754;1084;3266;253;820;424;1199;677;2019
521910;201505;1044;2862;926;2724;185;582;559;1717;744;2299
521920;201505;351;1047;298;949;106;384;79;213;185;597
521925;201505;647;1941;555;1777;103;358;229;671;332;1029
521930;201505;3923;12648;3508;11878;1197;4310;903;3051;2100;7361
521935;201505;638;1842;569;1717;156;473;276;814;432;1287
521940;201505;1026;2856;844;2565;230;748;363;1083;593;1831
521945;201505;652;2182;612;2128;106;345;418;1557;524;1902
521950;201505;622;1718;495;1522;100;343;255;791;355;1134
521960;201505;795;2321;642;2048;138;504;280;855;418;1359
521970;201505;2387;6860;2124;6523;284;885;1588;5009;1872;5894
521971;201505;1091;2924;809;2403;167;524;250;687;417;1211
521973;201505;891;2835;743;2549;176;648;253;853;429;1501
521975;201505;12632;34746;11779;33757;1895;5682;8534;24521;10429;30203
521980;201505;1909;5589;1694;5327;246;686;1319;4337;1565;5023
521990;201505;1059;3154;906;2916;125;465;576;1845;701;2310
522000;201505;2272;6217;1672;5461;251;928;1014;3405;1265;4333
522005;201505;416;1019;278;797;79;219;89;262;168;481
522010;201505;3140;9203;2637;8385;975;3243;602;1889;1577;5132
522015;201505;882;2667;749;2462;173;595;392;1293;565;1888
522020;201505;5256;13776;4365;12604;956;2911;2638;7667;3594;10578
522026;201505;621;1675;451;1473;124;451;158;519;282;970
522028;201505;525;1560;433;1356;84;277;266;820;350;1097
522040;201505;2672;6643;2052;5858;481;1423;1122;3236;1603;4659
522045;201505;14807;48238;12425;43427;3890;15016;2637;8952;6527;23968
522050;201505;1130;3187;855;2697;236;808;294;834;530;1642
522060;201505;2800;8436;2197;7508;644;2443;1033;3457;1677;5900
522068;201505;1595;5104;1473;4967;115;302;1238;4406;1353;4708
522070;201505;789;2376;709;2250;78;309;506;1590;584;1899
522100;201505;642;1872;565;1754;205;715;254;739;459;1454
522108;201505;912;2769;776;2571;71;264;603;1990;674;2254
522119;201505;1386;4293;1193;4017;258;921;649;2257;907;3178
522130;201505;469;1365;410;1295;121;404;223;707;344;1111
522140;201505;17792;49026;14702;44025;4340;14075;5127;14741;9467;28816
522145;201505;824;2315;742;2188;329;1032;223;661;552;1693
522150;201505;920;2585;808;2402;237;723;318;928;555;1651
522155;201505;801;2311;706;2167;127;381;465;1479;592;1860
522157;201505;693;1972;592;1826;53;194;472;1447;525;1641
522160;201505;6140;17375;4418;14277;1489;5395;571;1677;2060;7072
522170;201505;3154;8823;2591;7907;847;2659;742;2323;1589;4982
522180;201505;353;1033;277;907;89;313;98;333;187;646
522185;201505;16268;47889;13856;44740;3414;11746;7529;24601;10943;36347
522190;201505;973;2446;751;2105;116;340;413;1184;529;1524
522200;201505;1681;5414;1436;4895;431;1613;410;1302;841;2915
522205;201505;1449;4166;1186;3747;303;1033;547;1682;850;2715
522220;201505;1389;3743;1116;3406;277;848;561;1897;838;2745
522230;201505;1175;3396;1023;3155;118;427;695;2142;813;2569
530010;201505;240821;758599;214009;710431;60311;221997;74085;241192;134396;463189
110001;201504;3908;12396;3255;11389;737;2757;1806;6358;2543;9115
110002;201504;13048;39884;10725;35770;3167;11591;4222;13886;7389;25477
110003;201504;886;2843;797;2683;229;811;222;700;451;1511
110004;201504;10284;32641;8550;29101;2805;10369;2119;7134;4924;17503
110005;201504;1942;6316;1763;5975;637;2226;728;2457;1365;4683
110006;201504;2247;6642;1536;5380;501;1884;297;920;798;2804
110007;201504;1391;4277;1311;4163;305;1071;643;2260;948;3331
110008;201504;2412;8177;2278;7986;397;1291;1702;6266;2099;7557
110009;201504;4812;14397;3927;12991;1073;3961;1620;5170;2693;9131
110010;201504;7897;23115;6907;21857;1675;5063;3936;13624;5611;18687
110011;201504;8646;26468;7268;23970;2415;8442;2763;9000;5178;17442
110012;201504;14265;43051;12022;38907;3800;12982;3962;12811;7762;25793
110013;201504;5442;16781;4383;15156;1503;5444;1553;5546;3056;10990
110014;201504;4476;12846;3688;11695;705;2315;2359;7584;3064;9899
110015;201504;5166;15547;3855;13221;1216;4573;1111;3771;2327;8344
110018;201504;4468;12666;3465;11340;937;3522;1508;4724;2445;8246
110020;201504;58716;165468;45488;147776;9959;34282;23858;79570;33817;113852
110025;201504;4294;12498;3547;11136;607;2027;2298;7183;2905;9210
110026;201504;662;2069;616;2001;160;526;369;1211;529;1737
110028;201504;7761;22212;5631;18640;1560;5699;1035;3223;2595;8922
110029;201504;1373;4110;1187;3781;355;1180;512;1649;867;2829
110030;201504;10061;28059;8035;25320;2015;6896;3805;12326;5820;19222
110032;201504;4095;13014;3621;12020;1145;3970;1275;4169;2420;8139
110033;201504;5427;17254;4999;16602;1519;4910;2528;8991;4047;13901
110034;201504;3605;9545;3062;8873;558;1531;2255;6682;2813;8213
110037;201504;2098;7042;1805;6495;453;1728;924;3321;1377;5049
110040;201504;3495;11071;3120;10413;945;3441;1435;4705;2380;8146
110045;201504;5249;17319;4629;16569;1451;5639;2447;8686;3898;14325
110050;201504;1725;5477;1461;5055;423;1494;786;2795;1209;4289
110060;201504;833;2800;739;2614;240;957;264;903;504;1860
110070;201504;2036;6816;1938;6611;463;1686;1132;3846;1595;5532
110080;201504;3869;11292;3520;10892;438;1249;2795;8988;3233;10237
110090;201504;783;2368;651;2132;182;686;289;873;471;1559
110092;201504;1379;4671;1292;4557;200;738;896;3262;1096;4000
110094;201504;3518;10779;3225;10358;985;3266;1621;5333;2606;8599
110100;201504;2315;7339;2075;6924;611;2157;1072;3551;1683;5708
110110;201504;1723;5459;1578;5276;679;2384;570;1954;1249;4338
110120;201504;1831;5925;1457;5105;456;1679;386;1355;842;3034
110130;201504;2685;7653;1997;6571;674;2341;597;1954;1271;4295
110140;201504;2556;8444;2257;7901;509;1907;1224;4310;1733;6217
110143;201504;1289;4086;1008;3587;244;919;504;1780;748;2699
110145;201504;1055;3035;889;2772;191;652;521;1603;712;2255
110146;201504;442;1391;391;1317;83;287;219;751;302;1038
110147;201504;842;2427;648;2098;174;619;239;684;413;1303
110148;201504;1351;4032;1006;3323;318;1117;230;710;548;1827
110149;201504;3605;10679;2908;9579;872;2895;1464;4983;2336;7878
110150;201504;2506;7477;2189;7012;294;1034;1415;4632;1709;5666
110155;201504;882;2773;813;2613;234;805;419;1315;653;2120
110160;201504;2206;6838;1820;6134;567;1974;791;2690;1358;4664
110170;201504;3131;8788;2323;7385;529;1800;1271;3998;1800;5798
110175;201504;1811;5393;1358;4816;231;897;799;2901;1030;3798
110180;201504;1508;4442;1256;4061;287;945;756;2502;1043;3447
120001;201504;2842;9931;2686;9667;499;1930;1746;6399;2245;8329
120005;201504;1476;6230;1439;6169;133;604;1166;5116;1299;5720
120010;201504;4472;15697;4247;15329;688;2420;3081;11483;3769;13903
120013;201504;1760;6987;1692;6885;397;1579;1075;4650;1472;6229
120017;201504;2054;7392;1922;7154;526;2002;921;3732;1447;5734
120020;201504;14087;62805;13678;62024;2103;9295;10079;47631;12182;56926
120025;201504;2623;9106;2529;8973;482;1854;1661;5964;2143;7818
120030;201504;6160;24340;6041;24205;284;1076;5501;22357;5785;23433
120032;201504;1438;6911;1381;6774;202;1170;987;4857;1189;6027
120033;201504;3461;13841;3434;13795;140;589;3180;12893;3320;13482
120034;201504;1973;8184;1912;8091;176;885;1591;6688;1767;7573
120035;201504;2889;13604;2848;13517;199;969;2488;12022;2687;12991
120038;201504;2673;9801;2556;9575;651;2539;1446;5519;2097;8058
120039;201504;1591;8252;1557;8171;186;1027;1237;6593;1423;7620
120040;201504;46598;166298;42442;158089;11137;44343;21056;79909;32193;124252
120042;201504;2874;12419;2735;12110;390;1872;1965;8867;2355;10739
120043;201504;881;4252;852;4202;64;286;725;3707;789;3993
120045;201504;4267;14644;4199;14552;702;2531;3249;11357;3951;13888
120050;201504;7930;33111;7594;32377;1284;5384;5138;23042;6422;28426
120060;201504;7300;33356;7191;33162;572;2910;6100;28560;6672;31470
120070;201504;2701;10204;2632;10051;472;1771;1793;7103;2265;8874
120080;201504;3614;13782;3460;13535;508;1975;2641;10645;3149;12620
130002;201504;2968;12450;2823;12202;200;993;2369;10306;2569;11299
130006;201504;1913;8107;1686;7692;262;1337;1155;5331;1417;6668
130008;201504;2088;8428;1992;8269;141;623;1678;7052;1819;7675
130010;201504;2860;9589;2495;9168;182;643;2176;8137;2358;8780
130014;201504;3288;10729;2907;10151;479;1788;1913;6754;2392;8542
130020;201504;2635;9521;2626;9510;22;71;2596;9421;2618;9492
130030;201504;7175;27354;6917;27050;572;1910;5950;24080;6522;25990
130040;201504;3793;11656;3416;11167;271;990;2884;9549;3155;10539
130050;201504;6269;24914;5673;24035;539;2182;4405;19647;4944;21829
130060;201504;5743;26418;5467;25988;486;2515;4468;21512;4954;24027
130063;201504;3491;15510;3435;15435;259;1117;3011;13811;3270;14928
130068;201504;3070;12864;2799;12337;386;1836;1907;8504;2293;10340
130070;201504;6699;21894;6002;21028;641;2212;4749;17112;5390;19324
130080;201504;4980;22447;4761;22117;839;4086;3322;15860;4161;19946
130083;201504;2160;8586;2041;8405;308;1458;1450;5978;1758;7436
130090;201504;2570;9302;2489;9188;132;560;2244;8299;2376;8859
130100;201504;5539;20831;5325;20551;246;1099;4868;18788;5114;19887
130110;201504;6605;21501;6199;21017;529;1677;5270;18341;5799;20018
130115;201504;4305;15332;4106;15069;77;246;3907;14447;3984;14693
130120;201504;14017;53468;13362;52623;1215;4450;11300;45818;12515;50268
130130;201504;3684;15405;3627;15298;297;1360;3079;13105;3376;14465
130140;201504;6228;24239;6156;24155;98;231;6028;23854;6126;24085
130150;201504;3412;13192;3341;13103;156;747;3061;11950;3217;12697
130160;201504;4125;17024;4016;16880;286;1104;3619;15431;3905;16535
130165;201504;2836;11748;2722;11557;323;1440;2169;9331;2492;10771
130170;201504;8965;32687;8043;31549;1034;4166;6198;24993;7232;29159
130180;201504;3464;11157;3382;11041;117;296;3145;10401;3262;10697
130185;201504;10665;34954;9743;33895;927;2908;8084;29370;9011;32278
130190;201504;17179;58988;15104;56328;2811;10502;10014;39121;12825;49623
130195;201504;1895;7946;1837;7863;108;457;1631;7087;1739;7544
130200;201504;1987;7123;1848;6897;499;1836;1098;4234;1597;6070
130210;201504;1176;4648;1112;4559;107;503;925;3815;1032;4318
130220;201504;1968;8131;1802;7819;327;1604;1048;4582;1375;6186
130230;201504;3627;16349;3427;16030;362;1641;2672;13061;3034;14702
130240;201504;8398;32260;7794;31369;377;1799;6848;27821;7225;29620
130250;201504;19373;67771;18350;66439;2446;8461;14069;53155;16515;61616
130255;201504;4195;14766;3971;14414;132;409;3651;13513;3783;13922
130260;201504;248927;813833;224972;774337;63674;230631;108916;382394;172590;613025
130270;201504;7013;29593;6467;28710;897;4079;4811;22071;5708;26150
130280;201504;3254;13118;3171;13001;119;433;2916;12216;3035;12649
130290;201504;11169;39511;10819;39096;162;298;10394;38247;10556;38545
130300;201504;4296;16869;4107;16570;293;1370;3481;14090;3774;15460
130310;201504;5086;19052;4692;18566;359;1408;3956;16011;4315;17419
130320;201504;2952;10375;2693;10020;357;1347;1977;7565;2334;8912
130330;201504;3502;12915;3280;12619;182;809;2856;11085;3038;11894
130340;201504;17825;68446;16681;66939;3063;11867;11792;49573;14855;61440
130350;201504;3221;13376;3152;13282;271;1270;2671;11360;2942;12630
130353;201504;5857;17981;5120;17025;1168;3768;3163;11314;4331;15082
130356;201504;4462;15985;4216;15631;365;1192;3483;13503;3848;14695
130360;201504;3151;8975;2914;8721;33;55;2824;8582;2857;8637
130370;201504;5250;20549;4514;19574;275;1462;3770;16438;4045;17900
130380;201504;7375;30932;7087;30541;459;2084;6184;26994;6643;29078
130390;201504;4837;21625;4509;21050;454;2307;3501;16681;3955;18988
130395;201504;2058;7436;1816;6941;278;1138;1176;4449;1454;5587
130400;201504;2083;7903;2005;7796;129;531;1790;7020;1919;7551
130406;201504;10357;39267;9322;37729;2232;9305;5662;23712;7894;33017
130410;201504;3926;14940;3570;14277;1080;4620;1598;6590;2678;11210
130420;201504;10278;43669;9905;43053;2714;11337;6197;28379;8911;39716
130423;201504;3212;12470;3030;12222;250;1164;2579;10433;2829;11597
130426;201504;2126;9250;2063;9147;282;1252;1588;7251;1870;8503
130430;201504;3408;12180;3268;11981;422;1608;2489;9282;2911;10890
130440;201504;3544;12997;3408;12851;182;636;3105;11910;3287;12546
140002;201504;1645;5280;1544;5160;158;514;1193;4101;1351;4615
140005;201504;3075;8978;2906;8796;76;164;2779;8506;2855;8670
140010;201504;50648;154749;43278;143328;10660;37874;21101;71863;31761;109737
140015;201504;2934;9457;2772;9247;342;924;2193;7685;2535;8609
140017;201504;3296;10177;2994;9797;286;837;2387;8127;2673;8964
140020;201504;4514;15366;4221;14964;384;1271;3446;12605;3830;13876
140023;201504;2120;7199;1878;6824;251;962;1319;4893;1570;5855
140028;201504;2179;5958;2110;5884;67;122;2007;5695;2074;5817
140030;201504;3676;11564;3502;11350;434;1097;2897;9817;3331;10914
140040;201504;1583;7454;1538;7346;120;672;1234;5947;1354;6619
140045;201504;2453;9121;2254;8836;466;1648;1462;6278;1928;7926
140047;201504;5429;15214;4837;14438;1404;4287;2392;7573;3796;11860
140050;201504;1520;4782;1381;4601;222;772;951;3223;1173;3995
140060;201504;1500;4622;1358;4400;281;952;882;2923;1163;3875
140070;201504;1464;7612;1425;7476;92;555;1221;6398;1313;6953
150010;201504;33986;106493;32278;104257;1980;6591;27777;90931;29757;97522
150013;201504;1668;4900;1539;4757;161;469;1230;3896;1391;4365
150020;201504;12247;41093;11878;40594;908;3062;10308;35723;11216;38785
150030;201504;6638;28544;6437;28243;604;2278;5442;24793;6046;27071
150034;201504;4311;11962;4105;11711;229;590;3705;10704;3934;11294
150040;201504;12628;41853;10917;39770;2190;7373;7407;29010;9597;36383
150050;201504;5753;22100;5549;21753;353;1555;4773;18843;5126;20398
150060;201504;16585;52938;15397;51193;2667;8498;10813;37231;13480;45729
150070;201504;5922;24283;5320;23622;394;1896;4609;20719;5003;22615
150080;201504;66636;176004;56956;163288;9663;26427;37105;110673;46768;137100
150085;201504;5167;17928;4915;17583;558;1719;3990;14878;4548;16597
150090;201504;9883;38213;9389;37511;846;3282;7732;31615;8578;34897
150095;201504;5260;17574;4787;16880;420;1380;3872;14146;4292;15526
150100;201504;3287;12345;3107;12042;190;922;2589;9949;2779;10871
150110;201504;3279;16199;3268;16174;145;649;3046;15256;3191;15905
150120;201504;6059;23354;5906;23086;705;2674;4738;18852;5443;21526
150125;201504;753;2218;678;2125;125;439;447;1363;572;1802
150130;201504;21532;65741;20069;63713;1847;5607;15946;51937;17793;57544
150140;201504;152441;439163;145288;430158;14825;42931;119442;359094;134267;402025
150145;201504;4505;14460;4155;14009;594;2048;3150;10813;3744;12861
150150;201504;11058;34851;10280;33670;1718;5808;7176;23848;8894;29656
150157;201504;3116;9430;2731;8893;350;1257;2028;6691;2378;7948
150160;201504;3034;9887;2835;9601;791;2658;1631;5771;2422;8429
150170;201504;22066;81048;20668;78928;3450;13274;14756;57523;18206;70797
150172;201504;3009;10440;2690;9930;433;1638;1908;7211;2341;8849
150175;201504;1963;5932;1856;5816;121;302;1602;5250;1723;5552
150178;201504;10208;31969;9211;30881;706;2300;7542;26251;8248;28551
150180;201504;17931;72108;17244;71191;1427;6319;14500;60535;15927;66854
150190;201504;7223;23515;6848;23014;380;884;6004;20970;6384;21854
150195;201504;5102;17018;4739;16430;338;1260;3982;13931;4320;15191
150200;201504;5263;16995;5047;16745;145;451;4695;15776;4840;16227
150210;201504;24194;91387;23399;90274;2288;8063;19274;77224;21562;85287
150215;201504;6394;20226;5558;18948;1479;5328;2603;9047;4082;14375
150220;201504;12590;39328;11268;37265;2549;8690;5996;20289;8545;28979
150230;201504;11229;37397;10006;35642;1169;4744;7395;26403;8564;31147
150240;201504;35144;104823;31024;97918;10083;33055;11319;37186;21402;70241
150250;201504;4049;16441;3912;16240;528;2232;2998;12819;3526;15051
150260;201504;2106;8467;2008;8296;398;1692;1258;5349;1656;7041
150270;201504;8718;27005;6996;24850;1563;5878;4274;15507;5837;21385
150275;201504;5825;21282;5540;20843;731;2789;4194;16141;4925;18930
150276;201504;2095;6289;1891;6016;397;1357;1346;4279;1743;5636
150277;201504;4949;15402;4297;14596;669;2276;3087;10877;3756;13153
150280;201504;5808;25872;5648;25519;1101;4939;3802;17762;4903;22701
150285;201504;2669;10773;2551;10553;518;2204;1626;6991;2144;9195
150290;201504;9661;28723;9262;28274;738;1778;7988;25366;8726;27144
150293;201504;9460;26394;7361;23429;2237;7586;2795;9617;5032;17203
150295;201504;6759;20472;5646;19160;1072;3449;3849;14034;4921;17483
150300;201504;1798;6333;1726;6246;124;414;1426;5343;1550;5757
150304;201504;4054;12772;3555;12070;566;1959;2431;8505;2997;10464
150307;201504;6512;22027;6034;21357;414;1356;5107;18409;5521;19765
150309;201504;6331;22059;5829;21349;1259;4544;3866;14888;5125;19432
150310;201504;5778;25762;5617;25497;643;2984;4491;20812;5134;23796
150320;201504;9034;21496;8425;20870;474;779;7564;19416;8038;20195
150330;201504;13561;47048;12662;45745;1504;5307;9767;36427;11271;41734
150340;201504;2367;7731;2195;7477;311;1121;1607;5541;1918;6662
150345;201504;6474;21878;6068;21337;597;2070;4930;17767;5527;19837
150350;201504;7689;24542;7220;23929;1109;3199;5368;18538;6477;21737
150360;201504;20806;65644;18275;62363;2856;9779;12747;45048;15603;54827
150370;201504;9500;35604;9049;35010;1113;3834;7398;29749;8511;33583
150375;201504;2776;12107;2709;12015;248;1021;2333;10633;2581;11654
150380;201504;9724;28647;8675;27222;669;2199;7223;22983;7892;25182
150390;201504;7718;33437;7297;32676;1357;5930;4857;22670;6214;28600
150400;201504;5733;22875;5501;22388;528;2124;4313;18008;4841;20132
150405;201504;8122;24830;7261;23767;1372;3799;5012;17805;6384;21604
150410;201504;1635;6365;1558;6212;245;1067;1033;4199;1278;5266
150420;201504;35926;122768;30950;114652;9035;36090;12928;49948;21963;86038
150430;201504;6900;23827;6580;23311;925;3159;4784;17496;5709;20655
150440;201504;5408;18895;5204;18615;948;3264;3711;13715;4659;16979
150442;201504;19858;59388;18175;56959;3223;10413;11968;38322;15191;48735
150445;201504;5062;17802;4710;17236;598;2112;3564;13415;4162;15527
150450;201504;4282;20664;4121;20427;354;1778;3475;17577;3829;19355
150460;201504;6419;24974;5872;24332;343;1581;5152;21763;5495;23344
150470;201504;17160;52451;16521;51688;567;1341;15450;49180;16017;50521
150475;201504;2176;7665;2025;7474;223;801;1669;6329;1892;7130
150480;201504;13505;46615;12712;45439;1140;4227;10550;38234;11690;42461
150490;201504;6742;26033;6591;25811;286;1119;5989;23742;6275;24861
150495;201504;4992;18423;4875;18267;155;565;4576;17301;4731;17866
150497;201504;2898;10498;2621;10006;817;3299;1338;5131;2155;8430
150500;201504;3142;8732;2915;8405;360;1032;2181;6304;2541;7336
150503;201504;3764;11716;3260;11093;1135;3962;1655;5907;2790;9869
150506;201504;11302;39983;10294;38548;2292;8060;6681;26696;8973;34756
150510;201504;9590;37720;8870;36404;1332;5579;6228;26503;7560;32082
150520;201504;6676;25910;6583;25786;198;581;6247;24822;6445;25403
150530;201504;11781;41111;10682;39445;1171;4108;8195;31041;9366;35149
150540;201504;4557;14098;4134;13499;292;989;3455;11321;3747;12310
150543;201504;5374;16895;4859;16142;1038;3593;3125;10597;4163;14190
150548;201504;8606;27800;8101;27166;326;1002;7423;25229;7749;26231
150549;201504;2148;6992;2007;6830;65;131;1868;6536;1933;6667
150550;201504;19846;62816;17389;58645;5430;18906;7182;24854;12612;43760
150553;201504;21972;76183;18535;68897;7069;28069;4787;18008;11856;46077
150555;201504;1638;5109;1461;4856;126;474;1171;3904;1297;4378
150560;201504;1930;6264;1825;6040;255;858;1262;4187;1517;5045
150563;201504;2907;9515;2704;9159;666;2437;1500;5087;2166;7524
150565;201504;3647;12692;3337;12211;200;864;2746;10166;2946;11030
150570;201504;5593;20838;5478;20644;375;1434;4658;17938;5033;19372
150580;201504;9514;39770;9302;39518;591;2239;8315;36222;8906;38461
150590;201504;5655;22884;5507;22706;90;256;5303;22114;5393;22370
150600;201504;7872;30410;7603;30022;391;1502;6840;27470;7231;28972
150610;201504;2393;8221;2192;7812;264;1037;1519;5364;1783;6401
150611;201504;2700;9569;2530;9225;228;901;1962;7200;2190;8101
150613;201504;11905;36536;10305;34214;3437;11838;4785;16455;8222;28293
150616;201504;3069;9379;2414;8371;619;2367;1032;3453;1651;5820
150618;201504;6405;22378;5993;21639;1712;6412;3155;11559;4867;17971
150619;201504;5129;17741;4813;17260;560;2228;3610;12982;4170;15210
150620;201504;6334;22903;5803;22230;758;2829;4624;18301;5382;21130
150630;201504;5631;17118;5359;16797;350;1081;4677;14943;5027;16024
150635;201504;4106;13545;3801;12966;793;2798;2131;7486;2924;10284
150640;201504;1762;5471;1710;5406;198;591;1394;4603;1592;5194
150650;201504;12490;37926;11151;35637;3001;9783;5274;17421;8275;27204
150655;201504;4970;16880;4738;16478;611;2185;3567;12571;4178;14756
150658;201504;4251;13392;3847;12809;901;3365;2358;7800;3259;11165
150660;201504;5579;17841;5096;17165;1276;4206;2936;10309;4212;14515
150670;201504;6407;17841;5373;16550;1022;3288;3763;11917;4785;15205
150680;201504;53338;196854;48075;187596;14983;60159;21108;88065;36091;148224
150690;201504;2009;6281;1822;5978;342;1049;1160;3972;1502;5021
150700;201504;6150;18930;5637;18283;1053;3499;3795;12626;4848;16125
150710;201504;4271;14265;3830;13556;430;1522;2870;10398;3300;11920
150715;201504;4976;15814;4361;14895;533;1932;3301;11442;3834;13374
150720;201504;6420;26346;6054;25695;890;3813;4390;19359;5280;23172
150730;201504;9265;32171;8836;31521;953;3328;7256;26483;8209;29811
150740;201504;3720;11854;3344;11191;547;1919;2069;7003;2616;8922
150745;201504;5348;16996;4946;16439;1078;3733;3238;10785;4316;14518
150746;201504;1408;4593;1342;4479;192;693;932;3138;1124;3831
150747;201504;5341;16771;4720;15992;484;1418;3621;13045;4105;14463
150750;201504;3013;10252;2869;10074;143;486;2601;9245;2744;9731
150760;201504;10840;35551;10198;34709;2123;7277;6676;23429;8799;30706
150770;201504;5838;22069;5430;21200;572;2130;4376;18027;4948;20157
150775;201504;1175;3610;1033;3356;210;837;594;1859;804;2696
150780;201504;3172;10493;3128;10445;57;142;3007;10141;3064;10283
150790;201504;5054;16259;4660;15787;396;1385;3819;13477;4215;14862
150795;201504;15793;48958;14189;46650;2885;9288;9033;30905;11918;40193
150796;201504;2946;8850;2717;8587;363;1103;2098;6881;2461;7984
150797;201504;3736;12601;3487;12228;144;564;3088;10912;3232;11476
150800;201504;13731;45919;12655;44616;2533;8314;8785;32709;11318;41023
150803;201504;6590;23920;6209;23316;679;2612;4757;18265;5436;20877
150805;201504;2741;9624;2558;9347;320;1125;1924;7227;2244;8352
150808;201504;5852;19828;4977;18202;2073;8148;982;3602;3055;11750
150810;201504;19055;60014;16260;56605;2257;7462;11691;43039;13948;50501
150812;201504;5311;16728;4892;16051;486;2004;3613;11430;4099;13434
150815;201504;8558;27851;7734;26843;804;2696;6378;22711;7182;25407
150820;201504;11331;32132;10038;30713;700;1409;8708;27826;9408;29235
150830;201504;13064;49024;12004;47412;619;2683;10060;41110;10679;43793
150835;201504;1956;6992;1816;6699;454;1790;861;3179;1315;4969
150840;201504;6695;20329;5573;18551;1278;4639;2882;9534;4160;14173
160005;201504;691;2544;649;2473;75;346;479;1792;554;2138
160010;201504;1413;4697;1409;4692;75;161;1305;4465;1380;4626
160015;201504;1682;6250;1642;6187;103;343;1443;5593;1546;5936
160020;201504;2022;7131;1882;6940;235;852;1413;5422;1648;6274
160021;201504;944;4053;917;4009;158;764;659;2916;817;3680
160023;201504;1074;4241;1059;4217;80;267;929;3803;1009;4070
160025;201504;1252;3847;1240;3834;9;31;1224;3787;1233;3818
160027;201504;8228;24759;7627;24100;2725;8151;3983;13699;6708;21850
160030;201504;43772;157559;39185;148976;9265;35103;22555;90165;31820;125268
160040;201504;4197;16393;4103;16254;115;530;3861;15305;3976;15835
160050;201504;3215;12137;2922;11748;1305;5201;1229;5289;2534;10490
160053;201504;2604;10166;2542;10072;553;2257;1720;6982;2273;9239
160055;201504;663;2609;651;2597;94;410;504;2024;598;2434
160060;201504;15621;53153;14649;52069;2908;9805;10381;38406;13289;48211
160070;201504;2427;9476;2337;9346;128;538;2080;8403;2208;8941
160080;201504;2554;9549;2545;9539;30;99;2502;9409;2532;9508
170025;201504;542;1813;499;1754;149;526;257;952;406;1478
170030;201504;1170;3817;1033;3573;312;1092;407;1447;719;2539
170035;201504;1514;4449;1219;3912;394;1353;398;1303;792;2656
170040;201504;1861;6064;1642;5764;273;1087;1047;3778;1320;4865
170070;201504;1983;5179;1545;4619;379;1240;832;2513;1211;3753
170100;201504;2497;7243;2197;6778;259;834;1699;5249;1958;6083
170105;201504;763;2413;616;2115;118;475;309;1012;427;1487
170110;201504;1080;3385;935;3148;218;794;459;1546;677;2340
170130;201504;1394;4359;1213;4059;297;1035;642;2232;939;3267
170190;201504;1594;4678;1213;4070;502;1616;269;1042;771;2658
170200;201504;1582;4507;1088;3575;268;970;333;1064;601;2034
170210;201504;31443;90845;25485;81080;7579;26146;8145;26997;15724;53143
170215;201504;1177;3702;1014;3453;84;332;784;2670;868;3002
170220;201504;5804;19932;5358;19134;1138;4319;3109;11189;4247;15508
170230;201504;1470;4741;1233;4293;269;1110;594;1972;863;3082
170240;201504;2720;8221;2306;7609;302;1165;1595;5227;1897;6392
170255;201504;3618;11472;3012;10488;880;3091;1293;4751;2173;7842
170270;201504;1056;2649;730;2199;94;308;486;1451;580;1759
170290;201504;2726;8531;2552;8323;159;392;2254;7638;2413;8030
170300;201504;1960;6092;1642;5573;222;848;1069;3656;1291;4504
170305;201504;774;2361;624;2088;109;395;334;1136;443;1531
170307;201504;1088;3787;912;3458;180;740;480;1910;660;2650
170310;201504;1640;4528;1262;3913;293;949;622;1982;915;2931
170320;201504;1106;3228;824;2727;216;758;314;1072;530;1830
170330;201504;752;2445;688;2342;101;393;493;1649;594;2042
170360;201504;449;1464;386;1356;92;345;176;600;268;945
170370;201504;1376;4001;1106;3570;256;922;537;1730;793;2652
170380;201504;1859;6019;1518;5484;298;1259;819;2908;1117;4167
170382;201504;556;1848;482;1730;115;480;271;952;386;1432
170384;201504;1559;6375;1457;6197;348;1585;866;3733;1214;5318
170386;201504;951;2808;829;2628;200;714;443;1416;643;2130
170388;201504;646;1934;534;1747;117;459;217;677;334;1136
170389;201504;913;3065;836;2941;89;355;611;2137;700;2492
170390;201504;1315;3840;1146;3626;133;454;862;2791;995;3245
170410;201504;519;1662;457;1548;51;217;301;996;352;1213
170460;201504;503;1367;355;1116;84;298;120;368;204;666
170510;201504;769;2605;630;2342;89;396;333;1217;422;1613
170550;201504;6471;18800;4939;16088;1658;5965;942;3011;2600;8976
170555;201504;1353;3925;1064;3478;240;862;538;1772;778;2634
170560;201504;997;3354;794;3092;170;721;469;1885;639;2606
170600;201504;1332;3807;1189;3615;247;733;777;2461;1024;3194
170610;201504;1668;5077;1302;4501;145;594;809;2806;954;3400
170625;201504;431;1334;338;1155;65;228;96;333;161;561
170650;201504;1273;4069;1104;3768;272;1001;489;1727;761;2728
170700;201504;4046;13072;3328;11881;683;2701;1643;6128;2326;8829
170710;201504;1849;5445;1497;4815;232;786;926;3027;1158;3813
170720;201504;1876;5026;1565;4546;310;821;1035;3163;1345;3984
170730;201504;1047;2990;854;2699;234;798;389;1240;623;2038
170740;201504;2223;7933;1971;7493;283;1198;1353;5200;1636;6398
170755;201504;845;2598;697;2287;164;603;245;780;409;1383
170765;201504;1368;3718;1079;3247;288;917;479;1478;767;2395
170770;201504;1764;5991;1620;5732;279;1066;1020;3656;1299;4722
170820;201504;3773;12031;3386;11405;845;3021;1589;5473;2434;8494
170825;201504;762;2287;604;1976;117;418;256;819;373;1237
170830;201504;1389;4087;1237;3867;26;44;1142;3633;1168;3677
170900;201504;2694;9431;2550;9183;248;891;2023;7465;2271;8356
170930;201504;3629;11342;3106;10435;982;3547;1072;3622;2054;7169
170950;201504;14147;40679;10482;34304;3502;12945;2202;6952;5704;19897
170980;201504;500;1500;378;1292;94;361;159;514;253;875
171050;201504;1437;4927;1325;4722;83;344;1101;3931;1184;4275
171070;201504;1582;4904;1443;4706;300;995;895;3012;1195;4007
171090;201504;1005;2810;842;2581;79;252;605;1854;684;2106
171110;201504;615;1786;469;1533;127;451;218;686;345;1137
171150;201504;870;2495;639;2089;121;436;356;1172;477;1608
171180;201504;690;2066;493;1666;126;451;200;715;326;1166
171190;201504;1781;6457;1547;5981;330;1366;760;3045;1090;4411
171195;201504;832;2936;726;2726;98;416;415;1590;513;2006
171200;201504;711;2280;592;2054;150;583;251;812;401;1395
171215;201504;457;1359;355;1160;66;242;155;512;221;754
171240;201504;755;2646;696;2532;89;382;475;1757;564;2139
171245;201504;661;2156;543;1884;121;480;198;633;319;1113
171250;201504;1124;3239;897;2863;144;533;546;1660;690;2193
171270;201504;434;1775;403;1717;131;541;168;792;299;1333
171280;201504;920;2800;784;2593;190;630;409;1468;599;2098
171320;201504;3903;11829;3325;10852;893;2994;1658;5515;2551;8509
171330;201504;2933;8613;2434;7836;624;2165;1155;3692;1779;5857
171360;201504;1473;4726;1277;4426;199;694;841;2994;1040;3688
171370;201504;723;2056;628;1923;135;454;341;1021;476;1475
171380;201504;1324;4328;1122;3951;432;1539;389;1399;821;2938
171395;201504;891;2693;710;2359;154;621;326;1022;480;1643
171420;201504;2277;6876;1789;6021;431;1551;730;2456;1161;4007
171430;201504;1049;3251;884;2985;207;704;475;1606;682;2310
171488;201504;2528;7740;2250;7352;533;1727;1259;4303;1792;6030
171500;201504;800;2452;693;2253;91;273;460;1549;551;1822
171510;201504;918;3217;819;3059;91;386;575;2188;666;2574
171515;201504;512;1474;399;1289;61;203;221;708;282;911
171525;201504;616;2017;521;1854;106;436;289;1005;395;1441
171550;201504;321;1070;251;932;89;369;39;156;128;525
171570;201504;1229;3904;1089;3637;183;643;747;2496;930;3139
171575;201504;1851;5356;1453;4608;285;932;683;2234;968;3166
171610;201504;5604;18526;4854;17186;1417;5537;1664;5777;3081;11314
171620;201504;2564;7583;2253;7149;125;464;1896;6050;2021;6514
171630;201504;877;2827;725;2564;232;890;267;923;499;1813
171650;201504;2298;7107;1809;6162;467;1746;678;2296;1145;4042
171660;201504;2483;6846;1934;5876;277;915;1149;3511;1426;4426
171665;201504;1453;4342;1197;3942;181;654;737;2517;918;3171
171670;201504;2073;5859;1718;5295;447;1555;806;2343;1253;3898
171700;201504;1094;3574;957;3312;143;572;622;2130;765;2702
171720;201504;742;2213;629;2015;221;737;249;819;470;1556
171750;201504;1166;3707;980;3329;282;1029;346;1173;628;2202
171780;201504;1267;3445;932;2980;114;413;551;1799;665;2212
171790;201504;1560;5163;1345;4862;245;854;869;3312;1114;4166
171800;201504;673;2128;595;2024;79;296;428;1477;507;1773
171820;201504;9934;29443;8583;27642;1723;6061;5087;16476;6810;22537
171830;201504;1486;5515;1347;5219;366;1500;626;2408;992;3908
171840;201504;812;2276;712;2140;46;140;591;1801;637;1941
171845;201504;796;2153;614;1855;114;390;319;942;433;1332
171850;201504;978;3465;865;3239;114;503;538;2012;652;2515
171855;201504;1150;3659;1046;3464;94;374;796;2577;890;2951
171865;201504;485;1562;413;1445;100;387;206;700;306;1087
171870;201504;721;2204;589;1976;134;487;250;883;384;1370
171875;201504;1361;4209;1115;3836;122;497;777;2637;899;3134
171880;201504;878;3225;857;3189;85;331;688;2619;773;2950
171884;201504;938;2635;687;2266;157;594;220;811;377;1405
171886;201504;1465;4792;1213;4265;370;1411;361;1254;731;2665
171888;201504;694;2127;572;1906;73;262;337;1157;410;1419
171889;201504;504;1619;468;1557;90;314;286;970;376;1284
171890;201504;1172;3730;1010;3507;138;544;666;2330;804;2874
171900;201504;505;1882;450;1775;126;503;218;869;344;1372
172000;201504;600;1972;521;1824;87;336;297;1042;384;1378
172010;201504;1177;4108;1102;3982;106;447;862;3121;968;3568
172015;201504;350;1347;296;1252;57;243;166;738;223;981
172020;201504;2305;7724;2135;7453;269;1006;1527;5386;1796;6392
172025;201504;748;2136;579;1844;65;240;322;1033;387;1273
172030;201504;1124;3752;1000;3534;104;452;716;2514;820;2966
172049;201504;1302;3501;1006;2978;119;364;779;2338;898;2702
172065;201504;1234;3451;1052;3237;64;210;945;2938;1009;3148
172080;201504;2578;7972;2184;7289;243;969;1493;4908;1736;5877
172085;201504;522;1426;377;1155;62;196;125;373;187;569
172090;201504;3186;9671;2598;8790;411;1523;1721;5909;2132;7432
172093;201504;598;1859;475;1653;125;540;235;784;360;1324
172097;201504;683;2009;543;1790;136;463;215;734;351;1197
172100;201504;30108;95440;24643;85221;7698;29540;6709;22860;14407;52400
172110;201504;1700;6310;1532;6048;192;794;1132;4596;1324;5390
172120;201504;5331;16263;4439;15091;542;1930;3199;11154;3741;13084
172125;201504;301;895;240;800;42;161;107;357;149;518
172130;201504;540;1507;431;1329;44;162;289;909;333;1071
172208;201504;2148;6504;1949;6213;365;1269;1113;3569;1478;4838
172210;201504;2390;7487;2157;7117;478;1717;1230;3995;1708;5712
210005;201504;22150;69357;18904;64414;5661;20757;8297;28567;13958;49324
210010;201504;1637;5847;1459;5579;148;609;1122;4375;1270;4984
210015;201504;3269;10481;2952;10013;189;428;2558;9016;2747;9444
210020;201504;6960;17247;6550;16751;277;758;5886;15035;6163;15793
210030;201504;5633;18740;5284;18264;386;1700;4367;15025;4753;16725
210040;201504;1879;5394;1722;5214;141;447;1413;4289;1554;4736
210043;201504;6465;18708;5675;17698;524;1570;4392;14258;4916;15828
210047;201504;6574;25502;6048;24625;752;3344;4350;17922;5102;21266
210050;201504;2374;8648;1965;7961;665;2822;780;3304;1445;6126
210055;201504;1705;5843;1572;5658;171;635;1200;4378;1371;5013
210060;201504;7515;28587;6905;27564;687;3085;5189;21099;5876;24184
210070;201504;6963;20736;6474;20143;183;632;5861;18361;6044;18993
210080;201504;3703;12804;3628;12711;49;205;3467;12180;3516;12385
210083;201504;4310;14984;4021;14674;106;314;3803;14088;3909;14402
210087;201504;2866;8605;2631;8314;216;687;2212;7102;2428;7789
210090;201504;9971;32604;9476;31825;411;1606;8306;27994;8717;29600
210095;201504;5915;22024;5741;21783;443;1719;4852;18747;5295;20466
210100;201504;7202;21584;6694;20992;479;1714;5707;17859;6186;19573
210110;201504;3004;10562;2911;10446;113;485;2617;9435;2730;9920
210120;201504;26249;72617;22454;68174;2688;7001;17046;54686;19734;61687
210125;201504;3585;11468;3441;11313;237;616;3047;10306;3284;10922
210130;201504;4282;12781;4032;12443;310;1025;3359;10381;3669;11406
210135;201504;1674;4920;1481;4653;113;345;1223;3906;1336;4251
210140;201504;17311;55487;15032;52300;2871;10246;9351;33831;12222;44077
210150;201504;4502;11256;4069;10723;73;183;3784;9978;3857;10161
210160;201504;17426;55600;16420;54121;1661;4847;13341;45554;15002;50401
210170;201504;14055;50607;13726;50181;798;2589;12311;45987;13109;48576
210173;201504;1918;7970;1871;7887;110;517;1666;7044;1776;7561
210177;201504;3003;9462;2844;9274;194;697;2457;8023;2651;8720
210180;201504;1546;4733;1444;4583;80;294;1233;3909;1313;4203
210190;201504;4897;15619;4562;15039;260;1144;3619;11749;3879;12893
210193;201504;1405;4458;1270;4235;74;260;1065;3608;1139;3868
210197;201504;2076;6870;1922;6706;214;664;1556;5664;1770;6328
210200;201504;8700;29344;8064;28430;975;3214;6167;22657;7142;25871
210203;201504;6471;21201;6137;20774;390;1139;5473;18868;5863;20007
210207;201504;3044;10032;2850;9691;379;1190;2081;7323;2460;8513
210210;201504;8498;28922;8123;28448;131;572;7466;26516;7597;27088
210215;201504;1440;5780;1389;5701;119;550;1148;4735;1267;5285
210220;201504;6091;23459;5808;23018;430;1773;4809;19421;5239;21194
210230;201504;5068;17000;4700;16426;310;1138;3963;14005;4273;15143
210232;201504;12047;40179;10286;38020;1638;6134;7157;28034;8795;34168
210235;201504;3502;11029;3206;10648;182;698;2771;9273;2953;9971
210237;201504;2450;9258;2414;9209;38;126;2327;8945;2365;9071
210240;201504;3014;9528;2851;9300;168;518;2423;8008;2591;8526
210250;201504;4999;16138;4744;15812;127;533;4408;14682;4535;15215
210255;201504;2494;8019;2295;7658;392;1355;1583;5344;1975;6699
210260;201504;5384;17112;4899;16405;680;2203;3607;12456;4287;14659
210270;201504;5310;15205;4715;14383;108;428;4263;13030;4371;13458
210275;201504;3599;8926;3393;8707;64;101;3281;8524;3345;8625
210280;201504;5628;16996;4949;16126;299;1130;4143;13523;4442;14653
210290;201504;5634;18459;5160;17878;380;1249;4396;15588;4776;16837
210300;201504;36975;105978;30663;98216;2143;7100;24189;80460;26332;87560
210310;201504;2910;8310;2719;8058;102;259;2409;7204;2511;7463
210312;201504;2170;7018;2106;6926;79;329;1913;6296;1992;6625
210315;201504;2453;8504;2328;8331;123;491;2037;7336;2160;7827
210317;201504;4303;13012;4109;12766;238;708;3680;11593;3918;12301
210320;201504;19117;61027;17782;59422;971;3084;15623;53345;16594;56429
210325;201504;3563;11197;3191;10645;342;1219;2405;8126;2747;9345
210330;201504;36792;88863;28588;80183;3663;7976;20700;65317;24363;73293
210340;201504;11743;35760;10641;34388;1364;3531;7860;27488;9224;31019
210350;201504;10212;32086;9351;30905;636;2084;7760;26105;8396;28189
210355;201504;3937;14339;3639;13921;164;494;3290;12997;3454;13491
210360;201504;16887;50858;15483;48939;1183;3821;12513;40269;13696;44090
210370;201504;9361;22607;7932;21090;263;472;7190;19752;7453;20224
210375;201504;3229;9681;2702;9040;766;2637;1442;5013;2208;7650
210380;201504;6219;17526;5523;16605;446;1187;4624;14268;5070;15455
210390;201504;2832;10033;2585;9629;117;557;2233;8350;2350;8907
210400;201504;4959;15514;4748;15263;165;490;4373;14224;4538;14714
210405;201504;8454;23332;6843;21094;2063;6317;2932;10043;4995;16360
210407;201504;2051;7318;1811;6928;199;728;1403;5570;1602;6298
210408;201504;2343;9126;2196;8953;92;335;1966;8332;2058;8667
210409;201504;3767;13738;3564;13434;194;818;3029;11558;3223;12376
210410;201504;3495;11667;3367;11511;281;763;2905;10297;3186;11060
210420;201504;4078;13475;3765;12934;259;878;3119;10920;3378;11798
210430;201504;2194;6780;2125;6698;119;381;1891;5983;2010;6364
210440;201504;4106;12897;4003;12755;204;598;3614;11691;3818;12289
210450;201504;2888;9131;2591;8700;179;690;2136;7140;2315;7830
210455;201504;4120;12116;3628;11371;573;1811;2527;8168;3100;9979
210460;201504;3855;12475;3563;12075;142;561;3112;10619;3254;11180
210462;201504;1639;5902;1530;5699;105;459;1236;4632;1341;5091
210465;201504;2637;8707;2468;8489;293;795;1997;7208;2290;8003
210467;201504;6240;20648;5832;20172;379;1086;5077;18098;5456;19184
210470;201504;2045;5634;1578;4960;81;266;1271;4068;1352;4334
210480;201504;14003;45927;12232;43586;3081;10775;7230;27514;10311;38289
210490;201504;3482;10110;3135;9611;183;624;2637;8068;2820;8692
210500;201504;6396;26108;6136;25672;738;2917;4723;20546;5461;23463
210510;201504;6542;22299;6244;21948;331;839;5488;20025;5819;20864
210515;201504;3522;11862;3391;11706;130;383;3149;11042;3279;11425
210520;201504;2600;8110;2386;7815;105;348;2119;7015;2224;7363
210530;201504;36597;113797;29605;103306;7642;30051;13647;48771;21289;78822
210535;201504;3241;11394;3115;11209;132;485;2781;10108;2913;10593
210540;201504;13202;44567;11715;42291;2760;9645;6556;25671;9316;35316
210542;201504;5922;17536;5421;16991;319;783;4780;15477;5099;16260
210545;201504;2324;7577;2201;7378;82;390;1909;6369;1991;6759
210547;201504;3745;13196;3514;12822;289;982;2830;10608;3119;11590
210550;201504;5848;17227;5386;16748;233;503;4958;15850;5191;16353
210560;201504;4238;13209;3785;12481;218;825;3187;10478;3405;11303
210565;201504;1532;5323;1316;4997;114;536;981;3753;1095;4289
210570;201504;12547;35524;11259;34036;843;1886;9596;30121;10439;32007
210580;201504;3153;9572;2839;9179;354;902;2183;7713;2537;8615
210590;201504;4263;13298;4002;12992;241;767;3537;11639;3778;12406
210592;201504;2483;7773;2387;7621;64;254;2144;6844;2208;7098
210594;201504;2723;7730;2269;7093;125;330;1875;6062;2000;6392
210596;201504;2772;10314;2625;10040;275;1105;1985;7720;2260;8825
210598;201504;1933;6002;1795;5831;99;383;1602;5178;1701;5561
210600;201504;3257;9486;2888;8981;195;651;2364;7347;2559;7998
210610;201504;2727;8675;2467;8356;157;602;2097;7177;2254;7779
210620;201504;1938;6035;1794;5853;50;129;1650;5474;1700;5603
210630;201504;3657;13029;3228;12291;449;1773;2106;8273;2555;10046
210632;201504;4625;16015;4270;15516;392;1451;3482;12852;3874;14303
210635;201504;1918;6779;1827;6641;71;245;1660;6124;1731;6369
210637;201504;2771;9371;2584;9113;139;515;2219;7944;2358;8459
210640;201504;4279;15077;4202;14992;10;35;4107;14762;4117;14797
210650;201504;6878;21177;6728;21005;96;269;6539;20538;6635;20807
210660;201504;7765;23677;7221;22888;214;602;6731;21483;6945;22085
210663;201504;2674;7873;2516;7677;171;569;2142;6587;2313;7156
210667;201504;1798;6360;1712;6228;82;345;1504;5525;1586;5870
210670;201504;4489;16817;4306;16516;266;1129;3634;14146;3900;15275
210675;201504;4958;13889;4596;13446;327;869;3919;11728;4246;12597
210680;201504;4316;12256;3924;11790;203;549;3423;10448;3626;10997
210690;201504;7275;24138;6858;23694;263;785;6219;22085;6482;22870
210700;201504;2605;7849;2428;7656;527;1374;1595;5765;2122;7139
210710;201504;4790;15819;4567;15470;183;709;4014;13678;4197;14387
210720;201504;2545;9281;2392;9059;150;662;2098;7911;2248;8573
210725;201504;1099;4130;967;3893;136;597;586;2373;722;2970
210730;201504;1120;3618;1036;3508;88;250;862;2989;950;3239
210735;201504;4068;14372;3753;13838;699;2597;2507;9607;3206;12204
210740;201504;4965;14491;4703;14226;135;453;4476;13579;4611;14032
210745;201504;3882;11623;3627;11283;252;614;3096;9844;3348;10458
210750;201504;20449;55619;18191;53088;2017;5790;14459;43215;16476;49005
210760;201504;5988;16636;5644;16274;45;142;5520;15949;5565;16091
210770;201504;5772;16211;5126;15481;160;532;4697;14248;4857;14780
210780;201504;8531;28298;7826;27056;906;3318;5632;19841;6538;23159
210790;201504;4818;14764;4151;14026;290;730;3491;12378;3781;13108
210800;201504;4757;13797;4391;13377;139;408;3989;12326;4128;12734
210805;201504;3639;15458;3513;15233;140;619;3100;13678;3240;14297
210810;201504;5432;16735;5074;16301;367;654;4462;15144;4829;15798
210820;201504;8119;23360;7447;22435;1337;3934;4995;15512;6332;19446
210825;201504;5714;19434;5471;19129;354;1110;4763;17058;5117;18168
210830;201504;8463;25535;8080;25081;793;2154;6716;21509;7509;23663
210840;201504;3727;10297;3375;9771;220;564;2738;7995;2958;8559
210845;201504;5749;17883;5522;17635;162;376;5131;16758;5293;17134
210850;201504;6121;22078;5622;21229;739;3130;4060;15442;4799;18572
210860;201504;17431;52816;15901;50758;1456;4777;12648;40997;14104;45774
210870;201504;6070;20086;5531;19454;552;1780;4461;16183;5013;17963
210880;201504;4269;13858;4142;13681;181;584;3751;12528;3932;13112
210890;201504;5398;15888;4931;15343;416;1346;4117;13013;4533;14359
210900;201504;5001;15185;4178;13851;1402;4802;1498;5349;2900;10151
210905;201504;1854;5835;1711;5646;125;324;1424;4874;1549;5198
210910;201504;8998;28571;8230;27361;1377;4877;5643;18924;7020;23801
210920;201504;3160;10933;3044;10753;167;597;2638;9467;2805;10064
210923;201504;1490;5329;1382;5171;163;612;998;3920;1161;4532
210927;201504;4824;15239;4623;15029;22;72;4533;14802;4555;14874
210930;201504;2545;9274;2427;9122;152;751;2084;7776;2236;8527
210940;201504;2828;11090;2775;10995;222;875;2336;9373;2558;10248
210945;201504;5970;17752;5760;17536;242;280;5464;17140;5706;17420
210950;201504;5380;16588;4738;15575;471;1585;3570;12009;4041;13594
210955;201504;1898;6162;1678;5838;253;869;1151;4220;1404;5089
210960;201504;8825;29015;8473;28533;2495;8125;4876;17596;7371;25721
210970;201504;1412;5060;1257;4820;173;791;884;3417;1057;4208
210975;201504;1767;5990;1682;5841;136;508;1353;4755;1489;5263
210980;201504;9883;23522;9617;23234;712;1397;8464;21009;9176;22406
210990;201504;16835;50068;13550;45869;2911;10308;7981;27985;10892;38293
211000;201504;15882;51050;14205;49013;728;2672;12399;43616;13127;46288
211003;201504;4788;17003;4387;16412;361;1523;3395;13032;3756;14555
211010;201504;6604;23587;6379;23327;87;286;6114;22586;6201;22872
211020;201504;7398;23538;7220;23269;335;1099;6442;20917;6777;22016
211023;201504;2345;7916;2264;7769;136;487;1956;6790;2092;7277
211027;201504;2913;11384;2818;11238;246;893;2343;9620;2589;10513
211030;201504;4060;12270;3672;11858;583;1355;2865;9990;3448;11345
211040;201504;4294;16326;4160;16118;132;578;3708;14614;3840;15192
211050;201504;10190;26942;10010;26744;251;553;9592;25809;9843;26362
211060;201504;6016;21508;5866;21287;458;1630;5018;18533;5476;20163
211065;201504;1836;6166;1671;5959;33;95;1596;5770;1629;5865
211070;201504;8331;28338;7691;27270;485;1773;6374;22957;6859;24730
211080;201504;1408;4259;1155;3900;100;490;918;3003;1018;3493
211085;201504;1883;6555;1725;6297;245;878;1249;4684;1494;5562
211090;201504;3567;10726;3353;10440;125;513;2945;9079;3070;9592
211100;201504;6683;17428;6515;17240;50;183;6325;16721;6375;16904
211102;201504;3110;11527;2949;11306;258;942;2513;9845;2771;10787
211105;201504;2713;8641;2335;8110;169;685;1927;6645;2096;7330
211107;201504;4515;14355;4090;13796;240;764;3490;12122;3730;12886
211110;201504;6321;19065;5141;17316;1003;3320;3152;11160;4155;14480
211120;201504;34044;93749;30156;89098;4696;13070;21730;66844;26426;79914
211125;201504;2122;6875;1908;6543;115;416;1640;5671;1755;6087
211130;201504;136047;384298;124830;370423;22927;68258;83835;254448;106762;322706
211140;201504;5444;17344;5096;16813;219;798;4404;14576;4623;15374
211150;201504;9917;29339;9152;28407;524;1765;7887;24632;8411;26397
211153;201504;2982;9131;2778;8889;394;1064;2202;7411;2596;8475
211157;201504;1232;3959;1052;3696;114;494;712;2581;826;3075
211160;201504;4083;13776;3521;12829;315;1450;2592;9375;2907;10825
211163;201504;1655;5564;1577;5451;51;176;1431;5041;1482;5217
211167;201504;1529;5045;1425;4894;27;106;1336;4620;1363;4726
211170;201504;6501;17320;6242;17026;117;360;5826;15884;5943;16244
211172;201504;2399;7111;2169;6771;142;569;1834;5622;1976;6191
211174;201504;2830;8272;2563;7940;79;331;2309;7094;2388;7425
211176;201504;4881;15180;4329;14509;467;1574;3332;11512;3799;13086
211178;201504;3480;9818;3418;9754;59;115;3307;9507;3366;9622
211180;201504;4332;15267;4088;14892;296;1156;3408;12615;3704;13771
211190;201504;2815;9506;2620;9235;79;353;2331;8276;2410;8629
211195;201504;1499;4597;1248;4287;83;248;1038;3713;1121;3961
211200;201504;2195;7413;1940;7077;253;792;1465;5691;1718;6483
211210;201504;7164;21708;6863;21306;399;1231;5972;18766;6371;19997
211220;201504;34418;100460;29727;94529;5828;19096;19153;62589;24981;81685
211223;201504;5240;15499;4789;14790;538;1689;3594;11288;4132;12977
211227;201504;1646;6044;1531;5870;134;609;1214;4688;1348;5297
211230;201504;8667;28570;7857;27245;997;3562;5741;20313;6738;23875
211240;201504;8156;28063;7793;27641;261;948;7231;25773;7492;26721
211245;201504;5494;15958;5435;15889;105;195;5232;15470;5337;15665
211250;201504;12855;44102;12126;43287;1454;3769;9790;37488;11244;41257
211260;201504;8515;26530;8273;26213;588;1849;7311;23335;7899;25184
211270;201504;10484;36039;9448;34768;564;2388;7798;29266;8362;31654
211280;201504;12675;37665;11960;36815;1076;2595;10117;32484;11193;35079
211285;201504;1755;6439;1568;6026;330;1364;814;3253;1144;4617
211290;201504;7258;24063;7036;23786;623;1777;5986;20828;6609;22605
211300;201504;8285;25238;7747;24504;244;793;7010;22325;7254;23118
211400;201504;11582;36139;10433;34666;2636;8607;5579;20625;8215;29232
220005;201504;1818;5273;1677;5064;72;291;1396;4111;1468;4402
220010;201504;1465;4172;1286;3913;84;307;975;2946;1059;3253
220020;201504;3369;10585;3168;10248;557;1862;2122;6874;2679;8736
220025;201504;2260;5562;2032;5226;48;140;1775;4526;1823;4666
220027;201504;1378;3739;1256;3587;74;195;1064;3082;1138;3277
220030;201504;3349;9421;3285;9319;185;611;2877;8115;3062;8726
220040;201504;7838;24490;7321;23620;1413;4709;4653;15019;6066;19728
220045;201504;1414;4582;1296;4368;87;364;982;3239;1069;3603
220050;201504;4600;13556;4008;12642;258;972;3261;10180;3519;11152
220060;201504;1995;5242;1908;5143;53;136;1778;4810;1831;4946
220070;201504;2483;7322;2249;6960;148;496;1818;5616;1966;6112
220080;201504;738;2297;699;2235;71;299;558;1720;629;2019
220090;201504;1815;4622;1550;4274;88;302;1328;3597;1416;3899
220095;201504;747;2017;705;1959;27;83;655;1808;682;1891
220100;201504;1400;4244;1189;3898;120;416;879;2913;999;3329
220105;201504;2215;7200;1999;6787;168;593;1490;5077;1658;5670
220110;201504;3402;10067;3200;9741;170;662;2710;8088;2880;8750
220115;201504;2401;8530;2311;8391;188;764;1974;7155;2162;7919
220117;201504;1386;3683;1134;3316;92;267;902;2652;994;2919
220120;201504;12330;35818;11503;34801;183;743;10864;32839;11047;33582
220130;201504;899;3101;786;2946;60;198;669;2558;729;2756
220140;201504;1640;4427;1472;4222;225;473;1176;3568;1401;4041
220150;201504;7039;21964;6688;21494;199;773;6105;19610;6304;20383
220155;201504;1106;3432;908;3060;72;299;623;2044;695;2343
220157;201504;1066;2703;949;2532;23;71;837;2212;860;2283
220160;201504;2755;8265;2426;7704;132;545;1946;6110;2078;6655
220170;201504;1381;4306;1216;4036;64;292;993;3272;1057;3564
220173;201504;2056;6271;1732;5650;59;295;1417;4564;1476;4859
220177;201504;1770;5204;1740;5159;61;185;1633;4853;1694;5038
220180;201504;1185;3198;1007;2888;37;141;759;2113;796;2254
220190;201504;4605;15344;4206;14801;558;1880;3261;11712;3819;13592
220191;201504;1440;4898;1374;4783;182;625;1024;3596;1206;4221
220192;201504;1814;5159;1439;4490;137;457;1010;3153;1147;3610
220194;201504;1717;5110;1557;4842;146;506;1183;3587;1329;4093
220196;201504;1974;5856;1824;5612;187;631;1398;4290;1585;4921
220198;201504;1346;3810;1062;3445;17;59;991;3250;1008;3309
220200;201504;4396;15034;4184;14725;645;2323;3015;10750;3660;13073
220202;201504;2060;6469;1869;6123;41;180;1686;5489;1727;5669
220205;201504;2935;7562;2555;7056;48;184;2311;6329;2359;6513
220207;201504;871;2717;778;2558;75;298;590;1916;665;2214
220208;201504;1781;5863;1578;5502;200;815;1112;3844;1312;4659
220209;201504;1523;4707;1391;4499;62;269;1128;3621;1190;3890
220210;201504;1768;4764;1563;4464;47;184;1332;3750;1379;3934
220211;201504;1634;4799;1554;4696;93;383;1337;3976;1430;4359
220213;201504;1767;5106;1645;4891;53;207;1377;4028;1430;4235
220217;201504;1910;6239;1834;6150;33;90;1724;5853;1757;5943
220220;201504;11223;31580;10191;30033;933;2484;7542;22845;8475;25329
220225;201504;1061;3170;929;2989;39;169;804;2547;843;2716
220230;201504;5686;15371;4974;14404;156;431;4466;13025;4622;13456
220240;201504;2862;8988;2672;8666;187;685;2091;6761;2278;7446
220245;201504;1488;4031;1328;3806;49;148;1165;3381;1214;3529
220250;201504;3177;9063;2966;8753;55;165;2742;8149;2797;8314
220253;201504;1773;5285;1498;4812;144;545;1114;3564;1258;4109
220255;201504;1768;5032;1537;4657;78;328;1267;3732;1345;4060
220260;201504;4764;15284;4228;14308;340;1195;3221;10981;3561;12176
220265;201504;1336;4693;1227;4522;106;460;869;3240;975;3700
220270;201504;6794;22061;6587;21704;346;1598;5701;18355;6047;19953
220271;201504;1502;4242;1401;4094;63;149;1237;3690;1300;3839
220272;201504;1805;5543;1665;5299;82;336;1343;4232;1425;4568
220273;201504;1215;3582;1092;3373;94;313;844;2591;938;2904
220275;201504;2080;5412;1740;5003;28;97;1616;4621;1644;4718
220277;201504;2351;6622;2116;6267;112;375;1737;5167;1849;5542
220280;201504;1738;4611;1515;4241;121;429;1146;3111;1267;3540
220285;201504;1597;4363;1381;4063;46;180;1211;3586;1257;3766
220290;201504;6204;20711;5390;19604;516;2122;4114;15062;4630;17184
220300;201504;1959;6402;1743;6105;84;391;1469;5123;1553;5514
220310;201504;2517;8430;2243;8123;69;198;2043;7661;2112;7859
220320;201504;3355;9975;2847;9079;338;1186;2031;6475;2369;7661
220323;201504;1503;5338;1318;5071;146;601;998;3898;1144;4499
220325;201504;1157;3788;1030;3537;96;398;756;2583;852;2981
220327;201504;1374;4410;1246;4196;58;294;1006;3331;1064;3625
220330;201504;3640;10110;3406;9818;145;412;3049;8852;3194;9264
220335;201504;2035;5957;1808;5688;70;224;1616;5138;1686;5362
220340;201504;1918;5342;1651;4947;128;423;1271;3774;1399;4197
220342;201504;1098;3724;1037;3634;82;343;847;2979;929;3322
220345;201504;2930;7738;2553;7153;54;155;2299;6429;2353;6584
220350;201504;4049;10799;3523;10001;198;617;2866;8115;3064;8732
220360;201504;1290;3667;1132;3410;111;386;850;2524;961;2910
220370;201504;9188;26424;8335;25330;354;1066;7497;22899;7851;23965
220375;201504;1550;4865;1434;4723;37;134;1343;4452;1380;4586
220380;201504;1420;3831;1215;3553;66;218;993;2881;1059;3099
220385;201504;815;2147;675;1917;35;117;549;1531;584;1648
220390;201504;9509;29666;8571;27932;2247;7689;3331;10971;5578;18660
220400;201504;1534;3611;1269;3212;41;144;1080;2650;1121;2794
220410;201504;1411;4013;1179;3682;101;401;912;2785;1013;3186
220415;201504;865;2363;776;2245;62;182;588;1701;650;1883
220420;201504;2190;6381;1908;5818;107;337;1544;4726;1651;5063
220430;201504;2567;7478;2485;7365;149;473;2143;6334;2292;6807
220435;201504;1601;4760;1489;4578;41;131;1282;3952;1323;4083
220440;201504;2497;8161;2310;7943;116;392;2035;7030;2151;7422
220450;201504;2333;7101;1987;6607;447;1598;1160;3855;1607;5453
220455;201504;1343;4297;1250;4169;46;149;1142;3857;1188;4006
220460;201504;960;2581;886;2492;38;106;799;2241;837;2347
220465;201504;2357;7844;2142;7517;514;1917;1282;4535;1796;6452
220470;201504;4044;12051;3682;11459;211;753;2886;8863;3097;9616
220480;201504;2566;7379;2295;6993;162;492;1854;5676;2016;6168
220490;201504;2334;6723;2164;6513;73;269;1940;5826;2013;6095
220500;201504;3383;9059;2840;8145;116;504;2318;6466;2434;6970
220510;201504;3018;8398;2264;7248;110;474;1688;5355;1798;5829
220515;201504;2007;4890;1749;4566;144;343;1425;3777;1569;4120
220520;201504;5243;14512;4832;13957;132;396;4378;12720;4510;13116
220525;201504;1349;3832;1255;3692;60;213;1071;3112;1131;3325
220527;201504;1412;4338;1263;4021;139;445;939;3061;1078;3506
220530;201504;1246;3680;1126;3504;70;279;957;2913;1027;3192
220535;201504;907;2747;861;2691;82;281;679;2114;761;2395
220540;201504;3525;11472;3365;11229;160;651;2900;9655;3060;10306
220545;201504;1424;4830;1362;4720;171;690;1011;3441;1182;4131
220550;201504;9237;29944;8677;29029;1064;3759;6420;21598;7484;25357
220551;201504;1440;4765;1330;4587;83;374;1073;3663;1156;4037
220552;201504;1616;5124;1410;4736;92;445;1075;3471;1167;3916
220553;201504;1673;4917;1386;4487;64;242;1119;3662;1183;3904
220554;201504;826;2388;733;2252;73;234;568;1754;641;1988
220555;201504;2355;6976;2192;6774;52;192;1988;6146;2040;6338
220556;201504;1476;4595;1326;4316;67;278;1032;3308;1099;3586
220557;201504;1572;5159;1420;4869;175;661;964;3296;1139;3957
220558;201504;1072;3319;976;3152;72;312;728;2283;800;2595
220559;201504;1516;4250;1370;4017;39;144;1195;3495;1234;3639
220560;201504;1757;4328;1438;3904;71;193;1224;3310;1295;3503
220570;201504;7490;23997;7024;23231;1298;4278;4652;15801;5950;20079
220580;201504;6568;21308;6405;21114;301;917;5894;19656;6195;20573
220585;201504;1992;7192;1902;7029;117;471;1614;5989;1731;6460
220590;201504;1356;4127;1230;3949;197;653;852;2794;1049;3447
220595;201504;2395;6975;2196;6710;45;179;1994;6068;2039;6247
220600;201504;1298;3170;1062;2879;181;354;769;2236;950;2590
220605;201504;1997;5888;1744;5503;79;262;1452;4582;1531;4844
220610;201504;2716;8299;2623;8162;92;366;2355;7294;2447;7660
220620;201504;7820;26376;7577;26025;319;1301;6793;23346;7112;24647
220630;201504;405;1251;349;1144;64;218;191;633;255;851
220635;201504;1767;6293;1602;5929;119;574;1105;4030;1224;4604
220640;201504;2681;7831;2461;7526;136;470;2096;6391;2232;6861
220650;201504;2329;6719;2079;6292;116;406;1692;5090;1808;5496
220660;201504;2574;8187;2288;7811;196;863;1895;6329;2091;7192
220665;201504;1180;4144;1129;4054;35;165;1032;3694;1067;3859
220667;201504;1800;5955;1695;5818;57;203;1482;5130;1539;5333
220669;201504;1915;6233;1785;5999;270;1072;1209;4017;1479;5089
220670;201504;2074;6291;1888;6054;149;367;1616;5394;1765;5761
220672;201504;2546;7217;2415;7065;253;724;1997;5924;2250;6648
220675;201504;1313;3796;1226;3653;87;230;975;2930;1062;3160
220680;201504;2248;7310;2131;7152;166;556;1781;6058;1947;6614
220690;201504;1759;4891;1522;4512;98;326;1208;3593;1306;3919
220695;201504;924;2676;858;2568;46;160;689;2037;735;2197
220700;201504;8850;25417;7892;23958;595;2049;6181;18683;6776;20732
220710;201504;816;2407;679;2170;50;155;495;1601;545;1756
220720;201504;2085;5671;1981;5538;56;166;1783;5011;1839;5177
220730;201504;1409;3961;1209;3650;41;166;1019;3049;1060;3215
220735;201504;1029;2658;835;2319;42;152;682;1868;724;2020
220740;201504;1459;4595;1217;4274;141;486;958;3469;1099;3955
220750;201504;3998;11616;3744;11238;429;1079;2958;9202;3387;10281
220755;201504;1229;3532;1127;3362;56;197;938;2782;994;2979
220760;201504;2689;9388;2533;9185;118;510;2222;8110;2340;8620
220770;201504;22709;75710;20497;71457;6745;24698;7468;26879;14213;51577
220775;201504;1213;3186;1179;3148;8;12;1160;3108;1168;3120
220777;201504;1679;4679;1527;4452;97;266;1229;3568;1326;3834
220779;201504;1298;3552;1258;3500;37;134;1162;3182;1199;3316
220780;201504;6201;16338;5504;15339;373;1006;4586;12871;4959;13877
220785;201504;1319;3557;1281;3480;54;125;1192;3253;1246;3378
220790;201504;9960;31167;9308;30145;886;3055;7368;23789;8254;26844
220793;201504;851;2455;780;2344;39;146;667;1991;706;2137
220795;201504;1468;4128;1417;4056;73;212;1272;3653;1345;3865
220800;201504;16524;45756;15017;43651;1017;3628;11726;33684;12743;37312
220810;201504;3375;9830;2934;9097;154;619;2337;7169;2491;7788
220820;201504;5358;14872;4982;14346;184;591;4495;12929;4679;13520
220830;201504;7578;21525;7106;20761;698;2057;5608;16543;6306;18600
220840;201504;14683;46533;13137;43466;3150;10692;6273;21169;9423;31861
220850;201504;2857;9892;2730;9735;138;544;2409;8653;2547;9197
220855;201504;639;1969;567;1843;46;179;417;1332;463;1511
220860;201504;966;2618;865;2460;46;171;712;1992;758;2163
220865;201504;2714;7462;2172;6566;99;483;1761;5155;1860;5638
220870;201504;2384;7878;2104;7520;72;271;1922;6905;1994;7176
220880;201504;4846;13063;4551;12722;130;417;4240;11859;4370;12276
220885;201504;1344;4797;1191;4517;107;507;897;3384;1004;3891
220887;201504;1405;3529;1216;3266;21;66;1139;3064;1160;3130
220890;201504;1632;5723;1484;5474;116;402;1212;4609;1328;5011
220900;201504;1899;5447;1678;5028;74;208;1413;4246;1487;4454
220910;201504;1655;4969;1471;4701;62;199;1284;4143;1346;4342
220915;201504;1046;2979;900;2710;46;196;697;2047;743;2243
220920;201504;1353;4935;1242;4772;118;552;938;3561;1056;4113
220930;201504;1384;4647;1317;4551;68;285;1115;3872;1183;4157
220935;201504;1079;3302;964;3061;56;246;689;2109;745;2355
220937;201504;1551;4237;1307;3814;68;256;1020;2902;1088;3158
220940;201504;1420;4416;1314;4195;81;342;1016;3200;1097;3542
220945;201504;453;1642;419;1577;44;192;298;1104;342;1296
220950;201504;1325;3313;978;2750;33;132;726;1990;759;2122
220955;201504;1483;4318;1303;4014;95;317;1006;3093;1101;3410
220960;201504;905;2391;724;2087;18;73;587;1670;605;1743
220965;201504;1698;5109;1604;4975;60;276;1406;4295;1466;4571
220970;201504;2178;5811;1627;4931;153;478;1122;3435;1275;3913
220975;201504;663;2239;637;2208;30;123;590;2037;620;2160
220980;201504;1321;4053;1161;3775;99;372;845;2757;944;3129
220985;201504;1259;3703;1196;3609;99;348;951;2841;1050;3189
220987;201504;1537;4871;1399;4636;93;423;1067;3437;1160;3860
220990;201504;1878;5396;1634;4995;59;262;1280;3838;1339;4100
220995;201504;1315;3841;993;3332;83;329;743;2521;826;2850
220997;201504;2218;6986;2117;6840;63;210;1973;6398;2036;6608
221000;201504;4449;13621;4105;13046;436;1604;3077;9667;3513;11271
221005;201504;1451;4590;1337;4372;488;1491;597;2099;1085;3590
221010;201504;1177;3205;1012;2989;49;144;890;2639;939;2783
221020;201504;1845;5723;1720;5499;96;415;1318;4144;1414;4559
221030;201504;1633;4694;1437;4390;82;342;1186;3570;1268;3912
221035;201504;1455;4040;1369;3935;51;114;1266;3694;1317;3808
221037;201504;640;1922;575;1813;23;100;444;1344;467;1444
221038;201504;633;1786;510;1576;44;128;332;1051;376;1179
221039;201504;927;2669;847;2553;50;207;728;2140;778;2347
221040;201504;4714;14508;4449;14076;239;832;3680;11735;3919;12567
221050;201504;3524;10858;3346;10617;169;629;2900;9176;3069;9805
221060;201504;8228;23795;7368;22448;716;2338;5622;17219;6338;19557
221062;201504;1303;4569;1219;4435;27;100;1115;4098;1142;4198
221063;201504;1059;3519;984;3376;271;872;579;2155;850;3027
221065;201504;2821;7879;2577;7502;200;590;2116;6141;2316;6731
221070;201504;3958;12442;3503;11691;162;660;2909;9724;3071;10384
221080;201504;3518;9294;3067;8688;140;443;2632;7475;2772;7918
221090;201504;1379;3795;1186;3484;33;143;984;2838;1017;2981
221093;201504;1725;5159;1624;4952;338;1109;905;2696;1243;3805
221095;201504;977;2647;883;2514;26;74;776;2220;802;2294
221097;201504;811;2289;689;2077;53;212;511;1500;564;1712
221100;201504;117895;345981;108518;330525;20547;67399;67771;203239;88318;270638
221110;201504;10234;32912;9672;32220;449;1706;8474;28293;8923;29999
221120;201504;4166;13639;3962;13285;836;2903;2630;8903;3466;11806
221130;201504;4578;13359;3924;12050;1287;3980;1651;5093;2938;9073
221135;201504;1495;4731;1395;4593;155;595;1128;3652;1283;4247
221140;201504;1369;3407;1256;3258;57;137;1127;2931;1184;3068
221150;201504;1242;3207;1025;2839;27;122;821;2234;848;2356
221160;201504;851;2248;801;2171;39;116;645;1765;684;1881
221170;201504;1159;3612;1075;3473;66;238;869;2791;935;3029
230010;201504;3312;9140;2783;8243;149;507;2290;6751;2439;7258
230015;201504;2879;9978;2694;9579;406;1683;1711;5978;2117;7661
230020;201504;14400;47246;13922;46421;686;2518;11907;39969;12593;42487
230030;201504;12298;35718;11228;34057;579;1995;9411;28495;9990;30490
230040;201504;4640;12851;3929;11655;263;934;3024;8898;3287;9832
230050;201504;2612;8977;2068;7538;430;1658;854;3116;1284;4774
230060;201504;2161;6302;1884;5812;122;449;1421;4332;1543;4781
230070;201504;4488;12271;3854;11295;367;1185;2716;8066;3083;9251
230075;201504;8837;31954;8287;30841;631;3174;6602;24103;7233;27277
230080;201504;2409;6412;1966;5768;96;310;1639;4813;1735;5123
230090;201504;3752;11155;3351;10465;389;1336;2445;7667;2834;9003
230100;201504;16702;50293;15259;47648;2888;9717;8952;28093;11840;37810
230110;201504;13697;44055;12676;41942;2386;8507;7264;23774;9650;32281
230120;201504;8019;22206;6943;20662;779;2233;4865;15300;5644;17533
230125;201504;2961;8676;2448;7709;176;606;1797;5640;1973;6246
230130;201504;5847;19203;4964;17344;498;2075;3410;11706;3908;13781
230140;201504;3637;11650;3102;10690;403;1483;2086;7343;2489;8826
230150;201504;1680;5323;1464;4880;270;1021;877;2840;1147;3861
230160;201504;6506;19533;5786;18446;394;1500;4545;14430;4939;15930
230170;201504;6565;20503;5601;18739;391;1555;4146;13762;4537;15317
230180;201504;1777;5225;1579;4852;102;398;1177;3507;1279;3905
230185;201504;4203;13760;3806;13031;670;2339;2383;8464;3053;10803
230190;201504;13149;41969;11659;39006;2447;9183;5809;19079;8256;28262
230195;201504;5179;15938;4593;14969;276;1217;3655;11583;3931;12800
230200;201504;5533;16043;4958;14933;442;1450;3690;11044;4132;12494
230205;201504;4278;13628;3831;12865;273;1171;2823;9441;3096;10612
230210;201504;9123;26457;7954;24647;1802;5677;4477;14351;6279;20028
230220;201504;13262;38282;11994;36125;1255;4336;8754;25980;10009;30316
230230;201504;7650;24878;6942;23482;1018;3612;4451;15209;5469;18821
230240;201504;13797;39333;12290;36753;634;2359;9765;28747;10399;31106
230250;201504;10136;31494;9966;31249;430;1598;8561;26725;8991;28323
230260;201504;14698;49628;13647;47560;2483;9223;7962;28318;10445;37541
230270;201504;7399;22111;6408;20403;758;2672;4365;14015;5123;16687
230280;201504;19940;59682;17807;56119;2205;7042;12686;40417;14891;47459
230290;201504;4880;15013;4203;13658;580;1900;2832;9257;3412;11157
230300;201504;4461;13695;4247;13385;325;1244;3412;10613;3737;11857
230310;201504;4902;14641;4283;13618;291;1214;3207;10043;3498;11257
230320;201504;7092;22695;6525;21694;515;2112;5005;16528;5520;18640
230330;201504;4885;14408;4222;13121;327;1155;3060;9433;3387;10588
230340;201504;3461;11783;3179;11188;435;1746;2048;7042;2483;8788
230350;201504;17963;55279;16274;52398;2244;7938;10140;33366;12384;41304
230360;201504;3316;9558;2722;8456;314;1110;1825;5621;2139;6731
230365;201504;3075;8489;2695;7873;124;468;2204;6384;2328;6852
230370;201504;54665;177897;49499;169007;13514;48712;23357;82002;36871;130714
230380;201504;6617;19501;5640;17752;372;1318;4180;13180;4552;14498
230390;201504;3583;11304;3183;10625;296;1265;2275;7451;2571;8716
230393;201504;3294;10917;2822;9951;262;1265;1994;6744;2256;8009
230395;201504;5408;16247;4854;15278;777;2525;3023;9732;3800;12257
230400;201504;5374;16507;4684;15420;300;1313;3635;11764;3935;13077
230410;201504;14364;45998;12672;42426;1878;6770;7875;26362;9753;33132
230420;201504;24638;80189;22506;75918;5323;19431;10799;36293;16122;55724
230423;201504;4169;13849;3861;13238;289;1202;2966;10097;3255;11299
230425;201504;5586;18612;5132;17598;717;2611;3403;11706;4120;14317
230426;201504;2801;7857;2243;6810;117;482;1690;5003;1807;5485
230427;201504;1819;5497;1404;4603;151;559;899;2879;1050;3438
230428;201504;8608;27397;8228;26732;1351;4916;5197;16713;6548;21629
230430;201504;4555;14592;4251;14015;365;1501;3088;9952;3453;11453
230435;201504;4788;15620;4318;14789;799;3134;2390;8130;3189;11264
230440;201504;353870;1071873;327085;1025283;78774;263023;158097;497860;236871;760883
230445;201504;4580;12393;3864;11344;269;758;2898;8667;3167;9425
230450;201504;3572;11472;3115;10647;366;1538;2088;7034;2454;8572
230460;201504;1920;6411;1702;6016;183;772;1188;4155;1371;4927
230465;201504;4188;12522;3526;11321;275;1164;2439;7675;2714;8839
230470;201504;10710;39635;10029;38259;1154;4858;7317;28036;8471;32894
230480;201504;1454;4694;1243;4302;176;664;811;2819;987;3483
230490;201504;2584;7798;2240;7156;394;1394;1158;3567;1552;4961
230495;201504;5818;19410;5250;18459;787;3321;3058;10711;3845;14032
230500;201504;9547;33527;9126;32755;624;2669;7227;26046;7851;28715
230510;201504;1539;5512;1259;4804;334;1371;431;1717;765;3088
230520;201504;4867;15017;4371;14128;464;1728;2926;9420;3390;11148
230523;201504;14596;47790;12831;43749;3129;11808;3510;12196;6639;24004
230526;201504;4049;12444;3536;11578;287;1155;2631;8578;2918;9733
230530;201504;5369;17610;4872;16943;1020;3594;3162;11355;4182;14949
230533;201504;3958;11325;3563;10605;252;825;2768;8216;3020;9041
230535;201504;5588;16568;4897;15337;671;2087;3184;10309;3855;12396
230540;201504;18259;53197;16417;50312;725;2861;13837;42046;14562;44907
230550;201504;19782;59600;17824;55855;3694;12549;9545;29639;13239;42188
230560;201504;6684;19386;5971;18107;251;1015;4813;14403;5064;15418
230565;201504;3388;9545;2748;8331;153;568;2016;6054;2169;6622
230570;201504;3846;10378;3381;9806;136;523;2858;8216;2994;8739
230580;201504;10212;31171;9562;30260;455;1515;8511;27134;8966;28649
230590;201504;8917;28110;7792;25975;603;2583;5749;18701;6352;21284
230600;201504;3670;10362;2854;8724;196;669;1874;5718;2070;6387
230610;201504;6039;19769;5625;19100;723;2555;4064;13984;4787;16539
230620;201504;2192;6236;1744;5281;185;629;1048;3082;1233;3711
230625;201504;7906;25698;7081;23850;2126;7690;2177;7320;4303;15010
230630;201504;11462;36810;10460;34984;2776;8840;4985;17890;7761;26730
230640;201504;26198;86197;24275;83373;2728;10278;18560;63934;21288;74212
230650;201504;4962;15268;4462;14307;294;1205;3441;10776;3735;11981
230655;201504;9079;34345;8719;33727;691;2785;7239;28476;7930;31261
230660;201504;6206;19419;5316;17770;390;1668;4013;13201;4403;14869
230670;201504;6132;16568;4954;14560;197;770;3830;10949;4027;11719
230680;201504;2925;8547;2450;7666;378;1277;1450;4512;1828;5789
230690;201504;6260;20609;6168;20421;537;2197;4357;14156;4894;16353
230700;201504;9418;27084;8415;25333;753;2779;6000;17576;6753;20355
230710;201504;7493;24507;6545;22749;781;2765;4691;16556;5472;19321
230720;201504;1913;6059;1658;5577;206;733;1112;3802;1318;4535
230725;201504;3736;12663;3272;11537;777;2815;1380;4883;2157;7698
230730;201504;57667;174879;47883;158664;13163;48249;15755;53596;28918;101845
230740;201504;5923;18171;5457;17399;278;1205;4510;14182;4788;15387
230750;201504;8605;24782;7352;22781;453;1668;5765;17748;6218;19416
230760;201504;10439;31371;9739;29939;1063;3898;6889;20381;7952;24279
230763;201504;4324;13476;3935;12734;250;1172;3036;9515;3286;10687
230765;201504;39359;126744;35812;119702;9963;36255;12470;41941;22433;78196
230770;201504;24836;69197;22761;66350;2545;7943;16472;48207;19017;56150
230780;201504;6130;23790;5851;23183;1488;6020;2883;12058;4371;18078
230790;201504;2640;8731;2456;8425;268;997;1839;6349;2107;7346
230800;201504;7612;27250;6931;25751;1534;6175;3273;12107;4807;18282
230810;201504;12151;39730;11498;38620;953;3367;9313;31532;10266;34899
230820;201504;3378;11576;2962;10681;441;1833;1719;6111;2160;7944
230830;201504;7642;23349;6785;21781;616;2301;4901;15618;5517;17919
230835;201504;4099;10912;3388;9881;226;735;2677;7813;2903;8548
230837;201504;3178;10826;2772;10006;318;1363;1877;6683;2195;8046
230840;201504;9247;30358;8461;28998;795;3052;6399;22103;7194;25155
230850;201504;10189;31356;9375;30197;1013;3572;6973;22439;7986;26011
230860;201504;5296;15286;4703;14344;285;1028;3764;11417;4049;12445
230870;201504;19023;50791;16594;47156;974;3192;13010;36789;13984;39981
230880;201504;1930;6663;1813;6428;213;917;1221;4277;1434;5194
230890;201504;3964;14565;3669;13911;537;2456;2349;8687;2886;11143
230900;201504;3012;10062;2561;9114;537;1872;1309;4787;1846;6659
230910;201504;3188;9365;2579;8255;209;859;1863;5828;2072;6687
230920;201504;4571;13485;4271;13121;166;621;3814;11801;3980;12422
230930;201504;7536;22915;6666;21281;699;2380;4601;14811;5300;17191
230940;201504;7771;22312;6795;20831;392;1256;5465;16887;5857;18143
230945;201504;6243;18781;5405;17559;535;1996;3811;12556;4346;14552
230950;201504;7120;19429;6249;18283;377;1164;4996;14841;5373;16005
230960;201504;13922;43202;12663;40805;2732;9435;6047;19711;8779;29146
230970;201504;13444;41788;11931;38935;2466;9076;5577;17891;8043;26967
230980;201504;2983;9520;2627;8863;757;2611;1241;4372;1998;6983
230990;201504;1705;5144;1418;4567;144;596;940;2936;1084;3532
231000;201504;2883;7806;2273;6637;218;748;1462;4138;1680;4886
231010;201504;3231;8801;2683;7934;255;889;1991;5783;2246;6672
231020;201504;7948;26734;7545;25901;1339;4684;4738;16621;6077;21305
231025;201504;7960;24659;7221;23408;1046;3571;4763;15751;5809;19322
231030;201504;8078;26276;6827;23726;1206;4533;3914;13695;5120;18228
231040;201504;3164;10223;2819;9526;231;973;2025;6689;2256;7662
231050;201504;12104;34558;10341;31413;830;2836;7681;23243;8511;26079
231060;201504;2482;7956;2269;7581;181;820;1628;5303;1809;6123
231070;201504;8903;28351;8129;26809;1362;4791;4827;16080;6189;20871
231080;201504;4252;13356;3874;12708;211;988;2957;9389;3168;10377
231085;201504;4725;14910;4554;14673;603;1857;3411;11411;4014;13268
231090;201504;4217;11868;3424;10287;187;688;2416;7136;2603;7824
231095;201504;2264;7370;1941;6718;212;823;1306;4538;1518;5361
231100;201504;3199;9916;2679;8900;226;885;1917;6296;2143;7181
231110;201504;3767;12538;3685;12398;365;1393;2739;9225;3104;10618
231120;201504;2152;7201;2017;6930;313;1150;1326;4596;1639;5746
231123;201504;2172;5954;1848;5394;143;373;1457;4297;1600;4670
231126;201504;6454;18216;5404;16565;349;1345;4063;12354;4412;13699
231130;201504;19186;59647;17286;56446;3585;12054;10054;34279;13639;46333
231135;201504;4311;12835;3634;11678;315;1172;2646;8441;2961;9613
231140;201504;16880;53630;15025;50129;1414;6352;10068;32382;11482;38734
231150;201504;5848;16859;4914;15136;800;2697;2702;8175;3502;10872
231160;201504;5755;19510;5420;18871;928;3403;3596;12579;4524;15982
231170;201504;4377;14139;3934;13222;343;1481;2762;9046;3105;10527
231180;201504;14357;43087;12917;40259;2170;7354;7819;24018;9989;31372
231190;201504;4721;13360;4027;12339;282;1034;3178;9594;3460;10628
231195;201504;4609;15674;3989;14444;394;1766;2870;10298;3264;12064
231200;201504;7837;26931;6859;24939;529;2599;4970;17693;5499;20292
231210;201504;5147;15919;4445;14951;261;1158;3528;11852;3789;13010
231220;201504;11794;34838;10672;32793;712;2736;7973;24084;8685;26820
231230;201504;8744;29918;8068;28855;769;3212;6225;22305;6994;25517
231240;201504;12086;38479;10919;36164;2193;7713;5727;19280;7920;26993
231250;201504;1968;5744;1371;4285;438;1325;300;977;738;2302
231260;201504;3723;10839;3352;10274;497;1523;2208;6906;2705;8429
231270;201504;7365;20513;6518;19170;425;1783;4968;14206;5393;15989
231280;201504;1778;5833;1658;5604;157;534;1207;4145;1364;4679
231290;201504;34025;117449;30900;110340;6846;27299;13287;46510;20133;73809
231300;201504;4674;13579;3790;11834;279;1096;2667;8108;2946;9204
231310;201504;7418;21221;6214;18761;982;3131;3539;10477;4521;13608
231320;201504;6925;21398;5968;19555;325;1360;4372;14312;4697;15672
231325;201504;2696;8132;2390;7627;222;772;1687;5478;1909;6250
231330;201504;12717;40250;10950;36803;1665;5695;6927;23592;8592;29287
231335;201504;5362;15418;4644;14140;259;1046;3696;11005;3955;12051
231340;201504;17571;57971;16358;56181;1024;3477;13584;47736;14608;51213
231350;201504;13040;42355;12665;41810;1166;3655;10576;35566;11742;39221
231355;201504;4392;14231;4127;13803;223;856;3378;11364;3601;12220
231360;201504;7502;24518;6790;23260;1502;5084;4033;14342;5535;19426
231370;201504;2503;6970;1966;6095;91;306;1505;4667;1596;4973
231375;201504;4188;14344;3924;13841;263;1202;3177;11072;3440;12274
231380;201504;5226;16895;4951;16518;671;2342;3473;11913;4144;14255
231390;201504;3432;10842;3176;10424;242;1016;2385;7716;2627;8732
231395;201504;3935;12982;3613;12410;645;2305;2191;7621;2836;9926
231400;201504;9286;28558;8657;27313;645;2498;6462;20155;7107;22653
231410;201504;13518;46537;12552;44995;1074;4085;9827;35519;10901;39604
240010;201504;2467;7526;2097;6761;377;1364;1006;3121;1383;4485
240020;201504;11053;34953;9818;32618;2293;8187;4751;15926;7044;24113
240030;201504;2497;7332;2444;7246;163;567;2051;6004;2214;6571
240040;201504;846;2519;718;2264;34;160;520;1564;554;1724
240050;201504;3480;9478;2983;8625;130;470;2400;6846;2530;7316
240060;201504;1404;4102;1263;3830;64;257;1027;3013;1091;3270
240070;201504;2635;7557;2483;7284;384;1197;1701;4945;2085;6142
240080;201504;3055;8242;2626;7680;235;663;2028;5964;2263;6627
240090;201504;2316;6282;1937;5595;58;230;1538;4336;1596;4566
240100;201504;8719;25062;7850;23301;692;2392;5647;16300;6339;18692
240110;201504;5311;16228;4697;15085;821;2974;2692;8323;3513;11297
240120;201504;2761;9425;2639;9193;413;1571;1806;6301;2219;7872
240130;201504;2821;7608;2420;6998;148;537;1906;5397;2054;5934
240140;201504;2240;6766;1916;6170;332;1249;1087;3403;1419;4652
240145;201504;6004;18860;5388;17785;1419;5081;2706;9021;4125;14102
240150;201504;1009;3049;826;2680;88;372;530;1636;618;2008
240160;201504;1454;4700;1274;4392;182;688;781;2780;963;3468
240165;201504;895;2857;781;2617;114;342;491;1740;605;2082
240170;201504;2438;7273;2134;6725;552;1933;988;3039;1540;4972
240180;201504;2667;8471;2429;8027;522;1839;1363;4607;1885;6446
240185;201504;1426;4787;1368;4682;115;418;1084;3744;1199;4162
240190;201504;985;3022;897;2869;54;230;682;2135;736;2365
240200;201504;14294;37257;11895;34091;2575;7528;6216;18533;8791;26061
240210;201504;2860;8109;2615;7759;181;632;2198;6467;2379;7099
240220;201504;7407;24347;7004;23769;520;2271;5777;19365;6297;21636
240230;201504;5558;15178;4929;14144;214;731;4138;11776;4352;12507
240240;201504;1836;5574;1279;4201;303;1119;257;723;560;1842
240250;201504;2754;7996;2588;7777;139;468;2178;6519;2317;6987
240260;201504;13022;43951;12333;42842;1957;7692;8070;28056;10027;35748
240270;201504;2288;7347;2108;7050;203;685;1640;5583;1843;6268
240280;201504;1575;4444;1408;4165;82;302;1133;3304;1215;3606
240290;201504;1368;4313;1199;4009;95;454;820;2626;915;3080
240300;201504;2258;6286;1649;4984;419;1345;584;1709;1003;3054
240310;201504;9742;27988;8872;26630;1407;4662;4982;15101;6389;19763
240320;201504;2073;6157;1681;5355;79;348;1232;3783;1311;4131
240325;201504;38684;106001;30063;92119;9402;31129;7943;24841;17345;55970
240330;201504;1521;4574;1279;4101;123;494;842;2603;965;3097
240340;201504;1870;5326;1585;4876;181;601;1148;3524;1329;4125
240350;201504;1997;5891;1858;5706;132;486;1597;4869;1729;5355
240360;201504;7136;21428;6231;20084;1179;4075;3585;11927;4764;16002
240370;201504;1993;5487;1630;4843;204;619;1043;3106;1247;3725
240375;201504;870;2331;760;2161;125;420;483;1307;608;1727
240380;201504;2523;7540;1983;6337;273;903;1063;3375;1336;4278
240390;201504;963;2641;807;2355;55;209;598;1683;653;1892
240400;201504;1343;3707;1139;3356;118;393;811;2330;929;2723
240410;201504;524;1704;482;1621;87;344;296;984;383;1328
240420;201504;4763;18219;4509;17672;1069;4423;2507;10093;3576;14516
240430;201504;3294;9380;3034;8943;158;627;2462;7077;2620;7704
240440;201504;2653;7042;2398;6637;589;1651;1289;3562;1878;5213
240450;201504;3551;10735;3134;9945;315;1308;2057;6247;2372;7555
240460;201504;2961;9105;2797;8893;212;865;2314;7211;2526;8076
240470;201504;3682;11402;2952;9841;515;1785;1662;5513;2177;7298
240480;201504;514;1335;412;1131;36;101;241;648;277;749
240485;201504;2097;6490;1845;6019;340;1199;1073;3563;1413;4762
240490;201504;1664;4258;1407;3869;56;198;1155;3076;1211;3274
240500;201504;2102;6101;1914;5811;144;507;1490;4485;1634;4992
240510;201504;1789;5387;1661;5172;169;555;1304;4085;1473;4640
240520;201504;1361;3899;1164;3597;127;480;865;2611;992;3091
240530;201504;2112;6739;1902;6403;298;1051;1319;4455;1617;5506
240540;201504;1730;5323;1649;5193;137;499;1301;4074;1438;4573
240550;201504;845;2397;732;2206;57;197;563;1664;620;1861
240560;201504;3258;9533;3058;9243;279;845;2488;7589;2767;8434
240570;201504;3110;8787;2440;7302;554;1810;916;2450;1470;4260
240580;201504;7647;24239;7175;23405;937;3332;5370;17419;6307;20751
240590;201504;798;2255;691;2065;40;164;521;1520;561;1684
240600;201504;1652;4853;1313;4154;176;667;741;2235;917;2902
240610;201504;4929;13978;4250;12709;539;1767;2611;7602;3150;9369
240615;201504;1047;3048;853;2677;142;456;483;1493;625;1949
240620;201504;1750;5521;1566;5216;202;673;1174;3976;1376;4649
240630;201504;2009;6270;1865;6024;166;461;1424;4791;1590;5252
240640;201504;924;2693;779;2451;61;276;546;1653;607;1929
240650;201504;3796;11609;3461;11135;218;791;2831;9184;3049;9975
240660;201504;2406;7797;2274;7604;225;782;1782;6014;2007;6796
240670;201504;2728;8192;2269;7233;305;1083;1269;3975;1574;5058
240680;201504;1516;4464;1224;3935;126;449;776;2488;902;2937
240690;201504;984;2767;854;2549;54;212;689;1998;743;2210
240700;201504;2749;8204;2273;7313;96;455;1750;5494;1846;5949
240710;201504;18892;49040;16550;45788;3003;8246;10200;28951;13203;37197
240720;201504;5315;15217;4999;14718;1612;4989;2348;6714;3960;11703
240725;201504;1097;3279;854;2742;80;271;490;1533;570;1804
240730;201504;2197;6661;1896;6111;140;499;1427;4577;1567;5076
240740;201504;2016;5920;1814;5559;179;667;1271;3782;1450;4449
240750;201504;2249;8385;2049;8012;471;2057;1060;4169;1531;6226
240760;201504;1307;3674;1120;3425;112;263;838;2755;950;3018
240770;201504;3126;9062;2804;8614;158;609;2382;7246;2540;7855
240780;201504;6337;17485;5080;15536;964;3055;2832;8915;3796;11970
240790;201504;898;2753;735;2474;41;177;532;1808;573;1985
240800;201504;36702;105817;32741;99196;8018;25576;14347;43865;22365;69441
240810;201504;90763;263952;83971;252258;22607;70684;40086;121548;62693;192232
240820;201504;6810;20417;5823;18872;1390;4933;2558;8601;3948;13534
240830;201504;8763;27487;8223;26685;402;1442;7142;23253;7544;24695
240840;201504;1255;3500;1056;3185;91;310;682;1991;773;2301
240850;201504;1303;3875;950;3065;170;578;453;1430;623;2008
240860;201504;1352;3820;1126;3418;73;253;859;2551;932;2804
240870;201504;1186;3266;974;2873;93;322;626;1747;719;2069
240880;201504;1157;3953;1092;3853;120;518;830;2868;950;3386
240890;201504;5229;14863;4458;13453;894;2932;2154;6398;3048;9330
240895;201504;2724;9334;2480;8911;275;1051;1772;6485;2047;7536
240910;201504;2780;8512;2467;7915;177;684;1873;5953;2050;6637
240920;201504;804;2645;703;2417;179;688;310;1017;489;1705
240930;201504;3514;9295;3104;8791;185;519;2570;7399;2755;7918
240933;201504;1378;4079;1226;3829;140;528;855;2601;995;3129
240940;201504;6507;17969;5343;15968;933;2871;2990;8978;3923;11849
240950;201504;1035;3379;980;3287;73;325;765;2496;838;2821
240960;201504;792;2489;695;2300;91;330;482;1604;573;1934
240970;201504;2045;5649;1713;5091;128;464;1277;3714;1405;4178
240980;201504;3094;10201;2864;9764;549;2020;1770;6014;2319;8034
240990;201504;2938;8711;2754;8339;474;1563;1705;5095;2179;6658
241000;201504;1083;3029;921;2741;52;196;674;1983;726;2179
241010;201504;2961;9888;2713;9413;352;1494;1919;6452;2271;7946
241020;201504;2266;6303;1835;5474;144;505;1182;3404;1326;3909
241025;201504;1618;4946;1455;4640;93;408;1037;3237;1130;3645
241030;201504;2499;8356;2271;7928;164;685;1772;6211;1936;6896
241040;201504;2302;7929;2106;7573;233;932;1492;5428;1725;6360
241050;201504;1313;3871;1141;3576;63;262;889;2723;952;2985
241060;201504;881;2556;802;2422;51;150;630;1917;681;2067
241070;201504;883;2535;781;2358;81;276;531;1557;612;1833
241080;201504;1182;3506;987;3131;55;246;721;2232;776;2478
241090;201504;2184;6381;1864;5811;123;528;1464;4497;1587;5025
241100;201504;1180;3540;1021;3174;116;373;647;1998;763;2371
241105;201504;1165;3540;1063;3354;213;705;597;1916;810;2621
241110;201504;847;2672;706;2368;58;255;449;1472;507;1727
241120;201504;7407;22710;6751;21683;1395;4580;4203;13847;5598;18427
241140;201504;3408;9415;2958;8549;322;950;2090;5977;2412;6927
241142;201504;718;2164;535;1765;136;521;171;514;307;1035
241150;201504;5614;16699;5020;15690;667;2142;3456;10944;4123;13086
241160;201504;993;2944;933;2832;125;416;674;2039;799;2455
241170;201504;1154;3489;1062;3324;106;348;793;2486;899;2834
241180;201504;925;2624;757;2305;94;302;402;1189;496;1491
241190;201504;1211;3348;978;2884;73;265;623;1748;696;2013
241200;201504;19224;56655;17280;53547;3989;13306;8613;26977;12602;40283
241210;201504;1471;4236;1200;3675;206;697;628;1872;834;2569
241220;201504;7653;25609;7183;24728;1580;5835;4069;14155;5649;19990
241230;201504;3075;9061;2809;8683;164;634;2363;7219;2527;7853
241240;201504;1189;3489;924;2935;124;414;428;1409;552;1823
241250;201504;5869;18431;4989;16721;294;1487;3937;12870;4231;14357
241255;201504;1724;6657;1617;6426;404;1716;778;3165;1182;4881
241260;201504;5143;13952;4186;12471;274;1063;3079;8992;3353;10055
241270;201504;1881;5817;1665;5390;178;668;1084;3467;1262;4135
241280;201504;1978;5729;1800;5393;235;750;1236;3667;1471;4417
241290;201504;3177;8977;2649;8071;386;1248;1677;5099;2063;6347
241300;201504;1469;4267;1295;3965;68;208;984;3060;1052;3268
241310;201504;1574;4810;1451;4602;206;681;1018;3260;1224;3941
241320;201504;922;3135;841;2961;133;521;511;1790;644;2311
241330;201504;1463;4644;1356;4501;102;408;1146;3783;1248;4191
241335;201504;2694;8251;2510;7922;156;523;2127;6717;2283;7240
241340;201504;1877;5861;1624;5318;384;1372;769;2450;1153;3822
241350;201504;1943;6199;1762;5863;156;673;1311;4225;1467;4898
241355;201504;1373;3894;1154;3522;65;210;1004;3069;1069;3279
241360;201504;2032;5582;1721;5002;75;253;1296;3634;1371;3887
241370;201504;1360;4184;1130;3707;187;683;587;1887;774;2570
241380;201504;688;1958;578;1735;104;330;323;963;427;1293
241390;201504;2773;9261;2590;8922;366;1382;1867;6445;2233;7827
241400;201504;3733;10989;3436;10595;366;1268;2655;8257;3021;9525
241410;201504;2615;7807;2339;7418;449;1530;1457;4582;1906;6112
241415;201504;1706;5168;1550;4913;103;425;1206;3743;1309;4168
241420;201504;2301;7945;2014;7469;667;2733;571;2064;1238;4797
241430;201504;562;1711;454;1470;49;176;276;867;325;1043
241440;201504;6303;22741;5930;22134;1259;4851;3803;14516;5062;19367
241445;201504;1065;3098;1002;3016;90;235;808;2564;898;2799
241450;201504;3205;8805;2812;8235;419;1317;1899;5552;2318;6869
241460;201504;3507;10293;3051;9398;256;946;2234;6718;2490;7664
241470;201504;1413;3919;1145;3579;124;481;848;2606;972;3087
241475;201504;1223;3817;1079;3534;51;255;826;2652;877;2907
241480;201504;2831;9498;2602;9131;897;3202;978;3723;1875;6925
241490;201504;654;1750;551;1599;45;135;338;971;383;1106
241500;201504;775;2448;687;2312;35;134;571;1922;606;2056
250010;201504;2690;8529;2360;7838;169;739;1816;5905;1985;6644
250020;201504;1691;4853;1309;4162;91;388;874;2678;965;3066
250030;201504;7299;21179;6809;20487;626;1894;5506;16730;6132;18624
250040;201504;4349;14669;4001;13938;656;2442;2535;8910;3191;11352
250050;201504;3436;10919;3247;10647;384;1369;2429;7945;2813;9314
250053;201504;1259;3766;1152;3624;160;511;788;2519;948;3030
250057;201504;647;2740;636;2729;18;40;600;2655;618;2695
250060;201504;4951;15137;4678;14742;420;1566;3769;11711;4189;13277
250070;201504;3924;12301;3662;11859;193;873;3038;9575;3231;10448
250073;201504;766;2352;682;2206;52;205;528;1686;580;1891
250077;201504;2248;6587;1890;6016;222;751;1166;3787;1388;4538
250080;201504;4223;12539;4078;12331;374;1196;3260;9802;3634;10998
250090;201504;2622;7660;2508;7473;108;351;2100;6186;2208;6537
250100;201504;3984;13168;3756;12774;376;1433;2929;9924;3305;11357
250110;201504;5327;15979;5035;15573;508;1805;3954;12102;4462;13907
250115;201504;529;1735;469;1599;30;159;298;946;328;1105
250120;201504;2000;6045;1737;5544;112;395;1357;4338;1469;4733
250130;201504;5498;17047;5180;16589;221;771;4595;14853;4816;15624
250135;201504;1075;3295;984;3139;82;283;716;2298;798;2581
250140;201504;2057;6804;1938;6632;180;705;1506;5207;1686;5912
250150;201504;5059;17050;4606;16206;396;1727;3352;11617;3748;13344
250153;201504;1449;3978;1276;3724;61;252;1089;3110;1150;3362
250157;201504;1737;5824;1594;5536;255;938;1064;3724;1319;4662
250160;201504;3255;9999;3143;9831;155;546;2852;8936;3007;9482
250170;201504;1545;4609;1411;4398;246;806;953;3012;1199;3818
250180;201504;15579;46989;14927;45987;1553;5852;11202;33584;12755;39436
250190;201504;4227;12304;3882;11760;672;2122;2464;7422;3136;9544
250200;201504;2208;6146;1727;5502;112;425;1425;4518;1537;4943
250205;201504;913;3124;846;2993;66;328;619;2161;685;2489
250210;201504;1519;5037;1409;4867;146;613;1067;3621;1213;4234
250215;201504;1351;4567;1297;4478;135;547;905;3111;1040;3658
250220;201504;781;2270;661;2115;37;131;572;1827;609;1958
250230;201504;1595;4069;1350;3670;92;301;1105;2920;1197;3221
250240;201504;2314;7831;2191;7596;134;517;1768;6135;1902;6652
250250;201504;4373;13210;3979;12691;211;718;3445;11058;3656;11776
250260;201504;1742;5382;1526;5036;99;409;1192;3895;1291;4304
250270;201504;1254;3977;1145;3839;106;343;882;3061;988;3404
250280;201504;3622;10854;3222;10257;488;1572;2305;7458;2793;9030
250290;201504;2012;5490;1688;5080;49;210;1497;4497;1546;4707
250300;201504;5470;16040;5174;15680;557;2295;4202;12187;4759;14482
250310;201504;1142;3538;1010;3322;115;435;777;2518;892;2953
250320;201504;8010;24920;7641;24224;1008;3631;5206;16075;6214;19706
250330;201504;2593;8006;2201;7460;170;694;1718;5768;1888;6462
250340;201504;1101;3255;1001;3094;34;107;885;2737;919;2844
250350;201504;4376;12048;3859;11445;131;464;3459;10328;3590;10792
250355;201504;2001;6345;1836;6098;107;519;1478;4770;1585;5289
250360;201504;1946;5808;1813;5619;80;267;1521;4757;1601;5024
250370;201504;12106;35208;10802;33760;958;3040;9169;28920;10127;31960
250375;201504;1099;3428;1025;3320;50;197;888;2874;938;3071
250380;201504;1730;4922;1636;4803;88;314;1437;4208;1525;4522
250390;201504;1971;5240;1568;4570;197;565;1067;3139;1264;3704
250400;201504;68859;187048;56929;168157;13814;43278;26752;79979;40566;123257
250403;201504;1545;5090;1451;4967;225;867;1007;3420;1232;4287
250407;201504;1195;3432;1029;3165;63;195;780;2382;843;2577
250410;201504;628;2027;554;1885;45;203;438;1466;483;1669
250415;201504;1751;5470;1593;5184;122;459;1229;3946;1351;4405
250420;201504;1254;3834;1165;3705;57;235;999;3117;1056;3352
250430;201504;6082;17047;5774;16589;304;1033;4928;13975;5232;15008
250435;201504;1411;4357;1262;4089;160;583;857;2760;1017;3343
250440;201504;4491;13168;4176;12729;202;601;3552;10905;3754;11506
250450;201504;2031;5827;1816;5545;80;271;1657;5081;1737;5352
250460;201504;6413;19409;5989;18814;688;2283;4534;14406;5222;16689
250470;201504;1513;4220;1318;3949;102;391;979;2807;1081;3198
250480;201504;3816;11593;3532;11189;80;352;3175;10009;3255;10361
250485;201504;656;1681;544;1510;31;100;434;1171;465;1271
250490;201504;3781;12271;3695;12150;852;2909;2359;7764;3211;10673
250500;201504;1773;5373;1600;5094;348;1079;981;3237;1329;4316
250510;201504;4704;13596;4201;12867;204;738;3619;11075;3823;11813
250520;201504;1741;5367;1636;5194;252;930;1019;3147;1271;4077
250523;201504;1607;5246;1552;5161;232;837;1134;3785;1366;4622
250527;201504;1397;4267;1324;4176;29;136;1234;3863;1263;3999
250530;201504;649;1963;561;1852;25;77;493;1654;518;1731
250535;201504;1308;4183;1245;4056;70;316;1005;3210;1075;3526
250540;201504;2369;7149;2224;6990;27;88;2131;6736;2158;6824
250550;201504;916;3049;826;2910;56;244;646;2245;702;2489
250560;201504;1663;5300;1619;5237;72;262;1472;4761;1544;5023
250570;201504;2595;8345;2278;7738;175;731;1744;5835;1919;6566
250580;201504;1142;3111;946;2805;88;355;699;1983;787;2338
250590;201504;931;2914;862;2826;66;282;714;2287;780;2569
250600;201504;7359;21611;6906;20967;492;1447;5737;17692;6229;19139
250610;201504;3222;9579;2988;9235;318;1080;2219;6869;2537;7949
250620;201504;732;2171;655;2013;116;372;408;1242;524;1614
250625;201504;2302;7417;2267;7374;44;101;2174;7145;2218;7246
250630;201504;9653;30677;9101;29691;1981;6805;5148;16849;7129;23654
250640;201504;3539;10831;3368;10633;163;673;2975;9287;3138;9960
250650;201504;834;2503;751;2362;76;311;508;1530;584;1841
250660;201504;2216;5477;1690;4843;29;74;1593;4593;1622;4667
250670;201504;2445;8302;2331;8107;151;671;1906;6532;2057;7203
250680;201504;4780;13880;4581;13620;179;637;4120;12261;4299;12898
250690;201504;5971;15827;5733;15532;384;1116;5091;13714;5475;14830
250700;201504;5081;14956;4657;14363;729;2408;3152;9652;3881;12060
250710;201504;4316;13839;3992;13422;537;1851;2894;9957;3431;11808
250720;201504;2576;7651;2462;7467;96;401;2181;6536;2277;6937
250730;201504;3562;11038;3372;10772;355;1277;2542;8017;2897;9294
250740;201504;1995;5881;1770;5506;149;545;1353;4150;1502;4695
250750;201504;99641;286060;92890;276169;13667;44761;63510;186718;77177;231479
250760;201504;2237;6517;2017;6203;111;437;1709;5213;1820;5650
250770;201504;3856;13197;3640;12924;626;2390;2409;8612;3035;11002
250780;201504;1877;5523;1623;5065;189;736;1047;3122;1236;3858
250790;201504;2419;7987;2316;7836;504;1645;1486;5221;1990;6866
250800;201504;2662;7580;2375;7102;105;353;1965;5763;2070;6116
250810;201504;1382;4021;1189;3746;102;416;940;2907;1042;3323
250820;201504;1818;5770;1754;5684;58;237;1606;5184;1664;5421
250830;201504;5764;18828;5380;18067;619;2418;3757;12407;4376;14825
250840;201504;943;3061;826;2807;82;327;549;1854;631;2181
250850;201504;2052;6308;1840;5956;128;576;1410;4471;1538;5047
250855;201504;1081;3263;992;3125;78;325;756;2308;834;2633
250860;201504;3121;10289;2775;9659;678;2657;989;3393;1667;6050
250870;201504;1060;3115;975;2966;48;205;768;2266;816;2471
250880;201504;1372;3931;1214;3705;162;499;905;2787;1067;3286
250890;201504;9371;28963;8724;28083;1200;4702;6188;19421;7388;24123
250900;201504;2886;9431;2551;8779;269;882;1842;6419;2111;7301
250905;201504;1983;6385;1915;6298;304;1015;1411;4720;1715;5735
250910;201504;4892;14434;4669;14108;297;1029;3923;11797;4220;12826
250915;201504;1485;4537;1431;4461;103;289;1241;3960;1344;4249
250920;201504;3472;10029;3268;9734;430;1191;2408;7445;2838;8636
250930;201504;1988;6313;1871;6117;259;986;1340;4314;1599;5300
250933;201504;1135;3760;1098;3692;84;330;850;2869;934;3199
250937;201504;758;2358;667;2174;71;291;452;1448;523;1739
250939;201504;1580;4947;1475;4763;153;527;1035;3319;1188;3846
250940;201504;3723;11192;3500;10845;141;547;2953;9180;3094;9727
250950;201504;1231;3900;1120;3759;39;138;994;3370;1033;3508
250960;201504;1139;3734;1076;3650;90;359;870;2939;960;3298
250970;201504;8580;23679;7440;22018;936;2843;5329;15853;6265;18696
250980;201504;2618;7825;2392;7426;180;728;1712;5124;1892;5852
250990;201504;2025;6968;1849;6603;241;1029;1266;4439;1507;5468
251000;201504;2212;6714;2014;6416;92;352;1676;5335;1768;5687
251010;201504;2791;8149;2504;7698;133;481;2123;6533;2256;7014
251020;201504;1628;4770;1475;4583;86;301;1297;4034;1383;4335
251030;201504;1200;3373;1080;3160;84;285;777;2258;861;2543
251040;201504;1880;5948;1674;5619;136;671;1239;3998;1375;4669
251050;201504;1089;3198;953;2956;139;455;603;1877;742;2332
251060;201504;970;2312;774;2053;47;153;603;1568;650;1721
251065;201504;468;1445;426;1385;46;174;314;987;360;1161
251070;201504;639;1795;578;1712;49;203;458;1277;507;1480
251080;201504;19997;56556;18204;53619;4833;14817;9001;27119;13834;41936
251090;201504;2989;9392;2674;8787;210;803;1958;6353;2168;7156
251100;201504;964;3086;845;2866;117;463;512;1670;629;2133
251110;201504;2018;5935;1784;5492;174;572;1248;3818;1422;4390
251120;201504;5982;20419;5743;19994;676;2783;4398;15102;5074;17885
251130;201504;4094;10663;3690;10220;28;84;3585;9952;3613;10036
251140;201504;4270;13154;3977;12709;130;568;3331;10611;3461;11179
251150;201504;2626;8618;2394;8288;264;1110;1796;6156;2060;7266
251160;201504;1725;5788;1668;5713;55;227;1529;5247;1584;5474
251170;201504;1399;4342;1335;4266;96;379;1131;3568;1227;3947
251180;201504;2662;8168;2447;7879;501;1610;1530;5016;2031;6626
251190;201504;4266;12032;4117;11868;184;525;3804;11005;3988;11530
251200;201504;4108;13002;3878;12719;109;391;3580;11804;3689;12195
251203;201504;1157;3851;1086;3696;76;354;822;2760;898;3114
251207;201504;1143;3587;987;3305;81;381;688;2207;769;2588
251210;201504;7958;22655;6849;21204;774;2371;5212;16542;5986;18913
251220;201504;1149;3083;962;2810;105;326;730;2146;835;2472
251230;201504;4642;14175;4214;13688;216;809;3802;12361;4018;13170
251240;201504;3142;10059;3022;9903;287;991;2474;8124;2761;9115
251250;201504;10327;30626;9522;29441;1032;3781;7264;22007;8296;25788
251260;201504;546;1665;477;1574;24;84;365;1201;389;1285
251270;201504;4198;13522;3938;13202;125;535;3573;11986;3698;12521
251272;201504;1380;4210;1320;4126;106;350;1111;3489;1217;3839
251274;201504;883;2833;811;2701;91;381;587;1902;678;2283
251275;201504;1253;3689;1192;3601;92;389;912;2645;1004;3034
251276;201504;1235;3852;1160;3715;104;402;870;2742;974;3144
251278;201504;581;1881;515;1742;64;253;343;1165;407;1418
251280;201504;2329;7255;2215;7073;176;674;1760;5528;1936;6202
251290;201504;5775;16228;5465;15860;610;2093;4268;12132;4878;14225
251300;201504;771;2617;716;2535;52;237;542;1878;594;2115
251310;201504;3163;9347;2912;8994;142;559;2410;7374;2552;7933
251315;201504;1591;5604;1531;5502;216;806;1046;3819;1262;4625
251320;201504;1910;5413;1529;4801;71;268;1149;3587;1220;3855
251330;201504;1849;4971;1612;4661;71;297;1433;4052;1504;4349
251335;201504;1031;3536;962;3411;89;415;701;2425;790;2840
251340;201504;3556;10036;3044;9266;229;918;2300;6766;2529;7684
251350;201504;1444;4501;1304;4295;133;494;952;3088;1085;3582
251360;201504;1805;5916;1658;5736;77;347;1439;4971;1516;5318
251365;201504;847;2497;683;2153;29;118;487;1501;516;1619
251370;201504;21986;70459;21458;69721;2242;8887;16974;53727;19216;62614
251380;201504;1394;4341;1202;4016;59;280;989;3214;1048;3494
251385;201504;839;2329;744;2180;81;244;534;1532;615;1776
251390;201504;5836;20351;5411;19641;1240;4742;3167;11617;4407;16359
251392;201504;1030;3069;934;2926;65;207;744;2344;809;2551
251394;201504;622;1898;513;1698;32;125;369;1208;401;1333
251396;201504;843;2392;741;2220;110;342;499;1471;609;1813
251398;201504;996;2962;868;2710;58;215;607;1883;665;2098
251400;201504;1192;3390;1036;3181;98;380;773;2302;871;2682
251410;201504;1403;3761;1274;3548;80;277;1039;2840;1119;3117
251420;201504;2064;6071;1830;5797;145;518;1476;4647;1621;5165
251430;201504;1679;6007;1559;5816;94;434;1311;4877;1405;5311
251440;201504;1312;3894;1092;3468;85;295;797;2515;882;2810
251445;201504;1564;4804;1489;4702;73;308;1300;4046;1373;4354
251450;201504;4666;14832;4297;14382;137;608;3771;12645;3908;13253
251455;201504;1146;3667;1026;3469;90;365;721;2424;811;2789
251460;201504;834;2591;791;2523;103;313;614;1998;717;2311
251465;201504;460;1448;402;1320;25;108;288;914;313;1022
251470;201504;1194;3497;985;3103;102;371;598;1882;700;2253
251480;201504;995;2775;883;2591;25;122;747;2125;772;2247
251490;201504;1853;5618;1671;5349;228;847;1101;3500;1329;4347
251500;201504;1703;5575;1667;5517;146;552;1358;4456;1504;5008
251510;201504;2569;8524;2337;8050;408;1473;1414;4905;1822;6378
251520;201504;989;2762;888;2601;132;396;526;1551;658;1947
251530;201504;11738;33573;11209;32846;416;1686;9907;28615;10323;30301
251540;201504;2834;9223;2617;8787;203;847;2075;6884;2278;7731
251550;201504;3836;9618;3149;8760;97;352;2664;7304;2761;7656
251560;201504;768;2347;701;2234;115;437;402;1175;517;1612
251570;201504;1012;3010;829;2649;75;301;596;1870;671;2171
251580;201504;1980;5586;1842;5395;355;917;1257;3864;1612;4781
251590;201504;1589;5253;1538;5192;68;262;1374;4659;1442;4921
251593;201504;1088;3360;1002;3244;157;567;614;1941;771;2508
251597;201504;1965;6038;1882;5923;117;447;1568;4861;1685;5308
251600;201504;6570;19374;6148;18707;429;1470;5055;15319;5484;16789
251610;201504;3322;10036;3022;9638;334;1087;2244;7189;2578;8276
251615;201504;1133;3319;922;2959;81;329;646;2039;727;2368
251620;201504;15741;44359;13645;41794;1135;3652;10862;33758;11997;37410
251630;201504;4822;12412;4126;11511;290;874;3364;9357;3654;10231
251640;201504;2600;7609;2173;6887;161;636;1603;5023;1764;5659
251650;201504;4051;11833;3702;11385;240;793;3212;9928;3452;10721
251660;201504;3446;11504;3220;11112;190;937;2672;8984;2862;9921
251670;201504;4271;12848;3758;12155;58;180;3465;11339;3523;11519
251675;201504;725;2373;671;2293;148;540;390;1317;538;1857
251680;201504;2682;7746;2245;7055;112;472;1829;5668;1941;6140
251690;201504;3421;10498;3159;10012;213;805;2399;7474;2612;8279
251700;201504;1961;6364;1850;6221;104;431;1605;5404;1709;5835
251710;201504;936;2437;685;1966;82;277;389;1078;471;1355
251720;201504;1383;4263;1241;4022;79;343;1005;3197;1084;3540
251740;201504;773;2196;618;1931;75;251;387;1209;462;1460
260005;201504;25211;61929;21719;57099;4739;12560;12453;32928;17192;45488
260010;201504;9903;26698;8034;24370;990;3119;5474;17103;6464;20222
260020;201504;5706;16645;4898;15427;351;1171;3811;12187;4162;13358
260030;201504;5728;16940;5237;16190;418;1460;4113;12653;4531;14113
260040;201504;10139;24509;8431;22590;668;1491;6753;18870;7421;20361
260050;201504;11274;35109;10458;34175;557;1925;9199;30440;9756;32365
260060;201504;3895;10997;3491;10315;304;875;2692;8094;2996;8969
260070;201504;9682;28457;9083;27566;1618;5300;6038;18260;7656;23560
260080;201504;5348;14846;4749;13987;478;1565;3605;10501;4083;12066
260090;201504;5183;14563;4903;14161;1075;2973;3313;9871;4388;12844
260100;201504;3283;9032;2878;8454;162;626;2430;7103;2592;7729
260105;201504;4725;13799;4519;13411;528;1746;3338;9750;3866;11496
260110;201504;21113;60425;19447;58416;891;2689;17207;52021;18098;54710
260120;201504;11252;34555;10297;32897;2668;8670;5402;18003;8070;26673
260130;201504;3206;9055;3020;8767;442;1227;2185;6496;2627;7723
260140;201504;13376;33621;11432;31280;900;2657;9174;25469;10074;28126
260150;201504;3145;8958;2808;8497;196;735;2281;6906;2477;7641
260160;201504;5782;17993;5147;17207;331;1297;4334;14554;4665;15851
260170;201504;17383;48318;16498;47139;1249;3772;13543;38779;14792;42551
260180;201504;3309;10225;3012;9794;204;788;2507;8092;2711;8880
260190;201504;15978;37805;14762;36296;541;1384;13057;32047;13598;33431
260200;201504;10592;30440;9790;29311;787;2549;8050;24259;8837;26808
260210;201504;11166;34352;10165;32899;609;2349;8463;27447;9072;29796
260220;201504;9302;27737;8994;27316;509;1976;7911;23659;8420;25635
260230;201504;9597;27848;8904;26919;451;1498;7540;23106;7991;24604
260240;201504;3024;9111;2594;8513;370;1297;1856;6146;2226;7443
260250;201504;2292;6361;2042;6040;118;371;1733;5133;1851;5504
260260;201504;12015;33947;11152;32828;1671;5270;8181;24541;9852;29811
260270;201504;3551;10577;3323;10242;297;1178;2636;7956;2933;9134
260280;201504;12847;42046;11850;40518;643;2419;10159;35086;10802;37505
260290;201504;29751;90015;28311;87571;4320;15035;18959;57546;23279;72581
260300;201504;8604;26191;7653;24773;473;1956;6113;19834;6586;21790
260310;201504;4712;13971;4320;13383;1345;3825;2250;7574;3595;11399
260320;201504;6952;23043;6475;22327;437;1590;5397;18828;5834;20418
260330;201504;2681;8712;2486;8387;158;685;1978;6617;2136;7302
260340;201504;1910;5653;1774;5444;83;308;1569;4785;1652;5093
260345;201504;23489;74100;22077;71364;5788;20844;9396;29030;15184;49874
260350;201504;4580;12706;4328;12331;289;956;3580;10138;3869;11094
260360;201504;2284;6821;2094;6529;214;825;1517;4670;1731;5495
260370;201504;5952;18511;5260;17265;538;2055;3842;12679;4380;14734
260380;201504;4805;15923;4420;15386;348;1367;3465;12107;3813;13474
260390;201504;4495;14278;3964;13294;384;1473;2853;9393;3237;10866
260392;201504;3560;11197;3303;10878;116;479;2984;9815;3100;10294
260400;201504;13496;38986;12864;37962;1892;6338;9002;25969;10894;32307
260410;201504;57286;168681;52605;161176;15500;49660;23715;74049;39215;123709
260415;201504;3958;12596;3420;11558;405;1679;2189;7159;2594;8838
260420;201504;12189;27967;10976;26686;350;932;9973;24277;10323;25209
260430;201504;2801;9251;2518;8776;271;1055;1826;6343;2097;7398
260440;201504;3184;9727;2867;9100;417;1496;1774;5458;2191;6954
260450;201504;4950;14729;4695;14345;220;780;4063;12419;4283;13199
260460;201504;5656;17324;5213;16589;872;3043;3296;10315;4168;13358
260470;201504;4797;14153;4505;13765;292;916;3869;12022;4161;12938
260480;201504;4016;11667;3608;11089;608;2045;2391;7407;2999;9452
260490;201504;5036;13526;4421;12501;378;1257;3488;9675;3866;10932
260500;201504;6201;17479;5546;16500;670;2060;3973;11855;4643;13915
260510;201504;8870;23702;8215;22913;266;694;7603;21408;7869;22102
260515;201504;4789;14701;3743;12579;316;1233;2388;8026;2704;9259
260520;201504;15811;41887;15248;41142;2622;7045;11021;30098;13643;37143
260530;201504;9969;30112;8813;28469;467;1524;7541;24696;8008;26220
260540;201504;5955;14881;5442;14336;659;1346;4411;12070;5070;13416
260545;201504;77;276;45;178;7;29;10;36;17;65
260550;201504;2754;9105;2389;8360;552;2181;1034;3563;1586;5744
260560;201504;6505;17021;5883;16134;207;649;5251;14363;5458;15012
260570;201504;6684;22549;6186;21720;818;3242;4456;15719;5274;18961
260580;201504;3764;10568;3511;10163;194;697;2998;8483;3192;9180
260590;201504;6076;15407;5807;15095;255;577;5273;13890;5528;14467
260600;201504;26379;79591;24071;75688;2613;9551;17342;53983;19955;63534
260610;201504;6749;20197;6387;19675;1054;3444;4440;13569;5494;17013
260620;201504;16257;49287;15569;48109;2669;9218;10073;30590;12742;39808
260630;201504;2170;6537;1947;6166;154;613;1546;4800;1700;5413
260640;201504;17412;48127;16382;46692;2402;7220;11315;32280;13717;39500
260650;201504;5203;16860;4716;16041;505;1716;3600;12533;4105;14249
260660;201504;8250;22934;7438;21914;396;1245;6507;19251;6903;20496
260670;201504;2381;6527;1951;5930;203;709;1391;4217;1594;4926
260680;201504;21890;60967;20267;58192;4437;13173;10598;30282;15035;43455
260690;201504;3707;10110;3184;9299;141;549;2679;7720;2820;8269
260700;201504;5613;17141;5469;16990;45;86;5358;16806;5403;16892
260710;201504;1233;3746;1128;3601;89;349;885;2798;974;3147
260720;201504;16524;54271;15609;52724;3730;13009;8602;29628;12332;42637
260730;201504;6873;23044;6354;22204;888;3187;4601;16325;5489;19512
260740;201504;1321;4002;1148;3699;149;524;731;2361;880;2885
260750;201504;6523;20930;5984;20201;546;1678;4954;17129;5500;18807
260760;201504;4676;12702;4375;12319;295;910;3628;10241;3923;11151
260765;201504;7568;25972;7255;25500;966;4222;5333;18273;6299;22495
260770;201504;3924;10272;3567;9781;135;472;3001;8123;3136;8595
260775;201504;5187;15017;4923;14631;497;1816;3623;10444;4120;12260
260780;201504;3697;12056;3515;11732;742;2809;2142;7007;2884;9816
260790;201504;112783;285259;105895;275216;20757;55937;65126;168788;85883;224725
260795;201504;3029;9478;2757;9062;390;1416;1879;6234;2269;7650
260800;201504;4874;13153;4497;12642;178;736;3974;10850;4152;11586
260805;201504;3999;11607;3551;10935;429;1461;2496;7651;2925;9112
260810;201504;6838;19742;6674;19548;318;945;6060;17867;6378;18812
260820;201504;4327;12334;3983;11874;1032;3192;2241;6677;3273;9869
260825;201504;2847;9231;2603;8853;194;714;2102;7183;2296;7897
260830;201504;3694;11925;3334;11250;842;2733;1905;6758;2747;9491
260840;201504;4241;12264;3837;11682;279;1108;3150;9396;3429;10504
260845;201504;4293;12499;3996;11960;546;1729;2792;8378;3338;10107
260850;201504;4935;16399;4407;15230;961;3767;2142;7234;3103;11001
260860;201504;3297;10521;3017;9981;201;750;2387;7921;2588;8671
260870;201504;4249;11782;3822;11261;496;1330;2890;8778;3386;10108
260875;201504;6752;18461;6008;17315;1008;2964;3882;11279;4890;14243
260880;201504;9149;28619;8499;27587;701;2321;6892;22637;7593;24958
260890;201504;13461;38637;12582;37294;964;3284;9802;28927;10766;32211
260900;201504;6024;18614;5190;17026;727;2730;3199;10411;3926;13141
260910;201504;3055;9191;2793;8809;204;740;2260;7170;2464;7910
260915;201504;4465;15137;4290;14893;60;251;4069;14191;4129;14442
260920;201504;3426;10337;3241;10086;401;1386;2493;7853;2894;9239
260930;201504;4008;12885;3550;12175;414;1520;2567;8906;2981;10426
260940;201504;13655;36858;12447;34879;1558;5205;8549;23227;10107;28432
260950;201504;6226;19492;5760;18600;748;3035;3535;10845;4283;13880
260960;201504;56915;160208;52711;153366;10605;32968;29613;85908;40218;118876
260970;201504;4965;15839;4597;15325;339;1444;3606;11880;3945;13324
260980;201504;3851;12634;3629;12364;143;543;3271;11201;3414;11744
260990;201504;17202;54243;15769;52373;1307;4334;12879;43634;14186;47968
261000;201504;16046;43946;12968;39148;2478;7963;6889;21420;9367;29383
261010;201504;2600;7377;2398;7126;147;325;2119;6496;2266;6821
261020;201504;5965;17640;5429;16831;457;1670;4290;12984;4747;14654
261030;201504;3383;11086;3169;10705;245;1004;2560;8535;2805;9539
261040;201504;5283;17146;4675;16015;437;1751;3417;11614;3854;13365
261050;201504;8128;23597;7596;22665;1001;2955;5236;15663;6237;18618
261060;201504;11979;35703;11175;34230;1228;4371;8405;25356;9633;29727
261070;201504;49954;124768;44095;116517;7571;20612;27770;73776;35341;94388
261080;201504;5821;17236;5471;16710;363;1007;4658;14499;5021;15506
261090;201504;16518;45680;15250;43954;1415;4022;12133;35484;13548;39506
261100;201504;7763;24780;6974;23416;1247;4401;4225;14448;5472;18849
261110;201504;59994;178163;54020;169374;12295;40454;30426;97516;42721;137970
261120;201504;3615;9763;3208;9270;100;343;2881;8354;2981;8697
261130;201504;7025;18124;6657;17717;144;360;6279;16780;6423;17140
261140;201504;3245;9181;2950;8735;477;1584;1841;5368;2318;6952
261150;201504;5503;16379;5019;15622;547;1924;3808;11848;4355;13772
261153;201504;2055;6018;1676;5437;77;308;1310;4282;1387;4590
261160;201504;208992;542750;195639;524216;43910;121003;107475;293582;151385;414585
261170;201504;5781;16017;5301;15340;641;1888;4051;11874;4692;13762
261180;201504;9574;26809;9054;26090;726;2283;7091;20527;7817;22810
261190;201504;5223;16392;4897;15992;613;2667;3530;11131;4143;13798
261200;201504;3699;9244;3354;8819;451;1184;2542;6790;2993;7974
261210;201504;1929;5114;1843;5006;117;293;1650;4541;1767;4834
261220;201504;12917;40966;10831;36409;1961;7203;5536;18543;7497;25746
261230;201504;4383;13274;4029;12833;171;611;3538;11364;3709;11975
261240;201504;4771;14236;4450;13692;691;2084;3062;9600;3753;11684
261245;201504;3651;11506;3152;10630;186;856;2514;8348;2700;9204
261247;201504;3373;10390;2866;9457;289;1078;2052;6814;2341;7892
261250;201504;19827;52975;18984;51902;3550;9318;13753;38577;17303;47895
261255;201504;4072;12639;3713;12036;236;887;3124;10156;3360;11043
261260;201504;12012;34242;10836;32856;483;1250;9648;29909;10131;31159
261270;201504;3878;11325;3531;10782;503;1676;2336;7051;2839;8727
261280;201504;2550;7803;2325;7476;167;593;1879;6039;2046;6632
261290;201504;2927;8504;2696;8207;147;554;2280;6972;2427;7526
261300;201504;10735;35112;9467;32837;1610;6383;5754;19761;7364;26144
261310;201504;7439;22908;7026;22197;1633;5322;4098;13012;5731;18334
261320;201504;5618;17825;5237;17125;315;1173;4278;14044;4593;15217
261330;201504;5424;16081;5178;15736;497;1542;4150;12643;4647;14185
261340;201504;4197;13958;3996;13636;485;2006;2702;9154;3187;11160
261350;201504;8059;27018;7589;26238;411;1871;6190;21154;6601;23025
261360;201504;8142;21645;7301;20474;670;1969;5764;16008;6434;17977
261370;201504;20037;59542;18789;57643;3802;12433;11454;35116;15256;47549
261380;201504;4194;14322;3846;13637;562;2183;2612;9339;3174;11522
261390;201504;15894;48723;14431;46302;2182;7813;9103;29009;11285;36822
261400;201504;4868;16799;4391;15822;481;1982;3133;11315;3614;13297
261410;201504;8547;24426;7838;23337;977;2929;5835;17651;6812;20580
261420;201504;7388;25186;7078;24743;1718;6784;4222;14475;5940;21259
261430;201504;3412;10798;2998;10215;300;1019;2296;8010;2596;9029
261440;201504;1633;5160;1482;4931;77;350;1228;4043;1305;4393
261450;201504;13965;39812;13557;39311;465;1492;12520;36312;12985;37804
261460;201504;7176;21643;6752;21101;423;1121;5963;19151;6386;20272
261470;201504;4016;10872;3640;10412;143;465;3246;9258;3389;9723
261480;201504;3567;12973;3322;12552;357;1538;2495;9282;2852;10820
261485;201504;5002;15408;4552;14620;811;3020;2692;8470;3503;11490
261500;201504;5699;15884;5045;15017;507;1376;3920;12068;4427;13444
261510;201504;1963;6324;1819;6101;125;463;1463;4931;1588;5394
261520;201504;2650;8633;2417;8183;152;613;1699;5881;1851;6494
261530;201504;12220;39250;10744;36453;2433;9098;4606;15646;7039;24744
261540;201504;7450;23999;7125;23453;1461;4761;4568;15441;6029;20202
261550;201504;3429;9951;3255;9705;298;1156;2669;7766;2967;8922
261560;201504;7094;23103;6425;22240;1082;3942;4538;15990;5620;19932
261570;201504;3491;10683;3049;9996;444;1557;2000;6550;2444;8107
261580;201504;5676;17936;5078;17000;366;1469;4180;13968;4546;15437
261590;201504;2487;7123;2238;6759;212;674;1697;5207;1909;5881
261600;201504;5406;14697;4639;13638;387;1192;3593;10660;3980;11852
261610;201504;2464;7211;2100;6690;115;458;1705;5350;1820;5808
261618;201504;2491;7104;2310;6879;213;699;1839;5404;2052;6103
261620;201504;4266;13216;3970;12734;566;1881;2804;9083;3370;10964
261630;201504;7842;22971;6616;20696;1056;3832;3723;11309;4779;15141
261640;201504;32091;82365;29817;79588;2102;5410;24753;68139;26855;73549
261650;201504;3653;11465;3421;11145;444;1536;2493;8212;2937;9748
270010;201504;4528;17126;4159;16415;496;2257;2819;11228;3315;13485
270020;201504;3820;11294;3597;10956;340;1175;2848;8572;3188;9747
270030;201504;40421;121500;37945;117559;9024;28868;21788;68471;30812;97339
270040;201504;10626;32331;9920;31461;2258;6808;5894;19685;8152;26493
270050;201504;4174;11958;3856;11559;355;1204;3051;9125;3406;10329
270060;201504;1669;5371;1574;5245;282;1043;1024;3432;1306;4475
270070;201504;4292;13314;3964;12873;176;790;3435;10976;3611;11766
270080;201504;1271;4068;1136;3795;176;682;716;2315;892;2997
270090;201504;2147;6704;2035;6492;45;195;1793;5627;1838;5822
270100;201504;5953;18466;5680;18024;994;3375;3814;12052;4808;15427
270110;201504;3168;8959;2863;8624;398;1232;1980;6359;2378;7591
270120;201504;3031;8830;2758;8473;84;322;2489;7679;2573;8001
270130;201504;4951;15471;4725;15216;421;1197;3993;13274;4414;14471
270135;201504;1742;4784;1673;4711;120;151;1510;4475;1630;4626
270140;201504;10494;25675;9127;23951;785;2940;7193;17762;7978;20702
270150;201504;2692;9168;2634;9095;117;458;2431;8404;2548;8862
270160;201504;5206;17247;4774;16711;265;993;4082;14366;4347;15359
270170;201504;3906;12713;3582;12262;673;2727;2125;7144;2798;9871
270180;201504;2215;7492;2043;7255;122;611;1695;5947;1817;6558
270190;201504;1871;6152;1771;6011;126;508;1423;4876;1549;5384
270200;201504;2645;8887;2473;8645;221;931;1918;6636;2139;7567
270210;201504;4603;14431;4377;14117;302;1267;3743;11911;4045;13178
270220;201504;1430;4688;1343;4529;251;934;779;2596;1030;3530
270230;201504;11043;35581;9743;33469;1352;5663;6319;21246;7671;26909
270235;201504;6413;20745;6019;20109;357;1512;5037;16684;5394;18196
270240;201504;9960;29727;8576;27930;1965;6662;4568;15114;6533;21776
270250;201504;3329;8609;3071;8304;136;312;2831;7722;2967;8034
270255;201504;5017;15172;4004;13341;301;1263;2870;9403;3171;10666
270260;201504;5777;18938;5604;18684;546;2260;4607;15077;5153;17337
270270;201504;1224;3492;1125;3353;207;641;656;1928;863;2569
270280;201504;3610;10447;3300;9999;381;1251;2441;7373;2822;8624
270290;201504;8396;29300;7928;28483;793;3371;6207;22117;7000;25488
270300;201504;3576;11893;3265;11550;210;844;2777;9896;2987;10740
270310;201504;7318;22439;6484;21087;284;1386;5450;17328;5734;18714
270320;201504;6425;20426;6191;20047;1160;4377;3968;12794;5128;17171
270330;201504;4585;15394;4289;14997;417;1619;3434;12068;3851;13687
270340;201504;1753;5438;1570;5194;149;544;1240;4108;1389;4652
270350;201504;1893;5367;1726;5160;181;599;1299;3940;1480;4539
270360;201504;2039;6385;1981;6315;181;521;1688;5529;1869;6050
270370;201504;1645;5413;1500;5160;147;598;1073;3725;1220;4323
270375;201504;2880;8422;2603;8022;308;1153;1839;5456;2147;6609
270380;201504;5768;17817;5437;17363;540;1751;4271;13892;4811;15643
270390;201504;1316;3653;1174;3453;122;435;868;2455;990;2890
270400;201504;6098;18550;5544;17758;470;1767;4025;12681;4495;14448
270410;201504;4880;15155;4569;14587;491;1736;3312;10471;3803;12207
270420;201504;5871;18915;5664;18637;319;1489;4691;15105;5010;16594
270430;201504;133894;390729;125757;379047;32507;102128;64014;197285;96521;299413
270440;201504;4720;14449;4380;13961;232;899;3613;11569;3845;12468
270450;201504;6323;19692;6070;19370;373;1514;5089;16103;5462;17617
270460;201504;3496;9421;3142;8953;210;715;2643;7430;2853;8145
270470;201504;10288;33444;9608;32349;1288;4447;6641;22920;7929;27367
270480;201504;3044;9454;2714;8865;295;1193;1855;5818;2150;7011
270490;201504;971;3181;921;3108;58;237;733;2449;791;2686
270500;201504;4977;17248;4740;16945;349;1353;3992;14401;4341;15754
270510;201504;6042;18256;5445;17437;706;2967;3969;12133;4675;15100
270520;201504;3631;11676;3396;11290;888;3224;1618;5446;2506;8670
270530;201504;1504;4464;1341;4241;177;585;896;2933;1073;3518
270540;201504;2051;7011;1871;6752;153;748;1501;5301;1654;6049
270550;201504;7102;21073;6246;19959;909;3052;4289;14049;5198;17101
270560;201504;3064;9402;2859;9093;434;1663;2036;6255;2470;7918
270570;201504;3957;12850;3640;12325;380;1636;2778;9169;3158;10805
270580;201504;1950;6465;1867;6349;230;833;1422;4908;1652;5741
270590;201504;1396;4729;1319;4598;34;157;1236;4289;1270;4446
270600;201504;2877;9667;2593;9214;212;1056;1999;6939;2211;7995
270610;201504;3234;10270;3002;9940;260;980;2419;7950;2679;8930
270620;201504;1377;4742;1310;4640;109;531;1076;3661;1185;4192
270630;201504;17297;49445;16078;47492;2365;6881;11307;34176;13672;41057
270640;201504;5914;18203;5301;17387;380;1579;4324;13942;4704;15521
270642;201504;2298;8112;2146;7882;280;1215;1569;5727;1849;6942
270644;201504;2595;7532;2324;7233;189;531;1962;6264;2151;6795
270650;201504;3791;12135;3629;11910;622;2579;2393;7491;3015;10070
270660;201504;2546;6445;1985;5653;120;442;1417;4027;1537;4469
270670;201504;16254;42728;14043;40162;1751;4792;10475;31118;12226;35910
270680;201504;4295;12816;4121;12624;169;467;3760;11646;3929;12113
270690;201504;9021;25093;8238;24201;2616;7393;4193;13175;6809;20568
270700;201504;691;2141;630;2037;90;364;432;1331;522;1695
270710;201504;5936;19658;5668;19309;589;2162;4566;15644;5155;17806
270720;201504;3299;11206;3023;10726;190;962;2445;8518;2635;9480
270730;201504;6405;19524;6087;19169;680;2180;4966;15873;5646;18053
270740;201504;2382;6827;2237;6627;298;1023;1637;4751;1935;5774
270750;201504;5044;16058;4675;15517;486;1755;3639;12131;4125;13886
270760;201504;3436;10419;3106;9864;247;890;2412;7653;2659;8543
270770;201504;18707;49645;15743;46078;3107;9155;9475;28923;12582;38078
270780;201504;1840;6104;1741;5934;211;789;1252;4290;1463;5079
270790;201504;1636;5111;1497;4902;331;1156;814;2633;1145;3789
270800;201504;11530;33998;10752;32985;854;2918;8861;27208;9715;30126
270810;201504;3377;10217;2642;8884;286;1143;1694;5725;1980;6868
270820;201504;1796;6053;1644;5806;255;1023;1075;3792;1330;4815
270830;201504;5566;16504;5050;15863;927;3323;3339;10531;4266;13854
270840;201504;7827;25846;7226;25094;382;1887;6203;21195;6585;23082
270850;201504;7448;24001;7231;23737;1294;5190;5023;15723;6317;20913
270860;201504;11502;32270;9858;30125;1197;4394;6957;20881;8154;25275
270870;201504;2236;6696;1839;5871;267;915;1137;3592;1404;4507
270880;201504;8194;26466;7709;25765;567;2343;6386;21088;6953;23431
270890;201504;2497;7587;2334;7294;296;1116;1699;5186;1995;6302
270895;201504;2927;10925;2784;10736;214;939;2346;9106;2560;10045
270900;201504;1944;5298;1572;4760;107;398;1194;3546;1301;3944
270910;201504;3448;11677;3282;11359;306;1352;2549;8594;2855;9946
270915;201504;9853;33154;8897;31470;1559;6395;5269;18387;6828;24782
270920;201504;6299;19804;5953;19320;191;937;5407;17320;5598;18257
270930;201504;17510;46781;14443;42997;2703;8356;8739;26915;11442;35271
270940;201504;5919;19850;5643;19546;600;2383;4383;15243;4983;17626
280010;201504;683;2051;592;1901;48;220;405;1241;453;1461
280020;201504;4858;14332;4199;13168;709;2399;2688;8378;3397;10777
280030;201504;71548;188513;62530;175220;16405;48390;29176;82880;45581;131270
280040;201504;3157;9793;2823;9306;291;983;2120;7185;2411;8168
280050;201504;3817;12313;3537;11858;1169;4143;1453;5025;2622;9168
280060;201504;4345;14392;4046;13887;843;3142;2318;8068;3161;11210
280067;201504;7513;21431;6514;20007;751;2351;4638;14416;5389;16767
280070;201504;1909;6479;1811;6338;367;1339;1196;4243;1563;5582
280100;201504;3927;12219;3513;11504;842;2905;1821;6063;2663;8968
280110;201504;1412;4333;1307;4176;69;297;1104;3478;1173;3775
280120;201504;7750;24758;7179;23859;1088;3382;5104;17767;6192;21149
280130;201504;7321;21106;6768;20295;1160;3819;4403;13223;5563;17042
280140;201504;5554;15177;5042;14483;533;1551;3958;11484;4491;13035
280150;201504;3464;10490;3190;10019;422;1516;2149;6561;2571;8077
280160;201504;1398;4048;1251;3828;133;475;938;2859;1071;3334
280170;201504;4808;14237;4349;13574;463;1355;3368;10845;3831;12200
280190;201504;1092;3109;984;2933;67;268;769;2213;836;2481
280200;201504;1150;3474;1051;3330;149;587;721;2190;870;2777
280210;201504;13052;40241;11942;38681;2190;7363;7777;25869;9967;33232
280220;201504;1554;4785;1456;4634;89;346;1254;3959;1343;4305
280230;201504;3525;10533;3136;9918;465;1575;1967;6292;2432;7867
280240;201504;3479;10230;3153;9721;277;815;2474;7722;2751;8537
280250;201504;843;2203;703;1986;119;403;396;1012;515;1415
280260;201504;2005;5370;1850;5178;86;262;1652;4661;1738;4923
280270;201504;2306;7156;2025;6729;131;520;1576;5178;1707;5698
280280;201504;4167;13627;3831;13070;906;2591;2130;8196;3036;10787
280290;201504;17170;52987;15493;50356;2255;8037;10297;33991;12552;42028
280300;201504;9572;29689;8969;28979;678;2353;7538;24753;8216;27106
280310;201504;1352;3831;1211;3609;77;313;871;2529;948;2842
280320;201504;8287;27068;7657;25985;1437;5393;4204;14282;5641;19675
280330;201504;4555;12802;4145;12202;366;1291;3388;9827;3754;11118
280340;201504;3807;11011;3584;10708;306;997;2878;8743;3184;9740
280350;201504;22153;62860;19950;59631;2576;7971;13975;42537;16551;50508
280360;201504;5757;18149;5419;17632;1035;3825;3226;10309;4261;14134
280370;201504;1834;5156;1630;4833;140;462;1242;3639;1382;4101
280380;201504;1002;3049;927;2949;97;364;718;2271;815;2635
280390;201504;3201;9405;2750;8585;469;1499;1698;5314;2167;6813
280400;201504;4253;12382;3864;11842;1049;3075;2150;7007;3199;10082
280410;201504;2195;7072;1911;6530;308;1206;1111;3654;1419;4860
280420;201504;4217;12291;3928;11845;231;747;3386;10240;3617;10987
280430;201504;2269;5867;2077;5624;126;424;1718;4630;1844;5054
280440;201504;4867;14308;4552;13933;328;995;3912;12105;4240;13100
280445;201504;2446;7025;2280;6748;91;352;1888;5511;1979;5863
280450;201504;8633;23815;8064;23118;513;1207;6958;20565;7471;21772
280460;201504;7036;18735;6327;17755;838;2478;4614;13144;5452;15622
280470;201504;1799;5516;1646;5266;194;612;1216;3941;1410;4553
280480;201504;30692;90500;29240;88448;4575;15893;19800;58596;24375;74489
280490;201504;3792;11491;3355;10702;319;1178;2475;7821;2794;8999
280500;201504;914;2446;844;2358;32;99;738;2037;770;2136
280510;201504;2725;7888;2356;7405;246;890;1776;5634;2022;6524
280520;201504;1732;4912;1578;4718;147;375;1296;4003;1443;4378
280530;201504;2197;6410;2063;6246;166;534;1733;5315;1899;5849
280540;201504;9270;25320;8693;24556;231;894;7891;22116;8122;23010
280550;201504;6906;18465;5945;16995;651;1953;4201;12014;4852;13967
280560;201504;7493;22247;7068;21619;377;1343;6037;18312;6414;19655
280570;201504;6490;17833;5735;16868;703;2334;4038;11843;4741;14177
280580;201504;5588;17336;4753;15884;894;2996;2852;9854;3746;12850
280590;201504;2328;7128;2169;6925;262;1129;1574;4904;1836;6033
280600;201504;3893;11917;3639;11536;349;1278;2744;8635;3093;9913
280610;201504;2490;7002;2302;6744;257;916;1639;4671;1896;5587
280620;201504;5117;15370;4474;14189;686;1967;2912;9658;3598;11625
280630;201504;3861;12537;3675;12270;362;1069;2996;10392;3358;11461
280640;201504;2200;6560;2095;6444;78;149;1967;6184;2045;6333
280650;201504;1130;3526;1022;3344;144;526;686;2251;830;2777
280660;201504;2660;7589;2536;7422;419;1161;1928;5741;2347;6902
280670;201504;15943;41843;14867;40419;2718;7697;9849;26740;12567;34437
280680;201504;2792;7573;2470;7087;165;538;2020;5776;2185;6314
280690;201504;995;2827;868;2649;125;401;589;1781;714;2182
280700;201504;1105;3311;967;3102;67;210;749;2436;816;2646
280710;201504;11494;30937;10614;29927;750;1950;9055;25949;9805;27899
280720;201504;2260;6303;2056;6058;241;730;1474;4438;1715;5168
280730;201504;947;2815;898;2749;80;254;761;2347;841;2601
280740;201504;13092;35710;11403;33187;1706;4888;7556;22582;9262;27470
280750;201504;3547;10846;3241;10320;327;1167;2330;7436;2657;8603
280760;201504;5623;17342;5127;16655;680;2278;3584;12063;4264;14341
290010;201504;3112;6978;2229;5625;67;271;1781;4267;1848;4538
290020;201504;4512;15142;4442;15053;364;1011;3871;13484;4235;14495
290030;201504;3158;9983;2985;9715;507;1652;2081;6839;2588;8491
290035;201504;4702;12229;4104;11452;258;820;3315;9533;3573;10353
290040;201504;3802;10766;3348;10248;211;842;2748;8300;2959;9142
290050;201504;2526;8239;2279;7867;162;655;1817;6276;1979;6931
290060;201504;1339;3422;1118;3163;196;629;798;2191;994;2820
290070;201504;32047;81242;27278;75383;5951;16356;14329;42064;20280;58420
290080;201504;6137;18317;5277;17205;613;1964;3968;13358;4581;15322
290090;201504;2282;4907;1777;4374;190;436;1472;3706;1662;4142
290100;201504;9686;27752;8504;25905;1114;3537;5647;17665;6761;21202
290110;201504;5085;15149;4845;14747;709;2365;3324;10014;4033;12379
290115;201504;4958;14769;4362;13973;306;1022;3425;11211;3731;12233
290120;201504;6673;17745;5808;16705;257;792;5119;14724;5376;15516
290130;201504;4558;12038;3841;11150;244;863;3142;8938;3386;9801
290135;201504;4630;11914;4030;10992;278;948;3054;8021;3332;8969
290140;201504;4163;12943;3531;12089;217;819;3035;10445;3252;11264
290150;201504;2212;6593;2106;6422;178;554;1769;5416;1947;5970
290160;201504;3435;9321;3333;9197;201;370;3049;8612;3250;8982
290170;201504;2737;9234;2500;8874;176;779;2156;7589;2332;8368
290180;201504;2897;8482;2560;7962;214;777;1956;6045;2170;6822
290190;201504;3891;13089;3743;12854;296;1194;2946;10127;3242;11321
290195;201504;2208;6087;1891;5610;128;459;1529;4527;1657;4986
290200;201504;3784;11917;3397;11288;288;984;2693;9026;2981;10010
290205;201504;3110;9374;2803;8907;325;1255;2036;6327;2361;7582
290210;201504;15576;43136;14414;41705;2832;7181;9560;30023;12392;37204
290220;201504;2266;6838;2158;6670;176;722;1682;5047;1858;5769
290225;201504;2944;7826;2725;7588;155;364;2483;7036;2638;7400
290230;201504;2280;7516;2209;7428;146;554;1903;6433;2049;6987
290240;201504;3815;10210;3455;9709;334;1017;2615;7248;2949;8265
290250;201504;3685;11864;3258;11208;231;817;2615;9143;2846;9960
290260;201504;4875;14365;4265;13430;343;1193;3348;10578;3691;11771
290265;201504;3300;10512;2977;9938;180;740;2339;7785;2519;8525
290270;201504;12266;44361;11552;43268;1538;6076;8455;32226;9993;38302
290280;201504;5195;17124;4863;16580;392;1466;3791;13021;4183;14487
290290;201504;9639;30604;8680;29072;1459;5052;5691;19466;7150;24518
290300;201504;4547;13018;3243;10577;263;850;2216;7532;2479;8382
290310;201504;1500;4487;1333;4229;240;831;781;2474;1021;3305
290320;201504;27480;81355;23752;76391;5693;19306;12452;41089;18145;60395
290323;201504;3810;10289;3308;9740;185;604;2784;8170;2969;8774
290327;201504;4401;13588;3863;12615;617;2086;2486;8147;3103;10233
290330;201504;1849;4685;1720;4544;159;466;1476;3877;1635;4343
290340;201504;4760;15156;4493;14806;1358;4437;2424;8143;3782;12580
290350;201504;4698;14424;4028;13460;512;1753;2778;9533;3290;11286
290360;201504;4488;13794;3901;13013;173;612;3330;11263;3503;11875
290370;201504;4846;13782;4244;13025;452;1297;3433;10768;3885;12065
290380;201504;5540;16149;4833;15122;332;1150;3863;12169;4195;13319
290390;201504;14780;46057;13611;44271;2709;8893;8083;27585;10792;36478
290395;201504;2644;8648;2339;8101;166;751;1800;6205;1966;6956
290400;201504;3616;10768;3110;10059;272;878;2385;7786;2657;8664
290405;201504;4552;14534;3873;13257;502;1796;2499;8759;3001;10555
290410;201504;6107;17949;4991;16229;502;1923;3626;11578;4128;13501
290420;201504;3329;9621;2730;8803;225;806;2167;6986;2392;7792
290430;201504;3067;9848;2801;9390;520;1876;1744;5869;2264;7745
290440;201504;2919;7869;2431;7193;178;588;1945;5837;2123;6425
290450;201504;3316;9710;2901;9116;380;1221;2038;6515;2418;7736
290460;201504;13140;38561;11780;36336;3061;9940;5278;16255;8339;26195
290470;201504;4553;12599;3498;11073;742;2664;1795;5763;2537;8427
290475;201504;4995;17199;4560;16367;440;1968;3340;11823;3780;13791
290480;201504;2686;6993;2391;6611;378;1108;1563;4435;1941;5543
290485;201504;4841;15408;4235;14519;361;1689;3401;11450;3762;13139
290490;201504;8069;21367;7731;20930;600;1716;6489;17551;7089;19267
290500;201504;4435;13833;3612;12243;604;2247;1915;6454;2519;8701
290510;201504;3352;9825;2908;9215;170;641;2406;7670;2576;8311
290515;201504;3199;9408;2773;8818;230;711;2220;7235;2450;7946
290520;201504;12280;37659;9996;33485;908;3772;6400;21224;7308;24996
290530;201504;5166;14995;4481;13984;364;1135;3588;11307;3952;12442
290540;201504;3949;11449;3743;11191;453;1278;2929;8983;3382;10261
290550;201504;4485;12157;3928;11509;144;419;3574;10542;3718;10961
290560;201504;5894;17704;5236;16741;1173;3978;2968;9663;4141;13641
290570;201504;42230;117564;38601;112357;4633;14097;27462;79809;32095;93906
290580;201504;7022;24110;6625;23501;926;3353;4804;17496;5730;20849
290590;201504;7716;24153;6453;22032;403;1688;5092;17343;5495;19031
290600;201504;17243;52832;15913;50827;2596;8036;10955;36237;13551;44273
290610;201504;2517;8523;2114;7729;181;839;1517;5459;1698;6298
290620;201504;6528;19896;5960;19054;364;1248;4989;15968;5353;17216
290630;201504;7991;21249;7172;20375;630;1784;6026;17326;6656;19110
290640;201504;2680;7826;2151;6951;160;618;1618;5171;1778;5789
290650;201504;11225;31997;10468;30966;2274;6610;6508;19899;8782;26509
290660;201504;3591;10111;3110;9421;167;568;2455;7609;2622;8177
290670;201504;7016;21409;6332;20357;742;2356;4689;15544;5431;17900
290680;201504;10191;30340;9307;29282;428;1500;8011;25327;8439;26827
290682;201504;4545;13181;4049;12494;165;661;3422;10437;3587;11098
290685;201504;3664;8842;2446;7129;295;923;1498;4473;1793;5396
290687;201504;7764;21400;6091;18989;1392;4474;3208;10329;4600;14803
290689;201504;3173;9116;2711;8405;234;741;2104;6657;2338;7398
290690;201504;5536;16025;5014;15374;495;1585;3959;12265;4454;13850
290700;201504;2354;7329;2226;7135;208;743;1708;5497;1916;6240
290710;201504;8016;25279;7644;24667;444;1450;6346;21101;6790;22551
290720;201504;18699;55001;16923;52799;1456;4081;14039;45192;15495;49273
290730;201504;7158;20024;6479;19145;1036;2952;4487;13510;5523;16462
290740;201504;924;2756;784;2520;87;303;536;1752;623;2055
290750;201504;10379;29175;8750;26202;1650;5628;4678;13379;6328;19007
290755;201504;2419;6795;1990;6091;113;402;1508;4593;1621;4995
290760;201504;4293;12845;3497;11500;400;1246;2361;7956;2761;9202
290770;201504;2577;9118;2422;8917;111;525;1984;7368;2095;7893
290780;201504;9027;22907;7812;21205;777;1628;6032;17121;6809;18749
290790;201504;4338;13223;4037;12792;279;852;3402;10923;3681;11775
290800;201504;7387;15826;5916;14269;677;1407;4451;11409;5128;12816
290810;201504;5037;15848;4286;14658;248;923;3276;11362;3524;12285
290820;201504;5698;15984;5068;15155;449;1444;3918;11839;4367;13283
290830;201504;4257;11641;3893;11106;228;826;3194;8925;3422;9751
290840;201504;17478;49490;15609;46823;2543;7403;10519;32944;13062;40347
290850;201504;6331;18401;6140;18165;721;1938;5023;15378;5744;17316
290860;201504;4965;17106;4645;16708;601;2217;3505;12993;4106;15210
290870;201504;4714;13980;3840;12627;324;1301;2846;9330;3170;10631
290880;201504;1430;3936;1144;3468;84;263;808;2476;892;2739
290890;201504;7027;18637;6039;17541;682;1941;4778;14105;5460;16046
290900;201504;2588;7330;1893;6161;283;968;952;3124;1235;4092
290910;201504;4558;12660;3987;11837;137;474;3505;10379;3642;10853
290920;201504;4705;13998;4363;13502;279;783;3649;11465;3928;12248
290930;201504;7719;24095;6791;22547;562;2261;5165;16935;5727;19196
290940;201504;3422;11032;3197;10734;195;686;2786;9535;2981;10221
290950;201504;1578;4423;1409;4184;195;570;973;2954;1168;3524
290960;201504;5783;16470;5268;15793;214;756;4454;13424;4668;14180
290970;201504;3577;11552;3192;10892;359;1271;2146;7457;2505;8728
290980;201504;10213;29461;8708;26662;2390;7555;3123;9549;5513;17104
290990;201504;9151;27496;8049;25719;855;2893;6024;19189;6879;22082
291000;201504;3062;9330;2802;8998;251;862;2320;7518;2571;8380
291005;201504;13886;37262;12416;35272;1791;5234;8661;25063;10452;30297
291010;201504;3205;10152;2545;8726;284;1027;1623;5609;1907;6636
291020;201504;1427;3757;1094;3171;129;426;665;1849;794;2275
291030;201504;2284;6224;1697;5072;169;570;1045;3052;1214;3622
291040;201504;5430;16497;4886;15740;448;1617;3875;12496;4323;14113
291050;201504;7729;25491;6989;24085;1877;7191;3388;11368;5265;18559
291060;201504;6038;22291;5727;21831;795;3461;4068;15439;4863;18900
291070;201504;16254;47044;14338;44272;1289;4103;10962;34256;12251;38359
291072;201504;22338;66381;18308;58405;4902;16912;6752;21923;11654;38835
291075;201504;5158;14622;4577;13847;274;689;3657;11452;3931;12141
291077;201504;1524;4342;1241;3891;115;410;842;2639;957;3049
291080;201504;79230;245820;70822;229555;23603;78503;20000;64107;43603;142610
291085;201504;5559;14842;4872;13950;482;1372;3933;11371;4415;12743
291090;201504;1559;3828;1358;3577;102;355;1109;2857;1211;3212
291100;201504;2835;7107;2254;6499;125;459;1851;5292;1976;5751
291110;201504;4799;17489;4405;16862;561;2498;3138;11847;3699;14345
291120;201504;7464;20078;6862;19195;858;2482;5009;14110;5867;16592
291125;201504;1830;3745;1406;3290;106;257;1111;2662;1217;2919
291130;201504;2855;8842;2431;8128;162;692;1811;5920;1973;6612
291140;201504;4289;12684;3844;11875;567;1797;2541;7937;3108;9734
291150;201504;2008;5264;1907;5149;133;415;1539;4094;1672;4509
291160;201504;5380;16641;4705;15573;1165;3865;2516;8443;3681;12308
291165;201504;2517;7193;1964;6152;75;346;1461;4451;1536;4797
291170;201504;21504;55935;18544;52100;942;3181;14361;40154;15303;43335
291180;201504;6503;16935;5233;15104;550;1791;3685;10600;4235;12391
291185;201504;3854;10538;3498;10038;306;905;2851;8164;3157;9069
291190;201504;7103;19696;6318;18646;545;1698;5114;15206;5659;16904
291200;201504;2905;8684;2358;7668;165;542;1668;5546;1833;6088
291210;201504;7282;17324;6201;16097;385;1106;5045;13099;5430;14205
291220;201504;4089;12777;3765;12274;464;1712;2775;8999;3239;10711
291230;201504;4074;10525;3662;10061;100;233;3389;9426;3489;9659
291240;201504;4665;12690;4030;11532;184;595;3264;9197;3448;9792
291250;201504;3680;11039;2881;9667;315;1088;1939;6622;2254;7710
291260;201504;1093;3214;999;3086;58;231;827;2511;885;2742
291270;201504;4441;14392;4067;13706;1208;4253;2070;7072;3278;11325
291280;201504;2398;6361;1811;5523;428;1384;924;2765;1352;4149
291290;201504;5608;15712;4906;14825;805;2428;3186;9913;3991;12341
291300;201504;4305;12491;3533;11167;295;1079;2582;8016;2877;9095
291310;201504;5433;15509;4699;14229;328;1075;3688;11155;4016;12230
291320;201504;6035;19200;5121;17446;1181;4405;2690;9033;3871;13438
291330;201504;1612;4801;1434;4512;141;519;1013;3115;1154;3634
291340;201504;3872;11387;3253;10514;198;741;2646;8530;2844;9271
291345;201504;3547;11272;3301;10993;199;608;2913;9970;3112;10578
291350;201504;5475;16239;4849;15168;315;1088;3874;12249;4189;13337
291360;201504;33265;93675;30313;89522;7453;21837;17511;53502;24964;75339
291370;201504;8466;24687;8036;24145;636;1925;6422;19686;7058;21611
291380;201504;3747;11490;3242;10676;227;809;2371;8009;2598;8818
291390;201504;10500;28400;9494;27230;1324;3587;7172;20992;8496;24579
291400;201504;16409;42965;13523;39087;2409;6674;8330;25461;10739;32135
291410;201504;3350;8752;2491;7505;170;688;1888;5537;2058;6225
291420;201504;2156;5881;1880;5549;107;356;1638;4843;1745;5199
291430;201504;3385;9848;2990;9331;174;756;2412;7380;2586;8136
291440;201504;6468;19899;5509;18247;538;1899;4130;13841;4668;15740
291450;201504;8146;24498;7259;23256;315;993;5952;19759;6267;20752
291460;201504;13041;39403;11644;37184;1901;6626;7186;23063;9087;29689
291465;201504;8021;23009;7165;22044;525;1797;6015;18529;6540;20326
291470;201504;15789;43042;13871;40723;1193;3366;10562;32214;11755;35580
291480;201504;34228;89916;29519;83425;3974;12634;18887;52916;22861;65550
291490;201504;4399;14296;4257;14104;389;1253;3555;12064;3944;13317
291500;201504;4273;12342;3661;11462;255;928;2924;9144;3179;10072
291510;201504;3571;10788;3263;10384;92;276;2988;9620;3080;9896
291520;201504;3893;10560;3380;9858;375;1160;2373;7015;2748;8175
291530;201504;2069;5937;1734;5420;413;1364;903;2929;1316;4293
291535;201504;4063;12132;3632;11516;229;794;2941;9421;3170;10215
291540;201504;2223;5245;1861;4871;156;299;1607;4367;1763;4666
291550;201504;5288;14418;4638;13522;1058;2995;2622;7879;3680;10874
291560;201504;18372;44193;13408;38424;1235;3458;10061;29945;11296;33403
291570;201504;2238;6122;2091;5948;156;360;1816;5320;1972;5680
291580;201504;5656;17222;5023;16287;583;2320;3641;11730;4224;14050
291590;201504;1826;5784;1632;5462;178;620;1205;4128;1383;4748
291600;201504;5754;15642;4232;13315;1018;3489;1907;5872;2925;9361
291610;201504;4895;15325;4737;15131;257;919;4158;13335;4415;14254
291620;201504;3022;7137;2401;6482;139;345;1948;5455;2087;5800
291630;201504;3145;7746;2653;7175;269;673;2101;5808;2370;6481
291640;201504;17390;47038;14128;42444;3534;11380;5264;16104;8798;27484
291650;201504;7987;23919;7382;23195;638;1680;6201;20127;6839;21807
291660;201504;2237;5902;1885;5376;153;528;1304;3608;1457;4136
291670;201504;1854;5300;1674;5042;118;401;1313;3944;1431;4345
291680;201504;4279;12492;3713;11554;764;2612;2073;6418;2837;9030
291685;201504;4726;11825;3920;10781;553;1456;2775;7928;3328;9384
291690;201504;4049;10899;3276;9688;238;690;2382;7097;2620;7787
291700;201504;9208;28785;8294;27208;877;2944;6278;20948;7155;23892
291710;201504;5238;13879;4305;12715;447;1469;3196;9500;3643;10969
291720;201504;4297;14299;3706;13098;357;1468;2640;9211;2997;10679
291730;201504;6051;18250;5471;17484;668;2248;4148;13518;4816;15766
291733;201504;2621;7651;2234;7134;254;878;1508;4886;1762;5764
291735;201504;2720;7625;2273;6961;131;478;1829;5546;1960;6024
291740;201504;3630;10874;3128;10122;281;1039;2386;7659;2667;8698
291750;201504;22676;58197;17479;50286;3947;11791;8846;25996;12793;37787
291760;201504;11406;36238;10112;33989;4045;15042;3072;10148;7117;25190
291770;201504;7627;21967;6585;20128;950;3139;4342;13157;5292;16296
291780;201504;4476;13572;4196;13091;368;1172;3348;10470;3716;11642
291790;201504;2643;8139;2503;7949;112;457;2147;6760;2259;7217
291800;201504;30872;86160;27412;81310;4785;14521;17148;52518;21933;67039
291810;201504;10685;29618;8927;27547;438;1585;7545;23358;7983;24943
291820;201504;3719;11027;3361;10512;260;864;2593;8186;2853;9050
291830;201504;4328;11548;3990;11072;474;1361;2994;8389;3468;9750
291835;201504;6313;19709;5067;17576;1421;5278;2574;8982;3995;14260
291840;201504;47962;133338;42095;126799;5762;16837;31128;97056;36890;113893
291845;201504;2932;8415;2608;8031;186;510;2299;7218;2485;7728
291850;201504;4692;13265;3836;11951;380;1084;2914;9374;3294;10458
291855;201504;1828;4677;1578;4363;181;624;1159;3089;1340;3713
291860;201504;2142;6164;1771;5464;134;506;1181;3573;1315;4079
291870;201504;1421;3796;1054;3145;100;362;672;1954;772;2316
291875;201504;2864;9053;2582;8620;161;683;1880;6151;2041;6834
291880;201504;4925;15622;4636;15149;373;1191;3765;12511;4138;13702
291890;201504;1360;3449;1135;3187;297;837;659;1939;956;2776
291900;201504;1307;3621;1088;3268;84;313;864;2573;948;2886
291905;201504;2817;7544;2215;6543;106;396;1691;4878;1797;5274
291910;201504;2741;7346;2298;6817;137;516;1927;5632;2064;6148
291915;201504;7122;21620;5996;19544;395;1373;4847;15946;5242;17319
291920;201504;30240;87517;27610;83779;5148;16247;16791;51715;21939;67962
291930;201504;2620;7726;2338;7286;204;718;1727;5339;1931;6057
291940;201504;3410;9705;2507;8072;353;1290;1415;4373;1768;5663
291950;201504;8746;29343;7913;27933;1362;4864;4697;17019;6059;21883
291955;201504;9587;28882;9061;28197;2047;6330;5495;17776;7542;24106
291960;201504;3183;9359;2626;8536;244;789;1894;6375;2138;7164
291970;201504;4022;12492;3753;12100;472;1603;2660;8710;3132;10313
291980;201504;11905;33950;9062;29866;1087;3740;6224;21028;7311;24768
291990;201504;2267;6842;2052;6547;128;435;1649;5392;1777;5827
291992;201504;2826;8659;2748;8503;398;1296;2054;6313;2452;7609
291995;201504;1903;5772;1772;5547;144;520;1435;4470;1579;4990
292000;201504;2395;6840;2112;6448;299;1060;1477;4480;1776;5540
292010;201504;6448;16411;4970;14270;458;1282;3806;11001;4264;12283
292020;201504;4240;14452;3945;13976;678;2497;2780;9916;3458;12413
292030;201504;2100;6442;1856;6083;241;845;1102;3584;1343;4429
292040;201504;4375;12057;3766;11420;251;610;3260;10303;3511;10913
292045;201504;2871;9925;2830;9874;84;278;2682;9367;2766;9645
292050;201504;6353;19571;5520;17907;472;1864;3787;12135;4259;13999
292060;201504;11625;31346;10824;30354;1077;2805;8778;24924;9855;27729
292070;201504;4607;14316;4415;14084;392;1151;3718;12048;4110;13199
292080;201504;3617;9414;3039;8694;208;625;2521;7264;2729;7889
292090;201504;4108;10818;3531;10148;235;782;2996;8667;3231;9449
292100;201504;11032;30010;9246;27508;2630;8154;4034;12611;6664;20765
292105;201504;3005;9458;2701;8995;151;623;2206;7345;2357;7968
292110;201504;6774;17885;5212;15507;1198;3598;2854;8772;4052;12370
292120;201504;7877;22300;6727;20173;1388;4166;3716;11589;5104;15755
292130;201504;3016;8089;2610;7521;477;1280;1710;5100;2187;6380
292140;201504;5013;13054;4240;12014;957;2451;2665;7885;3622;10336
292145;201504;2473;7623;2261;7311;136;419;1803;6089;1939;6508
292150;201504;12977;39675;11980;38066;681;2426;9627;30827;10308;33253
292160;201504;2659;7726;2272;7229;108;331;2005;6463;2113;6794
292170;201504;8896;25374;7415;22860;963;3367;4763;14637;5726;18004
292180;201504;3291;9411;2543;8205;324;1047;1691;5557;2015;6604
292190;201504;3403;9543;2862;8754;573;1835;1730;5396;2303;7231
292200;201504;6450;20429;5563;18791;1605;5904;2164;7296;3769;13200
292205;201504;3903;12162;3536;11633;209;854;2902;9444;3111;10298
292210;201504;6493;17841;5446;16458;370;1306;4442;13468;4812;14774
292220;201504;1939;5339;1770;5101;388;1059;1037;3041;1425;4100
292225;201504;3217;9920;2941;9528;177;652;2445;7953;2622;8605
292230;201504;6462;19282;6127;18743;436;1785;4802;14248;5238;16033
292240;201504;4687;14128;4217;13168;502;1644;2901;8964;3403;10608
292250;201504;5154;15909;4753;15164;1102;3686;2334;7483;3436;11169
292260;201504;3166;9479;2986;9233;192;632;2538;7868;2730;8500
292265;201504;2992;9416;2658;8845;179;730;1979;6511;2158;7241
292270;201504;4151;10629;3262;9601;203;701;2711;8013;2914;8714
292273;201504;2729;6547;2097;5773;228;581;1574;4573;1802;5154
292275;201504;1768;4720;1569;4427;217;641;1103;3140;1320;3781
292280;201504;2044;6067;1801;5805;145;395;1438;4922;1583;5317
292285;201504;2564;7049;2186;6523;154;542;1758;5258;1912;5800
292290;201504;7319;21872;6081;20197;418;1591;4749;16031;5167;17622
292300;201504;8134;24404;7033;23066;1659;5630;4146;14059;5805;19689
292303;201504;2796;8673;2589;8404;85;365;2297;7403;2382;7768
292305;201504;2974;8105;2831;7909;57;189;2666;7451;2723;7640
292310;201504;5948;17667;5558;17110;233;816;4677;14400;4910;15216
292320;201504;6623;19108;5700;17560;543;1808;4355;13453;4898;15261
292330;201504;2128;5857;1975;5639;179;576;1576;4440;1755;5016
292335;201504;5265;13732;4687;12969;450;1208;3855;10826;4305;12034
292340;201504;6415;18258;5410;16636;566;1741;3849;11955;4415;13696
292350;201504;2198;6629;1981;6311;185;709;1580;5034;1765;5743
292360;201504;5116;13774;4908;13330;187;362;4255;12144;4442;12506
292370;201504;8003;23831;7413;23004;793;2149;5911;18846;6704;20995
292380;201504;7231;21365;6677;20515;487;1452;5508;17117;5995;18569
292390;201504;3522;8075;3116;7637;97;167;2912;7238;3009;7405
292400;201504;20826;62625;19779;61022;2596;8332;14691;45702;17287;54034
292405;201504;4589;11650;3747;10595;240;651;3072;8767;3312;9418
292410;201504;1945;5228;1831;5100;126;314;1611;4543;1737;4857
292420;201504;3777;12263;3624;12076;121;358;3391;11440;3512;11798
292430;201504;5652;16864;4352;15015;308;1262;3225;11136;3533;12398
292440;201504;8561;28328;7864;27303;268;1085;6992;24546;7260;25631
292450;201504;4193;12464;3453;11292;331;1121;2506;8346;2837;9467
292460;201504;5279;15805;4566;14563;772;2625;2865;9174;3637;11799
292465;201504;2427;7321;2043;6680;195;757;1412;4682;1607;5439
292467;201504;1949;6262;1848;6099;319;1119;1250;4204;1569;5323
292470;201504;2928;7888;2460;7123;137;479;1955;5603;2092;6082
292480;201504;6093;16339;5283;15244;192;710;4663;13368;4855;14078
292490;201504;2436;6629;2015;6016;164;542;1557;4631;1721;5173
292500;201504;6581;19544;5601;17835;611;2102;3934;12716;4545;14818
292510;201504;12824;36333;11087;33881;906;2988;8677;26933;9583;29921
292520;201504;5661;16687;5053;15750;1267;4016;2674;8453;3941;12469
292525;201504;5349;13981;4537;13032;228;697;3838;11123;4066;11820
292530;201504;26327;76399;23370;72427;6138;19733;11850;37861;17988;57594
292540;201504;2847;7988;2519;7556;255;877;1991;5968;2246;6845
292550;201504;6525;20561;5762;19539;672;2434;4332;15034;5004;17468
292560;201504;4096;11322;3478;10432;220;873;2800;8250;3020;9123
292570;201504;3917;11712;3722;11506;79;194;3526;11110;3605;11304
292575;201504;6047;20333;5880;20065;750;2646;4609;15815;5359;18461
292580;201504;6831;20459;6460;19966;453;1418;5439;16972;5892;18390
292590;201504;7260;22081;6781;21365;588;1918;5482;17237;6070;19155
292593;201504;3112;8166;2618;7404;200;528;2086;5950;2286;6478
292595;201504;6015;16680;5309;15776;436;1407;4171;12483;4607;13890
292600;201504;10621;29915;9698;28756;920;2187;7873;24243;8793;26430
292610;201504;4513;12894;3678;11490;343;1107;2369;7691;2712;8798
292620;201504;6062;17674;5204;16677;149;492;4809;15538;4958;16030
292630;201504;9490;23925;7958;21607;717;1952;5842;16186;6559;18138
292640;201504;7781;25660;7195;24819;483;1793;5716;20078;6199;21871
292650;201504;4737;13078;4511;12774;363;669;3960;11705;4323;12374
292660;201504;10604;32022;9835;30913;1053;3413;7630;24319;8683;27732
292665;201504;2638;8065;2544;7939;49;103;2423;7672;2472;7775
292670;201504;3832;10749;2938;9226;237;831;1950;6141;2187;6972
292680;201504;3576;10834;3287;10355;379;1121;2515;8019;2894;9140
292690;201504;2961;8052;2151;6794;206;693;1516;4910;1722;5603
292700;201504;9207;27523;8105;25908;1135;3366;5587;18733;6722;22099
292710;201504;2031;6677;1927;6535;65;255;1732;5889;1797;6144
292720;201504;9252;23770;7977;22357;374;1160;6939;19588;7313;20748
292730;201504;3540;10661;3413;10474;353;1097;2635;8181;2988;9278
292740;201504;335901;906365;315952;877796;58754;173470;200861;554768;259615;728238
292750;201504;6511;17455;5564;16173;328;1006;4582;13395;4910;14401
292760;201504;4066;12805;3689;12140;493;1745;2465;8171;2958;9916
292770;201504;5630;17175;5203;16514;1025;3402;3267;10567;4292;13969
292780;201504;1929;4600;1473;4028;159;537;1076;2895;1235;3432
292790;201504;3203;8521;3069;8381;107;223;2873;7960;2980;8183
292800;201504;9041;27005;8340;25856;572;1977;6757;20916;7329;22893
292805;201504;2962;8492;2654;8067;384;1277;1918;5807;2302;7084
292810;201504;9379;28648;8044;26805;1019;3527;5822;19838;6841;23365
292820;201504;7334;20984;5469;18302;309;1210;4369;14727;4678;15937
292830;201504;1873;5450;1679;5178;79;335;1424;4333;1503;4668
292840;201504;7686;24021;7192;23351;296;1146;6469;20883;6765;22029
292850;201504;3243;8473;2646;7565;365;1074;1644;4606;2009;5680
292860;201504;14646;38710;13495;37189;1270;3638;10618;29281;11888;32919
292870;201504;19181;52495;16741;48728;2304;7417;10271;29585;12575;37002
292880;201504;12730;36549;11335;34544;1359;4552;7876;23788;9235;28340
292890;201504;5477;18651;4915;17633;793;3044;3083;11204;3876;14248
292895;201504;2767;6818;2169;5924;285;753;1520;4177;1805;4930
292900;201504;2842;8858;2698;8640;231;1010;1987;6101;2218;7111
292905;201504;4189;12278;3534;11390;198;604;2911;9614;3109;10218
292910;201504;5055;15172;4584;14307;683;2310;2873;8990;3556;11300
292920;201504;8893;26364;8436;25731;656;2359;6843;20374;7499;22733
292925;201504;5136;15703;4558;14866;460;1503;3446;11378;3906;12881
292930;201504;6514;20971;6208;20448;534;2282;4703;15190;5237;17472
292935;201504;2146;6121;1802;5747;101;266;1504;5032;1605;5298
292937;201504;3259;8330;2709;7649;279;886;2063;5740;2342;6626
292940;201504;3275;8953;2576;7997;301;947;1753;5659;2054;6606
292950;201504;7963;23456;7472;22643;682;2491;5582;16551;6264;19042
292960;201504;5089;13370;4437;12495;366;1136;3313;9254;3679;10390
292970;201504;4318;12987;3838;12362;150;627;3264;10540;3414;11167
292975;201504;3414;9235;3227;8987;313;794;2738;7769;3051;8563
292980;201504;3366;9073;2630;8060;257;902;1915;5827;2172;6729
292990;201504;11831;34201;10506;32165;467;1614;8887;27201;9354;28815
293000;201504;2777;7411;2449;7002;79;262;2130;6176;2209;6438
293010;201504;18082;50354;15481;46248;2535;8218;9509;28252;12044;36470
293015;201504;7511;25749;6635;24095;968;3907;4267;15460;5235;19367
293020;201504;9255;30830;8656;29998;405;1749;7439;25731;7844;27480
293030;201504;5579;16098;4411;14324;364;1175;3136;10683;3500;11858
293040;201504;3718;12259;3537;11920;187;668;3131;10542;3318;11210
293050;201504;19967;55698;17542;52618;2539;7889;11372;35095;13911;42984
293060;201504;3988;10314;3237;9112;282;867;2374;6619;2656;7486
293070;201504;21276;61958;18808;58079;4703;14772;9485;30217;14188;44989
293075;201504;3360;11157;3039;10713;230;894;2451;8723;2681;9617
293076;201504;3715;10313;3390;9873;219;604;2854;8490;3073;9094
293077;201504;4848;15165;4296;14419;1104;3883;2293;7855;3397;11738
293080;201504;4653;14673;4259;14055;241;1101;3483;11289;3724;12390
293090;201504;3357;10770;2806;9948;255;917;2112;7640;2367;8557
293100;201504;5825;17194;4818;15433;447;1496;3543;11506;3990;13002
293105;201504;3954;13107;3465;12178;487;1761;2341;8388;2828;10149
293110;201504;2003;5827;1786;5495;74;274;1510;4637;1584;4911
293120;201504;3857;12774;3632;12439;315;1002;2900;10184;3215;11186
293130;201504;4074;11511;3443;10811;157;548;3086;9824;3243;10372
293135;201504;30971;78137;23411;67614;4713;15636;10270;29289;14983;44925
293140;201504;2032;5894;1937;5760;146;529;1553;4500;1699;5029
293150;201504;5601;18501;4871;17080;892;3244;2982;10732;3874;13976
293160;201504;3763;9840;3488;9523;574;1154;2549;7513;3123;8667
293170;201504;3337;10011;3060;9602;383;1337;2199;6952;2582;8289
293180;201504;5170;14575;4183;13007;213;853;3341;10210;3554;11063
293190;201504;13867;42173;13019;40931;454;2111;11427;35350;11881;37461
293200;201504;6764;19215;5880;18037;261;926;4961;15299;5222;16225
293210;201504;5016;14575;4472;13658;341;1194;3420;10437;3761;11631
293220;201504;5100;15129;4476;14084;1133;3709;2109;6731;3242;10440
293230;201504;3834;11812;3515;11328;573;1977;2426;7866;2999;9843
293240;201504;4493;12189;3588;10699;162;529;2719;8111;2881;8640
293245;201504;4334;12413;3953;11849;385;1139;3024;9248;3409;10387
293250;201504;5854;16412;5332;15644;604;1853;3827;11250;4431;13103
293260;201504;4639;13931;3926;12901;317;1127;2996;9953;3313;11080
293270;201504;5661;15182;5305;14808;412;937;4679;13415;5091;14352
293280;201504;5368;15126;4599;14116;281;819;3695;11578;3976;12397
293290;201504;15548;51859;14595;50023;3539;12677;7444;26036;10983;38713
293300;201504;6919;16554;5847;15318;401;960;4673;12505;5074;13465
293305;201504;4812;11963;4128;11033;185;559;3525;9395;3710;9954
293310;201504;2508;6516;2052;5752;179;535;1484;4124;1663;4659
293315;201504;4385;11237;3769;10296;509;1369;2682;7461;3191;8830
293317;201504;2472;7207;2203;6715;203;638;1519;4662;1722;5300
293320;201504;8086;26907;7897;26681;595;2195;6748;22945;7343;25140
293325;201504;1899;5475;1572;4970;219;776;1065;3390;1284;4166
293330;201504;52331;165806;46918;156511;10099;36488;23953;80579;34052;117067
293340;201504;2703;7643;2120;6628;285;982;1388;4260;1673;5242
293345;201504;3377;10005;2934;9396;290;852;2226;7448;2516;8300
293350;201504;6737;18963;6383;18557;358;844;5701;17021;6059;17865
293360;201504;13378;40775;12052;39103;555;1878;10629;34793;11184;36671
310010;201504;1133;3057;838;2601;165;641;368;1060;533;1701
310020;201504;3284;10286;2693;9065;693;2596;486;1455;1179;4051
310030;201504;2352;7447;1963;6768;474;1834;1040;3529;1514;5363
310040;201504;1014;2716;846;2496;70;242;656;1925;726;2167
310050;201504;1923;6632;1732;6197;325;1382;839;2932;1164;4314
310060;201504;3224;10420;2847;9929;334;1245;2172;7640;2506;8885
310070;201504;331;940;257;803;29;122;149;425;178;547
310080;201504;725;2196;579;1935;120;509;197;587;317;1096
310090;201504;4713;14040;4069;12893;586;2066;2519;7948;3105;10014
310100;201504;3359;10178;2809;9246;222;896;2162;7075;2384;7971
310110;201504;5048;14201;4294;13031;705;2527;2617;7789;3322;10316
310120;201504;497;1556;426;1435;143;618;183;493;326;1111
310130;201504;431;1307;389;1246;82;315;221;661;303;976
310140;201504;200;657;166;596;64;273;39;108;103;381
310150;201504;4750;14573;4167;13470;949;3434;1838;5859;2787;9293
310160;201504;7361;22912;6045;20582;1715;6476;1940;6551;3655;13027
310163;201504;921;3030;777;2733;208;809;277;942;485;1751
310170;201504;9147;25967;8281;24747;1297;4032;5508;16884;6805;20916
310180;201504;1623;4761;1370;4374;323;1151;644;1994;967;3145
310190;201504;2716;9016;2468;8610;706;2690;379;1315;1085;4005
310200;201504;1880;6142;1563;5501;382;1511;562;1945;944;3456
310205;201504;1112;3242;882;2878;165;546;493;1644;658;2190
310210;201504;2652;7999;2427;7672;272;982;1859;5862;2131;6844
310220;201504;1050;3274;983;3162;196;702;563;1761;759;2463
310230;201504;2645;8334;2212;7385;506;1987;1000;3111;1506;5098
310240;201504;1051;3649;903;3385;152;642;473;1844;625;2486
310250;201504;863;2919;834;2867;160;660;503;1628;663;2288
310260;201504;3359;10674;2725;9383;717;2788;883;2824;1600;5612
310270;201504;2502;7312;2170;6824;162;556;1761;5586;1923;6142
310280;201504;2263;6187;1932;5697;348;1285;1059;2969;1407;4254
310285;201504;2090;7475;1957;7273;219;891;1536;5807;1755;6698
310290;201504;1276;3906;1187;3775;313;1138;585;1693;898;2831
310300;201504;1786;6049;1690;5860;445;1746;935;3147;1380;4893
310310;201504;376;1024;266;804;39;122;130;392;169;514
310320;201504;387;1257;325;1131;54;245;150;502;204;747
310330;201504;505;1269;359;1011;27;96;177;447;204;543
310340;201504;8454;25650;7056;23278;1361;4715;3841;13071;5202;17786
310350;201504;14471;39059;10555;32446;2842;9767;2982;8885;5824;18652
310360;201504;430;1319;411;1293;43;171;305;921;348;1092
310370;201504;1441;4925;1367;4804;373;1348;757;2698;1130;4046
310375;201504;1351;3609;890;2800;139;505;357;1088;496;1593
310380;201504;379;1032;282;889;99;347;103;293;202;640
310390;201504;515;1841;445;1689;121;513;77;241;198;754
310400;201504;10162;29002;7750;24759;1949;6850;2083;6606;4032;13456
310410;201504;832;2736;551;2238;153;678;108;424;261;1102
310420;201504;5958;16988;3719;12077;720;2600;589;1700;1309;4300
310430;201504;1483;4954;1173;4324;327;1342;248;868;575;2210
310440;201504;553;1590;449;1420;97;363;194;575;291;938
310445;201504;1264;4112;1048;3710;160;612;635;2242;795;2854
310450;201504;4697;13333;3810;12091;596;2017;2512;8147;3108;10164
310460;201504;1611;5021;1370;4631;388;1432;282;1002;670;2434
310470;201504;3463;8847;2916;8167;276;753;2394;6801;2670;7554
310480;201504;1215;3601;946;3070;211;817;408;1215;619;2032
310490;201504;2958;9745;2563;8974;711;2809;1004;3447;1715;6256
310500;201504;1308;4462;1185;4198;294;1185;505;1738;799;2923
310510;201504;2239;7070;1783;6049;490;1808;353;1134;843;2942
310520;201504;1424;3768;1123;3284;86;265;738;2164;824;2429
310530;201504;897;2779;530;1811;80;303;88;268;168;571
310540;201504;3177;10436;2901;9974;808;2937;1271;4391;2079;7328
310550;201504;1228;3578;1000;3193;248;964;450;1311;698;2275
310560;201504;15670;47989;13239;43252;3766;13821;4181;12764;7947;26585
310570;201504;1192;3602;1065;3403;162;600;753;2355;915;2955
310590;201504;4283;12508;3412;10858;583;2095;1408;4272;1991;6367
310600;201504;1433;4787;1296;4493;378;1512;446;1409;824;2921
310610;201504;494;1669;441;1557;105;474;149;456;254;930
310620;201504;173162;532087;142852;473224;35211;132095;54311;170086;89522;302181
310630;201504;3982;12310;3707;11842;465;1728;2686;8458;3151;10186
310640;201504;1349;4045;1059;3521;351;1262;257;787;608;2049
310650;201504;2723;8809;2213;7927;378;1489;1271;4594;1649;6083
310660;201504;1394;4205;1210;3950;152;511;863;2806;1015;3317
310665;201504;1252;3878;1118;3683;165;588;799;2685;964;3273
310670;201504;47196;145916;42361;135653;11051;38088;16364;50734;27415;88822
310680;201504;708;2061;638;1956;144;465;351;1059;495;1524
310690;201504;1388;4528;1125;4050;298;1244;339;1132;637;2376
310700;201504;580;1510;454;1337;127;423;228;639;355;1062
310710;201504;6607;21582;5165;19171;1184;5112;1227;4360;2411;9472
310720;201504;780;2362;704;2227;162;592;354;1059;516;1651
310730;201504;9406;29374;8349;27613;1622;5903;5055;16671;6677;22574
310740;201504;4861;15714;3945;13906;1118;4398;971;3284;2089;7682
310750;201504;1554;3890;1212;3456;148;430;885;2533;1033;2963
310760;201504;608;1846;509;1692;116;421;206;670;322;1091
310770;201504;816;2580;633;2290;155;633;258;863;413;1496
310780;201504;3787;10574;3238;9596;551;1652;1955;5791;2506;7443
310790;201504;1925;6128;1727;5777;450;1586;797;2759;1247;4345
310800;201504;2793;8823;2146;7577;724;2928;237;776;961;3704
310810;201504;1286;3606;1153;3378;206;666;628;1776;834;2442
310820;201504;1366;3938;1022;3303;247;909;318;971;565;1880
310825;201504;2485;8369;1969;7450;145;749;1453;5407;1598;6156
310830;201504;1404;4562;1091;3943;332;1280;290;989;622;2269
310840;201504;2213;6897;1812;6202;610;2329;509;1632;1119;3961
310850;201504;1554;4614;1288;4270;186;693;927;3071;1113;3764
310855;201504;2910;9258;2514;8647;472;1766;1580;5494;2052;7260
310860;201504;7769;23862;6611;21842;1018;3605;3828;12887;4846;16492
310870;201504;994;2768;798;2447;160;538;416;1259;576;1797
310880;201504;1234;3759;934;3199;172;709;461;1545;633;2254
310890;201504;2692;8306;2118;7319;540;2142;600;1903;1140;4045
310900;201504;3996;12838;3227;11214;828;3282;1097;3488;1925;6770
310910;201504;2073;5898;1382;4574;324;1213;284;863;608;2076
310920;201504;1914;5757;1528;5198;369;1413;695;2366;1064;3779
310925;201504;898;2960;808;2801;315;1204;294;988;609;2192
310930;201504;5934;17019;4752;15242;851;2944;2776;9141;3627;12085
310940;201504;6354;18250;5327;16660;999;3358;2899;9060;3898;12418
310945;201504;1334;3722;1098;3399;182;684;683;2020;865;2704
310950;201504;1995;6390;1506;5310;427;1752;401;1255;828;3007
310960;201504;414;1351;340;1215;107;413;111;395;218;808
310970;201504;1470;4962;1061;3974;308;1286;133;420;441;1706
310980;201504;509;1251;315;916;42;152;141;357;183;509
310990;201504;1163;3888;984;3513;246;988;304;997;550;1985
311000;201504;3632;12361;3226;11527;910;3725;1130;3749;2040;7474
311010;201504;768;2546;714;2450;226;846;326;1078;552;1924
311020;201504;946;2858;762;2532;175;661;311;962;486;1623
311030;201504;1700;4785;1223;3879;308;1105;422;1200;730;2305
311040;201504;488;1648;428;1491;95;349;98;327;193;676
311050;201504;2265;7187;1969;6683;537;2025;856;2903;1393;4928
311060;201504;2157;6538;1641;5427;365;1362;418;1283;783;2645
311070;201504;1467;5132;1289;4798;340;1468;487;1784;827;3252
311080;201504;901;2677;805;2512;128;442;491;1483;619;1925
311090;201504;1579;5858;1334;5347;452;2040;247;958;699;2998
311100;201504;2197;7437;1836;6672;729;2877;383;1352;1112;4229
311110;201504;3964;9300;2720;7554;442;1340;1449;3981;1891;5321
311115;201504;1201;3548;1016;3272;114;476;675;2136;789;2612
311120;201504;7965;22486;6185;19315;1605;5604;1622;4641;3227;10245
311130;201504;2100;6629;1777;6174;448;1893;786;2573;1234;4466
311140;201504;1388;3743;1135;3426;126;451;811;2414;937;2865
311150;201504;1951;6596;1792;6339;340;1299;1050;3744;1390;5043
311160;201504;4849;16298;4084;14929;1473;5871;1185;4240;2658;10111
311170;201504;780;2378;620;2083;82;286;311;1091;393;1377
311180;201504;1474;4141;1106;3434;327;1098;257;729;584;1827
311190;201504;1047;3144;891;2838;201;751;302;854;503;1605
311200;201504;2175;6654;1802;5882;554;2006;397;1147;951;3153
311205;201504;1084;3548;930;3241;193;774;392;1364;585;2138
311210;201504;948;3074;878;2969;162;547;610;2131;772;2678
311220;201504;900;2835;726;2461;180;652;253;843;433;1495
311230;201504;8350;25824;6832;22958;1322;4824;3118;10755;4440;15579
311240;201504;1170;3535;949;3178;258;979;322;1034;580;2013
311250;201504;905;2940;806;2792;236;937;261;757;497;1694
311260;201504;2767;7399;2056;6209;546;1832;685;2006;1231;3838
311265;201504;1330;3645;1046;3196;175;630;609;1832;784;2462
311270;201504;3410;10908;2975;10315;421;1837;2048;6873;2469;8710
311280;201504;1316;3617;898;2802;192;688;270;794;462;1482
311290;201504;2121;7045;1978;6751;427;1460;1139;3966;1566;5426
311300;201504;4600;15308;4120;14484;553;2244;2839;10032;3392;12276
311310;201504;537;1860;488;1771;96;421;211;718;307;1139
311320;201504;4119;13680;3635;12624;786;3146;1290;4231;2076;7377
311330;201504;4958;14873;4273;13775;1297;4663;1746;5570;3043;10233
311340;201504;12367;39154;10926;36430;3294;11933;3312;10935;6606;22868
311350;201504;2262;6584;1820;5754;360;1354;829;2427;1189;3781
311360;201504;1221;3378;936;3018;405;1400;209;667;614;2067
311370;201504;3887;11731;3313;10738;767;3035;1451;4275;2218;7310
311380;201504;453;1450;377;1315;109;435;127;430;236;865
311390;201504;1843;6749;1707;6537;717;3140;551;1973;1268;5113
311400;201504;1484;4747;1283;4372;273;1100;583;1814;856;2914
311410;201504;1818;6317;1651;6097;462;1863;887;3342;1349;5205
311420;201504;2037;6623;1492;5320;395;1529;286;798;681;2327
311430;201504;3997;12033;2776;9328;561;2077;391;1225;952;3302
311440;201504;2352;7634;1774;6523;617;2665;352;1230;969;3895
311450;201504;2012;6987;1711;6277;484;1962;399;1337;883;3299
311455;201504;1286;3432;1055;3066;232;754;564;1541;796;2295
311460;201504;693;2247;534;1922;120;536;128;419;248;955
311470;201504;553;1763;444;1535;113;483;138;427;251;910
311480;201504;777;2065;725;1998;179;472;421;1155;600;1627
311490;201504;260;991;235;921;77;317;82;310;159;627
311500;201504;472;1373;374;1188;94;336;168;526;262;862
311510;201504;3122;9635;2534;8510;885;3494;590;1801;1475;5295
311520;201504;643;2150;593;2043;216;803;215;707;431;1510
311530;201504;12057;31198;8427;25126;2008;7185;2401;6892;4409;14077
311535;201504;807;2379;558;1887;123;490;89;280;212;770
311540;201504;647;2258;609;2205;227;864;288;1018;515;1882
311545;201504;2099;6566;1925;6350;219;865;1428;4683;1647;5548
311547;201504;1551;4348;1294;3944;101;336;871;2670;972;3006
311550;201504;2999;9609;2535;8672;578;2259;858;2864;1436;5123
311560;201504;262;669;219;614;36;113;129;346;165;459
311570;201504;2216;5517;1738;4918;116;336;1378;4003;1494;4339
311580;201504;2361;4957;1849;4363;554;1231;999;2486;1553;3717
311590;201504;433;1359;375;1279;109;445;121;396;230;841
311600;201504;1201;3636;1030;3406;201;663;648;2212;849;2875
311610;201504;3144;11000;2826;10441;941;3445;1245;4884;2186;8329
311615;201504;3076;9471;2561;8649;289;1151;1776;6012;2065;7163
311620;201504;438;1376;389;1299;90;333;223;736;313;1069
311630;201504;1424;4175;1193;3774;265;820;665;2147;930;2967
311640;201504;846;2656;701;2413;135;525;405;1354;540;1879
311650;201504;2280;6743;1928;6164;250;854;1155;3821;1405;4675
311660;201504;2434;8156;1988;7155;437;1748;281;825;718;2573
311670;201504;1539;4623;1289;4198;439;1580;487;1568;926;3148
311680;201504;2105;6700;1804;6223;422;1530;1008;3528;1430;5058
311690;201504;556;1430;448;1301;53;174;341;982;394;1156
311700;201504;2227;6111;1884;5638;132;539;1504;4379;1636;4918
311710;201504;1712;5157;1257;4309;471;1814;342;1123;813;2937
311720;201504;398;1328;355;1241;64;250;175;590;239;840
311730;201504;5682;14439;3348;10269;954;3430;987;2485;1941;5915
311740;201504;941;2642;806;2480;305;910;418;1341;723;2251
311750;201504;3989;13074;3468;12264;619;2505;1995;6961;2614;9466
311760;201504;806;2701;752;2590;203;827;324;989;527;1816
311770;201504;2445;7656;1994;6823;497;1910;603;1947;1100;3857
311780;201504;1129;4086;953;3663;303;1326;221;786;524;2112
311783;201504;1963;6425;1661;5843;102;476;1240;4347;1342;4823
311787;201504;564;1938;419;1520;67;257;96;288;163;545
311790;201504;1467;4374;1073;3598;269;1002;292;918;561;1920
311800;201504;4168;14056;3167;11279;664;2500;205;614;869;3114
311810;201504;1054;3538;995;3432;39;192;842;2881;881;3073
311820;201504;663;2121;546;1832;150;563;260;815;410;1378
311830;201504;8004;27134;6653;23824;2316;8958;926;3007;3242;11965
311840;201504;3184;9487;2773;8896;788;2890;1267;3921;2055;6811
311850;201504;304;896;260;825;68;236;117;364;185;600
311860;201504;49827;148746;42609;135753;10069;35521;19519;60049;29588;95570
311870;201504;2300;6732;1747;5677;379;1456;568;1659;947;3115
311880;201504;6926;20241;6174;19345;950;2889;4290;14012;5240;16901
311890;201504;1462;4443;1194;3905;299;1098;466;1447;765;2545
311900;201504;773;2414;694;2312;121;397;449;1580;570;1977
311910;201504;4481;13223;3715;12142;959;3436;1608;5252;2567;8688
311920;201504;1930;6366;1693;5967;186;745;1145;4040;1331;4785
311930;201504;3827;11082;3272;10212;1189;3939;1020;3122;2209;7061
311940;201504;12070;36569;9935;32244;2850;10180;2123;6456;4973;16636
311950;201504;2310;6761;1916;6224;164;596;1395;4499;1559;5095
311960;201504;366;1129;326;1046;71;290;163;446;234;736
311970;201504;392;1340;321;1190;78;339;72;255;150;594
311980;201504;661;1834;449;1455;71;248;181;586;252;834
311990;201504;452;1325;375;1201;138;486;127;374;265;860
311995;201504;1159;3515;714;2424;80;298;105;267;185;565
312000;201504;658;2012;595;1911;88;320;372;1188;460;1508
312010;201504;957;3136;827;2849;153;608;363;1221;516;1829
312015;201504;1499;4711;1297;4366;160;665;831;2767;991;3432
312020;201504;876;2730;754;2537;158;603;402;1363;560;1966
312030;201504;1784;5313;1620;5111;136;513;1341;4208;1477;4721
312040;201504;718;2686;621;2416;171;750;132;481;303;1231
312050;201504;1469;5064;1282;4683;370;1508;272;940;642;2448
312060;201504;753;2290;662;2163;298;1043;202;592;500;1635
312070;201504;1037;3201;688;2438;166;636;242;847;408;1483
312080;201504;2619;7349;2067;6475;375;1420;1031;2980;1406;4400
312083;201504;963;2733;824;2532;135;484;518;1553;653;2037
312087;201504;2206;6778;1947;6398;262;925;1382;4636;1644;5561
312090;201504;9030;28333;7980;26554;2314;8410;3305;10741;5619;19151
312100;201504;1391;4652;1178;4320;254;1040;600;2226;854;3266
312110;201504;1134;3968;984;3640;330;1396;183;597;513;1993
312120;201504;748;2501;651;2307;163;687;210;641;373;1328
312125;201504;1166;3705;1032;3455;235;827;529;1825;764;2652
312130;201504;787;2312;616;1971;97;357;258;786;355;1143
312140;201504;994;3140;809;2697;161;607;272;778;433;1385
312150;201504;581;1644;492;1451;34;117;335;952;369;1069
312160;201504;7592;25889;6830;24319;1938;7600;2530;8912;4468;16512
312170;201504;976;2872;869;2670;104;341;538;1659;642;2000
312180;201504;1424;4338;1250;4003;294;1018;510;1560;804;2578
312190;201504;627;1991;467;1668;161;651;87;284;248;935
312200;201504;4885;14214;4214;13195;465;1568;3024;9475;3489;11043
312210;201504;1049;2872;811;2502;213;726;340;998;553;1724
312220;201504;1848;6200;1671;5997;163;620;1370;5069;1533;5689
312230;201504;13471;42009;10569;36339;3915;14857;1850;6179;5765;21036
312235;201504;1763;5087;1467;4647;155;607;993;3133;1148;3740
312240;201504;959;3167;788;2812;194;774;250;829;444;1603
312245;201504;2292;6767;1984;6365;114;366;1645;5326;1759;5692
312247;201504;828;2507;655;2201;166;630;313;1066;479;1696
312250;201504;1203;3379;952;2959;181;668;427;1274;608;1942
312260;201504;939;2967;783;2727;145;591;481;1641;626;2232
312270;201504;688;2081;567;1851;94;403;252;732;346;1135
312280;201504;394;1343;352;1251;137;523;44;141;181;664
312290;201504;745;2464;688;2379;225;910;209;694;434;1604
312300;201504;950;3149;764;2714;179;717;96;260;275;977
312310;201504;926;3478;854;3307;244;1039;345;1291;589;2330
312320;201504;2191;6226;1700;5236;418;1415;376;923;794;2338
312330;201504;998;2982;840;2752;153;594;578;1855;731;2449
312340;201504;311;802;275;755;34;135;217;557;251;692
312350;201504;338;851;306;814;30;90;257;668;287;758
312352;201504;1686;5408;1539;5204;431;1465;908;3205;1339;4670
312360;201504;2790;9091;2315;8103;546;2147;707;2403;1253;4550
312370;201504;1749;5583;1588;5332;586;2205;502;1562;1088;3767
312380;201504;1882;5438;1681;5145;143;460;1346;4201;1489;4661
312385;201504;1289;3866;1126;3599;128;551;795;2434;923;2985
312390;201504;2098;6862;1707;6008;500;1865;307;989;807;2854
312400;201504;3324;10708;2826;9755;1009;3637;921;3306;1930;6943
312410;201504;10336;34027;9251;31962;2356;9028;3725;12580;6081;21608
312420;201504;4022;12420;3807;12167;542;1725;2807;9212;3349;10937
312430;201504;7433;22782;6771;21697;1144;3723;4489;14634;5633;18357
312440;201504;694;2215;619;2089;135;499;326;1146;461;1645
312450;201504;1139;3869;926;3418;356;1384;311;1140;667;2524
312460;201504;376;1141;336;1095;95;341;163;527;258;868
312470;201504;710;1946;456;1446;91;330;145;440;236;770
312480;201504;1255;3512;1004;3226;272;976;515;1587;787;2563
312490;201504;2089;5506;1642;4852;248;829;943;2667;1191;3496
312500;201504;677;2122;606;2015;116;484;333;1078;449;1562
312510;201504;3034;8966;2374;7596;425;1574;1120;3319;1545;4893
312520;201504;287;990;233;885;66;265;80;313;146;578
312530;201504;607;1835;545;1745;85;350;351;1066;436;1416
312540;201504;1474;4633;1155;3998;255;957;580;1985;835;2942
312550;201504;688;2118;594;1911;133;448;262;787;395;1235
312560;201504;2056;5554;1750;5161;133;456;1413;4155;1546;4611
312570;201504;2625;7770;2196;7027;643;2214;645;1968;1288;4182
312580;201504;541;1780;447;1587;89;403;166;550;255;953
312590;201504;1807;6011;1579;5542;379;1544;599;1927;978;3471
312595;201504;2088;7022;1863;6501;484;1816;900;3091;1384;4907
312600;201504;771;2531;617;2242;119;552;318;1051;437;1603
312610;201504;7241;20692;5474;17521;1374;4966;1351;4006;2725;8972
312620;201504;2031;5985;1603;5405;129;473;1264;4373;1393;4846
312630;201504;367;1196;327;1121;75;296;172;570;247;866
312640;201504;568;1818;456;1593;98;400;165;514;263;914
312650;201504;2189;6481;1580;5269;168;630;919;3049;1087;3679
312660;201504;1380;3696;1124;3330;120;421;772;2254;892;2675
312670;201504;5874;17714;5060;16575;1251;4637;2309;7364;3560;12001
312675;201504;1361;4342;1139;3892;159;631;679;2275;838;2906
312680;201504;1493;4664;1315;4399;189;713;877;2887;1066;3600
312690;201504;2196;5862;1762;5257;352;1181;984;2810;1336;3991
312695;201504;830;3023;798;2981;149;546;549;2128;698;2674
312700;201504;1949;5768;1520;4917;212;778;775;2460;987;3238
312705;201504;1361;3855;1143;3502;128;433;799;2437;927;2870
312707;201504;1735;5317;1367;4621;198;776;713;2331;911;3107
312710;201504;7038;18576;4706;14563;1293;4595;1028;2889;2321;7484
312720;201504;758;2577;656;2357;161;646;237;794;398;1440
312730;201504;1971;4792;1425;4152;211;716;803;2340;1014;3056
312733;201504;1679;4488;1270;3727;90;355;867;2429;957;2784
312735;201504;883;2520;776;2375;203;701;425;1251;628;1952
312737;201504;914;2293;660;1939;213;625;280;847;493;1472
312738;201504;553;1672;406;1370;107;411;135;419;242;830
312740;201504;461;1283;307;1093;94;373;82;295;176;668
312750;201504;1257;4517;1200;4406;272;1185;591;2089;863;3274
312760;201504;2178;6960;1686;6012;439;1760;384;1344;823;3104
312770;201504;41319;114613;32851;100634;8810;29483;9997;29791;18807;59274
312780;201504;2744;9624;2460;9154;470;1908;1376;5270;1846;7178
312790;201504;338;872;198;624;52;203;48;113;100;316
312800;201504;5128;16916;4258;15148;1364;5270;1210;4317;2574;9587
312810;201504;2182;6665;1534;5424;432;1681;300;992;732;2673
312820;201504;2048;5957;1839;5623;166;621;1233;3672;1399;4293
312825;201504;1363;3713;1188;3495;97;290;956;2831;1053;3121
312830;201504;2726;8534;1912;6873;496;1974;346;1197;842;3171
312840;201504;1201;3881;1020;3547;135;589;554;1847;689;2436
312850;201504;654;2114;534;1882;96;410;192;652;288;1062
312860;201504;1135;3335;895;2912;234;912;270;761;504;1673
312870;201504;5334;16635;3942;13844;879;3502;1014;3430;1893;6932
312880;201504;1310;3918;1132;3626;175;625;656;2121;831;2746
312890;201504;1599;4798;1090;3689;332;1259;347;1142;679;2401
312900;201504;1259;3789;1120;3599;206;705;767;2509;973;3214
312910;201504;1565;3260;1024;2567;186;563;546;1247;732;1810
312920;201504;865;2766;742;2579;192;766;375;1268;567;2034
312930;201504;2260;6568;1958;6133;451;1466;995;3217;1446;4683
312940;201504;916;3006;803;2812;238;963;215;703;453;1666
312950;201504;3327;9290;2595;8208;878;3014;798;2480;1676;5494
312960;201504;1983;5860;1764;5577;297;926;1272;4125;1569;5051
312965;201504;1780;5716;1511;5222;253;974;887;3108;1140;4082
312970;201504;989;3358;822;3093;296;1292;146;492;442;1784
312980;201504;17117;58065;16086;55832;5150;19693;6356;21017;11506;40710
312990;201504;430;1312;327;1137;112;437;105;361;217;798
313000;201504;532;1766;432;1567;117;542;160;509;277;1051
313005;201504;2606;8409;2298;7867;440;1567;1344;4643;1784;6210
313010;201504;3743;11979;3200;11066;875;3366;1381;4677;2256;8043
313020;201504;959;3148;815;2854;218;889;242;730;460;1619
313030;201504;1483;4018;1105;3506;252;969;500;1501;752;2470
313040;201504;866;2923;741;2590;141;577;285;926;426;1503
313050;201504;1816;5824;1470;5326;445;1800;574;1991;1019;3791
313055;201504;1600;5205;1462;5015;137;505;1114;3874;1251;4379
313060;201504;636;2084;507;1757;168;599;59;197;227;796
313065;201504;1944;6344;1679;5925;285;1135;1195;4208;1480;5343
313070;201504;1145;3336;936;2964;227;839;436;1272;663;2111
313080;201504;478;1497;384;1319;95;403;125;352;220;755
313090;201504;5372;15524;4677;14448;804;2624;3020;9463;3824;12087
313100;201504;1104;3441;1007;3284;102;345;780;2564;882;2909
313110;201504;1737;4939;1299;4095;284;1025;507;1454;791;2479
313115;201504;2506;8527;2383;8280;595;2378;1179;3823;1774;6201
313120;201504;3568;9715;3044;9015;733;2378;1820;5237;2553;7615
313130;201504;23679;71871;20313;64940;5058;17873;7566;22748;12624;40621
313140;201504;701;1814;536;1569;37;135;366;1056;403;1191
313150;201504;1467;4651;1261;4266;514;1868;320;1071;834;2939
313160;201504;1057;3183;928;2948;158;596;559;1722;717;2318
313170;201504;7750;27055;6524;24109;1870;7444;1327;4769;3197;12213
313180;201504;2468;6708;1949;5978;546;1861;709;2086;1255;3947
313190;201504;3044;10781;2547;9445;581;2399;792;2745;1373;5144
313200;201504;1292;4210;1145;3951;160;635;793;2716;953;3351
313210;201504;4503;13773;3736;12718;846;3310;1862;6102;2708;9412
313220;201504;1320;3970;970;3216;262;984;238;682;500;1666
313230;201504;2328;8337;2149;8072;335;1359;1459;5505;1794;6864
313240;201504;7772;24460;6320;21900;1498;5954;2524;8458;4022;14412
313250;201504;7185;22584;6375;21246;1020;3552;3821;12947;4841;16499
313260;201504;618;1846;469;1552;85;327;125;378;210;705
313270;201504;5481;16216;4700;14962;801;2775;2877;9138;3678;11913
313280;201504;438;1448;333;1208;56;246;88;273;144;519
313290;201504;928;3269;767;2980;247;1066;163;556;410;1622
313300;201504;1900;6390;1586;5627;465;1803;250;780;715;2583
313310;201504;1129;3917;998;3641;250;1029;190;622;440;1651
313320;201504;2461;7196;1906;6295;374;1372;838;2768;1212;4140
313330;201504;3819;12214;3221;11138;611;2443;1742;5939;2353;8382
313340;201504;2051;4959;1588;4289;315;860;888;2374;1203;3234
313350;201504;3246;10016;2527;8503;575;2165;491;1478;1066;3643
313360;201504;1234;3626;931;3115;261;1032;440;1366;701;2398
313370;201504;1207;4092;1131;3888;175;739;602;1927;777;2666
313375;201504;2216;5799;1496;4721;307;1209;516;1573;823;2782
313380;201504;4987;15839;4131;14069;1108;4218;1398;4483;2506;8701
313390;201504;894;3162;856;3113;100;421;594;2153;694;2574
313400;201504;3627;10221;3289;9834;272;805;2757;8408;3029;9213
313410;201504;1266;3595;1059;3309;216;760;617;1904;833;2664
313420;201504;20230;48136;12364;34798;2488;7912;2534;6802;5022;14714
313430;201504;1114;3471;868;2958;184;753;348;1095;532;1848
313440;201504;6322;14410;4333;12090;354;1082;3008;8426;3362;9508
313450;201504;685;2007;547;1729;122;477;192;547;314;1024
313460;201504;2272;7863;2016;7435;582;2405;600;2083;1182;4488
313470;201504;3257;9140;3041;8899;274;689;2580;7736;2854;8425
313480;201504;1118;3206;861;2766;139;525;365;1098;504;1623
313490;201504;1516;4653;965;3715;348;1446;142;526;490;1972
313500;201504;400;1246;364;1169;69;266;182;546;251;812
313505;201504;8950;26857;8302;26117;354;698;7672;24820;8026;25518
313507;201504;1377;3886;1206;3654;191;664;777;2377;968;3041
313510;201504;15482;44660;13502;41897;2219;7050;8452;26974;10671;34024
313520;201504;15131;45833;12527;41417;1652;6306;7968;26030;9620;32336
313530;201504;633;2021;514;1798;69;288;180;586;249;874
313535;201504;2536;7540;2223;7004;214;728;1601;5001;1815;5729
313540;201504;1070;3359;827;2739;231;829;205;622;436;1451
313545;201504;1294;4775;1171;4516;167;823;742;2714;909;3537
313550;201504;1867;6026;1654;5604;427;1531;803;2653;1230;4184
313560;201504;2213;5394;1880;5021;269;658;1395;3871;1664;4529
313570;201504;828;2984;723;2786;256;1057;261;976;517;2033
313580;201504;5972;16925;4948;15522;815;2780;3216;10185;4031;12965
313590;201504;1037;2970;812;2692;399;1437;229;727;628;2164
313600;201504;4018;12131;3492;11313;549;1977;2213;7239;2762;9216
313610;201504;1032;3177;885;2886;191;679;410;1314;601;1993
313620;201504;6017;18839;5237;17454;1553;5589;1822;5957;3375;11546
313630;201504;8121;23398;6341;20722;1344;4995;2811;9512;4155;14507
313640;201504;828;2474;648;2197;195;741;213;696;408;1437
313650;201504;2116;6889;1855;6468;255;1016;1296;4478;1551;5494
313652;201504;1006;3603;921;3441;163;667;557;2075;720;2742
313655;201504;947;3088;792;2824;139;593;463;1603;602;2196
313657;201504;1290;3973;1106;3695;128;583;795;2434;923;3017
313660;201504;858;2855;780;2717;172;714;381;1243;553;1957
313665;201504;3353;11014;3066;10406;666;2575;1485;4869;2151;7444
313670;201504;51020;143680;34925;116144;9374;34535;10287;33422;19661;67957
313680;201504;1101;3335;958;3109;143;506;647;2088;790;2594
313690;201504;888;3188;787;2966;218;866;290;1098;508;1964
313695;201504;1360;4504;1182;4180;130;512;818;2930;948;3442
313700;201504;3833;12726;3223;11927;548;2103;2165;8225;2713;10328
313710;201504;1291;3526;1018;3117;246;814;495;1476;741;2290
313720;201504;5210;16983;4279;14987;941;3709;1394;4490;2335;8199
313730;201504;1340;3556;998;3129;203;710;540;1673;743;2383
313740;201504;2138;7658;1798;6831;569;2456;212;723;781;3179
313750;201504;2426;7356;2052;6658;585;2086;648;1933;1233;4019
313753;201504;1828;5407;1466;4785;407;1488;559;1795;966;3283
313760;201504;4473;14459;3706;12933;1088;4175;1036;3365;2124;7540
313770;201504;3479;11509;3180;10970;1090;4067;1114;3672;2204;7739
313780;201504;3671;10213;2883;9034;513;1955;1367;4197;1880;6152
313790;201504;513;1759;489;1720;109;379;270;991;379;1370
313800;201504;1197;3336;1042;3097;134;454;686;2044;820;2498
313810;201504;1484;4389;1436;4323;72;221;1266;3859;1338;4080
313820;201504;12931;34788;10613;31113;1850;6449;5333;15167;7183;21616
313830;201504;419;1405;358;1277;97;397;110;387;207;784
313835;201504;922;3079;865;2996;174;677;512;1723;686;2400
313840;201504;7761;22303;6064;19417;1604;5746;1702;5283;3306;11029
313850;201504;1238;3387;1089;3131;241;825;559;1501;800;2326
313860;201504;2826;8581;2210;7254;562;2044;504;1556;1066;3600
313862;201504;1200;3007;787;2319;138;407;320;967;458;1374
313865;201504;2273;7021;2058;6691;251;929;1486;4807;1737;5736
313867;201504;1112;3774;952;3453;332;1291;324;1204;656;2495
313868;201504;1594;5593;1400;5189;144;654;954;3509;1098;4163
313870;201504;859;2715;778;2583;230;895;250;727;480;1622
313880;201504;1658;5128;1474;4907;271;1111;912;2869;1183;3980
313890;201504;1872;5149;1570;4743;241;720;1045;3262;1286;3982
313900;201504;4186;15308;3816;14459;1220;5245;1176;4276;2396;9521
313910;201504;774;2613;659;2380;243;957;101;337;344;1294
313920;201504;3494;11419;3042;10635;476;1767;1857;6669;2333;8436
313925;201504;1920;5156;1394;4164;103;346;906;2701;1009;3047
313930;201504;5269;17313;4383;15727;772;2982;2445;8997;3217;11979
313940;201504;8285;27829;6985;25754;2246;9094;2440;9341;4686;18435
313950;201504;4202;12114;3371;10769;1003;3727;1219;3549;2222;7276
313960;201504;5800;15057;4292;12999;1329;4467;1189;3390;2518;7857
313970;201504;1442;4134;1236;3896;153;532;813;2670;966;3202
313980;201504;1258;3980;1000;3519;291;1190;372;1289;663;2479
313990;201504;1892;7070;1637;6468;539;2353;386;1385;925;3738
314000;201504;7591;24959;6946;23749;1450;5949;4103;13486;5553;19435
314010;201504;1109;3172;921;2939;125;484;591;1838;716;2322
314015;201504;1264;4549;1120;4259;343;1417;382;1410;725;2827
314020;201504;527;1636;410;1388;104;406;99;306;203;712
314030;201504;873;2818;690;2406;114;452;251;856;365;1308
314040;201504;678;1915;561;1709;275;859;164;512;439;1371
314050;201504;1817;5668;1444;4912;358;1403;475;1462;833;2865
314053;201504;1507;4874;1369;4712;197;654;948;3424;1145;4078
314055;201504;2131;6472;1931;6180;104;405;1528;4952;1632;5357
314060;201504;1150;3543;921;3146;85;357;578;1945;663;2302
314070;201504;3837;11888;2951;10197;804;3029;708;2333;1512;5362
314080;201504;1898;5850;1258;4351;241;943;276;840;517;1783
314085;201504;1970;6675;1717;6324;504;2059;655;2385;1159;4444
314090;201504;3410;11606;3005;10826;864;3439;1110;4067;1974;7506
314100;201504;3403;8965;2890;8264;254;652;2358;6934;2612;7586
314110;201504;4285;13658;3759;12592;801;3147;1509;4631;2310;7778
314120;201504;1015;2485;535;1697;135;489;142;433;277;922
314130;201504;718;2069;381;1310;64;237;72;243;136;480
314140;201504;5021;15590;4266;14160;942;3375;1862;6147;2804;9522
314150;201504;1643;4491;1342;3989;239;818;685;1997;924;2815
314160;201504;2508;6607;1972;5901;157;520;1488;4651;1645;5171
314170;201504;1104;3342;903;2903;131;503;482;1485;613;1988
314180;201504;5797;18287;5032;17160;1278;4806;2331;8093;3609;12899
314190;201504;743;2166;595;1929;142;565;248;739;390;1304
314200;201504;2995;9487;2628;8826;327;1334;1774;5827;2101;7161
314210;201504;1964;5869;1752;5495;241;898;1105;3316;1346;4214
314220;201504;1724;5451;1367;4743;429;1690;304;910;733;2600
314225;201504;1315;3863;1165;3659;74;219;1007;3227;1081;3446
314230;201504;657;2203;597;2091;148;581;248;836;396;1417
314240;201504;1148;3566;981;3318;148;476;664;2365;812;2841
314250;201504;556;1667;425;1393;95;367;147;421;242;788
314260;201504;1110;3956;1014;3749;294;1189;363;1302;657;2491
314270;201504;2883;9517;2499;8837;269;1085;1725;6160;1994;7245
314280;201504;3223;9020;2214;7082;575;2148;683;1877;1258;4025
314290;201504;4999;13863;4301;12759;1131;3626;2405;7009;3536;10635
314300;201504;1658;5526;1453;5072;410;1538;526;1767;936;3305
314310;201504;5545;16850;4746;15312;1466;5170;1493;4581;2959;9751
314315;201504;899;3488;831;3358;132;628;514;2092;646;2720
314320;201504;3133;8730;2320;7667;665;2459;1130;3770;1795;6229
314330;201504;52796;162378;47071;153218;13425;47803;18661;59953;32086;107756
314340;201504;2758;7595;1563;5197;361;1291;121;255;482;1546
314345;201504;1240;4222;1109;4014;297;1128;621;2267;918;3395
314350;201504;1406;4075;1128;3635;437;1550;307;950;744;2500
314360;201504;708;2221;472;1684;113;483;118;401;231;884
314370;201504;529;1851;488;1785;152;601;256;930;408;1531
314380;201504;1255;3766;874;3026;238;893;155;528;393;1421
314390;201504;14736;42700;11248;36178;2900;10250;2928;8704;5828;18954
314400;201504;4754;13815;3964;12709;1422;4754;1585;5256;3007;10010
314410;201504;2607;8260;2215;7475;632;2484;773;2431;1405;4915
314420;201504;749;2179;602;1977;64;294;430;1359;494;1653
314430;201504;6914;20630;6040;18969;1816;6241;1844;5825;3660;12066
314435;201504;1357;4354;1204;4087;140;605;762;2540;902;3145
314437;201504;1130;2947;971;2716;42;116;817;2292;859;2408
314440;201504;670;1940;505;1698;177;666;90;270;267;936
314450;201504;1596;4650;1354;4311;386;1452;651;1940;1037;3392
314460;201504;4374;14742;3628;13184;984;3979;705;2442;1689;6421
314465;201504;2361;7419;2161;7093;149;631;1668;5375;1817;6006
314467;201504;1106;3094;923;2768;106;311;617;1883;723;2194
314470;201504;2445;7843;1964;6781;471;1900;520;1550;991;3450
314480;201504;6227;20716;4317;15645;707;2799;464;1426;1171;4225
314490;201504;992;2911;788;2509;211;739;317;962;528;1701
314500;201504;2151;6018;1577;5035;437;1502;632;1947;1069;3449
314505;201504;1854;5616;1741;5439;325;1118;1091;3431;1416;4549
314510;201504;1942;5317;1314;4421;447;1656;321;1050;768;2706
314520;201504;3355;12258;2648;10530;665;3014;394;1323;1059;4337
314530;201504;6552;23235;6175;22615;1145;4209;3741;14145;4886;18354
314535;201504;2790;7825;2408;7298;232;805;1855;5603;2087;6408
314537;201504;1246;3880;979;3409;167;700;539;1841;706;2541
314540;201504;418;1273;358;1149;88;326;119;341;207;667
314545;201504;1359;4214;1179;3946;197;758;751;2491;948;3249
314550;201504;628;1738;471;1524;94;398;197;581;291;979
314560;201504;4972;17282;4268;15571;891;3666;1213;4226;2104;7892
314570;201504;302;896;228;742;63;220;102;319;165;539
314580;201504;515;1757;415;1528;108;469;81;269;189;738
314585;201504;849;2786;608;2265;148;634;168;609;316;1243
314587;201504;1865;5832;1640;5433;356;1117;797;2758;1153;3875
314590;201504;3452;11713;2431;8970;436;1779;292;947;728;2726
314600;201504;2040;6832;1600;5979;539;2263;290;1013;829;3276
314610;201504;7403;25487;6711;23896;1743;7021;2605;8715;4348;15736
314620;201504;1753;5092;1532;4810;175;498;1185;3830;1360;4328
314625;201504;1502;5128;1462;5079;149;533;1200;4201;1349;4734
314630;201504;4986;14806;4315;13752;380;1436;3230;10285;3610;11721
314640;201504;604;1673;468;1441;121;419;142;371;263;790
314650;201504;1191;3367;856;2785;164;647;330;966;494;1613
314655;201504;1624;4863;1247;4160;261;910;604;2016;865;2926
314660;201504;257;705;198;594;19;63;103;297;122;360
314670;201504;1587;4348;1255;3776;186;633;761;2290;947;2923
314675;201504;1808;5552;1543;5082;149;597;1060;3470;1209;4067
314690;201504;2541;8014;2103;7262;573;2311;562;1784;1135;4095
314700;201504;8705;30774;6751;26388;2217;9720;1239;4764;3456;14484
314710;201504;9043;27798;6301;21813;1305;5094;926;2905;2231;7999
314720;201504;2356;7755;1979;6971;488;1967;803;2767;1291;4734
314730;201504;2394;7156;1935;6496;584;2198;642;2065;1226;4263
314740;201504;2975;9578;2612;8889;613;2363;1088;3539;1701;5902
314750;201504;335;1067;286;958;48;187;141;453;189;640
314760;201504;1735;5839;1288;4727;247;1069;300;940;547;2009
314770;201504;1210;3785;723;2452;80;334;119;304;199;638
314780;201504;305;807;216;690;61;237;92;280;153;517
314790;201504;12433;36841;9176;31178;3787;14708;1350;4028;5137;18736
314795;201504;1632;4756;1385;4359;134;558;1035;3119;1169;3677
314800;201504;12534;36622;9191;30003;2781;9901;1407;4356;4188;14257
314810;201504;13085;38336;10192;33282;3116;11350;2329;7572;5445;18922
314820;201504;1026;2808;695;2292;194;714;233;728;427;1442
314830;201504;1767;5840;1517;5424;497;1960;607;2194;1104;4154
314840;201504;995;3626;816;3352;188;924;438;1760;626;2684
314850;201504;1966;5795;1600;5129;238;935;982;3033;1220;3968
314860;201504;3289;11087;2969;10552;610;2400;1755;6267;2365;8667
314870;201504;5532;17778;4885;16931;617;2461;3580;12507;4197;14968
314875;201504;1756;5907;1684;5803;326;1094;1246;4394;1572;5488
314880;201504;849;2372;735;2222;57;177;546;1702;603;1879
314890;201504;630;1896;435;1484;99;407;144;432;243;839
314900;201504;479;1467;383;1315;97;350;180;612;277;962
314910;201504;1607;5434;1341;4972;463;1935;380;1297;843;3232
314915;201504;2585;8110;2256;7632;213;861;1718;5738;1931;6599
314920;201504;594;1663;424;1405;74;292;216;662;290;954
314930;201504;5028;16940;4422;15643;1324;5134;1093;3776;2417;8910
314940;201504;404;1192;374;1140;86;291;202;577;288;868
314950;201504;335;1069;269;953;63;245;67;235;130;480
314960;201504;803;2510;622;2149;175;674;160;493;335;1167
314970;201504;503;1702;428;1569;104;437;108;380;212;817
314980;201504;1792;5557;1526;5094;487;1832;182;527;669;2359
314990;201504;2762;8722;2143;7376;635;2525;405;1167;1040;3692
314995;201504;1624;5021;1440;4742;176;699;984;3168;1160;3867
315000;201504;1062;3120;875;2811;149;571;523;1645;672;2216
315010;201504;466;1454;375;1262;105;424;132;381;237;805
315015;201504;2023;6225;1809;5969;249;838;1324;4558;1573;5396
315020;201504;802;2509;606;2073;107;418;290;957;397;1375
315030;201504;763;2287;619;2023;197;703;156;499;353;1202
315040;201504;889;2798;841;2697;155;526;531;1681;686;2207
315050;201504;1502;4351;1197;3854;294;1093;464;1444;758;2537
315053;201504;1081;3238;961;3043;181;721;439;1365;620;2086
315057;201504;1903;6398;1569;5887;286;1091;903;3531;1189;4622
315060;201504;905;2958;668;2434;163;662;149;542;312;1204
315070;201504;751;2238;662;2118;183;657;353;1084;536;1741
315080;201504;3057;10401;2714;9683;637;2506;1330;4692;1967;7198
315090;201504;777;2798;693;2622;162;670;252;973;414;1643
315100;201504;1206;4089;900;3376;221;958;208;701;429;1659
315110;201504;1413;4387;1247;4065;302;1098;554;1775;856;2873
315120;201504;14476;33911;9860;27995;1625;4874;5184;15507;6809;20381
315130;201504;1502;4930;1342;4621;386;1497;406;1337;792;2834
315140;201504;2792;9221;2361;8318;627;2572;779;2440;1406;5012
315150;201504;4963;13424;3715;11348;796;2794;1397;4105;2193;6899
315160;201504;1317;3753;1113;3384;212;702;577;1688;789;2390
315170;201504;1450;4273;1209;3918;213;733;637;2250;850;2983
315180;201504;16209;46715;10201;33967;2106;8052;1974;6043;4080;14095
315190;201504;2161;5791;1824;5293;496;1531;919;2675;1415;4206
315200;201504;4236;14141;3484;12487;1017;4058;900;3067;1917;7125
315210;201504;8141;23920;6515;20697;1611;5675;2234;6816;3845;12491
315213;201504;1105;3588;1048;3513;65;198;919;3145;984;3343
315217;201504;2636;8979;2194;8226;324;1433;1287;4833;1611;6266
315220;201504;9992;29046;8366;26589;2307;7244;4219;14023;6526;21267
315230;201504;2718;7287;2436;6949;211;336;2005;6237;2216;6573
315240;201504;3103;9748;2725;9160;569;2111;1620;5358;2189;7469
315250;201504;9870;30328;7269;25345;1990;7820;2184;7544;4174;15364
315260;201504;987;3112;729;2544;199;779;136;409;335;1188
315270;201504;703;2348;570;2065;135;554;152;500;287;1054
315280;201504;3145;9268;2235;7287;571;2039;480;1362;1051;3401
315290;201504;1376;3885;1028;3323;366;1290;167;521;533;1811
315300;201504;510;1347;365;1170;181;615;117;371;298;986
315310;201504;1279;4162;1087;3810;139;570;699;2374;838;2944
315320;201504;851;2682;687;2465;151;613;326;1213;477;1826
315330;201504;686;2479;433;1795;124;566;43;192;167;758
315340;201504;3986;11452;3271;10347;728;2578;1416;4420;2144;6998
315350;201504;1781;4985;1338;4342;260;879;749;2507;1009;3386
315360;201504;1688;5585;1375;4799;275;1052;461;1491;736;2543
315370;201504;471;1398;402;1294;75;276;261;834;336;1110
315380;201504;218;751;173;643;45;191;37;120;82;311
315390;201504;1408;4855;1144;4243;327;1380;231;786;558;2166
315400;201504;4286;12986;3574;11646;778;2841;1666;5302;2444;8143
315410;201504;1941;5220;1640;4782;242;872;1047;2975;1289;3847
315415;201504;1128;3746;1038;3614;391;1381;446;1630;837;3011
315420;201504;1233;3968;938;3361;254;976;162;562;416;1538
315430;201504;3922;10621;2893;8904;736;2596;747;2179;1483;4775
315440;201504;912;2850;782;2626;141;548;411;1365;552;1913
315445;201504;2123;5977;1721;5405;178;690;1281;3976;1459;4666
315450;201504;2410;7726;2191;7396;478;1550;1358;4792;1836;6342
315460;201504;36358;119544;32297;111112;10629;39334;7209;23775;17838;63109
315470;201504;526;1571;441;1427;58;231;251;785;309;1016
315480;201504;1699;5194;1072;3752;207;824;184;606;391;1430
315490;201504;3136;8557;2472;7624;356;1313;1260;3790;1616;5103
315500;201504;477;1453;313;1069;58;244;111;317;169;561
315510;201504;1447;4113;1234;3785;75;254;944;2900;1019;3154
315520;201504;1113;3317;888;3012;130;511;568;1876;698;2387
315530;201504;559;1925;489;1765;211;817;156;537;367;1354
315540;201504;1198;3695;983;3331;194;805;351;1163;545;1968
315550;201504;1742;4936;1363;4422;452;1666;449;1399;901;3065
315560;201504;6719;22234;6064;21342;682;2743;4302;15268;4984;18011
315570;201504;2105;6611;1948;6373;428;1575;1051;3390;1479;4965
315580;201504;2549;7544;2013;6581;488;1908;706;2124;1194;4032
315590;201504;942;2723;840;2570;145;506;496;1468;641;1974
315600;201504;2564;9079;2094;8214;370;1522;1152;4735;1522;6257
315610;201504;1018;2933;827;2539;164;639;306;789;470;1428
315620;201504;316;1112;299;1082;86;289;162;626;248;915
315630;201504;912;2883;771;2630;188;693;214;703;402;1396
315640;201504;615;1782;500;1583;112;419;221;643;333;1062
315645;201504;864;2720;747;2460;283;1017;186;588;469;1605
315650;201504;1908;5324;1590;4872;105;450;1203;3623;1308;4073
315660;201504;2593;6860;2198;6247;476;1377;1251;3574;1727;4951
315670;201504;10071;33815;8896;31545;2767;10638;2986;10382;5753;21020
315680;201504;3041;10347;2432;9110;914;3592;461;1766;1375;5358
315690;201504;3589;10265;2551;8422;700;2593;589;1976;1289;4569
315700;201504;7305;22892;6206;20709;1194;4578;2992;9580;4186;14158
315710;201504;1973;5681;1573;5055;175;699;958;3021;1133;3720
315720;201504;3417;10726;3016;9990;673;2657;1509;4725;2182;7382
315725;201504;1710;5146;1381;4709;401;1400;704;2454;1105;3854
315727;201504;632;1945;530;1736;122;442;227;720;349;1162
315730;201504;883;2714;799;2564;147;520;467;1481;614;2001
315733;201504;952;2939;858;2760;311;1083;256;781;567;1864
315737;201504;1337;4118;1059;3609;98;393;685;2371;783;2764
315740;201504;1070;3323;903;2994;174;706;474;1479;648;2185
315750;201504;1132;3537;1041;3387;87;335;785;2531;872;2866
315760;201504;1010;2778;972;2730;21;63;910;2563;931;2626
315765;201504;1424;4467;1311;4302;97;350;1048;3473;1145;3823
315770;201504;1611;5196;1429;4844;366;1390;454;1464;820;2854
315780;201504;23439;76527;21316;72033;6260;22759;6294;21093;12554;43852
315790;201504;3460;11701;3068;10907;367;1255;2058;7553;2425;8808
315800;201504;1541;5943;1257;5115;318;1450;256;1000;574;2450
315810;201504;1422;4015;1218;3696;170;527;811;2433;981;2960
315820;201504;2689;9086;2379;8559;747;2763;1058;3932;1805;6695
315830;201504;1245;4201;1060;3785;179;789;307;953;486;1742
315840;201504;833;2178;607;1790;94;309;206;561;300;870
315850;201504;1192;4265;1147;4169;286;1090;512;1810;798;2900
315860;201504;505;1764;393;1540;100;468;74;274;174;742
315870;201504;480;1440;404;1321;114;417;136;403;250;820
315880;201504;1124;3027;932;2786;214;764;363;1013;577;1777
315890;201504;1557;5317;1377;5036;510;1964;621;2281;1131;4245
315895;201504;5099;15757;4623;14820;1079;3890;2048;6344;3127;10234
315900;201504;740;2320;710;2260;100;415;505;1485;605;1900
315910;201504;548;1865;510;1798;173;653;273;938;446;1591
315920;201504;1588;4444;985;3177;239;856;207;581;446;1437
315930;201504;1112;3047;866;2618;219;733;265;777;484;1510
315935;201504;1071;3571;968;3343;273;1033;297;1007;570;2040
315940;201504;670;2121;591;1961;161;609;244;765;405;1374
315950;201504;1169;3585;1063;3400;224;696;668;2185;892;2881
315960;201504;2961;9604;2154;8025;987;4228;111;288;1098;4516
315970;201504;784;2168;615;1930;60;171;454;1495;514;1666
315980;201504;4340;10513;2699;7771;699;2324;697;1684;1396;4008
315990;201504;3996;11725;3410;10797;631;2424;1882;5833;2513;8257
316000;201504;555;1703;479;1595;161;636;174;551;335;1187
316010;201504;552;1879;462;1700;92;411;166;536;258;947
316020;201504;1111;3585;924;3281;152;641;532;1884;684;2525
316030;201504;3565;10303;2631;8702;332;1220;1395;4782;1727;6002
316040;201504;3677;11633;2725;9586;453;1861;404;1079;857;2940
316045;201504;2133;6801;1947;6492;273;861;1393;4861;1666;5722
316050;201504;351;1105;278;988;55;209;158;543;213;752
316060;201504;743;2218;594;1995;95;416;338;1063;433;1479
316070;201504;5929;18982;5127;17163;1260;4752;2122;6758;3382;11510
316080;201504;740;2729;666;2545;161;693;109;433;270;1126
316090;201504;615;1809;410;1355;83;310;104;310;187;620
316095;201504;1426;4561;1237;4222;251;868;732;2553;983;3421
316100;201504;2833;9375;2124;7596;548;2258;383;1234;931;3492
316105;201504;959;2683;718;2287;195;684;267;857;462;1541
316110;201504;12096;41903;10843;39683;1410;5652;7367;27601;8777;33253
316120;201504;1202;3937;986;3402;273;1024;301;951;574;1975
316130;201504;1452;3219;887;2440;144;473;469;1228;613;1701
316140;201504;1062;3109;817;2710;118;421;458;1543;576;1964
316150;201504;1476;4258;1367;4070;268;938;808;2396;1076;3334
316160;201504;1247;3717;970;3179;161;623;452;1453;613;2076
316165;201504;976;2628;809;2382;148;517;488;1416;636;1933
316170;201504;1402;4018;1054;3421;198;728;445;1357;643;2085
316180;201504;1383;4379;992;3511;257;1035;211;644;468;1679
316190;201504;2813;8771;1446;5116;290;1082;189;567;479;1649
316200;201504;4043;12966;3112;11106;763;3144;845;2917;1608;6061
316210;201504;4940;15728;4244;14455;1814;6559;782;2555;2596;9114
316220;201504;750;2325;534;1906;125;531;67;242;192;773
316225;201504;1182;3376;1023;3138;140;513;687;2037;827;2550
316230;201504;459;1303;358;1135;61;212;178;593;239;805
316240;201504;6813;20852;5854;19612;600;2069;4522;15394;5122;17463
316245;201504;3189;11105;2953;10719;231;1111;2336;8345;2567;9456
316250;201504;9924;30097;8267;26746;2619;9288;2379;7264;4998;16552
316255;201504;2584;7892;2270;7503;387;1320;1532;5108;1919;6428
316257;201504;1401;3956;1080;3382;228;799;410;1220;638;2019
316260;201504;1789;5095;1372;4471;158;575;821;2800;979;3375
316265;201504;1323;3683;963;2958;107;414;557;1625;664;2039
316270;201504;4347;14388;3986;13648;1019;3793;1811;6102;2830;9895
316280;201504;3294;10776;2960;10136;521;1994;1705;5826;2226;7820
316290;201504;3228;10236;2763;9338;589;2380;1205;3842;1794;6222
316292;201504;3381;10974;3040;10389;708;2670;1510;4918;2218;7588
316294;201504;870;2806;605;2196;130;568;59;197;189;765
316295;201504;1803;6162;1671;5902;312;1362;958;3149;1270;4511
316300;201504;1014;3127;861;2868;73;261;593;2009;666;2270
316310;201504;679;2044;493;1689;90;354;154;503;244;857
316320;201504;588;1878;476;1692;95;395;106;357;201;752
316330;201504;959;2952;751;2487;105;381;466;1528;571;1909
316340;201504;997;3209;829;2866;223;919;304;950;527;1869
316350;201504;1387;4426;1239;4185;223;766;688;2398;911;3164
316360;201504;746;1949;579;1712;62;195;432;1275;494;1470
316370;201504;4393;14402;3832;13287;1150;4379;754;2595;1904;6974
316380;201504;1561;4252;1261;3830;104;354;898;2744;1002;3098
316390;201504;887;2639;742;2385;216;773;309;997;525;1770
316400;201504;1345;4283;1082;3814;255;975;449;1548;704;2523
316410;201504;1094;3680;1020;3567;193;725;634;2232;827;2957
316420;201504;1891;6297;1693;6032;189;853;1171;4059;1360;4912
316430;201504;924;2836;714;2426;185;706;237;737;422;1443
316440;201504;691;2231;567;2046;216;899;136;467;352;1366
316443;201504;722;2123;591;1873;144;503;228;683;372;1186
316447;201504;1578;4839;1442;4649;100;312;1253;4093;1353;4405
316450;201504;2148;7344;1861;6800;294;1192;1206;4469;1500;5661
316460;201504;749;2358;686;2252;164;606;404;1256;568;1862
316470;201504;7582;24496;5981;21041;1588;6536;1767;5926;3355;12462
316480;201504;218;738;195;699;49;192;62;205;111;397
316490;201504;290;917;260;839;60;209;123;372;183;581
316500;201504;1096;3984;760;2949;148;622;32;117;180;739
316510;201504;845;3092;745;2885;266;1090;167;621;433;1711
316520;201504;1175;3567;969;3267;190;727;371;1115;561;1842
316530;201504;1123;3658;944;3291;228;1000;347;1013;575;2013
316540;201504;1008;3270;908;3103;198;837;360;1134;558;1971
316550;201504;1220;4099;1141;3966;227;889;727;2516;954;3405
316553;201504;1986;7009;1584;6046;469;1966;376;1415;845;3381
316555;201504;2922;10045;2538;9614;205;756;2038;7903;2243;8659
316556;201504;601;1645;480;1435;44;167;348;1006;392;1173
316557;201504;755;2766;721;2716;327;1324;173;594;500;1918
316560;201504;345;1183;297;1087;68;309;71;216;139;525
316570;201504;1369;4347;1200;4004;179;653;626;2087;805;2740
316580;201504;280;813;201;646;53;206;59;170;112;376
316590;201504;1514;4163;1118;3507;184;685;651;1942;835;2627
316600;201504;1001;3219;874;2963;295;1064;252;835;547;1899
316610;201504;597;2154;518;1996;108;466;314;1197;422;1663
316620;201504;2151;6673;1842;6094;367;1397;1038;3335;1405;4732
316630;201504;1554;5143;1336;4673;549;2023;369;1304;918;3327
316640;201504;193;614;168;560;33;141;69;198;102;339
316650;201504;917;3474;808;3299;185;773;443;1911;628;2684
316660;201504;202;518;101;299;11;43;28;66;39;109
316670;201504;1840;5374;1470;4691;568;1986;328;964;896;2950
316680;201504;1894;5247;1550;4761;186;610;1166;3598;1352;4208
316690;201504;1198;4016;1076;3765;340;1362;394;1330;734;2692
316695;201504;1132;3582;985;3296;81;287;684;2329;765;2616
316700;201504;362;1138;327;1078;64;264;179;530;243;794
316710;201504;3415;12931;2985;12001;1044;4470;849;3611;1893;8081
316720;201504;17322;56609;14463;50431;4466;16797;3139;10497;7605;27294
316730;201504;370;1138;320;1033;73;282;171;506;244;788
316740;201504;671;2259;595;2116;204;814;191;638;395;1452
316750;201504;426;1451;374;1338;86;361;129;430;215;791
316760;201504;3419;11507;2933;10911;1702;6418;827;3225;2529;9643
316770;201504;1287;3760;1159;3586;170;608;800;2450;970;3058
316780;201504;598;2030;526;1887;159;652;131;413;290;1065
316790;201504;878;2528;643;2126;176;633;199;657;375;1290
316800;201504;6008;19865;5448;18825;1121;4477;2694;8878;3815;13355
316805;201504;852;2284;801;2215;96;247;651;1877;747;2124
316810;201504;609;1860;518;1687;161;586;226;704;387;1290
316820;201504;389;1023;233;747;60;231;42;121;102;352
316830;201504;602;2082;572;2026;187;734;239;812;426;1546
316840;201504;2994;9075;2617;8392;674;2480;1049;3181;1723;5661
316850;201504;2124;6457;1871;6015;326;1173;1107;3577;1433;4750
316860;201504;18967;60184;16358;55297;4064;15803;6931;22375;10995;38178
316870;201504;6359;20614;5312;18206;1624;6121;942;3048;2566;9169
316880;201504;798;2580;735;2468;234;907;274;863;508;1770
316890;201504;1332;3296;1050;2924;334;1075;514;1343;848;2418
316900;201504;2517;7775;2055;6809;531;2046;710;2124;1241;4170
316905;201504;459;1537;400;1409;144;529;132;463;276;992
316910;201504;760;2514;573;2122;135;525;154;584;289;1109
316920;201504;1693;4952;1348;4450;330;1217;479;1521;809;2738
316930;201504;8962;30587;7301;26902;1844;7593;1205;4061;3049;11654
316935;201504;5004;14703;3329;11314;915;3557;628;1922;1543;5479
316940;201504;7113;23456;5890;20853;1456;5659;1426;4809;2882;10468
316950;201504;1480;4336;1309;4091;147;565;925;2870;1072;3435
316960;201504;5129;12950;4087;11617;778;2438;2350;6632;3128;9070
316970;201504;3426;10956;3222;10639;943;3584;1128;3435;2071;7019
316980;201504;1059;3151;762;2641;301;1170;181;629;482;1799
316990;201504;9524;30908;8098;27616;2861;10675;860;2778;3721;13453
317000;201504;2781;9528;2686;9422;151;455;2175;8458;2326;8913
317005;201504;2540;7920;2285;7567;396;1307;1471;4987;1867;6294
317010;201504;30864;77845;19041;58876;4881;17013;4314;13801;9195;30814
317020;201504;57030;161356;35303;116158;7994;29192;8059;24591;16053;53783
317030;201504;809;2297;658;2060;81;320;401;1217;482;1537
317040;201504;10373;30482;8423;26975;2257;7930;3317;10535;5574;18465
317043;201504;756;2138;671;2034;96;279;464;1446;560;1725
317047;201504;1167;3071;852;2552;135;467;400;1184;535;1651
317050;201504;1564;5386;1245;4628;256;1094;535;1871;791;2965
317052;201504;2460;7811;2165;7369;194;781;1656;5610;1850;6391
317057;201504;1752;4926;1350;4227;153;593;767;2317;920;2910
317060;201504;401;1184;294;941;64;249;94;261;158;510
317065;201504;1244;4156;1130;3970;132;549;867;3018;999;3567
317070;201504;9591;30345;6800;24039;1632;6515;1239;4368;2871;10883
317075;201504;1136;3458;944;3089;268;978;311;937;579;1915
317080;201504;6235;17434;5365;15960;1545;4912;1905;5495;3450;10407
317090;201504;4940;16516;4590;15935;670;2370;3198;11331;3868;13701
317100;201504;3163;8925;2502;7794;767;2660;951;2789;1718;5449
317103;201504;2037;7077;1720;6434;331;1536;806;2932;1137;4468
317107;201504;1370;4208;1167;3788;220;853;674;2041;894;2894
317110;201504;668;1702;404;1228;82;308;168;470;250;778
317115;201504;1162;3679;1003;3345;151;517;637;2155;788;2672
317120;201504;11507;38249;9441;33334;2492;9837;3360;11447;5852;21284
317130;201504;7761;23543;6666;21604;1462;5413;3063;9754;4525;15167
317140;201504;609;2069;579;2011;64;240;410;1441;474;1681
317150;201504;1009;2826;871;2667;85;313;639;1923;724;2236
317160;201504;3518;9478;2692;8390;269;951;1915;5937;2184;6888
317170;201504;1809;5079;1517;4610;95;395;1011;2898;1106;3293
317180;201504;1880;6283;1498;5455;409;1604;415;1459;824;3063
317190;201504;1398;4020;1139;3667;135;452;806;2606;941;3058
317200;201504;4653;14795;4084;13661;1148;4268;1355;4321;2503;8589
317210;201504;1067;3231;881;2972;189;751;476;1590;665;2341
317220;201504;310;1093;299;1080;84;316;171;629;255;945
320010;201504;5473;17174;4774;15660;871;3034;2387;7839;3258;10873
320013;201504;2047;6018;1433;4831;218;771;704;2443;922;3214
320016;201504;3309;9345;2857;8682;411;1199;2014;6224;2425;7423
320020;201504;3954;12330;3406;11233;1043;3776;1212;3929;2255;7705
320030;201504;1621;5190;1299;4474;400;1469;439;1458;839;2927
320035;201504;1812;5374;1611;5075;427;1525;832;2472;1259;3997
320040;201504;3240;10684;2610;9231;636;2474;716;2436;1352;4910
320050;201504;1816;4950;1564;4497;285;908;880;2434;1165;3342
320060;201504;12248;38627;9466;32272;2305;8644;2953;9469;5258;18113
320070;201504;1579;5130;1298;4464;325;1257;308;912;633;2169
320080;201504;5360;15429;4137;12942;1190;3967;1180;3650;2370;7617
320090;201504;8501;24712;6702;21102;1817;6132;2739;8276;4556;14408
320100;201504;3091;9343;2509;8202;590;2052;1161;3737;1751;5789
320110;201504;1390;4178;1235;3884;299;984;453;1402;752;2386
320115;201504;1823;6485;1654;6170;865;3381;462;1741;1327;5122
320120;201504;16425;51391;13122;44880;3806;14215;3766;12907;7572;27122
320130;201504;36945;119449;33660;112673;7787;29240;15566;50224;23353;79464
320140;201504;4126;13108;2918;10272;728;2858;292;934;1020;3792
320150;201504;17199;47516;12364;38366;3221;10979;2076;6174;5297;17153
320160;201504;5126;15857;4392;14494;1138;4255;1638;4969;2776;9224
320170;201504;1734;5623;1419;4907;408;1501;493;1710;901;3211
320180;201504;819;2678;716;2505;303;1108;215;765;518;1873
320190;201504;3862;13173;3060;11215;901;3520;855;3067;1756;6587
320200;201504;1085;3409;928;3127;234;847;381;1324;615;2171
320210;201504;5141;14339;4436;13055;955;3233;2284;6342;3239;9575
320220;201504;2841;8502;2201;7364;591;2178;851;2875;1442;5053
320225;201504;1496;5154;1223;4482;428;1693;234;876;662;2569
320230;201504;4276;13970;3769;13117;1276;4784;1300;4571;2576;9355
320240;201504;11780;34967;9145;30059;2588;9268;2356;7702;4944;16970
320245;201504;3872;13152;3590;12487;1176;4391;1146;3813;2322;8204
320250;201504;1766;5417;1262;4249;313;1194;264;780;577;1974
320255;201504;1879;6243;1602;5770;636;2483;589;2201;1225;4684
320260;201504;1073;3308;824;2710;212;773;209;571;421;1344
320265;201504;2518;7808;2190;7381;375;1316;1463;5086;1838;6402
320270;201504;2754;8278;2060;6887;497;1809;876;2876;1373;4685
320280;201504;7027;21353;6250;19863;1415;5016;2798;8495;4213;13511
320290;201504;1503;4915;1119;3948;374;1388;212;718;586;2106
320300;201504;4545;15172;4088;14162;1291;4778;1144;3910;2435;8688
320305;201504;4516;14586;3996;13404;981;3613;1837;5972;2818;9585
320310;201504;1999;5984;1721;5445;442;1499;720;2215;1162;3714
320313;201504;2298;6802;1597;5179;382;1472;285;789;667;2261
320316;201504;1909;5796;1595;5151;499;1700;630;1956;1129;3656
320320;201504;19836;62082;16260;55269;4602;17307;5769;19146;10371;36453
320330;201504;3221;9569;2777;8832;583;1802;1548;5168;2131;6970
320332;201504;4996;16832;4429;15780;1550;5869;1531;5547;3081;11416
320334;201504;1777;5763;1264;4609;390;1590;241;808;631;2398
320335;201504;2346;6923;1523;5046;432;1594;262;769;694;2363
320340;201504;5862;16052;4719;14102;1064;3481;2107;6253;3171;9734
320350;201504;5364;14305;4015;11856;922;2950;1544;4473;2466;7423
320360;201504;1748;4624;1282;3718;226;729;577;1547;803;2276
320370;201504;3331;10760;2703;9374;807;2905;959;3272;1766;6177
320380;201504;2498;7353;2196;6812;333;1175;1390;4212;1723;5387
320390;201504;7529;22682;6141;19807;1923;6872;1798;5394;3721;12266
320400;201504;4087;11850;3391;10799;1002;3594;1335;3920;2337;7514
320405;201504;3910;11532;3497;10943;1003;3431;1830;5562;2833;8993
320410;201504;5719;14733;4211;12838;935;3054;2224;6790;3159;9844
320420;201504;1711;5268;1254;4444;385;1495;225;795;610;2290
320425;201504;2064;5492;1748;4985;258;824;1077;3019;1335;3843
320430;201504;2309;6602;2031;6061;451;1457;1067;3081;1518;4538
320435;201504;2725;9089;2320;8251;1079;3999;674;2530;1753;6529
320440;201504;1218;4054;1079;3681;270;1033;381;1216;651;2249
320450;201504;2065;6459;1700;5713;482;1789;730;2344;1212;4133
320455;201504;4426;14833;3222;11815;975;3812;800;2866;1775;6678
320460;201504;2956;9342;2280;7925;606;2312;770;2543;1376;4855
320465;201504;1690;5288;1322;4443;288;1059;505;1629;793;2688
320470;201504;4434;13518;3109;10478;888;3285;482;1435;1370;4720
320480;201504;2025;6072;1703;5466;425;1571;681;2080;1106;3651
320490;201504;16099;49924;13362;44592;4279;15472;3887;13033;8166;28505
320495;201504;1204;3710;878;2972;336;1186;126;466;462;1652
320500;201504;46425;142040;40253;130563;10781;38155;18409;58331;29190;96486
320501;201504;4282;13559;3770;12760;1179;4489;1545;5053;2724;9542
320503;201504;1879;6392;1527;5596;536;2167;407;1305;943;3472
320506;201504;3707;11637;2524;8675;787;2880;209;642;996;3522
320510;201504;8250;25863;7049;23439;1904;6924;2994;9700;4898;16624
320515;201504;2067;5871;1721;5156;467;1460;517;1479;984;2939
320517;201504;2207;7125;1789;6254;668;2550;389;1246;1057;3796
320520;201504;35066;107425;28822;95435;8175;29999;10671;34807;18846;64806
320530;201504;28433;86670;23667;77378;5407;20491;10981;33694;16388;54185
330010;201504;19791;60879;17977;57296;3457;12248;10581;32853;14038;45101
330015;201504;1817;5054;1555;4577;283;985;641;1800;924;2785
330020;201504;17029;50311;15548;47957;3217;10895;9074;27445;12291;38340
330022;201504;1741;5388;1509;5005;285;1121;831;2656;1116;3777
330023;201504;3172;10134;2921;9633;778;2815;1099;3418;1877;6233
330025;201504;4034;11182;3336;10117;779;2619;1856;5507;2635;8126
330030;201504;8171;27439;7219;25453;1762;6947;3280;11022;5042;17969
330040;201504;12840;37012;11022;33877;2599;8610;5524;16519;8123;25129
330045;201504;67094;188833;59822;178292;7675;24854;41751;123165;49426;148019
330050;201504;2672;8355;2371;7761;747;2754;709;2125;1456;4879
330060;201504;5675;16672;4985;15657;1166;4130;2778;8758;3944;12888
330070;201504;23489;71430;20880;66881;4893;17131;9737;30854;14630;47985
330080;201504;8350;23797;7816;22996;1135;3325;5362;16011;6497;19336
330090;201504;2762;7603;2527;7212;502;1604;1374;3817;1876;5421
330093;201504;2020;5975;1671;5297;379;1270;614;1927;993;3197
330095;201504;1075;3640;960;3390;310;1259;202;627;512;1886
330100;201504;55383;177779;50510;169413;9806;36958;26942;90667;36748;127625
330110;201504;2399;7635;2159;7199;589;2186;742;2412;1331;4598
330115;201504;2131;6196;1922;5859;432;1502;989;2908;1421;4410
330120;201504;2453;7000;2193;6637;611;2059;1070;3114;1681;5173
330130;201504;3639;11764;3231;11023;885;3297;1451;4871;2336;8168
330140;201504;3117;9652;2827;9220;700;2506;1445;4719;2145;7225
330150;201504;2575;7581;1983;6383;459;1624;471;1471;930;3095
330160;201504;1168;3939;1063;3741;335;1322;417;1394;752;2716
330170;201504;108659;327467;100991;315511;16557;55570;67102;209227;83659;264797
330180;201504;1927;5783;1664;5296;185;759;1067;3197;1252;3956
330185;201504;7741;24451;6858;22732;1584;5702;3578;11708;5162;17410
330187;201504;3865;11144;3344;10285;486;1728;2269;6833;2755;8561
330190;201504;26745;77332;24987;74511;5059;15969;15703;46383;20762;62352
330200;201504;13743;43746;12333;41197;2930;10175;6454;21820;9384;31995
330205;201504;2428;6575;2108;6035;436;1418;1138;3146;1574;4564
330210;201504;4365;11588;3300;9634;956;3005;811;2318;1767;5323
330220;201504;10430;32068;9250;29527;2626;9172;2676;7947;5302;17119
330225;201504;3977;12479;3717;12092;353;1375;2809;9286;3162;10661
330227;201504;18202;51663;16260;48826;4171;13151;8565;25652;12736;38803
330230;201504;1436;4280;1302;4047;337;1185;547;1589;884;2774
330240;201504;17588;55099;15370;50699;5502;19834;3171;9877;8673;29711
330245;201504;1275;3978;1039;3529;276;1024;238;805;514;1829
330250;201504;35931;105120;32901;100079;9695;30127;14712;45517;24407;75644
330260;201504;3715;11645;3236;10643;670;2493;1428;4386;2098;6879
330270;201504;14968;40724;11821;36119;3307;10965;4316;13113;7623;24078
330280;201504;2116;6462;1789;5799;338;1222;821;2481;1159;3703
330285;201504;18647;54110;16970;51705;2997;9899;10910;33111;13907;43010
330290;201504;3574;9959;3164;9370;563;1925;1949;5556;2512;7481
330300;201504;3534;11494;3246;10985;517;1998;1961;6538;2478;8536
330310;201504;2454;7012;2164;6522;394;1256;1190;3552;1584;4808
330320;201504;13759;41046;12905;39759;2038;6869;9125;27925;11163;34794
330330;201504;28990;81784;25973;77031;4638;15448;16400;47410;21038;62858
330340;201504;14433;43065;11515;37481;3305;11485;3346;10763;6651;22248
330350;201504;88537;271017;83580;263672;12871;41755;60519;192333;73390;234088
330360;201504;5641;17235;5490;17024;388;1336;4713;14579;5101;15915
330370;201504;3592;12891;3304;12261;1197;4698;1089;4063;2286;8761
330380;201504;4862;15669;4158;14323;954;3621;1934;6502;2888;10123
330385;201504;4088;14110;3772;13494;1240;4732;1435;5091;2675;9823
330390;201504;23049;76520;20718;71806;4886;18907;9905;33513;14791;52420
330395;201504;3007;8900;2737;8443;313;1164;1858;5583;2171;6747
330400;201504;2469;8025;2244;7623;376;1548;1282;4031;1658;5579
330410;201504;2931;9192;2500;8371;483;1757;1301;4340;1784;6097
330411;201504;2335;7300;2033;6654;290;1178;1161;3579;1451;4757
330412;201504;1345;4574;1093;4091;262;1132;431;1511;693;2643
330414;201504;26147;73078;22478;68182;4010;12437;14397;44096;18407;56533
330415;201504;3629;11109;3155;10264;838;2863;1312;4305;2150;7168
330420;201504;9491;28388;6651;22860;1752;6588;1115;3716;2867;10304
330430;201504;7815;23117;7037;21721;1546;5240;3584;10841;5130;16081
330440;201504;1948;6511;1654;5891;532;2145;362;1125;894;3270
330450;201504;1418;4765;1288;4539;332;1386;658;2250;990;3636
330452;201504;13009;38706;10338;33441;2792;9970;3714;11517;6506;21487
330455;201504;479840;1354068;402512;1230932;99128;322728;198962;605026;298090;927754
330460;201504;1285;4209;1163;4001;263;1062;574;1927;837;2989
330470;201504;4410;13590;3944;12719;1082;3885;1631;5055;2713;8940
330475;201504;8034;25074;7150;23563;2059;7468;3054;9935;5113;17403
330480;201504;6024;17874;5500;17104;1260;4279;2886;8822;4146;13101
330490;201504;103675;281062;94831;268430;9517;27999;74167;211484;83684;239483
330500;201504;5503;17136;5229;16631;688;2463;3656;11479;4344;13942
330510;201504;38657;120948;35493;115894;10927;36480;17179;57208;28106;93688
330513;201504;1533;4577;1394;4329;447;1404;554;1758;1001;3162
330515;201504;3003;9376;2683;8780;826;2847;925;2987;1751;5834
330520;201504;11894;35358;10637;33154;2326;7765;5337;16506;7663;24271
330530;201504;1536;4619;1366;4297;351;1199;590;1810;941;3009
330540;201504;3151;9389;2682;8577;669;2338;1123;3479;1792;5817
330550;201504;8249;27494;7237;25630;3150;11782;1421;4994;4571;16776
330555;201504;10459;31124;9338;29510;1767;5741;5855;18911;7622;24652
330560;201504;4273;13012;3935;12415;816;2902;2075;6319;2891;9221
330570;201504;3714;10718;3178;9854;815;2619;1606;5048;2421;7667
330575;201504;5358;15526;4785;14555;848;2939;3004;8757;3852;11696
330580;201504;15305;48208;13101;43722;3600;12781;5117;17196;8717;29977
330590;201504;1747;5331;1621;5116;345;1175;977;3050;1322;4225
330600;201504;10803;30912;8685;27511;1243;4729;4999;15366;6242;20095
330610;201504;9156;29043;8416;27695;1693;6322;4643;15094;6336;21416
330615;201504;1676;5918;1520;5553;667;2572;391;1488;1058;4060
330620;201504;3762;13007;3420;12376;1209;4746;930;3439;2139;8185
330630;201504;22449;67633;18683;60807;3850;14345;9624;29916;13474;44261
350010;201504;2255;6771;1605;5442;409;1532;276;806;685;2338
350020;201504;506;1354;350;1057;71;243;171;490;242;733
350030;201504;4330;13598;3422;11679;1282;4836;755;2306;2037;7142
350040;201504;515;1773;404;1510;105;442;100;320;205;762
350050;201504;1128;3444;912;3044;206;795;318;977;524;1772
350055;201504;603;1863;554;1781;127;467;316;967;443;1434
350060;201504;101;325;85;296;27;110;32;99;59;209
350070;201504;3005;9532;2164;7647;498;1942;397;1215;895;3157
350075;201504;537;1811;443;1645;136;557;116;394;252;951
350080;201504;562;1587;409;1295;74;263;175;543;249;806
350090;201504;558;1546;400;1269;86;297;125;360;211;657
350100;201504;1933;6175;1409;5036;362;1445;368;1211;730;2656
350110;201504;469;1396;351;1129;57;210;157;468;214;678
350115;201504;1292;4048;1143;3708;230;890;587;1704;817;2594
350120;201504;586;1559;290;912;61;210;47;137;108;347
350130;201504;3388;10033;3038;9353;552;1960;1566;4485;2118;6445
350140;201504;623;1995;544;1854;115;459;242;784;357;1243
350150;201504;399;1345;358;1254;128;478;96;332;224;810
350160;201504;6961;21471;5209;17721;1450;5525;1980;6105;3430;11630
350170;201504;1825;6309;1592;5740;465;1819;382;1283;847;3102
350180;201504;1250;3352;883;2594;199;596;383;1091;582;1687
350190;201504;3220;10214;2704;9199;616;2546;1409;4383;2025;6929
350200;201504;313;1022;276;958;62;239;113;392;175;631
350210;201504;6396;16970;4632;14017;1332;4519;1627;4641;2959;9160
350220;201504;2666;8361;2388;7869;699;2705;866;2554;1565;5259
350230;201504;722;2410;667;2318;182;704;258;886;440;1590
350240;201504;438;1380;408;1329;78;282;267;838;345;1120
350250;201504;2228;8119;2118;7903;797;3194;761;2793;1558;5987
350260;201504;1005;2669;717;2168;133;431;335;983;468;1414
350270;201504;5221;15983;4513;14488;883;3018;2092;6617;2975;9635
350275;201504;1970;6525;1761;6173;477;1836;654;2145;1131;3981
350280;201504;21803;55007;13797;40987;3098;9959;3160;9247;6258;19206
350290;201504;1558;5125;1254;4470;299;1176;301;1012;600;2188
350300;201504;414;1262;362;1165;72;243;182;573;254;816
350310;201504;900;2992;795;2747;140;548;365;1224;505;1772
350315;201504;548;1698;440;1472;74;320;142;428;216;748
350320;201504;12195;38207;10547;34871;2957;10424;1574;5290;4531;15714
350330;201504;13668;39298;9157;28625;1955;6292;3185;9342;5140;15634
350335;201504;349;1090;310;1012;49;154;180;601;229;755
350340;201504;1118;3359;807;2747;183;720;261;824;444;1544
350350;201504;772;2438;675;2279;152;610;250;841;402;1451
350360;201504;779;2648;660;2393;184;701;232;863;416;1564
350370;201504;716;2170;524;1734;102;373;101;291;203;664
350380;201504;3462;10755;2725;9533;930;3606;684;2176;1614;5782
350390;201504;8664;27295;7671;25451;2204;7711;3227;10436;5431;18147
350395;201504;330;948;183;643;32;130;42;139;74;269
350400;201504;7696;21937;6172;19193;1465;5109;2497;7391;3962;12500
350410;201504;7776;26995;6314;23725;1859;7737;1227;4336;3086;12073
350420;201504;578;1689;398;1358;87;361;45;112;132;473
350430;201504;752;2362;616;2114;137;559;299;981;436;1540
350440;201504;1261;3990;1161;3799;321;1119;570;1807;891;2926
350450;201504;7615;22698;5893;19293;1511;5369;1469;4495;2980;9864
350460;201504;1415;3993;953;3036;216;774;286;806;502;1580
350470;201504;252;689;204;608;41;150;106;289;147;439
350480;201504;799;2463;545;1882;81;306;88;259;169;565
350490;201504;2067;6028;1765;5603;475;1738;770;2258;1245;3996
350500;201504;581;1709;500;1587;122;414;217;663;339;1077
350510;201504;1015;3157;795;2656;158;622;296;890;454;1512
350520;201504;1003;3672;797;3211;210;974;170;611;380;1585
350530;201504;2439;7224;1991;6289;624;2136;548;1566;1172;3702
350535;201504;1376;4235;1296;4087;84;353;1048;3226;1132;3579
350540;201504;1957;5473;1578;4797;447;1465;556;1664;1003;3129
350550;201504;11875;32000;8207;25844;1766;6350;3085;9257;4851;15607
350560;201504;3514;11561;3171;10862;538;1983;1678;5821;2216;7804
350570;201504;19149;64600;17254;60394;5141;19418;6333;21230;11474;40648
350580;201504;1707;5340;1233;4247;271;1036;178;518;449;1554
350590;201504;4046;12538;3040;10457;832;3203;1009;3137;1841;6340
350600;201504;40303;99415;27130;77665;4429;13896;13395;36708;17824;50604
350610;201504;8078;23320;6253;20140;1354;4977;2828;8748;4182;13725
350620;201504;419;1199;325;1056;68;267;158;478;226;745
350630;201504;1681;5035;1304;4307;332;1282;308;878;640;2160
350635;201504;5539;16960;4283;14618;1117;4079;1617;5490;2734;9569
350640;201504;644;2062;497;1690;111;407;130;414;241;821
350650;201504;6894;21036;3793;13386;961;3757;346;1210;1307;4967
350660;201504;4124;12689;3573;11744;796;2890;1909;6135;2705;9025
350670;201504;1805;5592;1680;5353;329;1156;1031;3175;1360;4331
350680;201504;1155;3545;914;3051;223;892;379;1219;602;2111
350690;201504;921;3025;754;2687;193;759;234;775;427;1534
350700;201504;2834;9616;2481;8835;951;3657;798;2570;1749;6227
350710;201504;2427;7630;2186;7238;314;1150;1459;4792;1773;5942
350715;201504;879;2685;779;2510;237;873;277;791;514;1664
350720;201504;143;431;130;408;37;128;48;137;85;265
350730;201504;429;1591;409;1538;119;490;148;535;267;1025
350740;201504;2036;6316;1645;5428;341;1262;709;2184;1050;3446
350745;201504;383;1165;292;955;47;180;140;409;187;589
350750;201504;10193;30714;7889;26119;1973;7240;1910;5863;3883;13103
350760;201504;12414;37663;10561;34225;2782;10057;4302;13170;7084;23227
350770;201504;759;2145;512;1658;79;293;230;709;309;1002
350775;201504;544;1525;450;1374;79;287;252;735;331;1022
350780;201504;2177;6610;1646;5517;472;1735;226;715;698;2450
350790;201504;2006;6330;1527;5361;428;1641;355;1093;783;2734
350800;201504;3040;10115;2854;9803;500;1991;1801;6043;2301;8034
350810;201504;2215;6371;1810;5716;565;1931;644;1977;1209;3908
350820;201504;561;1508;407;1200;75;269;179;475;254;744
350830;201504;903;2810;630;2171;91;342;138;392;229;734
350840;201504;2368;8396;1947;7359;588;2460;361;1145;949;3605
350850;201504;6415;21331;5333;18887;1734;6505;1251;4253;2985;10758
350860;201504;3172;10025;3038;9835;281;1113;2427;7791;2708;8904
350870;201504;2541;8254;2170;7677;583;2289;1245;4428;1828;6717
350880;201504;1370;4510;1140;4029;298;1132;257;893;555;2025
350890;201504;656;1878;451;1440;81;311;106;259;187;570
350900;201504;4477;14906;3591;12867;976;3816;701;2312;1677;6128
350910;201504;831;2490;736;2298;256;853;262;769;518;1622
350920;201504;9837;28539;8948;27008;1334;4431;6068;17799;7402;22230
350925;201504;4677;14303;3914;12763;995;3516;1603;4835;2598;8351
350930;201504;1602;4358;1309;3857;144;497;913;2614;1057;3111
350940;201504;2097;6895;1920;6620;360;1480;1192;3959;1552;5439
350945;201504;857;2823;744;2587;130;541;369;1197;499;1738
350950;201504;67299;208304;54989;183113;13818;50712;22173;70623;35991;121335
350960;201504;4751;16081;4086;14663;708;2973;2354;8085;3062;11058
350970;201504;4381;15242;3744;13718;1230;4924;925;3049;2155;7973
350980;201504;602;1983;541;1878;228;845;181;629;409;1474
350990;201504;1740;5989;1499;5517;497;1975;409;1443;906;3418
350995;201504;798;2746;760;2673;126;566;465;1547;591;2113
351000;201504;3420;10207;2893;9201;393;1426;1565;4808;1958;6234
351010;201504;378;1105;257;843;84;309;78;254;162;563
351015;201504;865;2879;743;2654;217;859;310;1086;527;1945
351020;201504;7933;25299;6953;23777;1778;6539;3332;11507;5110;18046
351030;201504;1615;5793;1476;5476;360;1566;545;1880;905;3446
351040;201504;3386;10418;3098;9915;531;1992;1962;6006;2493;7998
351050;201504;11218;34218;8523;29110;2482;9331;2617;8737;5099;18068
351060;201504;33478;100751;27364;89380;6884;24615;11046;35067;17930;59682
351070;201504;1702;4756;1181;3824;358;1278;194;510;552;1788
351080;201504;2734;8011;2125;7245;553;2128;976;3207;1529;5335
351090;201504;389;1322;310;1161;71;307;70;258;141;565
351100;201504;1880;5799;1524;5085;471;1629;501;1727;972;3356
351110;201504;8079;20490;4446;14276;1071;3890;1075;3150;2146;7040
351120;201504;614;1788;496;1548;67;244;259;715;326;959
351130;201504;969;2719;528;1802;90;360;103;311;193;671
351140;201504;1774;6144;1594;5747;526;2130;459;1558;985;3688
351150;201504;1815;6183;1359;4995;274;1124;312;991;586;2115
351160;201504;1380;4728;1233;4401;335;1343;447;1504;782;2847
351170;201504;1541;4995;1246;4330;264;990;535;1734;799;2724
351190;201504;771;2466;632;2126;135;481;136;419;271;900
351200;201504;2227;6536;1858;5807;411;1475;681;1921;1092;3396
351210;201504;1038;3133;809;2660;196;737;277;811;473;1548
351220;201504;3203;10720;2831;9954;596;2349;1383;4770;1979;7119
351230;201504;1758;5577;1523;5163;310;1237;875;2879;1185;4116
351240;201504;1058;3357;779;2723;210;810;188;566;398;1376
351250;201504;917;2618;648;2067;135;468;250;754;385;1222
351260;201504;957;2784;838;2532;184;622;359;1015;543;1637
351270;201504;375;1300;339;1231;89;375;136;444;225;819
351280;201504;5298;15682;3966;12807;933;3198;1327;3958;2260;7156
351290;201504;1037;2993;796;2515;194;640;300;893;494;1533
351300;201504;11685;39401;8997;33436;2424;9921;2841;10381;5265;20302
351310;201504;3255;9967;2659;8891;525;2101;1305;4028;1830;6129
351320;201504;916;3126;793;2852;215;880;220;672;435;1552
351330;201504;292;815;245;735;104;315;58;170;162;485
351340;201504;6076;20445;5333;18953;1491;5718;2257;7931;3748;13649
351350;201504;7127;23067;6192;21076;1863;6692;1978;6339;3841;13031
351360;201504;4180;13082;3852;12468;938;3378;1647;5069;2585;8447
351370;201504;2283;7120;1830;6191;484;1847;631;1966;1115;3813
351380;201504;36460;109045;33178;102825;6753;22970;15213;45577;21966;68547
351385;201504;192;603;179;578;39;133;95;293;134;426
351390;201504;1175;3816;997;3453;306;1210;380;1179;686;2389
351400;201504;957;3154;893;3003;353;1235;309;1042;662;2277
351410;201504;2777;8393;2462;7844;445;1529;1411;4352;1856;5881
351420;201504;394;1137;267;882;61;217;63;199;124;416
351430;201504;840;2630;766;2504;80;272;582;1915;662;2187
351440;201504;3887;11513;3031;9648;835;2789;592;1658;1427;4447
351450;201504;1598;4471;1345;4126;352;1137;620;1984;972;3121
351460;201504;788;2408;665;2192;314;1080;189;600;503;1680
351470;201504;1066;3197;936;2943;271;945;344;1044;615;1989
351480;201504;2812;9191;2564;8779;513;2177;1338;4342;1851;6519
351490;201504;1900;6345;1692;5900;245;1054;1004;3332;1249;4386
351492;201504;203;639;152;517;25;99;73;237;98;336
351495;201504;148;485;118;407;31;121;35;110;66;231
351500;201504;22144;65505;17585;56798;4926;17546;6802;20999;11728;38545
351510;201504;8230;26253;6927;23614;1704;6311;3352;11259;5056;17570
351512;201504;422;1219;346;1074;60;193;194;618;254;811
351515;201504;2340;7331;1727;6013;459;1708;477;1546;936;3254
351518;201504;1929;6181;1330;5063;349;1508;316;1102;665;2610
351519;201504;817;2441;641;2084;132;521;249;676;381;1197
351520;201504;816;2243;416;1460;67;272;63;199;130;471
351530;201504;381;1160;289;956;40;143;95;271;135;414
351535;201504;2351;6150;1877;5480;189;656;1306;3744;1495;4400
351540;201504;1810;5582;1502;5018;539;1992;256;798;795;2790
351550;201504;4640;13547;3350;10944;760;2865;1189;3722;1949;6587
351560;201504;401;1257;341;1124;80;303;64;200;144;503
351565;201504;209;693;191;646;47;191;84;258;131;449
351570;201504;11630;36272;10016;33024;2481;8849;5122;16439;7603;25288
351580;201504;361;978;238;720;55;166;71;203;126;369
351590;201504;431;1185;326;988;59;206;109;299;168;505
351600;201504;1673;4593;1479;4294;226;768;803;2201;1029;2969
351610;201504;660;1808;506;1537;65;238;234;652;299;890
351620;201504;18941;60893;14520;51736;3455;13726;3526;11029;6981;24755
351630;201504;17859;57915;16357;55440;3862;13791;9448;31995;13310;45786
351640;201504;9635;30265;8062;27478;1673;6291;4332;14514;6005;20805
351650;201504;424;1260;212;708;47;166;34;104;81;270
351660;201504;756;2373;561;1889;131;462;154;467;285;929
351670;201504;3966;12270;3270;10774;591;2287;1591;4884;2182;7171
351680;201504;694;2110;444;1502;91;321;91;297;182;618
351685;201504;446;1325;363;1183;92;310;160;525;252;835
351690;201504;1082;3157;734;2357;149;534;193;517;342;1051
351700;201504;1262;3648;1105;3358;312;959;452;1363;764;2322
351710;201504;661;2140;547;1894;114;407;193;617;307;1024
351720;201504;1653;5047;1144;3787;217;773;377;1119;594;1892
351730;201504;1020;2929;827;2666;300;1115;287;867;587;1982
351740;201504;4027;11020;3223;9438;703;2199;1142;3166;1845;5365
351750;201504;1218;3901;895;3131;225;904;297;937;522;1841
351760;201504;3778;11870;3185;10569;860;3052;1186;3715;2046;6767
351770;201504;2306;7144;1931;6504;542;1952;914;2967;1456;4919
351780;201504;1550;4335;931;2957;190;657;242;720;432;1377
351790;201504;1079;3222;947;3027;315;1039;412;1326;727;2365
351800;201504;421;948;309;795;42;115;170;428;212;543
351810;201504;1088;3131;997;3016;186;636;695;2069;881;2705
351820;201504;2108;6671;1671;5842;527;1950;188;625;715;2575
351830;201504;4080;12866;3216;10855;585;2224;1568;5015;2153;7239
351840;201504;7474;24930;6494;23006;1867;7152;2301;7937;4168;15089
351850;201504;1603;4765;1228;4054;227;919;516;1510;743;2429
351860;201504;3387;10801;2998;10009;830;3008;1301;4112;2131;7120
351870;201504;30924;93822;26920;86592;6846;23616;13358;42427;20204;66043
351880;201504;108785;347392;94605;317871;28228;100636;28772;94410;57000;195046
351885;201504;550;1975;511;1889;145;568;237;840;382;1408
351890;201504;694;2087;535;1750;124;442;133;397;257;839
351900;201504;1299;3969;1112;3674;305;1079;399;1307;704;2386
351905;201504;453;1483;384;1366;67;297;216;723;283;1020
351907;201504;16574;50194;14033;45520;2331;8846;8077;25204;10408;34050
351910;201504;976;3010;881;2856;187;710;434;1329;621;2039
351920;201504;1055;2908;931;2714;139;481;598;1680;737;2161
351925;201504;926;2833;820;2630;124;465;449;1332;573;1797
351930;201504;2729;8964;2549;8605;578;2375;1500;4626;2078;7001
351940;201504;919;2701;813;2520;172;571;486;1465;658;2036
351950;201504;1416;3885;1016;3138;143;479;538;1610;681;2089
351960;201504;4163;12262;3094;10321;786;2896;1332;4295;2118;7191
351970;201504;5530;20108;4907;18823;1557;6407;1686;6326;3243;12733
351980;201504;908;2691;703;2294;142;532;291;811;433;1343
351990;201504;1544;4376;1228;3770;302;1097;298;770;600;1867
352000;201504;2341;7547;2133;7138;526;1919;986;3114;1512;5033
352010;201504;1900;6369;1664;5824;446;1702;394;1315;840;3017
352020;201504;1425;4526;1236;4145;324;1192;452;1433;776;2625
352030;201504;4836;14358;4031;13167;989;3403;2161;7174;3150;10577
352040;201504;1958;6550;1622;5789;365;1451;407;1317;772;2768
352042;201504;2916;8262;1986;6213;427;1487;952;2874;1379;4361
352044;201504;1388;4649;1071;3896;235;932;199;638;434;1570
352050;201504;7671;24555;5331;19296;1510;6100;1012;3115;2522;9215
352060;201504;774;2252;669;2080;163;612;284;797;447;1409
352070;201504;662;1833;596;1731;194;592;238;695;432;1287
352080;201504;466;1323;339;1093;68;250;136;397;204;647
352090;201504;1706;5560;1353;4789;309;1202;310;961;619;2163
352100;201504;2415;7389;1746;6102;453;1783;556;1754;1009;3537
352110;201504;504;1808;440;1663;130;531;161;579;291;1110
352115;201504;411;1308;353;1188;73;275;155;489;228;764
352120;201504;905;2779;766;2548;144;554;416;1346;560;1900
352130;201504;1861;5316;1300;4214;367;1249;415;1250;782;2499
352140;201504;1603;4845;1064;3653;202;737;452;1503;654;2240
352150;201504;742;2269;576;1937;147;513;253;832;400;1345
352160;201504;1079;2987;888;2639;188;609;373;1007;561;1616
352170;201504;2767;8365;2492;7830;553;1935;1334;3965;1887;5900
352180;201504;3472;9863;2930;8870;755;2509;1123;3185;1878;5694
352190;201504;1158;3510;1028;3258;207;770;468;1333;675;2103
352200;201504;398;1379;332;1251;52;223;192;734;244;957
352210;201504;16967;45284;13487;40228;2491;7805;8014;24393;10505;32198
352215;201504;559;1747;513;1686;72;285;309;999;381;1284
352220;201504;12564;41211;11262;38585;3684;13586;3676;12286;7360;25872
352230;201504;13017;44008;11289;40726;3365;13299;4313;15156;7678;28455
352240;201504;11893;35488;9568;31324;2994;11048;3368;10304;6362;21352
352250;201504;22845;73435;20124;67958;5715;20809;7369;24577;13084;45386
352260;201504;5400;15444;3363;11196;657;2498;1172;3628;1829;6126
352265;201504;888;2819;750;2589;93;419;460;1492;553;1911
352270;201504;2097;7120;1753;6350;521;1981;418;1436;939;3417
352280;201504;2378;7259;1960;6537;485;1860;671;2127;1156;3987
352290;201504;1185;3741;1026;3410;245;954;357;1045;602;1999
352300;201504;911;2706;729;2375;191;693;311;949;502;1642
352310;201504;35744;110716;30918;102661;7974;28343;17317;57262;25291;85605
352320;201504;5747;17627;4968;16173;1467;5213;1605;4718;3072;9931
352330;201504;1902;6174;1651;5822;577;2165;510;1776;1087;3941
352340;201504;5652;18916;4540;16393;1314;5128;827;2723;2141;7851
352350;201504;1538;5448;1386;5115;306;1248;537;1907;843;3155
352360;201504;1098;3436;963;3171;200;815;596;1841;796;2656
352370;201504;894;3051;814;2884;156;653;401;1351;557;2004
352380;201504;969;3069;843;2849;286;1119;229;723;515;1842
352390;201504;17839;49216;11890;37679;2219;8125;5566;16385;7785;24510
352400;201504;3835;10741;2398;7959;596;2133;738;2254;1334;4387
352410;201504;3560;10633;2910;9515;886;3112;916;2866;1802;5978
352420;201504;987;2812;879;2630;257;861;428;1231;685;2092
352430;201504;6254;19287;5357;17831;1871;6833;1711;5568;3582;12401
352440;201504;15553;47733;12587;41975;3261;11664;4557;14862;7818;26526
352450;201504;677;1983;449;1534;106;407;102;309;208;716
352460;201504;2373;7794;2022;7138;648;2526;555;1812;1203;4338
352470;201504;4516;12473;2662;8622;460;1666;924;2812;1384;4478
352480;201504;4890;13406;3822;11448;771;2717;1567;4301;2338;7018
352490;201504;715;2487;582;2156;113;479;135;457;248;936
352500;201504;7763;23570;7128;22563;3368;11692;2076;5693;5444;17385
352510;201504;3133;10218;2521;8959;838;3278;585;1978;1423;5256
352520;201504;2154;7522;1908;6947;478;1900;919;3260;1397;5160
352530;201504;7671;24670;5741;20318;1627;6232;866;2733;2493;8965
352540;201504;490;1547;374;1292;55;232;109;353;164;585
352550;201504;882;2950;606;2256;146;626;105;339;251;965
352560;201504;676;2011;499;1634;97;337;172;503;269;840
352570;201504;1687;5567;1253;4536;275;1153;270;866;545;2019
352580;201504;874;2567;744;2352;180;640;374;1123;554;1763
352585;201504;217;708;170;611;63;237;32;122;95;359
352590;201504;11053;34924;9517;31822;2333;8526;4818;15465;7151;23991
352600;201504;1621;4977;1447;4656;411;1453;626;1906;1037;3359
352610;201504;3317;10124;2780;9197;863;3176;837;2564;1700;5740
352620;201504;5137;15990;4809;15556;1004;3534;3071;9867;4075;13401
352630;201504;656;2124;616;2024;152;572;287;902;439;1474
352640;201504;2895;8981;2364;7846;373;1427;1183;3786;1556;5213
352650;201504;834;2439;622;1990;133;451;193;581;326;1032
352660;201504;1017;3449;793;2919;172;703;182;620;354;1323
352670;201504;10528;32007;6411;22685;1688;6449;904;2966;2592;9415
352680;201504;3193;10946;2486;9255;570;2372;676;2208;1246;4580
352690;201504;29852;83510;20702;64809;4111;14238;9379;28129;13490;42367
352700;201504;769;2308;630;2093;189;720;284;887;473;1607
352710;201504;5702;16678;4271;13813;1055;3841;1559;4786;2614;8627
352720;201504;7705;25068;7014;23633;2102;7335;2594;8643;4696;15978
352725;201504;418;1185;260;856;36;144;100;304;136;448
352730;201504;2297;7695;2037;7007;446;1691;708;2174;1154;3865
352740;201504;1901;5438;1546;4827;298;1129;890;2603;1188;3732
352750;201504;406;1181;242;807;47;176;58;163;105;339
352760;201504;1080;3743;957;3465;284;1102;405;1391;689;2493
352770;201504;712;2202;618;2020;139;520;287;899;426;1419
352780;201504;640;2116;533;1882;118;481;168;531;286;1012
352790;201504;638;1824;468;1512;96;337;114;354;210;691
352800;201504;971;3489;712;2777;173;746;174;550;347;1296
352810;201504;1152;2992;765;2256;139;487;249;692;388;1179
352820;201504;599;1750;473;1558;161;575;102;328;263;903
352830;201504;512;1454;350;1111;66;233;56;137;122;370
352840;201504;3879;13324;3425;12347;1061;4056;1034;3686;2095;7742
352850;201504;8859;27828;7618;25647;1996;7229;2827;9368;4823;16597
352860;201504;841;2744;761;2560;209;769;254;778;463;1547
352870;201504;1003;2485;745;2002;77;286;446;1085;523;1371
352880;201504;2282;6581;1685;5309;365;1210;530;1547;895;2757
352885;201504;253;840;239;809;43;167;132;420;175;587
352890;201504;715;1922;538;1566;94;336;255;652;349;988
352900;201504;18695;54953;13766;44841;3031;10823;5323;16449;8354;27272
352910;201504;262;834;198;695;50;201;25;73;75;274
352920;201504;2537;7608;2038;6666;527;1942;795;2346;1322;4288
352930;201504;5879;18488;4693;15857;1298;4736;1039;3315;2337;8051
352940;201504;24387;80570;20727;72032;7175;26395;3398;11123;10573;37518
352950;201504;348;1062;232;821;62;261;55;159;117;420
352960;201504;625;1932;415;1445;67;269;69;225;136;494
352965;201504;310;897;251;787;65;237;47;125;112;362
352970;201504;3069;7900;2565;7176;335;989;1757;4964;2092;5953
352980;201504;1292;3832;1080;3511;262;887;586;2006;848;2893
352990;201504;3896;12508;3460;11734;1011;3825;1299;4161;2310;7986
353000;201504;499;1374;301;928;53;171;50;126;103;297
353010;201504;2985;8376;2218;6881;538;1915;710;1981;1248;3896
353020;201504;4274;11711;2822;8552;409;1424;1138;3087;1547;4511
353030;201504;4168;12198;3457;10879;1000;3420;872;2539;1872;5959
353040;201504;670;1913;568;1751;160;556;204;593;364;1149
353050;201504;5040;16900;4232;15248;1313;5162;1508;5103;2821;10265
353060;201504;33634;104993;31432;101524;3827;15030;23116;72016;26943;87046
353070;201504;9267;30059;6884;24768;1913;7364;1761;6293;3674;13657
353080;201504;5022;16304;3579;12973;878;3551;870;2856;1748;6407
353090;201504;532;1758;479;1648;55;245;270;862;325;1107
353100;201504;242;655;127;406;32;112;28;84;60;196
353110;201504;7346;22862;6501;21399;1579;5539;3517;11629;5096;17168
353120;201504;476;1537;389;1348;115;460;98;282;213;742
353130;201504;2640;7728;2201;7035;747;2642;768;2312;1515;4954
353140;201504;2401;6545;1843;5455;480;1546;706;1921;1186;3467
353150;201504;1753;5384;1444;4841;433;1590;397;1307;830;2897
353160;201504;635;1817;448;1426;123;395;70;190;193;585
353170;201504;472;1599;426;1523;124;522;186;633;310;1155
353180;201504;7075;20779;5688;18185;859;3095;3267;10220;4126;13315
353190;201504;3467;10790;2975;9709;588;2177;1482;4503;2070;6680
353200;201504;939;3166;770;2770;250;980;208;713;458;1693
353205;201504;492;1571;410;1397;87;303;160;544;247;847
353210;201504;964;2459;730;2054;38;144;531;1482;569;1626
353215;201504;476;1507;414;1370;72;277;142;418;214;695
353220;201504;698;2146;578;1885;131;457;174;531;305;988
353230;201504;977;3090;892;2942;232;849;259;785;491;1634
353240;201504;2059;6614;1858;6217;467;1763;910;2860;1377;4623
353250;201504;1083;2936;850;2529;157;501;387;1106;544;1607
353260;201504;906;2473;688;2105;113;410;325;933;438;1343
353270;201504;639;1917;551;1743;154;527;186;537;340;1064
353280;201504;600;1938;511;1760;140;530;140;469;280;999
353282;201504;1615;5199;1535;5063;242;925;956;3015;1198;3940
353284;201504;331;917;204;651;42;132;56;182;98;314
353286;201504;147;432;103;333;20;59;14;49;34;108
353290;201504;512;1658;416;1486;110;436;202;690;312;1126
353300;201504;1522;4757;1285;4230;307;1165;484;1390;791;2555
353310;201504;218;655;189;599;54;193;73;203;127;396
353320;201504;515;1484;451;1376;89;306;247;723;336;1029
353325;201504;559;1875;463;1666;78;322;76;220;154;542
353330;201504;595;1709;396;1257;76;282;187;533;263;815
353340;201504;2949;8508;1978;6594;561;2032;672;2159;1233;4191
353350;201504;3170;9559;2679;8679;850;2964;1136;3533;1986;6497
353360;201504;391;1295;342;1186;53;221;207;688;260;909
353370;201504;648;2122;568;1929;81;310;328;1088;409;1398
353380;201504;332;1084;284;1000;65;284;125;396;190;680
353390;201504;5924;15988;4229;12954;857;2969;1602;4485;2459;7454
353400;201504;496;1474;406;1292;111;402;110;286;221;688
353410;201504;606;1772;498;1599;107;387;284;900;391;1287
353420;201504;576;1592;411;1221;107;311;136;380;243;691
353430;201504;2404;8290;1762;6520;444;1733;178;593;622;2326
353440;201504;58637;189042;50500;170365;14071;50031;17439;57024;31510;107055
353450;201504;444;1355;376;1222;88;328;160;494;248;822
353460;201504;3585;9995;3092;9164;474;1542;1589;4792;2063;6334
353470;201504;9454;28533;6823;23136;1558;5935;1690;5309;3248;11244
353475;201504;1654;4717;1146;3608;218;741;319;892;537;1633
353480;201504;1475;4395;1304;4069;245;861;757;2284;1002;3145
353490;201504;1170;3245;912;2748;203;676;329;886;532;1562
353500;201504;941;2587;805;2353;251;770;335;952;586;1722
353510;201504;1101;3488;866;2902;193;736;249;687;442;1423
353520;201504;1128;3305;885;2878;212;774;340;1085;552;1859
353530;201504;2587;7671;2302;7158;436;1580;1226;3665;1662;5245
353540;201504;1994;6023;1745;5604;453;1551;752;2390;1205;3941
353550;201504;6172;17138;5347;15875;664;2391;3397;9615;4061;12006
353560;201504;2143;7081;1775;6400;462;1871;572;1978;1034;3849
353570;201504;428;1323;356;1170;57;212;220;676;277;888
353580;201504;2219;7035;2046;6743;414;1568;1287;4166;1701;5734
353590;201504;702;2001;549;1732;160;536;168;535;328;1071
353600;201504;1728;4860;1560;4575;248;823;880;2521;1128;3344
353610;201504;579;1939;444;1642;93;412;128;427;221;839
353620;201504;2211;7266;1892;6646;530;2016;605;1988;1135;4004
353625;201504;289;772;187;595;45;161;67;206;112;367
353630;201504;1658;5667;1265;4661;249;981;173;554;422;1535
353640;201504;1361;3929;1114;3415;177;548;589;1762;766;2310
353650;201504;6823;20523;5083;16826;1100;3918;1693;5341;2793;9259
353657;201504;319;996;283;922;49;180;106;321;155;501
353660;201504;1260;3243;922;2690;370;1183;163;341;533;1524
353670;201504;3979;12874;3364;11533;1014;3967;1065;3272;2079;7239
353680;201504;646;2180;586;2070;257;984;210;716;467;1700
353690;201504;546;1432;331;1037;61;241;122;320;183;561
353700;201504;2174;6739;1878;6132;359;1301;739;2269;1098;3570
353710;201504;2967;7216;1348;4486;300;1042;279;891;579;1933
353715;201504;465;1350;343;1107;48;179;125;375;173;554
353720;201504;2034;6359;1762;5953;302;1174;1026;3381;1328;4555
353730;201504;4439;13566;3453;11427;780;2812;960;2872;1740;5684
353740;201504;2074;6204;1629;5296;490;1664;463;1479;953;3143
353750;201504;804;2696;621;2264;134;561;176;623;310;1184
353760;201504;8827;25569;7192;22923;1529;5415;3821;12013;5350;17428
353770;201504;804;2440;485;1666;100;376;41;68;141;444
353780;201504;4437;15273;3858;14138;1403;5467;1068;3922;2471;9389
353790;201504;1838;6403;1523;5743;425;1839;331;1188;756;3027
353800;201504;15060;47239;11939;41416;3227;12382;4491;15140;7718;27522
353810;201504;1068;3379;840;2891;191;739;294;964;485;1703
353820;201504;1219;4180;1111;3924;280;1177;539;1731;819;2908
353830;201504;761;2050;596;1766;107;345;273;795;380;1140
353850;201504;1629;5191;1480;4930;301;1089;733;2359;1034;3448
353860;201504;2400;8037;1996;7097;533;2041;562;1931;1095;3972
353870;201504;24526;73834;17736;60030;3962;14891;5555;16977;9517;31868
353880;201504;2454;7767;2058;7082;289;1224;1159;3900;1448;5124
353890;201504;2669;6622;1853;5295;375;1183;887;2395;1262;3578
353900;201504;1056;3308;777;2701;179;696;198;609;377;1305
353910;201504;1176;4294;1138;4216;327;1303;655;2373;982;3676
353920;201504;2285;6791;1650;5399;379;1335;283;801;662;2136
353930;201504;4062;13094;3034;11058;850;3335;653;2333;1503;5668
353940;201504;1266;4003;1025;3475;187;742;429;1325;616;2067
353950;201504;3482;11052;3168;10513;444;1740;2101;6761;2545;8501
353960;201504;611;1926;469;1610;95;366;115;323;210;689
353970;201504;548;1618;479;1522;40;151;356;1123;396;1274
353980;201504;13272;39852;11481;36535;2574;8826;5848;18277;8422;27103
353990;201504;411;1270;371;1182;75;288;152;433;227;721
354000;201504;1977;5695;1343;4438;282;1018;139;411;421;1429
354010;201504;361;1082;310;998;91;304;144;472;235;776
354020;201504;4646;14243;4102;13050;1120;3924;1636;4802;2756;8726
354025;201504;899;2550;697;2206;163;563;203;605;366;1168
354030;201504;520;1421;369;1173;75;268;158;462;233;730
354040;201504;796;2162;604;1809;72;273;333;916;405;1189
354050;201504;970;3134;838;2876;268;1032;265;859;533;1891
354060;201504;5153;15995;3675;12744;916;3443;1253;4175;2169;7618
354070;201504;3065;10084;2657;9196;760;2849;549;1823;1309;4672
354075;201504;2118;7909;1999;7689;576;2460;916;3478;1492;5938
354080;201504;1696;5229;1217;4106;268;978;299;865;567;1843
354085;201504;302;778;272;731;20;76;217;559;237;635
354090;201504;1316;3889;1249;3782;131;437;938;2881;1069;3318
354100;201504;15794;53113;13273;48224;3395;13196;5948;21375;9343;34571
354105;201504;849;2626;742;2422;129;502;396;1210;525;1712
354110;201504;808;2274;658;2064;208;742;204;583;412;1325
354120;201504;1966;5437;1539;4645;305;1042;636;1757;941;2799
354130;201504;5853;17087;4654;14744;1897;6442;870;2380;2767;8822
354140;201504;25092;63886;15730;46715;3197;10383;5518;15143;8715;25526
354150;201504;4150;11236;3159;9483;658;2234;1472;4219;2130;6453
354160;201504;3651;11963;3123;10806;843;3189;1258;4186;2101;7375
354165;201504;367;1338;329;1244;100;427;102;371;202;798
354170;201504;1455;4525;1152;3830;224;839;432;1262;656;2101
354180;201504;496;1504;466;1448;68;266;274;765;342;1031
354190;201504;1459;4759;1226;4244;348;1341;395;1280;743;2621
354200;201504;1095;3111;892;2742;159;562;373;1022;532;1584
354210;201504;723;2386;627;2199;108;479;312;994;420;1473
354220;201504;2888;8610;2515;7899;663;2315;1120;3358;1783;5673
354230;201504;623;2054;574;1973;110;426;284;952;394;1378
354240;201504;1207;3951;912;3262;184;743;201;642;385;1385
354250;201504;656;1941;453;1582;183;712;120;401;303;1113
354260;201504;7272;22207;6501;20911;1892;6631;2491;7880;4383;14511
354270;201504;1153;3988;1004;3647;269;1087;384;1390;653;2477
354280;201504;644;1973;600;1895;80;328;445;1336;525;1664
354290;201504;1047;3597;956;3419;243;947;367;1285;610;2232
354300;201504;3512;11814;3387;11580;906;3290;1733;5812;2639;9102
354310;201504;880;2771;674;2337;177;665;237;813;414;1478
354320;201504;768;2275;648;2043;162;573;216;620;378;1193
354323;201504;402;1140;312;970;70;244;109;305;179;549
354325;201504;1194;3978;1034;3595;212;853;417;1332;629;2185
354330;201504;6779;20743;5672;18544;1177;4356;2858;8818;4035;13174
354340;201504;26298;82277;21488;73640;7005;26057;7729;25654;14734;51711
354350;201504;1110;3296;1035;3161;279;947;530;1525;809;2472
354360;201504;456;1435;336;1195;58;217;26;90;84;307
354370;201504;1214;4094;1067;3800;141;633;661;2280;802;2913
354380;201504;1077;3196;855;2802;260;1018;139;356;399;1374
354390;201504;12095;37277;8688;30164;1990;7565;2048;6762;4038;14327
354400;201504;1512;5207;1225;4527;265;1074;378;1332;643;2406
354410;201504;5526;16923;4626;15365;965;3504;2314;7597;3279;11101
354420;201504;1261;3821;978;3190;251;906;368;1119;619;2025
354425;201504;2657;7496;2239;6738;710;2303;578;1660;1288;3963
354430;201504;1255;4108;1178;3968;294;1121;536;1734;830;2855
354440;201504;521;1537;398;1292;51;199;197;590;248;789
354450;201504;429;1235;248;843;39;165;54;156;93;321
354460;201504;848;2325;638;1972;200;665;247;740;447;1405
354470;201504;548;1546;432;1313;55;221;208;556;263;777
354480;201504;715;2030;613;1869;103;367;351;1022;454;1389
354490;201504;740;2445;574;2054;124;499;193;618;317;1117
354500;201504;2098;7045;1859;6599;720;2938;364;1140;1084;4078
354510;201504;715;2116;633;1970;111;349;390;1237;501;1586
354515;201504;316;1061;249;908;47;202;83;266;130;468
354520;201504;6745;22307;4019;14358;888;3654;1541;5128;2429;8782
354530;201504;2730;9617;2510;9171;683;2768;1203;4296;1886;7064
354540;201504;1249;3789;1031;3387;364;1334;189;546;553;1880
354550;201504;494;1537;423;1380;81;284;199;623;280;907
354560;201504;1504;4450;1096;3537;226;725;406;1268;632;1993
354570;201504;734;2188;533;1743;136;477;83;235;219;712
354580;201504;10111;29281;7959;25191;1642;5795;3455;10322;5097;16117
354600;201504;1581;5305;1400;4952;335;1420;672;2239;1007;3659
354610;201504;397;1138;252;808;36;110;52;142;88;252
354620;201504;385;1268;311;1134;86;377;130;436;216;813
354625;201504;272;910;216;790;48;192;56;197;104;389
354630;201504;1976;6650;1777;6223;833;2975;452;1517;1285;4492
354640;201504;3612;11759;2881;10174;698;2843;667;2102;1365;4945
354650;201504;889;2682;805;2526;103;365;530;1623;633;1988
354660;201504;2347;6869;1846;5998;350;1281;989;3200;1339;4481
354670;201504;1637;5316;1347;4603;370;1376;338;991;708;2367
354680;201504;4657;15523;4215;14602;1086;4092;1688;5655;2774;9747
354690;201504;771;2502;540;1943;96;365;174;592;270;957
354700;201504;1212;3419;820;2589;153;575;339;900;492;1475
354710;201504;537;1593;456;1441;79;294;203;574;282;868
354720;201504;215;592;154;469;51;146;40;123;91;269
354730;201504;7749;25672;6062;22065;1522;6066;2448;8613;3970;14679
354740;201504;253;759;166;574;31;115;36;119;67;234
354750;201504;2426;7400;1884;6469;591;2281;673;2225;1264;4506
354760;201504;2037;6542;1647;5678;479;1773;320;1026;799;2799
354765;201504;232;630;149;471;25;89;25;73;50;162
354770;201504;2227;6292;1732;5473;686;2330;397;1191;1083;3521
354780;201504;39918;117937;35376;107981;7191;24597;18221;52361;25412;76958
354790;201504;787;2513;667;2299;137;555;326;1034;463;1589
354800;201504;1887;5542;1664;5237;410;1432;920;2889;1330;4321
354805;201504;946;2857;689;2276;76;275;141;415;217;690
354810;201504;598;1922;375;1354;77;325;70;190;147;515
354820;201504;1043;3599;901;3302;220;957;258;840;478;1797
354830;201504;390;1125;310;982;83;293;151;435;234;728
354840;201504;678;1962;562;1752;134;457;268;814;402;1271
354850;201504;15943;50111;12000;42056;2911;11392;4451;14393;7362;25785
354860;201504;1322;4234;1166;3956;246;961;541;1762;787;2723
354870;201504;42526;130325;38788;122523;9712;32866;17715;54991;27427;87857
354880;201504;4056;11378;2481;8121;491;1801;679;1822;1170;3623
354890;201504;15828;47193;13261;42333;3532;12101;4531;13925;8063;26026
354900;201504;479;1414;381;1242;107;375;136;441;243;816
354910;201504;6513;19473;3742;13343;654;2613;277;916;931;3529
354920;201504;468;1364;329;1090;76;283;89;275;165;558
354925;201504;353;1009;217;737;36;144;34;87;70;231
354930;201504;213;593;156;496;36;126;78;238;114;364
354940;201504;2222;7880;1763;6658;632;2541;233;785;865;3326
354950;201504;1476;4764;1293;4499;173;726;844;2900;1017;3626
354960;201504;766;2409;671;2256;173;658;270;868;443;1526
354970;201504;4086;13350;3571;12273;648;2605;1975;6499;2623;9104
354980;201504;33112;82125;19537;59302;3973;13629;6531;18300;10504;31929
354990;201504;44649;136213;36703;120049;7184;25937;18859;59646;26043;85583
354995;201504;1669;5175;1521;4966;332;1186;865;2797;1197;3983
355000;201504;1452;4718;1257;4372;394;1553;235;712;629;2265
355010;201504;3607;11174;2898;9618;772;2764;1152;3773;1924;6537
355020;201504;2710;9153;2139;7984;904;3654;485;1756;1389;5410
355030;201504;949835;2724667;833138;2493330;201282;657193;372216;1072729;573498;1729922
355040;201504;2570;7908;2270;7380;556;1983;1214;3866;1770;5849
355050;201504;1216;3745;980;3273;312;1108;216;716;528;1824
355060;201504;5146;17403;4152;15272;1048;4319;1026;3439;2074;7758
355070;201504;6709;20925;6009;19799;1313;5067;3199;9834;4512;14901
355080;201504;1170;4041;872;3318;195;872;121;364;316;1236
355090;201504;1117;3920;949;3537;204;838;400;1436;604;2274
355100;201504;19784;61919;16662;56688;4866;18090;6944;23131;11810;41221
355110;201504;1168;4007;1055;3761;320;1256;345;1191;665;2447
355120;201504;629;1997;536;1824;136;530;235;763;371;1293
355130;201504;597;1542;309;912;44;144;121;308;165;452
355140;201504;1065;3593;1022;3514;235;900;529;1836;764;2736
355150;201504;3241;9714;2755;8912;655;2279;1373;4393;2028;6672
355160;201504;1568;5089;1353;4753;482;1920;425;1351;907;3271
355170;201504;9705;26937;6949;22113;2160;7414;1755;5538;3915;12952
355180;201504;2877;8843;2398;7952;638;2487;837;2514;1475;5001
355190;201504;1280;4355;1086;3931;412;1582;339;1183;751;2765
355200;201504;780;2824;720;2701;303;1227;172;613;475;1840
355210;201504;2529;8353;2269;7814;527;2130;1135;3662;1662;5792
355220;201504;29655;92165;24575;82400;8826;31404;6406;20887;15232;52291
355230;201504;1394;3915;776;2533;122;398;189;556;311;954
355240;201504;25758;75056;18412;59977;4033;14430;6727;20656;10760;35086
355250;201504;25575;84137;22794;78759;6858;25127;9464;32331;16322;57458
355255;201504;818;2290;576;1791;112;384;165;467;277;851
355260;201504;1424;4028;1221;3708;306;1083;503;1351;809;2434
355270;201504;1531;4640;1465;4544;129;514;1192;3611;1321;4125
355280;201504;23685;69830;19826;62513;4166;14871;8816;26422;12982;41293
355290;201504;901;2830;761;2518;149;525;310;961;459;1486
355300;201504;1027;3352;840;2951;191;731;266;874;457;1605
355310;201504;1015;3144;856;2849;156;564;444;1491;600;2055
355320;201504;616;1925;529;1727;97;387;201;548;298;935
355330;201504;1788;5677;1289;4704;347;1427;418;1460;765;2887
355340;201504;2551;6733;2329;6356;414;1236;1425;3768;1839;5004
355350;201504;1285;4418;1087;3983;295;1206;347;1192;642;2398
355360;201504;1114;3668;1021;3482;167;611;710;2467;877;3078
355365;201504;273;868;227;778;51;206;66;214;117;420
355370;201504;7333;18257;5289;15743;1441;4699;2292;6994;3733;11693
355380;201504;3417;10329;2637;8516;666;2424;562;1487;1228;3911
355385;201504;830;2628;774;2538;290;1042;248;753;538;1795
355390;201504;964;2747;763;2360;163;574;333;915;496;1489
355395;201504;1859;5577;1400;4555;222;798;613;1836;835;2634
355400;201504;8714;28885;7588;26577;2331;8930;2574;8601;4905;17531
355410;201504;14679;50453;12527;45924;4353;17331;2975;10940;7328;28271
355420;201504;765;2702;704;2566;242;979;215;773;457;1752
355430;201504;3614;10289;3046;9329;574;1981;1613;4760;2187;6741
355440;201504;881;2844;705;2405;139;519;215;654;354;1173
355450;201504;3072;9251;1931;6567;407;1483;603;1897;1010;3380
355460;201504;588;1607;425;1317;82;306;149;387;231;693
355465;201504;395;1212;333;1098;80;293;83;266;163;559
355470;201504;829;2556;679;2272;149;560;298;948;447;1508
355475;201504;127;467;116;435;28;104;53;200;81;304
355480;201504;3142;11304;2926;10876;842;3357;1369;5023;2211;8380
355490;201504;954;2734;668;2176;138;470;122;375;260;845
355495;201504;700;2353;627;2201;135;551;236;781;371;1332
355500;201504;8114;23380;5261;17231;933;3429;1101;3245;2034;6674
355510;201504;2065;5560;1238;3894;216;821;406;1134;622;1955
355520;201504;452;1111;256;731;40;136;104;261;144;397
355530;201504;330;769;143;437;17;60;38;111;55;171
355535;201504;721;2211;577;1945;169;654;147;410;316;1064
355540;201504;8394;26654;7922;25878;2002;7052;4275;13606;6277;20658
355550;201504;759;2259;652;2098;151;562;309;951;460;1513
355560;201504;1318;3908;912;3023;191;740;169;415;360;1155
355570;201504;189;594;144;491;24;85;22;56;46;141
355580;201504;1099;3116;832;2604;190;683;358;1087;548;1770
355590;201504;230;611;193;543;27;82;114;318;141;400
355600;201504;1135;3612;960;3233;372;1376;236;747;608;2123
355610;201504;1397;3923;1180;3574;245;831;562;1638;807;2469
355620;201504;4058;12788;3254;10958;650;2510;1420;4416;2070;6926
355630;201504;3175;9099;1927;6500;364;1369;503;1582;867;2951
355635;201504;940;3079;811;2857;105;434;550;1940;655;2374
355640;201504;3326;10817;2570;9193;567;2292;390;1247;957;3539
355645;201504;3175;11135;2922;10704;496;2000;1845;6786;2341;8786
355650;201504;6779;20877;5831;19078;951;3704;3512;10793;4463;14497
355660;201504;1241;3948;995;3438;234;985;396;1253;630;2238
355670;201504;2477;7822;1743;6099;382;1559;674;2088;1056;3647
355680;201504;1496;4937;1130;4095;371;1454;253;858;624;2312
355690;201504;407;1280;299;1095;192;746;22;65;214;811
355695;201504;321;965;194;636;11;32;19;37;30;69
355700;201504;5821;19749;5015;17878;1358;5213;1965;6702;3323;11915
355710;201504;11468;28834;7007;20719;1889;6078;1838;5063;3727;11141
355715;201504;258;780;163;566;35;131;31;92;66;223
355720;201504;1517;4981;1254;4408;363;1413;364;1127;727;2540
355730;201504;735;2501;630;2260;211;783;135;477;346;1260
410010;201504;1517;4807;1342;4453;328;1211;380;1223;708;2434
410020;201504;1145;3846;1029;3605;279;1047;412;1393;691;2440
410030;201504;1120;3821;940;3375;253;968;166;590;419;1558
410040;201504;10141;33734;8977;31414;2686;10575;2593;8663;5279;19238
410045;201504;1017;2881;711;2278;178;624;213;634;391;1258
410050;201504;2279;6410;1450;4755;394;1381;234;711;628;2092
410060;201504;2196;6901;1955;6431;503;1800;822;2709;1325;4509
410070;201504;1759;5027;1355;4219;457;1587;276;733;733;2320
410080;201504;1234;3734;1034;3343;188;710;484;1456;672;2166
410090;201504;1051;3311;951;3121;266;976;323;1018;589;1994
410100;201504;2547;7792;1851;6165;500;1874;224;680;724;2554
410105;201504;418;1312;288;994;54;224;45;121;99;345
410110;201504;2466;7374;2005;6497;394;1464;707;2189;1101;3653
410115;201504;516;1406;396;1176;60;193;156;437;216;630
410120;201504;2534;8723;2379;8473;788;2968;1047;3793;1835;6761
410130;201504;1181;3813;1050;3509;358;1227;319;1031;677;2258
410140;201504;16178;43037;10917;33496;2488;8539;3303;9852;5791;18391
410150;201504;17194;42640;8410;25066;1709;5610;1519;4009;3228;9619
410160;201504;2990;9377;2688;8861;781;2879;1012;3341;1793;6220
410165;201504;743;2177;597;1868;143;474;255;754;398;1228
410170;201504;2043;6017;1628;5118;506;1779;393;1179;899;2958
410180;201504;9038;28927;7768;26157;1921;7186;3044;9569;4965;16755
410185;201504;566;1570;472;1397;116;353;181;507;297;860
410190;201504;2007;5933;1644;5111;414;1416;375;1045;789;2461
410200;201504;3729;10488;2682;8358;602;2095;355;995;957;3090
410210;201504;2525;7566;1912;6230;347;1314;438;1177;785;2491
410220;201504;634;1820;465;1481;91;329;138;409;229;738
410230;201504;1494;4795;1296;4428;406;1581;493;1593;899;3174
410240;201504;4321;13203;3888;12303;1118;4021;1225;3704;2343;7725
410250;201504;2482;6929;1708;5330;474;1640;310;865;784;2505
410260;201504;1590;4871;1350;4412;345;1247;517;1633;862;2880
410270;201504;522;1486;412;1276;74;264;168;496;242;760
410275;201504;866;2600;602;2017;97;345;291;969;388;1314
410280;201504;2878;8488;2077;6792;430;1626;445;1320;875;2946
410290;201504;3333;10088;2834;9132;685;2402;1199;3874;1884;6276
410300;201504;664;1867;577;1686;81;272;282;742;363;1014
410302;201504;358;969;246;784;29;100;143;462;172;562
410304;201504;1240;4007;1115;3743;317;1119;443;1533;760;2652
410305;201504;1926;5117;1588;4592;400;1240;898;2594;1298;3834
410310;201504;2147;7055;1923;6655;448;1742;786;2685;1234;4427
410315;201504;634;1853;415;1423;87;321;130;415;217;736
410320;201504;1248;3694;784;2651;118;450;60;172;178;622
410322;201504;589;1765;416;1386;102;343;112;351;214;694
410330;201504;1339;3680;1099;3216;248;788;344;958;592;1746
410335;201504;965;2856;828;2613;188;651;314;940;502;1591
410337;201504;777;2078;581;1696;86;302;234;602;320;904
410340;201504;478;1423;331;1030;42;158;134;369;176;527
410345;201504;1869;5444;1397;4456;363;1260;392;1164;755;2424
410347;201504;722;1956;458;1456;76;289;149;460;225;749
410350;201504;923;2807;650;2232;141;574;99;288;240;862
410360;201504;3316;9572;2741;8565;563;1970;1148;3479;1711;5449
410370;201504;12238;35542;8901;28044;1923;6941;2559;7087;4482;14028
410380;201504;1190;3687;1051;3381;163;615;547;1666;710;2281
410390;201504;2790;8047;2207;6965;755;2595;580;1632;1335;4227
410395;201504;888;2947;782;2722;192;790;347;1161;539;1951
410400;201504;4083;12873;3505;11761;851;3281;1325;4240;2176;7521
410405;201504;955;2763;765;2397;177;640;294;887;471;1527
410410;201504;1265;4151;1194;4046;401;1564;396;1222;797;2786
410420;201504;7753;25228;6541;22474;1937;7249;1298;3978;3235;11227
410425;201504;3318;10526;2387;8405;470;1818;287;935;757;2753
410430;201504;14966;40721;10851;32984;2420;8194;3322;9712;5742;17906
410440;201504;3074;9751;2724;9071;700;2580;1177;3843;1877;6423
410442;201504;2738;9295;2423;8568;758;2841;723;2543;1481;5384
410445;201504;2258;7517;1950;6955;537;2140;699;2586;1236;4726
410450;201504;2296;6549;1802;5591;571;1848;312;839;883;2687
410460;201504;2177;6491;1782;5719;459;1567;605;1828;1064;3395
410465;201504;1922;6597;1606;5878;422;1760;610;2028;1032;3788
410470;201504;1528;4945;1235;4254;309;1211;323;1086;632;2297
410480;201504;29113;83083;20583;65342;5572;19316;3825;11087;9397;30403
410490;201504;10847;34576;8522;29548;2302;8932;2353;7586;4655;16518
410500;201504;1617;5067;1323;4422;476;1762;381;1246;857;3008
410510;201504;2466;6538;1753;5106;369;1143;690;1813;1059;2956
410520;201504;3142;10979;2971;10623;969;3701;1098;3923;2067;7624
410530;201504;1633;4524;1259;3772;239;839;515;1426;754;2265
410540;201504;3157;9256;2136;7127;489;1741;689;2273;1178;4014
410550;201504;6224;18038;4213;13626;862;3143;672;1942;1534;5085
410560;201504;1376;4226;1053;3505;253;950;283;746;536;1696
410570;201504;2578;8325;2308;7854;650;2347;856;3128;1506;5475
410580;201504;21891;67640;18141;59954;5119;18839;4915;14984;10034;33823
410590;201504;1329;4186;807;2725;124;444;154;446;278;890
410600;201504;1916;5619;1558;4915;364;1194;645;2049;1009;3243
410610;201504;771;2284;621;1985;108;405;245;742;353;1147
410620;201504;1566;5449;1177;4436;357;1441;161;582;518;2023
410630;201504;2502;7406;1859;5982;483;1717;387;1061;870;2778
410640;201504;4640;13003;3481;10824;1017;3675;721;2040;1738;5715
410645;201504;1100;3858;1046;3775;475;1861;284;1005;759;2866
410650;201504;2302;7116;1852;6156;625;2178;339;1057;964;3235
410655;201504;855;2522;678;2180;162;599;233;714;395;1313
410657;201504;711;2057;507;1619;110;401;184;517;294;918
410660;201504;2414;6946;1410;4653;322;1156;217;604;539;1760
410670;201504;943;2632;670;2064;148;484;191;519;339;1003
410680;201504;2723;9233;2208;7929;635;2264;721;2742;1356;5006
410685;201504;649;1876;566;1736;50;163;416;1289;466;1452
410690;201504;108437;315060;74891;244668;17182;61985;16822;49247;34004;111232
410700;201504;2265;6994;2095;6670;591;2056;905;2769;1496;4825
410710;201504;941;2837;664;2183;168;608;187;534;355;1142
410712;201504;817;2488;707;2282;278;985;213;711;491;1696
410715;201504;986;3085;764;2575;165;623;288;918;453;1541
410720;201504;3349;9924;2440;7996;578;2135;617;1866;1195;4001
410725;201504;1054;2957;744;2350;120;386;129;346;249;732
410730;201504;498;1455;433;1320;143;497;115;338;258;835
410740;201504;872;2606;611;2071;113;446;277;940;390;1386
410750;201504;1784;5214;1484;4597;339;1141;485;1390;824;2531
410752;201504;303;849;186;604;37;144;71;201;108;345
410753;201504;446;1297;288;938;57;218;102;299;159;517
410754;201504;1021;3161;889;2937;90;331;591;2020;681;2351
410755;201504;817;2075;635;1785;79;259;384;1051;463;1310
410760;201504;2228;6906;1989;6458;589;2090;688;2130;1277;4220
410765;201504;16179;48139;11767;39176;2448;9211;1489;4530;3937;13741
410770;201504;916;2537;687;2088;196;656;185;517;381;1173
410773;201504;1358;3936;1154;3618;245;907;632;1880;877;2787
410775;201504;1535;4447;1438;4308;342;1088;737;2209;1079;3297
410780;201504;521;1447;382;1201;101;315;154;546;255;861
410785;201504;698;2240;571;1931;219;779;125;414;344;1193
410790;201504;536;1665;437;1432;96;348;91;228;187;576
410800;201504;2780;7024;2137;5985;524;1700;842;2191;1366;3891
410810;201504;325;999;264;862;42;157;117;382;159;539
410820;201504;925;2779;712;2285;185;652;143;405;328;1057
410830;201504;31792;92289;25730;81656;7622;26930;8884;27280;16506;54210
410832;201504;1039;3061;907;2819;130;483;518;1512;648;1995
410840;201504;6809;20105;4540;15242;1212;4403;556;1592;1768;5995
410845;201504;1341;3971;1122;3502;188;666;519;1563;707;2229
410850;201504;2779;8157;2480;7702;543;1949;1285;3957;1828;5906
410855;201504;567;1575;410;1241;96;334;155;406;251;740
410860;201504;3642;10281;2930;8948;535;1776;1303;3908;1838;5684
410865;201504;1618;5566;1509;5351;382;1465;830;2996;1212;4461
410870;201504;1229;3789;1130;3630;520;1758;388;1225;908;2983
410880;201504;4260;12980;3392;11338;773;2879;745;2275;1518;5154
410890;201504;1021;3251;795;2806;197;781;73;222;270;1003
410895;201504;1088;3783;972;3518;349;1365;275;921;624;2286
410900;201504;851;2363;621;1969;124;491;206;571;330;1062
410910;201504;417;1111;355;1006;55;177;195;532;250;709
410920;201504;773;2301;618;2019;152;555;245;761;397;1316
410930;201504;1794;5293;1516;4796;380;1440;597;1820;977;3260
410940;201504;20548;67669;17941;62836;5372;20679;6308;22263;11680;42942
410950;201504;1809;6001;1673;5765;304;1095;1059;3683;1363;4778
410960;201504;7179;19933;4635;15095;1423;5121;1136;3511;2559;8632
410965;201504;1022;3149;892;2906;304;1042;341;1089;645;2131
410970;201504;4497;13558;3551;11664;1106;4174;701;2220;1807;6394
410975;201504;1579;4545;1278;3994;225;841;556;1701;781;2542
410980;201504;5563;15658;3368;11185;737;2712;538;1719;1275;4431
410990;201504;865;2526;531;1780;174;637;77;195;251;832
411000;201504;455;1358;318;1047;69;262;58;153;127;415
411005;201504;502;1475;320;1034;81;282;39;96;120;378
411007;201504;2236;7132;1960;6517;594;2103;669;2180;1263;4283
411010;201504;3779;12965;3377;12044;973;3915;694;2235;1667;6150
411020;201504;2564;8063;2290;7595;763;2848;737;2411;1500;5259
411030;201504;650;1779;511;1516;126;430;154;404;280;834
411040;201504;615;1784;304;990;65;239;70;215;135;454
411050;201504;2117;7432;1879;6897;562;2271;302;1003;864;3274
411060;201504;1645;5083;1366;4479;299;1076;189;539;488;1615
411065;201504;370;1119;285;945;54;188;108;342;162;530
411070;201504;5556;17059;4194;14199;1181;4421;700;2090;1881;6511
411080;201504;2142;6536;1910;6109;545;1955;569;1725;1114;3680
411090;201504;750;1837;541;1532;84;307;137;348;221;655
411095;201504;1613;4519;1171;3632;219;769;293;802;512;1571
411100;201504;1383;4012;1011;3266;176;659;182;500;358;1159
411110;201504;721;2135;453;1524;65;240;71;186;136;426
411120;201504;1755;5326;1340;4431;375;1373;410;1262;785;2635
411125;201504;4191;13801;4026;13463;1259;4551;1696;5499;2955;10050
411130;201504;726;2204;567;1849;137;481;171;575;308;1056
411140;201504;2111;7493;1817;6797;628;2457;511;1994;1139;4451
411150;201504;4514;12621;3488;10540;874;2950;723;1825;1597;4775
411155;201504;971;2689;765;2295;164;576;344;934;508;1510
411160;201504;235;692;194;607;36;125;71;202;107;327
411170;201504;687;2230;571;1959;130;488;211;689;341;1177
411180;201504;5716;17079;4724;15219;1167;4185;1592;5034;2759;9219
411190;201504;1454;4145;1204;3672;317;1133;337;890;654;2023
411200;201504;4446;13181;3579;11698;954;3517;1373;4303;2327;7820
411210;201504;2116;6075;1669;5251;585;1989;281;850;866;2839
411220;201504;1143;3243;910;2803;220;799;367;990;587;1789
411230;201504;1213;3403;767;2494;205;756;196;552;401;1308
411240;201504;1333;3202;735;2211;157;496;240;677;397;1173
411250;201504;2494;7319;2067;6541;557;1931;589;1805;1146;3736
411260;201504;302;830;198;639;29;102;92;287;121;389
411270;201504;1774;5648;1593;5308;352;1361;774;2447;1126;3808
411275;201504;1407;4208;1166;3653;308;1039;279;805;587;1844
411280;201504;1526;4523;1110;3646;240;893;235;697;475;1590
411290;201504;798;2279;615;1887;153;488;223;667;376;1155
411295;201504;917;2602;835;2441;147;460;362;1077;509;1537
411300;201504;1270;3258;905;2532;92;291;384;1013;476;1304
411310;201504;844;2378;655;2041;95;339;234;725;329;1064
411320;201504;5629;16439;4154;13571;1135;3912;867;2654;2002;6566
411325;201504;1503;4744;1308;4351;247;912;773;2573;1020;3485
411330;201504;3338;10461;2876;9595;1013;3744;822;2672;1835;6416
411340;201504;928;2726;588;1923;102;393;232;724;334;1117
411342;201504;721;2066;592;1793;151;498;189;495;340;993
411345;201504;985;3081;892;2899;243;868;421;1374;664;2242
411350;201504;2832;8394;1963;6590;529;1986;242;741;771;2727
411360;201504;601;1533;389;1141;47;181;175;433;222;614
411370;201504;46131;130833;35198;110438;6605;24127;13344;38600;19949;62727
411373;201504;1457;4556;1214;4074;305;1146;321;1068;626;2214
411375;201504;1090;3034;821;2509;185;614;290;844;475;1458
411380;201504;1296;3484;767;2339;126;419;229;647;355;1066
411390;201504;1741;5160;1491;4696;348;1215;556;1666;904;2881
411400;201504;1989;5785;1481;4663;299;1046;388;1114;687;2160
411410;201504;2150;6472;1639;5263;409;1491;429;1157;838;2648
411420;201504;4273;12399;3105;9775;595;2131;545;1335;1140;3466
411430;201504;3074;9651;2593;8793;747;2782;1097;3636;1844;6418
411435;201504;421;1368;343;1160;89;329;136;428;225;757
411440;201504;2628;8525;2368;8014;847;3062;658;2295;1505;5357
411450;201504;2257;6876;2041;6476;445;1462;1129;3635;1574;5097
411460;201504;3287;9688;1881;6365;411;1565;229;626;640;2191
411470;201504;855;2540;564;1846;98;353;97;263;195;616
411480;201504;4355;13116;3268;11003;1008;3840;637;1996;1645;5836
411490;201504;1455;4444;1228;4027;349;1300;328;928;677;2228
411500;201504;1855;5067;1295;4043;314;1084;335;997;649;2081
411510;201504;2121;6316;1686;5426;491;1759;356;960;847;2719
411520;201504;27024;73550;16294;50879;3425;11782;3524;10088;6949;21870
411530;201504;974;2783;665;2187;201;755;99;256;300;1011
411535;201504;516;1546;248;899;40;167;25;74;65;241
411540;201504;2955;7968;2202;6546;328;1071;1096;3202;1424;4273
411545;201504;965;3269;882;3111;158;599;593;2121;751;2720
411550;201504;808;2193;647;1938;249;830;148;422;397;1252
411560;201504;2453;7352;1854;5962;409;1451;349;986;758;2437
411570;201504;6486;17702;4766;14820;1240;4371;1077;3386;2317;7757
411573;201504;893;2706;842;2616;148;493;525;1646;673;2139
411575;201504;1443;4554;1222;4076;239;848;477;1576;716;2424
411580;201504;3939;11191;2618;8461;466;1793;415;1056;881;2849
411585;201504;637;2110;385;1357;91;355;72;233;163;588
411590;201504;418;1271;362;1174;75;282;162;493;237;775
411600;201504;300;890;216;735;48;198;77;249;125;447
411605;201504;2032;5477;1355;4148;232;811;564;1644;796;2455
411610;201504;2176;6050;1882;5603;344;1109;1243;3665;1587;4774
411620;201504;2692;8633;2504;8306;742;2626;1140;3847;1882;6473
411630;201504;455;1179;266;880;51;208;52;160;103;368
411640;201504;495;1468;383;1234;67;237;145;414;212;651
411650;201504;200;650;165;584;41;175;52;165;93;340
411660;201504;826;2319;656;1993;133;446;276;830;409;1276
411670;201504;1233;3427;1036;3019;241;800;413;1107;654;1907
411680;201504;1406;4402;1273;4156;213;680;857;2940;1070;3620
411690;201504;3387;10074;2708;8793;758;2603;619;2034;1377;4637
411695;201504;749;2438;603;2123;150;571;197;698;347;1269
411700;201504;1825;5326;1290;4235;265;985;302;898;567;1883
411705;201504;2139;7273;1880;6747;425;1526;1027;3830;1452;5356
411710;201504;1778;5304;1379;4443;335;1182;348;1032;683;2214
411720;201504;807;2381;612;1949;101;351;168;485;269;836
411721;201504;714;2167;610;1969;184;651;103;297;287;948
411722;201504;662;1949;479;1551;102;387;134;359;236;746
411725;201504;1375;4446;870;3139;199;764;180;628;379;1392
411727;201504;1917;5613;1515;4762;359;1234;540;1572;899;2806
411729;201504;541;1469;384;1177;125;410;83;217;208;627
411730;201504;5422;15717;4562;14098;1951;6189;1203;3765;3154;9954
411740;201504;614;1753;402;1260;71;251;141;413;212;664
411745;201504;904;2706;738;2359;168;566;223;691;391;1257
411750;201504;4558;13706;3439;11101;885;3200;764;2276;1649;5476
411760;201504;7943;23416;6899;21621;2299;7888;2032;6289;4331;14177
411770;201504;3349;11398;2824;10130;947;3674;567;1998;1514;5672
411780;201504;2615;8473;2500;8349;182;548;2079;7336;2261;7884
411790;201504;2931;8417;2165;6905;603;2247;703;2128;1306;4375
411800;201504;1433;4129;923;2991;141;532;164;426;305;958
411810;201504;1573;4658;1341;4189;316;1129;461;1276;777;2405
411820;201504;15204;47818;12570;42780;4351;15416;3310;11613;7661;27029
411830;201504;451;1212;364;1085;148;465;25;83;173;548
411840;201504;10086;29479;7657;24797;2005;7124;1783;5557;3788;12681
411845;201504;543;1674;373;1245;56;213;100;289;156;502
411850;201504;6465;19446;5403;17335;1411;4888;1578;5010;2989;9898
411860;201504;876;2728;709;2377;194;684;210;654;404;1338
411870;201504;910;3125;662;2445;104;437;178;621;282;1058
411880;201504;2177;6282;1775;5557;485;1760;407;1097;892;2857
411885;201504;839;2299;672;1979;139;532;236;608;375;1140
411890;201504;1136;3463;733;2488;125;485;117;325;242;810
411900;201504;964;3089;691;2412;180;635;110;389;290;1024
411910;201504;1224;4115;996;3557;309;1199;277;910;586;2109
411915;201504;13923;39132;9254;29519;1925;6764;2215;6474;4140;13238
411920;201504;969;3300;840;2984;231;963;144;424;375;1387
411925;201504;593;1680;394;1311;102;351;110;350;212;701
411930;201504;6028;19838;5357;18561;1888;6939;1620;5647;3508;12586
411940;201504;3290;10995;2851;10083;788;2982;688;2360;1476;5342
411950;201504;11253;35803;9442;32223;2449;9137;4179;13969;6628;23106
411960;201504;5117;15393;4687;14568;1169;4079;2041;6169;3210;10248
411965;201504;602;1705;444;1450;86;332;166;557;252;889
411970;201504;763;2172;616;1940;173;603;211;644;384;1247
411980;201504;1528;4711;1313;4261;240;835;510;1659;750;2494
411990;201504;27851;91923;23543;82787;6649;26089;6630;22870;13279;48959
411995;201504;2576;8026;2221;7320;783;2928;530;1592;1313;4520
412000;201504;2135;5627;1708;4898;297;1031;861;2247;1158;3278
412010;201504;706;2394;573;2092;124;477;120;404;244;881
412015;201504;658;1989;532;1718;104;353;249;798;353;1151
412020;201504;397;1139;269;861;66;239;101;296;167;535
412030;201504;697;2187;474;1659;82;343;124;368;206;711
412033;201504;727;2184;495;1620;100;381;119;344;219;725
412035;201504;993;2750;698;2201;165;569;274;822;439;1391
412040;201504;599;1906;482;1636;110;407;169;539;279;946
412050;201504;1685;4999;1315;4249;290;1068;270;824;560;1892
412060;201504;6582;22806;5943;21453;1800;7020;2177;7886;3977;14906
412065;201504;899;2711;705;2277;177;649;227;668;404;1317
412070;201504;1186;3229;948;2757;158;491;347;976;505;1467
412080;201504;1372;4241;809;2902;128;537;51;129;179;666
412085;201504;368;1055;152;515;38;144;36;105;74;249
412090;201504;4270;13909;4051;13512;664;2480;2652;8920;3316;11400
412100;201504;1960;6239;1714;5760;535;1956;517;1679;1052;3635
412110;201504;1069;3049;716;2293;160;564;186;580;346;1144
412120;201504;1905;6455;1667;5896;449;1817;651;2104;1100;3921
412125;201504;763;2417;664;2245;147;546;271;895;418;1441
412130;201504;617;1853;462;1510;96;360;106;317;202;677
412135;201504;508;1438;352;1121;76;274;135;391;211;665
412140;201504;1546;4658;1267;4069;318;1085;320;1013;638;2098
412150;201504;3038;8845;2596;7965;363;1273;1567;4684;1930;5957
412160;201504;1034;3333;648;2321;165;662;99;307;264;969
412170;201504;4392;13936;3572;12323;1077;4069;1299;4346;2376;8415
412175;201504;1329;4578;1162;4194;320;1295;472;1667;792;2962
412180;201504;1721;5338;1265;4428;332;1320;343;1144;675;2464
412190;201504;3044;8866;2317;7576;631;2285;662;2196;1293;4481
412200;201504;2264;7360;1584;5577;358;1376;510;1763;868;3139
412210;201504;719;2011;416;1372;85;334;55;168;140;502
412215;201504;3595;11158;3272;10585;618;2003;2029;6784;2647;8787
412217;201504;1085;3100;993;2942;130;480;698;1951;828;2431
412220;201504;5333;17705;5092;17266;1543;5468;2686;9123;4229;14591
412230;201504;2868;9591;2490;8837;655;2665;726;2405;1381;5070
412240;201504;9570;24791;5346;16687;1011;3606;926;2527;1937;6133
412250;201504;1891;5597;1624;5045;427;1476;361;950;788;2426
412260;201504;1281;3614;827;2629;142;542;272;767;414;1309
412265;201504;1022;3158;898;2940;190;735;446;1427;636;2162
412270;201504;740;2342;517;1807;113;448;132;424;245;872
412280;201504;604;1894;449;1558;213;781;42;137;255;918
412290;201504;1048;3021;816;2553;158;537;279;808;437;1345
412300;201504;1882;5679;1562;5051;469;1677;386;1199;855;2876
412310;201504;1086;3151;967;2976;121;381;615;2018;736;2399
412320;201504;800;2192;573;1787;143;506;190;587;333;1093
412330;201504;1647;4639;1285;3926;231;790;670;2019;901;2809
412340;201504;871;2730;585;1996;81;302;97;308;178;610
412350;201504;2434;7626;1975;6614;537;1948;276;789;813;2737
412360;201504;281;845;190;618;24;92;70;196;94;288
412370;201504;829;2582;673;2259;178;665;179;567;357;1232
412380;201504;1701;5319;1422;4677;367;1310;422;1312;789;2622
412382;201504;694;1992;482;1546;99;330;129;384;228;714
412385;201504;2450;7686;2179;7081;673;2308;618;1953;1291;4261
412390;201504;2151;6265;1944;5921;542;1849;763;2325;1305;4174
412395;201504;911;2561;730;2260;102;333;432;1326;534;1659
412400;201504;1016;3163;878;2890;263;920;266;889;529;1809
412402;201504;1941;5853;1570;5068;413;1502;378;1035;791;2537
412405;201504;3567;10390;2254;7454;436;1665;255;729;691;2394
412410;201504;4742;15088;4099;13832;1343;5366;832;2580;2175;7946
412420;201504;385;1141;280;903;56;207;107;281;163;488
412430;201504;510;1438;386;1187;73;260;149;417;222;677
412440;201504;3489;10566;2875;9503;563;2057;1157;3883;1720;5940
412450;201504;313;1006;242;829;42;149;36;84;78;233
412460;201504;845;2514;624;2062;155;597;163;480;318;1077
412470;201504;1847;6322;1621;5759;535;2002;538;1936;1073;3938
412480;201504;1332;3932;929;3036;194;683;131;343;325;1026
412490;201504;925;2759;804;2505;164;540;254;731;418;1271
412500;201504;1975;5769;1657;5143;392;1383;416;1089;808;2472
412510;201504;2282;7639;1964;6852;546;2073;843;2913;1389;4986
412520;201504;1551;4418;1215;3743;320;1062;318;925;638;1987
412530;201504;665;1936;539;1668;118;366;155;461;273;827
412535;201504;606;1794;383;1260;94;332;75;209;169;541
412540;201504;1192;3458;930;2918;148;531;280;870;428;1401
412545;201504;859;2465;672;2047;106;386;258;686;364;1072
412550;201504;27138;81749;18618;62581;4938;17954;3545;11099;8483;29053
412555;201504;326;986;224;742;44;166;44;116;88;282
412560;201504;5253;16651;4152;14340;1018;4038;989;3137;2007;7175
412570;201504;4368;13108;3047;10101;722;2740;562;1720;1284;4460
412575;201504;909;2790;718;2343;168;617;195;585;363;1202
412580;201504;1281;3531;928;2919;197;649;258;767;455;1416
412590;201504;420;1241;289;954;67;251;83;269;150;520
412600;201504;1441;4384;1155;3771;287;1050;358;1088;645;2138
412610;201504;670;2037;473;1526;118;445;151;420;269;865
412620;201504;1180;3839;931;3292;257;1029;153;491;410;1520
412625;201504;10740;29928;8089;24860;2046;6858;1546;4328;3592;11186
412627;201504;970;2945;644;2242;204;768;58;182;262;950
412630;201504;3303;10551;2812;9492;671;2400;911;2967;1582;5367
412635;201504;462;1416;311;1067;74;272;23;68;97;340
412640;201504;894;2666;620;2059;123;436;77;212;200;648
412650;201504;1985;5840;1625;5130;396;1446;524;1435;920;2881
412660;201504;2866;8400;2257;7143;468;1670;462;1305;930;2975
412665;201504;650;1677;340;1079;92;307;71;218;163;525
412667;201504;1545;4593;1223;3941;310;1140;266;788;576;1928
412670;201504;668;2071;449;1547;104;407;77;211;181;618
412680;201504;1339;4040;863;2953;171;658;225;674;396;1332
412690;201504;727;2260;550;1865;195;700;111;370;306;1070
412700;201504;1843;5778;1562;5339;570;2205;481;1578;1051;3783
412710;201504;8117;25425;6779;22665;1713;6373;1674;5251;3387;11624
412720;201504;1473;4600;1021;3433;193;713;180;498;373;1211
412730;201504;2247;6718;1463;4918;321;1214;178;443;499;1657
412740;201504;1394;4495;1117;3878;294;1140;222;776;516;1916
412750;201504;3796;11946;3391;11275;561;2202;2170;7088;2731;9290
412760;201504;2312;7616;2198;7423;567;2231;1108;3551;1675;5782
412770;201504;11466;32080;6802;21900;1138;4073;1267;3556;2405;7629
412780;201504;1267;4074;1107;3743;290;1064;381;1212;671;2276
412785;201504;2325;6792;1700;5465;407;1459;781;2427;1188;3886
412788;201504;1422;4587;1282;4302;290;1117;467;1409;757;2526
412790;201504;1172;3532;940;3064;216;787;251;729;467;1516
412795;201504;858;2424;713;2148;198;618;219;646;417;1264
412796;201504;2823;8798;2609;8396;710;2584;1042;3116;1752;5700
412800;201504;3214;9174;2417;7564;497;1753;809;2411;1306;4164
412810;201504;10500;28961;5943;18950;1021;3631;1219;3252;2240;6883
412820;201504;6919;20462;5001;16686;1277;4650;1085;3633;2362;8283
412830;201504;340;1057;274;912;64;263;83;239;147;502
412840;201504;1928;5561;1554;4823;334;1145;372;1064;706;2209
412850;201504;2568;7746;2191;7136;426;1638;980;3007;1406;4645
412853;201504;1525;4354;1364;4071;155;599;810;2221;965;2820
412855;201504;1521;4387;1168;3632;316;1115;320;884;636;1999
412860;201504;1216;3530;1014;3151;223;782;434;1307;657;2089
412862;201504;764;1986;529;1528;84;266;209;560;293;826
412863;201504;1265;4253;1220;4179;196;731;837;2849;1033;3580
412865;201504;695;2149;519;1728;112;395;197;672;309;1067
412870;201504;913;2585;736;2299;249;856;182;531;431;1387
412880;201504;1076;3004;843;2590;212;728;229;625;441;1353
420005;201504;547;1645;361;1223;76;277;128;418;204;695
420010;201504;3194;9410;2623;8541;351;1222;1891;6303;2242;7525
420020;201504;799;2607;474;1739;72;323;56;166;128;489
420030;201504;541;1457;284;962;63;252;44;141;107;393
420040;201504;840;2585;530;1936;127;503;76;215;203;718
420050;201504;716;2194;537;1784;166;584;189;589;355;1173
420055;201504;240;714;150;499;31;108;29;84;60;192
420060;201504;247;835;172;637;45;191;26;85;71;276
420070;201504;1395;4467;1116;3790;184;680;565;1954;749;2634
420075;201504;196;565;108;361;22;86;32;95;54;181
420080;201504;625;1984;495;1710;162;602;119;407;281;1009
420090;201504;539;1844;398;1530;111;461;69;261;180;722
420100;201504;1329;4223;1201;4044;300;1068;690;2331;990;3399
420110;201504;358;1204;316;1113;91;342;127;446;218;788
420120;201504;317;1095;269;996;89;366;63;215;152;581
420125;201504;308;1200;281;1141;92;387;95;359;187;746
420127;201504;549;1646;219;808;68;264;25;88;93;352
420130;201504;1966;6554;1644;5924;433;1726;494;1597;927;3323
420140;201504;5408;15832;3757;12676;981;3694;651;1980;1632;5674
420150;201504;775;2160;464;1520;101;372;156;455;257;827
420160;201504;305;876;193;634;34;127;53;160;87;287
420165;201504;218;690;134;468;26;103;33;102;59;205
420170;201504;212;647;139;502;45;201;19;45;64;246
420180;201504;435;1344;253;912;44;164;52;181;96;345
420190;201504;511;1534;276;990;52;209;43;134;95;343
420195;201504;1424;4119;1132;3669;287;994;476;1569;763;2563
420200;201504;3025;9817;1925;7223;542;2290;320;1067;862;3357
420205;201504;956;3162;837;2948;199;770;407;1414;606;2184
420207;201504;1501;4397;1035;3410;304;1144;264;775;568;1919
420208;201504;535;1523;334;1155;108;404;97;326;205;730
420209;201504;343;1088;215;775;43;179;69;234;112;413
420210;201504;1596;4893;1009;3814;231;1077;205;703;436;1780
420213;201504;851;3036;806;2928;146;549;518;1929;664;2478
420215;201504;413;1352;282;1018;80;313;48;158;128;471
420220;201504;195;680;174;639;46;197;60;168;106;365
420230;201504;4333;12845;3178;10690;669;2640;1379;4427;2048;7067
420240;201504;12445;33999;7481;24770;1235;5050;3048;8986;4283;14036
420243;201504;616;1890;487;1615;107;415;171;541;278;956
420245;201504;1119;3382;743;2570;160;621;180;536;340;1157
420250;201504;605;1972;571;1913;170;669;250;796;420;1465
420253;201504;563;1499;449;1338;81;261;243;750;324;1011
420257;201504;325;943;218;743;38;139;112;378;150;517
420260;201504;1278;4070;1081;3720;248;981;491;1678;739;2659
420270;201504;519;1604;152;566;26;106;34;109;60;215
420280;201504;2423;6496;1470;4749;290;1114;538;1541;828;2655
420285;201504;154;459;65;240;6;24;3;16;9;40
420287;201504;594;1830;505;1664;135;464;174;573;309;1037
420290;201504;6711;19763;4314;14305;895;3278;1294;3943;2189;7221
420300;201504;6547;20031;4338;15309;1023;4042;839;2910;1862;6952
420310;201504;795;2303;734;2213;131;425;487;1432;618;1857
420315;201504;981;3175;781;2762;222;870;295;1028;517;1898
420320;201504;5435;16874;4504;15204;1270;4768;1829;6049;3099;10817
420325;201504;357;1171;335;1125;81;303;128;414;209;717
420330;201504;1113;3878;851;3168;221;913;213;684;434;1597
420340;201504;1488;4630;1135;3815;246;913;232;711;478;1624
420350;201504;1413;4406;1147;3868;296;1067;461;1535;757;2602
420360;201504;3213;9922;2185;7589;599;2356;295;855;894;3211
420370;201504;1995;5577;1612;4973;158;479;1310;4080;1468;4559
420380;201504;4947;16021;3761;13200;1004;3909;941;3164;1945;7073
420390;201504;1708;4866;915;3152;193;764;191;547;384;1311
420395;201504;1623;5065;1125;3908;189;745;174;494;363;1239
420400;201504;1376;4029;963;3208;262;1036;263;786;525;1822
420410;201504;802;2141;544;1712;133;468;290;895;423;1363
420415;201504;471;1501;347;1193;119;433;96;313;215;746
420417;201504;789;2518;667;2216;118;417;344;1139;462;1556
420419;201504;413;1275;271;990;118;478;41;141;159;619
420420;201504;12130;36394;9318;30732;2882;10723;2597;7948;5479;18671
420425;201504;1356;3729;874;2747;96;370;365;1039;461;1409
420430;201504;3479;10668;2249;7810;518;2002;746;2540;1264;4542
420435;201504;288;903;203;704;42;176;98;321;140;497
420440;201504;1227;3437;655;2217;258;957;108;332;366;1289
420445;201504;336;1025;290;935;61;201;150;486;211;687
420450;201504;1101;3127;628;2130;120;449;135;388;255;837
420455;201504;2010;6166;1765;5741;356;1399;852;2686;1208;4085
420460;201504;9099;27149;6911;23212;1638;6425;2625;8338;4263;14763
420470;201504;1228;3312;759;2411;200;729;208;593;408;1322
420475;201504;131;400;69;249;19;74;9;27;28;101
420480;201504;4801;14241;3798;12472;1455;5385;514;1554;1969;6939
420490;201504;746;2019;431;1466;115;412;111;361;226;773
420500;201504;1868;5849;1464;5080;455;1767;638;2153;1093;3920
420510;201504;118;478;106;450;43;186;38;155;81;341
420515;201504;118;403;96;357;18;78;17;65;35;143
420517;201504;902;2798;809;2631;146;531;474;1514;620;2045
420519;201504;479;1328;351;1083;61;201;112;322;173;523
420520;201504;673;1725;478;1464;114;397;265;790;379;1187
420530;201504;1172;3912;890;3225;222;920;208;620;430;1540
420535;201504;274;822;159;560;51;210;16;41;67;251
420540;201504;21632;62733;15344;49097;4121;14549;4207;12050;8328;26599
420543;201504;427;1138;314;946;32;116;188;603;220;719
420545;201504;1669;5228;1333;4511;327;1278;439;1360;766;2638
420550;201504;4473;14396;3432;12076;857;3554;798;2493;1655;6047
420555;201504;447;1379;353;1188;105;394;112;348;217;742
420560;201504;554;1613;473;1456;81;264;236;718;317;982
420570;201504;2043;6642;1636;5693;463;1832;529;1718;992;3550
420580;201504;1329;4263;1080;3829;307;1243;470;1631;777;2874
420590;201504;3266;9986;2224;7566;505;1881;399;1186;904;3067
420600;201504;816;2718;743;2554;150;552;347;1232;497;1784
420610;201504;551;1719;331;1212;94;382;69;229;163;611
420620;201504;851;2601;723;2374;222;786;221;714;443;1500
420630;201504;1105;3428;776;2653;174;647;237;709;411;1356
420640;201504;739;2284;360;1348;88;372;29;89;117;461
420650;201504;2358;7010;1401;4857;252;997;267;809;519;1806
420660;201504;520;1502;418;1311;80;294;197;591;277;885
420665;201504;780;2195;491;1612;81;279;142;424;223;703
420670;201504;1720;5304;1232;4209;244;968;265;784;509;1752
420675;201504;222;676;152;514;28;105;53;167;81;272
420680;201504;537;1298;325;976;65;221;108;297;173;518
420690;201504;892;3076;649;2383;122;460;157;505;279;965
420700;201504;3720;10704;2806;8845;658;2422;867;2547;1525;4969
420710;201504;612;2063;478;1791;145;600;154;561;299;1161
420720;201504;1657;4865;1335;4431;289;1028;819;2742;1108;3770
420730;201504;3491;10475;2845;9320;762;2760;1128;3518;1890;6278
420740;201504;859;2678;707;2397;204;732;357;1194;561;1926
420750;201504;2379;7544;1635;5769;301;1256;504;1540;805;2796
420757;201504;113;297;62;221;13;59;23;72;36;131
420760;201504;345;1066;235;775;47;180;55;149;102;329
420765;201504;586;1840;300;1113;59;247;49;156;108;403
420768;201504;1218;4263;950;3658;313;1275;329;1248;642;2523
420770;201504;710;2037;373;1300;75;313;91;284;166;597
420775;201504;702;2228;447;1534;120;421;97;306;217;727
420780;201504;1659;5031;1055;3528;270;988;204;600;474;1588
420785;201504;324;987;231;743;40;145;74;209;114;354
420790;201504;1345;4643;1064;3947;294;1212;426;1478;720;2690
420800;201504;829;2380;451;1505;134;517;90;267;224;784
420810;201504;2412;8241;1907;7072;602;2535;474;1676;1076;4211
420820;201504;8466;26706;6167;22601;1784;7409;1829;6614;3613;14023
420830;201504;2581;8333;2163;7573;732;2804;769;2634;1501;5438
420840;201504;1037;3029;594;2139;159;653;153;490;312;1143
420845;201504;1355;4238;1023;3608;309;1258;237;756;546;2014
420850;201504;1752;5525;1050;4007;284;1232;152;558;436;1790
420860;201504;501;1415;316;1067;92;363;134;445;226;808
420870;201504;1233;3431;934;2996;311;1157;303;867;614;2024
420880;201504;1188;3952;926;3276;207;815;194;603;401;1418
420890;201504;13351;32338;5932;18828;1061;3785;1704;4649;2765;8434
420895;201504;244;665;123;398;34;107;13;35;47;142
420900;201504;2164;6032;1295;4321;284;1074;319;943;603;2017
420910;201504;21669;64858;14140;49306;2945;11789;4175;13505;7120;25294
420915;201504;584;2293;463;1951;116;530;216;874;332;1404
420917;201504;465;1428;221;708;53;201;84;218;137;419
420920;201504;199;557;88;301;30;106;12;38;42;144
420930;201504;18933;54892;15011;48274;3846;13875;5294;16505;9140;30380
420940;201504;4054;12168;3281;10520;876;3208;750;2003;1626;5211
420945;201504;215;683;137;494;31;128;30;104;61;232
420950;201504;625;1767;282;1057;40;192;34;107;74;299
420960;201504;1120;3262;936;2960;211;807;438;1276;649;2083
420970;201504;2500;8041;2186;7477;618;2390;923;3153;1541;5543
420980;201504;437;1335;334;1154;112;407;139;527;251;934
420985;201504;523;1497;264;930;59;238;74;242;133;480
420990;201504;900;2489;527;1802;103;408;167;511;270;919
421000;201504;583;1998;386;1485;86;368;62;202;148;570
421003;201504;703;1924;273;910;37;136;41;85;78;221
421005;201504;222;700;178;625;48;185;90;307;138;492
421010;201504;6041;17506;4174;14025;1153;4431;1007;3003;2160;7434
421020;201504;522;1670;406;1447;67;241;205;776;272;1017
421030;201504;948;3468;877;3293;287;1144;260;989;547;2133
421040;201504;726;2062;565;1790;125;453;266;796;391;1249
421050;201504;1995;5427;1169;3829;293;1089;263;701;556;1790
421055;201504;234;710;134;465;36;140;37;103;73;243
421060;201504;512;1783;376;1391;71;294;131;454;202;748
421070;201504;763;2395;498;1746;121;483;110;368;231;851
421080;201504;533;1619;462;1501;95;323;275;874;370;1197
421085;201504;571;1523;305;1041;67;263;79;281;146;544
421090;201504;416;1166;246;795;42;155;101;301;143;456
421100;201504;987;2897;658;2189;173;583;136;413;309;996
421105;201504;1471;4561;1232;4143;291;1067;478;1643;769;2710
421110;201504;1160;4130;1042;3899;391;1571;265;949;656;2520
421120;201504;1549;4885;1070;3733;183;760;321;985;504;1745
421125;201504;423;1205;311;1002;90;333;110;326;200;659
421130;201504;3537;11588;2961;10518;1026;4091;948;3332;1974;7423
421140;201504;374;1122;290;937;55;189;107;319;162;508
421145;201504;580;1861;400;1365;60;221;172;570;232;791
421150;201504;556;1738;418;1493;102;404;163;579;265;983
421160;201504;1227;3507;633;2128;118;460;233;744;351;1204
421165;201504;286;997;222;801;41;146;101;369;142;515
421170;201504;1545;4617;1259;4131;272;999;742;2406;1014;3405
421175;201504;1241;3547;927;3043;220;922;363;1050;583;1972
421180;201504;611;1712;330;1116;79;304;93;266;172;570
421185;201504;425;1192;302;953;56;170;149;491;205;661
421187;201504;310;938;231;772;48;166;110;362;158;528
421189;201504;465;1439;409;1332;88;310;153;472;241;782
421190;201504;11418;33494;7125;24490;1657;6157;1534;4920;3191;11077
421200;201504;979;3263;840;2971;207;821;285;946;492;1767
421205;201504;253;785;189;660;46;196;46;129;92;325
421210;201504;1676;5112;1293;4173;353;1216;376;1149;729;2365
421220;201504;2168;7333;1881;6720;620;2442;480;1661;1100;4103
421223;201504;750;2162;498;1701;122;449;183;610;305;1059
421225;201504;1147;3584;946;3176;228;849;347;1143;575;1992
421227;201504;812;2701;714;2546;157;567;454;1658;611;2225
421230;201504;589;1941;516;1781;130;501;207;660;337;1161
421240;201504;474;1543;275;975;37;146;58;185;95;331
421250;201504;1857;5413;1193;4211;372;1468;273;895;645;2363
421260;201504;385;1109;122;460;25;95;29;102;54;197
421265;201504;592;1921;510;1763;118;430;198;674;316;1104
421270;201504;815;2206;432;1436;118;421;107;386;225;807
421280;201504;1672;5278;1341;4742;412;1628;467;1632;879;3260
421290;201504;1679;4424;900;2887;185;639;191;511;376;1150
421300;201504;312;959;255;837;74;278;106;327;180;605
421310;201504;317;1036;250;863;60;218;78;252;138;470
421315;201504;396;1177;222;797;40;148;23;82;63;230
421320;201504;541;1772;355;1281;65;254;50;127;115;381
421330;201504;534;1813;429;1609;157;675;66;241;223;916
421335;201504;580;1887;465;1664;116;461;96;359;212;820
421340;201504;1770;5225;1464;4717;218;846;905;2865;1123;3711
421350;201504;909;2995;724;2591;174;714;235;769;409;1483
421360;201504;3179;9174;2022;6918;433;1703;606;1886;1039;3589
421370;201504;794;2622;636;2271;186;756;208;690;394;1446
421380;201504;1047;3010;840;2625;158;559;403;1243;561;1802
421390;201504;149;437;78;270;11;35;35;128;46;163
421400;201504;313;1127;240;956;77;336;64;241;141;577
421410;201504;337;979;233;773;35;114;124;421;159;535
421415;201504;354;1175;176;662;46;184;44;149;90;333
421420;201504;941;2866;661;2207;130;480;169;501;299;981
421430;201504;247;782;188;664;41;163;41;142;82;305
421440;201504;904;2604;600;2036;153;583;234;745;387;1328
421450;201504;581;1835;387;1419;97;399;59;186;156;585
421460;201504;648;1751;326;1135;55;227;76;248;131;475
421470;201504;445;1545;354;1337;96;387;141;524;237;911
421480;201504;2805;8083;1681;5929;392;1624;376;1147;768;2771
421490;201504;300;930;136;527;39;172;25;83;64;255
421500;201504;2383;8115;2027;7374;731;3020;410;1421;1141;4441
421505;201504;397;1325;349;1219;81;305;161;545;242;850
421507;201504;610;1873;401;1404;74;266;146;529;220;795
421510;201504;209;705;184;660;38;173;90;277;128;450
421520;201504;849;2263;556;1660;57;227;280;745;337;972
421530;201504;422;1304;243;901;43;199;80;290;123;489
421535;201504;714;2123;407;1468;72;288;192;650;264;938
421540;201504;373;1021;298;885;65;212;122;345;187;557
421545;201504;1031;3422;781;2906;215;939;179;596;394;1535
421550;201504;2001;6564;1717;6033;539;2191;495;1607;1034;3798
421555;201504;347;1050;141;511;24;95;21;71;45;166
421560;201504;229;713;107;383;23;94;23;79;46;173
421565;201504;968;2924;868;2761;323;1154;332;1002;655;2156
421567;201504;886;3250;760;2933;364;1461;149;560;513;2021
421568;201504;536;1690;377;1321;100;368;99;350;199;718
421569;201504;187;579;107;394;26;110;27;88;53;198
421570;201504;1332;4121;714;2581;205;822;140;489;345;1311
421575;201504;507;1702;443;1573;74;289;271;959;345;1248
421580;201504;3651;11549;2792;9654;796;3165;682;2037;1478;5202
421590;201504;238;741;194;658;34;120;107;355;141;475
421600;201504;609;1826;462;1523;127;464;102;303;229;767
421605;201504;637;1931;451;1570;95;398;119;364;214;762
421610;201504;1590;4323;1285;3839;193;672;739;2123;932;2795
421620;201504;4877;14748;3321;11480;980;3675;1074;3722;2054;7397
421625;201504;379;1109;183;630;29;111;50;172;79;283
421630;201504;2804;8346;1558;5363;381;1490;223;656;604;2146
421635;201504;274;830;167;559;25;96;83;255;108;351
421640;201504;1077;3283;834;2785;153;515;461;1553;614;2068
421650;201504;2227;7264;1834;6390;616;2442;298;891;914;3333
421660;201504;8796;28092;6885;24230;1875;7469;2168;7057;4043;14526
421670;201504;1095;3423;760;2660;224;867;212;708;436;1575
421680;201504;1249;4120;1076;3707;374;1385;208;668;582;2053
421690;201504;1926;6294;1474;5195;340;1330;223;697;563;2027
421700;201504;618;1795;330;1136;73;299;92;237;165;536
421710;201504;274;918;155;574;48;188;44;159;92;347
421715;201504;284;770;158;507;43;150;45;130;88;280
421720;201504;1789;5421;1168;4141;387;1531;280;915;667;2446
421725;201504;114;385;105;365;36;140;26;88;62;228
421730;201504;624;1840;306;1083;65;247;57;162;122;409
421740;201504;728;2232;493;1681;116;464;98;237;214;701
421750;201504;1182;3254;790;2468;160;553;352;1002;512;1555
421755;201504;361;1098;240;799;55;217;74;219;129;436
421760;201504;647;2124;365;1313;78;325;123;401;201;726
421770;201504;3089;9261;2326;7714;681;2411;749;2485;1430;4896
421775;201504;605;1755;393;1372;87;322;115;382;202;704
421780;201504;1440;4758;1077;3943;302;1243;393;1352;695;2595
421790;201504;940;2570;543;1898;140;574;166;525;306;1099
421795;201504;359;1065;232;747;35;133;71;222;106;355
421800;201504;2667;8085;1991;6778;445;1756;794;2490;1239;4246
421810;201504;727;2315;544;1914;141;521;79;262;220;783
421820;201504;1175;3437;765;2607;130;504;188;560;318;1064
421825;201504;1514;4972;1415;4740;239;951;870;2781;1109;3732
421830;201504;2629;9041;2395;8576;556;2270;1162;4040;1718;6310
421835;201504;152;447;111;385;26;117;63;199;89;316
421840;201504;377;1237;297;1049;74;297;101;328;175;625
421850;201504;494;1446;311;1048;76;290;94;308;170;598
421860;201504;367;1131;229;829;38;145;46;147;84;292
421870;201504;4786;13524;3276;10484;944;3260;632;1919;1576;5179
421875;201504;442;1322;196;738;45;199;34;115;79;314
421880;201504;978;3062;758;2576;177;698;199;613;376;1311
421885;201504;336;1091;274;970;81;300;95;325;176;625
421890;201504;983;3312;834;2999;263;1089;268;904;531;1993
421895;201504;374;1230;334;1153;72;247;195;700;267;947
421900;201504;774;2442;606;2047;167;588;163;493;330;1081
421910;201504;539;1695;386;1352;82;329;116;362;198;691
421915;201504;576;1734;385;1284;80;277;101;292;181;569
421917;201504;580;1745;438;1499;125;512;153;477;278;989
421920;201504;805;2257;533;1885;223;829;182;639;405;1468
421930;201504;3433;9307;2055;6830;518;1934;393;1180;911;3114
421935;201504;778;2655;596;2245;138;609;209;734;347;1343
421940;201504;267;919;164;616;30;135;36;104;66;239
421950;201504;4162;11555;2128;7217;561;2036;364;1193;925;3229
421960;201504;236;729;187;617;46;166;48;139;94;305
421970;201504;2227;6438;1455;4754;522;1814;320;947;842;2761
421985;201504;512;1317;275;840;47;171;83;260;130;431
422000;201504;965;2869;788;2541;191;661;339;1120;530;1781
430003;201504;859;2499;667;2162;186;682;205;635;391;1317
430005;201504;283;898;234;795;44;158;131;439;175;597
430010;201504;2156;5910;1602;4952;409;1329;646;2028;1055;3357
430020;201504;791;1992;656;1799;80;257;462;1217;542;1474
430030;201504;1128;2954;849;2453;288;917;177;457;465;1374
430040;201504;11897;30819;9481;26801;2838;8543;2681;7335;5519;15878
430045;201504;744;2074;592;1766;107;356;323;943;430;1299
430047;201504;275;686;163;497;23;65;71;216;94;281
430050;201504;1175;3163;699;2202;139;477;186;538;325;1015
430055;201504;307;853;183;570;26;90;89;267;115;357
430057;201504;71;158;25;68;5;13;6;11;11;24
430060;201504;16039;51791;13975;48153;3915;14266;6701;23484;10616;37750
430063;201504;1026;3024;827;2603;215;704;399;1290;614;1994
430064;201504;1621;4768;1334;4288;357;1177;607;1991;964;3168
430066;201504;177;454;133;386;15;59;77;206;92;265
430070;201504;598;1604;250;810;56;203;67;178;123;381
430080;201504;709;2071;470;1616;105;411;141;443;246;854
430085;201504;774;2096;524;1656;127;454;196;600;323;1054
430087;201504;1043;3178;986;3074;127;440;701;2129;828;2569
430090;201504;886;2338;327;1079;43;168;59;193;102;361
430100;201504;936;2513;562;1729;151;516;166;442;317;958
430105;201504;880;2704;642;2247;178;716;173;567;351;1283
430107;201504;257;865;195;677;35;132;61;197;96;329
430110;201504;1884;5440;1594;4991;432;1449;717;2186;1149;3635
430120;201504;1711;5079;1310;4240;264;909;699;2220;963;3129
430130;201504;4034;10538;3522;9789;665;2015;1929;5305;2594;7320
430140;201504;1236;3804;890;3041;259;913;293;978;552;1891
430150;201504;873;2313;580;1770;146;489;148;431;294;920
430155;201504;458;1326;290;974;41;144;119;394;160;538
430160;201504;16343;48289;14886;45943;2834;9746;8504;26210;11338;35956
430163;201504;1846;5517;1538;4961;299;1095;762;2475;1061;3570
430165;201504;457;1131;141;457;29;101;42;123;71;224
430170;201504;899;2531;387;1352;73;267;59;172;132;439
430175;201504;970;3058;782;2608;196;603;333;1208;529;1811
430180;201504;956;2599;784;2314;169;570;423;1194;592;1764
430185;201504;789;1968;407;1239;66;214;113;292;179;506
430187;201504;679;2022;518;1675;127;481;182;528;309;1009
430190;201504;1768;5289;1546;4862;311;1127;894;2747;1205;3874
430192;201504;194;594;92;291;7;22;22;59;29;81
430195;201504;322;984;89;316;9;32;6;22;15;54
430200;201504;1718;5502;1453;4940;420;1514;370;1244;790;2758
430205;201504;501;1439;381;1224;47;185;256;801;303;986
430210;201504;6599;17708;3604;11376;745;2557;773;2218;1518;4775
430215;201504;374;1070;259;823;50;175;108;330;158;505
430220;201504;789;1983;312;1015;48;167;56;173;104;340
430222;201504;302;908;234;763;37;156;108;330;145;486
430223;201504;350;1018;306;953;64;201;191;618;255;819
430225;201504;47;126;27;83;6;16;8;20;14;36
430230;201504;1895;5915;1770;5789;195;486;1534;5218;1729;5704
430235;201504;280;919;221;776;59;229;54;171;113;400
430237;201504;526;1408;390;1166;47;173;255;737;302;910
430240;201504;985;2584;651;2008;145;534;267;771;412;1305
430245;201504;945;2947;724;2473;184;653;333;1167;517;1820
430250;201504;1413;3971;1242;3676;509;1587;298;874;807;2461
430258;201504;167;475;123;394;13;48;51;164;64;212
430260;201504;854;2402;582;1854;66;232;310;1015;376;1247
430265;201504;333;1017;262;864;78;253;33;97;111;350
430270;201504;2947;8303;2569;7679;442;1585;1505;4248;1947;5833
430280;201504;4658;12909;3845;11440;925;2916;1779;5264;2704;8180
430290;201504;2484;6614;2275;6341;181;511;1966;5553;2147;6064
430300;201504;9562;28385;7787;24968;2245;7685;3148;10314;5393;17999
430310;201504;7168;22141;5884;19709;1605;5884;2348;7475;3953;13359
430320;201504;884;2577;589;1979;111;328;290;1035;401;1363
430330;201504;789;2109;621;1784;171;503;270;714;441;1217
430340;201504;788;1982;444;1468;87;326;213;707;300;1033
430350;201504;6365;19826;5384;17752;1903;6625;1827;5862;3730;12487
430355;201504;368;917;144;436;31;102;22;50;53;152
430360;201504;1098;2866;913;2524;166;520;448;1152;614;1672
430367;201504;313;811;195;603;45;157;60;179;105;336
430370;201504;508;1456;383;1213;110;387;91;252;201;639
430380;201504;885;2260;471;1495;122;412;168;547;290;959
430390;201504;4551;13091;3227;10373;778;2686;810;2498;1588;5184
430400;201504;1444;3469;1006;2796;307;935;397;1012;704;1947
430410;201504;708;1892;530;1590;96;306;270;816;366;1122
430420;201504;4039;11659;3139;9683;827;2688;1294;3925;2121;6613
430430;201504;836;2282;528;1695;149;515;139;429;288;944
430435;201504;2008;5456;1559;4652;349;1136;773;2284;1122;3420
430440;201504;4318;13428;3379;11362;628;2226;1671;5824;2299;8050
430450;201504;7826;21990;6132;18678;2223;7199;1496;4518;3719;11717
430460;201504;28804;85382;22323;73694;6256;22506;7674;25210;13930;47716
430461;201504;510;1386;170;536;30;107;42;127;72;234
430462;201504;314;897;231;749;85;307;59;178;144;485
430463;201504;4128;13160;3577;12127;819;3040;1768;6009;2587;9049
430465;201504;659;1781;555;1603;125;403;319;892;444;1295
430466;201504;3708;10354;3289;9700;657;2176;1882;5380;2539;7556
430467;201504;586;1739;511;1620;110;381;241;728;351;1109
430468;201504;1482;4211;1297;3936;453;1480;441;1314;894;2794
430469;201504;261;741;67;245;9;38;16;55;25;93
430470;201504;7707;20543;5439;16679;1655;5499;1082;3221;2737;8720
430471;201504;840;2752;754;2573;246;869;190;662;436;1531
430480;201504;1058;2811;564;1800;84;285;137;385;221;670
430485;201504;226;655;109;372;20;73;36;121;56;194
430490;201504;458;1296;315;1030;89;307;111;363;200;670
430495;201504;405;1200;260;891;52;198;62;189;114;387
430500;201504;1355;3764;1097;3322;333;1134;461;1353;794;2487
430510;201504;20469;61201;16761;54077;5857;20754;4945;14932;10802;35686
430511;201504;469;1404;207;710;22;84;31;87;53;171
430512;201504;1235;3216;1074;2942;281;804;386;1099;667;1903
430513;201504;760;2081;488;1501;91;284;218;677;309;961
430515;201504;517;1519;385;1238;66;217;196;631;262;848
430517;201504;1373;4374;1164;3938;235;827;683;2319;918;3146
430520;201504;1639;4598;1178;3643;317;1084;435;1253;752;2337
430530;201504;1000;2801;529;1706;90;336;142;411;232;747
430535;201504;2182;6772;1718;5793;409;1580;613;1995;1022;3575
430537;201504;519;1625;440;1463;54;171;316;1077;370;1248
430540;201504;764;1726;517;1404;96;269;308;829;404;1098
430543;201504;536;1393;473;1329;90;279;348;976;438;1255
430544;201504;712;2267;593;2016;122;446;314;1043;436;1489
430545;201504;1326;4267;1141;4040;373;1352;561;2122;934;3474
430550;201504;692;2016;454;1512;107;398;155;505;262;903
430558;201504;88;256;43;150;15;65;6;14;21;79
430560;201504;418;1041;246;736;29;100;82;234;111;334
430570;201504;1172;3001;758;2198;196;668;320;806;516;1474
430580;201504;1284;3367;758;2424;223;763;215;698;438;1461
430583;201504;162;446;54;181;4;15;3;11;7;26
430585;201504;369;968;243;701;60;195;108;283;168;478
430587;201504;227;688;193;623;58;200;66;220;124;420
430590;201504;1382;3857;1310;3744;212;677;936;2648;1148;3325
430593;201504;26;100;23;89;6;32;9;28;15;60
430595;201504;264;719;93;319;19;75;15;48;34;123
430597;201504;360;1046;262;821;47;168;77;204;124;372
430600;201504;2232;6063;1293;3988;262;859;411;1237;673;2096
430605;201504;1364;4154;1083;3583;239;878;451;1509;690;2387
430607;201504;803;2011;594;1689;91;269;363;1053;454;1322
430610;201504;8751;23367;6688;20094;1787;5879;2409;7199;4196;13078
430613;201504;264;645;115;347;26;70;26;67;52;137
430620;201504;772;2219;602;1860;152;522;251;717;403;1239
430630;201504;464;1408;234;772;49;159;37;107;86;266
430632;201504;754;2074;432;1349;80;288;203;585;283;873
430635;201504;709;1941;518;1577;107;355;250;749;357;1104
430637;201504;513;1476;454;1353;67;241;291;827;358;1068
430640;201504;1729;4575;769;2486;73;237;104;228;177;465
430642;201504;513;1351;310;981;59;199;121;377;180;576
430645;201504;217;568;101;311;18;55;26;86;44;141
430650;201504;1911;6236;1647;5707;335;1178;963;3439;1298;4617
430655;201504;203;576;171;510;33;111;72;177;105;288
430660;201504;5786;16406;4541;14212;1168;4027;1827;5664;2995;9691
430670;201504;510;1504;459;1403;35;107;346;1095;381;1202
430673;201504;716;1722;367;1121;84;272;143;426;227;698
430675;201504;290;849;131;426;25;91;49;150;74;241
430676;201504;3576;10819;3035;9879;845;2947;1082;3554;1927;6501
430680;201504;1157;3429;836;2736;169;627;297;864;466;1491
430690;201504;4477;12663;3582;10923;1118;3571;1141;3538;2259;7109
430692;201504;312;1048;224;872;27;110;143;553;170;663
430693;201504;1445;4021;980;3054;174;649;280;782;454;1431
430695;201504;540;1526;384;1211;85;311;144;400;229;711
430697;201504;481;1360;368;1165;105;329;141;478;246;807
430700;201504;9781;25374;4635;15282;866;3184;370;1157;1236;4341
430705;201504;296;904;262;849;82;292;77;225;159;517
430710;201504;1846;4729;1386;3959;305;948;587;1692;892;2640
430720;201504;924;2272;615;1825;169;549;230;683;399;1232
430730;201504;1773;4718;1253;3860;313;948;549;1787;862;2735
430740;201504;593;1645;345;1133;91;321;60;183;151;504
430745;201504;547;1538;314;967;60;205;65;176;125;381
430750;201504;1810;4968;1440;4329;302;1013;706;2020;1008;3033
430755;201504;579;1529;372;1090;43;152;161;414;204;566
430760;201504;3308;8103;2317;6677;446;1469;1100;3293;1546;4762
430770;201504;6808;19605;5307;16847;1017;3550;2773;8709;3790;12259
430780;201504;2484;6616;1461;4625;302;1046;491;1503;793;2549
430781;201504;593;1719;410;1351;102;351;124;391;226;742
430783;201504;566;1394;386;1103;77;250;184;487;261;737
430786;201504;86;281;62;215;12;40;23;83;35;123
430790;201504;4646;12706;3152;9680;674;2342;1220;3469;1894;5811
430800;201504;866;2532;581;1864;127;439;194;588;321;1027
430805;201504;522;1443;371;1174;45;134;212;704;257;838
430807;201504;409;1175;273;868;59;219;76;219;135;438
430810;201504;765;2103;379;1238;61;225;66;188;127;413
430820;201504;1226;3837;876;2953;217;793;257;816;474;1609
430825;201504;443;1184;202;619;32;109;69;183;101;292
430830;201504;2165;6568;1989;6311;205;679;1493;4789;1698;5468
430840;201504;994;3048;902;2871;228;740;431;1416;659;2156
430843;201504;107;314;55;183;8;25;22;73;30;98
430845;201504;348;1046;282;909;110;384;34;101;144;485
430850;201504;2865;8522;2430;7721;616;2147;944;2921;1560;5068
430860;201504;999;2696;555;1850;164;646;146;424;310;1070
430865;201504;694;1840;635;1744;221;633;301;805;522;1438
430870;201504;714;1998;399;1330;106;366;92;280;198;646
430880;201504;1284;3603;933;2922;292;1004;245;789;537;1793
430885;201504;216;586;139;461;28;98;69;228;97;326
430890;201504;1844;4847;1279;3777;93;335;556;1547;649;1882
430900;201504;3007;7945;2561;7189;536;1727;1346;3588;1882;5315
430905;201504;1074;3053;669;2169;177;618;160;502;337;1120
430910;201504;1624;4816;1161;3863;282;1037;458;1418;740;2455
430912;201504;537;1536;435;1360;59;212;269;832;328;1044
430915;201504;511;1654;354;1329;109;433;93;374;202;807
430920;201504;15405;47208;13648;43912;3324;11648;7715;24305;11039;35953
430925;201504;120;304;68;210;17;62;32;96;49;158
430930;201504;9647;28104;6838;22637;1878;6714;1965;6691;3843;13405
430940;201504;1234;3704;757;2530;133;514;207;637;340;1151
430950;201504;1235;3422;837;2601;189;656;311;879;500;1535
430955;201504;151;456;76;251;18;66;21;69;39;135
430957;201504;279;936;224;829;54;219;105;391;159;610
430960;201504;1397;3853;1169;3464;345;1130;458;1384;803;2514
430965;201504;1503;4373;1301;4032;84;316;1071;3293;1155;3609
430970;201504;560;1553;333;1074;69;245;91;279;160;524
430975;201504;664;2145;520;1806;91;339;265;918;356;1257
430980;201504;453;1135;274;865;70;249;98;280;168;529
430990;201504;614;1937;453;1543;120;433;109;338;229;771
430995;201504;633;1856;517;1624;176;576;193;596;369;1172
431000;201504;1760;4544;912;2821;183;638;117;295;300;933
431010;201504;2812;7962;1736;5775;354;1341;450;1319;804;2660
431020;201504;12890;31672;8378;23639;2073;6018;2489;7077;4562;13095
431030;201504;383;1115;202;685;50;193;47;147;97;340
431033;201504;2428;7116;2160;6723;527;1726;1139;3618;1666;5344
431036;201504;217;568;86;301;15;53;17;50;32;103
431040;201504;1020;2886;800;2515;204;729;384;1164;588;1893
431041;201504;564;1556;503;1472;141;420;238;726;379;1146
431043;201504;397;1278;286;1017;133;526;78;240;211;766
431046;201504;120;341;86;268;15;52;30;88;45;140
431050;201504;1845;4630;1413;3915;307;950;786;2117;1093;3067
431053;201504;643;2115;535;1883;168;645;152;541;320;1186
431055;201504;706;1928;651;1837;50;148;494;1398;544;1546
431057;201504;395;1154;239;823;53;196;71;235;124;431
431060;201504;5902;17249;5418;16589;1547;4653;2860;9134;4407;13787
431065;201504;542;1536;418;1283;51;185;241;717;292;902
431070;201504;751;2193;448;1513;93;329;96;288;189;617
431075;201504;294;889;202;688;34;127;60;211;94;338
431080;201504;617;1947;488;1669;118;461;110;361;228;822
431085;201504;956;2541;760;2193;123;392;470;1327;593;1719
431087;201504;637;1818;557;1661;75;218;367;1102;442;1320
431090;201504;547;1340;262;796;81;255;59;171;140;426
431100;201504;4052;11255;3304;9965;852;2770;1269;3843;2121;6613
431110;201504;1605;4231;1196;3418;250;773;558;1521;808;2294
431112;201504;628;1961;593;1904;169;561;292;918;461;1479
431113;201504;521;1508;397;1257;113;377;104;336;217;713
431115;201504;1459;4239;1278;3925;225;732;790;2416;1015;3148
431120;201504;2730;8413;2161;7286;598;2286;851;2712;1449;4998
431123;201504;532;1529;379;1233;77;275;207;682;284;957
431125;201504;1398;4286;1043;3536;301;1007;315;1156;616;2163
431127;201504;233;614;60;196;5;14;5;12;10;26
431130;201504;3604;10236;2730;8702;622;2249;1055;3320;1677;5569
431140;201504;4462;11088;2414;7608;421;1523;565;1520;986;3043
431142;201504;540;1597;479;1486;47;153;326;1031;373;1184
431150;201504;1199;3554;920;3011;205;721;356;1166;561;1887
431160;201504;1018;2990;858;2668;160;504;419;1399;579;1903
431162;201504;516;1350;245;822;31;130;37;100;68;230
431164;201504;165;462;50;185;14;53;3;9;17;62
431170;201504;780;2185;556;1763;155;519;169;524;324;1043
431171;201504;851;2522;728;2276;245;808;194;582;439;1390
431173;201504;509;1490;452;1384;108;349;260;798;368;1147
431175;201504;1127;3165;969;2912;312;989;355;1063;667;2052
431177;201504;896;2900;733;2584;240;946;310;1043;550;1989
431179;201504;363;787;86;255;11;43;20;46;31;89
431180;201504;2340;6778;1640;5285;396;1363;411;1217;807;2580
431190;201504;742;1945;388;1254;73;263;89;286;162;549
431198;201504;393;1293;349;1207;150;545;83;290;233;835
431200;201504;355;1006;111;378;20;64;3;10;23;74
431205;201504;336;1029;179;620;38;123;62;219;100;342
431210;201504;768;2112;653;1905;174;510;359;1061;533;1571
431213;201504;263;797;215;707;55;210;84;257;139;467
431215;201504;335;981;169;571;31;101;15;41;46;142
431217;201504;211;643;162;533;54;191;45;146;99;337
431220;201504;1003;2616;650;1915;86;284;343;941;429;1225
431225;201504;1326;3865;1120;3503;232;760;622;1961;854;2721
431230;201504;903;2626;675;2163;80;279;375;1176;455;1455
431235;201504;112;318;35;108;7;24;7;18;14;42
431237;201504;525;1577;421;1425;123;484;188;622;311;1106
431238;201504;41;129;31;104;7;28;10;32;17;60
431240;201504;2948;8851;2551;8195;870;3031;761;2376;1631;5407
431242;201504;377;1200;337;1129;105;378;84;279;189;657
431244;201504;431;1017;278;771;48;157;142;364;190;521
431245;201504;1105;2922;831;2427;119;370;533;1563;652;1933
431247;201504;205;607;155;507;56;187;51;165;107;352
431250;201504;1654;5215;1439;4916;408;1501;671;2313;1079;3814
431260;201504;368;1030;202;680;45;184;61;184;106;368
431261;201504;233;812;202;739;40;172;72;246;112;418
431262;201504;411;1115;180;595;26;112;73;237;99;349
431265;201504;1468;3845;823;2508;168;572;215;541;383;1113
431267;201504;168;475;138;421;27;97;82;241;109;338
431270;201504;2712;6992;1883;5658;500;1639;770;2336;1270;3975
431275;201504;234;714;131;468;33;119;23;70;56;189
431280;201504;285;800;117;400;20;81;23;60;43;141
431290;201504;362;1138;278;935;67;259;61;183;128;442
431295;201504;113;312;59;178;5;18;28;79;33;97
431300;201504;365;928;60;227;14;55;2;6;16;61
431301;201504;238;741;121;409;29;102;20;62;49;164
431303;201504;777;2048;474;1425;77;284;150;407;227;691
431306;201504;2237;5956;1552;4726;196;739;483;1255;679;1994
431308;201504;44;147;40;136;24;86;11;36;35;122
431310;201504;782;2336;491;1686;104;370;146;524;250;894
431320;201504;936;2552;503;1645;111;409;126;376;237;785
431330;201504;2708;6713;1286;4078;377;1333;136;383;513;1716
431333;201504;464;1231;216;642;43;137;66;169;109;306
431335;201504;66;191;50;151;15;45;11;23;26;68
431337;201504;2465;7546;1860;6279;457;1667;392;1218;849;2885
431339;201504;687;1894;471;1428;85;274;213;633;298;907
431340;201504;27880;73598;20099;60210;4734;15646;6113;17755;10847;33401
431342;201504;592;1535;487;1358;142;427;251;675;393;1102
431344;201504;412;1132;301;933;24;70;201;643;225;713
431346;201504;348;900;176;536;46;142;43;128;89;270
431349;201504;714;2056;488;1518;109;347;159;486;268;833
431350;201504;4101;12086;3425;10858;697;2535;1650;5051;2347;7586
431360;201504;744;1933;507;1542;133;432;166;512;299;944
431365;201504;1237;3679;1053;3370;307;1068;484;1581;791;2649
431370;201504;5240;14887;4189;13083;1172;3957;1446;4530;2618;8487
431380;201504;1036;3187;967;3042;142;476;662;2055;804;2531
431390;201504;3272;8679;2028;6308;425;1497;590;1655;1015;3152
431395;201504;1277;3814;1088;3504;261;951;545;1702;806;2653
431400;201504;283;902;153;541;42;160;20;52;62;212
431402;201504;1316;3109;752;2122;150;452;375;1027;525;1479
431403;201504;286;830;202;681;55;206;36;117;91;323
431405;201504;4473;12519;3601;11254;773;2790;1805;5451;2578;8241
431406;201504;823;2517;612;2059;181;651;264;871;445;1522
431407;201504;602;1756;399;1332;104;355;101;303;205;658
431410;201504;14819;43254;10592;35033;3311;12174;1611;5255;4922;17429
431413;201504;222;548;103;327;11;38;40;120;51;158
431415;201504;777;2197;587;1846;133;487;253;727;386;1214
431417;201504;674;1673;541;1485;73;201;315;887;388;1088
431420;201504;1478;4121;1300;3848;276;855;665;2085;941;2940
431430;201504;545;1443;360;1089;69;216;118;322;187;538
431440;201504;24931;70767;20600;63727;6022;19795;7855;25077;13877;44872
431442;201504;147;415;98;293;20;64;13;25;33;89
431445;201504;504;1415;224;706;34;107;85;255;119;362
431446;201504;496;1447;361;1176;76;243;151;500;227;743
431447;201504;744;2089;531;1653;106;360;233;729;339;1089
431449;201504;854;2384;679;2078;79;271;419;1288;498;1559
431450;201504;2189;5556;1953;5207;349;1016;1373;3601;1722;4617
431455;201504;720;1832;399;1143;118;340;109;296;227;636
431460;201504;3514;9786;3011;8838;871;2609;1033;3139;1904;5748
431470;201504;1971;5771;1569;4898;408;1279;629;2019;1037;3298
431475;201504;173;503;42;164;6;24;4;15;10;39
431477;201504;732;1928;495;1465;62;197;287;826;349;1023
431478;201504;263;680;100;301;21;65;23;61;44;126
431480;201504;3033;8417;2275;7061;604;2085;858;2531;1462;4616
431490;201504;113691;311172;97825;287495;13018;45052;67767;194373;80785;239425
431500;201504;827;2200;609;1787;117;340;316;917;433;1257
431505;201504;496;1220;375;1052;37;94;282;825;319;919
431507;201504;350;865;244;665;35;95;163;432;198;527
431510;201504;2172;5975;1745;5219;379;1238;799;2287;1178;3525
431513;201504;294;801;133;430;25;85;63;200;88;285
431514;201504;105;272;38;131;5;24;2;5;7;29
431515;201504;766;2229;523;1631;101;372;185;470;286;842
431517;201504;84;270;75;247;23;79;24;69;47;148
431520;201504;440;1284;275;878;41;148;72;219;113;367
431530;201504;4407;10538;3369;9327;1117;3315;1209;3538;2326;6853
431531;201504;296;840;193;627;43;146;74;244;117;390
431532;201504;521;1470;450;1319;126;390;184;535;310;925
431535;201504;373;1007;186;568;33;106;57;152;90;258
431540;201504;2187;7134;1939;6779;226;752;1331;4949;1557;5701
431545;201504;300;812;53;173;6;22;7;29;13;51
431550;201504;2368;6937;2110;6483;406;1422;1073;3224;1479;4646
431555;201504;736;1886;587;1652;127;356;344;985;471;1341
431560;201504;19551;59661;14419;49517;3980;15130;3885;13858;7865;28988
431570;201504;5425;15165;4800;14183;1344;4088;2388;7176;3732;11264
431575;201504;450;1156;317;932;50;176;94;247;144;423
431580;201504;690;1955;439;1405;97;356;154;440;251;796
431590;201504;1005;2756;673;2089;87;277;306;949;393;1226
431595;201504;509;1466;403;1246;89;278;173;528;262;806
431600;201504;2173;6206;1556;5009;335;1277;357;1013;692;2290
431610;201504;1571;4629;1212;3918;268;894;517;1676;785;2570
431620;201504;462;1395;245;802;62;214;101;308;163;522
431630;201504;1521;4080;1040;3107;288;896;401;1189;689;2085
431640;201504;6172;17883;5530;16894;1202;4181;3069;9235;4271;13416
431642;201504;520;1431;418;1245;58;203;208;597;266;800
431643;201504;176;450;146;399;21;65;72;173;93;238
431645;201504;1847;5335;1605;4940;317;1051;934;2861;1251;3912
431647;201504;180;514;121;372;28;90;28;72;56;162
431650;201504;294;915;208;741;36;150;50;149;86;299
431660;201504;1237;3450;787;2524;188;672;203;561;391;1233
431670;201504;1366;3645;1035;3050;232;765;456;1271;688;2036
431673;201504;228;652;137;456;30;116;33;96;63;212
431675;201504;639;1738;190;637;32;116;44;121;76;237
431680;201504;10335;28042;7634;23187;2079;6839;2192;6648;4271;13487
431690;201504;26174;73076;20687;64160;5876;19631;7953;25167;13829;44798
431695;201504;134;426;95;327;22;82;22;47;44;129
431697;201504;470;1333;412;1224;105;318;192;583;297;901
431700;201504;1630;4596;1382;4114;255;811;761;2218;1016;3029
431710;201504;13052;37977;10613;33847;3439;11790;3015;9960;6454;21750
431720;201504;7383;20427;5745;17316;1244;4167;2504;7368;3748;11535
431725;201504;12;35;9;29;1;4;4;11;5;15
431730;201504;3996;11885;3179;10373;885;3220;910;3025;1795;6245
431740;201504;5313;15166;4396;13472;1493;5047;972;2720;2465;7767
431750;201504;9938;28101;8518;25828;1840;6046;4355;13496;6195;19542
431755;201504;316;843;62;219;8;30;10;30;18;60
431760;201504;3924;11446;3178;10061;762;2631;1095;3308;1857;5939
431770;201504;2146;5758;1778;5178;368;1133;994;2861;1362;3994
431775;201504;229;621;164;499;61;204;30;74;91;278
431780;201504;2521;6764;1924;5662;521;1648;491;1359;1012;3007
431790;201504;1275;3936;1069;3536;205;726;616;2078;821;2804
431795;201504;426;1194;279;860;47;158;97;293;144;451
431800;201504;9143;26942;7323;23476;2301;8033;1714;5225;4015;13258
431805;201504;326;783;98;331;12;49;17;60;29;109
431810;201504;3690;10211;2904;8619;559;1808;1353;3945;1912;5753
431820;201504;2736;8501;2361;7749;547;1955;937;2980;1484;4935
431830;201504;11120;27635;8643;23946;2528;7596;3340;9277;5868;16873
431840;201504;2823;8424;2437;7757;630;2207;1110;3528;1740;5735
431842;201504;812;2038;392;1179;71;250;114;297;185;547
431843;201504;346;1004;295;916;40;138;163;491;203;629
431844;201504;234;634;123;412;23;90;36;108;59;198
431845;201504;530;1563;440;1380;46;154;295;934;341;1088
431846;201504;451;1340;379;1219;57;216;241;765;298;981
431848;201504;213;584;119;401;24;95;19;59;43;154
431849;201504;432;1061;100;306;22;71;20;46;42;117
431850;201504;5067;14683;4437;13488;1100;3577;1847;5552;2947;9129
431860;201504;839;2218;625;1851;88;309;368;1043;456;1352
431861;201504;100;309;62;221;9;31;9;28;18;59
431862;201504;471;1539;380;1352;118;471;89;290;207;761
431870;201504;19937;56777;15323;48512;4025;13986;4998;15577;9023;29563
431880;201504;4497;13418;3589;11524;865;3063;1495;4686;2360;7749
431890;201504;5421;14638;4100;12357;1310;4207;1217;3723;2527;7930
431900;201504;1109;3178;766;2504;212;807;290;837;502;1644
431910;201504;1031;2440;485;1395;85;265;164;430;249;695
431912;201504;626;1781;484;1514;147;445;161;536;308;981
431915;201504;1480;3987;1128;3373;269;876;439;1304;708;2180
431920;201504;1395;3883;1245;3664;133;369;997;2983;1130;3352
431930;201504;1361;3724;1015;3163;240;727;515;1719;755;2446
431935;201504;73;228;58;197;16;63;21;64;37;127
431936;201504;407;1191;312;980;50;148;169;569;219;717
431937;201504;339;874;191;574;45;147;38;96;83;243
431940;201504;2722;7389;1775;5516;434;1465;492;1469;926;2934
431950;201504;1690;5198;1462;4795;307;1130;669;2096;976;3226
431960;201504;3172;9336;2812;8644;735;2449;969;2934;1704;5383
431970;201504;513;1393;265;842;40;148;71;201;111;349
431971;201504;120;337;91;288;16;51;34;93;50;144
431973;201504;493;1711;430;1579;55;207;269;1035;324;1242
431975;201504;95;210;16;61;5;23;3;10;8;33
431980;201504;1448;4197;1210;3725;288;980;413;1188;701;2168
431990;201504;8302;22857;6274;19502;1166;4203;2305;6737;3471;10940
432000;201504;10632;29921;8368;25962;2614;8564;3032;9358;5646;17922
432010;201504;2367;6772;1954;6014;450;1498;919;2784;1369;4282
432020;201504;2405;5926;1892;5256;230;720;1341;3693;1571;4413
432023;201504;562;1609;381;1214;88;324;123;351;211;675
432026;201504;1313;3924;977;3216;156;532;552;1812;708;2344
432030;201504;429;1251;327;1025;66;211;154;461;220;672
432032;201504;598;1552;408;1203;74;238;203;563;277;801
432035;201504;836;2586;736;2400;131;466;461;1483;592;1949
432040;201504;962;2290;479;1502;110;394;129;353;239;747
432045;201504;241;734;152;554;36;142;57;219;93;361
432050;201504;691;1929;593;1748;97;298;353;1063;450;1361
432055;201504;893;2683;720;2333;142;498;422;1333;564;1831
432057;201504;429;1087;330;915;39;113;223;590;262;703
432060;201504;484;1340;207;702;44;165;47;141;91;306
432065;201504;232;659;181;567;43;151;71;206;114;357
432067;201504;1004;3120;725;2504;157;569;369;1277;526;1846
432070;201504;2448;6678;1653;5095;425;1485;448;1250;873;2735
432080;201504;3822;10988;3276;10010;991;3211;1258;3802;2249;7013
432085;201504;322;910;219;737;48;188;109;362;157;550
432090;201504;1518;4419;1222;3800;416;1385;435;1259;851;2644
432100;201504;1300;3768;688;2336;155;558;93;239;248;797
432110;201504;2766;8327;2092;6929;550;2037;299;863;849;2900
432120;201504;5262;15587;4447;14169;1657;5632;1409;4461;3066;10093
432130;201504;2585;7205;2073;6538;671;2302;886;2813;1557;5115
432132;201504;458;1298;235;790;26;98;88;281;114;379
432135;201504;723;2248;693;2191;94;341;513;1583;607;1924
432140;201504;2147;6726;1727;5923;432;1572;754;2659;1186;4231
432143;201504;1440;4264;1211;3892;269;882;651;2171;920;3053
432145;201504;1109;3408;691;2418;143;554;122;381;265;935
432146;201504;233;740;164;577;40;156;42;140;82;296
432147;201504;671;2110;500;1736;132;478;180;657;312;1135
432149;201504;372;1078;229;735;54;183;92;300;146;483
432150;201504;3845;10747;2841;8937;680;2377;909;2711;1589;5088
432160;201504;4385;13889;3834;12970;1205;4277;1516;5323;2721;9600
432162;201504;407;987;85;276;13;48;19;54;32;102
432163;201504;406;1077;95;300;5;17;8;23;13;40
432166;201504;739;2183;601;1898;90;342;313;935;403;1277
432170;201504;1003;3176;645;2379;130;482;118;418;248;900
432180;201504;3033;7990;2092;6376;593;1935;599;1788;1192;3723
432183;201504;440;1388;358;1223;165;591;69;233;234;824
432185;201504;940;2538;582;1864;118;418;255;801;373;1219
432190;201504;3469;9495;2378;7100;602;1887;687;1884;1289;3771
432195;201504;1268;3457;1050;3151;143;474;710;2100;853;2574
432200;201504;3388;10129;2712;8969;690;2483;1239;4180;1929;6663
432210;201504;450;1245;343;1075;74;281;168;479;242;760
432215;201504;895;2767;767;2563;139;439;478;1696;617;2135
432218;201504;299;799;221;648;39;119;88;228;127;347
432220;201504;4296;11312;3532;10143;370;1248;2370;6711;2740;7959
432225;201504;71;222;60;204;26;92;16;52;42;144
432230;201504;1121;3021;678;2047;162;538;203;505;365;1043
432232;201504;549;1580;430;1355;105;370;182;563;287;933
432234;201504;429;1177;285;850;66;204;99;281;165;485
432235;201504;79;229;44;151;10;47;6;16;16;63
432237;201504;482;1339;442;1277;24;97;352;995;376;1092
432240;201504;14400;46289;12231;43397;2177;8961;7341;26680;9518;35641
432250;201504;5024;17214;4594;16357;1705;6661;1443;5140;3148;11801
432252;201504;390;1139;296;976;65;233;160;527;225;760
432253;201504;1339;4255;931;3250;267;981;228;804;495;1785
432254;201504;790;2131;234;772;51;181;30;84;81;265
432255;201504;240;617;131;436;35;122;41;135;76;257
432260;201504;7677;19240;5344;15433;1234;3694;2217;6616;3451;10310
432270;201504;2636;7836;2219;7120;620;2047;928;3066;1548;5113
432280;201504;1306;3610;679;2212;119;417;151;423;270;840
432285;201504;178;568;56;195;13;54;11;29;24;83
432290;201504;600;1780;394;1305;96;323;131;424;227;747
432300;201504;23862;71230;21119;66557;4424;15155;11865;37077;16289;52232
432310;201504;856;2520;689;2236;140;515;374;1179;514;1694
432320;201504;257;657;127;399;28;85;27;77;55;162
432330;201504;316;846;127;431;17;60;10;32;27;92
432335;201504;217;631;97;335;22;83;9;25;31;108
432340;201504;363;904;173;529;33;108;58;170;91;278
432345;201504;682;1889;624;1794;93;348;376;989;469;1337
432350;201504;441;1185;249;817;54;190;77;230;131;420
432360;201504;165;500;32;112;8;37;10;26;18;63
432370;201504;460;1299;363;1107;34;97;241;759;275;856
432375;201504;829;2096;650;1810;90;264;391;1107;481;1371
432377;201504;175;563;49;162;6;23;15;34;21;57
432380;201504;845;2866;751;2688;299;1196;262;855;561;2051
500020;201504;2296;6925;1732;5869;415;1648;667;2118;1082;3766
500025;201504;1209;2917;780;2168;106;300;434;1186;540;1486
500060;201504;6728;19778;5366;17546;759;2566;3490;11884;4249;14450
500070;201504;4146;12125;3465;10942;749;2743;1589;4924;2338;7667
500080;201504;1643;4812;1210;4036;348;1290;431;1465;779;2755
500085;201504;2261;5951;1647;5024;187;625;967;2839;1154;3464
500090;201504;2395;6893;1803;5831;373;1262;871;2891;1244;4153
500100;201504;2550;7536;2277;7084;583;2134;1060;3112;1643;5246
500110;201504;8619;25167;6909;22530;1129;3950;3774;13067;4903;17017
500124;201504;2024;6464;1748;6013;308;1015;1010;3788;1318;4803
500150;201504;1436;3604;1045;2978;211;717;472;1167;683;1884
500190;201504;4933;12756;3840;11331;731;2328;2197;6652;2928;8980
500200;201504;2555;6444;1963;5439;313;997;1067;2890;1380;3887
500210;201504;4891;14541;4107;13313;906;3152;2071;6804;2977;9956
500215;201504;1660;5064;1337;4433;249;921;546;1740;795;2661
500220;201504;2916;9190;2415;8307;510;1878;931;3282;1441;5160
500230;201504;2698;6893;2033;5918;510;1621;909;2689;1419;4310
500240;201504;4779;14807;3414;12027;562;2180;1311;4885;1873;7065
500260;201504;2710;7010;2028;5921;325;1053;995;2753;1320;3806
500270;201504;121223;311464;77890;237070;19664;65012;18834;56646;38498;121658
500280;201504;1415;3871;1187;3570;115;361;886;2721;1001;3082
500290;201504;4218;10071;2577;7555;616;2090;832;2205;1448;4295
500295;201504;2614;7768;1766;5780;338;1234;451;1268;789;2502
500310;201504;823;2143;694;1957;155;506;333;881;488;1387
500315;201504;3181;9832;2665;9060;438;1538;1696;5981;2134;7519
500320;201504;16218;51892;13150;46218;4024;15234;4315;16041;8339;31275
500325;201504;4095;10580;3012;8881;665;2154;1496;4332;2161;6486
500330;201504;6472;17323;4882;14438;979;3174;2411;7026;3390;10200
500345;201504;2211;5827;1733;5067;279;929;998;2869;1277;3798
500348;201504;2384;6807;2092;6346;166;613;1595;4791;1761;5404
500350;201504;1266;3822;791;2749;116;442;247;869;363;1311
500370;201504;23373;70722;17728;60207;4094;15569;5616;19073;9710;34642
500375;201504;2927;8018;2166;6580;529;1729;788;2401;1317;4130
500380;201504;2948;8362;2457;7514;760;2412;890;2762;1650;5174
500390;201504;606;1273;383;966;37;119;272;645;309;764
500400;201504;1337;4045;1008;3268;239;855;286;846;525;1701
500410;201504;2283;6379;1813;5683;484;1671;839;2618;1323;4289
500430;201504;2513;7222;1989;6470;410;1513;916;3048;1326;4561
500440;201504;1408;3835;1072;3297;212;727;537;1603;749;2330
500450;201504;1980;6039;1516;5145;319;1230;298;873;617;2103
500460;201504;3644;11046;2902;9639;790;2931;729;2342;1519;5273
500470;201504;2999;8855;2124;6958;575;2076;316;919;891;2995
500480;201504;1943;6256;1811;6081;165;551;1493;5143;1658;5694
500490;201504;1016;2808;800;2436;231;789;247;750;478;1539
500500;201504;3634;11311;2865;10133;1113;4467;831;2905;1944;7372
500510;201504;861;2225;549;1681;79;272;248;694;327;966
500515;201504;1877;4996;1548;4560;248;716;928;2998;1176;3714
500520;201504;3034;10361;2707;9894;482;1898;1738;6529;2220;8427
500525;201504;1205;3846;971;3390;208;804;445;1606;653;2410
500540;201504;6080;16893;3608;12166;1057;4174;563;1656;1620;5830
500560;201504;4705;15408;4282;14776;614;2340;3086;10676;3700;13016
500568;201504;4007;10193;2816;8428;594;2070;1200;3399;1794;5469
500570;201504;7512;20073;5041;15491;1389;4594;1329;3946;2718;8540
500580;201504;3669;10477;2941;9253;322;1087;2046;6472;2368;7559
500600;201504;3719;9993;2528;7778;580;1966;941;2874;1521;4840
500620;201504;8360;23235;6112;19250;1248;4371;2816;8873;4064;13244
500625;201504;750;2257;467;1615;102;387;145;493;247;880
500627;201504;500;1455;390;1261;78;257;125;433;203;690
500630;201504;6107;16717;4533;14145;1237;4309;1474;4445;2711;8754
500635;201504;2606;10007;2175;9324;324;1303;1363;6436;1687;7739
500640;201504;1663;3995;1278;3451;100;318;945;2523;1045;2841
500660;201504;18534;53496;14487;46843;4190;15360;4900;15632;9090;30992
500690;201504;2974;8469;2374;7685;924;3106;819;2898;1743;6004
500710;201504;3684;10936;3128;10013;652;2365;1574;4963;2226;7328
500720;201504;5917;15858;3844;12203;1058;3681;1063;3269;2121;6950
500730;201504;978;2730;704;2186;170;601;234;686;404;1287
500740;201504;3901;10821;3161;9431;476;1720;1405;4186;1881;5906
500750;201504;857;2425;780;2330;156;481;504;1569;660;2050
500755;201504;1239;3611;862;2821;194;716;263;739;457;1455
500769;201504;5031;13440;3094;9414;591;2058;753;1908;1344;3966
500770;201504;1785;5238;1340;4416;372;1369;416;1382;788;2751
500780;201504;1037;3060;857;2718;226;784;307;898;533;1682
500790;201504;9197;25567;7724;23029;1390;4828;4286;12305;5676;17133
500793;201504;2304;6637;1819;5834;433;1537;608;1769;1041;3306
500795;201504;2494;7250;2122;6740;258;694;1594;5373;1852;6067
500797;201504;869;2340;629;1933;103;350;248;721;351;1071
500800;201504;2735;7474;2133;6646;832;2947;662;2082;1494;5029
500830;201504;17254;47703;12041;37585;2710;9379;3732;11074;6442;20453
500840;201504;1394;3889;995;3112;142;488;452;1378;594;1866
510010;201504;1219;3753;1058;3481;317;1057;501;1708;818;2765
510020;201504;3226;9260;2102;6999;488;1767;626;1970;1114;3737
510025;201504;8047;23485;6679;21067;1588;5630;2784;8288;4372;13918
510030;201504;1788;4930;1486;4449;363;1242;652;1808;1015;3050
510035;201504;865;2473;690;2227;118;384;423;1400;541;1784
510040;201504;1722;4706;1327;4123;252;884;707;2200;959;3084
510050;201504;1907;5571;1390;4592;373;1363;447;1454;820;2817
510060;201504;1502;4285;1138;3635;245;835;430;1334;675;2169
510080;201504;1152;3564;903;3088;290;1106;202;615;492;1721
510100;201504;677;1805;472;1406;58;193;211;589;269;782
510120;201504;323;678;190;512;20;56;118;323;138;379
510125;201504;3158;8317;2504;7156;448;1573;1080;2868;1528;4441
510130;201504;1912;5175;1556;4617;401;1268;592;1759;993;3027
510140;201504;3004;9600;2405;8666;958;3845;562;1810;1520;5655
510160;201504;1371;4595;1272;4466;126;508;991;3487;1117;3995
510170;201504;5695;17103;4670;15313;928;3424;2227;7068;3155;10492
510180;201504;11930;31310;8498;25891;2435;7823;2839;9533;5274;17356
510185;201504;1390;4067;1147;3757;164;500;775;2789;939;3289
510190;201504;2195;6560;1535;5543;379;1517;648;2421;1027;3938
510250;201504;14001;42956;12018;40101;3569;12906;5234;17895;8803;30801
510260;201504;2287;9115;2018;8557;642;2894;802;3762;1444;6656
510263;201504;4298;11509;3108;9555;785;2590;979;2894;1764;5484
510267;201504;5657;16300;4097;13021;967;3352;1237;3701;2204;7053
510268;201504;855;2477;724;2290;160;537;391;1249;551;1786
510269;201504;1008;3070;774;2625;260;913;229;788;489;1701
510270;201504;2660;8476;2328;7847;409;1424;1191;4076;1600;5500
510279;201504;2009;6226;1737;5734;523;1887;550;1654;1073;3541
510285;201504;1421;4210;1120;3680;289;1042;419;1311;708;2353
510300;201504;3363;9899;2824;9121;222;850;2206;7154;2428;8004
510305;201504;1528;4696;1196;4052;310;1142;363;1201;673;2343
510310;201504;863;2606;723;2348;238;844;238;735;476;1579
510320;201504;3834;11113;2957;9462;848;3143;648;1900;1496;5043
510325;201504;5345;16965;4591;15945;1070;3823;2963;10587;4033;14410
510330;201504;2835;9031;2331;8131;581;2278;873;3006;1454;5284
510335;201504;4772;14541;3997;13529;584;1977;2824;10084;3408;12061
510336;201504;575;1745;453;1511;96;356;226;736;322;1092
510337;201504;2170;7101;1813;6417;718;2573;510;1978;1228;4551
510340;201504;67878;192373;52020;167580;19069;67686;11266;37868;30335;105554
510343;201504;1098;3233;969;3059;89;276;782;2550;871;2826
510345;201504;1671;4940;1379;4412;321;1105;499;1505;820;2610
510350;201504;3497;9615;2733;8560;665;2200;1340;4383;2005;6583
510360;201504;1806;4486;1195;3734;145;551;831;2526;976;3077
510370;201504;1042;3604;922;3429;208;821;556;2101;764;2922
510380;201504;540;1655;382;1345;155;606;58;180;213;786
510385;201504;983;3637;735;3061;117;509;344;1551;461;2060
510390;201504;1130;3452;1036;3338;268;706;654;2351;922;3057
510395;201504;849;2136;655;1872;108;347;308;997;416;1344
510410;201504;3899;12745;3508;11994;866;3126;1870;6474;2736;9600
510420;201504;2418;6224;1776;5156;220;785;948;2705;1168;3490
510450;201504;599;1631;445;1401;108;395;180;556;288;951
510452;201504;637;2053;449;1627;102;412;186;647;288;1059
510454;201504;860;2752;746;2552;116;413;476;1687;592;2100
510455;201504;982;3010;737;2519;162;655;240;771;402;1426
510460;201504;2230;5885;1752;5215;236;872;1091;3107;1327;3979
510480;201504;4591;12264;3297;9892;827;2614;820;2279;1647;4893
510490;201504;1426;4620;1261;4372;256;1038;776;2605;1032;3643
510500;201504;1528;4552;1060;3628;266;1062;437;1430;703;2492
510510;201504;2767;9639;2417;9030;811;3331;913;3353;1724;6684
510515;201504;6293;19306;4852;16150;1153;4288;1246;3892;2399;8180
510517;201504;1786;5279;1499;4785;500;1665;552;1788;1052;3453
510520;201504;2145;5103;1567;4368;76;255;1153;3323;1229;3578
510523;201504;1049;3133;912;2909;152;503;593;1934;745;2437
510525;201504;7864;20102;5186;15903;1109;3613;1969;6001;3078;9614
510530;201504;537;1526;454;1414;70;298;269;791;339;1089
510550;201504;2557;8465;2159;7737;635;2465;792;2837;1427;5302
510558;201504;2032;5849;1690;5351;391;1365;819;2634;1210;3999
510560;201504;1696;5347;1171;4443;355;1485;290;1106;645;2591
510562;201504;5308;15867;4248;13751;1279;4620;1289;4192;2568;8812
510590;201504;2937;7790;2379;7087;583;1810;1192;3641;1775;5451
510600;201504;1563;4036;1040;3176;197;663;433;1234;630;1897
510610;201504;2802;8019;2402;7464;185;661;1922;6005;2107;6666
510615;201504;2304;7077;1942;6504;580;2080;910;3103;1490;5183
510617;201504;606;1819;496;1622;50;163;374;1267;424;1430
510618;201504;1443;4202;1041;3418;211;819;464;1448;675;2267
510619;201504;809;2214;496;1644;82;306;85;239;167;545
510620;201504;1488;3669;823;2660;235;857;165;496;400;1353
510621;201504;1002;3488;890;3252;237;951;321;1117;558;2068
510622;201504;3858;11692;2650;9083;666;2517;367;1013;1033;3530
510623;201504;3523;10050;2844;8846;788;2649;1192;3590;1980;6239
510624;201504;1357;4083;988;3368;210;825;337;1042;547;1867
510625;201504;2244;6473;1771;5665;481;1710;424;1301;905;3011
510626;201504;1533;4185;1036;3496;327;1240;403;1382;730;2622
510627;201504;772;2171;510;1625;132;466;129;403;261;869
510628;201504;1625;4030;1179;3427;114;371;879;2554;993;2925
510629;201504;1860;5968;1530;5253;451;1734;517;1691;968;3425
510630;201504;2567;8649;1995;7505;564;2413;446;1679;1010;4092
510631;201504;403;1143;364;1082;52;155;256;757;308;912
510637;201504;2726;7888;2345;7273;605;2044;1085;3329;1690;5373
510642;201504;4765;15591;4119;14667;1192;4627;1910;7095;3102;11722
510645;201504;959;2159;615;1695;199;553;212;623;411;1176
510650;201504;6230;20976;5704;20342;1174;4208;3887;14540;5061;18748
510665;201504;1315;3581;889;2773;232;762;289;865;521;1627
510670;201504;394;914;220;661;29;112;98;277;127;389
510675;201504;6371;20242;5183;17904;1576;6187;1298;4216;2874;10403
510677;201504;2212;5791;1741;5187;220;675;1271;3944;1491;4619
510680;201504;792;2397;632;2086;129;466;236;726;365;1192
510682;201504;2323;7232;1795;6251;461;1805;468;1535;929;3340
510685;201504;952;2547;792;2330;74;251;585;1704;659;1955
510700;201504;4356;11349;3007;9427;651;2126;1575;5078;2226;7204
510704;201504;8898;23886;7374;21461;1503;4897;4004;11427;5507;16324
510706;201504;1885;5717;1376;4916;317;1163;724;2679;1041;3842
510710;201504;3522;9807;2531;7807;652;2135;653;1782;1305;3917
510715;201504;687;1711;425;1231;89;285;158;418;247;703
510718;201504;1982;5299;1486;4748;627;2064;527;1794;1154;3858
510719;201504;456;1037;282;805;35;142;124;324;159;466
510720;201504;1319;3113;986;2716;189;586;602;1644;791;2230
510724;201504;820;2489;681;2232;154;570;342;1051;496;1621
510726;201504;655;1730;500;1476;105;332;196;543;301;875
510729;201504;761;1916;484;1440;118;394;200;594;318;988
510730;201504;2448;7421;2057;6725;551;2035;793;2460;1344;4495
510735;201504;1142;3787;903;3395;221;939;438;1625;659;2564
510740;201504;1140;2808;831;2359;203;567;446;1325;649;1892
510757;201504;667;2269;558;2047;181;698;211;789;392;1487
510760;201504;28957;76587;20664;62764;6111;20164;6114;18305;12225;38469
510770;201504;4411;11502;3804;10792;384;1025;2626;8362;3010;9387
510774;201504;434;1193;364;1086;82;291;168;512;250;803
510775;201504;783;2249;655;2044;227;773;223;686;450;1459
510776;201504;508;1423;405;1224;89;295;198;595;287;890
510777;201504;1640;4839;1221;4264;172;655;914;3224;1086;3879
510779;201504;704;2063;518;1724;86;310;231;781;317;1091
510780;201504;3760;11243;3154;10294;764;2586;1468;5022;2232;7608
510785;201504;1854;5374;1459;4712;495;1682;389;1283;884;2965
510787;201504;2114;6424;1696;5695;616;2176;392;1240;1008;3416
510788;201504;507;1366;377;1162;170;513;94;329;264;842
510790;201504;15782;45887;10732;36238;2599;10124;1283;4125;3882;14249
510792;201504;7203;22137;5172;18163;1169;4716;1089;3514;2258;8230
510794;201504;1246;3910;1029;3534;382;1440;286;887;668;2327
510795;201504;8711;26509;6434;22110;1797;6802;1601;5565;3398;12367
510800;201504;1726;4820;1387;4355;352;1230;607;1779;959;3009
510805;201504;1909;5400;1584;4928;153;486;1209;3807;1362;4293
510810;201504;694;1695;539;1492;143;414;265;702;408;1116
510820;201504;778;1837;534;1472;102;329;218;532;320;861
510830;201504;623;2029;534;1890;162;614;254;973;416;1587
510835;201504;658;1992;492;1658;146;556;172;517;318;1073
510840;201504;50075;122426;39131;108571;8792;25711;20228;58026;29020;83737
510850;201504;1478;4237;1109;3609;381;1399;197;504;578;1903
510860;201504;2484;8140;1871;6847;685;2729;187;667;872;3396
510880;201504;692;2276;595;2110;180;693;266;972;446;1665
510885;201504;616;1727;494;1561;81;294;225;716;306;1010
510890;201504;852;2717;701;2467;231;923;244;755;475;1678
510895;201504;1121;3501;955;3185;265;1010;409;1296;674;2306
520005;201504;1242;4043;1131;3869;332;1187;522;1825;854;3012
520010;201504;1700;5751;1412;5139;547;2281;299;975;846;3256
520013;201504;3748;10296;2806;8605;644;2077;1117;3416;1761;5493
520015;201504;493;1397;395;1250;104;354;160;513;264;867
520017;201504;1117;3348;945;3070;257;932;377;1137;634;2069
520020;201504;396;1058;309;933;71;225;149;457;220;682
520025;201504;25118;79134;24161;78036;2401;8226;20252;65781;22653;74007
520030;201504;4542;14373;3900;13373;908;3403;1899;6582;2807;9985
520050;201504;335;917;275;817;25;76;195;584;220;660
520055;201504;772;2339;656;2109;127;397;341;1135;468;1532
520060;201504;1423;4425;1223;4023;256;966;512;1615;768;2581
520080;201504;1731;5228;1496;4897;346;1104;843;2910;1189;4014
520082;201504;880;2638;788;2485;144;411;494;1672;638;2083
520085;201504;964;2964;823;2689;176;602;277;902;453;1504
520090;201504;959;2244;713;1925;158;381;378;1097;536;1478
520110;201504;41764;121722;32646;107961;12113;45344;7406;24032;19519;69376
520120;201504;260;665;153;479;34;127;36;108;70;235
520130;201504;3495;9982;3186;9526;740;2416;1732;5157;2472;7573
520140;201504;43165;139892;37881;130087;13362;50169;9118;30587;22480;80756
520145;201504;434;1138;333;991;78;246;143;409;221;655
520150;201504;651;1744;535;1609;134;434;287;856;421;1290
520160;201504;815;2328;671;2110;212;706;205;645;417;1351
520170;201504;4011;9500;3212;8602;298;828;2584;7055;2882;7883
520180;201504;1928;5770;1606;5260;388;1474;661;2105;1049;3579
520215;201504;1911;4967;1622;4526;224;652;1031;2921;1255;3573
520235;201504;760;1995;574;1725;135;455;261;750;396;1205
520250;201504;1283;3991;1054;3602;305;1146;430;1476;735;2622
520260;201504;786;2029;550;1594;84;259;241;670;325;929
520280;201504;534;1572;492;1513;194;634;171;592;365;1226
520310;201504;1126;2747;856;2364;209;565;399;1215;608;1780
520320;201504;1754;5490;1446;4902;153;543;924;3217;1077;3760
520330;201504;2744;8480;2107;7386;633;2489;414;1353;1047;3842
520340;201504;1827;4622;1401;4106;192;498;1040;3206;1232;3704
520350;201504;2889;8227;2377;7279;630;2180;1086;3167;1716;5347
520355;201504;1096;3687;996;3528;348;1340;397;1359;745;2699
520357;201504;786;2149;671;1970;49;160;503;1466;552;1626
520360;201504;643;1850;577;1743;115;359;289;900;404;1259
520380;201504;1303;3518;891;2743;171;573;367;1110;538;1683
520390;201504;1012;2484;635;1979;169;638;252;700;421;1338
520393;201504;567;1440;466;1293;65;188;307;849;372;1037
520396;201504;740;2369;633;2161;81;318;437;1497;518;1815
520400;201504;1714;4884;1470;4552;234;785;971;2997;1205;3782
520410;201504;1499;3770;1122;3267;261;827;613;1771;874;2598
520420;201504;336;947;249;770;48;163;77;213;125;376
520425;201504;1195;3269;1041;3000;279;858;552;1573;831;2431
520430;201504;2065;5398;1334;4061;301;1045;462;1262;763;2307
520440;201504;3641;9360;2507;7429;788;2569;630;1855;1418;4424
520450;201504;10355;29216;7468;23935;1916;6758;1076;3168;2992;9926
520455;201504;675;2028;549;1814;182;661;175;580;357;1241
520460;201504;869;2495;704;2216;140;506;347;1049;487;1555
520465;201504;792;2204;681;2066;125;434;407;1212;532;1646
520470;201504;1779;5757;1606;5487;354;1197;1044;3737;1398;4934
520480;201504;961;2766;753;2438;136;478;392;1236;528;1714
520485;201504;1253;3975;1084;3690;312;1185;566;1912;878;3097
520490;201504;3851;12151;3107;10966;975;3599;1351;4881;2326;8480
520495;201504;1265;3567;1099;3355;99;315;919;2837;1018;3152
520500;201504;1471;4176;1306;3934;394;1251;586;1769;980;3020
520505;201504;851;2403;731;2232;166;530;424;1319;590;1849
520510;201504;10461;29226;7234;23969;1962;7175;2002;6697;3964;13872
520520;201504;1029;2916;828;2619;270;914;314;999;584;1913
520530;201504;2143;6936;1823;6397;517;1844;772;2899;1289;4743
520540;201504;3010;8525;2308;7220;630;2098;576;1745;1206;3843
520545;201504;1139;3424;947;3035;218;752;310;947;528;1699
520547;201504;732;2318;631;2134;234;837;207;669;441;1506
520549;201504;9633;27822;7943;25729;2351;8026;3988;13069;6339;21095
520551;201504;3434;10461;3204;10168;827;2835;1986;6307;2813;9142
520552;201504;780;2414;724;2335;116;416;492;1598;608;2014
520570;201504;538;1556;390;1294;153;547;86;265;239;812
520580;201504;3155;8145;2202;6749;653;2267;817;2425;1470;4692
520590;201504;1452;4065;1164;3590;283;913;342;983;625;1896
520620;201504;7141;22653;6508;21722;1423;5065;3936;13262;5359;18327
520630;201504;752;1992;558;1699;127;394;261;796;388;1190
520640;201504;2764;7786;2303;7042;689;2218;969;3040;1658;5258
520650;201504;831;2304;642;1941;166;560;300;893;466;1453
520660;201504;356;1067;291;967;101;365;94;304;195;669
520670;201504;879;2673;808;2569;51;146;705;2285;756;2431
520680;201504;630;1779;513;1616;136;440;236;762;372;1202
520690;201504;395;1017;278;846;58;156;128;428;186;584
520710;201504;521;1348;346;1018;11;33;196;574;207;607
520725;201504;1697;4320;1282;3699;284;891;718;2054;1002;2945
520735;201504;747;2136;559;1768;144;524;185;558;329;1082
520740;201504;1681;4813;1380;4410;287;1032;702;2195;989;3227
520750;201504;624;1697;494;1502;106;333;279;879;385;1212
520753;201504;1295;3716;1207;3583;152;423;895;2792;1047;3215
520760;201504;924;2498;797;2329;134;428;545;1628;679;2056
520780;201504;2025;4931;1660;4451;170;410;1228;3373;1398;3783
520790;201504;2685;7271;2265;6692;282;804;1654;5077;1936;5881
520800;201504;15362;45129;13516;42931;2679;8218;8706;29432;11385;37650
520810;201504;914;2459;801;2321;135;389;600;1802;735;2191
520815;201504;558;1806;420;1520;188;780;24;65;212;845
520830;201504;1543;4188;1321;3959;41;94;1211;3708;1252;3802
520840;201504;1474;4823;1239;4384;410;1614;265;939;675;2553
520850;201504;645;1951;517;1754;141;534;236;780;377;1314
520860;201504;6835;19368;5102;16820;1394;4980;2128;7212;3522;12192
520870;201504;110895;299056;75650;239236;21219;74596;18894;56955;40113;131551
520880;201504;7168;20543;5274;17617;1574;5933;845;2747;2419;8680
520890;201504;3950;11196;3285;10097;699;2306;1626;4998;2325;7304
520910;201504;3684;10903;2738;9027;875;3089;502;1587;1377;4676
520915;201504;842;2385;634;1996;129;438;275;839;404;1277
520920;201504;3399;9164;2408;7575;583;1964;816;2655;1399;4619
520929;201504;561;1553;434;1353;108;335;232;750;340;1085
520940;201504;1033;3031;878;2802;96;351;638;2018;734;2369
520945;201504;719;1734;585;1525;175;436;275;719;450;1155
520960;201504;784;2361;653;2124;77;241;362;1211;439;1452
520970;201504;3230;9575;2700;8637;641;2254;957;2980;1598;5234
520980;201504;822;2342;755;2241;253;826;381;1091;634;1917
520990;201504;2940;9708;2785;9485;537;1892;1816;6398;2353;8290
520993;201504;1094;2878;880;2544;74;225;621;1811;695;2036
520995;201504;2564;7020;2327;6711;342;978;1691;4946;2033;5924
521000;201504;7125;21646;6029;19740;1551;5789;2405;7604;3956;13393
521010;201504;3876;11643;3146;10279;805;2842;1163;3830;1968;6672
521015;201504;666;1865;557;1691;128;363;301;950;429;1313
521020;201504;3917;11107;2777;8797;786;2712;467;1275;1253;3987
521030;201504;599;1577;509;1430;109;306;264;755;373;1061
521040;201504;5810;15975;5007;14768;1791;5374;2065;6489;3856;11863
521056;201504;896;2764;752;2521;250;889;305;1082;555;1971
521060;201504;1299;3481;1062;3111;281;779;436;1348;717;2127
521080;201504;1210;2879;738;2097;109;384;289;685;398;1069
521090;201504;3133;8380;2426;7478;770;2483;995;3213;1765;5696
521100;201504;1659;4008;1400;3724;243;626;960;2682;1203;3308
521120;201504;4468;12605;3756;11599;908;2972;1861;5868;2769;8840
521130;201504;1053;2892;807;2433;140;517;459;1347;599;1864
521140;201504;1014;3230;867;2933;272;984;259;873;531;1857
521150;201504;12921;33365;8159;24262;2688;8631;2126;6177;4814;14808
521160;201504;827;1998;512;1439;106;324;220;586;326;910
521170;201504;1253;3032;975;2651;224;624;554;1484;778;2108
521180;201504;6575;21824;5987;20770;2192;8114;1834;6421;4026;14535
521190;201504;9569;27318;6566;21966;1813;6517;1739;5851;3552;12368
521200;201504;744;1947;631;1774;75;238;404;1109;479;1347
521205;201504;600;1782;470;1546;54;201;270;890;324;1091
521210;201504;916;2514;635;1988;209;756;204;532;413;1288
521220;201504;3814;10429;3011;9361;932;3181;1210;3726;2142;6907
521225;201504;365;904;289;814;32;84;206;610;238;694
521230;201504;1209;3794;1103;3580;365;1280;527;1650;892;2930
521250;201504;27497;88985;24968;85144;10375;37917;8082;27892;18457;65809
521260;201504;757;1857;611;1613;95;328;374;906;469;1234
521270;201504;1843;5721;1694;5499;160;419;1317;4495;1477;4914
521280;201504;1872;5791;1552;5179;488;1737;490;1609;978;3346
521290;201504;532;1511;394;1285;108;415;153;477;261;892
521295;201504;1078;2870;958;2709;91;261;798;2297;889;2558
521300;201504;1813;5230;1615;4912;289;888;983;3051;1272;3939
521305;201504;800;2223;669;2035;125;363;424;1354;549;1717
521308;201504;4722;14082;3785;12284;903;3080;1756;5648;2659;8728
521310;201504;7722;23045;5775;19340;1639;5976;1307;4057;2946;10033
521340;201504;255;740;229;702;32;117;149;439;181;556
521350;201504;1940;5312;1637;4858;223;671;1144;3483;1367;4154
521370;201504;1000;2982;799;2634;235;848;232;738;467;1586
521375;201504;1325;3904;1115;3537;269;952;519;1557;788;2509
521377;201504;1021;2739;973;2686;74;140;855;2463;929;2603
521380;201504;4966;14020;3573;11441;701;2410;768;2519;1469;4929
521385;201504;512;1401;440;1309;100;326;247;720;347;1046
521390;201504;907;2463;709;2196;195;694;231;699;426;1393
521400;201504;2177;6062;1972;5811;266;866;1512;4460;1778;5326
521405;201504;1365;3898;1081;3386;322;1133;482;1504;804;2637
521410;201504;712;2208;648;2106;233;737;286;998;519;1735
521440;201504;1394;3952;1319;3808;123;368;1034;2949;1157;3317
521450;201504;4439;13915;3602;12350;1074;4023;912;3082;1986;7105
521460;201504;6628;19686;5765;18275;1414;4928;2893;9056;4307;13984
521470;201504;734;2069;548;1708;138;482;103;304;241;786
521480;201504;415;1232;290;956;69;237;106;343;175;580
521483;201504;2829;7356;2183;6269;600;1802;676;1883;1276;3685
521486;201504;1553;4016;1328;3680;130;388;1007;2768;1137;3156
521487;201504;636;1630;446;1329;118;360;120;362;238;722
521490;201504;774;2286;639;2065;68;289;449;1422;517;1711
521500;201504;1336;4284;1059;3671;204;810;351;1069;555;1879
521520;201504;891;2136;690;1864;186;499;326;936;512;1435
521523;201504;11984;44336;11167;42946;4321;17832;1848;7835;6169;25667
521525;201504;1046;2756;924;2594;105;360;676;1851;781;2211
521530;201504;1657;4764;1048;3511;251;905;192;591;443;1496
521540;201504;968;2645;676;2147;167;631;211;616;378;1247
521550;201504;1008;2569;879;2368;227;654;452;1173;679;1827
521560;201504;4320;13937;3633;12974;1394;5478;1160;4033;2554;9511
521565;201504;694;1780;595;1661;91;231;415;1195;506;1426
521570;201504;4466;12610;3107;9856;811;2789;942;2959;1753;5748
521580;201504;579;1348;399;1101;119;358;134;361;253;719
521590;201504;641;1856;518;1656;158;551;95;311;253;862
521600;201504;558;1458;388;1176;101;332;110;291;211;623
521630;201504;1536;3909;1123;3294;282;992;219;510;501;1502
521640;201504;1978;5143;1568;4585;463;1488;660;1977;1123;3465
521645;201504;593;1739;468;1458;71;247;205;583;276;830
521680;201504;1461;4681;1238;4225;643;2360;198;628;841;2988
521690;201504;567;1678;504;1564;112;407;238;681;350;1088
521710;201504;2604;8018;2205;7206;498;1716;985;3222;1483;4938
521720;201504;1880;5346;1600;4938;313;967;1017;3150;1330;4117
521730;201504;3813;12531;3407;11774;1378;5308;869;2723;2247;8031
521740;201504;3351;9199;2644;8250;830;2828;1240;4052;2070;6880
521760;201504;12361;41444;11233;39594;2450;9628;6027;21438;8477;31066
521770;201504;2656;7825;2170;6934;814;2799;642;1935;1456;4734
521800;201504;7701;22871;6645;21151;2119;7227;2592;8518;4711;15745
521805;201504;892;2041;639;1675;157;374;349;997;506;1371
521810;201504;699;1972;577;1780;134;447;299;916;433;1363
521830;201504;5122;16894;4711;16273;855;3226;3108;10729;3963;13955
521839;201504;743;2077;571;1757;119;419;195;561;314;980
521850;201504;6561;17894;5083;15236;1154;3638;1670;4589;2824;8227
521860;201504;1869;5223;1468;4556;340;1173;488;1454;828;2627
521870;201504;479;1670;435;1554;137;528;128;430;265;958
521878;201504;725;2147;529;1728;114;422;229;722;343;1144
521880;201504;24762;63417;16386;49840;4508;14800;5105;15639;9613;30439
521890;201504;3588;10809;2889;9455;950;3369;671;2113;1621;5482
521900;201504;1444;3763;1096;3301;251;820;455;1288;706;2108
521910;201504;1051;2923;934;2786;190;592;570;1789;760;2381
521920;201504;350;1046;298;952;104;378;83;226;187;604
521925;201504;645;1931;558;1776;105;364;233;683;338;1047
521930;201504;3913;12625;3504;11864;1195;4311;908;3077;2103;7388
521935;201504;634;1828;564;1701;151;457;276;814;427;1271
521940;201504;1018;2845;838;2553;234;756;353;1065;587;1821
521945;201504;644;2168;604;2114;105;342;417;1556;522;1898
521950;201504;592;1662;470;1471;98;337;229;731;327;1068
521960;201504;781;2296;636;2039;138;511;282;864;420;1375
521970;201504;2382;6842;2124;6508;296;918;1574;4948;1870;5866
521971;201504;1088;2923;811;2416;169;531;253;701;422;1232
521973;201504;880;2811;743;2553;183;680;256;859;439;1539
521975;201504;12602;34700;11778;33746;1887;5660;8573;24628;10460;30288
521980;201504;1902;5604;1693;5348;254;710;1312;4339;1566;5049
521990;201504;1046;3130;898;2899;131;487;569;1823;700;2310
522000;201504;1832;5546;1577;5194;246;922;1013;3350;1259;4272
522005;201504;416;1021;280;805;77;214;93;274;170;488
522010;201504;3130;9196;2631;8385;978;3250;604;1918;1582;5168
522015;201504;878;2655;746;2451;178;610;385;1262;563;1872
522020;201504;5232;13732;4352;12577;949;2903;2641;7679;3590;10582
522026;201504;613;1645;443;1443;125;458;155;502;280;960
522028;201504;527;1566;435;1362;82;268;270;835;352;1103
522040;201504;2666;6623;2047;5840;475;1410;1124;3237;1599;4647
522045;201504;14710;47907;12372;43212;3899;15041;2644;8981;6543;24022
522050;201504;1127;3181;859;2702;236;801;316;902;552;1703
522060;201504;2805;8446;2204;7520;649;2458;1036;3454;1685;5912
522068;201504;1590;5105;1471;4972;113;296;1243;4430;1356;4726
522070;201504;790;2382;710;2256;77;305;507;1595;584;1900
522100;201504;640;1864;563;1746;203;706;254;740;457;1446
522108;201504;915;2781;779;2583;70;257;608;2015;678;2272
522119;201504;1376;4277;1190;4010;256;908;654;2282;910;3190
522130;201504;464;1349;407;1281;115;379;226;718;341;1097
522140;201504;17682;48750;14672;43907;4321;14027;5240;15105;9561;29132
522145;201504;806;2288;728;2169;335;1065;209;621;544;1686
522150;201504;919;2592;811;2414;238;726;321;943;559;1669
522155;201504;793;2297;703;2160;129;386;460;1468;589;1854
522157;201504;692;1976;590;1827;53;194;470;1448;523;1642
522160;201504;6102;17294;4399;14236;1495;5428;583;1726;2078;7154
522170;201504;3151;8808;2596;7919;846;2666;781;2456;1627;5122
522180;201504;350;1024;276;900;91;318;95;322;186;640
522185;201504;16159;47701;13797;44609;3350;11549;7565;24770;10915;36319
522190;201504;970;2449;751;2111;121;361;417;1194;538;1555
522200;201504;1679;5410;1436;4897;432;1616;412;1312;844;2928
522205;201504;1399;4078;1167;3704;306;1042;532;1672;838;2714
522220;201504;1393;3757;1119;3419;281;864;559;1895;840;2759
522230;201504;1168;3378;1015;3135;115;415;694;2145;809;2560
530010;201504;239263;755251;213055;708211;60270;222153;73560;239962;133830;462115
110001;201503;3904;12390;3252;11386;735;2750;1830;6459;2565;9209
110002;201503;13028;39917;10730;35848;3164;11628;4264;14048;7428;25676
110003;201503;872;2800;789;2656;236;844;240;769;476;1613
110004;201503;10272;32634;8549;29116;2796;10327;2138;7217;4934;17544
110005;201503;1931;6298;1757;5965;635;2215;725;2460;1360;4675
110006;201503;2228;6611;1535;5392;508;1914;298;936;806;2850
110007;201503;1397;4301;1318;4188;305;1072;656;2306;961;3378
110008;201503;2381;8101;2262;7926;395;1280;1690;6223;2085;7503
110009;201503;4802;14393;3932;13008;1078;3981;1621;5174;2699;9155
110010;201503;7886;23061;6908;21820;1652;4960;3980;13749;5632;18709
110011;201503;8593;26373;7228;23892;2395;8396;2773;9048;5168;17444
110012;201503;14224;42965;12007;38867;3789;12956;3982;12869;7771;25825
110013;201503;5374;16630;4327;15025;1465;5356;1558;5582;3023;10938
110014;201503;4456;12830;3674;11690;705;2333;2332;7525;3037;9858
110015;201503;5138;15516;3856;13244;1219;4604;1141;3882;2360;8486
110018;201503;4419;12549;3446;11281;927;3478;1550;4877;2477;8355
110020;201503;58328;164616;45314;147281;9815;33721;23972;80073;33787;113794
110025;201503;4275;12473;3547;11148;602;2011;2306;7215;2908;9226
110026;201503;661;2070;615;2002;155;505;373;1233;528;1738
110028;201503;7767;22224;5643;18672;1558;5688;1047;3272;2605;8960
110029;201503;1368;4094;1187;3771;353;1172;515;1652;868;2824
110030;201503;9935;27839;7989;25206;1989;6824;3807;12349;5796;19173
110032;201503;4090;13004;3619;12019;1134;3945;1292;4222;2426;8167
110033;201503;5403;17242;4986;16606;1527;4969;2531;9000;4058;13969
110034;201503;3591;9511;3055;8849;545;1486;2260;6697;2805;8183
110037;201503;2097;7053;1807;6515;430;1640;960;3470;1390;5110
110040;201503;3477;11031;3116;10394;942;3432;1439;4712;2381;8144
110045;201503;5210;17229;4604;16493;1442;5604;2437;8660;3879;14264
110050;201503;1689;5404;1450;5038;420;1481;789;2818;1209;4299
110060;201503;825;2779;732;2593;240;955;272;934;512;1889
110070;201503;2026;6803;1941;6621;461;1682;1141;3877;1602;5559
110080;201503;3812;11182;3478;10802;400;1125;2809;9058;3209;10183
110090;201503;780;2359;653;2132;185;697;290;872;475;1569
110092;201503;1354;4615;1272;4507;200;738;885;3240;1085;3978
110094;201503;3495;10713;3210;10303;958;3171;1649;5436;2607;8607
110100;201503;2315;7356;2076;6945;602;2126;1084;3608;1686;5734
110110;201503;1712;5433;1570;5253;682;2400;589;2013;1271;4413
110120;201503;1836;5941;1463;5127;464;1704;391;1373;855;3077
110130;201503;2673;7633;1994;6566;675;2345;616;2019;1291;4364
110140;201503;2541;8403;2245;7870;484;1797;1259;4458;1743;6255
110143;201503;1277;4076;1005;3589;244;906;504;1793;748;2699
110145;201503;1052;3025;887;2764;189;646;522;1612;711;2258
110146;201503;446;1403;395;1329;83;287;222;761;305;1048
110147;201503;839;2421;645;2092;170;602;239;690;409;1292
110148;201503;1358;4063;1017;3371;303;1058;275;874;578;1932
110149;201503;3606;10706;2923;9628;872;2900;1489;5066;2361;7966
110150;201503;2511;7496;2199;7039;273;972;1456;4756;1729;5728
110155;201503;879;2759;811;2603;238;814;415;1302;653;2116
110160;201503;2200;6836;1819;6144;570;1993;795;2714;1365;4707
110170;201503;3123;8787;2322;7392;534;1825;1270;3989;1804;5814
110175;201503;1816;5406;1362;4828;231;897;803;2914;1034;3811
110180;201503;1506;4438;1255;4058;284;938;755;2497;1039;3435
120001;201503;2831;9892;2680;9638;499;1935;1739;6358;2238;8293
120005;201503;1471;6180;1435;6121;134;595;1164;5086;1298;5681
120010;201503;4476;15708;4251;15340;688;2420;3085;11494;3773;13914
120013;201503;1745;6921;1678;6820;396;1574;1064;4592;1460;6166
120017;201503;2049;7401;1922;7168;522;1985;928;3776;1450;5761
120020;201503;14080;62728;13676;61948;2118;9364;10055;47459;12173;56823
120025;201503;2605;9038;2511;8905;488;1877;1640;5878;2128;7755
120030;201503;6137;24223;6017;24087;286;1081;5475;22237;5761;23318
120032;201503;1435;6886;1377;6747;201;1163;988;4852;1189;6015
120033;201503;3434;13698;3408;13653;131;557;3170;12809;3301;13366
120034;201503;1959;8127;1899;8037;181;902;1583;6656;1764;7558
120035;201503;2892;13637;2851;13550;204;986;2484;12032;2688;13018
120038;201503;2677;9822;2563;9600;648;2523;1454;5557;2102;8080
120039;201503;1593;8255;1559;8174;186;1024;1244;6625;1430;7649
120040;201503;46310;165482;42212;157370;11108;44253;20946;79619;32054;123872
120042;201503;2876;12413;2739;12109;390;1870;1969;8867;2359;10737
120043;201503;882;4260;853;4210;67;303;723;3698;790;4001
120045;201503;4227;14549;4160;14458;712;2569;3202;11231;3914;13800
120050;201503;7929;33066;7592;32329;1300;5438;5125;22954;6425;28392
120060;201503;7274;33267;7165;33073;565;2862;6100;28596;6665;31458
120070;201503;2687;10183;2621;10033;467;1742;1791;7121;2258;8863
120080;201503;3613;13761;3460;13516;508;1972;2638;10619;3146;12591
130002;201503;2958;12447;2817;12203;200;985;2367;10322;2567;11307
130006;201503;1907;8070;1681;7654;257;1312;1154;5309;1411;6621
130008;201503;2075;8408;1984;8258;147;653;1661;6998;1808;7651
130010;201503;2847;9549;2493;9139;180;636;2176;8114;2356;8750
130014;201503;3283;10710;2903;10134;475;1779;1919;6769;2394;8548
130020;201503;2627;9436;2618;9425;23;75;2587;9332;2610;9407
130030;201503;7114;27182;6858;26881;591;1964;5864;23831;6455;25795
130040;201503;3805;11695;3429;11209;271;993;2896;9584;3167;10577
130050;201503;6225;24723;5630;23843;545;2222;4347;19387;4892;21609
130060;201503;5730;26265;5457;25843;495;2553;4448;21319;4943;23872
130063;201503;3445;15379;3397;15312;257;1108;2972;13686;3229;14794
130068;201503;3053;12827;2791;12316;393;1883;1902;8485;2295;10368
130070;201503;6683;21881;5990;21021;642;2213;4741;17120;5383;19333
130080;201503;4939;22296;4726;21974;854;4155;3279;15668;4133;19823
130083;201503;2159;8578;2040;8397;296;1421;1467;6029;1763;7450
130090;201503;2566;9284;2484;9168;134;575;2239;8274;2373;8849
130100;201503;5493;20718;5283;20444;249;1114;4818;18654;5067;19768
130110;201503;6590;21495;6187;21014;513;1641;5284;18412;5797;20053
130115;201503;4245;15165;4050;14904;77;248;3849;14274;3926;14522
130120;201503;13924;53209;13275;52371;1204;4407;11227;45620;12431;50027
130130;201503;3656;15328;3601;15225;300;1374;3049;13011;3349;14385
130140;201503;6228;24236;6158;24154;99;236;6029;23848;6128;24084
130150;201503;3413;13128;3342;13039;158;758;3063;11885;3221;12643
130160;201503;4095;16935;3985;16790;280;1081;3595;15367;3875;16448
130165;201503;2815;11655;2705;11473;325;1459;2158;9262;2483;10721
130170;201503;8909;32545;7991;31411;1014;4097;6164;24914;7178;29011
130180;201503;3463;11147;3382;11032;119;309;3143;10379;3262;10688
130185;201503;10583;34762;9667;33708;926;2910;8008;29167;8934;32077
130190;201503;16925;58355;14890;55756;2764;10354;9877;38789;12641;49143
130195;201503;1890;7901;1833;7819;108;450;1626;7049;1734;7499
130200;201503;1978;7096;1840;6872;510;1872;1082;4178;1592;6050
130210;201503;1176;4644;1112;4555;110;519;925;3806;1035;4325
130220;201503;1972;8155;1805;7837;328;1610;1051;4598;1379;6208
130230;201503;3622;16295;3424;15977;375;1696;2649;12920;3024;14616
130240;201503;8372;32216;7773;31331;380;1821;6828;27771;7208;29592
130250;201503;19338;67641;18336;66343;2307;7809;14250;53908;16557;61717
130255;201503;4190;14760;3966;14407;134;420;3644;13494;3778;13914
130260;201503;247675;809996;224125;771318;63017;227925;109486;384843;172503;612768
130270;201503;6995;29556;6455;28682;896;4077;4800;22040;5696;26117
130280;201503;3246;13077;3164;12959;116;430;2911;12175;3027;12605
130290;201503;11170;39533;10823;39121;163;306;10399;38267;10562;38573
130300;201503;4282;16843;4096;16550;292;1372;3472;14070;3764;15442
130310;201503;5054;18965;4664;18484;368;1436;3923;15916;4291;17352
130320;201503;2936;10318;2677;9965;351;1323;1969;7538;2320;8861
130330;201503;3439;12785;3221;12496;180;822;2805;10963;2985;11785
130340;201503;17752;68262;16634;66783;3093;11976;11689;49224;14782;61200
130350;201503;3201;13304;3137;13215;273;1278;2658;11296;2931;12574
130353;201503;5844;17952;5107;16993;1162;3765;3159;11294;4321;15059
130356;201503;4446;15959;4204;15610;360;1176;3481;13521;3841;14697
130360;201503;3137;8949;2900;8695;34;55;2809;8556;2843;8611
130370;201503;5243;20486;4507;19514;275;1465;3763;16377;4038;17842
130380;201503;7283;30650;6996;30261;460;2087;6087;26696;6547;28783
130390;201503;4838;21628;4509;21053;453;2298;3501;16688;3954;18986
130395;201503;2036;7376;1793;6875;269;1109;1178;4481;1447;5590
130400;201503;2068;7862;1992;7758;129;536;1781;6986;1910;7522
130406;201503;10266;39029;9233;37498;2184;9118;5630;23671;7814;32789
130410;201503;3921;14937;3569;14286;1080;4631;1597;6581;2677;11212
130420;201503;10246;43460;9874;42846;2818;11819;6021;27537;8839;39356
130423;201503;3217;12484;3035;12236;248;1150;2584;10454;2832;11604
130426;201503;2091;9133;2031;9033;293;1298;1543;7087;1836;8385
130430;201503;3407;12177;3268;11977;424;1635;2490;9261;2914;10896
130440;201503;3544;13036;3410;12892;180;641;3113;11956;3293;12597
140002;201503;1635;5234;1538;5120;158;514;1186;4055;1344;4569
140005;201503;3045;8910;2876;8728;75;165;2751;8438;2826;8603
140010;201503;49499;152509;42522;141631;10452;37451;20902;71536;31354;108987
140015;201503;2948;9501;2787;9292;349;935;2201;7718;2550;8653
140017;201503;3299;10202;3002;9829;284;818;2399;8181;2683;8999
140020;201503;4510;15361;4222;14971;379;1249;3459;12655;3838;13904
140023;201503;2126;7221;1890;6860;251;955;1329;4928;1580;5883
140028;201503;2171;5953;2102;5879;65;117;2001;5694;2066;5811
140030;201503;3682;11587;3511;11377;437;1107;2905;9843;3342;10950
140040;201503;1577;7456;1532;7346;123;688;1225;5932;1348;6620
140045;201503;2432;9042;2234;8758;458;1629;1451;6221;1909;7850
140047;201503;5411;15140;4825;14376;1409;4308;2392;7551;3801;11859
140050;201503;1496;4692;1359;4513;217;762;937;3157;1154;3919
140060;201503;1496;4641;1352;4414;276;937;880;2943;1156;3880
140070;201503;1463;7558;1428;7439;93;557;1234;6424;1327;6981
150010;201503;33860;106263;32172;104052;1961;6532;27702;90801;29663;97333
150013;201503;1659;4877;1531;4734;161;467;1224;3882;1385;4349
150020;201503;12241;41100;11879;40609;904;3063;10316;35753;11220;38816
150030;201503;6630;28496;6431;28199;602;2272;5449;24810;6051;27082
150034;201503;4312;11956;4105;11700;229;585;3704;10694;3933;11279
150040;201503;12614;41913;10909;39838;2193;7406;7402;29057;9595;36463
150050;201503;5734;22029;5531;21681;358;1579;4752;18758;5110;20337
150060;201503;16394;52462;15237;50759;2690;8586;10641;36735;13331;45321
150070;201503;5887;24191;5293;23540;389;1865;4593;20703;4982;22568
150080;201503;65735;174241;56360;161939;9436;25826;37025;110571;46461;136397
150085;201503;5131;17862;4883;17522;551;1701;3974;14856;4525;16557
150090;201503;9817;38101;9355;37438;842;3295;7725;31579;8567;34874
150095;201503;5256;17598;4790;16914;421;1382;3875;14168;4296;15550
150100;201503;3297;12382;3117;12079;191;927;2598;9981;2789;10908
150110;201503;3268;16135;3257;16110;143;642;3038;15201;3181;15843
150120;201503;6016;23264;5865;23000;722;2741;4677;18678;5399;21419
150125;201503;740;2212;676;2131;128;457;442;1350;570;1807
150130;201503;21364;65395;19939;63417;1813;5537;15887;51790;17700;57327
150140;201503;150522;434664;143622;426041;14531;42304;118353;356303;132884;398607
150145;201503;4493;14465;4152;14025;591;2044;3152;10835;3743;12879
150150;201503;11010;34804;10247;33641;1719;5833;7146;23799;8865;29632
150157;201503;3111;9420;2731;8888;352;1265;2028;6682;2380;7947
150160;201503;3000;9823;2804;9540;755;2552;1638;5815;2393;8367
150170;201503;21936;80671;20571;78616;3440;13261;14705;57320;18145;70581
150172;201503;2985;10388;2675;9898;421;1593;1917;7256;2338;8849
150175;201503;1960;5932;1855;5819;117;283;1615;5304;1732;5587
150178;201503;10174;31888;9167;30786;717;2345;7507;26121;8224;28466
150180;201503;17857;71901;17178;70992;1426;6376;14456;60388;15882;66764
150190;201503;7203;23416;6828;22913;385;884;5983;20888;6368;21772
150195;201503;5112;17048;4747;16453;341;1274;3992;13953;4333;15227
150200;201503;5240;16948;5024;16697;142;443;4675;15734;4817;16177
150210;201503;24089;91048;23310;89956;2283;8017;19233;77066;21516;85083
150215;201503;6330;20066;5526;18845;1445;5201;2652;9208;4097;14409
150220;201503;12558;39277;11260;37268;2553;8708;5997;20316;8550;29024
150230;201503;11220;37429;10010;35696;1152;4709;7438;26566;8590;31275
150240;201503;34955;104379;30918;97631;9951;32615;11501;37861;21452;70476
150250;201503;4093;16556;3953;16352;524;2209;3041;12957;3565;15166
150260;201503;2108;8478;2012;8309;402;1709;1260;5354;1662;7063
150270;201503;8703;26977;6994;24841;1524;5749;4330;15695;5854;21444
150275;201503;5774;21165;5502;20750;716;2748;4184;16117;4900;18865
150276;201503;2070;6242;1884;5996;385;1310;1354;4312;1739;5622
150277;201503;4933;15388;4285;14588;624;2130;3130;11051;3754;13181
150280;201503;5801;25856;5642;25504;1093;4903;3807;17794;4900;22697
150285;201503;2649;10736;2538;10526;516;2209;1624;6993;2140;9202
150290;201503;9617;28634;9222;28190;730;1771;7955;25287;8685;27058
150293;201503;9392;26328;7348;23434;2237;7596;2821;9733;5058;17329
150295;201503;6720;20408;5633;19132;1044;3335;3910;14245;4954;17580
150300;201503;1789;6312;1717;6225;123;414;1420;5327;1543;5741
150304;201503;4022;12672;3530;11979;555;1923;2418;8459;2973;10382
150307;201503;6510;22094;6037;21431;415;1382;5133;18557;5548;19939
150309;201503;6331;22120;5871;21547;1271;4591;3957;15275;5228;19866
150310;201503;5728;25642;5570;25381;640;2993;4442;20672;5082;23665
150320;201503;8910;21340;8364;20780;464;770;7525;19352;7989;20122
150330;201503;13507;46946;12631;45685;1476;5213;9789;36533;11265;41746
150340;201503;2365;7728;2194;7477;317;1141;1609;5558;1926;6699
150345;201503;6442;21831;6038;21290;598;2088;4904;17718;5502;19806
150350;201503;7682;24585;7218;23976;1104;3203;5375;18602;6479;21805
150360;201503;20704;65396;18213;62166;2826;9689;12730;44973;15556;54662
150370;201503;9467;35571;9041;35003;1113;3836;7402;29765;8515;33601
150375;201503;2762;12028;2695;11936;256;1056;2313;10524;2569;11580
150380;201503;9686;28532;8645;27121;679;2238;7189;22859;7868;25097
150390;201503;7702;33440;7289;32698;1350;5922;4870;22770;6220;28692
150400;201503;5705;22808;5475;22326;517;2087;4297;17975;4814;20062
150405;201503;8064;24667;7207;23609;1348;3748;4991;17720;6339;21468
150410;201503;1632;6367;1557;6219;249;1089;1033;4200;1282;5289
150420;201503;35700;122230;30831;114294;8919;35568;13161;50940;22080;86508
150430;201503;6851;23809;6536;23302;904;3150;4790;17592;5694;20742
150440;201503;5407;18900;5204;18620;947;3263;3710;13716;4657;16979
150442;201503;19693;58963;18055;56611;3161;10246;11962;38271;15123;48517
150445;201503;5065;17832;4720;17280;583;2054;3600;13548;4183;15602
150450;201503;4286;20674;4125;20437;358;1796;3475;17570;3833;19366
150460;201503;6396;24891;5852;24256;343;1567;5139;21729;5482;23296
150470;201503;17046;52053;16415;51298;570;1352;15341;48770;15911;50122
150475;201503;2065;7231;1918;7044;211;756;1578;5961;1789;6717
150480;201503;13449;46471;12679;45331;1084;4037;10590;38369;11674;42406
150490;201503;6722;25939;6572;25720;287;1101;5972;23683;6259;24784
150495;201503;4978;18344;4862;18191;165;619;4553;17163;4718;17782
150497;201503;2899;10520;2628;10039;816;3295;1352;5187;2168;8482
150500;201503;3106;8671;2893;8363;352;1023;2176;6301;2528;7324
150503;201503;3708;11579;3207;10959;1130;3950;1617;5806;2747;9756
150506;201503;11270;39928;10270;38516;2272;7980;6718;26870;8990;34850
150510;201503;9520;37520;8817;36245;1288;5373;6249;26619;7537;31992
150520;201503;6668;25877;6576;25754;205;610;6233;24762;6438;25372
150530;201503;11683;40877;10600;39229;1159;4102;8129;30865;9288;34967
150540;201503;4548;14092;4129;13499;290;995;3453;11317;3743;12312
150543;201503;5326;16738;4815;15995;1021;3524;3116;10569;4137;14093
150548;201503;8547;27611;8047;26982;338;1039;7355;25006;7693;26045
150549;201503;2145;6960;2005;6799;65;132;1868;6508;1933;6640
150550;201503;19777;62695;17350;58598;5395;18844;7235;25043;12630;43887
150553;201503;21743;75541;18408;68456;7048;28007;4755;17887;11803;45894
150555;201503;1639;5110;1465;4863;130;494;1174;3902;1304;4396
150560;201503;1923;6259;1822;6042;254;857;1259;4185;1513;5042
150563;201503;2900;9515;2701;9166;667;2436;1498;5100;2165;7536
150565;201503;3590;12566;3293;12105;193;849;2717;10092;2910;10941
150570;201503;5580;20781;5466;20592;379;1442;4642;17873;5021;19315
150580;201503;9494;39766;9289;39519;586;2235;8309;36240;8895;38475
150590;201503;5636;22822;5488;22645;90;260;5283;22045;5373;22305
150600;201503;7803;30183;7539;29801;396;1536;6777;27240;7173;28776
150610;201503;2385;8193;2185;7789;265;1044;1515;5346;1780;6390
150611;201503;2696;9557;2526;9213;231;914;1954;7172;2185;8086
150613;201503;11856;36474;10293;34201;3433;11822;4795;16512;8228;28334
150616;201503;3049;9314;2401;8323;611;2334;1052;3526;1663;5860
150618;201503;6325;22202;5948;21524;1698;6386;3158;11602;4856;17988
150619;201503;5097;17696;4784;17218;564;2237;3581;12944;4145;15181
150620;201503;6237;22639;5727;21999;753;2826;4567;18099;5320;20925
150630;201503;5609;17087;5343;16772;346;1071;4673;14944;5019;16015
150635;201503;4086;13518;3783;12939;780;2751;2145;7564;2925;10315
150640;201503;1760;5455;1708;5390;194;577;1399;4611;1593;5188
150650;201503;12426;37788;11103;35523;2980;9731;5272;17434;8252;27165
150655;201503;4976;16937;4746;16537;558;1997;3660;12921;4218;14918
150658;201503;4223;13341;3833;12781;843;3193;2424;8031;3267;11224
150660;201503;5570;17850;5092;17180;1265;4164;2947;10376;4212;14540
150670;201503;6303;17609;5287;16344;1055;3390;3638;11587;4693;14977
150680;201503;52635;196038;47885;187605;14989;60308;21362;89371;36351;149679
150690;201503;2003;6272;1817;5970;340;1044;1157;3967;1497;5011
150700;201503;6130;18833;5614;18180;1055;3493;3776;12553;4831;16046
150710;201503;4254;14203;3817;13505;423;1498;2869;10379;3292;11877
150715;201503;4945;15770;4338;14863;529;1928;3288;11433;3817;13361
150720;201503;6421;26342;6056;25695;895;3845;4389;19349;5284;23194
150730;201503;9243;32148;8819;31506;954;3337;7243;26470;8197;29807
150740;201503;3697;11785;3323;11131;530;1849;2082;7073;2612;8922
150745;201503;5337;16987;4939;16434;1050;3636;3270;10921;4320;14557
150746;201503;1405;4590;1340;4477;192;692;928;3131;1120;3823
150747;201503;5294;16736;4708;15994;487;1438;3615;13048;4102;14486
150750;201503;2997;10196;2858;10023;139;463;2608;9265;2747;9728
150760;201503;10747;35346;10120;34523;2126;7312;6602;23225;8728;30537
150770;201503;5833;22046;5424;21173;578;2149;4373;17999;4951;20148
150775;201503;1173;3598;1033;3353;207;818;595;1861;802;2679
150780;201503;3174;10482;3131;10435;56;138;3010;10130;3066;10268
150790;201503;5038;16191;4640;15714;387;1341;3825;13468;4212;14809
150795;201503;15726;48717;14130;46434;2837;9139;9070;30979;11907;40118
150796;201503;2921;8810;2697;8553;351;1076;2090;6870;2441;7946
150797;201503;3733;12603;3487;12234;144;564;3088;10921;3232;11485
150800;201503;13675;45813;12614;44524;2488;8151;8810;32850;11298;41001
150803;201503;6573;23859;6194;23263;683;2627;4743;18210;5426;20837
150805;201503;2739;9631;2557;9355;318;1122;1932;7265;2250;8387
150808;201503;5812;19729;4954;18137;2068;8113;1023;3779;3091;11892
150810;201503;18952;59880;16201;56523;2238;7441;11676;43036;13914;50477
150812;201503;5287;16657;4875;15995;486;2016;3616;11443;4102;13459
150815;201503;8537;27780;7719;26777;813;2737;6357;22603;7170;25340
150820;201503;11299;32106;10016;30698;693;1425;8705;27827;9398;29252
150830;201503;13094;49156;12034;47544;619;2692;10091;41236;10710;43928
150835;201503;1934;6942;1798;6653;463;1827;835;3107;1298;4934
150840;201503;6814;20618;5692;18875;1303;4681;2952;9750;4255;14431
160005;201503;675;2504;633;2433;77;355;459;1735;536;2090
160010;201503;1417;4706;1413;4701;77;170;1307;4465;1384;4635
160015;201503;1665;6217;1626;6155;99;328;1430;5578;1529;5906
160020;201503;2009;7089;1872;6902;239;866;1394;5359;1633;6225
160021;201503;950;4083;925;4043;163;776;673;2979;836;3755
160023;201503;1068;4237;1053;4213;79;271;924;3794;1003;4065
160025;201503;1236;3785;1224;3772;8;27;1209;3729;1217;3756
160027;201503;8194;24671;7596;24016;2710;8119;3971;13641;6681;21760
160030;201503;43029;155445;38501;146923;9095;34654;22165;88850;31260;123504
160040;201503;4170;16293;4078;16157;119;558;3832;15184;3951;15742
160050;201503;3204;12115;2921;11736;1281;5118;1255;5368;2536;10486
160053;201503;2606;10175;2545;10082;550;2247;1740;7043;2290;9290
160055;201503;665;2624;653;2612;95;414;504;2031;599;2445
160060;201503;15606;53151;14644;52086;2927;9888;10414;38567;13341;48455
160070;201503;2408;9442;2325;9324;123;524;2079;8418;2202;8942
160080;201503;2528;9441;2520;9432;33;107;2473;9291;2506;9398
170025;201503;540;1813;498;1756;153;546;254;943;407;1489
170030;201503;1166;3796;1031;3553;303;1050;434;1554;737;2604
170035;201503;1505;4426;1212;3890;393;1352;395;1291;788;2643
170040;201503;1860;6067;1639;5763;276;1099;1044;3769;1320;4868
170070;201503;1977;5179;1542;4622;381;1248;825;2501;1206;3749
170100;201503;2493;7236;2193;6771;260;846;1695;5230;1955;6076
170105;201503;762;2409;617;2118;119;478;312;1021;431;1499
170110;201503;1080;3385;935;3148;216;779;466;1576;682;2355
170130;201503;1389;4363;1216;4078;286;991;661;2311;947;3302
170190;201503;1581;4630;1219;4061;499;1599;282;1090;781;2689
170200;201503;1558;4458;1088;3575;270;982;347;1102;617;2084
170210;201503;31263;90403;25375;80776;7591;26207;8164;27090;15755;53297
170215;201503;1166;3676;1013;3444;83;336;796;2710;879;3046
170220;201503;5798;19945;5355;19155;1124;4277;3121;11254;4245;15531
170230;201503;1462;4714;1229;4276;262;1083;599;1989;861;3072
170240;201503;2723;8205;2313;7604;303;1164;1601;5223;1904;6387
170255;201503;3605;11445;3000;10464;880;3109;1310;4831;2190;7940
170270;201503;1055;2649;733;2207;96;315;485;1447;581;1762
170290;201503;2717;8504;2546;8300;157;391;2249;7613;2406;8004
170300;201503;1958;6103;1644;5589;225;858;1068;3659;1293;4517
170305;201503;773;2352;622;2077;111;403;334;1131;445;1534
170307;201503;1081;3764;905;3435;184;763;474;1884;658;2647
170310;201503;1629;4511;1259;3909;288;917;635;2041;923;2958
170320;201503;1105;3221;832;2735;222;775;330;1115;552;1890
170330;201503;748;2434;690;2340;117;442;471;1572;588;2014
170360;201503;450;1470;386;1361;94;349;176;608;270;957
170370;201503;1376;4004;1108;3579;256;920;538;1736;794;2656
170380;201503;1859;6022;1521;5490;298;1265;827;2928;1125;4193
170382;201503;559;1852;484;1733;118;485;271;951;389;1436
170384;201503;1558;6364;1458;6191;351;1596;867;3730;1218;5326
170386;201503;950;2815;835;2651;202;722;449;1442;651;2164
170388;201503;645;1927;534;1744;116;452;215;676;331;1128
170389;201503;914;3062;838;2940;94;379;609;2118;703;2497
170390;201503;1319;3861;1150;3647;133;456;865;2806;998;3262
170410;201503;518;1671;459;1563;53;220;302;1010;355;1230
170460;201503;503;1370;355;1119;85;304;120;369;205;673
170510;201503;770;2613;633;2354;83;370;346;1269;429;1639
170550;201503;6410;18671;4906;16013;1662;5988;957;3084;2619;9072
170555;201503;1350;3908;1064;3465;243;877;546;1795;789;2672
170560;201503;994;3358;792;3097;172;735;467;1884;639;2619
170600;201503;1326;3802;1186;3613;243;726;778;2468;1021;3194
170610;201503;1667;5072;1299;4491;148;610;809;2811;957;3421
170625;201503;433;1339;340;1160;65;233;100;343;165;576
170650;201503;1246;3997;1081;3703;258;946;496;1754;754;2700
170700;201503;4039;13077;3329;11900;681;2693;1647;6157;2328;8850
170710;201503;1840;5435;1495;4821;240;823;917;2997;1157;3820
170720;201503;1879;5033;1577;4574;308;816;1062;3239;1370;4055
170730;201503;1043;2974;853;2687;232;784;388;1238;620;2022
170740;201503;2212;7884;1961;7448;283;1195;1345;5165;1628;6360
170755;201503;847;2610;705;2311;162;600;249;788;411;1388
170765;201503;1359;3694;1073;3226;282;898;481;1480;763;2378
170770;201503;1769;6030;1626;5772;278;1072;1032;3705;1310;4777
170820;201503;3762;11993;3378;11379;849;3035;1575;5421;2424;8456
170825;201503;758;2297;602;1989;121;449;257;827;378;1276
170830;201503;1387;4087;1236;3870;27;49;1140;3629;1167;3678
170900;201503;2690;9426;2546;9178;247;892;2018;7447;2265;8339
170930;201503;3592;11242;3078;10354;978;3548;1060;3561;2038;7109
170950;201503;14099;40577;10463;34270;3509;12993;2207;6981;5716;19974
170980;201503;496;1493;378;1294;96;371;161;519;257;890
171050;201503;1431;4914;1323;4715;82;341;1104;3941;1186;4282
171070;201503;1582;4911;1444;4714;293;978;904;3045;1197;4023
171090;201503;998;2808;837;2580;83;270;600;1849;683;2119
171110;201503;615;1794;469;1541;129;459;221;708;350;1167
171150;201503;869;2491;639;2088;123;441;352;1162;475;1603
171180;201503;684;2055;493;1663;125;448;201;720;326;1168
171190;201503;1782;6455;1553;6001;333;1381;763;3051;1096;4432
171195;201503;834;2945;729;2740;101;434;405;1548;506;1982
171200;201503;709;2289;592;2072;148;578;256;837;404;1415
171215;201503;459;1364;359;1172;69;251;156;516;225;767
171240;201503;754;2649;696;2537;88;373;478;1777;566;2150
171245;201503;654;2142;542;1891;121;482;197;635;318;1117
171250;201503;1123;3246;899;2874;137;505;569;1743;706;2248
171270;201503;436;1781;406;1729;128;534;177;829;305;1363
171280;201503;917;2803;785;2601;189;629;409;1474;598;2103
171320;201503;3885;11796;3312;10832;897;3012;1653;5507;2550;8519
171330;201503;2924;8593;2426;7822;622;2159;1159;3713;1781;5872
171360;201503;1468;4710;1272;4410;199;694;836;2978;1035;3672
171370;201503;719;2053;625;1922;135;455;339;1020;474;1475
171380;201503;1316;4309;1119;3944;430;1537;392;1416;822;2953
171395;201503;891;2696;713;2367;155;618;329;1042;484;1660
171420;201503;2268;6875;1799;6063;439;1567;743;2532;1182;4099
171430;201503;1053;3268;890;3008;208;713;487;1653;695;2366
171488;201503;2517;7716;2246;7340;525;1692;1263;4333;1788;6025
171500;201503;790;2424;684;2226;88;266;454;1528;542;1794
171510;201503;914;3213;815;3055;93;393;571;2179;664;2572
171515;201503;514;1482;400;1296;61;203;222;713;283;916
171525;201503;616;2024;521;1861;104;430;290;1014;394;1444
171550;201503;322;1073;253;938;90;372;40;159;130;531
171570;201503;1228;3900;1090;3636;173;599;757;2535;930;3134
171575;201503;1833;5308;1441;4569;288;944;676;2215;964;3159
171610;201503;5567;18449;4834;17142;1418;5533;1652;5749;3070;11282
171620;201503;2553;7567;2245;7136;130;487;1884;6020;2014;6507
171630;201503;878;2834;727;2574;226;869;271;943;497;1812
171650;201503;2276;7049;1799;6131;464;1733;690;2343;1154;4076
171660;201503;2477;6837;1932;5880;276;920;1150;3522;1426;4442
171665;201503;1441;4303;1190;3910;179;653;737;2510;916;3163
171670;201503;2066;5855;1714;5293;434;1502;813;2380;1247;3882
171700;201503;1090;3578;961;3334;135;538;631;2174;766;2712
171720;201503;746;2232;635;2038;222;742;253;833;475;1575
171750;201503;1162;3703;981;3332;288;1048;348;1182;636;2230
171780;201503;1265;3442;931;2980;115;417;548;1793;663;2210
171790;201503;1559;5155;1346;4858;242;837;876;3335;1118;4172
171800;201503;672;2128;593;2021;77;289;431;1485;508;1774
171820;201503;9888;29306;8568;27568;1705;5971;5126;16635;6831;22606
171830;201503;1490;5543;1351;5246;373;1522;629;2432;1002;3954
171840;201503;808;2264;709;2129;46;139;587;1790;633;1929
171845;201503;792;2141;609;1845;113;384;318;946;431;1330
171850;201503;971;3467;864;3249;109;497;545;2038;654;2535
171855;201503;1155;3709;1055;3521;94;381;807;2634;901;3015
171865;201503;479;1547;409;1434;100;388;203;691;303;1079
171870;201503;719;2202;591;1980;134;491;253;891;387;1382
171875;201503;1352;4200;1110;3833;121;500;775;2636;896;3136
171880;201503;877;3222;856;3186;85;332;688;2617;773;2949
171884;201503;941;2647;689;2277;159;607;224;823;383;1430
171886;201503;1466;4822;1217;4304;376;1442;370;1299;746;2741
171888;201503;693;2118;570;1895;73;260;334;1144;407;1404
171889;201503;489;1603;460;1554;89;312;286;983;375;1295
171890;201503;1167;3728;1011;3515;138;546;667;2337;805;2883
171900;201503;506;1892;451;1787;128;512;216;868;344;1380
172000;201503;597;1964;519;1819;89;346;294;1030;383;1376
172010;201503;1171;4093;1100;3973;107;451;861;3112;968;3563
172015;201503;349;1347;296;1256;58;257;166;737;224;994
172020;201503;2305;7724;2134;7450;272;1012;1527;5391;1799;6403
172025;201503;737;2114;570;1824;68;255;317;1010;385;1265
172030;201503;1113;3743;993;3534;106;467;705;2491;811;2958
172049;201503;1279;3455;999;2956;116;354;776;2333;892;2687
172065;201503;1208;3416;1036;3212;58;192;934;2926;992;3118
172080;201503;2566;7946;2173;7267;240;967;1491;4910;1731;5877
172085;201503;520;1424;376;1156;69;234;136;402;205;636
172090;201503;3164;9621;2576;8743;423;1565;1679;5783;2102;7348
172093;201503;597;1861;475;1656;122;531;237;790;359;1321
172097;201503;688;2010;549;1793;137;463;220;745;357;1208
172100;201503;29939;95203;24599;85190;7692;29541;6739;23025;14431;52566
172110;201503;1693;6278;1526;6018;192;788;1129;4582;1321;5370
172120;201503;5314;16201;4430;15039;514;1837;3226;11225;3740;13062
172125;201503;305;912;244;817;42;161;111;374;153;535
172130;201503;536;1496;428;1322;45;168;284;897;329;1065
172208;201503;2121;6474;1946;6207;366;1272;1113;3576;1479;4848
172210;201503;2388;7478;2159;7110;470;1684;1236;4009;1706;5693
210005;201503;22078;69210;18856;64298;5572;20456;8395;28973;13967;49429
210010;201503;1632;5835;1455;5570;147;607;1120;4367;1267;4974
210015;201503;3252;10440;2941;9979;195;456;2545;8971;2740;9427
210020;201503;6952;17224;6544;16729;278;761;5876;15003;6154;15764
210030;201503;5633;18764;5286;18291;399;1742;4365;15037;4764;16779
210040;201503;1879;5397;1722;5217;140;441;1406;4271;1546;4712
210043;201503;6436;18671;5649;17669;507;1533;4392;14279;4899;15812
210047;201503;6536;25397;6016;24531;748;3332;4323;17840;5071;21172
210050;201503;2374;8651;1965;7969;659;2801;782;3323;1441;6124
210055;201503;1703;5838;1571;5654;172;637;1197;4369;1369;5006
210060;201503;7500;28542;6895;27529;681;3066;5187;21094;5868;24160
210070;201503;6950;20697;6464;20111;180;623;5860;18356;6040;18979
210080;201503;3707;12850;3634;12760;50;210;3471;12221;3521;12431
210083;201503;4310;14991;4021;14681;104;313;3805;14096;3909;14409
210087;201503;2852;8562;2617;8275;198;630;2230;7155;2428;7785
210090;201503;9976;32641;9489;31870;416;1626;8317;28036;8733;29662
210095;201503;5926;22110;5754;21873;442;1722;4868;18836;5310;20558
210100;201503;7177;21478;6682;20906;326;1194;5913;18499;6239;19693
210110;201503;2998;10562;2907;10450;113;489;2613;9435;2726;9924
210120;201503;26140;72473;22328;68005;2659;6992;16952;54522;19611;61514
210125;201503;3574;11435;3432;11282;234;616;3042;10276;3276;10892
210130;201503;4276;12758;4028;12424;317;1052;3351;10343;3668;11395
210135;201503;1669;4906;1477;4640;113;340;1220;3899;1333;4239
210140;201503;17231;55331;14975;52174;2858;10201;9334;33801;12192;44002
210150;201503;4499;11274;4068;10744;73;185;3781;9992;3854;10177
210160;201503;17380;55519;16375;54040;1657;4849;13302;45481;14959;50330
210170;201503;14021;50521;13700;50107;796;2579;12295;45942;13091;48521
210173;201503;1904;7931;1857;7848;106;508;1654;7003;1760;7511
210177;201503;2990;9422;2828;9228;201;729;2438;7953;2639;8682
210180;201503;1542;4715;1440;4565;82;300;1229;3891;1311;4191
210190;201503;4862;15546;4535;14984;254;1149;3605;11717;3859;12866
210193;201503;1397;4440;1266;4223;73;263;1065;3601;1138;3864
210197;201503;2079;6894;1925;6730;219;683;1555;5672;1774;6355
210200;201503;8690;29361;8059;28453;969;3189;6176;22710;7145;25899
210203;201503;6419;21153;6094;20736;387;1157;5436;18815;5823;19972
210207;201503;3044;10033;2851;9693;380;1197;2083;7323;2463;8520
210210;201503;8471;28841;8110;28385;132;579;7459;26468;7591;27047
210215;201503;1443;5794;1392;5715;118;546;1152;4752;1270;5298
210220;201503;6068;23419;5791;22989;426;1767;4798;19400;5224;21167
210230;201503;5064;17003;4700;16436;312;1145;3959;14001;4271;15146
210232;201503;12011;40094;10272;37961;1649;6147;7159;28053;8808;34200
210235;201503;3467;10921;3182;10552;182;694;2749;9183;2931;9877
210237;201503;2449;9231;2414;9185;36;115;2334;8952;2370;9067
210240;201503;3003;9501;2846;9280;169;513;2417;7991;2586;8504
210250;201503;5000;16117;4748;15798;132;550;4412;14670;4544;15220
210255;201503;2477;7995;2285;7652;396;1376;1574;5324;1970;6700
210260;201503;5385;17091;4903;16389;680;2199;3608;12436;4288;14635
210270;201503;5297;15196;4703;14375;108;427;4255;13032;4363;13459
210275;201503;3596;8922;3390;8703;64;101;3278;8520;3342;8621
210280;201503;5614;16977;4944;16121;295;1101;4146;13563;4441;14664
210290;201503;5633;18445;5164;17870;386;1272;4398;15567;4784;16839
210300;201503;36727;105678;30531;98051;2133;7101;24126;80434;26259;87535
210310;201503;2897;8281;2713;8038;103;261;2410;7204;2513;7465
210312;201503;2162;6992;2099;6903;82;341;1904;6262;1986;6603
210315;201503;2429;8460;2309;8296;119;487;2022;7304;2141;7791
210317;201503;4300;13008;4105;12760;239;712;3676;11585;3915;12297
210320;201503;19064;60895;17735;59301;969;3075;15579;53240;16548;56315
210325;201503;3546;11158;3177;10610;338;1212;2390;8079;2728;9291
210330;201503;36744;88692;28538;80015;3631;7875;20689;65251;24320;73126
210340;201503;11733;35796;10637;34432;1385;3611;7853;27514;9238;31125
210350;201503;10204;32067;9350;30895;645;2115;7756;26086;8401;28201
210355;201503;3928;14308;3633;13895;161;483;3289;12987;3450;13470
210360;201503;16812;50773;15446;48906;1169;3777;12501;40301;13670;44078
210370;201503;9243;22472;7871;21016;254;468;7163;19700;7417;20168
210375;201503;3215;9645;2691;9012;755;2602;1455;5052;2210;7654
210380;201503;6195;17472;5502;16554;456;1219;4599;14199;5055;15418
210390;201503;2817;9987;2572;9584;119;573;2223;8312;2342;8885
210400;201503;4950;15465;4741;15216;169;497;4362;14170;4531;14667
210405;201503;8440;23306;6842;21091;2065;6301;2973;10198;5038;16499
210407;201503;2044;7287;1806;6903;195;716;1406;5573;1601;6289
210408;201503;2336;9113;2189;8940;91;333;1958;8311;2049;8644
210409;201503;3761;13720;3558;13416;199;832;3018;11525;3217;12357
210410;201503;3483;11636;3353;11475;272;748;2903;10282;3175;11030
210420;201503;4064;13455;3756;12924;262;890;3108;10901;3370;11791
210430;201503;2193;6764;2124;6682;118;381;1891;5967;2009;6348
210440;201503;4103;12905;4002;12766;204;599;3611;11694;3815;12293
210450;201503;2886;9120;2594;8696;177;681;2142;7155;2319;7836
210455;201503;4096;12082;3608;11341;577;1833;2513;8120;3090;9953
210460;201503;3856;12471;3567;12074;140;560;3123;10639;3263;11199
210462;201503;1627;5882;1520;5683;105;458;1227;4622;1332;5080
210465;201503;2631;8694;2466;8482;288;780;2005;7233;2293;8013
210467;201503;6214;20577;5808;20103;380;1100;5050;18010;5430;19110
210470;201503;2032;5608;1572;4944;82;269;1266;4056;1348;4325
210480;201503;13946;45848;12181;43514;3157;11084;7101;27128;10258;38212
210490;201503;3473;10110;3132;9620;186;630;2627;8061;2813;8691
210500;201503;6380;26037;6121;25603;726;2872;4722;20528;5448;23400
210510;201503;6528;22264;6234;21917;331;844;5477;19991;5808;20835
210515;201503;3515;11787;3385;11633;132;389;3139;10951;3271;11340
210520;201503;2603;8118;2388;7822;105;348;2120;7019;2225;7367
210530;201503;36195;112793;29363;102616;7407;29184;14040;50271;21447;79455
210535;201503;3231;11377;3106;11193;133;492;2768;10082;2901;10574
210540;201503;13124;44444;11665;42196;2758;9672;6518;25574;9276;35246
210542;201503;5927;17630;5433;17092;314;772;4799;15590;5113;16362
210545;201503;2325;7578;2205;7385;80;382;1912;6370;1992;6752
210547;201503;3749;13202;3519;12829;288;979;2835;10615;3123;11594
210550;201503;5774;16964;5330;16503;224;472;4923;15665;5147;16137
210560;201503;4212;13153;3760;12430;219;824;3164;10439;3383;11263
210565;201503;1532;5318;1319;4997;114;535;985;3757;1099;4292
210570;201503;12488;35372;11208;33893;841;1895;9556;29999;10397;31894
210580;201503;3144;9570;2830;9177;352;899;2182;7720;2534;8619
210590;201503;4258;13298;4001;12998;243;782;3537;11645;3780;12427
210592;201503;2483;7775;2387;7623;64;254;2146;6854;2210;7108
210594;201503;2721;7740;2267;7104;125;333;1875;6075;2000;6408
210596;201503;2782;10356;2635;10081;272;1101;1998;7764;2270;8865
210598;201503;1943;6030;1805;5859;99;391;1613;5202;1712;5593
210600;201503;3247;9459;2885;8962;197;656;2365;7344;2562;8000
210610;201503;2718;8648;2461;8332;160;611;2089;7151;2249;7762
210620;201503;1933;6009;1792;5833;50;129;1646;5448;1696;5577
210630;201503;3649;12996;3222;12261;450;1768;2096;8237;2546;10005
210632;201503;4622;15997;4268;15501;389;1453;3484;12837;3873;14290
210635;201503;1911;6762;1820;6624;72;245;1654;6114;1726;6359
210637;201503;2775;9371;2594;9120;139;506;2228;7957;2367;8463
210640;201503;4282;15012;4207;14929;9;30;4119;14719;4128;14749
210650;201503;6830;21067;6682;20897;94;263;6494;20432;6588;20695
210660;201503;7750;23683;7208;22897;211;595;6719;21490;6930;22085
210663;201503;2673;7876;2515;7680;171;570;2140;6587;2311;7157
210667;201503;1788;6344;1704;6214;81;344;1497;5511;1578;5855
210670;201503;4479;16795;4305;16507;273;1152;3630;14120;3903;15272
210675;201503;4944;13858;4583;13416;325;869;3913;11707;4238;12576
210680;201503;4300;12241;3918;11785;206;556;3415;10439;3621;10995
210690;201503;7257;24098;6841;23655;263;789;6210;22047;6473;22836
210700;201503;2603;7826;2426;7633;527;1379;1597;5744;2124;7123
210710;201503;4766;15734;4546;15391;179;693;3997;13615;4176;14308
210720;201503;2542;9271;2391;9052;150;665;2095;7894;2245;8559
210725;201503;1097;4126;966;3890;139;613;583;2359;722;2972
210730;201503;1116;3602;1032;3492;85;242;863;2996;948;3238
210735;201503;4056;14368;3741;13837;693;2598;2507;9622;3200;12220
210740;201503;4946;14420;4687;14158;134;447;4461;13517;4595;13964
210745;201503;3877;11599;3621;11256;253;618;3093;9822;3346;10440
210750;201503;20350;55453;18125;52962;1993;5732;14445;43207;16438;48939
210760;201503;5984;16605;5644;16246;48;153;5516;15907;5564;16060
210770;201503;5759;16187;5122;15471;162;524;4693;14255;4855;14779
210780;201503;8521;28305;7822;27070;900;3284;5625;19839;6525;23123
210790;201503;4794;14718;4130;13985;291;732;3473;12347;3764;13079
210800;201503;4746;13778;4388;13366;139;407;3988;12321;4127;12728
210805;201503;3642;15483;3519;15262;144;645;3107;13709;3251;14354
210810;201503;5420;16706;5065;16278;356;638;4466;15141;4822;15779
210820;201503;8079;23263;7418;22353;1329;3921;4983;15468;6312;19389
210825;201503;5719;19381;5476;19075;344;1069;4783;17063;5127;18132
210830;201503;8428;25506;8049;25053;775;2122;6712;21522;7487;23644
210840;201503;3730;10310;3381;9786;223;579;2740;7990;2963;8569
210845;201503;5747;17877;5520;17629;162;376;5129;16752;5291;17128
210850;201503;6100;22012;5615;21187;732;3122;4080;15484;4812;18606
210860;201503;17417;52784;15901;50742;1444;4747;12668;41044;14112;45791
210870;201503;6071;20077;5534;19447;547;1769;4475;16211;5022;17980
210880;201503;4265;13843;4139;13667;185;596;3744;12496;3929;13092
210890;201503;5356;15815;4917;15298;411;1340;4111;12976;4522;14316
210900;201503;4979;15126;4174;13831;1375;4700;1550;5535;2925;10235
210905;201503;1854;5835;1711;5645;125;324;1426;4875;1551;5199
210910;201503;8994;28600;8237;27407;1374;4867;5650;18972;7024;23839
210920;201503;3171;10985;3057;10809;168;594;2651;9528;2819;10122
210923;201503;1489;5332;1381;5174;163;614;1003;3943;1166;4557
210927;201503;4809;15175;4616;14976;23;75;4532;14760;4555;14835
210930;201503;2544;9290;2428;9141;153;745;2085;7804;2238;8549
210940;201503;2824;11100;2773;11006;226;890;2334;9379;2560;10269
210945;201503;5960;17713;5753;17500;236;272;5464;17114;5700;17386
210950;201503;5358;16524;4734;15548;471;1592;3584;12030;4055;13622
210955;201503;1893;6139;1672;5813;263;899;1146;4200;1409;5099
210960;201503;8798;28954;8453;28482;2454;7973;4917;17743;7371;25716
210970;201503;1408;5055;1255;4820;171;787;888;3438;1059;4225
210975;201503;1763;5997;1681;5855;135;511;1354;4768;1489;5279
210980;201503;9836;23430;9575;23147;714;1398;8423;20923;9137;22321
210990;201503;16762;49858;13502;45704;2888;10236;8010;28093;10898;38329
211000;201503;15852;51013;14191;48996;737;2687;12389;43616;13126;46303
211003;201503;4773;16931;4378;16351;361;1519;3387;12978;3748;14497
211010;201503;6563;23388;6345;23136;88;288;6075;22383;6163;22671
211020;201503;7387;23457;7217;23202;315;1040;6467;20922;6782;21962
211023;201503;2347;7928;2266;7782;122;443;1986;6889;2108;7332
211027;201503;2914;11404;2818;11257;245;895;2343;9633;2588;10528
211030;201503;4057;12275;3668;11862;589;1365;2857;9979;3446;11344
211040;201503;4288;16324;4154;16116;132;579;3703;14615;3835;15194
211050;201503;10145;26910;9973;26721;254;558;9548;25769;9802;26327
211060;201503;6012;21477;5864;21258;463;1656;5006;18462;5469;20118
211065;201503;1824;6136;1661;5931;34;100;1584;5735;1618;5835
211070;201503;8321;28288;7684;27224;493;1791;6370;22929;6863;24720
211080;201503;1405;4251;1153;3896;98;479;915;2999;1013;3478
211085;201503;1878;6537;1723;6284;244;878;1254;4698;1498;5576
211090;201503;3558;10711;3345;10426;127;522;2938;9068;3065;9590
211100;201503;6678;17442;6510;17254;50;184;6321;16736;6371;16920
211102;201503;3097;11489;2939;11273;256;939;2505;9815;2761;10754
211105;201503;2705;8603;2330;8079;157;631;1949;6738;2106;7369
211107;201503;4507;14300;4082;13741;240;765;3485;12074;3725;12839
211110;201503;6294;19019;5121;17285;986;3258;3165;11240;4151;14498
211120;201503;33875;93306;29992;88663;4652;12934;21606;66520;26258;79454
211125;201503;2123;6880;1909;6548;117;424;1636;5660;1753;6084
211130;201503;135395;383179;124481;369693;22833;68042;83837;254689;106670;322731
211140;201503;5420;17303;5078;16782;220;803;4388;14544;4608;15347
211150;201503;9882;29284;9125;28360;522;1760;7870;24613;8392;26373
211153;201503;2954;9060;2751;8819;385;1042;2189;7372;2574;8414
211157;201503;1233;3961;1053;3698;117;509;712;2578;829;3087
211160;201503;4069;13760;3514;12823;321;1480;2588;9372;2909;10852
211163;201503;1654;5553;1578;5442;51;176;1432;5032;1483;5208
211167;201503;1511;5002;1412;4857;28;110;1322;4578;1350;4688
211170;201503;6488;17295;6230;17001;115;358;5816;15860;5931;16218
211172;201503;2386;7081;2158;6746;140;557;1822;5590;1962;6147
211174;201503;2828;8290;2564;7961;81;341;2307;7103;2388;7444
211176;201503;4938;15373;4389;14708;475;1600;3386;11694;3861;13294
211178;201503;3423;9838;3365;9779;60;122;3254;9529;3314;9651
211180;201503;4303;15211;4067;14843;291;1153;3402;12602;3693;13755
211190;201503;2797;9457;2604;9191;79;355;2316;8232;2395;8587
211195;201503;1490;4583;1244;4281;82;247;1034;3706;1116;3953
211200;201503;2104;7339;1881;7038;222;752;1464;5732;1686;6484
211210;201503;7176;21783;6875;21381;400;1238;5984;18830;6384;20068
211220;201503;34318;100330;29658;94433;5800;19024;19141;62626;24941;81650
211223;201503;5230;15466;4782;14761;536;1660;3588;11284;4124;12944
211227;201503;1641;6016;1525;5840;133;600;1210;4673;1343;5273
211230;201503;8655;28569;7850;27249;1006;3593;5726;20294;6732;23887
211240;201503;8141;28044;7779;27625;265;964;7214;25745;7479;26709
211245;201503;5455;15828;5396;15759;103;193;5195;15342;5298;15535
211250;201503;12818;44079;12094;43269;1434;3726;9795;37539;11229;41265
211260;201503;8504;26482;8265;26169;584;1830;7311;23320;7895;25150
211270;201503;10461;35945;9440;34699;567;2390;7807;29274;8374;31664
211280;201503;12658;37622;11952;36786;1067;2566;10127;32515;11194;35081
211285;201503;1753;6465;1570;6062;334;1400;819;3280;1153;4680
211290;201503;7250;24033;7029;23757;618;1758;5987;20827;6605;22585
211300;201503;8244;25148;7710;24419;248;816;6974;22230;7222;23046
211400;201503;12098;36694;10750;35033;2664;8576;5764;21182;8428;29758
220005;201503;1813;5261;1674;5056;72;295;1395;4107;1467;4402
220010;201503;1459;4159;1282;3904;88;327;977;2948;1065;3275
220020;201503;3360;10562;3161;10228;536;1790;2148;6962;2684;8752
220025;201503;2258;5559;2030;5223;49;141;1774;4527;1823;4668
220027;201503;1372;3727;1251;3576;76;197;1060;3074;1136;3271
220030;201503;3331;9387;3267;9285;183;606;2862;8087;3045;8693
220040;201503;7823;24453;7315;23603;1401;4676;4659;15037;6060;19713
220045;201503;1413;4585;1295;4372;97;406;980;3238;1077;3644
220050;201503;4595;13539;4007;12629;256;964;3262;10175;3518;11139
220060;201503;1982;5217;1896;5119;54;142;1766;4782;1820;4924
220070;201503;2475;7295;2244;6938;148;496;1816;5601;1964;6097
220080;201503;739;2298;700;2236;67;282;564;1740;631;2022
220090;201503;1804;4617;1541;4272;89;307;1319;3592;1408;3899
220095;201503;747;2011;705;1953;27;83;655;1803;682;1886
220100;201503;1403;4251;1192;3905;120;413;882;2925;1002;3338
220105;201503;2206;7173;1992;6764;169;598;1485;5061;1654;5659
220110;201503;3393;10071;3193;9747;178;700;2692;8044;2870;8744
220115;201503;2372;8451;2284;8314;188;771;1948;7071;2136;7842
220117;201503;1383;3674;1132;3309;92;268;902;2648;994;2916
220120;201503;12293;35705;11480;34711;183;742;10837;32736;11020;33478
220130;201503;903;3133;792;2984;58;186;690;2664;748;2850
220140;201503;1638;4418;1475;4221;230;477;1175;3566;1405;4043
220150;201503;7015;21916;6667;21454;201;778;6085;19568;6286;20346
220155;201503;1103;3426;905;3054;72;299;618;2030;690;2329
220157;201503;1062;2701;947;2532;23;71;836;2214;859;2285
220160;201503;2758;8283;2435;7734;133;549;1952;6125;2085;6674
220170;201503;1377;4297;1216;4033;65;297;993;3268;1058;3565
220173;201503;2060;6280;1735;5658;60;297;1422;4579;1482;4876
220177;201503;1764;5186;1735;5142;61;186;1628;4835;1689;5021
220180;201503;1180;3187;1004;2879;38;146;762;2125;800;2271
220190;201503;4555;15208;4157;14667;517;1753;3260;11720;3777;13473
220191;201503;1442;4905;1376;4790;183;625;1026;3605;1209;4230
220192;201503;1802;5136;1433;4481;143;475;1003;3140;1146;3615
220194;201503;1721;5128;1562;4861;149;521;1188;3605;1337;4126
220196;201503;1970;5843;1822;5603;182;605;1401;4308;1583;4913
220198;201503;1350;3805;1067;3440;17;59;996;3245;1013;3304
220200;201503;4384;15047;4174;14741;646;2334;3006;10749;3652;13083
220202;201503;2056;6461;1868;6121;40;179;1686;5485;1726;5664
220205;201503;2928;7551;2548;7046;54;208;2306;6324;2360;6532
220207;201503;871;2715;778;2556;76;301;589;1911;665;2212
220208;201503;1773;5856;1573;5497;193;791;1118;3878;1311;4669
220209;201503;1521;4702;1389;4494;61;266;1127;3619;1188;3885
220210;201503;1757;4738;1553;4439;48;188;1323;3727;1371;3915
220211;201503;1635;4801;1556;4699;93;383;1339;3979;1432;4362
220213;201503;1769;5109;1648;4897;55;216;1380;4032;1435;4248
220217;201503;1891;6189;1816;6102;42;116;1700;5788;1742;5904
220220;201503;11190;31537;10173;30009;928;2473;7535;22847;8463;25320
220225;201503;1058;3167;928;2989;37;165;808;2562;845;2727
220230;201503;5687;15356;4976;14392;157;439;4466;13008;4623;13447
220240;201503;2845;8948;2656;8629;190;697;2075;6726;2265;7423
220245;201503;1488;4027;1331;3805;50;141;1168;3388;1218;3529
220250;201503;3173;9043;2965;8738;54;162;2742;8137;2796;8299
220253;201503;1771;5279;1500;4816;135;508;1131;3619;1266;4127
220255;201503;1763;5018;1534;4646;79;329;1264;3722;1343;4051
220260;201503;4758;15277;4225;14303;338;1185;3226;11000;3564;12185
220265;201503;1334;4688;1226;4519;106;461;871;3246;977;3707
220270;201503;6798;22071;6590;21713;352;1629;5705;18371;6057;20000
220271;201503;1501;4236;1400;4088;60;144;1237;3683;1297;3827
220272;201503;1800;5532;1660;5288;81;336;1340;4223;1421;4559
220273;201503;1214;3584;1093;3381;97;329;847;2600;944;2929
220275;201503;2066;5401;1735;5003;28;97;1611;4621;1639;4718
220277;201503;2356;6610;2123;6258;112;372;1744;5162;1856;5534
220280;201503;1734;4594;1517;4237;123;437;1144;3097;1267;3534
220285;201503;1592;4351;1380;4053;45;176;1211;3577;1256;3753
220290;201503;6172;20649;5373;19563;513;2119;4127;15102;4640;17221
220300;201503;1952;6371;1741;6083;80;360;1475;5150;1555;5510
220310;201503;2507;8397;2237;8094;71;202;2036;7629;2107;7831
220320;201503;3355;9972;2853;9088;340;1195;2031;6464;2371;7659
220323;201503;1501;5337;1318;5072;148;611;998;3897;1146;4508
220325;201503;1133;3752;1013;3512;93;391;749;2579;842;2970
220327;201503;1372;4406;1244;4192;57;289;1007;3339;1064;3628
220330;201503;3636;10101;3403;9810;148;420;3043;8839;3191;9259
220335;201503;2039;5919;1813;5651;71;228;1619;5097;1690;5325
220340;201503;1910;5331;1645;4943;129;428;1265;3768;1394;4196
220342;201503;1087;3700;1029;3613;82;348;846;2980;928;3328
220345;201503;2927;7742;2554;7162;54;155;2300;6437;2354;6592
220350;201503;4016;10733;3504;9957;200;631;2854;8088;3054;8719
220360;201503;1286;3655;1131;3408;110;381;853;2534;963;2915
220370;201503;9161;26376;8315;25291;356;1074;7471;22837;7827;23911
220375;201503;1544;4853;1430;4713;37;134;1339;4439;1376;4573
220380;201503;1421;3839;1216;3561;66;218;993;2887;1059;3105
220385;201503;815;2152;676;1923;39;135;546;1519;585;1654
220390;201503;9498;29674;8567;27952;2237;7667;3342;11019;5579;18686
220400;201503;1529;3601;1270;3211;41;144;1081;2649;1122;2793
220410;201503;1408;4005;1178;3676;103;410;913;2780;1016;3190
220415;201503;868;2372;780;2255;65;194;594;1718;659;1912
220420;201503;2182;6366;1903;5808;104;325;1545;4742;1649;5067
220430;201503;2555;7461;2474;7349;149;470;2136;6336;2285;6806
220435;201503;1592;4742;1482;4563;43;143;1275;3929;1318;4072
220440;201503;2484;8134;2296;7914;112;381;2027;7018;2139;7399
220450;201503;2333;7112;1990;6622;444;1592;1170;3888;1614;5480
220455;201503;1340;4283;1248;4156;45;146;1141;3849;1186;3995
220460;201503;967;2601;893;2512;37;101;806;2262;843;2363
220465;201503;2349;7822;2137;7500;514;1926;1282;4526;1796;6452
220470;201503;4039;12043;3679;11453;210;750;2887;8869;3097;9619
220480;201503;2556;7362;2288;6979;159;486;1851;5670;2010;6156
220490;201503;2327;6706;2161;6502;75;277;1935;5811;2010;6088
220500;201503;3378;9036;2837;8128;115;500;2313;6447;2428;6947
220510;201503;3011;8384;2261;7240;108;464;1686;5358;1794;5822
220515;201503;1998;4894;1743;4574;136;337;1429;3796;1565;4133
220520;201503;5147;14328;4744;13782;132;403;4288;12531;4420;12934
220525;201503;1347;3826;1253;3686;60;215;1070;3108;1130;3323
220527;201503;1412;4348;1266;4038;136;437;944;3080;1080;3517
220530;201503;1242;3662;1124;3488;74;295;952;2885;1026;3180
220535;201503;904;2739;858;2683;81;279;679;2112;760;2391
220540;201503;3511;11442;3357;11207;155;633;2895;9645;3050;10278
220545;201503;1420;4828;1360;4720;168;676;1015;3467;1183;4143
220550;201503;9212;29872;8657;28967;1075;3795;6392;21506;7467;25301
220551;201503;1435;4756;1328;4583;83;374;1069;3653;1152;4027
220552;201503;1615;5107;1410;4722;95;461;1080;3477;1175;3938
220553;201503;1666;4904;1380;4472;61;235;1119;3660;1180;3895
220554;201503;821;2376;729;2243;73;225;564;1750;637;1975
220555;201503;2355;6969;2193;6768;52;195;1989;6140;2041;6335
220556;201503;1474;4585;1324;4306;68;280;1030;3298;1098;3578
220557;201503;1574;5169;1421;4877;172;648;966;3311;1138;3959
220558;201503;1069;3316;973;3149;72;313;728;2288;800;2601
220559;201503;1516;4250;1371;4018;39;144;1197;3500;1236;3644
220560;201503;1749;4311;1436;3897;69;187;1226;3315;1295;3502
220570;201503;7466;23933;7006;23174;1280;4217;4664;15842;5944;20059
220580;201503;6547;21254;6385;21061;293;907;5882;19610;6175;20517
220585;201503;1985;7187;1899;7030;114;458;1615;6002;1729;6460
220590;201503;1349;4106;1226;3932;200;661;846;2773;1046;3434
220595;201503;2389;6956;2195;6700;45;184;1999;6076;2044;6260
220600;201503;1295;3165;1060;2876;181;354;767;2233;948;2587
220605;201503;1995;5881;1744;5500;79;262;1451;4575;1530;4837
220610;201503;2694;8268;2604;8135;96;382;2332;7250;2428;7632
220620;201503;7800;26356;7562;26013;321;1311;6780;23343;7101;24654
220630;201503;401;1243;348;1141;66;227;187;624;253;851
220635;201503;1767;6300;1605;5940;124;591;1107;4050;1231;4641
220640;201503;2674;7826;2460;7527;135;468;2095;6392;2230;6860
220650;201503;2332;6730;2082;6303;119;420;1693;5091;1812;5511
220660;201503;2563;8181;2280;7807;199;873;1882;6308;2081;7181
220665;201503;1177;4137;1129;4054;37;177;1029;3678;1066;3855
220667;201503;1797;5949;1692;5812;56;208;1481;5122;1537;5330
220669;201503;1915;6240;1785;6006;267;1065;1212;4030;1479;5095
220670;201503;2059;6269;1879;6037;149;365;1609;5380;1758;5745
220672;201503;2548;7236;2418;7085;252;716;2002;5953;2254;6669
220675;201503;1310;3796;1223;3653;89;239;971;2922;1060;3161
220680;201503;2242;7298;2125;7139;168;563;1776;6045;1944;6608
220690;201503;1755;4884;1520;4508;99;331;1205;3582;1304;3913
220695;201503;923;2672;857;2564;46;160;688;2032;734;2192
220700;201503;8810;25353;7873;23935;591;2046;6177;18685;6768;20731
220710;201503;812;2405;678;2172;51;149;495;1614;546;1763
220720;201503;2079;5665;1978;5535;58;172;1778;5001;1836;5173
220730;201503;1405;3941;1205;3630;41;166;1016;3032;1057;3198
220735;201503;1027;2651;834;2314;41;151;681;1859;722;2010
220740;201503;1461;4603;1219;4282;142;492;959;3471;1101;3963
220750;201503;3995;11625;3743;11248;428;1080;2959;9216;3387;10296
220755;201503;1227;3529;1125;3359;56;197;938;2785;994;2982
220760;201503;2688;9374;2532;9171;119;513;2219;8090;2338;8603
220770;201503;22692;75647;20496;71437;6736;24651;7510;27020;14246;51671
220775;201503;1213;3167;1178;3128;8;12;1159;3089;1167;3101
220777;201503;1678;4681;1528;4456;97;272;1232;3576;1329;3848
220779;201503;1270;3523;1232;3476;36;132;1136;3157;1172;3289
220780;201503;6195;16310;5504;15325;378;1018;4584;12856;4962;13874
220785;201503;1317;3552;1281;3477;54;129;1191;3242;1245;3371
220790;201503;9919;31097;9282;30094;888;3090;7342;23717;8230;26807
220793;201503;851;2451;781;2341;39;146;667;1985;706;2131
220795;201503;1467;4129;1416;4057;74;217;1270;3648;1344;3865
220800;201503;16494;45705;14994;43612;1028;3667;11696;33613;12724;37280
220810;201503;3370;9817;2929;9084;154;623;2336;7162;2490;7785
220820;201503;5354;14882;4981;14363;182;586;4499;12956;4681;13542
220830;201503;7560;21486;7095;20734;699;2058;5600;16526;6299;18584
220840;201503;14620;46384;13092;43352;3152;10700;6257;21151;9409;31851
220850;201503;2844;9853;2716;9693;141;550;2401;8648;2542;9198
220855;201503;639;1969;567;1843;47;182;415;1326;462;1508
220860;201503;965;2610;865;2453;47;176;712;1986;759;2162
220865;201503;2714;7462;2177;6576;101;491;1764;5157;1865;5648
220870;201503;2378;7854;2101;7500;73;274;1916;6877;1989;7151
220880;201503;4845;13058;4549;12716;131;424;4237;11844;4368;12268
220885;201503;1338;4775;1186;4497;107;509;892;3364;999;3873
220887;201503;1402;3523;1213;3260;21;67;1135;3054;1156;3121
220890;201503;1630;5727;1483;5479;118;405;1209;4613;1327;5018
220900;201503;1883;5420;1666;5005;74;212;1405;4230;1479;4442
220910;201503;1649;4964;1468;4699;63;201;1282;4141;1345;4342
220915;201503;1043;2974;901;2715;45;195;699;2053;744;2248
220920;201503;1343;4917;1239;4768;117;544;935;3554;1052;4098
220930;201503;1384;4649;1318;4554;69;290;1115;3869;1184;4159
220935;201503;1078;3295;965;3057;56;244;691;2111;747;2355
220937;201503;1547;4241;1302;3817;68;257;1018;2909;1086;3166
220940;201503;1418;4407;1312;4186;81;337;1013;3192;1094;3529
220945;201503;454;1641;420;1576;45;195;299;1105;344;1300
220950;201503;1324;3314;977;2751;34;135;725;1988;759;2123
220955;201503;1486;4316;1308;4017;93;311;1011;3093;1104;3404
220960;201503;904;2392;725;2091;19;78;586;1667;605;1745
220965;201503;1696;5103;1602;4970;60;276;1405;4293;1465;4569
220970;201503;2171;5787;1620;4906;153;478;1115;3411;1268;3889
220975;201503;661;2234;636;2204;32;133;587;2022;619;2155
220980;201503;1323;4060;1163;3782;99;372;847;2764;946;3136
220985;201503;1248;3684;1193;3599;98;345;950;2835;1048;3180
220987;201503;1523;4854;1390;4627;93;414;1061;3443;1154;3857
220990;201503;1877;5402;1633;5000;60;268;1280;3842;1340;4110
220995;201503;1316;3846;994;3337;83;329;744;2526;827;2855
220997;201503;2206;6958;2107;6814;63;210;1963;6370;2026;6580
221000;201503;4444;13607;4101;13033;438;1612;3071;9647;3509;11259
221005;201503;1449;4584;1338;4375;464;1404;623;2189;1087;3593
221010;201503;1174;3195;1010;2980;49;144;888;2630;937;2774
221020;201503;1843;5719;1718;5495;94;410;1321;4156;1415;4566
221030;201503;1628;4679;1433;4377;82;342;1183;3559;1265;3901
221035;201503;1448;4020;1362;3915;52;118;1260;3676;1312;3794
221037;201503;639;1922;574;1813;23;100;444;1345;467;1445
221038;201503;633;1787;510;1577;45;131;332;1052;377;1183
221039;201503;925;2668;845;2552;51;210;725;2136;776;2346
221040;201503;4701;14481;4439;14055;236;839;3682;11740;3918;12579
221050;201503;3522;10890;3345;10651;167;626;2908;9240;3075;9866
221060;201503;8215;23769;7360;22428;711;2327;5630;17233;6341;19560
221062;201503;1300;4568;1215;4433;27;101;1111;4095;1138;4196
221063;201503;1056;3516;982;3374;270;870;577;2152;847;3022
221065;201503;2812;7866;2572;7494;205;606;2107;6122;2312;6728
221070;201503;3964;12464;3510;11714;162;660;2916;9747;3078;10407
221080;201503;3510;9282;3063;8681;139;443;2627;7463;2766;7906
221090;201503;1376;3787;1184;3478;33;143;981;2830;1014;2973
221093;201503;1721;5144;1621;4940;341;1120;897;2668;1238;3788
221095;201503;971;2644;877;2511;29;85;770;2216;799;2301
221097;201503;815;2306;696;2099;53;214;520;1529;573;1743
221100;201503;117619;345382;108346;330120;20374;66922;68065;204216;88439;271138
221110;201503;10209;32851;9657;32169;452;1710;8459;28250;8911;29960
221120;201503;4156;13622;3955;13274;840;2911;2621;8883;3461;11794
221130;201503;4561;13312;3911;12008;1277;3964;1662;5117;2939;9081
221135;201503;1496;4726;1398;4590;156;596;1127;3640;1283;4236
221140;201503;1361;3391;1251;3247;57;137;1121;2918;1178;3055
221150;201503;1241;3209;1025;2843;27;122;821;2239;848;2361
221160;201503;842;2236;793;2160;38;113;637;1753;675;1866
221170;201503;1158;3614;1075;3477;66;242;869;2788;935;3030
230010;201503;3301;9110;2775;8215;148;506;2281;6720;2429;7226
230015;201503;2866;9949;2683;9552;407;1692;1706;5966;2113;7658
230020;201503;14379;47219;13903;46397;683;2533;11893;39927;12576;42460
230030;201503;12276;35690;11219;34056;588;2037;9404;28493;9992;30530
230040;201503;4638;12881;3928;11686;270;951;3030;8955;3300;9906
230050;201503;2598;8949;2058;7515;427;1659;851;3106;1278;4765
230060;201503;2167;6326;1892;5843;121;441;1448;4424;1569;4865
230070;201503;4484;12285;3854;11317;365;1175;2725;8119;3090;9294
230075;201503;8845;31947;8299;30842;636;3208;6600;24047;7236;27255
230080;201503;2395;6411;1972;5798;104;347;1641;4816;1745;5163
230090;201503;3733;11105;3331;10416;376;1303;2445;7663;2821;8966
230100;201503;16606;50158;15171;47513;2936;9926;8840;27783;11776;37709
230110;201503;13681;44056;12676;41983;2396;8562;7286;23909;9682;32471
230120;201503;7993;22145;6929;20630;769;2204;4970;15460;5739;17664
230125;201503;2949;8653;2442;7695;173;599;1796;5637;1969;6236
230130;201503;5852;19208;4968;17346;496;2067;3418;11732;3914;13799
230140;201503;3623;11626;3094;10673;409;1522;2077;7306;2486;8828
230150;201503;1669;5299;1456;4861;268;1014;876;2843;1144;3857
230160;201503;6467;19464;5755;18384;393;1501;4516;14369;4909;15870
230170;201503;6531;20449;5575;18695;390;1558;4129;13747;4519;15305
230180;201503;1774;5223;1577;4851;101;394;1176;3510;1277;3904
230185;201503;4182;13726;3792;13010;657;2291;2381;8488;3038;10779
230190;201503;13081;41797;11629;38920;2443;9161;5804;19074;8247;28235
230195;201503;5176;15930;4595;14970;273;1201;3666;11623;3939;12824
230200;201503;5508;16014;4939;14917;459;1509;3668;11006;4127;12515
230205;201503;4279;13629;3832;12867;273;1186;2833;9466;3106;10652
230210;201503;9090;26416;7924;24611;1806;5704;4471;14392;6277;20096
230220;201503;13183;38181;11941;36066;1255;4354;8709;25919;9964;30273
230230;201503;7633;24871;6929;23490;1009;3593;4456;15266;5465;18859
230240;201503;13748;39257;12270;36733;642;2384;9741;28712;10383;31096
230250;201503;10130;31474;9958;31227;434;1613;8557;26716;8991;28329
230260;201503;14674;49610;13617;47517;2510;9342;7948;28282;10458;37624
230270;201503;7348;22019;6372;20340;760;2675;4336;13972;5096;16647
230280;201503;19924;59685;17805;56152;2201;7053;12681;40412;14882;47465
230290;201503;4866;14991;4206;13676;571;1881;2840;9281;3411;11162
230300;201503;4456;13696;4242;13386;329;1264;3402;10590;3731;11854
230310;201503;4872;14569;4257;13556;295;1234;3186;9985;3481;11219
230320;201503;7071;22663;6510;21676;518;2104;5005;16576;5523;18680
230330;201503;4860;14354;4212;13106;320;1148;3055;9414;3375;10562
230340;201503;3450;11773;3174;11191;431;1729;2048;7072;2479;8801
230350;201503;17902;55113;16219;52244;2267;8017;10138;33376;12405;41393
230360;201503;3311;9552;2722;8461;314;1106;1825;5624;2139;6730
230365;201503;3056;8461;2680;7852;123;460;2191;6369;2314;6829
230370;201503;54394;177414;49327;168761;13528;48836;23360;82209;36888;131045
230380;201503;6590;19457;5632;17741;371;1322;4178;13173;4549;14495
230390;201503;3575;11304;3180;10637;297;1268;2279;7474;2576;8742
230393;201503;3300;10945;2829;9981;262;1263;2001;6774;2263;8037
230395;201503;5414;16292;4866;15336;778;2559;3028;9724;3806;12283
230400;201503;5359;16485;4670;15398;293;1286;3631;11767;3924;13053
230410;201503;14315;45906;12645;42384;1884;6792;7885;26439;9769;33231
230420;201503;24595;80094;22478;75857;5327;19443;10804;36334;16131;55777
230423;201503;4147;13809;3845;13209;289;1193;2958;10105;3247;11298
230425;201503;5562;18566;5111;17563;708;2587;3399;11719;4107;14306
230426;201503;2796;7848;2248;6816;122;505;1690;4990;1812;5495
230427;201503;1820;5515;1430;4692;149;564;922;2954;1071;3518
230428;201503;8566;27332;8194;26691;1351;4943;5212;16800;6563;21743
230430;201503;4543;14573;4247;14009;365;1501;3087;9960;3452;11461
230435;201503;4742;15528;4288;14728;802;3154;2392;8142;3194;11296
230440;201503;352480;1069797;326190;1024170;78240;262008;158726;500726;236966;762734
230445;201503;4550;12341;3854;11326;265;765;2910;8710;3175;9475
230450;201503;3566;11463;3111;10636;361;1521;2095;7062;2456;8583
230460;201503;1920;6389;1708;6004;186;778;1200;4180;1386;4958
230465;201503;4181;12522;3521;11324;277;1178;2438;7679;2715;8857
230470;201503;10520;39263;9971;38140;1153;4878;7293;27991;8446;32869
230480;201503;1451;4685;1240;4293;178;674;811;2818;989;3492
230490;201503;2578;7790;2237;7151;387;1371;1168;3604;1555;4975
230495;201503;5808;19425;5244;18484;805;3396;3065;10769;3870;14165
230500;201503;9560;33551;9142;32787;624;2663;7249;26120;7873;28783
230510;201503;1536;5514;1259;4809;332;1367;433;1724;765;3091
230520;201503;4863;15018;4368;14134;460;1723;2930;9440;3390;11163
230523;201503;14487;47535;12762;43584;3129;11846;3528;12283;6657;24129
230526;201503;4034;12429;3531;11585;286;1150;2627;8586;2913;9736
230530;201503;5363;17582;4868;16915;991;3495;3198;11458;4189;14953
230533;201503;3961;11324;3570;10614;250;824;2772;8203;3022;9027
230535;201503;5575;16545;4880;15307;661;2048;3201;10384;3862;12432
230540;201503;18207;53081;16395;50249;729;2884;13812;41960;14541;44844
230550;201503;19699;59430;17774;55741;3724;12644;9513;29578;13237;42222
230560;201503;6687;19396;5992;18162;256;1035;4827;14448;5083;15483
230565;201503;3376;9510;2737;8294;158;591;2003;6002;2161;6593
230570;201503;3835;10349;3376;9783;136;523;2854;8199;2990;8722
230580;201503;10185;31148;9549;30262;449;1477;8516;27190;8965;28667
230590;201503;8890;28082;7785;25992;606;2600;5756;18740;6362;21340
230600;201503;3654;10335;2839;8697;198;684;1859;5671;2057;6355
230610;201503;6006;19708;5602;19066;713;2540;4064;13986;4777;16526
230620;201503;2188;6222;1749;5286;180;612;1052;3081;1232;3693
230625;201503;7855;25608;7032;23755;2096;7584;2163;7351;4259;14935
230630;201503;11425;36784;10440;34981;2758;8816;5000;17980;7758;26796
230640;201503;26139;86072;24232;83277;2743;10352;18538;63905;21281;74257
230650;201503;4951;15269;4454;14314;295;1217;3434;10785;3729;12002
230655;201503;9052;34269;8695;33655;684;2773;7242;28486;7926;31259
230660;201503;6187;19383;5315;17769;392;1671;4016;13215;4408;14886
230670;201503;6128;16565;4966;14586;207;815;3835;10961;4042;11776
230680;201503;2916;8524;2446;7653;371;1256;1457;4533;1828;5789
230690;201503;6246;20586;6154;20397;519;2142;4373;14206;4892;16348
230700;201503;9387;27081;8394;25343;747;2767;5984;17582;6731;20349
230710;201503;7477;24479;6538;22743;780;2770;4698;16603;5478;19373
230720;201503;1913;6062;1657;5580;208;745;1113;3814;1321;4559
230725;201503;3730;12640;3277;11550;770;2806;1413;4990;2183;7796
230730;201503;57569;174753;47881;158767;13153;48215;16042;54540;29195;102755
230740;201503;5908;18148;5446;17384;284;1229;4497;14155;4781;15384
230750;201503;8579;24717;7333;22725;461;1698;5748;17690;6209;19388
230760;201503;10384;31256;9702;29852;1051;3869;6896;20435;7947;24304
230763;201503;4320;13468;3936;12740;251;1184;3036;9511;3287;10695
230765;201503;39137;126314;35654;119385;9974;36340;12496;42133;22470;78473
230770;201503;24766;69071;22732;66270;2496;7834;16531;48366;19027;56200
230780;201503;6127;23798;5849;23193;1485;5994;2881;12077;4366;18071
230790;201503;2615;8704;2443;8421;273;1035;1845;6385;2118;7420
230800;201503;7590;27219;6919;25754;1528;6188;3292;12188;4820;18376
230810;201503;12106;39642;11457;38537;945;3341;9287;31496;10232;34837
230820;201503;3351;11501;2939;10616;435;1801;1715;6118;2150;7919
230830;201503;7635;23333;6781;21772;613;2290;4899;15623;5512;17913
230835;201503;4075;10879;3379;9871;225;734;2675;7814;2900;8548
230837;201503;3176;10831;2771;10011;318;1357;1875;6696;2193;8053
230840;201503;9225;30319;8442;28964;801;3071;6376;22047;7177;25118
230850;201503;10179;31364;9374;30224;996;3550;7041;22678;8037;26228
230860;201503;5271;15258;4692;14341;291;1065;3753;11407;4044;12472
230870;201503;18959;50704;16548;47088;991;3264;12961;36679;13952;39943
230880;201503;1917;6641;1802;6415;211;905;1213;4274;1424;5179
230890;201503;3992;14632;3691;13968;544;2492;2364;8720;2908;11212
230900;201503;3011;10062;2563;9125;537;1878;1323;4838;1860;6716
230910;201503;3187;9373;2579;8260;205;849;1864;5834;2069;6683
230920;201503;4557;13437;4255;13071;163;615;3802;11760;3965;12375
230930;201503;7491;22831;6637;21243;702;2401;4607;14859;5309;17260
230940;201503;7751;22263;6779;20792;387;1245;5455;16855;5842;18100
230945;201503;6225;18725;5391;17510;537;2002;3817;12573;4354;14575
230950;201503;7097;19412;6230;18270;378;1170;4973;14799;5351;15969
230960;201503;13842;43063;12595;40684;2688;9346;6096;19932;8784;29278
230970;201503;13335;41544;11843;38728;2452;9066;5551;17853;8003;26919
230980;201503;2980;9532;2621;8868;773;2669;1221;4317;1994;6986
230990;201503;1693;5132;1409;4558;144;602;934;2929;1078;3531
231000;201503;2874;7782;2270;6631;228;767;1451;4113;1679;4880
231010;201503;3215;8783;2677;7933;256;900;2005;5840;2261;6740
231020;201503;7891;26565;7502;25758;1333;4677;4731;16592;6064;21269
231025;201503;7929;24635;7199;23399;1044;3561;4748;15755;5792;19316
231030;201503;8073;26301;6827;23768;1210;4544;3911;13718;5121;18262
231040;201503;3158;10228;2814;9533;234;991;2021;6696;2255;7687
231050;201503;12049;34500;10316;31409;841;2909;7654;23222;8495;26131
231060;201503;2479;7950;2268;7578;183;829;1626;5294;1809;6123
231070;201503;8923;28447;8159;26925;1385;4887;4844;16174;6229;21061
231080;201503;4239;13314;3866;12676;208;965;2960;9411;3168;10376
231085;201503;4719;14882;4545;14642;601;1846;3408;11391;4009;13237
231090;201503;4204;11873;3422;10318;191;710;2418;7161;2609;7871
231095;201503;2264;7385;1944;6740;215;833;1305;4548;1520;5381
231100;201503;3194;9907;2680;8899;229;889;1917;6298;2146;7187
231110;201503;3752;12532;3670;12392;363;1397;2740;9254;3103;10651
231120;201503;2146;7194;2020;6944;310;1144;1339;4639;1649;5783
231123;201503;2176;5968;1868;5443;152;425;1471;4323;1623;4748
231126;201503;6430;18189;5382;16542;349;1352;4045;12320;4394;13672
231130;201503;18961;59315;17130;56201;3596;12133;9988;34133;13584;46266
231135;201503;4303;12827;3641;11709;313;1174;2653;8459;2966;9633
231140;201503;16804;53518;15003;50109;1432;6432;10076;32447;11508;38879
231150;201503;5831;16835;4909;15138;813;2745;2695;8154;3508;10899
231160;201503;5748;19507;5414;18871;924;3393;3595;12592;4519;15985
231170;201503;4376;14168;3942;13269;334;1468;2796;9177;3130;10645
231180;201503;14330;43035;12890;40216;2176;7401;7840;24108;10016;31509
231190;201503;4716;13348;4024;12331;289;1059;3174;9581;3463;10640
231195;201503;4611;15699;3997;14486;392;1773;2886;10356;3278;12129
231200;201503;7826;26906;6856;24932;537;2644;4961;17657;5498;20301
231210;201503;5137;15895;4441;14936;260;1152;3523;11840;3783;12992
231220;201503;11744;34753;10657;32767;727;2798;7963;24067;8690;26865
231230;201503;8678;29793;8022;28754;765;3230;6208;22267;6973;25497
231240;201503;11997;38279;10873;36068;2140;7553;5826;19664;7966;27217
231250;201503;1977;5767;1378;4309;437;1324;300;975;737;2299
231260;201503;3716;10837;3351;10283;493;1518;2231;6982;2724;8500
231270;201503;7339;20493;6499;19161;421;1773;4958;14215;5379;15988
231280;201503;1771;5821;1650;5591;150;520;1209;4158;1359;4678
231290;201503;33854;117105;30796;110173;6865;27450;13249;46414;20114;73864
231300;201503;4673;13590;3792;11849;279;1091;2676;8146;2955;9237
231310;201503;7395;21161;6205;18733;994;3168;3536;10483;4530;13651
231320;201503;6906;21360;5962;19533;326;1356;4368;14305;4694;15661
231325;201503;2690;8124;2390;7630;192;712;1755;5643;1947;6355
231330;201503;12716;40264;10952;36824;1666;5700;6935;23627;8601;29327
231335;201503;5353;15411;4635;14128;261;1055;3692;11005;3953;12060
231340;201503;17470;57740;16284;56004;1000;3409;13557;47696;14557;51105
231350;201503;12969;42264;12609;41739;1159;3648;10534;35515;11693;39163
231355;201503;4375;14195;4115;13775;221;853;3373;11350;3594;12203
231360;201503;7460;24435;6760;23198;1486;5043;4053;14429;5539;19472
231370;201503;2506;6974;1968;6099;92;310;1506;4665;1598;4975
231375;201503;4184;14311;3926;13820;270;1229;3173;11030;3443;12259
231380;201503;5187;16801;4909;16415;661;2312;3462;11902;4123;14214
231390;201503;3425;10861;3172;10447;247;1039;2381;7731;2628;8770
231395;201503;3928;12987;3613;12428;660;2375;2191;7626;2851;10001
231400;201503;9259;28468;8631;27218;646;2508;6453;20109;7099;22617
231410;201503;13443;46378;12507;44874;1065;4064;9798;35447;10863;39511
240010;201503;2457;7520;2090;6757;398;1452;983;3051;1381;4503
240020;201503;11040;34965;9816;32644;2316;8256;4734;15909;7050;24165
240030;201503;2500;7327;2443;7236;164;572;2050;5995;2214;6567
240040;201503;846;2519;719;2266;36;170;519;1559;555;1729
240050;201503;3468;9447;2973;8596;129;466;2393;6825;2522;7291
240060;201503;1400;4093;1261;3825;66;263;1025;3008;1091;3271
240070;201503;2633;7545;2484;7278;386;1198;1699;4936;2085;6134
240080;201503;3051;8243;2625;7687;236;670;2027;5967;2263;6637
240090;201503;2307;6267;1930;5583;59;236;1534;4329;1593;4565
240100;201503;8687;24994;7830;23260;694;2407;5627;16247;6321;18654
240110;201503;5294;16182;4689;15061;822;2979;2682;8289;3504;11268
240120;201503;2761;9415;2639;9183;418;1598;1803;6276;2221;7874
240130;201503;2814;7595;2413;6983;151;539;1897;5381;2048;5920
240140;201503;2233;6738;1911;6148;339;1277;1088;3407;1427;4684
240145;201503;5989;18834;5377;17761;1409;5056;2702;9021;4111;14077
240150;201503;1006;3052;824;2686;87;367;525;1625;612;1992
240160;201503;1455;4702;1276;4396;184;690;784;2795;968;3485
240165;201503;892;2849;777;2608;110;333;494;1749;604;2082
240170;201503;2436;7269;2129;6720;551;1929;983;3032;1534;4961
240180;201503;2651;8447;2422;8023;525;1862;1360;4595;1885;6457
240185;201503;1418;4775;1361;4672;121;442;1077;3731;1198;4173
240190;201503;984;3003;895;2849;55;235;681;2115;736;2350
240200;201503;14286;37232;11894;34088;2560;7482;6293;18766;8853;26248
240210;201503;2858;8100;2615;7752;188;659;2194;6444;2382;7103
240220;201503;7418;24363;7026;23810;494;2172;5867;19664;6361;21836
240230;201503;5526;15124;4913;14112;218;748;4127;11747;4345;12495
240240;201503;1834;5571;1275;4193;306;1131;256;725;562;1856
240250;201503;2741;7961;2579;7746;139;471;2171;6490;2310;6961
240260;201503;12974;43867;12293;42771;1946;7668;8055;28041;10001;35709
240270;201503;2275;7311;2098;7019;201;672;1640;5588;1841;6260
240280;201503;1569;4435;1402;4156;80;296;1129;3300;1209;3596
240290;201503;1361;4310;1193;4007;97;467;814;2622;911;3089
240300;201503;2254;6278;1643;4968;415;1340;580;1693;995;3033
240310;201503;9696;27831;8836;26488;1447;4807;4941;14947;6388;19754
240320;201503;2071;6162;1692;5399;86;389;1239;3817;1325;4206
240325;201503;38571;105795;30018;92030;9391;31169;8011;25036;17402;56205
240330;201503;1523;4579;1281;4106;123;494;844;2608;967;3102
240340;201503;1859;5299;1582;4864;182;606;1143;3507;1325;4113
240350;201503;1995;5891;1858;5709;130;481;1601;4879;1731;5360
240360;201503;7108;21340;6210;20016;1157;4006;3610;12014;4767;16020
240370;201503;1979;5457;1622;4829;200;609;1049;3121;1249;3730
240375;201503;866;2326;758;2158;124;417;482;1310;606;1727
240380;201503;2526;7586;1989;6390;264;883;1102;3528;1366;4411
240390;201503;960;2635;805;2352;57;218;597;1683;654;1901
240400;201503;1335;3683;1131;3330;110;374;817;2345;927;2719
240410;201503;521;1707;480;1625;85;338;298;997;383;1335
240420;201503;4761;18219;4508;17676;1074;4448;2502;10074;3576;14522
240430;201503;3280;9361;3023;8930;161;641;2454;7068;2615;7709
240440;201503;2654;7043;2400;6639;588;1646;1293;3574;1881;5220
240450;201503;3555;10764;3147;9995;323;1347;2063;6262;2386;7609
240460;201503;2959;9103;2796;8891;211;870;2316;7212;2527;8082
240470;201503;3680;11399;2955;9856;454;1602;1726;5728;2180;7330
240480;201503;512;1330;414;1131;39;109;240;642;279;751
240485;201503;2092;6479;1843;6013;346;1227;1064;3517;1410;4744
240490;201503;1657;4238;1403;3854;63;232;1144;3041;1207;3273
240500;201503;2089;6096;1906;5812;142;493;1487;4511;1629;5004
240510;201503;1786;5389;1659;5175;173;572;1294;4056;1467;4628
240520;201503;1358;3892;1165;3600;127;477;868;2620;995;3097
240530;201503;2116;6764;1907;6431;298;1049;1323;4482;1621;5531
240540;201503;1716;5307;1640;5186;134;493;1301;4087;1435;4580
240550;201503;842;2396;730;2206;58;198;560;1662;618;1860
240560;201503;3252;9509;3051;9218;275;831;2489;7587;2764;8418
240570;201503;3105;8795;2448;7337;551;1827;943;2529;1494;4356
240580;201503;7611;24167;7147;23348;939;3337;5347;17387;6286;20724
240590;201503;794;2245;688;2057;38;159;518;1511;556;1670
240600;201503;1642;4826;1308;4143;176;673;740;2238;916;2911
240610;201503;4917;13942;4242;12679;536;1752;2602;7573;3138;9325
240615;201503;1044;3043;853;2676;139;448;490;1512;629;1960
240620;201503;1745;5509;1564;5212;195;660;1183;4000;1378;4660
240630;201503;2003;6264;1860;6020;162;458;1425;4797;1587;5255
240640;201503;899;2667;758;2429;76;339;524;1618;600;1957
240650;201503;3790;11600;3457;11129;219;797;2827;9178;3046;9975
240660;201503;2395;7763;2266;7573;223;779;1780;6001;2003;6780
240670;201503;2722;8173;2267;7231;309;1102;1273;3994;1582;5096
240680;201503;1512;4461;1220;3931;128;468;772;2478;900;2946
240690;201503;977;2761;855;2560;56;222;693;2023;749;2245
240700;201503;2744;8201;2271;7317;96;458;1749;5500;1845;5958
240710;201503;18815;48785;16505;45608;2999;8196;10228;29061;13227;37257
240720;201503;5289;15155;4972;14651;1596;4934;2340;6696;3936;11630
240725;201503;1092;3265;849;2728;80;267;484;1520;564;1787
240730;201503;2194;6649;1895;6103;140;499;1428;4575;1568;5074
240740;201503;2010;5913;1811;5558;180;673;1269;3781;1449;4454
240750;201503;2247;8378;2052;8014;433;1884;1104;4357;1537;6241
240760;201503;1262;3582;1114;3381;114;270;831;2723;945;2993
240770;201503;3107;9019;2789;8575;158;608;2367;7204;2525;7812
240780;201503;6310;17413;5060;15477;973;3092;2815;8846;3788;11938
240790;201503;900;2756;737;2477;42;178;534;1809;576;1987
240800;201503;36529;105507;32665;99075;7999;25576;14468;44258;22467;69834
240810;201503;90271;263030;83673;251668;22419;70241;40285;122271;62704;192512
240820;201503;6801;20426;5820;18885;1371;4858;2598;8763;3969;13621
240830;201503;8746;27471;8219;26692;408;1471;7159;23339;7567;24810
240840;201503;1250;3488;1051;3168;97;337;676;1967;773;2304
240850;201503;1297;3867;947;3068;168;575;456;1444;624;2019
240860;201503;1346;3811;1123;3414;74;260;855;2542;929;2802
240870;201503;1185;3263;974;2872;94;324;632;1767;726;2091
240880;201503;1155;3954;1090;3854;121;522;825;2862;946;3384
240890;201503;5203;14795;4445;13408;889;2924;2171;6442;3060;9366
240895;201503;2708;9305;2469;8891;277;1061;1757;6452;2034;7513
240910;201503;2768;8492;2456;7897;180;697;1862;5929;2042;6626
240920;201503;807;2646;706;2418;178;681;308;1011;486;1692
240930;201503;3498;9275;3093;8777;187;521;2561;7385;2748;7906
240933;201503;1379;4090;1227;3840;142;536;855;2607;997;3143
240940;201503;6480;17938;5332;15960;931;2878;2990;8982;3921;11860
240950;201503;1035;3376;980;3284;72;320;765;2493;837;2813
240960;201503;791;2488;694;2299;91;332;481;1598;572;1930
240970;201503;2038;5634;1706;5076;132;478;1267;3690;1399;4168
240980;201503;3080;10166;2855;9737;555;2050;1765;5983;2320;8033
240990;201503;2928;8687;2746;8321;472;1572;1709;5095;2181;6667
241000;201503;1086;3043;925;2756;51;191;684;2015;735;2206
241010;201503;2943;9871;2699;9403;346;1485;1906;6432;2252;7917
241020;201503;2254;6287;1827;5467;144;516;1181;3407;1325;3923
241025;201503;1617;4934;1457;4635;95;412;1056;3291;1151;3703
241030;201503;2500;8354;2274;7930;166;687;1776;6226;1942;6913
241040;201503;2301;7920;2104;7560;228;912;1497;5446;1725;6358
241050;201503;1310;3864;1143;3581;66;281;891;2722;957;3003
241060;201503;880;2556;801;2422;51;151;631;1919;682;2070
241070;201503;884;2529;782;2351;76;263;544;1594;620;1857
241080;201503;1181;3499;987;3125;57;251;720;2226;777;2477
241090;201503;2182;6379;1861;5807;124;537;1459;4481;1583;5018
241100;201503;1180;3541;1024;3184;122;400;644;1983;766;2383
241105;201503;1163;3530;1061;3344;208;687;604;1930;812;2617
241110;201503;841;2666;707;2380;60;270;454;1487;514;1757
241120;201503;7404;22698;6749;21676;1399;4594;4210;13866;5609;18460
241140;201503;3392;9389;2952;8540;320;953;2088;5974;2408;6927
241142;201503;713;2146;530;1747;134;515;169;508;303;1023
241150;201503;5590;16696;5011;15705;668;2155;3460;10988;4128;13143
241160;201503;996;2953;936;2841;125;416;676;2042;801;2458
241170;201503;1151;3492;1060;3327;110;355;786;2478;896;2833
241180;201503;929;2642;761;2322;97;317;412;1220;509;1537
241190;201503;1208;3340;976;2878;74;267;620;1740;694;2007
241200;201503;19086;56368;17202;53350;3950;13190;8621;27005;12571;40195
241210;201503;1463;4234;1194;3677;204;691;626;1882;830;2573
241220;201503;7540;25349;7094;24513;1563;5784;4038;14078;5601;19862
241230;201503;3063;9027;2801;8657;163;632;2358;7196;2521;7828
241240;201503;1184;3476;919;2921;115;381;442;1463;557;1844
241250;201503;5853;18397;4978;16694;296;1507;3940;12883;4236;14390
241255;201503;1724;6668;1620;6445;401;1707;779;3170;1180;4877
241260;201503;5152;13991;4207;12533;286;1109;3085;9006;3371;10115
241270;201503;1878;5817;1669;5407;183;692;1084;3465;1267;4157
241280;201503;1967;5717;1791;5385;217;699;1261;3761;1478;4460
241290;201503;3160;8962;2644;8079;392;1268;1666;5093;2058;6361
241300;201503;1463;4253;1293;3958;71;220;978;3043;1049;3263
241310;201503;1564;4778;1446;4581;211;689;1011;3247;1222;3936
241320;201503;921;3132;842;2965;135;534;510;1784;645;2318
241330;201503;1463;4654;1356;4511;102;411;1147;3791;1249;4202
241335;201503;2676;8223;2495;7898;158;531;2111;6688;2269;7219
241340;201503;1868;5828;1619;5289;380;1367;774;2448;1154;3815
241350;201503;1935;6176;1758;5853;155;668;1315;4249;1470;4917
241355;201503;1365;3870;1150;3502;65;208;1000;3052;1065;3260
241360;201503;2024;5543;1719;4974;81;278;1288;3595;1369;3873
241370;201503;1359;4188;1130;3714;194;693;574;1859;768;2552
241380;201503;682;1946;574;1730;105;339;324;964;429;1303
241390;201503;2759;9229;2580;8898;365;1376;1859;6427;2224;7803
241400;201503;3713;10945;3425;10563;367;1281;2647;8232;3014;9513
241410;201503;2615;7824;2345;7446;438;1512;1510;4740;1948;6252
241415;201503;1703;5162;1550;4912;107;438;1202;3734;1309;4172
241420;201503;2296;7945;2009;7471;678;2803;582;2114;1260;4917
241430;201503;558;1696;452;1459;48;175;278;867;326;1042
241440;201503;6292;22705;5920;22101;1232;4749;3823;14590;5055;19339
241445;201503;1061;3104;997;3021;93;244;806;2572;899;2816
241450;201503;3205;8810;2813;8243;424;1328;1888;5527;2312;6855
241460;201503;3500;10282;3045;9388;248;920;2232;6723;2480;7643
241470;201503;1396;3879;1137;3552;117;464;851;2608;968;3072
241475;201503;1219;3807;1082;3538;52;262;826;2649;878;2911
241480;201503;2815;9470;2589;9109;894;3192;989;3787;1883;6979
241490;201503;655;1751;551;1600;49;154;338;971;387;1125
241500;201503;772;2441;687;2315;37;132;573;1937;610;2069
250010;201503;2682;8523;2355;7836;169;739;1810;5896;1979;6635
250020;201503;1688;4852;1311;4167;93;397;876;2681;969;3078
250030;201503;7291;21168;6806;20483;620;1883;5504;16725;6124;18608
250040;201503;4346;14662;4001;13936;662;2460;2535;8907;3197;11367
250050;201503;3430;10895;3242;10625;382;1363;2432;7950;2814;9313
250053;201503;1257;3756;1151;3616;158;503;788;2516;946;3019
250057;201503;646;2727;637;2718;18;40;601;2644;619;2684
250060;201503;4908;15037;4641;14657;428;1603;3729;11608;4157;13211
250070;201503;3912;12293;3650;11847;193;873;3027;9565;3220;10438
250073;201503;763;2349;679;2203;52;205;525;1683;577;1888
250077;201503;2235;6572;1883;6010;222;757;1161;3780;1383;4537
250080;201503;4216;12572;4073;12368;361;1170;3300;9973;3661;11143
250090;201503;2640;7708;2527;7529;112;365;2115;6223;2227;6588
250100;201503;3983;13162;3758;12771;373;1421;2934;9939;3307;11360
250110;201503;5301;15923;5016;15531;513;1841;3941;12058;4454;13899
250115;201503;532;1738;472;1602;31;164;298;939;329;1103
250120;201503;1998;6056;1736;5554;113;395;1360;4372;1473;4767
250130;201503;5497;17050;5184;16602;217;774;4599;14846;4816;15620
250135;201503;1072;3284;981;3127;84;293;711;2281;795;2574
250140;201503;2060;6821;1941;6649;186;739;1508;5207;1694;5946
250150;201503;5041;17014;4592;16178;397;1732;3343;11604;3740;13336
250153;201503;1440;3960;1274;3716;65;270;1082;3083;1147;3353
250157;201503;1735;5817;1593;5530;252;928;1067;3725;1319;4653
250160;201503;3247;9973;3136;9806;156;546;2843;8907;2999;9453
250170;201503;1544;4601;1409;4387;246;804;953;3010;1199;3814
250180;201503;15493;46847;14878;45892;1560;5914;11167;33507;12727;39421
250190;201503;4216;12280;3873;11742;672;2121;2457;7409;3129;9530
250200;201503;2200;6116;1722;5475;114;435;1420;4493;1534;4928
250205;201503;909;3112;843;2984;68;336;616;2150;684;2486
250210;201503;1513;5026;1409;4864;150;627;1065;3608;1215;4235
250215;201503;1345;4553;1292;4465;133;540;906;3116;1039;3656
250220;201503;781;2266;661;2111;36;126;573;1828;609;1954
250230;201503;1598;4071;1352;3670;92;301;1108;2923;1200;3224
250240;201503;2309;7804;2187;7571;134;517;1764;6107;1898;6624
250250;201503;4362;13174;3968;12655;214;727;3430;11009;3644;11736
250260;201503;1742;5378;1526;5031;98;408;1193;3892;1291;4300
250270;201503;1250;3965;1140;3826;107;344;877;3052;984;3396
250280;201503;3610;10841;3219;10255;491;1590;2299;7437;2790;9027
250290;201503;2008;5485;1687;5078;49;209;1494;4491;1543;4700
250300;201503;5464;16031;5168;15671;558;2312;4198;12170;4756;14482
250310;201503;1143;3542;1011;3326;118;446;776;2515;894;2961
250320;201503;7979;24839;7616;24154;1008;3648;5187;16006;6195;19654
250330;201503;2583;7986;2194;7444;172;703;1712;5749;1884;6452
250340;201503;1100;3254;1001;3094;34;107;883;2734;917;2841
250350;201503;4365;12026;3851;11427;130;456;3451;10313;3581;10769
250355;201503;1991;6336;1827;6090;111;533;1465;4746;1576;5279
250360;201503;1940;5804;1808;5620;80;275;1518;4751;1598;5026
250370;201503;12063;35135;10785;33715;951;3013;9160;28895;10111;31908
250375;201503;1098;3425;1026;3320;50;197;889;2874;939;3071
250380;201503;1726;4908;1632;4789;90;326;1433;4188;1523;4514
250390;201503;1967;5236;1565;4567;194;559;1066;3138;1260;3697
250400;201503;68569;186342;56773;167691;13717;43055;26900;80393;40617;123448
250403;201503;1542;5080;1446;4955;222;859;1004;3413;1226;4272
250407;201503;1191;3430;1031;3165;61;189;796;2430;857;2619
250410;201503;621;2011;549;1872;46;209;434;1454;480;1663
250415;201503;1733;5443;1582;5166;119;441;1220;3933;1339;4374
250420;201503;1252;3837;1164;3710;62;254;995;3113;1057;3367
250430;201503;6061;17002;5756;16543;296;1013;4924;13960;5220;14973
250435;201503;1407;4355;1260;4089;161;589;854;2754;1015;3343
250440;201503;4490;13161;4178;12727;206;613;3552;10899;3758;11512
250450;201503;2023;5812;1810;5532;78;267;1653;5072;1731;5339
250460;201503;6378;19328;5955;18738;687;2287;4512;14358;5199;16645
250470;201503;1510;4202;1321;3943;88;345;1013;2916;1101;3261
250480;201503;3801;11561;3521;11163;79;348;3169;9996;3248;10344
250485;201503;655;1679;545;1510;30;97;435;1171;465;1268
250490;201503;3774;12266;3689;12148;849;2921;2359;7759;3208;10680
250500;201503;1758;5337;1594;5077;344;1076;981;3231;1325;4307
250510;201503;4690;13516;4195;12807;203;739;3613;11006;3816;11745
250520;201503;1737;5376;1634;5207;251;938;1025;3178;1276;4116
250523;201503;1599;5237;1544;5152;224;821;1134;3790;1358;4611
250527;201503;1398;4263;1326;4173;29;136;1236;3860;1265;3996
250530;201503;649;1964;561;1853;25;78;493;1654;518;1732
250535;201503;1306;4182;1243;4054;70;316;1003;3206;1073;3522
250540;201503;2368;7120;2222;6960;27;88;2130;6708;2157;6796
250550;201503;912;3036;825;2902;57;248;646;2241;703;2489
250560;201503;1661;5296;1617;5233;74;270;1469;4751;1543;5021
250570;201503;2586;8335;2270;7729;178;747;1738;5830;1916;6577
250580;201503;1127;3069;931;2763;87;370;688;1936;775;2306
250590;201503;923;2897;855;2810;66;284;707;2269;773;2553
250600;201503;7371;21614;6927;20987;498;1446;5748;17694;6246;19140
250610;201503;3228;9599;2993;9253;317;1079;2226;6893;2543;7972
250620;201503;730;2165;654;2010;120;389;409;1238;529;1627
250625;201503;2295;7390;2262;7349;45;106;2165;7104;2210;7210
250630;201503;9591;30514;9072;29607;1958;6744;5202;17033;7160;23777
250640;201503;3527;10823;3364;10633;162;673;2976;9301;3138;9974
250650;201503;834;2505;751;2364;76;311;508;1530;584;1841
250660;201503;2209;5445;1684;4811;30;78;1583;4539;1613;4617
250670;201503;2443;8291;2333;8101;152;676;1910;6529;2062;7205
250680;201503;4763;13837;4564;13577;178;637;4104;12215;4282;12852
250690;201503;5947;15776;5710;15482;387;1123;5068;13661;5455;14784
250700;201503;5052;14888;4629;14296;714;2364;3156;9676;3870;12040
250710;201503;4301;13807;3979;13392;529;1837;2893;9950;3422;11787
250720;201503;2555;7602;2446;7425;102;423;2159;6471;2261;6894
250730;201503;3559;11068;3376;10817;367;1333;2556;8097;2923;9430
250740;201503;1994;5868;1769;5493;148;542;1353;4140;1501;4682
250750;201503;98852;284780;92444;275395;13597;44725;63387;186624;76984;231349
250760;201503;2229;6491;2013;6184;109;436;1705;5186;1814;5622
250770;201503;3858;13209;3643;12937;625;2383;2414;8644;3039;11027
250780;201503;1876;5522;1626;5068;185;720;1056;3152;1241;3872
250790;201503;2413;7979;2311;7830;506;1654;1490;5239;1996;6893
250800;201503;2645;7575;2361;7100;107;365;1952;5763;2059;6128
250810;201503;1375;4007;1186;3736;102;412;937;2897;1039;3309
250820;201503;1810;5744;1746;5658;57;234;1599;5161;1656;5395
250830;201503;5738;18830;5362;18091;589;2367;3809;12624;4398;14991
250840;201503;937;3072;826;2841;82;333;563;1931;645;2264
250850;201503;2051;6315;1842;5968;130;581;1412;4488;1542;5069
250855;201503;1077;3249;992;3119;78;325;757;2304;835;2629
250860;201503;3105;10256;2771;9647;654;2577;1061;3647;1715;6224
250870;201503;1059;3114;975;2967;48;205;768;2266;816;2471
250880;201503;1367;3912;1212;3692;161;497;904;2778;1065;3275
250890;201503;9341;28936;8700;28065;1204;4730;6151;19349;7355;24079
250900;201503;2870;9410;2544;8780;270;898;1838;6414;2108;7312
250905;201503;1973;6362;1905;6275;298;1001;1406;4708;1704;5709
250910;201503;4877;14379;4656;14057;294;1023;3916;11758;4210;12781
250915;201503;1487;4543;1433;4467;103;289;1243;3966;1346;4255
250920;201503;3463;10014;3263;9725;423;1171;2409;7459;2832;8630
250930;201503;1980;6299;1863;6102;272;1023;1326;4286;1598;5309
250933;201503;1135;3764;1097;3695;84;332;851;2873;935;3205
250937;201503;757;2357;665;2171;72;295;451;1447;523;1742
250939;201503;1566;4934;1461;4748;158;544;1024;3311;1182;3855
250940;201503;3707;11131;3486;10787;143;551;2938;9118;3081;9669
250950;201503;1228;3894;1121;3757;37;123;1004;3407;1041;3530
250960;201503;1144;3737;1082;3654;90;363;878;2948;968;3311
250970;201503;8546;23614;7420;21981;925;2825;5335;15866;6260;18691
250980;201503;2602;7818;2378;7423;192;796;1690;5075;1882;5871
250990;201503;2021;7004;1848;6646;224;969;1297;4590;1521;5559
251000;201503;2206;6697;2009;6400;93;353;1673;5328;1766;5681
251010;201503;2769;8105;2486;7660;133;489;2103;6479;2236;6968
251020;201503;1628;4765;1477;4579;86;299;1299;4035;1385;4334
251030;201503;1198;3375;1079;3166;87;294;774;2260;861;2554
251040;201503;1880;5952;1680;5632;137;676;1248;4020;1385;4696
251050;201503;1084;3185;949;2946;142;467;598;1862;740;2329
251060;201503;965;2296;774;2050;48;158;602;1560;650;1718
251065;201503;467;1440;426;1383;46;174;313;982;359;1156
251070;201503;634;1783;576;1703;48;198;459;1280;507;1478
251080;201503;19907;56342;18170;53505;4838;14826;9025;27224;13863;42050
251090;201503;2974;9352;2664;8763;212;822;1956;6350;2168;7172
251100;201503;960;3085;843;2867;124;498;514;1681;638;2179
251110;201503;2011;5911;1780;5474;171;567;1250;3814;1421;4381
251120;201503;5979;20385;5744;19968;679;2790;4407;15103;5086;17893
251130;201503;4098;10659;3695;10216;28;84;3586;9938;3614;10022
251140;201503;4255;13124;3969;12690;133;587;3322;10581;3455;11168
251150;201503;2619;8596;2387;8266;268;1122;1790;6135;2058;7257
251160;201503;1720;5785;1665;5712;55;228;1528;5247;1583;5475
251170;201503;1399;4350;1335;4274;96;379;1131;3576;1227;3955
251180;201503;2654;8159;2440;7871;500;1610;1527;5013;2027;6623
251190;201503;4251;12013;4104;11851;186;538;3788;10970;3974;11508
251200;201503;4134;13010;3903;12725;111;407;3599;11791;3710;12198
251203;201503;1150;3825;1079;3672;77;356;814;2734;891;3090
251207;201503;1142;3580;986;3298;81;379;688;2205;769;2584
251210;201503;7940;22636;6838;21195;778;2393;5199;16512;5977;18905
251220;201503;1152;3092;967;2821;102;314;737;2167;839;2481
251230;201503;4615;14107;4194;13629;211;806;3790;12311;4001;13117
251240;201503;3117;10007;3011;9868;284;973;2481;8154;2765;9127
251250;201503;10286;30522;9484;29338;1014;3720;7250;21994;8264;25714
251260;201503;546;1667;478;1577;24;84;364;1196;388;1280
251270;201503;4195;13468;3939;13156;125;534;3578;11952;3703;12486
251272;201503;1377;4201;1317;4117;105;350;1109;3480;1214;3830
251274;201503;881;2831;810;2700;88;368;590;1913;678;2281
251275;201503;1251;3692;1192;3607;92;386;918;2677;1010;3063
251276;201503;1239;3854;1162;3713;103;397;874;2747;977;3144
251278;201503;578;1882;513;1744;65;260;340;1164;405;1424
251280;201503;2322;7243;2209;7062;176;680;1759;5530;1935;6210
251290;201503;5759;16196;5451;15830;607;2085;4258;12105;4865;14190
251300;201503;761;2610;706;2529;54;249;530;1866;584;2115
251310;201503;3154;9327;2903;8973;143;567;2406;7364;2549;7931
251315;201503;1581;5582;1523;5482;215;806;1046;3827;1261;4633
251320;201503;1908;5415;1533;4816;73;272;1165;3640;1238;3912
251330;201503;1840;4960;1607;4655;72;299;1427;4042;1499;4341
251335;201503;1026;3523;960;3403;88;412;700;2415;788;2827
251340;201503;3537;10018;3032;9257;231;935;2296;6775;2527;7710
251350;201503;1444;4502;1305;4298;136;510;952;3080;1088;3590
251360;201503;1804;5913;1658;5733;77;348;1439;4965;1516;5313
251365;201503;844;2490;685;2158;35;146;488;1497;523;1643
251370;201503;21883;70297;21358;69562;2259;8963;16863;53523;19122;62486
251380;201503;1389;4335;1197;4007;60;279;985;3212;1045;3491
251385;201503;837;2322;742;2173;80;243;534;1528;614;1771
251390;201503;5821;20314;5403;19619;1232;4718;3177;11650;4409;16368
251392;201503;1031;3076;936;2934;65;206;747;2354;812;2560
251394;201503;623;1899;514;1699;32;125;370;1209;402;1334
251396;201503;844;2396;742;2223;112;351;500;1475;612;1826
251398;201503;998;2980;874;2736;55;206;622;1936;677;2142
251400;201503;1192;3392;1039;3187;98;380;776;2309;874;2689
251410;201503;1396;3755;1268;3543;80;277;1033;2834;1113;3111
251420;201503;2059;6062;1828;5792;151;542;1475;4646;1626;5188
251430;201503;1674;5995;1554;5804;97;450;1303;4850;1400;5300
251440;201503;1309;3892;1091;3467;86;299;797;2517;883;2816
251445;201503;1557;4784;1485;4686;74;313;1293;4018;1367;4331
251450;201503;4653;14824;4292;14385;139;617;3766;12644;3905;13261
251455;201503;1146;3668;1028;3475;91;366;721;2423;812;2789
251460;201503;825;2574;789;2516;103;319;616;2001;719;2320
251465;201503;455;1437;396;1305;25;108;286;914;311;1022
251470;201503;1188;3488;982;3100;102;374;599;1884;701;2258
251480;201503;994;2769;884;2590;24;119;750;2132;774;2251
251490;201503;1842;5589;1661;5322;232;868;1091;3461;1323;4329
251500;201503;1700;5576;1665;5521;139;526;1378;4540;1517;5066
251510;201503;2565;8530;2337;8064;387;1409;1464;5083;1851;6492
251520;201503;988;2756;887;2595;130;391;527;1550;657;1941
251530;201503;11697;33482;11177;32765;421;1700;9886;28582;10307;30282
251540;201503;2832;9221;2615;8785;204;849;2073;6882;2277;7731
251550;201503;3828;9600;3145;8748;101;370;2661;7292;2762;7662
251560;201503;771;2364;705;2253;114;431;409;1212;523;1643
251570;201503;1007;3007;828;2652;76;307;593;1864;669;2171
251580;201503;1976;5583;1844;5400;351;901;1265;3891;1616;4792
251590;201503;1588;5263;1537;5202;68;258;1374;4677;1442;4935
251593;201503;1090;3363;1004;3247;157;565;616;1943;773;2508
251597;201503;1959;6013;1876;5898;122;470;1556;4812;1678;5282
251600;201503;6550;19352;6132;18690;437;1489;5040;15308;5477;16797
251610;201503;3263;9890;2978;9515;288;968;2319;7433;2607;8401
251615;201503;1130;3313;921;2956;84;343;648;2044;732;2387
251620;201503;15744;44350;13652;41793;1156;3723;10833;33635;11989;37358
251630;201503;4809;12403;4125;11520;293;881;3361;9368;3654;10249
251640;201503;2596;7612;2168;6886;163;639;1598;5023;1761;5662
251650;201503;4030;11800;3687;11359;241;800;3195;9892;3436;10692
251660;201503;3429;11473;3211;11094;194;956;2663;8962;2857;9918
251670;201503;4235;12791;3739;12121;63;196;3450;11310;3513;11506
251675;201503;721;2367;670;2290;147;538;391;1319;538;1857
251680;201503;2657;7718;2234;7054;116;492;1820;5666;1936;6158
251690;201503;3423;10496;3161;10010;220;832;2398;7462;2618;8294
251700;201503;1952;6341;1843;6201;104;433;1600;5386;1704;5819
251710;201503;935;2433;686;1965;82;278;386;1068;468;1346
251720;201503;1379;4251;1239;4013;78;339;1007;3201;1085;3540
251740;201503;774;2202;619;1936;74;249;389;1215;463;1464
260005;201503;25111;61726;21650;56943;4725;12527;12483;33011;17208;45538
260010;201503;9861;26608;8004;24328;954;3030;5544;17324;6498;20354
260020;201503;5671;16605;4890;15426;353;1174;3818;12249;4171;13423
260030;201503;5700;16913;5222;16183;424;1495;4104;12657;4528;14152
260040;201503;10133;24455;8423;22536;661;1470;6750;18820;7411;20290
260050;201503;11220;34971;10414;34049;554;1925;9161;30321;9715;32246
260060;201503;3889;10975;3487;10296;298;866;2696;8088;2994;8954
260070;201503;9611;28320;9031;27451;1628;5345;5984;18122;7612;23467
260080;201503;5322;14806;4733;13961;450;1492;3642;10630;4092;12122
260090;201503;5152;14495;4880;14102;1073;2974;3289;9802;4362;12776
260100;201503;3265;8976;2864;8407;161;620;2419;7066;2580;7686
260105;201503;4697;13732;4495;13354;549;1818;3287;9612;3836;11430
260110;201503;21054;60401;19410;58416;905;2741;17154;51977;18059;54718
260120;201503;11209;34423;10263;32775;2665;8660;5393;17945;8058;26605
260130;201503;3205;9073;3019;8785;443;1240;2186;6505;2629;7745
260140;201503;13356;33605;11418;31270;901;2669;9152;25419;10053;28088
260150;201503;3139;8939;2808;8486;191;717;2289;6919;2480;7636
260160;201503;5748;17908;5128;17135;341;1334;4318;14504;4659;15838
260170;201503;17373;48308;16498;47142;1247;3757;13558;38829;14805;42586
260180;201503;3306;10236;3010;9807;201;788;2512;8118;2713;8906
260190;201503;15912;37717;14728;36244;538;1375;13033;32028;13571;33403
260200;201503;10569;30402;9765;29266;789;2555;8028;24221;8817;26776
260210;201503;11070;34183;10076;32740;608;2374;8395;27312;9003;29686
260220;201503;9258;27648;8952;27230;513;1998;7868;23558;8381;25556
260230;201503;9527;27737;8874;26858;450;1506;7518;23054;7968;24560
260240;201503;2996;9062;2577;8476;364;1286;1852;6144;2216;7430
260250;201503;2290;6363;2042;6046;120;381;1734;5138;1854;5519
260260;201503;11940;33797;11106;32723;1574;4980;8265;24824;9839;29804
260270;201503;3531;10534;3308;10209;296;1174;2628;7940;2924;9114
260280;201503;12819;42002;11834;40493;634;2400;10153;35086;10787;37486
260290;201503;29386;89162;28012;86819;4195;14756;18915;57454;23110;72210
260300;201503;8572;26087;7624;24680;477;1978;6077;19712;6554;21690
260310;201503;4706;13985;4319;13407;1344;3814;2254;7613;3598;11427
260320;201503;6918;23038;6454;22341;437;1603;5385;18856;5822;20459
260330;201503;2683;8726;2489;8404;172;743;1973;6603;2145;7346
260340;201503;1905;5643;1772;5438;85;310;1567;4786;1652;5096
260345;201503;23346;73881;21957;71177;5739;20753;9409;29134;15148;49887
260350;201503;4574;12732;4322;12357;296;966;3575;10163;3871;11129
260360;201503;2273;6819;2084;6527;222;852;1503;4645;1725;5497
260370;201503;5909;18388;5229;17162;530;2036;3835;12641;4365;14677
260380;201503;4777;15878;4409;15363;356;1392;3458;12102;3814;13494
260390;201503;4480;14255;3958;13286;389;1493;2853;9411;3242;10904
260392;201503;3553;11192;3297;10875;118;490;2977;9806;3095;10296
260400;201503;13454;38920;12835;37920;1910;6417;8975;25905;10885;32322
260410;201503;56605;167514;52289;160593;15448;49625;23858;74659;39306;124284
260415;201503;3947;12594;3412;11562;405;1692;2193;7194;2598;8886
260420;201503;12188;27944;10978;26666;355;944;9971;24246;10326;25190
260430;201503;2802;9264;2521;8790;273;1071;1828;6350;2101;7421
260440;201503;3166;9715;2858;9098;424;1521;1764;5446;2188;6967
260450;201503;4942;14718;4686;14333;222;789;4051;12387;4273;13176
260460;201503;5619;17227;5202;16560;857;3021;3344;10473;4201;13494
260470;201503;4795;14106;4502;13717;293;930;3865;11949;4158;12879
260480;201503;4012;11677;3607;11101;604;2045;2397;7428;3001;9473
260490;201503;5014;13497;4407;12484;378;1263;3470;9635;3848;10898
260500;201503;6185;17441;5538;16478;639;1995;4027;12018;4666;14013
260510;201503;8826;23572;8180;22794;263;688;7574;21303;7837;21991
260515;201503;4782;14691;3738;12570;325;1272;2378;7994;2703;9266
260520;201503;15752;41790;15196;41052;2663;7143;10920;29879;13583;37022
260530;201503;9963;30095;8814;28465;470;1541;7541;24683;8011;26224
260540;201503;5947;14918;5445;14386;641;1332;4449;12187;5090;13519
260545;201503;73;260;45;178;7;29;9;33;16;62
260550;201503;2742;9081;2383;8351;548;2167;1042;3605;1590;5772
260560;201503;6497;17022;5880;16140;210;658;5245;14360;5455;15018
260570;201503;6685;22572;6191;21749;831;3289;4449;15706;5280;18995
260580;201503;3750;10533;3499;10133;199;722;2987;8450;3186;9172
260590;201503;6070;15392;5808;15089;257;580;5271;13880;5528;14460
260600;201503;26208;79194;23957;75388;2629;9612;17277;53834;19906;63446
260610;201503;6735;20161;6375;19643;1064;3480;4433;13552;5497;17032
260620;201503;16213;49155;15539;48008;2654;9170;10091;30630;12745;39800
260630;201503;2168;6537;1945;6166;153;610;1544;4799;1697;5409
260640;201503;17346;47949;16321;46524;2379;7153;11327;32332;13706;39485
260650;201503;5186;16835;4712;16038;509;1720;3588;12512;4097;14232
260660;201503;8227;22899;7425;21889;402;1270;6493;19221;6895;20491
260670;201503;2371;6538;1942;5943;207;733;1382;4210;1589;4943
260680;201503;21744;60604;20177;57936;4422;13124;10606;30306;15028;43430
260690;201503;3685;10101;3178;9311;144;558;2664;7712;2808;8270
260700;201503;5607;17093;5462;16941;45;86;5350;16754;5395;16840
260710;201503;1223;3730;1118;3585;90;360;877;2779;967;3139
260720;201503;16373;53940;15480;52435;3702;12968;8533;29461;12235;42429
260730;201503;6858;23011;6345;22181;862;3116;4621;16382;5483;19498
260740;201503;1322;4015;1150;3713;152;543;722;2332;874;2875
260750;201503;6507;20888;5971;20162;549;1693;4947;17113;5496;18806
260760;201503;4658;12706;4357;12321;323;998;3586;10176;3909;11174
260765;201503;7507;25833;7205;25377;968;4217;5302;18212;6270;22429
260770;201503;3926;10284;3570;9796;140;492;3000;8121;3140;8613
260775;201503;5154;14938;4892;14554;492;1808;3606;10411;4098;12219
260780;201503;3692;12079;3513;11762;734;2780;2171;7145;2905;9925
260790;201503;112192;284201;105510;274473;20468;55289;65328;169437;85796;224726
260795;201503;3008;9440;2743;9035;399;1445;1851;6159;2250;7604
260800;201503;4840;13107;4471;12605;185;765;3951;10825;4136;11590
260805;201503;3983;11568;3544;10915;431;1461;2490;7633;2921;9094
260810;201503;6826;19791;6668;19605;309;928;6068;17954;6377;18882
260820;201503;4331;12360;3988;11901;1042;3213;2248;6722;3290;9935
260825;201503;2837;9209;2599;8842;197;729;2104;7194;2301;7923
260830;201503;3680;11904;3329;11249;855;2796;1908;6765;2763;9561
260840;201503;4242;12270;3844;11697;276;1112;3163;9422;3439;10534
260845;201503;4265;12447;3972;11914;554;1754;2757;8293;3311;10047
260850;201503;4912;16371;4392;15219;962;3796;2143;7248;3105;11044
260860;201503;3294;10528;3016;9993;206;768;2384;7916;2590;8684
260870;201503;4243;11789;3824;11279;501;1359;2887;8774;3388;10133
260875;201503;6726;18397;5992;17269;1006;2968;3878;11261;4884;14229
260880;201503;9079;28436;8453;27447;674;2251;6911;22685;7585;24936
260890;201503;13410;38524;12542;37193;969;3303;9773;28855;10742;32158
260900;201503;6001;18577;5174;17000;739;2770;3168;10336;3907;13106
260910;201503;3049;9161;2789;8780;207;753;2255;7138;2462;7891
260915;201503;4470;15150;4298;14912;63;265;4077;14206;4140;14471
260920;201503;3428;10351;3243;10102;404;1396;2493;7861;2897;9257
260930;201503;4003;12875;3547;12169;413;1519;2565;8902;2978;10421
260940;201503;13518;36550;12317;34575;1533;5151;8476;23077;10009;28228
260950;201503;6201;19461;5743;18584;731;3003;3585;11010;4316;14013
260960;201503;56566;159564;52492;152973;10555;32857;29605;86027;40160;118884
260970;201503;4950;15825;4586;15316;344;1471;3595;11851;3939;13322
260980;201503;3849;12613;3631;12347;142;544;3282;11208;3424;11752
260990;201503;17178;54167;15758;52317;1331;4409;12847;43517;14178;47926
261000;201503;15999;43834;12930;39049;2485;7983;6871;21388;9356;29371
261010;201503;2592;7364;2396;7125;145;323;2123;6505;2268;6828
261020;201503;6003;17774;5469;16970;460;1695;4334;13134;4794;14829
261030;201503;3377;11071;3165;10696;246;1018;2559;8530;2805;9548
261040;201503;5262;17105;4657;15981;437;1759;3406;11582;3843;13341
261050;201503;8123;23595;7596;22674;990;2928;5272;15782;6262;18710
261060;201503;11888;35426;11113;34015;1234;4371;8343;25145;9577;29516
261070;201503;49556;123954;43807;115880;7604;20739;27546;73263;35150;94002
261080;201503;5806;17258;5461;16738;352;985;4662;14552;5014;15537
261090;201503;16405;45492;15172;43821;1383;3966;12143;35554;13526;39520
261100;201503;7725;24688;6969;23393;1197;4244;4328;14774;5525;19018
261110;201503;59633;177352;53762;168718;12105;39842;30527;97978;42632;137820
261120;201503;3617;9773;3215;9287;99;341;2888;8370;2987;8711
261130;201503;7018;18107;6655;17705;146;364;6279;16773;6425;17137
261140;201503;3239;9156;2948;8720;476;1569;1840;5367;2316;6936
261150;201503;5495;16365;5013;15614;552;1949;3791;11799;4343;13748
261153;201503;2049;6009;1675;5436;79;318;1310;4275;1389;4593
261160;201503;207971;540739;195022;522914;43331;119401;108308;296250;151639;415651
261170;201503;5763;16019;5294;15359;652;1928;4040;11867;4692;13795
261180;201503;9539;26759;9023;26044;736;2291;7052;20488;7788;22779
261190;201503;5225;16417;4901;16020;615;2700;3540;11156;4155;13856
261200;201503;3664;9200;3337;8795;459;1209;2517;6739;2976;7948
261210;201503;1928;5112;1843;5005;120;300;1646;4531;1766;4831
261220;201503;12862;40909;10808;36423;1963;7244;5558;18684;7521;25928
261230;201503;4348;13164;3996;12722;176;623;3508;11265;3684;11888
261240;201503;4754;14209;4437;13673;686;2067;3059;9608;3745;11675
261245;201503;3639;11488;3153;10643;193;896;2511;8334;2704;9230
261247;201503;3364;10353;2857;9419;288;1083;2049;6788;2337;7871
261250;201503;19756;52813;18940;51778;3517;9251;13792;38634;17309;47885
261255;201503;4075;12647;3718;12048;236;890;3129;10167;3365;11057
261260;201503;11954;34186;10811;32837;484;1267;9625;29870;10109;31137
261270;201503;3857;11270;3513;10731;499;1668;2329;7024;2828;8692
261280;201503;2542;7791;2317;7464;169;605;1878;6046;2047;6651
261290;201503;2911;8468;2684;8175;149;561;2272;6947;2421;7508
261300;201503;10697;35075;9452;32854;1615;6404;5754;19816;7369;26220
261310;201503;7394;22803;6987;22104;1614;5286;4105;13033;5719;18319
261320;201503;5589;17750;5215;17062;314;1169;4262;14001;4576;15170
261330;201503;5410;16034;5167;15696;497;1536;4143;12620;4640;14156
261340;201503;4188;13941;3988;13619;485;2008;2700;9146;3185;11154
261350;201503;8068;27039;7599;26261;416;1896;6197;21164;6613;23060
261360;201503;8119;21618;7284;20455;674;2001;5760;16040;6434;18041
261370;201503;19958;59366;18729;57504;3761;12311;11485;35214;15246;47525
261380;201503;4183;14301;3844;13638;559;2180;2615;9351;3174;11531
261390;201503;15819;48570;14382;46186;2136;7683;9166;29202;11302;36885
261400;201503;4855;16780;4390;15826;492;2030;3130;11301;3622;13331
261410;201503;8514;24375;7816;23310;961;2888;5839;17673;6800;20561
261420;201503;7367;25122;7059;24683;1711;6756;4216;14462;5927;21218
261430;201503;3399;10764;2994;10196;304;1034;2290;7983;2594;9017
261440;201503;1625;5128;1477;4901;83;377;1222;4006;1305;4383
261450;201503;13878;39604;13470;39103;465;1492;12437;36111;12902;37603
261460;201503;7138;21495;6717;20961;420;1106;5931;19031;6351;20137
261470;201503;3991;10823;3621;10369;143;463;3231;9227;3374;9690
261480;201503;3552;12935;3311;12519;357;1539;2492;9281;2849;10820
261485;201503;4985;15371;4538;14592;818;3060;2676;8419;3494;11479
261500;201503;5688;15887;5036;15024;520;1417;3913;12083;4433;13500
261510;201503;1958;6316;1814;6093;127;473;1459;4922;1586;5395
261520;201503;2651;8637;2415;8180;154;625;1703;5890;1857;6515
261530;201503;12190;39242;10725;36460;2421;9081;4593;15629;7014;24710
261540;201503;7418;23949;7104;23423;1432;4700;4582;15482;6014;20182
261550;201503;3425;9964;3251;9716;297;1147;2666;7782;2963;8929
261560;201503;7065;23001;6410;22153;1091;3958;4502;15851;5593;19809
261570;201503;3477;10645;3044;9982;439;1534;2012;6597;2451;8131
261580;201503;5651;17873;5057;16947;368;1483;4160;13920;4528;15403
261590;201503;2470;7073;2229;6725;212;674;1694;5186;1906;5860
261600;201503;5400;14706;4638;13655;390;1204;3592;10669;3982;11873
261610;201503;2460;7205;2092;6682;117;471;1707;5358;1824;5829
261618;201503;2487;7101;2308;6878;212;702;1841;5413;2053;6115
261620;201503;4251;13207;3962;12738;544;1827;2829;9172;3373;10999
261630;201503;7826;22952;6610;20689;1063;3846;3714;11300;4777;15146
261640;201503;31999;82203;29700;79397;2108;5441;24671;67903;26779;73344
261650;201503;3633;11446;3402;11123;432;1496;2492;8234;2924;9730
270010;201503;4516;17113;4152;16413;494;2251;2818;11241;3312;13492
270020;201503;3804;11296;3586;10962;348;1205;2847;8601;3195;9806
270030;201503;40357;121346;37915;117464;8994;28776;21794;68523;30788;97299
270040;201503;10597;32344;9917;31513;2149;6506;6183;20667;8332;27173
270050;201503;4133;11874;3834;11499;354;1211;3033;9069;3387;10280
270060;201503;1656;5328;1562;5203;278;1027;1015;3401;1293;4428
270070;201503;4279;13268;3954;12831;177;795;3425;10936;3602;11731
270080;201503;1262;4043;1128;3772;176;685;713;2306;889;2991
270090;201503;2144;6691;2041;6504;42;179;1833;5768;1875;5947
270100;201503;5941;18448;5668;18004;996;3383;3822;12090;4818;15473
270110;201503;3162;8966;2856;8630;395;1236;1980;6364;2375;7600
270120;201503;3023;8819;2756;8469;85;327;2485;7670;2570;7997
270130;201503;4940;15470;4717;15218;410;1165;3999;13315;4409;14480
270135;201503;1741;4787;1676;4719;120;153;1515;4490;1635;4643
270140;201503;10321;25197;8996;23522;776;2910;7112;17513;7888;20423
270150;201503;2686;9152;2630;9081;119;468;2424;8372;2543;8840
270160;201503;5209;17270;4780;16741;267;996;4091;14410;4358;15406
270170;201503;3891;12708;3574;12266;673;2731;2123;7165;2796;9896
270180;201503;2208;7477;2036;7242;122;615;1691;5938;1813;6553
270190;201503;1871;6151;1771;6010;127;510;1422;4873;1549;5383
270200;201503;2641;8890;2471;8650;216;909;1921;6658;2137;7567
270210;201503;4581;14430;4367;14140;302;1273;3742;11959;4044;13232
270220;201503;1423;4669;1338;4516;244;910;789;2629;1033;3539
270230;201503;11011;35571;9733;33503;1355;5687;6321;21281;7676;26968
270235;201503;6402;20748;6020;20131;337;1419;5047;16734;5384;18153
270240;201503;9926;29561;8563;27807;1921;6476;4675;15453;6596;21929
270250;201503;3319;8600;3061;8296;134;309;2826;7726;2960;8035
270255;201503;5011;15155;4014;13357;299;1243;2884;9464;3183;10707
270260;201503;5769;18926;5600;18676;556;2303;4596;15036;5152;17339
270270;201503;1224;3501;1126;3364;208;645;654;1927;862;2572
270280;201503;3603;10441;3296;9998;378;1244;2439;7380;2817;8624
270290;201503;8370;29272;7905;28464;800;3399;6185;22106;6985;25505
270300;201503;3573;11892;3265;11552;211;846;2775;9895;2986;10741
270310;201503;7289;22397;6465;21057;291;1411;5429;17290;5720;18701
270320;201503;6400;20406;6171;20033;1170;4421;3939;12722;5109;17143
270330;201503;4567;15355;4276;14967;412;1600;3434;12082;3846;13682
270340;201503;1748;5441;1565;5197;149;549;1238;4117;1387;4666
270350;201503;1886;5337;1720;5131;181;597;1293;3917;1474;4514
270360;201503;2038;6383;1980;6313;183;524;1685;5524;1868;6048
270370;201503;1643;5408;1497;5151;147;595;1073;3727;1220;4322
270375;201503;2980;8822;2704;8422;344;1328;1864;5547;2208;6875
270380;201503;5711;17735;5394;17302;529;1732;4256;13888;4785;15620
270390;201503;1317;3666;1177;3465;135;484;868;2458;1003;2942
270400;201503;6087;18544;5536;17755;465;1758;4017;12680;4482;14438
270410;201503;4849;15087;4545;14530;492;1756;3299;10448;3791;12204
270420;201503;5859;18899;5655;18627;314;1459;4702;15175;5016;16634
270430;201503;133406;389450;125549;378221;32229;101183;64798;199636;97027;300819
270440;201503;4697;14400;4371;13930;237;913;3604;11549;3841;12462
270450;201503;6302;19664;6053;19350;378;1541;5076;16093;5454;17634
270460;201503;3490;9430;3135;8962;216;740;2629;7403;2845;8143
270470;201503;10253;33376;9587;32299;1289;4452;6615;22841;7904;27293
270480;201503;3040;9473;2712;8887;299;1208;1850;5836;2149;7044
270490;201503;967;3147;916;3074;69;291;720;2385;789;2676
270500;201503;4955;17223;4738;16941;354;1357;3990;14415;4344;15772
270510;201503;6023;18240;5433;17429;709;2999;3958;12104;4667;15103
270520;201503;3605;11613;3371;11229;868;3144;1629;5500;2497;8644
270530;201503;1496;4445;1332;4220;173;578;895;2929;1068;3507
270540;201503;2038;6978;1860;6722;155;759;1493;5288;1648;6047
270550;201503;7076;21002;6224;19892;901;3025;4268;13984;5169;17009
270560;201503;3063;9441;2866;9144;451;1721;2035;6272;2486;7993
270570;201503;3946;12843;3637;12332;383;1644;2780;9197;3163;10841
270580;201503;1946;6470;1865;6355;242;870;1408;4880;1650;5750
270590;201503;1392;4719;1317;4590;34;157;1231;4275;1265;4432
270600;201503;2872;9660;2594;9216;216;1079;1997;6926;2213;8005
270610;201503;3229;10242;3003;9921;260;969;2420;7940;2680;8909
270620;201503;1372;4730;1305;4628;108;529;1071;3647;1179;4176
270630;201503;17295;49454;16086;47516;2372;6893;11316;34210;13688;41103
270640;201503;5893;18179;5289;17375;387;1606;4310;13922;4697;15528
270642;201503;2274;8066;2124;7840;282;1227;1544;5666;1826;6893
270644;201503;2573;7475;2309;7184;185;525;1957;6232;2142;6757
270650;201503;3779;12127;3618;11903;651;2703;2353;7365;3004;10068
270660;201503;2546;6451;1990;5669;123;455;1418;4027;1541;4482
270670;201503;16211;42655;14012;40101;1737;4772;10465;31100;12202;35872
270680;201503;4281;12803;4108;12612;173;477;3740;11619;3913;12096
270690;201503;9000;25033;8227;24153;2602;7379;4188;13134;6790;20513
270700;201503;695;2165;635;2062;90;373;435;1340;525;1713
270710;201503;5901;19615;5635;19268;594;2181;4528;15584;5122;17765
270720;201503;3289;11189;3017;10717;197;992;2446;8542;2643;9534
270730;201503;6391;19496;6074;19141;682;2199;4953;15826;5635;18025
270740;201503;2380;6824;2236;6625;300;1026;1632;4739;1932;5765
270750;201503;5029;16036;4669;15506;486;1769;3634;12113;4120;13882
270760;201503;3422;10392;3100;9847;250;895;2403;7627;2653;8522
270770;201503;18535;49374;15672;45931;3060;9012;9522;29094;12582;38106
270780;201503;1840;6104;1745;5944;212;792;1257;4303;1469;5095
270790;201503;1641;5135;1504;4928;324;1150;845;2725;1169;3875
270800;201503;11483;33925;10715;32924;859;2951;8827;27136;9686;30087
270810;201503;3367;10211;2644;8897;287;1153;1695;5730;1982;6883
270820;201503;1795;6055;1646;5814;256;1023;1078;3808;1334;4831
270830;201503;5553;16523;5040;15885;949;3404;3302;10470;4251;13874
270840;201503;7797;25857;7200;25110;393;1945;6167;21155;6560;23100
270850;201503;7431;24018;7218;23761;1295;5228;5012;15715;6307;20943
270860;201503;11478;32270;9863;30171;1184;4361;7010;21071;8194;25432
270870;201503;2232;6685;1838;5866;269;923;1136;3593;1405;4516
270880;201503;8154;26377;7677;25685;571;2368;6353;20993;6924;23361
270890;201503;2487;7570;2325;7280;298;1134;1691;5171;1989;6305
270895;201503;2929;10945;2786;10756;213;941;2348;9122;2561;10063
270900;201503;1951;5326;1579;4788;107;398;1200;3571;1307;3969
270910;201503;3350;11450;3232;11221;312;1379;2548;8600;2860;9979
270915;201503;9840;33156;8893;31494;1557;6399;5280;18445;6837;24844
270920;201503;6297;19812;5952;19331;197;961;5400;17310;5597;18271
270930;201503;17498;46813;14450;43049;2703;8383;8762;26977;11465;35360
270940;201503;5913;19839;5637;19535;602;2372;4383;15268;4985;17640
280010;201503;677;2040;588;1893;48;220;405;1244;453;1464
280020;201503;4827;14278;4177;13130;693;2361;2693;8400;3386;10761
280030;201503;71233;187960;62399;174982;16095;47427;29624;84308;45719;131735
280040;201503;3151;9791;2821;9308;292;984;2118;7185;2410;8169
280050;201503;3783;12242;3512;11803;1157;4098;1473;5101;2630;9199
280060;201503;4306;14278;4011;13781;827;3079;2309;8067;3136;11146
280067;201503;7498;21380;6500;19966;738;2315;4657;14471;5395;16786
280070;201503;1904;6460;1807;6322;360;1307;1200;4261;1560;5568
280100;201503;3908;12199;3502;11497;863;2955;1777;5958;2640;8913
280110;201503;1410;4327;1307;4172;69;297;1104;3469;1173;3766
280120;201503;7741;24762;7172;23864;1080;3358;5108;17800;6188;21158
280130;201503;7298;21070;6746;20258;1149;3796;4396;13229;5545;17025
280140;201503;5533;15125;5025;14434;529;1528;3942;11450;4471;12978
280150;201503;3449;10453;3176;9982;420;1504;2140;6550;2560;8054
280160;201503;1397;4047;1250;3827;130;462;942;2873;1072;3335
280170;201503;4795;14240;4340;13587;459;1351;3367;10879;3826;12230
280190;201503;1091;3110;983;2934;69;278;766;2203;835;2481
280200;201503;1145;3466;1046;3322;149;589;722;2196;871;2785
280210;201503;12977;40077;11897;38556;2165;7239;7821;26069;9986;33308
280220;201503;1545;4761;1449;4614;87;341;1250;3948;1337;4289
280230;201503;3507;10472;3121;9863;466;1577;1955;6247;2421;7824
280240;201503;3451;10221;3140;9740;271;820;2482;7790;2753;8610
280250;201503;839;2197;701;1985;117;392;419;1095;536;1487
280260;201503;1991;5331;1840;5144;85;259;1647;4640;1732;4899
280270;201503;2304;7136;2024;6710;130;520;1576;5160;1706;5680
280280;201503;4150;13572;3821;13034;918;2639;2122;8152;3040;10791
280290;201503;17079;52808;15428;50216;2257;8058;10251;33872;12508;41930
280300;201503;9571;29709;8983;29014;680;2354;7555;24782;8235;27136
280310;201503;1349;3828;1210;3609;78;312;869;2530;947;2842
280320;201503;8254;27023;7633;25969;1442;5441;4192;14298;5634;19739
280330;201503;4548;12783;4142;12192;366;1278;3383;9830;3749;11108
280340;201503;3790;10991;3572;10693;303;997;2873;8740;3176;9737
280350;201503;22058;62713;19897;59551;2544;7945;14009;42683;16553;50628
280360;201503;5738;18115;5407;17605;1035;3813;3231;10341;4266;14154
280370;201503;1822;5144;1621;4828;138;467;1245;3663;1383;4130
280380;201503;1000;3044;925;2944;99;370;715;2266;814;2636
280390;201503;3185;9370;2740;8565;472;1502;1682;5281;2154;6783
280400;201503;4249;12377;3861;11838;1022;2985;2187;7125;3209;10110
280410;201503;2173;7034;1899;6509;309;1206;1093;3612;1402;4818
280420;201503;4211;12265;3921;11818;233;754;3380;10216;3613;10970
280430;201503;2244;5808;2061;5579;118;405;1746;4717;1864;5122
280440;201503;4867;14300;4551;13922;327;979;3914;12116;4241;13095
280445;201503;2451;7046;2284;6769;91;357;1896;5543;1987;5900
280450;201503;8591;23757;8038;23079;509;1205;6940;20531;7449;21736
280460;201503;7014;18707;6306;17727;824;2445;4601;13134;5425;15579
280470;201503;1793;5498;1645;5258;190;603;1220;3944;1410;4547
280480;201503;30538;90095;29120;88089;4540;15782;19765;58509;24305;74291
280490;201503;3788;11500;3354;10715;328;1209;2460;7786;2788;8995
280500;201503;910;2444;843;2360;29;89;744;2064;773;2153
280510;201503;2718;7882;2349;7400;241;877;1776;5644;2017;6521
280520;201503;1732;4908;1578;4714;152;385;1291;3989;1443;4374
280530;201503;2191;6412;2058;6249;170;547;1723;5298;1893;5845
280540;201503;9272;25299;8696;24537;231;897;7896;22097;8127;22994
280550;201503;6855;18459;5933;17037;644;1976;4233;12145;4877;14121
280560;201503;7454;22170;7033;21546;380;1349;6007;18260;6387;19609
280570;201503;6458;17854;5727;16913;694;2330;4070;11976;4764;14306
280580;201503;5579;17316;4749;15877;894;3009;2856;9874;3750;12883
280590;201503;2320;7106;2162;6906;264;1145;1562;4867;1826;6012
280600;201503;3879;11879;3630;11505;344;1261;2740;8621;3084;9882
280610;201503;2479;6981;2291;6723;259;926;1629;4654;1888;5580
280620;201503;5093;15344;4459;14177;673;1963;2919;9671;3592;11634
280630;201503;3862;12554;3676;12285;368;1091;2988;10377;3356;11468
280640;201503;2197;6551;2092;6435;79;153;1963;6171;2042;6324
280650;201503;1131;3526;1023;3344;144;525;686;2251;830;2776
280660;201503;2649;7577;2525;7409;415;1166;1926;5736;2341;6902
280670;201503;15874;41719;14816;40322;2672;7556;9886;26902;12558;34458
280680;201503;2782;7540;2458;7057;160;510;2023;5809;2183;6319
280690;201503;991;2816;864;2638;124;398;585;1770;709;2168
280700;201503;1102;3298;964;3089;66;207;748;2430;814;2637
280710;201503;11433;30813;10569;29828;754;1968;9011;25832;9765;27800
280720;201503;2248;6296;2048;6060;245;750;1469;4437;1714;5187
280730;201503;949;2823;899;2756;75;235;768;2380;843;2615
280740;201503;13059;35710;11377;33196;1708;4928;7553;22632;9261;27560
280750;201503;3534;10815;3237;10300;321;1163;2332;7428;2653;8591
280760;201503;5597;17282;5109;16612;661;2218;3598;12135;4259;14353
290010;201503;3117;6989;2236;5638;67;271;1786;4278;1853;4549
290020;201503;4509;15151;4438;15061;354;985;3884;13541;4238;14526
290030;201503;3154;9995;2985;9736;494;1639;2107;6921;2601;8560
290035;201503;4673;12224;4100;11486;258;800;3326;9609;3584;10409
290040;201503;3787;10749;3353;10253;212;849;2761;8327;2973;9176
290050;201503;2486;8156;2265;7833;161;660;1810;6257;1971;6917
290060;201503;1338;3414;1116;3152;196;631;798;2187;994;2818
290070;201503;31777;80749;27054;74969;5824;16113;14368;42230;20192;58343
290080;201503;6083;18253;5246;17174;598;1950;3963;13371;4561;15321
290090;201503;2284;4912;1784;4384;191;432;1479;3724;1670;4156
290100;201503;9585;27544;8443;25776;1123;3588;5629;17613;6752;21201
290110;201503;5071;15118;4835;14723;704;2356;3327;10018;4031;12374
290115;201503;4940;14707;4356;13934;308;1030;3420;11176;3728;12206
290120;201503;6602;17629;5797;16667;260;806;5124;14730;5384;15536
290130;201503;4541;12008;3845;11158;251;871;3149;8986;3400;9857
290135;201503;4619;11928;4038;11034;282;956;3067;8087;3349;9043
290140;201503;4147;12894;3523;12050;218;822;3026;10404;3244;11226
290150;201503;2209;6584;2102;6412;177;552;1768;5415;1945;5967
290160;201503;3419;9302;3321;9182;202;369;3035;8596;3237;8965
290170;201503;2736;9210;2503;8854;173;758;2165;7595;2338;8353
290180;201503;2893;8471;2560;7958;213;792;1960;6048;2173;6840
290190;201503;3878;13060;3730;12825;292;1175;2938;10118;3230;11293
290195;201503;2201;6083;1892;5625;129;460;1528;4541;1657;5001
290200;201503;3769;11884;3390;11266;280;973;2693;9013;2973;9986
290205;201503;3084;9349;2787;8899;325;1272;2022;6304;2347;7576
290210;201503;15591;43140;14434;41726;2836;7183;9580;30055;12416;37238
290220;201503;2245;6794;2145;6644;178;735;1677;5037;1855;5772
290225;201503;2932;7815;2723;7586;153;356;2486;7048;2639;7404
290230;201503;2267;7490;2197;7403;151;573;1892;6405;2043;6978
290240;201503;3804;10189;3444;9688;343;1056;2604;7221;2947;8277
290250;201503;3665;11813;3248;11167;229;809;2601;9091;2830;9900
290260;201503;4824;14283;4241;13395;351;1239;3342;10569;3693;11808
290265;201503;3287;10490;2973;9932;181;748;2342;7793;2523;8541
290270;201503;12230;44280;11524;43205;1532;6063;8440;32183;9972;38246
290280;201503;5146;17035;4835;16513;386;1460;3786;13007;4172;14467
290290;201503;9576;30471;8650;28992;1453;5050;5679;19442;7132;24492
290300;201503;4521;12954;3229;10531;258;842;2212;7506;2470;8348
290310;201503;1496;4484;1331;4229;238;823;781;2484;1019;3307
290320;201503;27248;80929;23613;76103;5622;19127;12565;41491;18187;60618
290323;201503;3788;10234;3287;9687;187;615;2774;8154;2961;8769
290327;201503;4374;13537;3860;12608;625;2116;2491;8169;3116;10285
290330;201503;1850;4685;1720;4543;160;466;1476;3878;1636;4344
290340;201503;4711;15049;4455;14715;1333;4331;2430;8217;3763;12548
290350;201503;4664;14390;4009;13457;501;1720;2779;9584;3280;11304
290360;201503;4460;13758;3880;12988;181;655;3314;11238;3495;11893
290370;201503;4797;13737;4240;13051;441;1291;3448;10830;3889;12121
290380;201503;5502;16085;4811;15079;339;1173;3841;12124;4180;13297
290390;201503;14737;46002;13582;44244;2727;8946;8022;27444;10749;36390
290395;201503;2632;8629;2340;8113;169;760;1804;6227;1973;6987
290400;201503;3590;10726;3110;10069;270;874;2414;7888;2684;8762
290405;201503;4545;14505;3888;13292;496;1780;2530;8859;3026;10639
290410;201503;6058;17830;4994;16227;506;1940;3634;11593;4140;13533
290420;201503;3306;9601;2727;8811;226;812;2167;6995;2393;7807
290430;201503;3070;9855;2804;9397;523;1893;1747;5870;2270;7763
290440;201503;2907;7839;2423;7167;181;601;1939;5810;2120;6411
290450;201503;3302;9673;2890;9085;388;1263;2035;6503;2423;7766
290460;201503;13086;38449;11748;36286;3062;9957;5269;16261;8331;26218
290470;201503;4528;12524;3484;11027;734;2635;1808;5812;2542;8447
290475;201503;4976;17134;4544;16311;440;1966;3329;11785;3769;13751
290480;201503;2684;6994;2388;6610;377;1109;1560;4425;1937;5534
290485;201503;4817;15359;4229;14502;369;1722;3390;11419;3759;13141
290490;201503;8039;21293;7709;20867;597;1717;6473;17503;7070;19220
290500;201503;4392;13753;3612;12280;615;2296;1913;6457;2528;8753
290510;201503;3334;9805;2909;9225;173;656;2400;7653;2573;8309
290515;201503;3171;9359;2767;8800;231;709;2213;7216;2444;7925
290520;201503;12243;37566;9972;33426;913;3789;6403;21265;7316;25054
290530;201503;5140;14930;4463;13931;360;1124;3572;11260;3932;12384
290540;201503;3950;11448;3745;11191;446;1260;2942;9020;3388;10280
290550;201503;4467;12109;3915;11466;144;423;3561;10496;3705;10919
290560;201503;5896;17757;5246;16802;1176;3998;2976;9705;4152;13703
290570;201503;41916;117037;38403;111985;4628;14120;27363;79674;31991;93794
290580;201503;6969;24012;6579;23416;935;3421;4770;17397;5705;20818
290590;201503;7705;24181;6457;22089;410;1716;5109;17432;5519;19148
290600;201503;17042;52495;15780;50582;2573;8025;10831;35934;13404;43959
290610;201503;2504;8503;2113;7731;184;850;1517;5464;1701;6314
290620;201503;6515;19857;5957;19031;368;1265;4992;15963;5360;17228
290630;201503;7967;21229;7157;20365;629;1796;6010;17294;6639;19090
290640;201503;2661;7793;2143;6931;161;619;1609;5148;1770;5767
290650;201503;11203;31964;10451;30942;2269;6597;6503;19909;8772;26506
290660;201503;3570;10074;3094;9392;171;584;2456;7606;2627;8190
290670;201503;6982;21341;6313;20313;744;2380;4682;15518;5426;17898
290680;201503;10149;30236;9279;29196;435;1530;7997;25272;8432;26802
290682;201503;4518;13118;4028;12437;159;654;3406;10381;3565;11035
290685;201503;3627;8800;2431;7122;297;937;1489;4471;1786;5408
290687;201503;7703;21266;6084;18982;1393;4489;3225;10389;4618;14878
290689;201503;3144;9070;2695;8380;248;790;2082;6605;2330;7395
290690;201503;5506;15978;4999;15345;483;1549;3965;12284;4448;13833
290700;201503;2349;7327;2222;7135;211;760;1705;5489;1916;6249
290710;201503;7987;25237;7638;24654;441;1439;6348;21124;6789;22563
290720;201503;18629;54879;16873;52702;1486;4194;13987;45067;15473;49261
290730;201503;7119;19974;6453;19109;1041;2989;4475;13489;5516;16478
290740;201503;920;2754;780;2518;88;313;535;1755;623;2068
290750;201503;10320;29112;8712;26178;1640;5607;4675;13430;6315;19037
290755;201503;2412;6787;1990;6095;120;438;1521;4639;1641;5077
290760;201503;4275;12845;3509;11563;389;1218;2396;8072;2785;9290
290770;201503;2573;9111;2421;8914;114;542;1980;7354;2094;7896
290780;201503;8954;22881;7826;21331;769;1653;6076;17275;6845;18928
290790;201503;4336;13215;4039;12789;277;852;3404;10913;3681;11765
290800;201503;7343;15777;5880;14228;698;1458;4393;11306;5091;12764
290810;201503;4990;15738;4258;14593;253;955;3273;11351;3526;12306
290820;201503;5681;15968;5065;15156;452;1471;3920;11835;4372;13306
290830;201503;4214;11562;3859;11037;227;824;3190;8923;3417;9747
290840;201503;17367;49231;15559;46679;2523;7365;10527;32969;13050;40334
290850;201503;6262;18286;6093;18072;715;1935;4994;15297;5709;17232
290860;201503;4927;17079;4610;16685;613;2258;3479;12985;4092;15243
290870;201503;4684;13926;3844;12645;327;1313;2854;9339;3181;10652
290880;201503;1424;3927;1143;3470;84;270;809;2479;893;2749
290890;201503;6987;18578;6009;17492;683;1949;4751;14045;5434;15994
290900;201503;2583;7327;1890;6161;285;976;949;3118;1234;4094
290910;201503;4530;12625;3978;11828;140;475;3491;10361;3631;10836
290920;201503;4705;14033;4365;13541;268;750;3670;11568;3938;12318
290930;201503;7673;24021;6780;22533;572;2289;5141;16891;5713;19180
290940;201503;3418;11022;3196;10726;197;699;2790;9528;2987;10227
290950;201503;1576;4428;1408;4189;193;564;977;2972;1170;3536
290960;201503;5761;16429;5250;15760;220;774;4438;13397;4658;14171
290970;201503;3542;11476;3181;10863;363;1294;2139;7432;2502;8726
290980;201503;10603;30682;9100;27899;2510;7999;3313;10106;5823;18105
290990;201503;9144;27533;8046;25763;844;2880;6048;19317;6892;22197
291000;201503;3066;9322;2807;8993;253;859;2322;7516;2575;8375
291005;201503;13760;37026;12319;35067;1775;5191;8589;24907;10364;30098
291010;201503;3182;10125;2539;8732;288;1058;1617;5603;1905;6661
291020;201503;1428;3749;1095;3163;126;414;668;1853;794;2267
291030;201503;2277;6213;1690;5057;171;575;1042;3043;1213;3618
291040;201503;5409;16451;4874;15706;459;1661;3863;12459;4322;14120
291050;201503;7698;25429;6980;24064;1883;7199;3378;11358;5261;18557
291060;201503;6009;22204;5713;21768;752;3297;4137;15702;4889;18999
291070;201503;16119;46800;14309;44193;1288;4081;10954;34273;12242;38354
291072;201503;22005;65665;18148;58063;4872;16832;6769;22097;11641;38929
291075;201503;5129;14527;4580;13826;278;705;3666;11466;3944;12171
291077;201503;1519;4326;1239;3880;119;426;838;2628;957;3054
291080;201503;78871;245030;70628;229114;23536;78431;20323;65128;43859;143559
291085;201503;5528;14772;4858;13906;481;1368;3912;11316;4393;12684
291090;201503;1555;3829;1354;3578;100;361;1107;2850;1207;3211
291100;201503;2811;7108;2253;6528;125;466;1861;5347;1986;5813
291110;201503;4789;17467;4407;16859;563;2507;3147;11870;3710;14377
291120;201503;7460;20106;6872;19248;840;2440;5078;14328;5918;16768
291125;201503;1811;3727;1390;3275;107;263;1096;2645;1203;2908
291130;201503;2857;8849;2453;8178;169;720;1816;5926;1985;6646
291140;201503;4277;12668;3833;11855;564;1787;2541;7956;3105;9743
291150;201503;1981;5210;1880;5095;136;417;1507;4037;1643;4454
291160;201503;5348;16556;4687;15522;1161;3868;2527;8499;3688;12367
291165;201503;2503;7187;1963;6170;87;404;1462;4461;1549;4865
291170;201503;21388;55592;18456;51813;937;3182;14388;40191;15325;43373
291180;201503;6479;16894;5215;15081;560;1828;3669;10566;4229;12394
291185;201503;3840;10494;3502;10025;312;928;2863;8188;3175;9116
291190;201503;7015;19528;6260;18534;554;1728;5071;15133;5625;16861
291200;201503;2886;8645;2351;7656;172;580;1670;5547;1842;6127
291210;201503;7239;17232;6172;16024;389;1140;5035;13046;5424;14186
291220;201503;4054;12711;3750;12242;446;1636;2785;9052;3231;10688
291230;201503;4053;10511;3661;10071;105;250;3385;9423;3490;9673
291240;201503;4650;12661;4021;11517;184;599;3260;9188;3444;9787
291250;201503;3668;11024;2879;9674;312;1085;1944;6648;2256;7733
291260;201503;1091;3210;1001;3089;60;240;830;2513;890;2753
291270;201503;4398;14360;4039;13711;1185;4197;2114;7275;3299;11472
291280;201503;2391;6311;1799;5473;421;1359;934;2796;1355;4155
291290;201503;5603;15702;4906;14825;811;2451;3184;9907;3995;12358
291300;201503;4239;12434;3543;11259;311;1167;2592;8090;2903;9257
291310;201503;5427;15493;4701;14228;331;1076;3685;11143;4016;12219
291320;201503;6027;19175;5125;17447;1182;4423;2701;9052;3883;13475
291330;201503;1608;4795;1434;4515;143;523;1016;3131;1159;3654
291340;201503;3853;11355;3241;10489;202;765;2638;8502;2840;9267
291345;201503;3536;11244;3291;10967;199;615;2912;9969;3111;10584
291350;201503;5445;16175;4834;15136;313;1085;3881;12287;4194;13372
291360;201503;33092;93517;30211;89462;7343;21594;17596;53873;24939;75467
291370;201503;8440;24685;8015;24145;641;1944;6414;19725;7055;21669
291380;201503;3741;11508;3240;10704;232;825;2381;8070;2613;8895
291390;201503;10454;28315;9451;27148;1304;3542;7164;20997;8468;24539
291400;201503;16428;42846;13557;39003;2393;6644;8399;25465;10792;32109
291410;201503;3330;8723;2483;7500;172;696;1887;5549;2059;6245
291420;201503;2152;5870;1877;5539;108;362;1636;4834;1744;5196
291430;201503;3373;9833;2986;9329;176;770;2404;7357;2580;8127
291440;201503;6442;19891;5512;18289;546;1913;4116;13838;4662;15751
291450;201503;8093;24398;7213;23160;318;1002;5936;19701;6254;20703
291460;201503;12980;39251;11605;37065;1920;6693;7145;22940;9065;29633
291465;201503;7960;22932;7123;21991;538;1876;5984;18474;6522;20350
291470;201503;15738;42922;13838;40626;1211;3420;10530;32102;11741;35522
291480;201503;33915;89479;29411;83325;3947;12620;19122;53629;23069;66249
291490;201503;4393;14288;4258;14104;386;1252;3565;12075;3951;13327
291500;201503;4265;12342;3660;11471;253;923;2924;9151;3177;10074
291510;201503;3558;10753;3253;10353;94;290;2976;9575;3070;9865
291520;201503;3864;10513;3356;9819;367;1128;2364;7014;2731;8142
291530;201503;2054;5908;1728;5404;413;1368;911;2952;1324;4320
291535;201503;4038;12090;3614;11486;238;831;2929;9405;3167;10236
291540;201503;2210;5226;1857;4861;156;302;1602;4352;1758;4654
291550;201503;5285;14421;4638;13529;1062;3005;2621;7874;3683;10879
291560;201503;18154;43925;13379;38417;1214;3450;10102;30042;11316;33492
291570;201503;2226;6109;2086;5945;156;360;1836;5383;1992;5743
291580;201503;5611;17132;4997;16246;575;2295;3639;11757;4214;14052
291590;201503;1821;5789;1630;5472;181;638;1197;4112;1378;4750
291600;201503;5834;15910;4335;13642;1035;3561;1980;6118;3015;9679
291610;201503;4889;15262;4732;15070;260;932;4142;13238;4402;14170
291620;201503;3016;7118;2400;6472;137;344;1947;5438;2084;5782
291630;201503;3139;7731;2658;7176;258;634;2133;5898;2391;6532
291640;201503;17295;46870;14132;42463;3569;11576;5327;16259;8896;27835
291650;201503;7966;23900;7373;23192;626;1650;6207;20169;6833;21819
291660;201503;2214;5855;1878;5367;156;552;1319;3647;1475;4199
291670;201503;1850;5298;1670;5041;116;392;1313;3953;1429;4345
291680;201503;4255;12454;3708;11552;767;2617;2079;6448;2846;9065
291685;201503;4708;11777;3913;10748;553;1459;2769;7897;3322;9356
291690;201503;4030;10873;3276;9696;242;704;2389;7125;2631;7829
291700;201503;9197;28765;8309;27235;871;2930;6303;21011;7174;23941
291710;201503;5187;13845;4316;12750;472;1546;3187;9488;3659;11034
291720;201503;4274;14285;3701;13130;365;1507;2633;9226;2998;10733
291730;201503;6049;18278;5473;17520;684;2315;4145;13521;4829;15836
291733;201503;2607;7620;2221;7102;259;888;1506;4882;1765;5770
291735;201503;2706;7596;2262;6937;130;475;1821;5528;1951;6003
291740;201503;3592;10815;3111;10084;282;1041;2372;7631;2654;8672
291750;201503;22598;58069;17467;50287;3924;11729;8901;26166;12825;37895
291760;201503;11377;36196;10102;33984;4038;15016;3111;10281;7149;25297
291770;201503;7596;21876;6581;20095;953;3152;4356;13186;5309;16338
291780;201503;4469;13572;4196;13100;377;1207;3338;10445;3715;11652
291790;201503;2625;8094;2486;7905;113;465;2136;6728;2249;7193
291800;201503;30690;85929;27335;81239;4751;14463;17137;52567;21888;67030
291810;201503;10631;29552;8905;27524;443;1621;7546;23386;7989;25007
291820;201503;3713;11015;3355;10502;271;887;2598;8218;2869;9105
291830;201503;4326;11550;3989;11070;469;1348;2999;8402;3468;9750
291835;201503;6281;19612;5054;17519;1392;5158;2595;9058;3987;14216
291840;201503;47768;132839;41986;126417;5611;16296;31268;97480;36879;113776
291845;201503;2933;8422;2606;8032;187;519;2298;7213;2485;7732
291850;201503;4679;13249;3836;11958;382;1093;2915;9379;3297;10472
291855;201503;1815;4669;1570;4361;181;635;1156;3090;1337;3725
291860;201503;2126;6146;1762;5468;131;503;1180;3588;1311;4091
291870;201503;1417;3789;1054;3143;99;358;674;1962;773;2320
291875;201503;2861;9057;2581;8625;161;684;1880;6161;2041;6845
291880;201503;4916;15569;4630;15108;357;1137;3790;12566;4147;13703
291890;201503;1358;3457;1134;3194;286;819;670;1966;956;2785
291900;201503;1307;3629;1089;3275;85;314;864;2575;949;2889
291905;201503;2801;7521;2248;6625;110;423;1716;4941;1826;5364
291910;201503;2739;7334;2300;6807;139;529;1931;5628;2070;6157
291915;201503;7092;21544;5986;19504;391;1375;4850;15925;5241;17300
291920;201503;30149;87431;27589;83791;5176;16383;16782;51704;21958;68087
291930;201503;2601;7682;2333;7271;211;744;1724;5343;1935;6087
291940;201503;3392;9670;2495;8047;349;1283;1416;4383;1765;5666
291950;201503;8702;29220;7879;27833;1383;4941;4696;17041;6079;21982
291955;201503;9416;28576;8919;27926;2021;6271;5390;17581;7411;23852
291960;201503;3170;9408;2627;8614;226;763;1948;6602;2174;7365
291970;201503;4017;12485;3748;12095;472;1596;2660;8729;3132;10325
291980;201503;11889;34017;9092;30015;1025;3513;6351;21544;7376;25057
291990;201503;2268;6839;2052;6543;128;435;1648;5386;1776;5821
291992;201503;2819;8619;2742;8466;397;1287;2052;6305;2449;7592
291995;201503;1886;5730;1755;5505;151;549;1401;4368;1552;4917
292000;201503;2382;6821;2102;6431;306;1084;1468;4458;1774;5542
292010;201503;6413;16395;4956;14279;457;1301;3807;11021;4264;12322
292020;201503;4228;14441;3936;13971;660;2447;2787;9952;3447;12399
292030;201503;2093;6436;1851;6080;237;833;1107;3616;1344;4449
292040;201503;4346;12012;3753;11395;247;602;3254;10302;3501;10904
292045;201503;2855;9860;2814;9809;89;301;2662;9282;2751;9583
292050;201503;6341;19565;5521;17931;476;1883;3793;12178;4269;14061
292060;201503;11563;31242;10783;30275;1046;2760;8798;24984;9844;27744
292070;201503;4511;14191;4376;14019;396;1170;3696;12025;4092;13195
292080;201503;3615;9399;3045;8690;211;633;2521;7242;2732;7875
292090;201503;4096;10817;3530;10158;236;782;3001;8692;3237;9474
292100;201503;11013;29992;9240;27519;2639;8200;4020;12565;6659;20765
292105;201503;2982;9427;2691;8988;154;642;2201;7343;2355;7985
292110;201503;6766;17862;5209;15494;1157;3482;2907;8938;4064;12420
292120;201503;7826;22247;6759;20291;1385;4154;3760;11720;5145;15874
292130;201503;2993;8045;2604;7499;478;1290;1714;5097;2192;6387
292140;201503;4966;13017;4260;12079;946;2435;2696;7984;3642;10419
292145;201503;2475;7635;2263;7323;136;419;1804;6099;1940;6518
292150;201503;12918;39576;11974;38076;691;2479;9624;30846;10315;33325
292160;201503;2657;7713;2270;7216;108;331;2003;6450;2111;6781
292170;201503;8860;25347;7410;22891;959;3355;4776;14726;5735;18081
292180;201503;3269;9393;2536;8219;314;1020;1713;5650;2027;6670
292190;201503;3400;9538;2867;8764;576;1836;1736;5420;2312;7256
292200;201503;6404;20360;5538;18761;1582;5858;2208;7457;3790;13315
292205;201503;3902;12160;3544;11655;211;861;2912;9479;3123;10340
292210;201503;6469;17836;5444;16482;373;1310;4435;13483;4808;14793
292220;201503;1939;5356;1776;5128;371;1016;1069;3128;1440;4144
292225;201503;3200;9877;2926;9485;177;657;2432;7916;2609;8573
292230;201503;6414;19180;6086;18654;443;1812;4777;14196;5220;16008
292240;201503;4614;14072;4178;13185;527;1748;2806;8777;3333;10525
292250;201503;5141;15894;4752;15182;1100;3689;2354;7551;3454;11240
292260;201503;3144;9438;2969;9200;206;691;2515;7802;2721;8493
292265;201503;2979;9408;2652;8850;188;768;1980;6532;2168;7300
292270;201503;4137;10624;3261;9609;204;711;2711;8017;2915;8728
292273;201503;2718;6536;2092;5773;225;576;1570;4574;1795;5150
292275;201503;1773;4743;1574;4450;217;641;1108;3162;1325;3803
292280;201503;2025;6050;1794;5800;132;346;1451;4978;1583;5324
292285;201503;2546;7032;2190;6530;154;543;1759;5259;1913;5802
292290;201503;7313;21843;6084;20200;419;1594;4760;16069;5179;17663
292300;201503;8080;24278;6993;22956;1638;5572;4156;14095;5794;19667
292303;201503;2790;8672;2587;8410;82;347;2300;7429;2382;7776
292305;201503;2951;8059;2830;7904;56;181;2669;7463;2725;7644
292310;201503;5917;17633;5545;17105;237;832;4668;14412;4905;15244
292320;201503;6613;19099;5692;17554;545;1818;4354;13460;4899;15278
292330;201503;2108;5813;1962;5607;173;566;1572;4432;1745;4998
292335;201503;5217;13618;4671;12912;458;1227;3835;10753;4293;11980
292340;201503;6407;18235;5412;16629;562;1738;3861;11962;4423;13700
292350;201503;2184;6604;1987;6326;190;726;1587;5044;1777;5770
292360;201503;5094;13794;4891;13357;182;365;4247;12166;4429;12531
292370;201503;7978;23853;7428;23081;803;2190;5910;18886;6713;21076
292380;201503;7193;21309;6658;20489;471;1447;5515;17122;5986;18569
292390;201503;3516;8060;3118;7630;96;166;2915;7231;3011;7397
292400;201503;20686;62288;19686;60757;2583;8347;14630;45481;17213;53828
292405;201503;4551;11628;3747;10633;246;668;3087;8852;3333;9520
292410;201503;1934;5213;1826;5091;125;312;1609;4538;1734;4850
292420;201503;3765;12227;3611;12039;122;364;3380;11405;3502;11769
292430;201503;5638;16871;4399;15128;321;1318;3249;11176;3570;12494
292440;201503;8539;28285;7846;27266;270;1093;6972;24499;7242;25592
292450;201503;4177;12427;3444;11269;331;1124;2503;8335;2834;9459
292460;201503;5272;15823;4564;14591;799;2744;2849;9129;3648;11873
292465;201503;2412;7285;2032;6653;198;765;1413;4670;1611;5435
292467;201503;1943;6258;1843;6096;316;1111;1252;4215;1568;5326
292470;201503;2916;7877;2462;7137;140;487;1952;5604;2092;6091
292480;201503;6060;16278;5265;15197;191;711;4647;13322;4838;14033
292490;201503;2421;6602;2003;5993;166;559;1552;4621;1718;5180
292500;201503;6553;19496;5603;17851;598;2066;3962;12809;4560;14875
292510;201503;12720;36141;11041;33782;915;3014;8647;26874;9562;29888
292520;201503;5656;16685;5052;15755;1268;4011;2672;8463;3940;12474
292525;201503;5348;13982;4541;13037;226;691;3850;11146;4076;11837
292530;201503;26207;76177;23305;72304;6077;19542;11954;38243;18031;57785
292540;201503;2842;7993;2519;7568;252;872;2005;6021;2257;6893
292550;201503;6499;20544;5747;19535;668;2424;4328;15057;4996;17481
292560;201503;4079;11274;3461;10387;221;877;2803;8259;3024;9136
292570;201503;3897;11656;3711;11459;79;194;3517;11068;3596;11262
292575;201503;6035;20277;5865;20005;751;2667;4600;15755;5351;18422
292580;201503;6822;20467;6455;19979;457;1432;5438;17002;5895;18434
292590;201503;7177;21978;6758;21344;609;2009;5462;17204;6071;19213
292593;201503;3072;8084;2606;7378;200;530;2078;5933;2278;6463
292595;201503;6000;16669;5299;15770;441;1425;4159;12469;4600;13894
292600;201503;10605;29871;9693;28727;910;2155;7883;24255;8793;26410
292610;201503;4498;12863;3667;11467;353;1143;2367;7678;2720;8821
292620;201503;6038;17612;5185;16620;154;512;4786;15469;4940;15981
292630;201503;9456;23881;7965;21636;704;1917;5891;16311;6595;18228
292640;201503;7766;25603;7197;24800;493;1820;5719;20077;6212;21897
292650;201503;4719;13036;4499;12743;359;651;3955;11704;4314;12355
292660;201503;10541;31906;9799;30836;1060;3446;7605;24267;8665;27713
292665;201503;2635;8041;2550;7926;46;99;2433;7662;2479;7761
292670;201503;3827;10755;2949;9272;239;843;1955;6166;2194;7009
292680;201503;3551;10750;3277;10303;373;1109;2527;8034;2900;9143
292690;201503;2940;8019;2147;6790;207;700;1519;4922;1726;5622
292700;201503;9217;27567;8116;25951;1135;3370;5607;18810;6742;22180
292710;201503;2017;6646;1921;6515;71;266;1736;5920;1807;6186
292720;201503;9207;23699;7960;22314;377;1181;6955;19603;7332;20784
292730;201503;3520;10603;3395;10421;355;1116;2621;8129;2976;9245
292740;201503;333706;901374;314182;873544;58476;172848;200172;553145;258648;725993
292750;201503;6467;17342;5543;16098;331;1006;4570;13368;4901;14374
292760;201503;4061;12841;3700;12206;492;1732;2490;8301;2982;10033
292770;201503;5578;17065;5167;16433;1005;3357;3269;10593;4274;13950
292780;201503;1920;4586;1468;4019;162;552;1069;2879;1231;3431
292790;201503;3181;8479;3051;8343;109;225;2853;7920;2962;8145
292800;201503;8989;26907;8292;25766;566;1973;6749;20918;7315;22891
292805;201503;2970;8534;2670;8122;393;1313;1910;5777;2303;7090
292810;201503;9302;28552;8003;26764;1010;3545;5811;19826;6821;23371
292820;201503;7303;20931;5444;18259;313;1224;4355;14716;4668;15940
292830;201503;1867;5468;1691;5222;83;353;1434;4368;1517;4721
292840;201503;7688;24025;7197;23363;295;1142;6475;20896;6770;22038
292850;201503;3253;8512;2664;7622;362;1074;1679;4701;2041;5775
292860;201503;14137;38143;13425;37204;1180;3481;10923;30182;12103;33663
292870;201503;19123;52359;16696;48626;2315;7463;10257;29564;12572;37027
292880;201503;12680;36490;11296;34498;1363;4574;7829;23708;9192;28282
292890;201503;5456;18615;4897;17596;791;3045;3072;11177;3863;14222
292895;201503;2755;6788;2167;5913;285;755;1530;4197;1815;4952
292900;201503;2831;8830;2690;8619;227;989;1993;6134;2220;7123
292905;201503;4184;12252;3539;11381;195;583;2929;9662;3124;10245
292910;201503;5044;15172;4579;14320;695;2369;2880;9013;3575;11382
292920;201503;8859;26286;8407;25658;656;2362;6802;20264;7458;22626
292925;201503;5117;15683;4546;14858;452;1492;3454;11422;3906;12914
292930;201503;6470;20863;6166;20340;545;2333;4681;15113;5226;17446
292935;201503;2137;6085;1786;5704;100;263;1497;5009;1597;5272
292937;201503;3259;8336;2715;7662;280;891;2070;5752;2350;6643
292940;201503;3265;8934;2580;8002;309;986;1754;5652;2063;6638
292950;201503;7918;23396;7444;22606;686;2519;5562;16512;6248;19031
292960;201503;5066;13327;4419;12457;365;1130;3302;9240;3667;10370
292970;201503;4300;12978;3834;12377;154;645;3258;10553;3412;11198
292975;201503;3418;9230;3232;8983;313;797;2743;7766;3056;8563
292980;201503;3403;9142;2679;8175;263;925;1954;5913;2217;6838
292990;201503;11789;34146;10477;32132;482;1674;8879;27208;9361;28882
293000;201503;2764;7395;2432;6981;80;266;2126;6165;2206;6431
293010;201503;18011;50262;15452;46235;2547;8283;9513;28316;12060;36599
293015;201503;7472;25637;6611;24035;981;3954;4246;15405;5227;19359
293020;201503;9237;30823;8643;29997;407;1770;7434;25757;7841;27527
293030;201503;5555;16062;4394;14297;370;1199;3129;10665;3499;11864
293040;201503;3719;12250;3538;11911;188;671;3132;10539;3320;11210
293050;201503;19871;55458;17466;52438;2485;7755;11493;35462;13978;43217
293060;201503;3977;10299;3242;9120;280;861;2376;6620;2656;7481
293070;201503;21132;61766;18732;57971;4676;14719;9488;30268;14164;44987
293075;201503;3354;11139;3035;10698;227;880;2458;8740;2685;9620
293076;201503;3705;10290;3397;9876;226;633;2859;8484;3085;9117
293077;201503;4817;15120;4288;14400;1108;3891;2281;7828;3389;11719
293080;201503;4628;14619;4244;14018;244;1126;3471;11252;3715;12378
293090;201503;3346;10745;2811;9956;251;906;2131;7693;2382;8599
293100;201503;5771;17080;4800;15404;449;1530;3553;11546;4002;13076
293105;201503;3943;13103;3469;12216;475;1739;2363;8478;2838;10217
293110;201503;1991;5804;1779;5484;73;276;1509;4637;1582;4913
293120;201503;3832;12763;3613;12435;307;996;2898;10220;3205;11216
293130;201503;4045;11452;3420;10758;161;559;3060;9762;3221;10321
293135;201503;30747;77603;23259;67252;4664;15560;10355;29588;15019;45148
293140;201503;2033;5902;1943;5775;153;552;1557;4514;1710;5066
293150;201503;5561;18426;4868;17077;899;3286;2983;10717;3882;14003
293160;201503;3756;9949;3499;9658;497;982;2656;7870;3153;8852
293170;201503;3323;9998;3053;9599;383;1348;2194;6937;2577;8285
293180;201503;5153;14538;4186;13013;217;862;3360;10288;3577;11150
293190;201503;13799;42049;13003;40887;466;2183;11415;35282;11881;37465
293200;201503;6735;19213;5870;18055;276;990;4965;15353;5241;16343
293210;201503;4983;14544;4467;13684;340;1200;3431;10493;3771;11693
293220;201503;5108;15163;4486;14124;1133;3710;2121;6773;3254;10483
293230;201503;3825;11846;3520;11383;571;1977;2444;7960;3015;9937
293240;201503;4478;12176;3618;10771;165;541;2777;8267;2942;8808
293245;201503;4320;12392;3942;11833;393;1168;3009;9225;3402;10393
293250;201503;5843;16399;5326;15641;605;1862;3825;11251;4430;13113
293260;201503;4608;13887;3920;12901;318;1134;2992;9942;3310;11076
293270;201503;5632;15154;5288;14794;405;926;4667;13404;5072;14330
293280;201503;5351;15087;4594;14105;290;853;3704;11605;3994;12458
293290;201503;15475;51754;14556;50000;3519;12625;7492;26247;11011;38872
293300;201503;6890;16516;5836;15305;395;961;4683;12536;5078;13497
293305;201503;4788;11922;4127;11025;182;556;3535;9402;3717;9958
293310;201503;2508;6519;2057;5765;176;529;1497;4159;1673;4688
293315;201503;4268;11057;3752;10283;511;1400;2679;7455;3190;8855
293317;201503;2465;7187;2196;6694;200;632;1518;4647;1718;5279
293320;201503;8076;26905;7887;26682;601;2223;6736;22927;7337;25150
293325;201503;1884;5443;1562;4949;210;740;1073;3423;1283;4163
293330;201503;52222;165465;46876;156387;10038;36307;24131;81206;34169;117513
293340;201503;2699;7649;2118;6639;277;957;1408;4335;1685;5292
293345;201503;3343;9977;2928;9407;293;870;2222;7460;2515;8330
293350;201503;6735;18932;6388;18535;362;863;5702;16980;6064;17843
293360;201503;13344;40730;12032;39072;552;1902;10620;34758;11172;36660
310010;201503;1132;3052;836;2594;163;630;369;1067;532;1697
310020;201503;3272;10257;2686;9050;699;2628;483;1438;1182;4066
310030;201503;2346;7430;1960;6755;474;1831;1037;3524;1511;5355
310040;201503;1007;2704;846;2494;70;242;654;1921;724;2163
310050;201503;1919;6628;1728;6193;323;1379;843;2949;1166;4328
310060;201503;3222;10417;2851;9937;334;1245;2179;7657;2513;8902
310070;201503;331;939;257;802;29;122;148;421;177;543
310080;201503;719;2180;580;1937;123;520;200;594;323;1114
310090;201503;4695;14000;4058;12865;591;2088;2510;7936;3101;10024
310100;201503;3338;10135;2787;9201;217;879;2149;7053;2366;7932
310110;201503;5008;14106;4269;12964;724;2598;2594;7722;3318;10320
310120;201503;490;1549;426;1445;144;626;184;499;328;1125
310130;201503;427;1297;385;1235;80;311;221;660;301;971
310140;201503;198;648;164;587;62;263;40;112;102;375
310150;201503;4719;14480;4156;13430;917;3320;1877;5992;2794;9312
310160;201503;7319;22783;6016;20495;1704;6424;1962;6671;3666;13095
310163;201503;913;3011;774;2726;204;794;279;955;483;1749
310170;201503;9115;25888;8253;24672;1284;3993;5490;16827;6774;20820
310180;201503;1619;4750;1367;4367;323;1151;643;1993;966;3144
310190;201503;2696;8995;2456;8608;759;2916;404;1449;1163;4365
310200;201503;1884;6144;1569;5512;385;1517;560;1936;945;3453
310205;201503;1104;3236;882;2881;167;550;497;1662;664;2212
310210;201503;2639;7972;2417;7651;273;992;1852;5842;2125;6834
310220;201503;1046;3274;982;3167;199;709;559;1757;758;2466
310230;201503;2625;8288;2195;7344;505;1987;990;3083;1495;5070
310240;201503;1047;3645;900;3382;151;644;475;1861;626;2505
310250;201503;859;2908;831;2858;159;651;504;1641;663;2292
310260;201503;3337;10621;2723;9369;725;2811;897;2882;1622;5693
310270;201503;2495;7291;2167;6809;163;564;1758;5563;1921;6127
310280;201503;2239;6142;1917;5665;349;1309;1048;2927;1397;4236
310285;201503;2079;7427;1945;7224;226;931;1519;5714;1745;6645
310290;201503;1266;3877;1178;3749;310;1130;582;1689;892;2819
310300;201503;1776;6026;1680;5837;445;1748;927;3127;1372;4875
310310;201503;377;1031;268;812;40;124;131;398;171;522
310320;201503;390;1272;328;1146;55;249;152;512;207;761
310330;201503;505;1266;359;1008;29;103;178;450;207;553
310340;201503;8411;25541;7035;23213;1351;4680;3853;13105;5204;17785
310350;201503;14312;38788;10494;32318;2849;9828;2977;8905;5826;18733
310360;201503;429;1317;411;1292;43;171;305;920;348;1091
310370;201503;1443;4933;1369;4812;368;1332;764;2721;1132;4053
310375;201503;1349;3601;892;2800;143;522;357;1077;500;1599
310380;201503;376;1024;283;889;97;340;111;318;208;658
310390;201503;511;1826;444;1683;118;485;76;249;194;734
310400;201503;9888;28474;7609;24458;1927;6844;2164;6940;4091;13784
310410;201503;825;2708;547;2216;150;666;108;424;258;1090
310420;201503;5950;16985;3707;12065;726;2630;598;1731;1324;4361
310430;201503;1475;4936;1172;4324;328;1352;250;875;578;2227
310440;201503;549;1591;449;1429;98;366;193;579;291;945
310445;201503;1260;4105;1045;3705;160;612;630;2227;790;2839
310450;201503;4688;13312;3803;12072;596;2025;2507;8130;3103;10155
310460;201503;1613;5036;1372;4648;414;1547;283;1002;697;2549
310470;201503;3424;8820;2906;8172;276;754;2381;6790;2657;7544
310480;201503;1195;3566;947;3072;208;805;404;1197;612;2002
310490;201503;2939;9696;2554;8952;708;2801;1007;3464;1715;6265
310500;201503;1303;4453;1183;4197;294;1186;504;1736;798;2922
310510;201503;2237;7075;1789;6079;497;1843;358;1150;855;2993
310520;201503;1414;3755;1117;3275;87;267;736;2164;823;2431
310530;201503;900;2793;534;1828;84;321;94;294;178;615
310540;201503;3147;10375;2875;9916;800;2920;1267;4393;2067;7313
310550;201503;1222;3567;997;3188;249;968;447;1303;696;2271
310560;201503;15602;47887;13211;43260;3759;13837;4218;12909;7977;26746
310570;201503;1193;3594;1068;3399;150;549;761;2380;911;2929
310590;201503;4263;12461;3397;10820;581;2096;1397;4235;1978;6331
310600;201503;1416;4741;1290;4469;384;1538;440;1382;824;2920
310610;201503;493;1666;444;1571;105;474;151;467;256;941
310620;201503;172428;530434;142351;472033;35125;131878;54205;170053;89330;301931
310630;201503;3962;12261;3691;11797;466;1742;2674;8416;3140;10158
310640;201503;1341;4025;1053;3506;351;1264;252;773;603;2037
310650;201503;2711;8794;2211;7930;376;1495;1291;4664;1667;6159
310660;201503;1396;4204;1213;3951;156;522;864;2799;1020;3321
310665;201503;1234;3847;1111;3667;164;576;788;2653;952;3229
310670;201503;46997;145446;42236;135342;11021;38058;16414;50921;27435;88979
310680;201503;706;2062;637;1958;143;464;350;1059;493;1523
310690;201503;1383;4523;1122;4045;305;1277;334;1116;639;2393
310700;201503;575;1501;455;1337;126;413;229;646;355;1059
310710;201503;6613;21611;5169;19194;1188;5143;1257;4499;2445;9642
310720;201503;775;2346;699;2211;172;637;340;1003;512;1640
310730;201503;9358;29264;8321;27540;1608;5860;5059;16682;6667;22542
310740;201503;4825;15633;3926;13859;1129;4455;971;3277;2100;7732
310750;201503;1550;3882;1212;3456;147;430;888;2539;1035;2969
310760;201503;601;1819;502;1663;117;422;204;660;321;1082
310770;201503;801;2546;623;2273;180;747;281;975;461;1722
310780;201503;3744;10470;3216;9542;543;1635;1957;5802;2500;7437
310790;201503;1917;6108;1721;5761;449;1582;801;2773;1250;4355
310800;201503;2772;8767;2135;7541;727;2934;245;814;972;3748
310810;201503;1281;3595;1157;3389;209;667;636;1804;845;2471
310820;201503;1346;3894;1017;3294;249;918;317;969;566;1887
310825;201503;2472;8344;1963;7438;147;756;1450;5410;1597;6166
310830;201503;1399;4562;1093;3961;338;1304;293;1009;631;2313
310840;201503;2196;6864;1805;6193;618;2374;508;1634;1126;4008
310850;201503;1536;4595;1285;4267;190;714;922;3051;1112;3765
310855;201503;2892;9221;2509;8631;482;1805;1566;5449;2048;7254
310860;201503;7739;23826;6599;21842;1012;3583;3835;12960;4847;16543
310870;201503;990;2770;796;2450;165;545;413;1264;578;1809
310880;201503;1224;3748;927;3196;172;711;456;1534;628;2245
310890;201503;2652;8260;2098;7290;541;2162;620;2007;1161;4169
310900;201503;3945;12721;3217;11199;828;3281;1145;3692;1973;6973
310910;201503;2073;5915;1402;4651;343;1281;299;922;642;2203
310920;201503;1910;5747;1526;5192;364;1393;696;2378;1060;3771
310925;201503;894;2952;806;2793;311;1192;295;991;606;2183
310930;201503;5910;16998;4750;15255;849;2956;2772;9137;3621;12093
310940;201503;6338;18245;5327;16689;995;3375;2907;9082;3902;12457
310945;201503;1328;3705;1095;3385;180;673;689;2041;869;2714
310950;201503;1980;6343;1495;5276;421;1717;405;1285;826;3002
310960;201503;411;1350;338;1215;106;411;110;393;216;804
310970;201503;1459;4926;1055;3949;314;1316;131;408;445;1724
310980;201503;470;1193;307;897;42;154;137;348;179;502
310990;201503;1159;3879;984;3513;243;978;316;1045;559;2023
311000;201503;3632;12388;3223;11539;914;3761;1127;3752;2041;7513
311010;201503;764;2532;710;2436;219;811;331;1101;550;1912
311020;201503;942;2848;759;2525;174;660;309;959;483;1619
311030;201503;1692;4786;1226;3894;311;1119;424;1211;735;2330
311040;201503;489;1652;430;1497;96;351;99;330;195;681
311050;201503;2247;7148;1953;6651;539;2034;847;2886;1386;4920
311060;201503;2120;6430;1621;5359;363;1348;403;1235;766;2583
311070;201503;1457;5099;1283;4771;337;1451;487;1784;824;3235
311080;201503;890;2649;800;2497;126;434;494;1504;620;1938
311090;201503;1597;5924;1357;5443;460;2076;251;974;711;3050
311100;201503;2173;7402;1836;6697;731;2893;388;1380;1119;4273
311110;201503;3945;9268;2708;7529;440;1339;1449;3985;1889;5324
311115;201503;1198;3543;1016;3272;115;480;672;2130;787;2610
311120;201503;7934;22427;6174;19303;1592;5573;1622;4661;3214;10234
311130;201503;2097;6622;1773;6166;443;1873;790;2594;1233;4467
311140;201503;1378;3728;1126;3413;127;456;805;2404;932;2860
311150;201503;1945;6585;1793;6341;338;1290;1057;3769;1395;5059
311160;201503;4838;16289;4090;14964;1478;5883;1179;4233;2657;10116
311170;201503;776;2365;617;2072;82;288;312;1095;394;1383
311180;201503;1462;4109;1104;3421;326;1089;262;745;588;1834
311190;201503;1034;3106;881;2806;196;739;310;870;506;1609
311200;201503;2169;6629;1799;5867;558;2024;402;1158;960;3182
311205;201503;1077;3532;927;3230;197;795;392;1359;589;2154
311210;201503;943;3062;875;2959;167;564;606;2113;773;2677
311220;201503;891;2819;717;2444;176;645;248;832;424;1477
311230;201503;8321;25736;6829;22940;1329;4856;3130;10794;4459;15650
311240;201503;1167;3539;950;3190;257;980;328;1065;585;2045
311250;201503;899;2916;800;2768;235;932;261;762;496;1694
311260;201503;2728;7345;2043;6184;546;1831;677;1990;1223;3821
311265;201503;1325;3638;1042;3190;174;629;610;1835;784;2464
311270;201503;3395;10894;2972;10320;433;1879;2043;6884;2476;8763
311280;201503;1308;3605;906;2826;194;694;270;795;464;1489
311290;201503;2114;7026;1974;6736;424;1455;1142;3980;1566;5435
311300;201503;4583;15289;4111;14483;555;2259;2839;10050;3394;12309
311310;201503;537;1857;487;1766;97;425;212;721;309;1146
311320;201503;4110;13672;3632;12632;793;3183;1302;4276;2095;7459
311330;201503;4923;14807;4251;13738;1311;4724;1709;5474;3020;10198
311340;201503;12307;39013;10895;36347;3278;11882;3336;11023;6614;22905
311350;201503;2257;6592;1824;5788;363;1375;839;2467;1202;3842
311360;201503;1219;3371;936;3016;401;1371;213;690;614;2061
311370;201503;3887;11738;3315;10752;774;3063;1454;4279;2228;7342
311380;201503;451;1436;376;1302;110;441;126;417;236;858
311390;201503;1832;6742;1701;6538;725;3189;550;1979;1275;5168
311400;201503;1473;4723;1274;4352;275;1111;577;1797;852;2908
311410;201503;1810;6311;1645;6093;455;1837;893;3381;1348;5218
311420;201503;2031;6598;1499;5337;396;1535;294;824;690;2359
311430;201503;3982;12041;2782;9400;580;2160;446;1438;1026;3598
311440;201503;2317;7560;1760;6489;624;2688;351;1233;975;3921
311450;201503;1990;6928;1703;6254;485;1954;387;1304;872;3258
311455;201503;1289;3439;1058;3074;230;747;572;1563;802;2310
311460;201503;689;2237;534;1921;121;541;131;431;252;972
311470;201503;552;1764;443;1536;110;472;139;434;249;906
311480;201503;769;2049;718;1983;184;486;407;1119;591;1605
311490;201503;256;977;233;912;79;324;82;311;161;635
311500;201503;468;1370;370;1186;96;345;162;511;258;856
311510;201503;3121;9641;2535;8522;898;3555;593;1802;1491;5357
311520;201503;641;2141;591;2034;219;815;213;698;432;1513
311530;201503;12010;31107;8398;25060;2002;7187;2403;6908;4405;14095
311535;201503;780;2327;556;1884;121;482;92;287;213;769
311540;201503;643;2256;609;2206;213;814;304;1076;517;1890
311545;201503;2086;6548;1916;6337;220;873;1420;4667;1640;5540
311547;201503;1545;4335;1291;3935;103;341;870;2667;973;3008
311550;201503;2984;9593;2534;8691;592;2329;858;2866;1450;5195
311560;201503;261;666;218;611;36;111;129;347;165;458
311570;201503;2203;5501;1737;4917;111;316;1384;4023;1495;4339
311580;201503;2358;4959;1850;4371;556;1236;999;2489;1555;3725
311590;201503;429;1350;372;1271;112;458;110;367;222;825
311600;201503;1194;3617;1026;3391;202;662;644;2203;846;2865
311610;201503;3136;10999;2824;10454;932;3416;1254;4939;2186;8355
311615;201503;3029;9437;2537;8641;280;1114;1772;6063;2052;7177
311620;201503;436;1375;387;1298;88;324;225;747;313;1071
311630;201503;1420;4186;1196;3798;265;828;670;2171;935;2999
311640;201503;845;2654;703;2423;135;525;408;1367;543;1892
311650;201503;2276;6725;1925;6150;256;872;1146;3786;1402;4658
311660;201503;2414;8080;1979;7109;434;1742;280;821;714;2563
311670;201503;1533;4614;1285;4197;435;1573;491;1587;926;3160
311680;201503;2102;6716;1803;6247;412;1501;1017;3584;1429;5085
311690;201503;553;1424;445;1294;54;174;337;976;391;1150
311700;201503;2215;6111;1878;5646;131;545;1506;4403;1637;4948
311710;201503;1700;5127;1257;4308;470;1809;340;1118;810;2927
311720;201503;397;1323;354;1236;65;261;182;615;247;876
311730;201503;5614;14254;3307;10139;935;3349;1010;2585;1945;5934
311740;201503;938;2642;803;2480;310;927;411;1328;721;2255
311750;201503;3967;13039;3456;12247;620;2516;1994;6982;2614;9498
311760;201503;806;2705;753;2598;202;824;328;1007;530;1831
311770;201503;2433;7663;1987;6839;503;1946;600;1959;1103;3905
311780;201503;1115;4047;942;3631;301;1325;217;776;518;2101
311783;201503;1953;6400;1654;5823;100;469;1236;4337;1336;4806
311787;201503;567;1961;416;1518;65;252;98;291;163;543
311790;201503;1449;4313;1059;3546;267;992;287;900;554;1892
311800;201503;4162;14029;3180;11341;669;2530;211;627;880;3157
311810;201503;1048;3528;989;3422;40;197;836;2870;876;3067
311820;201503;655;2101;539;1817;140;543;269;843;409;1386
311830;201503;7915;26908;6603;23699;2319;8988;920;2998;3239;11986
311840;201503;3188;9489;2776;8897;789;2893;1272;3936;2061;6829
311850;201503;304;896;260;826;67;238;119;370;186;608
311860;201503;50483;151810;43349;138948;10398;36928;19728;61049;30126;97977
311870;201503;2280;6691;1746;5665;377;1442;574;1682;951;3124
311880;201503;6907;20183;6157;19291;946;2880;4281;13974;5227;16854
311890;201503;1461;4446;1190;3897;299;1096;466;1453;765;2549
311900;201503;769;2402;691;2299;121;396;447;1571;568;1967
311910;201503;4462;13193;3710;12132;956;3426;1608;5259;2564;8685
311920;201503;1930;6374;1693;5975;180;724;1151;4072;1331;4796
311930;201503;3820;11083;3269;10219;1185;3933;1026;3149;2211;7082
311940;201503;12138;36876;10040;32633;2905;10389;2180;6645;5085;17034
311950;201503;2298;6736;1911;6213;165;592;1394;4513;1559;5105
311960;201503;362;1114;322;1031;69;282;161;439;230;721
311970;201503;384;1310;317;1172;77;336;69;242;146;578
311980;201503;660;1832;451;1463;74;263;185;602;259;865
311990;201503;451;1321;374;1197;138;486;126;370;264;856
311995;201503;1154;3503;714;2425;92;350;129;353;221;703
312000;201503;658;2015;596;1915;89;324;371;1185;460;1509
312010;201503;957;3122;830;2840;154;607;372;1242;526;1849
312015;201503;1495;4706;1294;4363;162;665;824;2751;986;3416
312020;201503;869;2711;745;2515;152;589;406;1383;558;1972
312030;201503;1773;5291;1611;5091;137;513;1331;4188;1468;4701
312040;201503;719;2696;623;2427;173;756;130;476;303;1232
312050;201503;1465;5061;1291;4729;381;1558;288;1017;669;2575
312060;201503;751;2282;660;2155;297;1040;201;587;498;1627
312070;201503;1031;3180;684;2423;164;630;245;854;409;1484
312080;201503;2604;7323;2056;6456;380;1438;1019;2957;1399;4395
312083;201503;965;2751;827;2551;137;490;517;1555;654;2045
312087;201503;2191;6757;1933;6380;264;939;1376;4619;1640;5558
312090;201503;8979;28243;7961;26521;2297;8354;3362;10966;5659;19320
312100;201503;1386;4648;1179;4325;257;1051;603;2235;860;3286
312110;201503;1132;3970;987;3662;340;1440;181;584;521;2024
312120;201503;750;2510;653;2316;163;687;212;650;375;1337
312125;201503;1165;3707;1033;3461;237;832;531;1836;768;2668
312130;201503;783;2302;615;1963;99;367;261;795;360;1162
312140;201503;1000;3154;814;2708;158;599;280;803;438;1402
312150;201503;581;1653;492;1460;39;135;334;960;373;1095
312160;201503;7565;25828;6816;24279;1948;7643;2510;8836;4458;16479
312170;201503;972;2863;867;2667;104;342;533;1643;637;1985
312180;201503;1419;4324;1244;3985;293;1012;511;1571;804;2583
312190;201503;624;1986;469;1678;168;680;89;291;257;971
312200;201503;4873;14220;4219;13233;457;1550;3051;9579;3508;11129
312210;201503;1049;2879;816;2516;215;737;354;1030;569;1767
312220;201503;1846;6163;1669;5959;164;624;1366;5019;1530;5643
312230;201503;13365;41692;10511;36143;3906;14819;1876;6279;5782;21098
312235;201503;1757;5076;1461;4634;155;611;986;3116;1141;3727
312240;201503;950;3161;780;2810;197;789;248;828;445;1617
312245;201503;2288;6748;1980;6344;113;353;1641;5311;1754;5664
312247;201503;823;2502;652;2199;164;622;318;1087;482;1709
312250;201503;1198;3361;951;2948;183;664;431;1283;614;1947
312260;201503;937;2963;783;2728;142;581;484;1657;626;2238
312270;201503;685;2071;567;1850;94;404;253;732;347;1136
312280;201503;382;1306;343;1220;135;514;44;143;179;657
312290;201503;741;2452;685;2370;233;946;202;666;435;1612
312300;201503;946;3139;759;2699;182;731;96;260;278;991
312310;201503;925;3479;853;3308;240;1026;346;1296;586;2322
312320;201503;2191;6224;1703;5239;415;1398;384;946;799;2344
312330;201503;998;2978;843;2751;154;594;578;1847;732;2441
312340;201503;311;802;275;755;34;135;217;557;251;692
312350;201503;338;851;306;814;30;90;257;668;287;758
312352;201503;1683;5416;1539;5216;431;1470;908;3213;1339;4683
312360;201503;2770;9040;2307;8083;560;2207;700;2391;1260;4598
312370;201503;1743;5580;1586;5340;581;2196;510;1601;1091;3797
312380;201503;1876;5429;1675;5135;142;460;1337;4182;1479;4642
312385;201503;1285;3858;1124;3593;129;555;792;2424;921;2979
312390;201503;2110;6919;1724;6077;512;1910;310;1005;822;2915
312400;201503;3317;10707;2826;9762;1005;3626;925;3324;1930;6950
312410;201503;10309;33968;9232;31919;2356;9022;3705;12536;6061;21558
312420;201503;4003;12379;3787;12123;540;1732;2791;9163;3331;10895
312430;201503;7396;22698;6752;21650;1119;3623;4513;14745;5632;18368
312440;201503;688;2188;614;2064;138;511;319;1113;457;1624
312450;201503;1125;3830;918;3390;354;1376;314;1148;668;2524
312460;201503;372;1129;332;1083;94;337;161;520;255;857
312470;201503;705;1934;454;1440;92;335;144;435;236;770
312480;201503;1248;3497;998;3212;271;977;512;1579;783;2556
312490;201503;2068;5496;1644;4881;244;814;956;2736;1200;3550
312500;201503;672;2119;603;2015;116;487;331;1076;447;1563
312510;201503;2957;8787;2325;7475;416;1562;1106;3293;1522;4855
312520;201503;287;991;233;886;66;265;80;313;146;578
312530;201503;603;1830;541;1740;88;362;345;1050;433;1412
312540;201503;1472;4627;1155;3994;259;970;579;1980;838;2950
312550;201503;687;2123;595;1922;134;454;265;800;399;1254
312560;201503;2053;5546;1747;5153;136;466;1412;4152;1548;4618
312570;201503;2614;7747;2191;7018;628;2149;665;2058;1293;4207
312580;201503;537;1775;445;1587;91;417;166;552;257;969
312590;201503;1804;6001;1576;5533;386;1573;596;1917;982;3490
312595;201503;2079;7005;1855;6485;491;1847;885;3041;1376;4888
312600;201503;754;2485;611;2229;118;555;317;1052;435;1607
312610;201503;7213;20639;5481;17554;1374;4959;1386;4140;2760;9099
312620;201503;2016;5933;1590;5357;125;454;1260;4368;1385;4822
312630;201503;367;1195;328;1120;74;293;177;588;251;881
312640;201503;566;1819;454;1593;93;384;169;532;262;916
312650;201503;2179;6467;1575;5270;168;636;915;3045;1083;3681
312660;201503;1369;3675;1118;3315;119;417;766;2239;885;2656
312670;201503;5871;17786;5080;16688;1208;4508;2461;7901;3669;12409
312675;201503;1359;4335;1141;3892;164;648;678;2272;842;2920
312680;201503;1484;4647;1312;4392;164;624;919;3037;1083;3661
312690;201503;2192;5863;1761;5267;351;1192;985;2812;1336;4004
312695;201503;827;3028;796;2987;150;559;554;2146;704;2705
312700;201503;1939;5736;1518;4901;214;788;767;2432;981;3220
312705;201503;1354;3848;1142;3507;131;443;794;2427;925;2870
312707;201503;1736;5340;1371;4648;203;797;712;2334;915;3131
312710;201503;6960;18415;4672;14489;1291;4599;1025;2885;2316;7484
312720;201503;763;2592;661;2372;164;656;236;789;400;1445
312730;201503;1973;4801;1424;4156;208;706;819;2394;1027;3100
312733;201503;1683;4520;1280;3769;93;363;879;2480;972;2843
312735;201503;879;2519;774;2377;209;717;420;1246;629;1963
312737;201503;910;2286;658;1934;212;622;279;843;491;1465
312738;201503;548;1658;403;1361;104;401;138;432;242;833
312740;201503;469;1319;315;1129;96;382;83;301;179;683
312750;201503;1253;4504;1198;4395;273;1182;591;2090;864;3272
312760;201503;2171;6944;1685;6009;441;1775;380;1336;821;3111
312770;201503;41048;114131;32729;100434;8801;29556;10017;29957;18818;59513
312780;201503;2739;9618;2457;9153;470;1908;1376;5280;1846;7188
312790;201503;339;872;199;624;53;206;49;114;102;320
312800;201503;5084;16825;4256;15165;1345;5178;1239;4422;2584;9600
312810;201503;2173;6662;1538;5458;453;1792;318;1040;771;2832
312820;201503;2048;5957;1839;5622;167;622;1233;3670;1400;4292
312825;201503;1356;3696;1185;3486;96;297;956;2823;1052;3120
312830;201503;2718;8534;1910;6876;485;1933;359;1258;844;3191
312840;201503;1194;3869;1016;3544;142;623;548;1835;690;2458
312850;201503;645;2098;528;1869;98;419;190;646;288;1065
312860;201503;1128;3324;892;2910;234;914;269;760;503;1674
312870;201503;5282;16495;3925;13785;890;3544;1021;3463;1911;7007
312880;201503;1299;3890;1121;3596;170;615;652;2110;822;2725
312890;201503;1588;4764;1085;3679;341;1290;336;1105;677;2395
312900;201503;1247;3760;1112;3576;208;705;757;2483;965;3188
312910;201503;1436;3129;1014;2561;191;586;546;1249;737;1835
312920;201503;861;2749;740;2569;187;743;382;1295;569;2038
312930;201503;2250;6537;1953;6111;448;1456;991;3200;1439;4656
312940;201503;904;2984;794;2797;233;952;212;702;445;1654
312950;201503;3324;9274;2598;8205;865;2960;833;2605;1698;5565
312960;201503;1973;5854;1759;5578;296;933;1265;4116;1561;5049
312965;201503;1774;5701;1506;5208;258;989;882;3095;1140;4084
312970;201503;988;3362;823;3099;296;1292;150;508;446;1800
312980;201503;16974;57703;15961;55505;5119;19608;6314;20940;11433;40548
312990;201503;428;1305;325;1130;112;437;105;358;217;795
313000;201503;532;1764;432;1566;116;538;160;509;276;1047
313005;201503;2596;8382;2297;7869;435;1560;1360;4699;1795;6259
313010;201503;3737;11996;3203;11106;889;3430;1391;4709;2280;8139
313020;201503;963;3164;822;2880;224;911;240;722;464;1633
313030;201503;1467;3988;1097;3488;252;974;497;1489;749;2463
313040;201503;865;2925;740;2592;140;572;283;926;423;1498
313050;201503;1801;5781;1459;5289;447;1798;574;2005;1021;3803
313055;201503;1593;5203;1458;5016;136;505;1111;3873;1247;4378
313060;201503;608;1999;490;1701;178;647;62;207;240;854
313065;201503;1934;6312;1674;5901;284;1138;1190;4178;1474;5316
313070;201503;1143;3330;935;2958;227;840;436;1268;663;2108
313080;201503;476;1488;382;1307;99;411;122;340;221;751
313090;201503;5362;15521;4670;14451;756;2482;3075;9649;3831;12131
313100;201503;1094;3424;1001;3271;103;355;776;2551;879;2906
313110;201503;1729;4925;1297;4093;282;1021;499;1430;781;2451
313115;201503;2495;8513;2378;8286;601;2418;1185;3852;1786;6270
313120;201503;3565;9720;3055;9041;650;2112;1969;5720;2619;7832
313130;201503;23498;71428;20180;64589;5055;17906;7476;22522;12531;40428
313140;201503;696;1812;532;1567;34;127;366;1062;400;1189
313150;201503;1458;4625;1258;4256;509;1849;326;1091;835;2940
313160;201503;1054;3175;930;2949;158;599;565;1732;723;2331
313170;201503;7686;26952;6555;24233;1903;7565;1327;4805;3230;12370
313180;201503;2452;6682;1941;5964;542;1847;709;2095;1251;3942
313190;201503;3020;10703;2534;9403;573;2377;809;2817;1382;5194
313200;201503;1292;4214;1146;3959;163;651;793;2716;956;3367
313210;201503;4475;13746;3718;12707;831;3289;1894;6228;2725;9517
313220;201503;1317;3962;968;3209;263;987;239;683;502;1670
313230;201503;2321;8319;2143;8054;331;1337;1458;5512;1789;6849
313240;201503;7688;24268;6268;21779;1512;6026;2504;8442;4016;14468
313250;201503;7169;22601;6374;21294;1034;3604;3826;13013;4860;16617
313260;201503;607;1829;468;1550;84;323;127;388;211;711
313270;201503;5468;16154;4720;14986;763;2602;3001;9552;3764;12154
313280;201503;438;1448;333;1208;56;246;88;273;144;519
313290;201503;927;3274;766;2984;241;1047;179;630;420;1677
313300;201503;1887;6357;1575;5602;464;1819;257;801;721;2620
313310;201503;1124;3891;993;3615;251;1036;189;616;440;1652
313320;201503;2451;7181;1906;6294;372;1363;842;2784;1214;4147
313330;201503;3805;12188;3212;11119;613;2454;1746;5956;2359;8410
313340;201503;2036;4931;1588;4290;316;860;887;2369;1203;3229
313350;201503;3247;10015;2530;8510;570;2145;505;1525;1075;3670
313360;201503;1226;3608;927;3101;262;1038;436;1348;698;2386
313370;201503;1207;4086;1128;3874;178;748;596;1900;774;2648
313375;201503;2201;5755;1487;4686;304;1196;519;1582;823;2778
313380;201503;4940;15714;4096;13966;1103;4216;1380;4423;2483;8639
313390;201503;893;3173;855;3124;98;419;602;2190;700;2609
313400;201503;3605;10219;3276;9843;280;840;2733;8370;3013;9210
313410;201503;1256;3582;1053;3302;220;770;623;1934;843;2704
313420;201503;20363;48524;12521;35253;2551;8112;2630;7111;5181;15223
313430;201503;1106;3462;862;2956;183;758;350;1105;533;1863
313440;201503;6264;14291;4294;11996;357;1094;2979;8350;3336;9444
313450;201503;681;1995;546;1721;121;471;193;547;314;1018
313460;201503;2287;7964;2034;7543;597;2484;607;2131;1204;4615
313470;201503;3256;9162;3042;8924;268;678;2595;7794;2863;8472
313480;201503;1113;3191;857;2753;142;532;360;1088;502;1620
313490;201503;1510;4635;961;3701;349;1450;141;524;490;1974
313500;201503;393;1230;361;1163;68;261;182;552;250;813
313505;201503;8898;26689;8264;25965;356;706;7628;24648;7984;25354
313507;201503;1372;3871;1203;3640;193;670;775;2363;968;3033
313510;201503;15426;44527;13466;41804;2209;7021;8489;27107;10698;34128
313520;201503;15057;45759;12490;41412;1659;6359;7967;26129;9626;32488
313530;201503;592;1927;505;1768;70;290;198;646;268;936
313535;201503;2513;7497;2202;6962;207;711;1594;4997;1801;5708
313540;201503;1068;3362;830;2757;234;846;202;614;436;1460
313545;201503;1292;4782;1177;4534;171;848;754;2750;925;3598
313550;201503;1865;6026;1651;5600;426;1536;813;2684;1239;4220
313560;201503;2199;5370;1873;5005;258;634;1403;3892;1661;4526
313570;201503;825;2976;722;2783;258;1071;257;951;515;2022
313580;201503;5964;16893;4944;15502;808;2759;3258;10315;4066;13074
313590;201503;1031;2964;809;2696;392;1412;238;757;630;2169
313600;201503;4005;12108;3483;11295;555;1998;2188;7169;2743;9167
313610;201503;1028;3178;880;2881;191;686;412;1328;603;2014
313620;201503;5974;18779;5219;17421;1562;5618;1822;5978;3384;11596
313630;201503;8100;23347;6330;20685;1347;5002;2795;9467;4142;14469
313640;201503;831;2484;651;2207;198;751;213;696;411;1447
313650;201503;2111;6899;1855;6486;224;909;1348;4685;1572;5594
313652;201503;1003;3602;917;3434;159;651;558;2084;717;2735
313655;201503;937;3066;783;2803;137;590;462;1602;599;2192
313657;201503;1283;3965;1106;3702;133;613;797;2439;930;3052
313660;201503;855;2853;779;2719;171;712;380;1242;551;1954
313665;201503;3310;10904;3045;10338;661;2558;1483;4867;2144;7425
313670;201503;50653;142862;34762;115752;9383;34667;10295;33471;19678;68138
313680;201503;1092;3313;953;3094;137;474;651;2116;788;2590
313690;201503;888;3189;787;2967;220;877;289;1094;509;1971
313695;201503;1353;4488;1179;4175;130;516;819;2936;949;3452
313700;201503;3821;12709;3220;11917;549;2110;2169;8237;2718;10347
313710;201503;1250;3408;989;3016;242;803;479;1424;721;2227
313720;201503;5198;16952;4297;15058;959;3778;1388;4464;2347;8242
313730;201503;1339;3549;1002;3133;197;687;550;1705;747;2392
313740;201503;2127;7610;1786;6782;585;2529;216;735;801;3264
313750;201503;2417;7329;2046;6640;580;2063;649;1940;1229;4003
313753;201503;1817;5387;1461;4776;407;1491;556;1787;963;3278
313760;201503;4467;14450;3704;12927;1080;4143;1047;3411;2127;7554
313770;201503;3472;11499;3177;10969;1084;4045;1112;3668;2196;7713
313780;201503;3652;10169;2879;9024;515;1958;1379;4223;1894;6181
313790;201503;510;1748;487;1712;108;378;273;999;381;1377
313800;201503;1192;3326;1036;3085;133;452;684;2042;817;2494
313810;201503;1480;4378;1432;4312;71;218;1262;3849;1333;4067
313820;201503;12680;34265;10446;30734;1856;6423;5288;15200;7144;21623
313830;201503;416;1401;355;1273;98;399;107;383;205;782
313835;201503;914;3064;860;2983;173;675;514;1731;687;2406
313840;201503;7745;22259;6055;19388;1595;5747;1776;5504;3371;11251
313850;201503;1236;3389;1092;3142;241;825;564;1516;805;2341
313860;201503;2815;8551;2213;7266;569;2081;510;1567;1079;3648
313862;201503;1186;2970;780;2294;140;411;314;944;454;1355
313865;201503;2263;6997;2048;6668;251;936;1479;4788;1730;5724
313867;201503;1106;3753;947;3435;325;1265;325;1206;650;2471
313868;201503;1588;5581;1407;5204;143;655;962;3537;1105;4192
313870;201503;855;2700;775;2571;235;918;248;716;483;1634
313880;201503;1657;5136;1473;4915;272;1124;917;2890;1189;4014
313890;201503;1859;5122;1564;4726;241;721;1040;3244;1281;3965
313900;201503;4114;15148;3796;14406;1231;5293;1168;4253;2399;9546
313910;201503;773;2604;660;2378;245;964;102;339;347;1303
313920;201503;3482;11383;3031;10602;479;1775;1855;6665;2334;8440
313925;201503;1917;5146;1391;4153;103;346;906;2699;1009;3045
313930;201503;5181;17164;4357;15679;769;2991;2451;9025;3220;12016
313940;201503;8208;27641;6931;25617;2259;9178;2458;9406;4717;18584
313950;201503;4181;12117;3370;10809;995;3714;1283;3804;2278;7518
313960;201503;5777;14994;4285;12976;1325;4455;1218;3476;2543;7931
313970;201503;1430;4103;1223;3868;156;541;815;2686;971;3227
313980;201503;1247;3954;995;3505;290;1186;371;1289;661;2475
313990;201503;1889;7055;1640;6473;542;2363;386;1386;928;3749
314000;201503;7567;24924;6925;23712;1464;6002;4087;13457;5551;19459
314010;201503;1089;3123;904;2892;134;523;566;1753;700;2276
314015;201503;1261;4546;1117;4256;342;1415;383;1417;725;2832
314020;201503;525;1632;408;1384;105;409;99;306;204;715
314030;201503;869;2814;693;2416;116;456;261;895;377;1351
314040;201503;685;1946;577;1759;264;828;196;605;460;1433
314050;201503;1806;5644;1438;4899;353;1388;472;1456;825;2844
314053;201503;1494;4844;1359;4685;194;642;947;3427;1141;4069
314055;201503;2122;6468;1924;6178;104;406;1521;4949;1625;5355
314060;201503;1140;3521;919;3148;89;377;585;1975;674;2352
314070;201503;3809;11800;2929;10123;795;2978;708;2344;1503;5322
314080;201503;1917;5886;1285;4422;247;970;285;859;532;1829
314085;201503;1951;6648;1709;6314;506;2076;647;2353;1153;4429
314090;201503;3395;11578;2998;10814;887;3538;1083;3971;1970;7509
314100;201503;3369;8935;2868;8249;249;651;2344;6927;2593;7578
314110;201503;4251;13575;3731;12523;807;3177;1481;4557;2288;7734
314120;201503;1010;2476;534;1695;136;494;145;441;281;935
314130;201503;716;2072;382;1319;64;239;70;239;134;478
314140;201503;4996;15537;4255;14128;934;3335;1876;6206;2810;9541
314150;201503;1635;4467;1342;3987;240;822;678;1978;918;2800
314160;201503;2505;6603;1969;5894;141;456;1516;4749;1657;5205
314170;201503;1096;3311;896;2873;130;504;478;1464;608;1968
314180;201503;5804;18330;5039;17202;1273;4792;2346;8152;3619;12944
314190;201503;741;2160;594;1927;141;560;251;752;392;1312
314200;201503;2972;9429;2613;8784;327;1332;1763;5798;2090;7130
314210;201503;1948;5837;1736;5457;244;907;1089;3277;1333;4184
314220;201503;1712;5429;1366;4742;430;1688;316;955;746;2643
314225;201503;1302;3840;1154;3638;73;225;999;3210;1072;3435
314230;201503;654;2198;593;2085;150;590;249;842;399;1432
314240;201503;1145;3552;979;3305;149;474;664;2362;813;2836
314250;201503;553;1669;424;1397;94;358;146;427;240;785
314260;201503;1104;3942;1009;3736;288;1166;369;1329;657;2495
314270;201503;2828;9434;2503;8856;267;1073;1740;6224;2007;7297
314280;201503;3190;8958;2212;7087;579;2165;681;1872;1260;4037
314290;201503;4983;13862;4294;12776;1112;3594;2434;7106;3546;10700
314300;201503;1647;5513;1451;5082;417;1575;530;1783;947;3358
314310;201503;5522;16823;4730;15290;1473;5201;1480;4561;2953;9762
314315;201503;893;3471;826;3342;131;624;510;2080;641;2704
314320;201503;3111;8692;2311;7642;662;2450;1129;3769;1791;6219
314330;201503;52335;161435;46853;152684;13294;47472;18870;60695;32164;108167
314340;201503;2709;7500;1555;5181;371;1343;122;258;493;1601
314345;201503;1241;4224;1110;4016;301;1143;620;2261;921;3404
314350;201503;1404;4063;1126;3625;436;1543;309;957;745;2500
314360;201503;704;2217;470;1683;113;489;119;403;232;892
314370;201503;530;1852;488;1785;152;601;255;925;407;1526
314380;201503;1237;3718;870;3004;248;929;161;542;409;1471
314390;201503;14696;42660;11244;36211;2912;10313;2937;8765;5849;19078
314400;201503;4753;13810;3966;12712;1407;4689;1627;5405;3034;10094
314410;201503;2591;8229;2201;7445;632;2484;765;2412;1397;4896
314420;201503;749;2180;603;1980;59;262;438;1403;497;1665
314430;201503;6893;20587;6031;18946;1806;6203;1841;5833;3647;12036
314435;201503;1348;4326;1196;4061;149;650;757;2513;906;3163
314437;201503;1126;2942;971;2711;43;117;821;2299;864;2416
314440;201503;662;1917;499;1679;178;666;88;267;266;933
314450;201503;1591;4634;1350;4297;386;1452;648;1928;1034;3380
314460;201503;4352;14691;3621;13173;995;4016;708;2472;1703;6488
314465;201503;2354;7416;2157;7096;153;647;1659;5356;1812;6003
314467;201503;1111;3119;931;2798;107;320;626;1914;733;2234
314470;201503;2415;7760;1938;6710;473;1903;496;1489;969;3392
314480;201503;6186;20608;4311;15639;711;2821;470;1453;1181;4274
314490;201503;987;2902;789;2510;211;744;315;955;526;1699
314500;201503;2133;5960;1558;4973;434;1493;623;1914;1057;3407
314505;201503;1834;5580;1727;5411;316;1092;1082;3419;1398;4511
314510;201503;1924;5288;1309;4406;445;1658;323;1056;768;2714
314520;201503;3331;12175;2634;10471;665;3014;385;1278;1050;4292
314530;201503;6540;23249;6167;22638;1150;4272;3747;14190;4897;18462
314535;201503;2782;7815;2402;7293;229;806;1857;5615;2086;6421
314537;201503;1242;3867;975;3396;170;710;534;1823;704;2533
314540;201503;417;1272;357;1148;86;322;123;353;209;675
314545;201503;1355;4212;1175;3943;199;771;746;2476;945;3247
314550;201503;627;1740;471;1529;95;403;195;578;290;981
314560;201503;4932;17219;4254;15570;906;3727;1188;4161;2094;7888
314570;201503;298;892;228;742;65;227;103;323;168;550
314580;201503;510;1757;412;1533;107;469;81;280;188;749
314585;201503;845;2770;606;2256;148;637;167;602;315;1239
314587;201503;1857;5809;1634;5412;356;1137;798;2746;1154;3883
314590;201503;3447;11700;2429;8961;441;1803;289;935;730;2738
314600;201503;1994;6709;1586;5939;551;2310;307;1080;858;3390
314610;201503;7325;25302;6665;23791;1731;7005;2581;8645;4312;15650
314620;201503;1751;5079;1530;4797;175;498;1185;3818;1360;4316
314625;201503;1501;5122;1462;5074;147;528;1204;4208;1351;4736
314630;201503;4953;14735;4294;13702;393;1494;3200;10199;3593;11693
314640;201503;602;1670;468;1440;120;416;141;369;261;785
314650;201503;1178;3343;857;2789;169;664;335;981;504;1645
314655;201503;1625;4867;1262;4198;257;904;638;2140;895;3044
314660;201503;256;704;197;593;18;62;103;297;121;359
314670;201503;1567;4304;1245;3747;185;629;747;2250;932;2879
314675;201503;1814;5569;1549;5100;153;614;1064;3481;1217;4095
314690;201503;2536;8005;2103;7262;578;2337;583;1843;1161;4180
314700;201503;8631;30587;6735;26372;2243;9853;1276;4931;3519;14784
314710;201503;8911;27486;6227;21638;1311;5149;946;2995;2257;8144
314720;201503;2331;7710;1964;6944;491;1980;806;2792;1297;4772
314730;201503;2376;7087;1921;6438;583;2194;631;2023;1214;4217
314740;201503;2953;9539;2602;8880;625;2424;1068;3469;1693;5893
314750;201503;332;1057;283;948;46;181;141;451;187;632
314760;201503;1727;5828;1284;4720;256;1112;296;922;552;2034
314770;201503;1210;3797;741;2519;85;358;120;308;205;666
314780;201503;302;803;216;692;61;233;92;286;153;519
314790;201503;12360;36649;9194;31225;3774;14647;1366;4100;5140;18747
314795;201503;1622;4742;1378;4351;139;571;1026;3105;1165;3676
314800;201503;12384;36292;9156;29909;2778;9928;1424;4418;4202;14346
314810;201503;13033;38229;10176;33249;3099;11301;2334;7601;5433;18902
314820;201503;1018;2794;689;2283;195;725;230;715;425;1440
314830;201503;1763;5835;1512;5417;495;1956;605;2194;1100;4150
314840;201503;984;3612;811;3345;190;938;434;1745;624;2683
314850;201503;1967;5799;1606;5143;240;946;988;3052;1228;3998
314860;201503;3268;11033;2962;10522;604;2382;1764;6297;2368;8679
314870;201503;5499;17715;4874;16900;615;2464;3568;12456;4183;14920
314875;201503;1792;6057;1723;5958;301;1024;1311;4625;1612;5649
314880;201503;845;2360;733;2213;57;177;545;1695;602;1872
314890;201503;628;1884;434;1473;97;399;144;430;241;829
314900;201503;470;1453;377;1304;98;353;173;601;271;954
314910;201503;1586;5409;1336;4964;465;1948;380;1299;845;3247
314915;201503;2579;8093;2254;7620;208;851;1727;5754;1935;6605
314920;201503;593;1660;423;1402;72;284;217;665;289;949
314930;201503;4993;16869;4403;15612;1325;5142;1089;3781;2414;8923
314940;201503;404;1190;374;1138;87;296;203;577;290;873
314950;201503;336;1073;270;957;64;247;68;240;132;487
314960;201503;795;2492;616;2133;175;674;153;476;328;1150
314970;201503;559;1919;484;1786;128;548;129;455;257;1003
314980;201503;1786;5543;1518;5077;498;1869;184;536;682;2405
314990;201503;2744;8684;2135;7351;637;2539;405;1168;1042;3707
314995;201503;1627;5019;1445;4748;175;695;1004;3236;1179;3931
315000;201503;1061;3115;876;2812;149;572;522;1641;671;2213
315010;201503;463;1451;373;1262;106;427;130;379;236;806
315015;201503;2014;6202;1798;5943;248;833;1321;4546;1569;5379
315020;201503;802;2512;608;2079;107;418;289;953;396;1371
315030;201503;757;2271;613;2005;199;717;154;483;353;1200
315040;201503;884;2795;836;2694;151;518;531;1686;682;2204
315050;201503;1495;4339;1191;3841;296;1099;458;1431;754;2530
315053;201503;1081;3244;959;3045;189;752;428;1328;617;2080
315057;201503;1907;6415;1573;5903;280;1063;913;3575;1193;4638
315060;201503;902;2950;668;2433;161;654;149;544;310;1198
315070;201503;743;2216;655;2097;180;649;347;1070;527;1719
315080;201503;3060;10438;2717;9719;645;2540;1331;4709;1976;7249
315090;201503;773;2788;692;2622;170;706;250;971;420;1677
315100;201503;1201;4074;898;3368;217;938;205;688;422;1626
315110;201503;1407;4379;1245;4062;305;1112;555;1774;860;2886
315120;201503;14390;33728;9794;27837;1630;4886;5145;15410;6775;20296
315130;201503;1503;4935;1343;4626;385;1495;408;1344;793;2839
315140;201503;2780;9212;2357;8329;638;2628;778;2453;1416;5081
315150;201503;4951;13406;3708;11344;806;2831;1390;4098;2196;6929
315160;201503;1312;3745;1115;3398;215;711;581;1705;796;2416
315170;201503;1445;4253;1209;3913;209;715;658;2325;867;3040
315180;201503;15817;45904;10207;34005;2110;8085;2029;6242;4139;14327
315190;201503;2158;5791;1825;5300;498;1537;921;2683;1419;4220
315200;201503;4219;14109;3471;12464;1010;4039;904;3096;1914;7135
315210;201503;8111;23868;6500;20672;1612;5689;2228;6808;3840;12497
315213;201503;1103;3582;1047;3508;67;202;917;3141;984;3343
315217;201503;2633;8976;2194;8232;321;1423;1286;4834;1607;6257
315220;201503;9986;29011;8369;26573;2283;7143;4246;14109;6529;21252
315230;201503;2697;7224;2417;6888;207;335;1994;6182;2201;6517
315240;201503;3104;9763;2727;9177;553;2041;1648;5467;2201;7508
315250;201503;9794;30136;7222;25222;1981;7800;2193;7610;4174;15410
315260;201503;982;3106;728;2550;202;800;139;422;341;1222
315270;201503;695;2335;566;2061;135;552;145;489;280;1041
315280;201503;3124;9249;2240;7318;569;2030;481;1374;1050;3404
315290;201503;1372;3873;1028;3319;366;1296;169;523;535;1819
315300;201503;477;1293;356;1148;177;597;115;371;292;968
315310;201503;1278;4163;1091;3826;140;570;708;2414;848;2984
315320;201503;846;2670;687;2459;152;616;326;1210;478;1826
315330;201503;691;2496;433;1802;123;563;42;189;165;752
315340;201503;3962;11412;3256;10319;732;2600;1413;4423;2145;7023
315350;201503;1778;4978;1341;4346;252;849;767;2570;1019;3419
315360;201503;1679;5561;1371;4789;273;1045;459;1484;732;2529
315370;201503;472;1399;403;1295;69;259;270;857;339;1116
315380;201503;217;750;172;642;47;199;34;111;81;310
315390;201503;1402;4834;1139;4223;328;1374;232;792;560;2166
315400;201503;4264;12933;3570;11633;779;2843;1686;5368;2465;8211
315410;201503;1922;5178;1625;4742;243;877;1027;2917;1270;3794
315415;201503;1132;3755;1042;3625;392;1381;446;1630;838;3011
315420;201503;1234;3971;939;3364;254;976;163;565;417;1541
315430;201503;3907;10586;2884;8879;733;2576;752;2202;1485;4778
315440;201503;907;2841;780;2623;142;556;413;1375;555;1931
315445;201503;2117;5959;1721;5397;174;683;1286;3973;1460;4656
315450;201503;2397;7710;2183;7387;480;1573;1352;4765;1832;6338
315460;201503;36190;119048;32203;110817;10592;39218;7321;24219;17913;63437
315470;201503;525;1568;441;1426;58;232;252;786;310;1018
315480;201503;1683;5160;1070;3748;204;812;183;606;387;1418
315490;201503;3120;8538;2471;7627;363;1333;1264;3814;1627;5147
315500;201503;478;1452;315;1073;58;243;113;317;171;560
315510;201503;1446;4121;1237;3802;73;252;953;2929;1026;3181
315520;201503;1113;3321;889;3019;131;516;568;1878;699;2394
315530;201503;534;1862;482;1741;210;812;154;528;364;1340
315540;201503;1189;3694;981;3346;195;812;363;1210;558;2022
315550;201503;1738;4927;1364;4420;455;1675;456;1430;911;3105
315560;201503;6709;22221;6059;21340;682;2760;4301;15260;4983;18020
315570;201503;2095;6598;1939;6361;437;1616;1037;3349;1474;4965
315580;201503;2539;7534;2013;6590;493;1931;727;2200;1220;4131
315590;201503;943;2729;841;2576;146;508;494;1467;640;1975
315600;201503;2554;9052;2095;8212;369;1522;1162;4776;1531;6298
315610;201503;1011;2920;823;2529;165;646;305;786;470;1432
315620;201503;312;1099;294;1066;84;288;159;609;243;897
315630;201503;910;2870;772;2625;190;699;223;740;413;1439
315640;201503;615;1785;501;1589;114;426;220;640;334;1066
315645;201503;857;2707;742;2449;282;1015;182;579;464;1594
315650;201503;1910;5329;1593;4879;110;467;1205;3632;1315;4099
315660;201503;2591;6871;2203;6271;473;1377;1260;3600;1733;4977
315670;201503;10350;34960;9193;32726;2862;11071;3087;10756;5949;21827
315680;201503;3024;10349;2421;9126;910;3590;488;1904;1398;5494
315690;201503;3569;10214;2552;8423;713;2643;596;2005;1309;4648
315700;201503;7267;22795;6178;20635;1197;4608;2985;9556;4182;14164
315710;201503;1971;5680;1573;5057;178;699;985;3136;1163;3835
315720;201503;3313;10499;2969;9859;672;2668;1502;4700;2174;7368
315725;201503;1707;5143;1380;4710;405;1420;698;2432;1103;3852
315727;201503;624;1929;525;1731;124;452;227;727;351;1179
315730;201503;880;2707;797;2560;146;514;468;1487;614;2001
315733;201503;940;2907;845;2726;310;1085;254;778;564;1863
315737;201503;1335;4113;1060;3612;97;388;688;2380;785;2768
315740;201503;1070;3327;904;3000;174;710;477;1491;651;2201
315750;201503;1121;3517;1032;3369;88;350;775;2494;863;2844
315760;201503;1002;2759;964;2711;21;63;902;2544;923;2607
315765;201503;1426;4480;1312;4313;97;350;1048;3480;1145;3830
315770;201503;1605;5185;1424;4835;368;1399;451;1453;819;2852
315780;201503;23351;76325;21270;71948;6290;22910;6260;21018;12550;43928
315790;201503;3406;11533;3018;10746;383;1319;1999;7359;2382;8678
315800;201503;1538;5936;1256;5112;315;1449;257;1001;572;2450
315810;201503;1411;3999;1211;3684;166;518;805;2426;971;2944
315820;201503;2687;9097;2381;8574;743;2762;1065;3958;1808;6720
315830;201503;1240;4190;1060;3788;192;842;296;910;488;1752
315840;201503;829;2166;602;1772;94;306;210;568;304;874
315850;201503;1194;4275;1149;4179;287;1095;511;1807;798;2902
315860;201503;501;1753;391;1536;104;481;75;280;179;761
315870;201503;478;1435;406;1327;116;424;135;400;251;824
315880;201503;1117;3010;926;2770;214;765;360;1007;574;1772
315890;201503;1554;5304;1376;5025;501;1923;626;2301;1127;4224
315895;201503;5084;15728;4621;14819;1078;3887;2090;6502;3168;10389
315900;201503;737;2314;708;2257;105;435;500;1469;605;1904
315910;201503;539;1850;503;1785;173;653;266;923;439;1576
315920;201503;1580;4438;988;3194;244;882;216;612;460;1494
315930;201503;1098;3019;865;2615;217;726;279;816;496;1542
315935;201503;1067;3561;966;3341;276;1045;306;1037;582;2082
315940;201503;669;2118;589;1955;162;610;245;777;407;1387
315950;201503;1165;3575;1061;3394;218;675;674;2207;892;2882
315960;201503;2926;9547;2143;8011;998;4275;106;282;1104;4557
315970;201503;781;2161;614;1926;58;163;457;1504;515;1667
315980;201503;4329;10494;2693;7764;697;2311;701;1709;1398;4020
315990;201503;3967;11665;3399;10776;633;2432;1880;5842;2513;8274
316000;201503;545;1679;471;1573;161;634;173;547;334;1181
316010;201503;536;1839;455;1687;95;422;161;525;256;947
316020;201503;1112;3594;925;3290;155;653;532;1889;687;2542
316030;201503;3558;10283;2633;8698;338;1243;1389;4746;1727;5989
316040;201503;3674;11611;2720;9559;448;1845;402;1081;850;2926
316045;201503;2130;6800;1950;6506;267;814;1405;4928;1672;5742
316050;201503;350;1102;278;988;57;222;161;555;218;777
316060;201503;745;2225;596;2001;97;424;338;1063;435;1487
316070;201503;5890;18906;5106;17121;1260;4773;2118;6756;3378;11529
316080;201503;732;2705;661;2531;157;674;116;458;273;1132
316090;201503;623;1823;420;1381;84;314;111;329;195;643
316095;201503;1419;4557;1233;4222;255;881;728;2547;983;3428
316100;201503;2811;9324;2127;7606;554;2275;389;1261;943;3536
316105;201503;957;2686;718;2292;193;682;268;862;461;1544
316110;201503;12039;41863;10812;39687;1410;5698;7366;27672;8776;33370
316120;201503;1196;3923;985;3403;270;998;312;1010;582;2008
316130;201503;1437;3181;875;2411;141;457;470;1238;611;1695
316140;201503;1054;3103;816;2715;120;435;463;1565;583;2000
316150;201503;1467;4238;1359;4051;269;942;802;2380;1071;3322
316160;201503;1246;3716;972;3180;161;623;452;1452;613;2075
316165;201503;968;2609;803;2366;145;508;487;1413;632;1921
316170;201503;1403;4025;1056;3430;202;741;445;1356;647;2097
316180;201503;1370;4344;989;3509;262;1061;223;696;485;1757
316190;201503;2805;8750;1444;5119;292;1088;189;570;481;1658
316200;201503;4027;12957;3107;11129;777;3225;856;2966;1633;6191
316210;201503;4912;15650;4228;14406;1819;6591;793;2601;2612;9192
316220;201503;749;2328;535;1914;127;541;67;242;194;783
316225;201503;1177;3368;1025;3144;142;520;696;2068;838;2588
316230;201503;456;1302;358;1137;61;212;179;597;240;809
316240;201503;6775;20770;5824;19540;599;2090;4509;15363;5108;17453
316245;201503;3170;11045;2938;10666;231;1116;2323;8299;2554;9415
316250;201503;9826;29892;8228;26670;2629;9342;2390;7309;5019;16651
316255;201503;2581;7886;2273;7511;364;1228;1588;5304;1952;6532
316257;201503;1394;3932;1075;3362;222;778;405;1205;627;1983
316260;201503;1783;5084;1368;4461;166;605;815;2773;981;3378
316265;201503;1317;3670;957;2941;106;410;551;1604;657;2014
316270;201503;4344;14390;3984;13651;1009;3749;1832;6203;2841;9952
316280;201503;3267;10730;2943;10107;520;1997;1696;5813;2216;7810
316290;201503;3194;10147;2744;9286;582;2350;1201;3822;1783;6172
316292;201503;3355;10898;3019;10322;715;2718;1476;4785;2191;7503
316294;201503;871;2808;606;2201;128;554;66;223;194;777
316295;201503;1777;6099;1651;5851;309;1348;948;3131;1257;4479
316300;201503;1010;3109;858;2852;73;258;591;2001;664;2259
316310;201503;647;1975;488;1670;92;356;154;512;246;868
316320;201503;578;1841;469;1662;91;374;107;362;198;736
316330;201503;956;2946;756;2501;109;391;465;1530;574;1921
316340;201503;995;3213;830;2878;224;926;304;955;528;1881
316350;201503;1379;4407;1234;4169;222;764;686;2391;908;3155
316360;201503;743;1934;581;1706;58;180;435;1284;493;1464
316370;201503;4376;14363;3821;13259;1149;4390;759;2612;1908;7002
316380;201503;1549;4233;1253;3815;105;360;897;2747;1002;3107
316390;201503;884;2626;738;2371;220;791;306;983;526;1774
316400;201503;1330;4257;1073;3800;252;963;454;1575;706;2538
316410;201503;1097;3695;1024;3583;191;723;637;2239;828;2962
316420;201503;1887;6296;1693;6037;190;857;1167;4055;1357;4912
316430;201503;923;2835;716;2436;186;713;240;750;426;1463
316440;201503;683;2203;561;2022;217;899;136;465;353;1364
316443;201503;716;2108;585;1858;141;496;230;690;371;1186
316447;201503;1578;4839;1443;4650;100;312;1254;4094;1354;4406
316450;201503;2133;7333;1858;6815;305;1235;1194;4447;1499;5682
316460;201503;733;2309;673;2211;159;588;402;1251;561;1839
316470;201503;7569;24456;5962;20978;1583;6531;1777;5964;3360;12495
316480;201503;214;728;191;689;48;189;60;200;108;389
316490;201503;285;908;257;832;58;205;125;380;183;585
316500;201503;1097;4002;764;2978;150;636;32;117;182;753
316510;201503;845;3100;749;2903;267;1093;171;639;438;1732
316520;201503;1169;3554;965;3257;199;760;378;1143;577;1903
316530;201503;1122;3657;943;3290;227;998;347;1014;574;2012
316540;201503;1002;3260;901;3092;204;861;348;1101;552;1962
316550;201503;1216;4093;1138;3963;224;876;730;2533;954;3409
316553;201503;1967;6946;1575;6023;467;1961;376;1412;843;3373
316555;201503;2926;10031;2541;9601;207;762;2053;7951;2260;8713
316556;201503;603;1654;481;1440;43;164;350;1006;393;1170
316557;201503;747;2736;716;2690;323;1301;176;610;499;1911
316560;201503;345;1191;296;1090;67;303;71;223;138;526
316570;201503;1360;4329;1191;3987;182;667;632;2117;814;2784
316580;201503;277;801;201;642;54;210;58;163;112;373
316590;201503;1510;4163;1120;3520;186;694;655;1957;841;2651
316600;201503;1008;3246;881;2990;293;1060;257;850;550;1910
316610;201503;591;2145;515;1993;109;471;308;1183;417;1654
316620;201503;2136;6640;1831;6067;364;1381;1033;3328;1397;4709
316630;201503;1536;5114;1328;4665;548;2023;370;1314;918;3337
316640;201503;191;611;166;556;31;137;69;198;100;335
316650;201503;912;3486;806;3315;186;780;445;1939;631;2719
316660;201503;203;528;108;326;11;44;36;92;47;136
316670;201503;1831;5353;1466;4678;566;1998;330;964;896;2962
316680;201503;1902;5285;1559;4803;167;523;1206;3768;1373;4291
316690;201503;1192;4006;1069;3754;337;1356;397;1351;734;2707
316695;201503;1127;3580;984;3303;76;275;694;2372;770;2647
316700;201503;359;1122;324;1062;64;262;178;521;242;783
316710;201503;3414;12928;2986;12001;1046;4482;859;3648;1905;8130
316720;201503;17154;56148;14358;50150;4412;16615;3146;10551;7558;27166
316730;201503;366;1129;316;1024;71;281;179;528;250;809
316740;201503;668;2247;593;2106;204;811;182;608;386;1419
316750;201503;422;1442;371;1330;86;359;128;429;214;788
316760;201503;3391;11444;2909;10854;1707;6431;813;3192;2520;9623
316770;201503;1285;3762;1159;3592;170;609;802;2464;972;3073
316780;201503;592;2014;521;1872;164;675;132;417;296;1092
316790;201503;872;2517;641;2122;176;634;198;656;374;1290
316800;201503;6011;19899;5453;18864;1125;4502;2703;8906;3828;13408
316805;201503;840;2276;789;2207;100;263;636;1856;736;2119
316810;201503;587;1827;513;1676;161;584;221;695;382;1279
316820;201503;387;1018;232;746;61;235;42;122;103;357
316830;201503;598;2083;569;2028;188;740;238;815;426;1555
316840;201503;2985;9066;2608;8381;676;2485;1047;3189;1723;5674
316850;201503;2110;6433;1862;6002;331;1193;1097;3548;1428;4741
316860;201503;18876;60005;16299;55188;4084;15878;6926;22405;11010;38283
316870;201503;6303;20483;5301;18182;1621;6093;953;3104;2574;9197
316880;201503;791;2569;729;2460;235;908;266;846;501;1754
316890;201503;1333;3305;1052;2934;334;1073;514;1352;848;2425
316900;201503;2501;7735;2047;6796;526;2042;717;2143;1243;4185
316905;201503;456;1528;398;1402;143;527;133;466;276;993
316910;201503;747;2507;573;2134;134;527;158;608;292;1135
316920;201503;1680;4944;1348;4457;308;1131;520;1677;828;2808
316930;201503;8938;30553;7314;26960;1880;7750;1233;4151;3113;11901
316935;201503;4979;14651;3321;11306;918;3586;636;1959;1554;5545
316940;201503;7086;23392;5889;20859;1465;5714;1460;4962;2925;10676
316950;201503;1475;4335;1309;4093;150;581;928;2883;1078;3464
316960;201503;5115;12933;4073;11600;786;2466;2334;6613;3120;9079
316970;201503;3413;10935;3213;10621;955;3640;1119;3402;2074;7042
316980;201503;1057;3145;761;2635;304;1184;182;630;486;1814
316990;201503;9411;30622;8038;27441;2881;10752;879;2845;3760;13597
317000;201503;2772;9509;2678;9404;150;452;2166;8440;2316;8892
317005;201503;2539;7908;2285;7561;360;1196;1559;5274;1919;6470
317010;201503;30638;77353;18967;58680;4844;16870;4338;13946;9182;30816
317020;201503;56403;159880;35083;115590;8016;29380;8058;24637;16074;54017
317030;201503;807;2282;657;2046;82;325;401;1207;483;1532
317040;201503;10264;30244;8358;26816;2236;7881;3313;10543;5549;18424
317043;201503;753;2138;669;2035;96;281;463;1450;559;1731
317047;201503;1163;3074;851;2556;139;478;398;1179;537;1657
317050;201503;1557;5362;1243;4617;255;1093;532;1864;787;2957
317052;201503;2462;7851;2170;7412;204;818;1674;5711;1878;6529
317057;201503;1742;4911;1348;4231;152;593;764;2316;916;2909
317060;201503;397;1168;294;938;63;241;94;259;157;500
317065;201503;1242;4153;1130;3970;129;539;870;3030;999;3569
317070;201503;9374;29803;6737;23849;1634;6549;1257;4446;2891;10995
317075;201503;1128;3426;938;3063;267;976;312;933;579;1909
317080;201503;6188;17359;5335;15910;1535;4911;1914;5537;3449;10448
317090;201503;4933;16513;4583;15931;671;2387;3195;11328;3866;13715
317100;201503;3143;8880;2496;7778;761;2645;962;2826;1723;5471
317103;201503;2027;7052;1711;6412;335;1557;791;2890;1126;4447
317107;201503;1367;4200;1166;3784;220;857;673;2036;893;2893
317110;201503;663;1700;402;1230;90;335;164;461;254;796
317115;201503;1155;3674;1003;3353;148;509;638;2162;786;2671
317120;201503;11466;38152;9417;33289;2513;9947;3332;11371;5845;21318
317130;201503;7714;23439;6642;21539;1456;5406;3071;9789;4527;15195
317140;201503;607;2059;577;2001;63;239;410;1434;473;1673
317150;201503;1004;2809;867;2650;84;302;657;1998;741;2300
317160;201503;3487;9427;2680;8366;265;935;1918;5956;2183;6891
317170;201503;1794;5041;1505;4576;100;409;1006;2881;1106;3290
317180;201503;1872;6270;1496;5464;419;1662;430;1522;849;3184
317190;201503;1395;4011;1138;3661;137;461;803;2592;940;3053
317200;201503;4618;14713;4068;13621;1159;4310;1355;4325;2514;8635
317210;201503;1060;3222;874;2963;187;744;473;1592;660;2336
317220;201503;307;1080;296;1067;84;316;169;619;253;935
320010;201503;5453;17141;4761;15642;873;3049;2383;7844;3256;10893
320013;201503;2033;5981;1429;4826;213;759;719;2492;932;3251
320016;201503;3291;9323;2850;8675;400;1173;2030;6289;2430;7462
320020;201503;3925;12281;3399;11225;1053;3806;1223;3970;2276;7776
320030;201503;1609;5145;1294;4450;395;1451;453;1508;848;2959
320035;201503;1807;5369;1612;5082;429;1534;838;2488;1267;4022
320040;201503;3335;11084;2715;9654;667;2618;745;2521;1412;5139
320050;201503;1822;4942;1577;4506;259;829;971;2697;1230;3526
320060;201503;12138;38314;9437;32123;2314;8693;3018;9672;5332;18365
320070;201503;1580;5147;1302;4485;332;1285;308;919;640;2204
320080;201503;5337;15380;4128;12932;1176;3933;1208;3745;2384;7678
320090;201503;8474;24664;6705;21117;1802;6097;2776;8406;4578;14503
320100;201503;3093;9345;2521;8225;587;2046;1178;3791;1765;5837
320110;201503;1388;4182;1232;3883;300;1001;454;1403;754;2404
320115;201503;1809;6445;1646;6144;864;3374;458;1724;1322;5098
320120;201503;16289;51085;13043;44693;3801;14202;3739;12885;7540;27087
320130;201503;36583;118674;33414;112155;7744;29118;15497;50250;23241;79368
320140;201503;4103;13049;2915;10268;714;2807;288;927;1002;3734
320150;201503;17140;47428;12374;38432;3237;11067;2107;6297;5344;17364
320160;201503;5090;15771;4373;14435;1141;4259;1649;5016;2790;9275
320170;201503;1734;5636;1426;4932;397;1449;514;1799;911;3248
320180;201503;819;2672;717;2502;302;1099;218;775;520;1874
320190;201503;3845;13133;3053;11209;908;3551;857;3086;1765;6637
320200;201503;1078;3398;922;3117;234;849;386;1343;620;2192
320210;201503;5121;14325;4431;13074;933;3158;2322;6496;3255;9654
320220;201503;2842;8510;2203;7371;592;2184;861;2912;1453;5096
320225;201503;1479;5111;1212;4449;426;1689;236;881;662;2570
320230;201503;4215;13785;3738;12989;1245;4688;1305;4561;2550;9249
320240;201503;11625;34571;9031;29750;2566;9215;2319;7625;4885;16840
320245;201503;3854;13115;3582;12474;1188;4434;1154;3852;2342;8286
320250;201503;1746;5372;1255;4241;305;1173;273;802;578;1975
320255;201503;1875;6254;1604;5789;643;2516;588;2195;1231;4711
320260;201503;1066;3286;819;2694;215;796;204;554;419;1350
320265;201503;2493;7757;2169;7338;351;1236;1468;5123;1819;6359
320270;201503;2746;8269;2055;6881;507;1844;866;2846;1373;4690
320280;201503;6987;21249;6231;19816;1403;4968;2810;8557;4213;13525
320290;201503;1489;4893;1114;3946;375;1408;213;709;588;2117
320300;201503;4525;15127;4088;14162;1292;4790;1156;3949;2448;8739
320305;201503;4487;14529;3973;13359;966;3579;1861;6057;2827;9636
320310;201503;1993;5969;1718;5438;447;1524;720;2209;1167;3733
320313;201503;2280;6770;1587;5164;380;1477;286;801;666;2278
320316;201503;1907;5789;1593;5144;496;1688;631;1960;1127;3648
320320;201503;19727;61895;16223;55230;4599;17378;5839;19421;10438;36799
320330;201503;3200;9540;2760;8806;571;1773;1571;5261;2142;7034
320332;201503;4991;16842;4430;15803;1537;5843;1560;5678;3097;11521
320334;201503;1749;5700;1251;4580;391;1608;241;813;632;2421
320335;201503;2304;6836;1512;5021;437;1615;267;787;704;2402
320340;201503;5806;15949;4639;13949;1032;3416;2106;6274;3138;9690
320350;201503;5345;14281;4005;11843;923;2966;1539;4458;2462;7424
320360;201503;1729;4597;1286;3744;219;717;598;1619;817;2336
320370;201503;3321;10736;2692;9342;806;2897;964;3305;1770;6202
320380;201503;2484;7331;2185;6797;319;1123;1406;4287;1725;5410
320390;201503;7471;22537;6109;19717;1914;6860;1813;5463;3727;12323
320400;201503;4080;11837;3390;10798;1005;3621;1355;3985;2360;7606
320405;201503;3897;11536;3488;10955;1002;3455;1841;5615;2843;9070
320410;201503;5685;14604;4183;12738;891;2908;2280;6969;3171;9877
320420;201503;1699;5234;1241;4415;389;1518;221;783;610;2301
320425;201503;2061;5494;1744;4985;263;846;1073;3020;1336;3866
320430;201503;2283;6569;2013;6044;441;1434;1055;3073;1496;4507
320435;201503;2709;9044;2303;8201;1075;3991;667;2498;1742;6489
320440;201503;1213;4037;1076;3669;272;1033;376;1207;648;2240
320450;201503;2063;6462;1699;5718;478;1783;732;2350;1210;4133
320455;201503;4414;14813;3218;11814;975;3807;794;2868;1769;6675
320460;201503;2947;9310;2279;7916;599;2287;793;2625;1392;4912
320465;201503;1692;5298;1325;4452;293;1072;503;1624;796;2696
320470;201503;4373;13396;3116;10512;890;3308;479;1421;1369;4729
320480;201503;2031;6094;1710;5491;418;1558;696;2116;1114;3674
320490;201503;16033;49760;13309;44454;4272;15450;3900;13092;8172;28542
320495;201503;1216;3767;900;3052;350;1234;133;492;483;1726
320500;201503;46020;141046;39966;129803;10775;38177;18300;58107;29075;96284
320501;201503;4225;13435;3741;12666;1170;4457;1546;5056;2716;9513
320503;201503;1851;6319;1508;5535;517;2107;413;1322;930;3429
320506;201503;3673;11549;2507;8619;772;2832;206;626;978;3458
320510;201503;8130;25517;6954;23135;1875;6833;2964;9604;4839;16437
320515;201503;2078;5909;1741;5217;482;1515;536;1538;1018;3053
320517;201503;2192;7085;1784;6243;671;2558;399;1283;1070;3841
320520;201503;34938;107147;28766;95301;8186;30063;10670;34876;18856;64939
320530;201503;28356;86519;23634;77304;5411;20524;10964;33692;16375;54216
330010;201503;19641;60507;17847;56958;3444;12249;10510;32665;13954;44914
330015;201503;1808;5031;1549;4563;284;997;638;1795;922;2792
330020;201503;16880;49982;15421;47657;3226;10949;9001;27283;12227;38232
330022;201503;1725;5360;1499;4985;283;1111;826;2650;1109;3761
330023;201503;3156;10087;2918;9609;769;2775;1115;3466;1884;6241
330025;201503;4006;11117;3330;10102;776;2622;1859;5505;2635;8127
330030;201503;8120;27303;7178;25339;1751;6923;3278;11032;5029;17955
330040;201503;12778;36859;10985;33779;2580;8547;5525;16539;8105;25086
330045;201503;66616;187767;59468;177413;7632;24709;41512;122601;49144;147310
330050;201503;2664;8343;2368;7762;757;2797;716;2152;1473;4949
330060;201503;5647;16620;4970;15629;1146;4048;2794;8842;3940;12890
330070;201503;23325;71098;20766;66656;4844;16995;9750;30994;14594;47989
330080;201503;8318;23736;7795;22956;1133;3332;5354;15995;6487;19327
330090;201503;2764;7611;2529;7220;503;1607;1373;3818;1876;5425
330093;201503;1996;5910;1650;5233;382;1292;569;1749;951;3041
330095;201503;1064;3609;953;3368;308;1261;199;611;507;1872
330100;201503;55084;176988;50293;168766;9794;36999;26793;90216;36587;127215
330110;201503;2387;7602;2149;7169;583;2159;751;2449;1334;4608
330115;201503;2123;6180;1919;5852;440;1528;977;2872;1417;4400
330120;201503;2430;6942;2182;6602;619;2083;1054;3068;1673;5151
330130;201503;3600;11677;3200;10960;870;3271;1448;4898;2318;8169
330140;201503;3099;9596;2814;9171;699;2494;1446;4726;2145;7220
330150;201503;2563;7558;1975;6372;459;1624;481;1507;940;3131
330160;201503;1131;3858;1044;3692;337;1333;410;1374;747;2707
330170;201503;108277;326564;100768;314900;16292;54741;67415;210348;83707;265089
330180;201503;1917;5749;1655;5268;186;760;1057;3161;1243;3921
330185;201503;7665;24274;6813;22628;1576;5685;3565;11711;5141;17396
330187;201503;3836;11077;3328;10238;485;1723;2259;6814;2744;8537
330190;201503;26594;77034;24883;74297;5029;15904;15682;46378;20711;62282
330200;201503;13751;43782;12342;41235;2929;10169;6462;21853;9391;32022
330205;201503;2422;6564;2107;6033;435;1414;1142;3156;1577;4570
330210;201503;4379;11608;3299;9629;977;3073;802;2281;1779;5354
330220;201503;10356;31869;9195;29362;2598;9063;2706;8057;5304;17120
330225;201503;3972;12466;3713;12082;346;1353;2812;9298;3158;10651
330227;201503;18147;51536;16219;48720;4152;13098;8559;25650;12711;38748
330230;201503;1435;4287;1301;4054;344;1214;542;1576;886;2790
330240;201503;17452;54653;15295;50408;5510;19855;3133;9753;8643;29608
330245;201503;1269;3982;1038;3539;276;1029;237;810;513;1839
330250;201503;35731;104608;32778;99711;9610;29882;14865;45981;24475;75863
330260;201503;3715;11659;3239;10663;676;2518;1430;4395;2106;6913
330270;201503;14649;40179;11687;35828;3290;10957;4296;13094;7586;24051
330280;201503;2094;6419;1781;5785;344;1230;827;2526;1171;3756
330285;201503;18585;53958;16929;51590;2997;9928;10900;33091;13897;43019
330290;201503;3561;9940;3153;9358;563;1930;1940;5541;2503;7471
330300;201503;3523;11455;3236;10943;513;1980;1958;6526;2471;8506
330310;201503;2441;6982;2154;6497;386;1232;1191;3562;1577;4794
330320;201503;13664;40766;12821;39503;2009;6779;9090;27813;11099;34592
330330;201503;28836;81473;25862;76789;4651;15503;16304;47194;20955;62697
330340;201503;14287;42697;11440;37253;3296;11477;3306;10654;6602;22131
330350;201503;88177;270654;83415;263619;12801;41526;60614;193094;73415;234620
330360;201503;5577;17106;5435;16911;391;1358;4659;14450;5050;15808
330370;201503;3564;12832;3292;12233;1195;4694;1084;4069;2279;8763
330380;201503;4819;15531;4133;14224;937;3558;1955;6582;2892;10140
330385;201503;4068;14050;3757;13445;1253;4772;1418;5038;2671;9810
330390;201503;22740;75618;20520;71166;4784;18648;10001;33867;14785;52515
330395;201503;2983;8842;2713;8384;321;1194;1835;5527;2156;6721
330400;201503;2449;7973;2226;7580;383;1574;1258;3961;1641;5535
330410;201503;2936;9215;2509;8409;490;1787;1308;4369;1798;6156
330411;201503;2321;7281;2025;6646;291;1187;1158;3577;1449;4764
330412;201503;1342;4577;1094;4102;264;1143;429;1512;693;2655
330414;201503;26090;72995;22430;68104;3993;12434;14410;44161;18403;56595
330415;201503;3618;11068;3151;10237;832;2857;1327;4346;2159;7203
330420;201503;9387;28185;6620;22799;1750;6615;1106;3699;2856;10314
330430;201503;7803;23111;7039;21737;1542;5248;3620;10955;5162;16203
330440;201503;1942;6492;1651;5878;534;2145;361;1127;895;3272
330450;201503;1416;4760;1287;4536;330;1377;659;2257;989;3634
330452;201503;12806;38288;10220;33206;2793;9998;3697;11558;6490;21556
330455;201503;475663;1344735;399851;1224222;98598;321565;198028;603238;296626;924803
330460;201503;1283;4206;1162;3999;261;1050;575;1938;836;2988
330470;201503;4403;13580;3937;12710;1101;3953;1610;5009;2711;8962
330475;201503;7985;24996;7122;23519;2021;7347;3080;10045;5101;17392
330480;201503;6001;17821;5478;17052;1268;4310;2850;8725;4118;13035
330490;201503;102571;278968;93948;266677;9483;27987;73505;210126;82988;238113
330500;201503;5455;17001;5185;16505;702;2509;3604;11322;4306;13831
330510;201503;38493;120683;35419;115756;10856;36262;17270;57591;28126;93853
330513;201503;1531;4571;1396;4329;448;1407;556;1756;1004;3163
330515;201503;2991;9353;2677;8773;825;2854;934;3017;1759;5871
330520;201503;11823;35156;10585;32992;2319;7754;5342;16551;7661;24305
330530;201503;1528;4599;1361;4283;349;1188;591;1818;940;3006
330540;201503;3131;9351;2674;8568;679;2375;1111;3458;1790;5833
330550;201503;8216;27406;7223;25579;3133;11747;1454;5118;4587;16865
330555;201503;10397;30985;9293;29401;1741;5685;5854;18905;7595;24590
330560;201503;4266;12997;3929;12407;823;2937;2065;6294;2888;9231
330570;201503;3711;10710;3180;9860;828;2663;1602;5041;2430;7704
330575;201503;5321;15474;4760;14522;845;2936;2974;8692;3819;11628
330580;201503;15227;48019;13054;43606;3604;12817;5083;17101;8687;29918
330590;201503;1727;5291;1598;5071;343;1179;963;3021;1306;4200
330600;201503;10742;30734;8660;27417;1222;4690;5090;15598;6312;20288
330610;201503;9084;28886;8370;27602;1701;6378;4619;15029;6320;21407
330615;201503;1660;5871;1506;5510;658;2542;394;1496;1052;4038
330620;201503;3750;12982;3413;12362;1209;4732;934;3460;2143;8192
330630;201503;22281;67325;18600;60657;3856;14411;9571;29813;13427;44224
350010;201503;2267;6817;1618;5491;412;1547;275;796;687;2343
350020;201503;503;1349;350;1058;71;241;173;501;244;742
350030;201503;4291;13498;3401;11620;1287;4856;752;2286;2039;7142
350040;201503;510;1755;402;1502;107;457;97;304;204;761
350050;201503;1123;3443;910;3050;204;795;322;1000;526;1795
350055;201503;580;1809;539;1741;126;471;307;936;433;1407
350060;201503;99;322;85;296;27;110;32;99;59;209
350070;201503;2849;9188;2144;7596;495;1941;395;1204;890;3145
350075;201503;521;1763;433;1615;132;550;120;413;252;963
350080;201503;557;1587;412;1310;74;263;178;555;252;818
350090;201503;555;1540;399;1266;89;306;123;354;212;660
350100;201503;1906;6117;1391;4979;356;1434;364;1192;720;2626
350110;201503;463;1375;346;1111;58;211;151;450;209;661
350115;201503;1290;4043;1142;3706;227;877;587;1715;814;2592
350120;201503;579;1539;292;918;63;221;48;135;111;356
350130;201503;3370;9989;3021;9309;554;1966;1552;4445;2106;6411
350140;201503;621;1991;543;1851;120;479;243;784;363;1263
350150;201503;398;1335;356;1243;121;449;101;346;222;795
350160;201503;6923;21399;5198;17698;1446;5515;1976;6102;3422;11617
350170;201503;1822;6301;1589;5726;470;1838;379;1268;849;3106
350180;201503;1245;3336;882;2588;199;596;380;1080;579;1676
350190;201503;3198;10184;2692;9189;618;2558;1402;4381;2020;6939
350200;201503;316;1028;279;964;63;241;114;394;177;635
350210;201503;6353;16885;4611;13965;1330;4524;1622;4629;2952;9153
350220;201503;2655;8338;2377;7848;708;2742;853;2516;1561;5258
350230;201503;722;2409;667;2317;184;710;258;886;442;1596
350240;201503;435;1370;405;1319;79;288;263;822;342;1110
350250;201503;2208;8061;2104;7856;798;3189;752;2768;1550;5957
350260;201503;996;2646;711;2153;131;427;336;986;467;1413
350270;201503;5224;15986;4535;14549;881;3029;2133;6744;3014;9773
350275;201503;1961;6492;1756;6153;473;1818;667;2177;1140;3995
350280;201503;21646;54700;13760;40891;3087;9922;3209;9411;6296;19333
350290;201503;1590;5242;1292;4594;316;1240;306;1030;622;2270
350300;201503;409;1252;357;1155;74;255;175;550;249;805
350310;201503;895;2985;792;2745;141;555;359;1209;500;1764
350315;201503;545;1703;443;1493;78;345;144;435;222;780
350320;201503;12147;38090;10506;34759;2941;10400;1588;5355;4529;15755
350330;201503;13598;39187;9125;28570;1957;6334;3168;9271;5125;15605
350335;201503;345;1075;308;1004;49;155;185;609;234;764
350340;201503;1113;3346;806;2739;180;708;260;820;440;1528
350350;201503;769;2434;679;2291;160;637;249;836;409;1473
350360;201503;765;2606;646;2349;178;679;221;827;399;1506
350370;201503;707;2146;518;1717;100;371;101;293;201;664
350380;201503;3421;10646;2708;9476;932;3611;679;2168;1611;5779
350390;201503;8594;27146;7618;25333;2182;7687;3232;10459;5414;18146
350395;201503;329;944;183;641;32;130;41;137;73;267
350400;201503;7619;21744;6130;19091;1469;5130;2505;7434;3974;12564
350410;201503;7724;26865;6292;23669;1856;7735;1238;4391;3094;12126
350420;201503;570;1657;390;1324;83;339;43;109;126;448
350430;201503;747;2340;616;2106;136;557;300;975;436;1532
350440;201503;1249;3961;1153;3777;319;1114;566;1796;885;2910
350450;201503;7573;22576;5870;19213;1508;5394;1464;4465;2972;9859
350460;201503;1418;4008;960;3059;216;777;288;810;504;1587
350470;201503;252;692;204;611;41;155;107;291;148;446
350480;201503;788;2432;538;1860;78;300;88;259;166;559
350490;201503;2066;6026;1767;5607;476;1742;772;2263;1248;4005
350500;201503;579;1707;498;1585;123;414;216;665;339;1079
350510;201503;1005;3142;789;2643;157;620;294;885;451;1505
350520;201503;989;3619;790;3168;204;941;177;641;381;1582
350530;201503;2430;7208;1989;6291;625;2156;549;1566;1174;3722
350535;201503;1374;4220;1296;4078;81;347;1054;3237;1135;3584
350540;201503;1946;5469;1573;4804;447;1470;556;1681;1003;3151
350550;201503;11824;31910;8197;25817;1754;6316;3111;9334;4865;15650
350560;201503;3517;11582;3174;10882;543;2002;1671;5806;2214;7808
350570;201503;19060;64365;17198;60244;5120;19379;6318;21198;11438;40577
350580;201503;1702;5328;1235;4250;268;1028;185;537;453;1565
350590;201503;4012;12476;3017;10420;840;3251;996;3119;1836;6370
350600;201503;40046;98855;27020;77428;4381;13781;13473;37038;17854;50819
350610;201503;8063;23247;6241;20077;1349;4965;2829;8743;4178;13708
350620;201503;418;1201;324;1058;67;265;158;483;225;748
350630;201503;1670;5020;1295;4295;339;1317;303;858;642;2175
350635;201503;5451;16752;4220;14449;1107;4054;1597;5425;2704;9479
350640;201503;642;2061;500;1702;112;407;131;420;243;827
350650;201503;6824;20826;3746;13238;968;3798;340;1193;1308;4991
350660;201503;4083;12591;3543;11664;788;2872;1899;6114;2687;8986
350670;201503;1778;5515;1663;5305;320;1135;1038;3196;1358;4331
350680;201503;1146;3513;906;3024;223;888;373;1197;596;2085
350690;201503;917;3022;755;2693;194;760;231;767;425;1527
350700;201503;2800;9521;2452;8754;933;3598;791;2558;1724;6156
350710;201503;2415;7606;2178;7222;313;1146;1458;4804;1771;5950
350715;201503;910;2768;798;2573;235;876;281;799;516;1675
350720;201503;141;423;128;400;37;128;46;129;83;257
350730;201503;423;1566;403;1513;118;491;147;524;265;1015
350740;201503;2029;6287;1647;5426;344;1273;729;2256;1073;3529
350745;201503;382;1161;291;951;46;177;137;397;183;574
350750;201503;10165;30650;7884;26138;1972;7249;1916;5901;3888;13150
350760;201503;12244;37264;10461;33966;2757;9997;4326;13303;7083;23300
350770;201503;751;2116;504;1629;78;293;229;700;307;993
350775;201503;541;1520;448;1369;80;291;251;732;331;1023
350780;201503;2162;6564;1631;5471;466;1718;227;716;693;2434
350790;201503;1991;6274;1518;5322;420;1600;352;1085;772;2685
350800;201503;3023;10074;2842;9772;501;2006;1793;6011;2294;8017
350810;201503;2208;6376;1807;5727;563;1939;641;1968;1204;3907
350820;201503;558;1504;405;1197;74;267;178;474;252;741
350830;201503;890;2778;622;2146;91;342;135;385;226;727
350840;201503;2356;8373;1938;7346;590;2473;364;1170;954;3643
350850;201503;6395;21289;5320;18870;1748;6583;1241;4218;2989;10801
350860;201503;3151;9979;3017;9789;282;1127;2404;7724;2686;8851
350870;201503;2530;8235;2163;7665;584;2297;1240;4415;1824;6712
350880;201503;1365;4494;1139;4023;301;1148;257;890;558;2038
350890;201503;657;1888;454;1452;81;311;106;257;187;568
350900;201503;4442;14817;3580;12838;971;3802;718;2367;1689;6169
350910;201503;828;2495;734;2302;253;849;263;770;516;1619
350920;201503;9744;28326;8886;26868;1367;4546;5984;17584;7351;22130
350925;201503;4628;14175;3892;12695;994;3521;1595;4829;2589;8350
350930;201503;1578;4303;1293;3821;143;496;900;2585;1043;3081
350940;201503;2081;6854;1908;6586;359;1476;1186;3947;1545;5423
350945;201503;854;2817;741;2581;134;559;362;1174;496;1733
350950;201503;66403;205931;54446;181602;13671;50216;21989;70269;35660;120485
350960;201503;4726;16016;4070;14619;708;2983;2347;8069;3055;11052
350970;201503;4366;15217;3741;13724;1232;4943;930;3077;2162;8020
350980;201503;603;1989;542;1884;228;847;182;634;410;1481
350990;201503;1728;5977;1487;5506;491;1960;408;1460;899;3420
350995;201503;789;2718;752;2648;129;579;456;1519;585;2098
351000;201503;3402;10168;2880;9179;394;1431;1568;4838;1962;6269
351010;201503;374;1097;258;846;86;315;77;251;163;566
351015;201503;865;2886;743;2659;218;861;310;1084;528;1945
351020;201503;7917;25253;6944;23740;1770;6516;3355;11599;5125;18115
351030;201503;1585;5674;1451;5381;362;1596;551;1882;913;3478
351040;201503;3370;10376;3082;9871;532;1994;1946;5951;2478;7945
351050;201503;11045;33870;8490;29036;2496;9392;2638;8838;5134;18230
351060;201503;33101;99851;27094;88702;6849;24508;10879;34680;17728;59188
351070;201503;1695;4747;1180;3825;362;1291;198;521;560;1812
351080;201503;2740;8030;2132;7267;551;2128;987;3240;1538;5368
351090;201503;388;1321;309;1160;71;308;72;266;143;574
351100;201503;1839;5667;1486;4961;470;1630;484;1654;954;3284
351110;201503;8068;20478;4437;14264;1073;3901;1067;3129;2140;7030
351120;201503;609;1773;490;1532;64;235;258;714;322;949
351130;201503;963;2700;522;1790;90;373;107;328;197;701
351140;201503;1750;6082;1578;5708;516;2111;468;1589;984;3700
351150;201503;1808;6163;1356;4990;277;1132;312;997;589;2129
351160;201503;1381;4723;1234;4391;337;1350;454;1521;791;2871
351170;201503;1529;4960;1234;4295;256;968;535;1734;791;2702
351190;201503;757;2430;630;2120;139;499;134;409;273;908
351200;201503;2210;6485;1846;5771;415;1494;700;1995;1115;3489
351210;201503;1036;3135;808;2665;198;742;274;805;472;1547
351220;201503;3196;10681;2825;9917;597;2349;1385;4766;1982;7115
351230;201503;1747;5539;1513;5127;303;1209;874;2873;1177;4082
351240;201503;1050;3329;777;2713;215;830;190;565;405;1395
351250;201503;915;2614;649;2069;134;465;255;765;389;1230
351260;201503;957;2796;838;2544;183;623;361;1029;544;1652
351270;201503;373;1295;339;1231;90;380;135;440;225;820
351280;201503;5291;15667;3961;12787;936;3216;1318;3917;2254;7133
351290;201503;1026;2959;791;2498;196;651;299;880;495;1531
351300;201503;11399;38690;8847;33018;2378;9812;2825;10358;5203;20170
351310;201503;3231;9904;2648;8857;530;2122;1320;4081;1850;6203
351320;201503;911;3110;791;2846;215;875;223;685;438;1560
351330;201503;292;815;245;735;106;322;59;173;165;495
351340;201503;6014;20289;5313;18900;1478;5659;2268;8001;3746;13660
351350;201503;7063;22893;6157;20966;1849;6654;2000;6412;3849;13066
351360;201503;4165;13049;3847;12459;934;3380;1679;5170;2613;8550
351370;201503;2272;7086;1823;6166;483;1846;629;1961;1112;3807
351380;201503;36054;107924;32814;101792;6667;22738;15082;45190;21749;67928
351385;201503;191;594;179;572;40;131;99;306;139;437
351390;201503;1164;3791;994;3448;316;1247;379;1187;695;2434
351400;201503;953;3151;890;3003;348;1223;309;1044;657;2267
351410;201503;2772;8375;2461;7835;450;1555;1400;4324;1850;5879
351420;201503;394;1143;268;890;63;223;63;206;126;429
351430;201503;840;2632;766;2506;80;272;583;1920;663;2192
351440;201503;3870;11486;3022;9642;840;2814;589;1656;1429;4470
351450;201503;1635;4597;1385;4259;365;1174;648;2079;1013;3253
351460;201503;781;2389;658;2173;311;1070;188;598;499;1668
351470;201503;1049;3159;921;2910;274;963;335;1021;609;1984
351480;201503;2794;9154;2550;8750;510;2168;1329;4336;1839;6504
351490;201503;1877;6268;1675;5841;238;1017;999;3330;1237;4347
351492;201503;201;634;150;512;24;97;73;238;97;335
351495;201503;147;483;119;414;32;126;34;107;66;233
351500;201503;21681;64408;17356;56187;4882;17453;6728;20841;11610;38294
351510;201503;8148;26057;6889;23528;1677;6221;3357;11313;5034;17534
351512;201503;420;1216;345;1072;63;204;188;599;251;803
351515;201503;2321;7279;1717;5985;460;1718;469;1520;929;3238
351518;201503;1900;6133;1316;5044;344;1508;311;1093;655;2601
351519;201503;788;2384;632;2057;136;544;253;689;389;1233
351520;201503;815;2240;415;1458;69;281;63;199;132;480
351530;201503;375;1146;284;945;36;133;93;264;129;397
351535;201503;2342;6136;1878;5485;193;673;1307;3743;1500;4416
351540;201503;1795;5555;1495;5011;552;2045;257;803;809;2848
351550;201503;4581;13355;3320;10849;754;2822;1187;3751;1941;6573
351560;201503;395;1245;335;1111;77;289;67;214;144;503
351565;201503;206;679;188;632;46;186;82;249;128;435
351570;201503;11553;36068;9966;32893;2477;8820;5114;16447;7591;25267
351580;201503;359;976;240;724;55;167;71;202;126;369
351590;201503;430;1181;325;984;57;196;108;297;165;493
351600;201503;1655;4556;1463;4255;221;755;800;2203;1021;2958
351610;201503;661;1813;508;1545;71;261;239;671;310;932
351620;201503;18808;60544;14455;51547;3459;13764;3505;10946;6964;24710
351630;201503;17629;57346;16150;54904;3837;13728;9321;31666;13158;45394
351640;201503;9941;31456;8355;28630;1821;6886;4417;14844;6238;21730
351650;201503;421;1248;212;705;46;160;35;108;81;268
351660;201503;758;2396;565;1916;132;475;153;468;285;943
351670;201503;3923;12140;3239;10677;584;2273;1590;4884;2174;7157
351680;201503;693;2117;447;1515;96;338;89;290;185;628
351685;201503;442;1315;360;1177;91;304;158;526;249;830
351690;201503;1073;3145;737;2375;163;586;205;560;368;1146
351700;201503;1257;3636;1099;3344;313;971;452;1366;765;2337
351710;201503;652;2109;541;1867;113;405;199;633;312;1038
351720;201503;1633;4998;1134;3752;215;768;375;1116;590;1884
351730;201503;1018;2929;830;2675;297;1106;294;891;591;1997
351740;201503;4120;11319;3316;9737;739;2331;1151;3194;1890;5525
351750;201503;1201;3843;884;3095;225;908;303;955;528;1863
351760;201503;3749;11795;3174;10540;838;2988;1223;3847;2061;6835
351770;201503;2289;7087;1916;6452;542;1966;919;2993;1461;4959
351780;201503;1530;4291;930;2949;192;669;242;721;434;1390
351790;201503;1075;3206;944;3016;315;1031;410;1324;725;2355
351800;201503;418;941;308;792;42;113;171;432;213;545
351810;201503;1086;3131;997;3020;187;645;694;2064;881;2709
351820;201503;2087;6611;1657;5800;525;1941;188;635;713;2576
351830;201503;4059;12823;3205;10835;583;2229;1571;5032;2154;7261
351840;201503;7442;24835;6474;22944;1872;7182;2296;7923;4168;15105
351850;201503;1560;4672;1202;3981;225;914;489;1424;714;2338
351860;201503;3372;10740;2992;9961;819;2961;1323;4180;2142;7141
351870;201503;30796;93550;26892;86536;6776;23395;13483;42847;20259;66242
351880;201503;109046;349623;95347;321011;28772;102718;28824;95064;57596;197782
351885;201503;545;1971;506;1885;144;575;235;835;379;1410
351890;201503;693;2093;538;1766;133;481;133;397;266;878
351900;201503;1296;3966;1109;3672;307;1093;407;1340;714;2433
351905;201503;444;1453;376;1338;68;304;209;695;277;999
351907;201503;16348;49676;13893;45166;2351;8928;7945;24833;10296;33761
351910;201503;955;2941;864;2795;184;695;432;1333;616;2028
351920;201503;1043;2876;924;2691;136;467;598;1681;734;2148
351925;201503;929;2844;826;2649;127;476;455;1349;582;1825
351930;201503;2699;8897;2522;8545;581;2384;1473;4556;2054;6940
351940;201503;901;2657;805;2494;169;567;491;1477;660;2044
351950;201503;1399;3845;999;3095;142;478;528;1580;670;2058
351960;201503;4144;12225;3095;10326;776;2855;1366;4422;2142;7277
351970;201503;5509;20042;4890;18765;1544;6363;1691;6355;3235;12718
351980;201503;900;2671;703;2294;140;520;293;832;433;1352
351990;201503;1533;4358;1219;3756;307;1118;298;773;605;1891
352000;201503;2340;7541;2136;7139;539;1966;983;3111;1522;5077
352010;201503;1903;6400;1673;5867;450;1725;402;1360;852;3085
352020;201503;1405;4472;1223;4103;322;1184;447;1421;769;2605
352030;201503;4807;14291;4010;13117;979;3392;2163;7174;3142;10566
352040;201503;1933;6477;1610;5737;364;1442;406;1307;770;2749
352042;201503;2840;8077;1952;6134;417;1454;939;2866;1356;4320
352044;201503;1427;4790;1112;4031;251;1000;202;643;453;1643
352050;201503;7555;24184;5265;19080;1513;6131;996;3041;2509;9172
352060;201503;775;2257;670;2085;164;616;284;797;448;1413
352070;201503;662;1839;597;1738;197;604;238;693;435;1297
352080;201503;466;1326;341;1098;67;248;138;402;205;650
352090;201503;1706;5552;1362;4806;316;1237;316;969;632;2206
352100;201503;2404;7360;1744;6090;446;1748;572;1817;1018;3565
352110;201503;500;1803;438;1663;127;523;163;589;290;1112
352115;201503;405;1303;347;1183;73;280;153;489;226;769
352120;201503;911;2787;778;2571;146;556;423;1359;569;1915
352130;201503;1861;5309;1302;4208;364;1234;420;1264;784;2498
352140;201503;1592;4823;1068;3657;207;756;458;1518;665;2274
352150;201503;726;2216;567;1911;145;506;249;818;394;1324
352160;201503;1085;3004;902;2681;184;593;403;1108;587;1701
352170;201503;2751;8311;2478;7783;553;1940;1323;3924;1876;5864
352180;201503;3460;9832;2929;8861;753;2505;1146;3254;1899;5759
352190;201503;1139;3454;1023;3241;204;747;502;1469;706;2216
352200;201503;400;1386;334;1258;52;222;194;742;246;964
352210;201503;16789;44893;13381;39949;2453;7699;7995;24386;10448;32085
352215;201503;558;1747;512;1686;74;288;307;1000;381;1288
352220;201503;12536;41159;11260;38599;3668;13536;3708;12425;7376;25961
352230;201503;12962;43858;11255;40613;3361;13292;4306;15157;7667;28449
352240;201503;11635;34953;9492;31130;2992;11053;3396;10438;6388;21491
352250;201503;22704;73048;20016;67646;5679;20709;7380;24649;13059;45358
352260;201503;5368;15347;3343;11133;649;2458;1164;3613;1813;6071
352265;201503;879;2804;750;2589;94;425;461;1502;555;1927
352270;201503;2093;7104;1754;6350;532;2023;417;1435;949;3458
352280;201503;2370;7241;1952;6518;486;1872;670;2123;1156;3995
352290;201503;1174;3714;1015;3377;240;940;345;1008;585;1948
352300;201503;910;2700;731;2376;191;692;314;957;505;1649
352310;201503;35200;109517;30561;101776;7834;27989;17215;57033;25049;85022
352320;201503;5737;17632;4974;16207;1478;5248;1620;4777;3098;10025
352330;201503;1898;6210;1654;5870;583;2199;524;1842;1107;4041
352340;201503;5609;18799;4523;16331;1306;5102;829;2723;2135;7825
352350;201503;1517;5384;1365;5051;308;1269;519;1833;827;3102
352360;201503;1092;3427;957;3162;202;825;586;1813;788;2638
352370;201503;892;3046;814;2881;157;659;405;1370;562;2029
352380;201503;957;3029;837;2823;286;1119;234;737;520;1856
352390;201503;17670;48884;11852;37627;2255;8280;5530;16322;7785;24602
352400;201503;3772;10584;2372;7881;587;2103;736;2257;1323;4360
352410;201503;3554;10619;2905;9501;892;3127;918;2889;1810;6016
352420;201503;987;2810;879;2627;257;869;431;1230;688;2099
352430;201503;6139;19076;5315;17736;1877;6865;1724;5610;3601;12475
352440;201503;15365;47258;12443;41601;3228;11584;4497;14734;7725;26318
352450;201503;673;1974;449;1534;109;419;101;305;210;724
352460;201503;2364;7788;2023;7159;656;2586;558;1823;1214;4409
352470;201503;4502;12426;2658;8597;469;1694;916;2773;1385;4467
352480;201503;4871;13374;3817;11452;775;2740;1576;4330;2351;7070
352490;201503;713;2492;583;2167;114;488;136;461;250;949
352500;201503;7621;23229;7012;22263;3324;11589;2047;5604;5371;17193
352510;201503;3119;10169;2509;8915;839;3279;581;1970;1420;5249
352520;201503;2159;7540;1915;6968;473;1870;930;3303;1403;5173
352530;201503;7590;24457;5684;20163;1630;6272;843;2666;2473;8938
352540;201503;487;1543;372;1291;56;236;108;351;164;587
352550;201503;888;2968;609;2270;155;659;103;336;258;995
352560;201503;673;2001;500;1635;96;333;174;502;270;835
352570;201503;1675;5524;1248;4505;274;1144;271;852;545;1996
352580;201503;877;2578;747;2363;184;658;377;1131;561;1789
352585;201503;218;711;171;614;63;237;32;122;95;359
352590;201503;10981;34784;9554;31975;2266;8329;4966;15968;7232;24297
352600;201503;1615;4959;1439;4631;410;1450;627;1910;1037;3360
352610;201503;3299;10103;2772;9191;862;3182;847;2594;1709;5776
352620;201503;5100;15885;4781;15468;989;3484;3100;9989;4089;13473
352630;201503;657;2134;617;2034;151;569;290;918;441;1487
352640;201503;2878;8953;2346;7814;373;1427;1163;3739;1536;5166
352650;201503;832;2436;626;2002;134;455;200;601;334;1056
352660;201503;1017;3461;795;2934;178;736;182;617;360;1353
352670;201503;10498;31945;6386;22627;1689;6446;913;3009;2602;9455
352680;201503;3184;10898;2484;9247;568;2370;672;2211;1240;4581
352690;201503;29586;82925;20548;64441;4099;14222;9267;27831;13366;42053
352700;201503;769;2311;632;2099;191;725;284;890;475;1615
352710;201503;5660;16590;4240;13745;1055;3836;1548;4789;2603;8625
352720;201503;7644;24900;6966;23494;2100;7331;2598;8678;4698;16009
352725;201503;416;1176;258;847;38;151;98;295;136;446
352730;201503;2283;7646;2017;6940;442;1681;692;2123;1134;3804
352740;201503;1871;5361;1529;4780;292;1109;890;2612;1182;3721
352750;201503;395;1160;244;811;48;180;62;173;110;353
352760;201503;1066;3711;950;3463;282;1113;426;1468;708;2581
352770;201503;709;2189;616;2011;141;530;290;906;431;1436
352780;201503;631;2091;531;1871;115;468;168;529;283;997
352790;201503;632;1808;463;1496;95;329;114;357;209;686
352800;201503;961;3463;704;2749;169;734;173;549;342;1283
352810;201503;1134;2951;761;2239;140;488;246;676;386;1164
352820;201503;596;1738;471;1549;159;565;100;321;259;886
352830;201503;499;1408;350;1102;72;257;59;149;131;406
352840;201503;3829;13176;3384;12223;1053;4048;1020;3649;2073;7697
352850;201503;8794;27674;7572;25545;1980;7171;2825;9393;4805;16564
352860;201503;835;2725;755;2541;208;768;252;768;460;1536
352870;201503;1001;2485;743;2005;77;286;445;1092;522;1378
352880;201503;2251;6496;1671;5263;364;1213;525;1536;889;2749
352885;201503;252;841;238;810;43;167;130;416;173;583
352890;201503;710;1912;537;1566;96;337;251;649;347;986
352900;201503;19017;55779;13962;45474;3090;11052;5370;16571;8460;27623
352910;201503;260;829;198;696;52;202;27;86;79;288
352920;201503;2527;7579;2033;6648;533;1977;794;2338;1327;4315
352930;201503;5857;18447;4681;15834;1295;4732;1034;3304;2329;8036
352940;201503;25425;84324;21750;75727;7602;28006;3639;11965;11241;39971
352950;201503;340;1035;227;800;61;256;55;159;116;415
352960;201503;622;1919;413;1435;68;272;65;210;133;482
352965;201503;308;893;249;783;64;229;45;125;109;354
352970;201503;3009;7798;2541;7133;331;988;1751;4969;2082;5957
352980;201503;1388;4120;1165;3768;288;959;609;2073;897;3032
352990;201503;3862;12424;3436;11668;1017;3876;1304;4188;2321;8064
353000;201503;496;1369;304;942;54;178;53;140;107;318
353010;201503;2964;8310;2205;6834;539;1914;712;1990;1251;3904
353020;201503;4250;11681;2830;8598;414;1460;1142;3107;1556;4567
353030;201503;4158;12177;3461;10895;1008;3457;877;2556;1885;6013
353040;201503;674;1925;572;1763;162;567;211;613;373;1180
353050;201503;5032;16890;4229;15249;1320;5218;1496;5058;2816;10276
353060;201503;33376;104343;31195;100914;3840;15107;22884;71371;26724;86478
353070;201503;9206;29888;6849;24662;1897;7331;1765;6283;3662;13614
353080;201503;4776;15554;3484;12639;900;3650;884;2894;1784;6544
353090;201503;527;1745;477;1643;54;242;266;849;320;1091
353100;201503;235;640;122;390;32;112;26;78;58;190
353110;201503;7279;22673;6454;21244;1554;5462;3510;11597;5064;17059
353120;201503;455;1493;381;1338;120;484;95;276;215;760
353130;201503;2624;7687;2190;7003;747;2640;772;2331;1519;4971
353140;201503;2382;6501;1827;5418;486;1571;691;1881;1177;3452
353150;201503;1745;5364;1438;4821;430;1577;396;1305;826;2882
353160;201503;629;1803;451;1432;125;402;75;202;200;604
353170;201503;466;1597;424;1525;125;526;184;634;309;1160
353180;201503;6485;19434;5387;17417;828;3034;3196;10101;4024;13135
353190;201503;3457;10779;2972;9711;589;2188;1479;4495;2068;6683
353200;201503;937;3157;772;2771;250;981;210;716;460;1697
353205;201503;493;1575;412;1403;88;305;162;550;250;855
353210;201503;964;2459;733;2057;37;140;537;1494;574;1634
353215;201503;474;1508;411;1367;70;271;140;417;210;688
353220;201503;696;2142;581;1892;128;442;177;543;305;985
353230;201503;968;3077;883;2928;230;846;255;774;485;1620
353240;201503;2040;6569;1840;6176;465;1764;902;2839;1367;4603
353250;201503;1076;2922;846;2518;157;501;385;1101;542;1602
353260;201503;892;2429;682;2082;116;419;325;930;441;1349
353270;201503;641;1926;553;1752;155;530;187;543;342;1073
353280;201503;594;1919;505;1741;140;530;142;478;282;1008
353282;201503;1605;5173;1527;5042;248;943;945;2981;1193;3924
353284;201503;326;906;204;649;42;133;59;189;101;322
353286;201503;145;420;101;321;25;82;14;44;39;126
353290;201503;506;1642;414;1476;116;457;194;655;310;1112
353300;201503;1512;4727;1281;4217;307;1159;484;1395;791;2554
353310;201503;218;659;189;603;54;194;74;208;128;402
353320;201503;510;1463;446;1355;88;296;243;715;331;1011
353325;201503;546;1831;453;1632;81;329;71;205;152;534
353330;201503;579;1666;387;1230;77;286;177;503;254;789
353340;201503;2799;8011;1914;6364;560;2018;734;2414;1294;4432
353350;201503;3137;9456;2659;8603;849;2961;1149;3575;1998;6536
353360;201503;389;1282;341;1176;54;225;205;674;259;899
353370;201503;635;2085;557;1893;78;301;324;1075;402;1376
353380;201503;333;1089;285;1005;65;284;125;396;190;680
353390;201503;5871;15831;4189;12821;845;2936;1584;4420;2429;7356
353400;201503;498;1486;408;1304;111;402;111;294;222;696
353410;201503;601;1759;493;1586;108;393;278;881;386;1274
353420;201503;570;1579;407;1209;107;315;133;369;240;684
353430;201503;2404;8300;1763;6534;447;1751;178;596;625;2347
353440;201503;58283;188181;50378;169965;14064;50102;17418;56911;31482;107013
353450;201503;443;1357;375;1223;90;336;160;499;250;835
353460;201503;3580;9981;3094;9165;478;1551;1587;4785;2065;6336
353470;201503;9337;28222;6778;23017;1558;5967;1696;5364;3254;11331
353475;201503;1649;4706;1144;3602;217;737;330;937;547;1674
353480;201503;1466;4369;1296;4051;245;860;751;2270;996;3130
353490;201503;1169;3245;914;2753;201;668;334;904;535;1572
353500;201503;928;2564;800;2342;252;773;334;950;586;1723
353510;201503;1079;3439;852;2856;192;728;251;700;443;1428
353520;201503;1123;3290;881;2868;212;777;335;1071;547;1848
353530;201503;2573;7633;2290;7123;433;1567;1219;3647;1652;5214
353540;201503;1972;5959;1729;5548;446;1535;755;2397;1201;3932
353550;201503;6147;17078;5329;15822;663;2388;3387;9591;4050;11979
353560;201503;2148;7089;1778;6416;455;1845;595;2069;1050;3914
353570;201503;425;1321;353;1167;56;208;219;682;275;890
353580;201503;2204;7005;2036;6724;422;1604;1272;4119;1694;5723
353590;201503;698;1996;545;1727;156;531;171;548;327;1079
353600;201503;1722;4855;1554;4572;250;833;875;2512;1125;3345
353610;201503;579;1940;444;1643;93;412;128;427;221;839
353620;201503;2195;7222;1884;6614;539;2041;602;1978;1141;4019
353625;201503;287;775;186;597;45;165;66;205;111;370
353630;201503;1649;5643;1259;4643;253;993;174;557;427;1550
353640;201503;1355;3895;1115;3400;185;568;584;1742;769;2310
353650;201503;6765;20381;5027;16681;1084;3888;1669;5261;2753;9149
353657;201503;321;1012;286;939;49;183;109;331;158;514
353660;201503;1257;3233;919;2676;371;1183;162;340;533;1523
353670;201503;3970;12844;3357;11507;1005;3927;1072;3295;2077;7222
353680;201503;645;2184;586;2075;259;988;209;718;468;1706
353690;201503;548;1444;335;1054;62;244;125;338;187;582
353700;201503;2174;6752;1882;6155;360;1305;737;2268;1097;3573
353710;201503;2954;7195;1336;4465;295;1042;275;880;570;1922
353715;201503;471;1368;361;1153;54;192;152;462;206;654
353720;201503;2023;6333;1755;5936;298;1155;1033;3431;1331;4586
353730;201503;4430;13556;3459;11447;779;2814;969;2901;1748;5715
353740;201503;2073;6210;1630;5308;488;1663;472;1508;960;3171
353750;201503;798;2688;618;2268;131;558;177;632;308;1190
353760;201503;8712;25349;7104;22743;1544;5469;3725;11785;5269;17254
353770;201503;801;2427;486;1666;98;364;41;64;139;428
353780;201503;4430;15244;3855;14117;1414;5512;1083;3980;2497;9492
353790;201503;1871;6554;1563;5909;444;1917;347;1252;791;3169
353800;201503;15006;47123;11895;41316;3198;12291;4512;15212;7710;27503
353810;201503;1063;3370;837;2889;191;741;297;979;488;1720
353820;201503;1209;4153;1107;3908;283;1188;527;1691;810;2879
353830;201503;758;2050;594;1766;107;345;272;797;379;1142
353850;201503;1616;5162;1475;4919;295;1081;740;2372;1035;3453
353860;201503;2377;7965;1980;7040;533;2036;544;1879;1077;3915
353870;201503;24541;74342;17946;60943;4043;15272;5677;17396;9720;32668
353880;201503;2439;7704;2051;7042;295;1248;1158;3882;1453;5130
353890;201503;2658;6589;1847;5278;380;1207;884;2394;1264;3601
353900;201503;1055;3303;779;2702;179;697;204;621;383;1318
353910;201503;1172;4289;1135;4212;321;1283;658;2384;979;3667
353920;201503;2314;6880;1671;5488;389;1369;286;810;675;2179
353930;201503;3821;12718;3004;11019;877;3450;674;2427;1551;5877
353940;201503;1259;3988;1022;3470;187;749;430;1326;617;2075
353950;201503;3460;10992;3154;10473;444;1744;2098;6752;2542;8496
353960;201503;599;1893;462;1590;97;382;116;335;213;717
353970;201503;545;1613;475;1516;40;151;355;1126;395;1277
353980;201503;13198;39683;11437;36425;2568;8808;5840;18280;8408;27088
353990;201503;409;1264;370;1179;78;298;150;424;228;722
354000;201503;1966;5676;1343;4455;286;1045;137;404;423;1449
354010;201503;361;1086;310;1002;91;304;144;476;235;780
354020;201503;4634;14176;4102;13008;1105;3874;1671;4886;2776;8760
354025;201503;897;2553;699;2217;167;572;200;610;367;1182
354030;201503;521;1423;370;1175;75;268;159;464;234;732
354040;201503;791;2146;602;1800;70;267;334;918;404;1185
354050;201503;964;3114;835;2862;267;1033;266;859;533;1892
354060;201503;5117;15909;3643;12666;907;3418;1268;4249;2175;7667
354070;201503;3052;10048;2648;9173;749;2816;561;1877;1310;4693
354075;201503;2098;7846;1987;7646;571;2451;919;3488;1490;5939
354080;201503;1697;5230;1221;4118;273;992;300;871;573;1863
354085;201503;301;776;271;729;20;76;216;557;236;633
354090;201503;1307;3872;1242;3769;133;444;930;2863;1063;3307
354100;201503;15741;52989;13267;48260;3396;13211;5958;21442;9354;34653
354105;201503;845;2623;738;2419;131;514;392;1202;523;1716
354110;201503;802;2266;653;2057;210;751;206;597;416;1348
354120;201503;1951;5400;1531;4620;298;1023;632;1741;930;2764
354130;201503;5784;16918;4623;14655;1876;6378;893;2454;2769;8832
354140;201503;25011;63671;15693;46594;3167;10292;5553;15247;8720;25539
354150;201503;4132;11201;3150;9462;654;2212;1475;4246;2129;6458
354160;201503;3650;11960;3130;10826;846;3199;1271;4241;2117;7440
354165;201503;360;1315;321;1219;101;430;95;351;196;781
354170;201503;1450;4516;1149;3825;223;848;433;1260;656;2108
354180;201503;494;1500;469;1458;66;259;282;793;348;1052
354190;201503;1444;4727;1221;4237;357;1377;394;1277;751;2654
354200;201503;1094;3109;891;2739;158;558;374;1025;532;1583
354210;201503;719;2385;625;2203;109;481;308;988;417;1469
354220;201503;2853;8539;2489;7846;661;2318;1097;3314;1758;5632
354230;201503;620;2051;571;1970;109;424;284;959;393;1383
354240;201503;1175;3862;890;3193;184;745;195;626;379;1371
354250;201503;654;1936;454;1581;183;709;122;409;305;1118
354260;201503;7696;23494;6929;22213;2024;7086;2666;8402;4690;15488
354270;201503;1136;3949;993;3624;262;1063;390;1423;652;2486
354280;201503;639;1957;595;1879;82;333;438;1316;520;1649
354290;201503;1043;3588;953;3413;241;945;364;1275;605;2220
354300;201503;3471;11706;3349;11482;889;3248;1734;5838;2623;9086
354310;201503;880;2773;673;2338;183;688;231;792;414;1480
354320;201503;766;2264;646;2032;163;582;214;604;377;1186
354323;201503;399;1130;311;964;70;244;108;299;178;543
354325;201503;1195;3990;1039;3617;219;883;417;1327;636;2210
354330;201503;6752;20688;5658;18530;1174;4350;2848;8804;4022;13154
354340;201503;26115;81772;21362;73252;6973;25958;7718;25652;14691;51610
354350;201503;1107;3291;1032;3156;274;925;532;1547;806;2472
354360;201503;438;1397;336;1196;59;223;28;93;87;316
354370;201503;1212;4091;1067;3802;146;649;659;2266;805;2915
354380;201503;1068;3169;849;2781;263;1028;134;335;397;1363
354390;201503;12017;37127;8672;30148;1987;7532;2055;6825;4042;14357
354400;201503;1598;5513;1308;4831;295;1187;404;1409;699;2596
354410;201503;5493;16853;4603;15318;949;3461;2323;7644;3272;11105
354420;201503;1253;3799;973;3179;254;915;366;1114;620;2029
354425;201503;2650;7477;2238;6736;710;2301;584;1674;1294;3975
354430;201503;1247;4089;1176;3964;298;1136;534;1731;832;2867
354440;201503;520;1538;398;1295;50;197;198;595;248;792
354450;201503;442;1270;256;865;39;162;57;168;96;330
354460;201503;835;2291;632;1951;198;663;247;737;445;1400
354470;201503;540;1529;425;1298;57;229;201;539;258;768
354480;201503;707;2009;607;1853;100;360;353;1028;453;1388
354490;201503;730;2419;575;2062;128;516;191;609;319;1125
354500;201503;2086;7030;1855;6597;718;2933;374;1184;1092;4117
354510;201503;711;2111;629;1965;107;344;390;1236;497;1580
354515;201503;315;1057;248;904;47;202;84;273;131;475
354520;201503;6663;22071;3983;14247;873;3601;1541;5149;2414;8750
354530;201503;2721;9588;2506;9161;682;2767;1213;4336;1895;7103
354540;201503;1241;3757;1023;3355;361;1325;191;552;552;1877
354550;201503;488;1524;419;1373;76;268;199;629;275;897
354560;201503;1490;4423;1100;3553;235;760;417;1297;652;2057
354570;201503;721;2160;527;1731;134;471;82;235;216;706
354580;201503;9967;28905;7920;25066;1629;5757;3484;10419;5113;16176
354600;201503;1571;5275;1392;4931;336;1431;666;2216;1002;3647
354610;201503;395;1136;251;807;37;112;52;143;89;255
354620;201503;386;1273;312;1139;86;377;131;441;217;818
354625;201503;271;905;216;786;48;192;58;199;106;391
354630;201503;1961;6619;1764;6190;818;2932;464;1551;1282;4483
354640;201503;3589;11717;2875;10165;710;2906;675;2120;1385;5026
354650;201503;877;2653;793;2496;102;363;516;1589;618;1952
354660;201503;2330;6836;1833;5972;354;1288;977;3177;1331;4465
354670;201503;1634;5314;1344;4600;372;1396;335;975;707;2371
354680;201503;4649;15533;4210;14619;1092;4134;1682;5635;2774;9769
354690;201503;766;2484;536;1927;98;374;170;570;268;944
354700;201503;1203;3398;815;2579;151;566;334;888;485;1454
354710;201503;531;1566;450;1412;76;282;207;587;283;869
354720;201503;208;575;152;466;50;146;41;127;91;273
354730;201503;7703;25535;6035;21973;1535;6129;2443;8588;3978;14717
354740;201503;247;738;171;593;37;133;43;151;80;284
354750;201503;2416;7381;1883;6470;591;2283;675;2239;1266;4522
354760;201503;2018;6501;1637;5661;471;1756;319;1027;790;2783
354765;201503;233;632;149;471;29;100;26;74;55;174
354770;201503;2206;6238;1712;5415;685;2325;385;1157;1070;3482
354780;201503;38802;115509;34467;106000;7095;24365;17541;50964;24636;75329
354790;201503;781;2497;662;2284;133;541;328;1044;461;1585
354800;201503;1843;5407;1633;5136;375;1321;961;3017;1336;4338
354805;201503;943;2860;693;2296;80;294;141;416;221;710
354810;201503;603;1942;382;1380;84;356;72;196;156;552
354820;201503;1037;3586;896;3289;222;964;261;851;483;1815
354830;201503;387;1120;307;977;81;288;151;437;232;725
354840;201503;676;1953;561;1745;134;455;270;820;404;1275
354850;201503;16102;50793;12215;42882;3009;11788;4485;14567;7494;26355
354860;201503;1313;4214;1159;3939;242;953;541;1762;783;2715
354870;201503;42505;130309;38764;122505;9703;32851;17697;54980;27400;87831
354880;201503;4028;11318;2480;8148;491;1821;674;1820;1165;3641
354890;201503;15735;47039;13217;42262;3535;12140;4494;13836;8029;25976
354900;201503;477;1406;382;1244;107;375;141;457;248;832
354910;201503;6481;19414;3751;13371;655;2623;290;953;945;3576
354920;201503;463;1344;329;1085;78;295;88;267;166;562
354925;201503;353;1010;218;741;35;138;35;93;70;231
354930;201503;213;593;156;496;35;121;78;241;113;362
354940;201503;2225;7900;1768;6682;636;2555;236;798;872;3353
354950;201503;1471;4753;1292;4495;176;731;842;2899;1018;3630
354960;201503;762;2399;668;2248;177;668;273;895;450;1563
354970;201503;4070;13293;3570;12264;636;2555;1991;6562;2627;9117
354980;201503;33121;82253;19562;59472;3972;13653;6555;18420;10527;32073
354990;201503;44127;135029;36409;119340;7177;25979;18719;59377;25896;85356
354995;201503;1648;5144;1517;4959;328;1185;873;2824;1201;4009
355000;201503;1436;4673;1242;4332;389;1536;222;670;611;2206
355010;201503;3569;11081;2879;9564;759;2724;1162;3804;1921;6528
355020;201503;2693;9126;2142;8007;888;3608;492;1787;1380;5395
355030;201503;937307;2696093;824518;2472700;200248;655190;367619;1062488;567867;1717678
355040;201503;2556;7866;2256;7336;553;2001;1207;3820;1760;5821
355050;201503;1210;3749;973;3271;309;1102;221;745;530;1847
355060;201503;5129;17382;4147;15272;1054;4352;1023;3438;2077;7790
355070;201503;6676;20835;5987;19736;1314;5091;3197;9828;4511;14919
355080;201503;1163;4032;868;3315;199;882;118;359;317;1241
355090;201503;1114;3915;948;3537;205;845;401;1438;606;2283
355100;201503;19655;61585;16564;56399;4850;18042;6869;22917;11719;40959
355110;201503;1164;3998;1051;3752;315;1248;353;1221;668;2469
355120;201503;630;2008;537;1835;138;538;235;769;373;1307
355130;201503;592;1532;310;920;47;156;120;306;167;462
355140;201503;1064;3595;1021;3516;240;924;522;1813;762;2737
355150;201503;3217;9684;2738;8894;662;2313;1358;4344;2020;6657
355160;201503;1545;5019;1332;4686;479;1924;413;1303;892;3227
355170;201503;9673;26885;6938;22097;2169;7460;1748;5512;3917;12972
355180;201503;2871;8812;2394;7925;632;2466;844;2533;1476;4999
355190;201503;1263;4315;1073;3897;410;1579;337;1179;747;2758
355200;201503;779;2809;722;2699;303;1219;177;628;480;1847
355210;201503;2527;8363;2269;7831;531;2151;1133;3659;1664;5810
355220;201503;29150;90718;24245;81452;8759;31229;6293;20592;15052;51821
355230;201503;1365;3835;766;2494;128;434;183;532;311;966
355240;201503;25593;74717;18365;59881;4007;14406;6773;20810;10780;35216
355250;201503;25453;83937;22743;78699;6848;25159;9492;32455;16340;57614
355255;201503;815;2287;578;1804;113;387;164;470;277;857
355260;201503;1361;3946;1214;3689;303;1067;498;1349;801;2416
355270;201503;1520;4613;1455;4518;131;519;1181;3584;1312;4103
355280;201503;23570;69565;19761;62355;4153;14842;8797;26388;12950;41230
355290;201503;865;2708;753;2483;151;535;311;965;462;1500
355300;201503;1014;3315;829;2918;195;746;261;866;456;1612
355310;201503;1009;3136;853;2847;153;558;443;1490;596;2048
355320;201503;613;1916;526;1719;99;394;199;543;298;937
355330;201503;1780;5648;1283;4674;349;1435;411;1432;760;2867
355340;201503;2541;6725;2322;6351;419;1256;1410;3736;1829;4992
355350;201503;1275;4384;1081;3959;297;1212;348;1196;645;2408
355360;201503;1102;3631;1010;3449;168;614;699;2436;867;3050
355365;201503;273;868;227;778;51;206;66;214;117;420
355370;201503;7287;18138;5250;15640;1439;4707;2263;6907;3702;11614
355380;201503;3415;10323;2646;8547;677;2454;556;1486;1233;3940
355385;201503;814;2597;760;2509;291;1055;241;734;532;1789
355390;201503;976;2776;783;2412;166;589;360;994;526;1583
355395;201503;1842;5517;1398;4535;221;792;606;1809;827;2601
355400;201503;8653;28716;7540;26445;2327;8912;2568;8614;4895;17526
355410;201503;14520;50045;12434;45635;4327;17232;2989;11017;7316;28249
355420;201503;763;2700;703;2566;241;976;219;786;460;1762
355430;201503;3574;10215;3019;9276;577;2002;1590;4702;2167;6704
355440;201503;873;2819;699;2384;139;518;211;640;350;1158
355450;201503;2885;8787;1893;6470;409;1511;601;1912;1010;3423
355460;201503;584;1597;427;1318;80;299;152;391;232;690
355465;201503;393;1204;332;1086;83;299;81;257;164;556
355470;201503;822;2533;672;2249;156;593;287;906;443;1499
355475;201503;117;446;105;410;21;85;46;182;67;267
355480;201503;3127;11260;2910;10825;841;3350;1364;5010;2205;8360
355490;201503;951;2725;668;2169;140;471;128;402;268;873
355495;201503;694;2340;623;2192;135;557;229;766;364;1323
355500;201503;8099;23386;5265;17286;930;3446;1108;3290;2038;6736
355510;201503;2041;5486;1226;3855;213;811;403;1121;616;1932
355520;201503;448;1103;254;727;40;136;102;258;142;394
355530;201503;324;751;139;422;17;60;38;109;55;169
355535;201503;716;2199;573;1934;169;649;146;412;315;1061
355540;201503;8353;26552;7889;25785;1987;6992;4279;13628;6266;20620
355550;201503;761;2263;654;2103;150;559;307;944;457;1503
355560;201503;1316;3904;916;3039;193;746;176;438;369;1184
355570;201503;187;590;144;494;23;81;22;56;45;137
355580;201503;1082;3085;824;2590;190;686;354;1077;544;1763
355590;201503;228;603;191;535;26;78;113;314;139;392
355600;201503;1123;3587;951;3217;373;1378;234;751;607;2129
355610;201503;1388;3907;1173;3562;243;827;556;1629;799;2456
355620;201503;4027;12720;3233;10912;651;2511;1397;4363;2048;6874
355630;201503;3345;9556;2097;6963;394;1481;631;1886;1025;3367
355635;201503;933;3055;805;2835;103;423;547;1931;650;2354
355640;201503;3312;10785;2570;9181;574;2320;395;1260;969;3580
355645;201503;3150;11059;2898;10627;496;2017;1838;6757;2334;8774
355650;201503;6709;20732;5808;19026;940;3685;3521;10842;4461;14527
355660;201503;1225;3886;989;3406;238;996;397;1257;635;2253
355670;201503;2453;7742;1719;6024;381;1560;662;2047;1043;3607
355680;201503;1479;4888;1121;4067;376;1473;254;865;630;2338
355690;201503;406;1274;298;1089;190;731;22;65;212;796
355695;201503;323;967;197;644;10;30;21;39;31;69
355700;201503;5753;19550;4980;17749;1357;5226;1962;6702;3319;11928
355710;201503;11429;28731;6984;20654;1886;6069;1831;5038;3717;11107
355715;201503;259;782;164;568;33;124;33;97;66;221
355720;201503;1536;5049;1275;4481;377;1461;368;1147;745;2608
355730;201503;731;2493;629;2257;209;774;138;487;347;1261
410010;201503;1491;4761;1324;4418;325;1210;393;1274;718;2484
410020;201503;1134;3820;1025;3593;274;1026;412;1399;686;2425
410030;201503;1111;3791;942;3376;259;991;166;588;425;1579
410040;201503;10047;33547;8929;31313;2691;10611;2575;8617;5266;19228
410045;201503;1011;2874;713;2286;183;645;214;634;397;1279
410050;201503;2265;6368;1442;4732;391;1370;246;748;637;2118
410060;201503;2184;6870;1948;6414;506;1816;813;2676;1319;4492
410070;201503;1748;4998;1351;4202;455;1576;278;738;733;2314
410080;201503;1218;3715;1025;3335;186;709;490;1489;676;2198
410090;201503;1044;3292;945;3103;268;987;321;1007;589;1994
410100;201503;2527;7741;1846;6153;517;1954;244;746;761;2700
410105;201503;416;1310;287;994;55;229;44;120;99;349
410110;201503;2488;7457;2033;6595;407;1522;721;2224;1128;3746
410115;201503;513;1397;394;1168;57;188;155;428;212;616
410120;201503;2523;8690;2374;8454;789;2976;1047;3792;1836;6768
410130;201503;1171;3806;1041;3504;351;1210;326;1064;677;2274
410140;201503;16012;42649;10861;33330;2484;8535;3345;10006;5829;18541
410150;201503;17076;42308;8382;24972;1727;5675;1550;4094;3277;9769
410160;201503;2973;9363;2680;8865;786;2903;1004;3329;1790;6232
410165;201503;742;2180;597;1872;145;483;256;760;401;1243
410170;201503;2015;5950;1609;5063;501;1772;395;1177;896;2949
410180;201503;8875;28421;7641;25749;1866;7023;3046;9580;4912;16603
410185;201503;559;1558;471;1393;114;347;185;514;299;861
410190;201503;1985;5888;1641;5108;416;1425;381;1080;797;2505
410200;201503;3707;10446;2675;8355;606;2118;357;1009;963;3127
410210;201503;2493;7495;1900;6198;343;1307;440;1178;783;2485
410220;201503;636;1834;465;1489;92;333;139;418;231;751
410230;201503;1484;4766;1286;4400;404;1574;493;1595;897;3169
410240;201503;4272;13095;3842;12204;1112;4002;1238;3743;2350;7745
410250;201503;2500;6986;1726;5391;482;1682;315;876;797;2558
410260;201503;1579;4858;1337;4392;348;1261;505;1606;853;2867
410270;201503;513;1475;405;1267;76;275;161;482;237;757
410275;201503;865;2611;603;2031;95;345;294;984;389;1329
410280;201503;2859;8438;2062;6747;423;1600;442;1314;865;2914
410290;201503;3317;10027;2824;9085;691;2430;1210;3898;1901;6328
410300;201503;658;1854;574;1677;79;264;284;747;363;1011
410302;201503;359;974;246;788;29;101;143;464;172;565
410304;201503;1240;4013;1116;3751;320;1130;442;1535;762;2665
410305;201503;1924;5113;1589;4595;403;1248;904;2609;1307;3857
410310;201503;2142;7057;1923;6667;447;1742;791;2702;1238;4444
410315;201503;629;1838;410;1408;84;310;129;413;213;723
410320;201503;1255;3705;800;2695;129;487;64;180;193;667
410322;201503;588;1757;415;1380;105;351;112;353;217;704
410330;201503;1331;3664;1095;3212;238;754;362;1015;600;1769
410335;201503;959;2838;822;2595;191;670;318;948;509;1618
410337;201503;780;2079;585;1700;88;311;241;611;329;922
410340;201503;528;1561;382;1186;47;183;150;394;197;577
410345;201503;1844;5371;1385;4416;364;1265;385;1141;749;2406
410347;201503;706;1909;450;1432;76;291;150;466;226;757
410350;201503;922;2806;647;2233;143;577;101;301;244;878
410360;201503;3222;9371;2689;8441;553;1932;1134;3472;1687;5404
410370;201503;12154;35341;8871;27973;1924;6950;2562;7111;4486;14061
410380;201503;1163;3639;1028;3341;155;587;537;1646;692;2233
410390;201503;2776;8028;2198;6955;761;2627;578;1633;1339;4260
410395;201503;872;2908;771;2690;189;773;350;1189;539;1962
410400;201503;4157;13141;3575;12008;879;3395;1360;4353;2239;7748
410405;201503;952;2760;763;2396;180;656;292;882;472;1538
410410;201503;1262;4153;1193;4050;405;1574;390;1213;795;2787
410420;201503;7712;25126;6520;22425;1942;7287;1306;4017;3248;11304
410425;201503;3292;10454;2374;8364;472;1839;289;942;761;2781
410430;201503;14880;40557;10837;32965;2441;8267;3377;9941;5818;18208
410440;201503;3069;9757;2724;9087;703;2598;1180;3863;1883;6461
410442;201503;2733;9304;2423;8594;762;2865;728;2570;1490;5435
410445;201503;2234;7466;1933;6918;535;2124;699;2597;1234;4721
410450;201503;2288;6520;1794;5562;577;1875;315;846;892;2721
410460;201503;2178;6495;1788;5737;451;1541;615;1857;1066;3398
410465;201503;1906;6571;1591;5855;420;1750;606;2037;1026;3787
410470;201503;1509;4901;1229;4235;306;1199;330;1115;636;2314
410480;201503;28889;82505;20699;65556;5699;19726;3981;11598;9680;31324
410490;201503;10837;34595;8579;29734;2345;9132;2413;7810;4758;16942
410500;201503;1607;5046;1317;4410;472;1747;383;1259;855;3006
410510;201503;2460;6534;1749;5102;368;1143;691;1821;1059;2964
410520;201503;3128;10950;2959;10600;998;3805;1086;3889;2084;7694
410530;201503;1617;4490;1253;3762;240;848;521;1442;761;2290
410540;201503;3125;9189;2118;7085;490;1745;682;2265;1172;4010
410550;201503;6328;18379;4338;14030;904;3308;718;2071;1622;5379
410560;201503;1359;4185;1038;3469;249;935;277;737;526;1672
410570;201503;2545;8248;2280;7790;653;2354;850;3114;1503;5468
410580;201503;21683;67156;18040;59672;5141;18921;4873;14885;10014;33806
410590;201503;1314;4132;810;2729;124;437;160;463;284;900
410600;201503;1902;5596;1550;4904;362;1199;644;2049;1006;3248
410610;201503;757;2255;615;1979;107;412;257;774;364;1186
410620;201503;1535;5382;1173;4424;361;1449;163;596;524;2045
410630;201503;2466;7337;1838;5947;464;1657;394;1102;858;2759
410640;201503;4572;12850;3454;10750;1023;3707;733;2076;1756;5783
410645;201503;1097;3843;1045;3762;474;1853;290;1024;764;2877
410650;201503;2298;7116;1855;6174;633;2215;343;1074;976;3289
410655;201503;841;2490;674;2163;160;593;232;710;392;1303
410657;201503;705;2051;505;1622;109;402;187;532;296;934
410660;201503;2394;6858;1416;4639;322;1146;233;647;555;1793
410670;201503;927;2595;658;2041;151;505;184;504;335;1009
410680;201503;2693;9183;2205;7941;637;2275;718;2750;1355;5025
410685;201503;647;1872;567;1738;46;146;422;1310;468;1456
410690;201503;107494;312609;74536;243622;17182;62131;17014;49914;34196;112045
410700;201503;2252;6973;2090;6662;594;2072;901;2769;1495;4841
410710;201503;929;2818;663;2186;171;618;184;526;355;1144
410712;201503;811;2473;702;2267;275;977;215;716;490;1693
410715;201503;971;3069;772;2621;167;633;299;968;466;1601
410720;201503;3369;9937;2466;8027;577;2116;642;1912;1219;4028
410725;201503;1045;2935;738;2338;121;401;131;350;252;751
410730;201503;478;1403;418;1277;143;494;112;329;255;823
410740;201503;867;2597;608;2068;112;442;278;948;390;1390
410750;201503;1768;5162;1469;4545;338;1151;485;1375;823;2526
410752;201503;283;804;182;589;37;144;71;201;108;345
410753;201503;447;1299;292;949;60;227;103;304;163;531
410754;201503;1009;3136;877;2914;91;332;588;2016;679;2348
410755;201503;817;2087;636;1800;78;259;386;1062;464;1321
410760;201503;2205;6861;1971;6422;591;2113;685;2128;1276;4241
410765;201503;16048;47800;11736;39091;2514;9456;1519;4661;4033;14117
410770;201503;912;2528;686;2084;195;653;188;526;383;1179
410773;201503;1356;3923;1150;3605;246;907;627;1866;873;2773
410775;201503;1532;4452;1437;4315;332;1050;753;2266;1085;3316
410780;201503;522;1457;391;1228;104;331;156;550;260;881
410785;201503;693;2236;571;1939;223;794;125;420;348;1214
410790;201503;517;1600;421;1375;94;341;91;229;185;570
410800;201503;2750;6952;2113;5922;535;1746;824;2134;1359;3880
410810;201503;324;995;264;860;42;155;117;381;159;536
410820;201503;921;2767;713;2287;186;654;144;412;330;1066
410830;201503;31570;91868;25597;81424;7604;26906;8901;27509;16505;54415
410832;201503;1025;3027;896;2791;127;470;517;1516;644;1986
410840;201503;6787;20089;4581;15374;1264;4612;569;1649;1833;6261
410845;201503;1338;3955;1119;3486;188;667;523;1569;711;2236
410850;201503;2770;8148;2474;7693;541;1941;1309;4054;1850;5995
410855;201503;561;1553;406;1222;92;317;157;406;249;723
410860;201503;3617;10220;2927;8929;538;1792;1330;3997;1868;5789
410865;201503;1620;5576;1512;5363;385;1471;831;3005;1216;4476
410870;201503;1224;3779;1126;3623;524;1773;382;1207;906;2980
410880;201503;4240;12911;3373;11280;773;2901;746;2259;1519;5160
410890;201503;1018;3241;794;2801;200;785;73;223;273;1008
410895;201503;1085;3779;972;3527;361;1414;278;944;639;2358
410900;201503;847;2365;619;1973;124;484;207;586;331;1070
410910;201503;416;1104;354;999;56;179;193;523;249;702
410920;201503;761;2264;608;1984;150;546;242;755;392;1301
410930;201503;1786;5286;1508;4791;381;1446;596;1829;977;3275
410940;201503;20325;67238;17830;62639;5321;20592;6503;23017;11824;43609
410950;201503;1795;5960;1658;5721;313;1137;1047;3642;1360;4779
410960;201503;7091;19688;4601;14972;1422;5097;1147;3571;2569;8668
410965;201503;1014;3144;888;2910;302;1041;342;1096;644;2137
410970;201503;4469;13481;3543;11644;1116;4213;714;2263;1830;6476
410975;201503;1562;4505;1272;3982;221;829;562;1728;783;2557
410980;201503;5539;15623;3374;11207;751;2773;568;1793;1319;4566
410990;201503;859;2509;529;1775;172;629;88;239;260;868
411000;201503;450;1347;312;1032;69;262;54;143;123;405
411005;201503;501;1477;323;1042;82;281;41;101;123;382
411007;201503;2225;7105;1952;6497;584;2056;688;2273;1272;4329
411010;201503;3769;12981;3383;12111;1069;4334;707;2284;1776;6618
411020;201503;2569;8089;2297;7625;766;2867;745;2439;1511;5306
411030;201503;642;1752;508;1505;130;440;153;401;283;841
411040;201503;604;1754;302;980;66;241;71;218;137;459
411050;201503;2102;7404;1869;6886;569;2309;303;1019;872;3328
411060;201503;1637;5076;1361;4481;302;1094;191;543;493;1637
411065;201503;368;1113;283;939;55;191;109;346;164;537
411070;201503;5496;16947;4149;14109;1172;4416;679;2046;1851;6462
411080;201503;2125;6507;1897;6085;541;1944;572;1742;1113;3686
411090;201503;741;1820;542;1532;84;308;140;357;224;665
411095;201503;1604;4499;1168;3628;219;773;296;824;515;1597
411100;201503;1376;3990;1007;3247;174;644;193;542;367;1186
411110;201503;719;2127;458;1535;70;255;74;200;144;455
411120;201503;1754;5334;1352;4467;384;1390;414;1283;798;2673
411125;201503;4137;13650;3985;13339;1250;4511;1710;5554;2960;10065
411130;201503;722;2199;566;1851;135;474;172;579;307;1053
411140;201503;2103;7469;1813;6784;629;2464;508;1976;1137;4440
411150;201503;4491;12581;3476;10534;888;3010;726;1844;1614;4854
411155;201503;957;2651;754;2262;163;573;335;909;498;1482
411160;201503;234;683;195;603;39;134;69;194;108;328
411170;201503;675;2206;560;1935;130;493;212;691;342;1184
411180;201503;5682;16994;4707;15166;1170;4204;1591;5022;2761;9226
411190;201503;1444;4110;1195;3641;305;1087;349;935;654;2022
411200;201503;4407;13092;3561;11651;953;3520;1382;4342;2335;7862
411210;201503;2108;6073;1680;5293;602;2047;284;857;886;2904
411220;201503;1143;3247;915;2814;220;798;373;1004;593;1802
411230;201503;1205;3391;767;2492;207;758;189;530;396;1288
411240;201503;1318;3158;730;2204;161;511;240;680;401;1191
411250;201503;2466;7282;2064;6537;560;1934;593;1825;1153;3759
411260;201503;298;821;194;631;29;100;91;295;120;395
411270;201503;1771;5643;1596;5311;357;1380;780;2465;1137;3845
411275;201503;1409;4210;1174;3669;315;1056;282;815;597;1871
411280;201503;1519;4504;1104;3630;242;897;231;688;473;1585
411290;201503;794;2275;613;1888;150;483;227;682;377;1165
411295;201503;902;2567;821;2408;148;467;361;1072;509;1539
411300;201503;1266;3248;911;2542;91;292;394;1039;485;1331
411310;201503;838;2358;649;2021;93;326;232;717;325;1043
411320;201503;5612;16427;4167;13617;1140;3929;900;2774;2040;6703
411325;201503;1494;4705;1305;4328;247;912;769;2549;1016;3461
411330;201503;3316;10387;2862;9543;1019;3763;827;2667;1846;6430
411340;201503;925;2711;586;1916;105;399;231;726;336;1125
411342;201503;718;2050;591;1782;153;496;182;472;335;968
411345;201503;982;3085;894;2914;242;864;426;1397;668;2261
411350;201503;2809;8346;1946;6553;528;1985;236;726;764;2711
411360;201503;600;1531;393;1149;48;183;176;433;224;616
411370;201503;46264;131592;35381;111322;6719;24648;13336;38636;20055;63284
411373;201503;1442;4502;1201;4024;307;1154;317;1049;624;2203
411375;201503;1070;2987;807;2474;182;602;289;846;471;1448
411380;201503;1289;3462;765;2330;120;398;232;656;352;1054
411390;201503;1725;5109;1480;4655;342;1204;570;1699;912;2903
411400;201503;1965;5728;1470;4631;305;1065;391;1131;696;2196
411410;201503;2130;6412;1633;5248;408;1500;434;1171;842;2671
411420;201503;4239;12298;3086;9713;588;2105;548;1338;1136;3443
411430;201503;3025;9531;2555;8697;750;2801;1075;3582;1825;6383
411435;201503;411;1336;335;1134;88;325;136;435;224;760
411440;201503;2713;8805;2454;8298;873;3146;682;2384;1555;5530
411450;201503;2239;6850;2027;6455;438;1450;1137;3671;1575;5121
411460;201503;3251;9601;1863;6307;412;1569;225;616;637;2185
411470;201503;855;2547;570;1866;101;364;108;297;209;661
411480;201503;4276;12962;3243;10930;1013;3868;648;2033;1661;5901
411490;201503;1431;4378;1209;3970;350;1303;324;925;674;2228
411500;201503;1827;5014;1289;4026;320;1112;329;983;649;2095
411510;201503;2100;6273;1670;5393;488;1754;358;970;846;2724
411520;201503;26775;72957;16220;50714;3441;11858;3519;10109;6960;21967
411530;201503;971;2782;668;2207;204;768;105;277;309;1045
411535;201503;510;1521;245;883;38;158;25;71;63;229
411540;201503;2907;7835;2171;6459;327;1060;1083;3181;1410;4241
411545;201503;963;3267;881;3110;156;594;594;2126;750;2720
411550;201503;806;2188;646;1934;249;828;147;419;396;1247
411560;201503;2428;7269;1845;5921;423;1518;351;984;774;2502
411570;201503;6428;17594;4725;14751;1239;4380;1072;3380;2311;7760
411573;201503;895;2712;845;2626;150;502;526;1647;676;2149
411575;201503;1417;4493;1204;4037;242;879;461;1522;703;2401
411580;201503;3914;11130;2618;8459;474;1835;420;1076;894;2911
411585;201503;604;2012;375;1325;89;345;69;230;158;575
411590;201503;417;1267;363;1172;75;280;169;516;244;796
411600;201503;296;878;214;728;47;195;78;252;125;447
411605;201503;2030;5493;1366;4196;235;823;577;1691;812;2514
411610;201503;2143;5966;1865;5557;341;1103;1246;3677;1587;4780
411620;201503;2673;8583;2493;8270;734;2612;1149;3869;1883;6481
411630;201503;449;1163;261;867;48;198;51;160;99;358
411640;201503;493;1474;382;1243;68;242;146;422;214;664
411650;201503;200;655;168;594;43;188;59;182;102;370
411660;201503;812;2285;646;1966;134;449;273;827;407;1276
411670;201503;1219;3401;1029;3009;248;834;408;1094;656;1928
411680;201503;1403;4399;1271;4154;213;679;856;2939;1069;3618
411690;201503;3366;10035;2711;8809;763;2626;646;2123;1409;4749
411695;201503;745;2421;598;2104;145;555;200;709;345;1264
411700;201503;1816;5301;1284;4213;269;992;304;901;573;1893
411705;201503;2135;7257;1878;6735;425;1525;1031;3842;1456;5367
411710;201503;1774;5307;1383;4464;334;1183;359;1070;693;2253
411720;201503;799;2356;604;1923;100;349;164;474;264;823
411721;201503;712;2158;608;1960;181;642;106;304;287;946
411722;201503;663;1957;485;1572;101;384;139;378;240;762
411725;201503;1373;4442;875;3163;204;783;178;626;382;1409
411727;201503;1914;5606;1523;4783;362;1249;559;1642;921;2891
411729;201503;535;1456;381;1173;121;403;94;253;215;656
411730;201503;5398;15674;4558;14101;1977;6276;1233;3898;3210;10174
411740;201503;605;1739;402;1273;69;249;150;441;219;690
411745;201503;894;2686;730;2343;164;555;224;697;388;1252
411750;201503;4511;13594;3405;11020;882;3220;745;2199;1627;5419
411760;201503;7873;23262;6854;21515;2301;7909;2048;6361;4349;14270
411770;201503;3330;11351;2809;10094;947;3680;566;1995;1513;5675
411780;201503;2617;8491;2503;8368;180;541;2084;7363;2264;7904
411790;201503;2900;8334;2146;6842;594;2218;698;2113;1292;4331
411800;201503;1414;4075;907;2939;136;513;163;426;299;939
411810;201503;1549;4603;1324;4147;320;1146;449;1242;769;2388
411820;201503;15127;47584;12533;42656;4325;15322;3333;11694;7658;27016
411830;201503;428;1161;337;1026;154;470;34;114;188;584
411840;201503;9956;29217;7641;24761;2022;7158;1838;5742;3860;12900
411845;201503;528;1628;368;1232;59;223;97;281;156;504
411850;201503;6391;19293;5370;17254;1428;4959;1577;5025;3005;9984
411860;201503;864;2712;700;2365;187;656;209;667;396;1323
411870;201503;908;3109;663;2438;104;434;181;633;285;1067
411880;201503;2167;6263;1771;5554;494;1791;405;1086;899;2877
411885;201503;831;2272;666;1962;138;532;234;599;372;1131
411890;201503;1125;3422;726;2463;129;497;119;333;248;830
411900;201503;960;3081;688;2408;185;659;110;389;295;1048
411910;201503;1222;4109;1005;3582;310;1211;286;939;596;2150
411915;201503;13789;38816;9189;29337;1949;6874;2203;6412;4152;13286
411920;201503;956;3262;829;2952;231;959;139;408;370;1367
411925;201503;592;1663;392;1295;103;354;109;340;212;694
411930;201503;5996;19805;5342;18560;1818;6738;1750;6133;3568;12871
411940;201503;3279;10971;2849;10080;791;2989;692;2365;1483;5354
411950;201503;11128;35444;9342;31916;2418;9062;4167;13956;6585;23018
411960;201503;5103;15350;4676;14532;1171;4105;2055;6194;3226;10299
411965;201503;597;1688;443;1442;83;318;167;559;250;877
411970;201503;753;2150;609;1926;174;614;196;589;370;1203
411980;201503;1518;4691;1305;4245;237;825;509;1662;746;2487
411990;201503;27462;90861;23268;82009;6624;26044;6538;22670;13162;48714
411995;201503;2555;7946;2209;7261;784;2930;527;1577;1311;4507
412000;201503;2114;5591;1700;4886;299;1037;854;2237;1153;3274
412010;201503;705;2393;574;2095;127;485;125;419;252;904
412015;201503;657;1989;532;1720;104;354;254;822;358;1176
412020;201503;396;1138;270;868;66;242;100;291;166;533
412030;201503;691;2163;472;1653;88;360;131;403;219;763
412033;201503;716;2146;490;1608;103;392;113;323;216;715
412035;201503;978;2718;694;2193;163;562;274;825;437;1387
412040;201503;567;1825;467;1587;108;401;167;535;275;936
412050;201503;1708;5087;1334;4332;312;1162;273;829;585;1991
412060;201503;6524;22679;5912;21392;1779;6921;2252;8217;4031;15138
412065;201503;890;2689;696;2252;174;640;227;666;401;1306
412070;201503;1175;3195;937;2725;159;491;340;959;499;1450
412080;201503;1365;4219;804;2886;133;554;53;140;186;694
412085;201503;359;1030;152;512;36;138;39;111;75;249
412090;201503;4260;13901;4043;13510;668;2502;2658;8948;3326;11450
412100;201503;1942;6189;1704;5731;532;1947;524;1695;1056;3642
412110;201503;1066;3043;716;2294;160;567;194;608;354;1175
412120;201503;1899;6452;1665;5904;440;1784;679;2220;1119;4004
412125;201503;760;2418;661;2246;151;566;271;905;422;1471
412130;201503;602;1818;453;1489;91;341;109;332;200;673
412135;201503;507;1438;356;1135;77;278;138;404;215;682
412140;201503;1522;4587;1258;4040;313;1071;344;1092;657;2163
412150;201503;3051;8917;2639;8111;380;1331;1576;4719;1956;6050
412160;201503;1019;3281;639;2287;167;672;130;422;297;1094
412170;201503;4342;13854;3549;12293;1070;4050;1302;4388;2372;8438
412175;201503;1323;4564;1167;4215;314;1262;487;1728;801;2990
412180;201503;1714;5324;1263;4423;335;1324;344;1161;679;2485
412190;201503;3017;8837;2311;7594;646;2345;653;2185;1299;4530
412200;201503;2264;7395;1586;5613;359;1387;504;1749;863;3136
412210;201503;722;2024;423;1395;85;336;58;176;143;512
412215;201503;3554;11071;3237;10508;582;1866;2056;6921;2638;8787
412217;201503;1090;3124;998;2966;133;492;703;1972;836;2464
412220;201503;5286;17610;5057;17198;1537;5469;2712;9242;4249;14711
412230;201503;2854;9565;2478;8815;663;2697;722;2406;1385;5103
412240;201503;9525;24650;5329;16600;1005;3574;918;2508;1923;6082
412250;201503;1881;5573;1614;5017;421;1456;364;971;785;2427
412260;201503;1268;3580;817;2600;136;518;278;782;414;1300
412265;201503;1016;3146;894;2930;187;730;448;1435;635;2165
412270;201503;706;2228;507;1774;118;466;129;421;247;887
412280;201503;602;1888;449;1561;224;814;42;137;266;951
412290;201503;1042;3008;812;2544;160;546;275;798;435;1344
412300;201503;1878;5671;1564;5055;467;1668;390;1212;857;2880
412310;201503;1078;3161;965;2996;120;383;636;2099;756;2482
412320;201503;792;2178;572;1784;143;509;190;588;333;1097
412330;201503;1647;4631;1287;3924;226;764;679;2049;905;2813
412340;201503;849;2654;574;1951;81;305;99;320;180;625
412350;201503;2426;7608;1972;6611;543;1972;276;796;819;2768
412360;201503;280;846;191;622;23;89;70;196;93;285
412370;201503;825;2587;671;2267;184;694;177;563;361;1257
412380;201503;1687;5285;1417;4672;369;1322;419;1298;788;2620
412382;201503;689;1977;478;1534;100;344;133;395;233;739
412385;201503;2442;7696;2189;7130;683;2353;653;2095;1336;4448
412390;201503;2134;6218;1931;5880;540;1845;763;2324;1303;4169
412395;201503;906;2558;726;2260;101;327;434;1345;535;1672
412400;201503;1014;3153;878;2886;256;894;282;948;538;1842
412402;201503;1928;5828;1568;5066;411;1501;397;1096;808;2597
412405;201503;3551;10340;2261;7489;451;1726;267;777;718;2503
412410;201503;4701;15019;4073;13792;1351;5391;835;2612;2186;8003
412420;201503;381;1129;277;892;59;221;105;271;164;492
412430;201503;497;1416;385;1192;79;281;151;424;230;705
412440;201503;3456;10494;2863;9472;549;2009;1178;3970;1727;5979
412450;201503;309;991;240;820;40;141;37;85;77;226
412460;201503;829;2469;620;2045;162;629;162;471;324;1100
412470;201503;1891;6466;1677;5943;553;2057;560;2011;1113;4068
412480;201503;1326;3918;924;3026;196;690;130;341;326;1031
412490;201503;923;2754;802;2500;162;537;255;728;417;1265
412500;201503;1975;5782;1666;5176;400;1414;415;1088;815;2502
412510;201503;2268;7612;1960;6852;540;2048;846;2940;1386;4988
412520;201503;1536;4381;1214;3744;324;1072;335;986;659;2058
412530;201503;661;1933;535;1662;116;362;157;473;273;835
412535;201503;600;1782;381;1257;95;341;77;217;172;558
412540;201503;1193;3485;928;2934;149;537;299;943;448;1480
412545;201503;852;2447;671;2045;106;388;274;738;380;1126
412550;201503;26553;80215;18343;61783;4877;17769;3541;11135;8418;28904
412555;201503;324;981;220;732;43;164;43;113;86;277
412560;201503;5211;16566;4133;14313;1026;4070;976;3099;2002;7169
412570;201503;4327;12994;3027;10049;725;2755;564;1714;1289;4469
412575;201503;906;2780;715;2331;168;616;196;586;364;1202
412580;201503;1264;3492;917;2891;198;654;263;786;461;1440
412590;201503;400;1172;282;930;67;248;80;260;147;508
412600;201503;1426;4364;1168;3825;307;1124;362;1106;669;2230
412610;201503;665;2022;471;1519;118;447;151;416;269;863
412620;201503;1175;3827;931;3297;257;1017;165;543;422;1560
412625;201503;10665;29723;8052;24739;2068;6944;1562;4370;3630;11314
412627;201503;959;2918;640;2230;212;803;50;155;262;958
412630;201503;3289;10486;2800;9431;672;2406;915;2958;1587;5364
412635;201503;458;1412;317;1090;73;280;29;89;102;369
412640;201503;869;2632;615;2059;126;451;82;226;208;677
412650;201503;1978;5815;1626;5127;401;1460;528;1447;929;2907
412660;201503;2851;8379;2249;7135;477;1704;466;1323;943;3027
412665;201503;649;1678;347;1112;99;341;86;268;185;609
412667;201503;1535;4571;1222;3941;315;1156;281;845;596;2001
412670;201503;663;2066;447;1547;105;412;74;201;179;613
412680;201503;1326;4019;862;2955;178;689;227;684;405;1373
412690;201503;719;2246;549;1867;199;720;110;364;309;1084
412700;201503;1802;5720;1557;5331;575;2214;492;1628;1067;3842
412710;201503;8083;25373;6760;22651;1725;6464;1677;5277;3402;11741
412720;201503;1467;4587;1016;3427;197;732;169;462;366;1194
412730;201503;2197;6574;1439;4844;322;1218;181;460;503;1678
412740;201503;1363;4432;1103;3843;293;1131;220;785;513;1916
412750;201503;3754;11845;3364;11202;570;2233;2150;7016;2720;9249
412760;201503;2293;7576;2180;7385;570;2240;1094;3519;1664;5759
412770;201503;11515;32306;6926;22299;1174;4229;1360;3831;2534;8060
412780;201503;1261;4068;1103;3738;292;1069;374;1188;666;2257
412785;201503;2318;6775;1695;5446;398;1426;782;2431;1180;3857
412788;201503;1414;4571;1278;4296;300;1166;466;1406;766;2572
412790;201503;1172;3536;943;3073;217;789;253;737;470;1526
412795;201503;952;2741;813;2485;221;700;266;793;487;1493
412796;201503;2801;8748;2586;8344;702;2571;1043;3127;1745;5698
412800;201503;3184;9080;2405;7528;501;1764;813;2415;1314;4179
412810;201503;10375;28622;5889;18794;1020;3638;1212;3252;2232;6890
412820;201503;6857;20340;4973;16626;1282;4661;1087;3680;2369;8341
412830;201503;337;1048;270;902;55;231;86;250;141;481
412840;201503;1904;5512;1547;4811;340;1170;402;1156;742;2326
412850;201503;2554;7722;2189;7135;414;1598;1010;3113;1424;4711
412853;201503;1506;4298;1350;4026;156;604;809;2211;965;2815
412855;201503;1509;4369;1161;3626;327;1175;315;862;642;2037
412860;201503;1208;3502;1007;3125;218;766;441;1325;659;2091
412862;201503;760;1977;530;1526;87;283;209;548;296;831
412863;201503;1262;4244;1217;4170;193;719;836;2844;1029;3563
412865;201503;688;2124;514;1707;109;382;197;675;306;1057
412870;201503;912;2590;737;2306;258;890;185;543;443;1433
412880;201503;1077;3014;848;2617;209;724;238;658;447;1382
420005;201503;544;1628;359;1213;77;284;128;415;205;699
420010;201503;3182;9401;2621;8542;357;1241;1885;6293;2242;7534
420020;201503;791;2582;471;1727;72;321;55;159;127;480
420030;201503;543;1468;286;973;66;267;44;141;110;408
420040;201503;842;2604;532;1955;132;537;77;216;209;753
420050;201503;713;2178;536;1773;165;577;188;585;353;1162
420055;201503;241;717;151;502;31;109;30;85;61;194
420060;201503;245;829;170;631;45;191;24;78;69;269
420070;201503;1395;4461;1120;3796;185;682;580;2005;765;2687
420075;201503;197;565;109;361;22;86;34;100;56;186
420080;201503;624;1986;497;1718;164;613;122;417;286;1030
420090;201503;538;1841;399;1532;112;465;68;257;180;722
420100;201503;1326;4229;1201;4054;300;1068;689;2338;989;3406
420110;201503;358;1203;316;1112;89;332;129;455;218;787
420120;201503;315;1088;267;989;88;363;62;211;150;574
420125;201503;308;1201;280;1137;92;387;95;359;187;746
420127;201503;543;1628;216;796;64;247;25;88;89;335
420130;201503;1961;6518;1643;5899;437;1737;503;1615;940;3352
420140;201503;5404;15827;3765;12702;1003;3795;650;1986;1653;5781
420150;201503;773;2151;461;1507;99;365;157;455;256;820
420160;201503;305;882;193;640;33;126;54;167;87;293
420165;201503;218;690;134;468;27;107;33;102;60;209
420170;201503;213;650;140;505;46;205;19;45;65;250
420180;201503;432;1342;254;919;48;183;52;178;100;361
420190;201503;511;1537;276;990;54;218;42;131;96;349
420195;201503;1416;4108;1134;3693;285;995;499;1658;784;2653
420200;201503;3014;9778;1918;7196;548;2319;320;1060;868;3379
420205;201503;953;3162;838;2954;200;777;409;1424;609;2201
420207;201503;1489;4358;1027;3385;302;1139;267;786;569;1925
420208;201503;530;1516;332;1153;111;419;94;317;205;736
420209;201503;343;1091;214;774;41;172;70;234;111;406
420210;201503;1568;4841;999;3784;236;1103;187;640;423;1743
420213;201503;850;3037;805;2929;147;551;519;1933;666;2484
420215;201503;413;1353;282;1019;79;310;48;157;127;467
420220;201503;194;676;173;635;46;197;60;168;106;365
420230;201503;4307;12767;3159;10628;660;2600;1381;4441;2041;7041
420240;201503;12371;33785;7443;24656;1239;5061;3038;8970;4277;14031
420243;201503;611;1878;484;1605;106;415;171;538;277;953
420245;201503;1104;3327;739;2548;163;632;178;524;341;1156
420250;201503;601;1967;567;1908;166;656;251;807;417;1463
420253;201503;561;1500;449;1343;80;249;243;760;323;1009
420257;201503;325;942;218;742;38;139;112;378;150;517
420260;201503;1264;4043;1071;3704;249;984;489;1682;738;2666
420270;201503;513;1587;150;558;26;107;34;109;60;216
420280;201503;2417;6481;1463;4745;290;1122;531;1525;821;2647
420285;201503;155;460;65;239;7;30;2;9;9;39
420287;201503;594;1830;505;1664;134;459;175;578;309;1037
420290;201503;6667;19682;4282;14235;902;3304;1271;3892;2173;7196
420300;201503;6503;19924;4338;15309;1022;4046;850;2947;1872;6993
420310;201503;787;2297;733;2215;133;432;484;1426;617;1858
420315;201503;974;3143;776;2738;224;885;292;1011;516;1896
420320;201503;5398;16782;4481;15146;1266;4750;1817;6009;3083;10759
420325;201503;357;1170;335;1124;81;303;128;414;209;717
420330;201503;1106;3865;846;3158;218;905;214;688;432;1593
420340;201503;1482;4619;1137;3822;250;926;233;719;483;1645
420350;201503;1381;4346;1138;3844;298;1071;460;1545;758;2616
420360;201503;3194;9879;2186;7588;604;2372;292;839;896;3211
420370;201503;1990;5547;1614;4959;152;461;1319;4086;1471;4547
420380;201503;4879;15886;3763;13255;1010;3942;948;3201;1958;7143
420390;201503;1689;4828;916;3161;189;756;197;576;386;1332
420395;201503;1615;5048;1126;3916;195;769;176;505;371;1274
420400;201503;1371;4006;966;3208;264;1042;268;794;532;1836
420410;201503;803;2148;545;1720;136;480;290;896;426;1376
420415;201503;470;1497;348;1195;118;429;98;320;216;749
420417;201503;781;2499;666;2216;121;428;343;1137;464;1565
420419;201503;411;1267;269;982;115;466;43;149;158;615
420420;201503;12075;36337;9288;30723;2866;10692;2635;8142;5501;18834
420425;201503;1350;3719;869;2739;96;376;365;1040;461;1416
420430;201503;3454;10601;2231;7754;510;1983;741;2520;1251;4503
420435;201503;288;903;203;704;42;176;98;321;140;497
420440;201503;1215;3396;652;2206;262;967;107;328;369;1295
420445;201503;338;1032;292;942;61;201;152;493;213;694
420450;201503;1095;3111;628;2129;122;468;135;383;257;851
420455;201503;1998;6143;1760;5732;357;1411;845;2665;1202;4076
420460;201503;8992;26953;6872;23132;1627;6428;2623;8345;4250;14773
420470;201503;1214;3275;756;2398;205;749;205;590;410;1339
420475;201503;129;390;67;239;18;68;9;27;27;95
420480;201503;4775;14192;3795;12470;1473;5465;500;1502;1973;6967
420490;201503;747;2028;435;1486;116;420;121;399;237;819
420500;201503;1862;5841;1465;5085;451;1746;646;2187;1097;3933
420510;201503;119;487;108;461;45;197;38;155;83;352
420515;201503;118;403;96;357;18;78;17;65;35;143
420517;201503;903;2803;810;2636;148;543;473;1511;621;2054
420519;201503;479;1335;352;1091;62;204;112;327;174;531
420520;201503;664;1721;481;1481;115;405;272;813;387;1218
420530;201503;1157;3894;886;3230;223;933;209;627;432;1560
420535;201503;273;822;165;587;53;213;17;48;70;261
420540;201503;21187;61577;15055;48307;4090;14504;4134;11913;8224;26417
420543;201503;425;1131;314;944;34;127;189;602;223;729
420545;201503;1660;5201;1326;4487;329;1288;432;1337;761;2625
420550;201503;4455;14385;3427;12087;852;3546;815;2575;1667;6121
420555;201503;445;1375;352;1187;105;396;112;349;217;745
420560;201503;554;1623;473;1466;83;273;236;731;319;1004
420570;201503;2028;6607;1631;5676;457;1807;526;1714;983;3521
420580;201503;1301;4171;1058;3749;303;1217;462;1612;765;2829
420590;201503;3233;9895;2212;7531;509;1895;407;1226;916;3121
420600;201503;808;2697;736;2535;152;562;342;1218;494;1780
420610;201503;535;1683;330;1210;95;391;68;226;163;617
420620;201503;848;2589;721;2366;220;776;223;722;443;1498
420630;201503;1099;3413;771;2640;172;645;240;723;412;1368
420640;201503;734;2267;357;1336;88;373;28;82;116;455
420650;201503;2278;6812;1355;4716;250;997;252;777;502;1774
420660;201503;516;1492;414;1301;77;285;200;598;277;883
420665;201503;780;2197;492;1615;83;287;140;414;223;701
420670;201503;1688;5223;1227;4198;243;970;271;805;514;1775
420675;201503;221;680;151;517;28;105;52;169;80;274
420680;201503;536;1297;324;975;63;213;110;305;173;518
420690;201503;884;3060;643;2375;120;459;157;508;277;967
420700;201503;3728;10748;2823;8900;658;2427;873;2567;1531;4994
420710;201503;609;2052;476;1783;147;608;149;542;296;1150
420720;201503;1640;4836;1329;4418;280;1008;831;2771;1111;3779
420730;201503;3467;10429;2831;9286;763;2753;1125;3517;1888;6270
420740;201503;841;2640;711;2399;192;684;379;1269;571;1953
420750;201503;2341;7421;1606;5669;293;1220;494;1510;787;2730
420757;201503;111;292;60;216;13;59;22;72;35;131
420760;201503;343;1062;234;772;48;183;56;153;104;336
420765;201503;583;1829;300;1112;60;250;48;152;108;402
420768;201503;1214;4258;951;3669;314;1281;335;1276;649;2557
420770;201503;709;2044;372;1307;77;320;92;297;169;617
420775;201503;704;2239;449;1545;124;436;94;300;218;736
420780;201503;1656;5017;1073;3588;275;1006;216;637;491;1643
420785;201503;326;994;234;755;43;152;75;214;118;366
420790;201503;1338;4636;1065;3958;299;1236;430;1502;729;2738
420800;201503;826;2386;450;1514;136;530;89;265;225;795
420810;201503;2391;8179;1895;7028;611;2564;468;1655;1079;4219
420820;201503;8392;26536;6140;22528;1782;7400;1855;6730;3637;14130
420830;201503;2573;8348;2162;7600;734;2836;770;2638;1504;5474
420840;201503;1039;3042;596;2151;159;649;157;509;316;1158
420845;201503;1325;4187;1012;3585;308;1256;237;761;545;2017
420850;201503;1739;5472;1040;3965;282;1223;153;568;435;1791
420860;201503;501;1423;318;1080;93;370;134;444;227;814
420870;201503;1229;3427;933;3000;308;1146;309;894;617;2040
420880;201503;1183;3934;926;3270;204;798;197;616;401;1414
420890;201503;13343;32265;5972;18917;1073;3833;1731;4712;2804;8545
420895;201503;244;665;123;398;34;107;13;35;47;142
420900;201503;2153;6013;1290;4310;282;1060;323;964;605;2024
420910;201503;22358;67175;14668;51234;3096;12442;4255;13767;7351;26209
420915;201503;562;2225;457;1928;117;526;211;859;328;1385
420917;201503;459;1415;220;706;54;204;82;213;136;417
420920;201503;201;566;89;306;31;109;11;36;42;145
420930;201503;18843;54696;14976;48185;3840;13866;5284;16502;9124;30368
420940;201503;4039;12159;3291;10562;882;3220;760;2033;1642;5253
420945;201503;213;673;135;484;32;134;29;98;61;232
420950;201503;621;1753;280;1048;40;199;34;96;74;295
420960;201503;1116;3259;932;2957;214;817;432;1264;646;2081
420970;201503;2521;8085;2221;7548;618;2377;953;3223;1571;5600
420980;201503;436;1336;333;1155;111;401;140;536;251;937
420985;201503;522;1497;263;930;60;244;74;242;134;486
420990;201503;821;2282;527;1799;109;429;175;540;284;969
421000;201503;583;2006;392;1516;90;390;63;204;153;594
421003;201503;703;1925;274;913;40;147;41;89;81;236
421005;201503;224;709;180;634;50;194;90;307;140;501
421010;201503;6035;17489;4182;14046;1156;4434;1028;3084;2184;7518
421020;201503;517;1659;404;1446;65;233;207;791;272;1024
421030;201503;946;3503;883;3349;309;1249;306;1167;615;2416
421040;201503;723;2057;561;1783;126;456;261;783;387;1239
421050;201503;1979;5391;1171;3841;301;1127;264;704;565;1831
421055;201503;233;709;137;477;40;162;38;107;78;269
421060;201503;500;1742;375;1385;70;293;133;457;203;750
421070;201503;758;2378;491;1724;122;492;108;361;230;853
421080;201503;524;1592;454;1475;96;325;268;853;364;1178
421085;201503;564;1492;298;1009;66;253;74;264;140;517
421090;201503;394;1090;238;760;38;140;102;305;140;445
421100;201503;974;2871;657;2191;175;593;139;414;314;1007
421105;201503;1460;4517;1223;4102;294;1076;473;1620;767;2696
421110;201503;1157;4124;1044;3906;398;1605;267;955;665;2560
421120;201503;1544;4866;1072;3739;190;797;320;979;510;1776
421125;201503;416;1190;306;993;83;312;115;349;198;661
421130;201503;3542;11618;2968;10553;1030;4116;950;3347;1980;7463
421140;201503;372;1118;288;933;59;207;108;331;167;538
421145;201503;575;1852;397;1363;60;223;169;562;229;785
421150;201503;547;1719;412;1478;100;400;163;581;263;981
421160;201503;1208;3462;623;2101;117;458;225;712;342;1170
421165;201503;285;1000;222;807;41;148;100;369;141;517
421170;201503;1538;4611;1252;4125;268;992;739;2407;1007;3399
421175;201503;1231;3531;917;3026;219;923;361;1049;580;1972
421180;201503;607;1695;326;1099;79;306;92;262;171;568
421185;201503;423;1188;301;950;55;167;150;497;205;664
421187;201503;309;935;230;769;50;174;108;354;158;528
421189;201503;461;1431;406;1327;88;311;154;479;242;790
421190;201503;11246;33147;7087;24391;1667;6227;1529;4908;3196;11135
421200;201503;975;3262;841;2982;212;844;291;966;503;1810
421205;201503;247;780;190;665;47;201;45;123;92;324
421210;201503;1670;5088;1290;4156;358;1234;379;1159;737;2393
421220;201503;2161;7317;1881;6723;628;2475;485;1688;1113;4163
421223;201503;745;2139;493;1678;120;442;183;604;303;1046
421225;201503;1140;3558;937;3143;228;850;344;1129;572;1979
421227;201503;800;2659;704;2508;154;557;448;1631;602;2188
421230;201503;588;1945;515;1783;128;493;210;679;338;1172
421240;201503;475;1546;279;986;38;146;63;202;101;348
421250;201503;1851;5417;1193;4230;370;1464;278;925;648;2389
421260;201503;382;1100;121;455;25;94;29;102;54;196
421265;201503;572;1869;494;1715;117;429;188;645;305;1074
421270;201503;809;2198;436;1453;123;442;110;402;233;844
421280;201503;1650;5229;1326;4704;406;1617;473;1645;879;3262
421290;201503;1715;4548;932;3003;196;678;204;556;400;1234
421300;201503;310;954;256;839;74;278;107;328;181;606
421310;201503;317;1036;250;863;60;218;78;252;138;470
421315;201503;392;1161;226;809;42;157;30;111;72;268
421320;201503;550;1818;367;1336;67;267;56;153;123;420
421330;201503;511;1774;428;1605;157;668;66;238;223;906
421335;201503;564;1850;459;1648;115;457;96;357;211;814
421340;201503;1757;5200;1457;4699;217;844;912;2900;1129;3744
421350;201503;905;2985;720;2581;174;711;238;782;412;1493
421360;201503;3149;9130;2007;6900;418;1676;621;1938;1039;3614
421370;201503;790;2616;634;2267;185;754;209;698;394;1452
421380;201503;1041;2997;835;2612;154;543;402;1247;556;1790
421390;201503;149;437;78;270;11;35;35;128;46;163
421400;201503;314;1131;241;960;77;336;65;246;142;582
421410;201503;334;972;230;765;33;110;122;414;155;524
421415;201503;350;1162;173;650;45;178;42;142;87;320
421420;201503;938;2863;660;2207;130;487;167;490;297;977
421430;201503;247;782;188;664;41;163;41;142;82;305
421440;201503;891;2595;596;2038;153;580;231;743;384;1323
421450;201503;579;1837;386;1423;95;398;60;192;155;590
421460;201503;650;1762;330;1150;52;217;77;249;129;466
421470;201503;443;1539;352;1329;95;384;143;529;238;913
421480;201503;2791;8060;1677;5923;394;1631;376;1159;770;2790
421490;201503;299;928;135;525;37;163;27;93;64;256
421500;201503;2359;8066;2019;7357;733;3033;419;1469;1152;4502
421505;201503;397;1324;349;1218;82;310;159;538;241;848
421507;201503;609;1871;401;1403;73;262;148;537;221;799
421510;201503;207;698;182;653;38;173;88;270;126;443
421520;201503;851;2276;558;1673;57;229;283;760;340;989
421530;201503;423;1305;243;901;43;199;80;290;123;489
421535;201503;711;2120;406;1469;77;303;188;641;265;944
421540;201503;367;1008;296;878;65;210;120;341;185;551
421545;201503;1025;3408;779;2903;216;940;174;592;390;1532
421550;201503;1995;6579;1719;6063;544;2215;497;1625;1041;3840
421555;201503;346;1045;142;511;24;98;20;64;44;162
421560;201503;227;705;107;383;22;90;24;83;46;173
421565;201503;960;2908;861;2746;322;1153;327;990;649;2143
421567;201503;886;3253;760;2936;364;1461;149;563;513;2024
421568;201503;538;1699;381;1334;101;371;100;353;201;724
421569;201503;187;583;107;398;26;110;26;87;52;197
421570;201503;1321;4092;714;2581;205;817;140;492;345;1309
421575;201503;508;1706;444;1577;74;289;272;963;346;1252
421580;201503;3638;11532;2782;9645;803;3201;679;2029;1482;5230
421590;201503;235;729;191;646;34;120;104;343;138;463
421600;201503;603;1815;458;1517;127;469;100;299;227;768
421605;201503;640;1944;452;1578;97;408;119;364;216;772
421610;201503;1572;4288;1280;3825;187;654;743;2142;930;2796
421620;201503;4824;14607;3292;11375;975;3683;1072;3676;2047;7359
421625;201503;377;1109;180;625;28;109;51;176;79;285
421630;201503;2765;8236;1556;5367;375;1458;235;710;610;2168
421635;201503;267;794;167;552;24;87;83;253;107;340
421640;201503;1064;3268;838;2815;149;510;486;1654;635;2164
421650;201503;2198;7201;1824;6365;615;2432;305;942;920;3374
421660;201503;8762;27995;6868;24173;1871;7471;2180;7094;4051;14565
421670;201503;1087;3416;757;2660;213;836;220;741;433;1577
421680;201503;1245;4108;1073;3696;372;1376;210;679;582;2055
421690;201503;1917;6263;1465;5161;337;1312;221;689;558;2001
421700;201503;617;1787;330;1132;73;303;92;234;165;537
421710;201503;271;909;156;578;48;188;45;163;93;351
421715;201503;283;771;159;512;44;155;45;130;89;285
421720;201503;1772;5377;1163;4119;390;1537;283;929;673;2466
421725;201503;113;386;105;368;38;148;25;85;63;233
421730;201503;622;1830;310;1101;67;258;57;158;124;416
421740;201503;727;2232;498;1697;118;473;101;248;219;721
421750;201503;1170;3220;782;2442;162;564;352;1004;514;1568
421755;201503;363;1105;242;806;55;217;75;222;130;439
421760;201503;635;2097;358;1298;77;320;120;406;197;726
421770;201503;3064;9178;2305;7631;684;2424;726;2386;1410;4810
421775;201503;604;1759;392;1376;88;327;114;382;202;709
421780;201503;1436;4740;1072;3922;300;1236;392;1347;692;2583
421790;201503;937;2573;543;1905;144;593;165;528;309;1121
421795;201503;358;1066;231;748;34;132;73;229;107;361
421800;201503;2633;8002;1969;6720;435;1729;794;2502;1229;4231
421810;201503;720;2305;542;1912;140;520;81;271;221;791
421820;201503;1169;3410;767;2603;127;495;193;576;320;1071
421825;201503;1507;4969;1410;4741;235;940;873;2809;1108;3749
421830;201503;2614;8996;2384;8540;555;2251;1161;4049;1716;6300
421835;201503;152;448;112;387;28;123;62;195;90;318
421840;201503;375;1234;296;1047;75;301;101;328;176;629
421850;201503;487;1415;312;1047;78;300;94;306;172;606
421860;201503;366;1130;230;836;38;145;48;156;86;301
421870;201503;4749;13425;3261;10435;933;3241;640;1942;1573;5183
421875;201503;440;1321;197;744;47;208;34;115;81;323
421880;201503;974;3060;759;2587;176;700;199;621;375;1321
421885;201503;333;1083;276;973;81;300;98;330;179;630
421890;201503;973;3296;830;2996;264;1097;266;906;530;2003
421895;201503;371;1221;332;1147;74;254;194;697;268;951
421900;201503;758;2404;600;2029;163;576;162;493;325;1069
421910;201503;535;1679;386;1346;85;337;111;340;196;677
421915;201503;568;1716;391;1304;83;287;102;298;185;585
421917;201503;577;1739;438;1498;126;512;152;475;278;987
421920;201503;805;2265;533;1893;223;835;182;642;405;1477
421930;201503;3400;9223;2043;6787;521;1958;393;1179;914;3137
421935;201503;776;2654;594;2244;136;596;208;740;344;1336
421940;201503;267;919;164;616;31;141;35;98;66;239
421950;201503;4126;11482;2118;7198;565;2076;365;1201;930;3277
421960;201503;237;735;188;623;46;166;50;148;96;314
421970;201503;2201;6405;1453;4762;521;1822;316;943;837;2765
421985;201503;510;1311;276;841;49;178;85;270;134;448
422000;201503;946;2806;771;2481;183;629;335;1104;518;1733
430003;201503;861;2508;669;2171;187;684;206;642;393;1326
430005;201503;285;910;236;807;43;162;135;451;178;613
430010;201503;2143;5884;1594;4935;399;1298;647;2038;1046;3336
430020;201503;792;2000;657;1807;79;254;463;1224;542;1478
430030;201503;1126;2953;849;2455;288;922;178;460;466;1382
430040;201503;11867;30725;9515;26833;2839;8497;2822;7736;5661;16233
430045;201503;745;2070;593;1762;104;352;332;961;436;1313
430047;201503;275;685;163;496;23;65;71;215;94;280
430050;201503;1165;3136;704;2215;144;492;185;534;329;1026
430055;201503;306;852;183;572;27;94;92;280;119;374
430057;201503;70;156;26;70;5;13;7;13;12;26
430060;201503;15838;51239;13832;47704;3863;14073;6709;23549;10572;37622
430063;201503;1022;3014;824;2596;212;696;398;1286;610;1982
430064;201503;1625;4795;1339;4318;363;1204;610;2010;973;3214
430066;201503;175;442;131;374;15;53;76;203;91;256
430070;201503;593;1594;255;827;59;215;69;185;128;400
430080;201503;700;2064;468;1619;107;417;142;453;249;870
430085;201503;753;2057;519;1644;126;445;197;613;323;1058
430087;201503;1042;3181;989;3079;126;441;711;2157;837;2598
430090;201503;885;2348;327;1087;44;171;60;203;104;374
430100;201503;931;2509;560;1730;150;512;165;442;315;954
430105;201503;860;2652;635;2217;177;721;167;535;344;1256
430107;201503;256;860;195;674;33;131;65;210;98;341
430110;201503;1866;5406;1587;4970;425;1436;734;2241;1159;3677
430120;201503;1702;5048;1304;4219;261;905;697;2204;958;3109
430130;201503;4028;10534;3532;9814;664;1995;1977;5455;2641;7450
430140;201503;1228;3792;889;3045;261;925;294;984;555;1909
430150;201503;873;2311;578;1765;144;482;152;444;296;926
430155;201503;457;1324;291;980;42;145;121;405;163;550
430160;201503;16264;48157;14838;45861;2780;9573;8606;26580;11386;36153
430163;201503;1806;5426;1519;4914;296;1094;760;2473;1056;3567
430165;201503;454;1125;143;463;30;108;44;126;74;234
430170;201503;851;2445;392;1366;74;272;61;177;135;449
430175;201503;969;3061;782;2615;192;591;339;1233;531;1824
430180;201503;956;2607;788;2326;173;581;423;1195;596;1776
430185;201503;787;1961;408;1237;65;211;115;295;180;506
430187;201503;679;2026;517;1675;126;477;183;537;309;1014
430190;201503;1766;5303;1544;4876;309;1125;902;2784;1211;3909
430192;201503;192;591;92;291;7;22;22;59;29;81
430195;201503;316;961;90;323;10;36;7;24;17;60
430200;201503;1714;5504;1453;4955;434;1565;384;1295;818;2860
430205;201503;499;1431;378;1212;47;186;253;790;300;976
430210;201503;6587;17679;3598;11366;754;2590;780;2257;1534;4847
430215;201503;360;1047;255;822;50;174;108;340;158;514
430220;201503;783;1977;314;1027;50;176;57;177;107;353
430222;201503;302;907;234;762;37;156;107;326;144;482
430223;201503;350;1017;307;954;64;201;191;618;255;819
430225;201503;47;126;27;83;6;16;8;20;14;36
430230;201503;1885;5938;1761;5813;189;483;1531;5244;1720;5727
430235;201503;283;929;225;789;61;237;55;176;116;413
430237;201503;525;1409;388;1164;48;175;252;734;300;909
430240;201503;978;2572;647;2001;146;535;262;761;408;1296
430245;201503;946;2957;724;2480;187;662;331;1167;518;1829
430250;201503;1415;3980;1244;3685;514;1611;299;872;813;2483
430258;201503;172;489;125;403;15;58;52;169;67;227
430260;201503;850;2395;580;1849;71;257;309;1005;380;1262
430265;201503;329;1009;261;863;79;256;34;98;113;354
430270;201503;2919;8236;2546;7616;433;1540;1497;4260;1930;5800
430280;201503;4643;12888;3828;11412;923;2934;1774;5242;2697;8176
430290;201503;2466;6562;2268;6309;182;512;1959;5527;2141;6039
430300;201503;9503;28245;7747;24874;2257;7762;3133;10257;5390;18019
430310;201503;7177;22186;5914;19803;1636;6018;2406;7657;4042;13675
430320;201503;879;2569;589;1982;111;331;290;1030;401;1361
430330;201503;783;2100;616;1777;169;500;265;700;434;1200
430340;201503;787;1982;446;1475;88;335;214;706;302;1041
430350;201503;6332;19756;5362;17693;1895;6594;1837;5936;3732;12530
430355;201503;357;895;144;436;30;99;22;50;52;149
430360;201503;1093;2859;909;2518;175;548;440;1134;615;1682
430367;201503;313;811;194;602;45;157;59;178;104;335
430370;201503;506;1456;382;1215;111;395;93;257;204;652
430380;201503;881;2249;468;1488;118;399;171;557;289;956
430390;201503;4540;13043;3244;10398;776;2662;850;2617;1626;5279
430400;201503;1439;3458;1004;2789;304;931;400;1019;704;1950
430410;201503;706;1895;532;1602;95;309;275;834;370;1143
430420;201503;4019;11613;3134;9666;817;2656;1297;3947;2114;6603
430430;201503;836;2282;531;1702;149;514;140;431;289;945
430435;201503;1993;5425;1547;4623;349;1138;779;2309;1128;3447
430440;201503;4288;13350;3372;11337;612;2166;1723;6023;2335;8189
430450;201503;7849;22081;6155;18763;2233;7249;1500;4525;3733;11774
430460;201503;28499;84661;22227;73357;6266;22524;7687;25286;13953;47810
430461;201503;510;1394;175;557;29;105;47;146;76;251
430462;201503;311;885;231;744;87;317;60;175;147;492
430463;201503;4116;13133;3570;12107;820;3044;1769;6018;2589;9062
430465;201503;660;1782;558;1608;121;393;331;922;452;1315
430466;201503;3671;10284;3262;9642;652;2171;1871;5363;2523;7534
430467;201503;584;1744;509;1625;111;388;244;749;355;1137
430468;201503;1467;4183;1284;3911;460;1503;419;1261;879;2764
430469;201503;255;716;66;242;9;38;16;55;25;93
430470;201503;7683;20471;5419;16612;1646;5477;1107;3300;2753;8777
430471;201503;838;2750;754;2577;257;929;188;636;445;1565
430480;201503;1049;2787;558;1782;84;286;135;376;219;662
430485;201503;226;654;113;384;21;77;39;131;60;208
430490;201503;455;1292;313;1028;87;300;111;368;198;668
430495;201503;409;1197;267;894;51;188;69;195;120;383
430500;201503;1354;3760;1097;3318;331;1135;459;1336;790;2471
430510;201503;20281;60764;16665;53814;5777;20502;5009;15177;10786;35679
430511;201503;475;1421;215;735;24;91;35;98;59;189
430512;201503;1232;3210;1071;2939;281;802;385;1097;666;1899
430513;201503;759;2077;488;1500;91;284;217;673;308;957
430515;201503;515;1519;384;1240;68;222;193;625;261;847
430517;201503;1369;4375;1159;3935;235;833;687;2340;922;3173
430520;201503;1619;4545;1169;3611;311;1060;434;1253;745;2313
430530;201503;995;2784;527;1699;90;336;139;398;229;734
430535;201503;2179;6767;1720;5804;404;1570;625;2029;1029;3599
430537;201503;517;1617;438;1455;51;162;319;1084;370;1246
430540;201503;746;1704;512;1397;95;271;308;828;403;1099
430543;201503;537;1396;475;1333;89;276;349;979;438;1255
430544;201503;702;2234;586;1989;119;433;315;1044;434;1477
430545;201503;1312;4232;1128;4006;367;1329;562;2134;929;3463
430550;201503;688;2003;450;1499;104;385;164;538;268;923
430558;201503;88;256;43;150;15;65;6;14;21;79
430560;201503;410;1019;244;725;31;108;83;232;114;340
430570;201503;1166;2983;754;2186;190;637;327;833;517;1470
430580;201503;1268;3353;758;2431;229;780;207;680;436;1460
430583;201503;162;444;55;182;4;15;4;12;8;27
430585;201503;365;961;239;694;63;204;102;271;165;475
430587;201503;229;700;195;635;58;200;67;228;125;428
430590;201503;1383;3866;1312;3754;216;696;932;2636;1148;3332
430593;201503;26;101;23;90;6;32;9;29;15;61
430595;201503;254;696;89;305;19;75;15;47;34;122
430597;201503;357;1046;259;816;49;174;74;197;123;371
430600;201503;2227;6051;1302;4015;260;855;421;1275;681;2130
430605;201503;1358;4137;1079;3570;236;862;454;1529;690;2391
430607;201503;801;2012;594;1692;85;253;368;1068;453;1321
430610;201503;8716;23306;6685;20104;1756;5789;2467;7406;4223;13195
430613;201503;263;643;115;347;27;74;25;63;52;137
430620;201503;765;2206;597;1851;151;521;251;720;402;1241
430630;201503;448;1353;236;776;49;160;38;109;87;269
430632;201503;754;2085;434;1364;82;295;207;605;289;900
430635;201503;704;1932;514;1569;108;361;247;744;355;1105
430637;201503;513;1476;455;1356;66;238;293;833;359;1071
430640;201503;1712;4529;760;2455;73;228;102;226;175;454
430642;201503;509;1343;308;977;57;192;121;377;178;569
430645;201503;195;527;101;318;16;54;29;91;45;145
430650;201503;1905;6234;1642;5708;329;1164;968;3463;1297;4627
430655;201503;203;576;171;510;33;111;72;177;105;288
430660;201503;5777;16398;4538;14215;1167;4028;1834;5699;3001;9727
430670;201503;507;1493;456;1394;35;107;343;1087;378;1194
430673;201503;714;1716;370;1126;80;263;152;446;232;709
430675;201503;289;844;130;421;24;86;49;150;73;236
430676;201503;3487;10594;2995;9757;841;2937;1081;3555;1922;6492
430680;201503;1159;3451;846;2772;171;638;301;881;472;1519
430690;201503;4457;12654;3574;10946;1112;3559;1174;3670;2286;7229
430692;201503;312;1057;225;884;27;112;143;561;170;673
430693;201503;1446;4022;980;3052;174;649;282;787;456;1436
430695;201503;527;1490;378;1198;85;314;140;391;225;705
430697;201503;480;1352;366;1157;102;313;142;486;244;799
430700;201503;9744;25291;4631;15276;876;3224;377;1183;1253;4407
430705;201503;290;887;257;834;83;295;75;227;158;522
430710;201503;1834;4708;1378;3950;306;954;583;1685;889;2639
430720;201503;921;2263;612;1815;168;545;226;673;394;1218
430730;201503;1771;4712;1257;3867;302;908;576;1879;878;2787
430740;201503;591;1640;345;1134;91;325;61;185;152;510
430745;201503;546;1539;327;1011;64;216;75;218;139;434
430750;201503;1805;4965;1437;4329;296;994;712;2045;1008;3039
430755;201503;576;1530;374;1100;46;165;160;413;206;578
430760;201503;3288;8051;2316;6667;441;1458;1121;3348;1562;4806
430770;201503;6742;19462;5254;16722;1000;3515;2763;8687;3763;12202
430780;201503;2435;6515;1455;4608;300;1054;508;1566;808;2620
430781;201503;595;1737;412;1365;103;359;127;402;230;761
430783;201503;547;1360;382;1093;77;251;183;485;260;736
430786;201503;84;272;59;204;11;37;21;73;32;110
430790;201503;4624;12665;3137;9650;661;2307;1232;3508;1893;5815
430800;201503;854;2511;575;1850;125;433;196;596;321;1029
430805;201503;522;1447;371;1178;45;134;212;708;257;842
430807;201503;413;1193;277;886;59;221;78;230;137;451
430810;201503;765;2108;381;1249;62;228;65;185;127;413
430820;201503;1218;3818;873;2946;218;797;258;819;476;1616
430825;201503;439;1177;206;635;34;123;76;205;110;328
430830;201503;2167;6588;1991;6331;204;676;1514;4880;1718;5556
430840;201503;997;3043;905;2866;224;718;433;1417;657;2135
430843;201503;107;315;55;184;8;25;22;74;30;99
430845;201503;349;1054;284;921;110;382;35;105;145;487
430850;201503;2856;8505;2428;7721;604;2098;956;2981;1560;5079
430860;201503;937;2489;547;1824;163;645;145;423;308;1068
430865;201503;690;1845;633;1751;214;621;304;821;518;1442
430870;201503;708;1971;397;1321;104;358;94;287;198;645
430880;201503;1263;3572;933;2939;292;1007;245;795;537;1802
430885;201503;210;575;138;457;31;116;66;209;97;325
430890;201503;1836;4826;1300;3823;93;331;596;1654;689;1985
430900;201503;3000;7929;2565;7199;535;1720;1356;3624;1891;5344
430905;201503;1068;3027;667;2149;179;626;160;495;339;1121
430910;201503;1595;4718;1137;3779;283;1039;442;1363;725;2402
430912;201503;535;1531;434;1356;61;221;265;817;326;1038
430915;201503;499;1617;347;1310;106;424;96;383;202;807
430920;201503;15182;46602;13462;43380;3313;11625;7589;23957;10902;35582
430925;201503;98;267;67;207;16;58;32;96;48;154
430930;201503;9598;28013;6821;22610;1877;6716;1969;6721;3846;13437
430940;201503;1220;3680;750;2518;129;510;216;674;345;1184
430950;201503;1234;3419;836;2598;189;658;312;879;501;1537
430955;201503;150;448;76;246;18;63;21;67;39;130
430957;201503;282;954;227;847;56;228;107;404;163;632
430960;201503;1386;3828;1163;3444;348;1135;450;1359;798;2494
430965;201503;1489;4338;1290;4006;84;317;1060;3269;1144;3586
430970;201503;561;1556;334;1077;69;245;91;279;160;524
430975;201503;666;2156;523;1819;89;335;271;938;360;1273
430980;201503;453;1141;274;871;69;248;99;287;168;535
430990;201503;611;1933;452;1543;123;449;105;322;228;771
430995;201503;630;1851;518;1630;179;589;190;589;369;1178
431000;201503;1746;4524;916;2844;183;639;119;301;302;940
431010;201503;2808;7961;1759;5845;359;1360;465;1369;824;2729
431020;201503;12795;31531;8362;23614;2049;5940;2534;7247;4583;13187
431030;201503;378;1100;200;676;50;190;47;148;97;338
431033;201503;2404;7034;2144;6654;480;1557;1194;3793;1674;5350
431036;201503;217;568;86;301;13;49;19;54;32;103
431040;201503;1016;2875;796;2504;203;714;388;1191;591;1905
431041;201503;562;1552;502;1469;144;429;233;710;377;1139
431043;201503;399;1293;287;1030;135;531;76;241;211;772
431046;201503;121;345;87;272;16;56;30;88;46;144
431050;201503;1830;4606;1403;3895;302;932;782;2107;1084;3039
431053;201503;641;2116;535;1889;167;644;155;554;322;1198
431055;201503;699;1913;644;1820;49;144;487;1378;536;1522
431057;201503;391;1143;237;817;54;197;73;244;127;441
431060;201503;5866;17173;5396;16534;1526;4581;2886;9221;4412;13802
431065;201503;516;1461;415;1267;53;187;251;741;304;928
431070;201503;757;2204;457;1535;94;328;99;300;193;628
431075;201503;296;894;203;691;34;127;61;212;95;339
431080;201503;605;1916;475;1633;112;435;111;367;223;802
431085;201503;946;2528;756;2192;123;397;466;1321;589;1718
431087;201503;637;1827;556;1667;76;220;365;1104;441;1324
431090;201503;545;1333;263;802;81;256;60;174;141;430
431100;201503;4050;11250;3306;9965;853;2766;1279;3881;2132;6647
431110;201503;1595;4211;1185;3396;255;793;549;1494;804;2287
431112;201503;618;1932;584;1877;163;539;291;922;454;1461
431113;201503;521;1508;397;1257;113;377;104;336;217;713
431115;201503;1461;4242;1280;3928;225;732;791;2416;1016;3148
431120;201503;2724;8431;2162;7322;598;2298;863;2777;1461;5075
431123;201503;530;1529;380;1238;79;282;209;689;288;971
431125;201503;1399;4303;1047;3558;302;1026;329;1193;631;2219
431127;201503;228;600;60;199;5;14;4;9;9;23
431130;201503;3584;10179;2719;8656;620;2254;1065;3341;1685;5595
431140;201503;4418;11019;2403;7597;435;1577;554;1511;989;3088
431142;201503;538;1597;478;1487;48;157;326;1034;374;1191
431150;201503;1188;3545;928;3048;206;744;367;1203;573;1947
431160;201503;1016;2991;856;2669;158;498;421;1410;579;1908
431162;201503;511;1343;251;837;33;139;39;104;72;243
431164;201503;164;460;50;185;15;58;2;5;17;63
431170;201503;765;2168;554;1768;157;529;171;538;328;1067
431171;201503;850;2519;726;2271;246;812;190;570;436;1382
431173;201503;508;1491;452;1387;105;341;264;811;369;1152
431175;201503;1119;3163;966;2919;311;989;360;1087;671;2076
431177;201503;884;2880;728;2576;238;940;311;1054;549;1994
431179;201503;355;758;87;259;10;41;20;46;30;87
431180;201503;2315;6708;1635;5265;401;1386;412;1218;813;2604
431190;201503;742;1949;389;1258;74;266;90;287;164;553
431198;201503;390;1272;346;1186;149;542;81;273;230;815
431200;201503;354;1001;113;382;21;70;5;14;26;84
431205;201503;338;1040;184;635;40;129;64;226;104;355
431210;201503;764;2102;651;1897;170;489;363;1082;533;1571
431213;201503;264;805;216;715;58;223;85;262;143;485
431215;201503;335;981;170;575;31;101;15;41;46;142
431217;201503;211;644;162;534;51;176;48;163;99;339
431220;201503;1003;2630;654;1936;83;272;354;985;437;1257
431225;201503;1313;3844;1112;3494;233;768;630;1990;863;2758
431230;201503;895;2618;675;2168;73;256;381;1199;454;1455
431235;201503;100;277;33;100;7;24;7;18;14;42
431237;201503;519;1565;414;1412;122;480;183;614;305;1094
431238;201503;41;129;31;104;7;28;10;32;17;60
431240;201503;2921;8803;2537;8175;862;3008;760;2402;1622;5410
431242;201503;375;1196;335;1125;98;356;86;285;184;641
431244;201503;427;1006;276;765;48;157;141;362;189;519
431245;201503;1073;2847;825;2404;119;370;541;1583;660;1953
431247;201503;205;609;156;511;59;204;51;161;110;365
431250;201503;1654;5202;1439;4903;411;1504;669;2302;1080;3806
431260;201503;355;992;199;668;48;197;56;163;104;360
431261;201503;235;814;203;740;41;171;70;242;111;413
431262;201503;409;1114;179;595;25;110;72;236;97;346
431265;201503;1461;3828;821;2500;166;570;216;543;382;1113
431267;201503;168;475;138;421;27;97;82;241;109;338
431270;201503;2681;6941;1881;5669;481;1576;795;2429;1276;4005
431275;201503;232;714;131;472;36;130;22;68;58;198
431280;201503;283;790;114;387;19;77;23;59;42;136
431290;201503;354;1111;274;919;68;275;62;188;130;463
431295;201503;113;312;59;178;5;18;28;79;33;97
431300;201503;349;894;61;230;15;58;1;3;16;61
431301;201503;214;661;121;407;29;102;22;62;51;164
431303;201503;778;2050;480;1432;82;302;150;402;232;704
431306;201503;2230;5930;1567;4754;205;782;506;1338;711;2120
431308;201503;43;142;39;131;23;81;11;36;34;117
431310;201503;780;2335;495;1691;102;362;151;540;253;902
431320;201503;928;2532;504;1646;110;402;124;371;234;773
431330;201503;2672;6633;1282;4065;374;1317;145;420;519;1737
431333;201503;465;1237;217;648;43;137;66;169;109;306
431335;201503;66;192;50;152;15;45;10;22;25;67
431337;201503;2446;7499;1850;6251;455;1662;392;1226;847;2888
431339;201503;686;1893;472;1430;86;274;214;639;300;913
431340;201503;27766;73458;20080;60257;4719;15591;6191;18028;10910;33619
431342;201503;591;1535;486;1358;136;407;255;690;391;1097
431344;201503;410;1123;300;926;24;70;200;636;224;706
431346;201503;339;895;193;577;54;162;47;137;101;299
431349;201503;710;2047;489;1521;108;347;162;493;270;840
431350;201503;4078;12028;3421;10837;688;2499;1717;5257;2405;7756
431360;201503;741;1944;508;1560;133;430;173;545;306;975
431365;201503;1233;3677;1050;3370;313;1094;472;1545;785;2639
431370;201503;5213;14855;4190;13114;1173;3971;1463;4586;2636;8557
431380;201503;1036;3190;968;3046;144;485;663;2057;807;2542
431390;201503;3240;8622;2018;6283;427;1516;597;1682;1024;3198
431395;201503;1265;3781;1082;3483;255;939;541;1681;796;2620
431400;201503;281;894;154;546;43;162;19;49;62;211
431402;201503;1311;3108;749;2122;149;448;375;1036;524;1484
431403;201503;279;809;196;661;54;202;34;110;88;312
431405;201503;4455;12488;3587;11230;777;2812;1802;5454;2579;8266
431406;201503;824;2520;614;2065;180;646;266;877;446;1523
431407;201503;597;1750;395;1327;109;373;99;299;208;672
431410;201503;14689;42959;10565;34934;3317;12188;1628;5324;4945;17512
431413;201503;222;545;103;325;11;38;39;116;50;154
431415;201503;773;2182;587;1841;127;460;257;742;384;1202
431417;201503;674;1682;541;1494;71;199;318;901;389;1100
431420;201503;1477;4115;1302;3846;274;853;671;2094;945;2947
431430;201503;543;1445;363;1102;69;220;118;323;187;543
431440;201503;24836;70615;20563;63674;5977;19659;7952;25398;13929;45057
431442;201503;144;408;98;294;21;69;13;25;34;94
431445;201503;496;1382;242;758;35;111;94;275;129;386
431446;201503;497;1446;366;1184;78;247;150;493;228;740
431447;201503;740;2084;528;1650;108;366;230;727;338;1093
431449;201503;843;2377;674;2083;87;300;413;1291;500;1591
431450;201503;2183;5549;1946;5198;351;1022;1362;3582;1713;4604
431455;201503;715;1817;401;1139;123;349;107;290;230;639
431460;201503;3490;9741;2997;8822;863;2596;1039;3171;1902;5767
431470;201503;1972;5774;1595;4969;420;1320;646;2063;1066;3383
431475;201503;171;498;41;162;6;24;3;13;9;37
431477;201503;731;1922;497;1465;64;203;289;825;353;1028
431478;201503;262;676;99;297;21;65;23;61;44;126
431480;201503;3001;8351;2263;7024;610;2105;864;2559;1474;4664
431490;201503;112503;308793;97007;285714;12973;45013;67219;193275;80192;238288
431500;201503;830;2205;611;1791;118;343;318;919;436;1262
431505;201503;492;1210;375;1048;39;99;279;814;318;913
431507;201503;337;837;243;662;35;95;163;433;198;528
431510;201503;2169;5972;1744;5219;378;1234;814;2339;1192;3573
431513;201503;292;796;132;427;25;85;62;199;87;284
431514;201503;106;277;39;136;6;29;2;5;8;34
431515;201503;759;2213;522;1630;97;354;191;492;288;846
431517;201503;82;262;74;243;22;76;23;65;45;141
431520;201503;439;1283;272;868;42;152;71;216;113;368
431530;201503;4360;10467;3339;9274;1074;3180;1275;3742;2349;6922
431531;201503;294;835;193;627;44;149;74;243;118;392
431532;201503;518;1465;449;1321;126;395;188;546;314;941
431535;201503;367;982;184;558;33;105;57;148;90;253
431540;201503;2186;7138;1938;6783;226;763;1333;4954;1559;5717
431545;201503;298;811;56;184;6;22;9;38;15;60
431550;201503;2347;6872;2103;6448;404;1420;1079;3224;1483;4644
431555;201503;723;1853;582;1630;132;356;334;964;466;1320
431560;201503;19375;59314;14351;49387;3995;15216;3914;13989;7909;29205
431570;201503;5417;15160;4793;14178;1350;4105;2388;7184;3738;11289
431575;201503;451;1156;318;932;52;182;97;258;149;440
431580;201503;679;1935;438;1410;97;356;155;448;252;804
431590;201503;1004;2765;681;2117;88;281;311;966;399;1247
431595;201503;509;1469;402;1247;87;276;173;528;260;804
431600;201503;2153;6156;1544;4968;328;1242;346;979;674;2221
431610;201503;1563;4613;1210;3914;268;899;521;1683;789;2582
431620;201503;450;1363;239;785;64;221;99;303;163;524
431630;201503;1517;4072;1044;3117;281;874;414;1229;695;2103
431640;201503;6135;17806;5502;16827;1175;4084;3116;9383;4291;13467
431642;201503;508;1406;414;1236;56;199;209;602;265;801
431643;201503;178;454;148;403;21;65;74;176;95;241
431645;201503;1825;5285;1593;4910;316;1052;920;2815;1236;3867
431647;201503;182;523;123;381;30;98;29;77;59;175
431650;201503;293;917;210;749;35;145;51;154;86;299
431660;201503;1228;3424;782;2508;187;665;204;564;391;1229
431670;201503;1367;3649;1036;3054;232;764;456;1273;688;2037
431673;201503;228;652;137;456;28;110;35;102;63;212
431675;201503;624;1703;188;636;30;111;46;130;76;241
431680;201503;10294;27939;7629;23176;2081;6851;2212;6714;4293;13565
431690;201503;26023;72796;20633;64080;5855;19577;8035;25526;13890;45103
431695;201503;135;428;96;329;22;82;23;49;45;131
431697;201503;468;1328;408;1216;103;312;190;581;293;893
431700;201503;1625;4589;1379;4112;250;797;765;2238;1015;3035
431710;201503;12971;37875;10556;33786;3409;11715;3094;10223;6503;21938
431720;201503;7334;20342;5746;17342;1224;4105;2601;7685;3825;11790
431725;201503;12;35;9;29;2;8;4;11;6;19
431730;201503;3967;11851;3166;10361;883;3217;912;3043;1795;6260
431740;201503;5283;15132;4386;13480;1496;5066;990;2781;2486;7847
431750;201503;9904;28052;8495;25802;1791;5889;4407;13683;6198;19572
431755;201503;315;840;61;219;7;26;10;30;17;56
431760;201503;3884;11343;3148;9980;741;2581;1098;3325;1839;5906
431770;201503;2139;5749;1771;5169;365;1124;989;2858;1354;3982
431775;201503;228;615;163;493;59;198;34;86;93;284
431780;201503;2513;6737;1925;5656;522;1658;508;1408;1030;3066
431790;201503;1266;3919;1067;3530;205;724;614;2075;819;2799
431795;201503;412;1181;281;872;46;154;99;305;145;459
431800;201503;9090;26859;7334;23537;2334;8130;1777;5479;4111;13609
431805;201503;325;779;97;327;13;51;17;60;30;111
431810;201503;3681;10197;2909;8641;568;1835;1350;3934;1918;5769
431820;201503;2709;8441;2339;7699;552;1971;919;2944;1471;4915
431830;201503;11065;27564;8618;23923;2530;7618;3351;9320;5881;16938
431840;201503;2814;8396;2435;7742;625;2186;1119;3550;1744;5736
431842;201503;806;2019;393;1179;72;252;121;316;193;568
431843;201503;344;1001;295;917;43;153;165;495;208;648
431844;201503;227;604;121;402;22;87;38;113;60;200
431845;201503;523;1547;438;1374;43;146;296;934;339;1080
431846;201503;447;1321;375;1200;55;208;244;772;299;980
431848;201503;210;578;117;395;24;95;18;56;42;151
431849;201503;431;1057;103;316;23;73;22;52;45;125
431850;201503;5041;14612;4411;13418;1082;3505;1868;5637;2950;9142
431860;201503;835;2203;620;1835;88;309;365;1034;453;1343
431861;201503;98;303;61;217;10;34;9;28;19;62
431862;201503;464;1531;373;1341;118;478;88;290;206;768
431870;201503;19770;56418;15266;48333;4029;13979;4999;15608;9028;29587
431880;201503;4476;13374;3583;11513;867;3074;1502;4706;2369;7780
431890;201503;5384;14590;4096;12363;1314;4230;1227;3763;2541;7993
431900;201503;1103;3163;764;2504;214;814;289;838;503;1652
431910;201503;1030;2442;485;1398;85;269;171;451;256;720
431912;201503;624;1777;483;1513;151;463;160;532;311;995
431915;201503;1477;3978;1126;3365;270;883;441;1308;711;2191
431920;201503;1395;3895;1247;3680;134;370;998;3000;1132;3370
431930;201503;1357;3718;1019;3176;214;637;547;1831;761;2468
431935;201503;74;229;60;200;16;59;22;65;38;124
431936;201503;405;1193;313;987;47;135;175;594;222;729
431937;201503;335;856;187;557;44;140;36;90;80;230
431940;201503;2711;7365;1774;5513;442;1490;487;1456;929;2946
431950;201503;1665;5148;1447;4767;310;1150;660;2078;970;3228
431960;201503;3155;9314;2817;8662;737;2473;973;2942;1710;5415
431970;201503;514;1396;265;844;40;148;72;206;112;354
431971;201503;119;332;90;283;16;51;34;93;50;144
431973;201503;491;1707;431;1581;51;193;274;1053;325;1246
431975;201503;95;211;17;63;5;23;3;10;8;33
431980;201503;1435;4173;1207;3716;288;984;411;1178;699;2162
431990;201503;8296;22865;6280;19531;1174;4238;2335;6816;3509;11054
432000;201503;10569;29785;8334;25907;2623;8600;3049;9433;5672;18033
432010;201503;2361;6759;1950;6005;448;1500;923;2795;1371;4295
432020;201503;2389;5886;1891;5244;228;710;1343;3698;1571;4408
432023;201503;558;1603;380;1216;87;325;122;353;209;678
432026;201503;1312;3934;980;3234;165;571;543;1790;708;2361
432030;201503;426;1240;325;1016;65;210;154;455;219;665
432032;201503;594;1558;403;1204;75;249;207;585;282;834
432035;201503;831;2577;729;2389;129;461;457;1476;586;1937
432040;201503;958;2278;478;1497;109;391;129;351;238;742
432045;201503;240;732;152;555;35;139;58;223;93;362
432050;201503;688;1925;591;1748;93;284;358;1086;451;1370
432055;201503;864;2614;712;2310;137;488;421;1325;558;1813
432057;201503;429;1087;330;915;39;113;223;590;262;703
432060;201503;479;1332;207;705;45;171;46;140;91;311
432065;201503;232;660;182;569;43;145;74;221;117;366
432067;201503;1004;3120;725;2504;160;579;368;1273;528;1852
432070;201503;2438;6657;1654;5103;429;1508;470;1326;899;2834
432080;201503;3778;10891;3247;9938;970;3153;1276;3862;2246;7015
432085;201503;317;898;217;732;47;188;107;354;154;542
432090;201503;1503;4385;1212;3780;417;1396;430;1243;847;2639
432100;201503;1293;3756;695;2366;163;589;98;259;261;848
432110;201503;2761;8338;2091;6943;556;2072;303;872;859;2944
432120;201503;5254;15578;4443;14167;1639;5550;1432;4564;3071;10114
432130;201503;2557;7130;2044;6464;664;2296;887;2809;1551;5105
432132;201503;460;1307;236;794;26;98;88;282;114;380
432135;201503;725;2251;696;2197;96;339;515;1595;611;1934
432140;201503;2134;6684;1720;5894;423;1534;756;2668;1179;4202
432143;201503;1417;4217;1196;3855;268;883;648;2162;916;3045
432145;201503;1099;3369;689;2402;143;552;122;381;265;933
432146;201503;233;741;165;581;41;160;42;140;83;300
432147;201503;657;2075;498;1728;129;466;183;665;312;1131
432149;201503;372;1077;228;728;54;182;91;296;145;478
432150;201503;3823;10709;2827;8920;683;2411;897;2678;1580;5089
432160;201503;4335;13766;3793;12860;1195;4272;1510;5322;2705;9594
432162;201503;407;990;86;281;14;53;19;54;33;107
432163;201503;392;1029;96;304;5;17;8;23;13;40
432166;201503;729;2146;591;1863;89;338;310;919;399;1257
432170;201503;993;3174;651;2414;132;491;125;447;257;938
432180;201503;3021;7954;2087;6356;592;1935;595;1776;1187;3711
432183;201503;446;1408;364;1243;167;596;71;240;238;836
432185;201503;935;2531;579;1860;116;418;258;815;374;1233
432190;201503;3436;9419;2365;7071;592;1860;682;1880;1274;3740
432195;201503;1240;3420;1047;3139;140;463;711;2105;851;2568
432200;201503;3378;10115;2709;8965;692;2494;1243;4195;1935;6689
432210;201503;446;1228;339;1058;73;276;171;488;244;764
432215;201503;893;2762;765;2559;137;433;480;1704;617;2137
432218;201503;297;799;220;650;38;121;95;257;133;378
432220;201503;4280;11275;3519;10106;364;1225;2367;6706;2731;7931
432225;201503;66;213;55;195;24;85;15;51;39;136
432230;201503;1118;3017;684;2067;173;580;214;542;387;1122
432232;201503;548;1582;430;1358;105;371;180;560;285;931
432234;201503;423;1163;284;847;64;197;101;289;165;486
432235;201503;79;230;45;153;10;47;6;16;16;63
432237;201503;481;1336;441;1274;25;103;349;982;374;1085
432240;201503;14369;46247;12228;43403;2179;8975;7345;26698;9524;35673
432250;201503;5004;17180;4582;16338;1712;6687;1451;5186;3163;11873
432252;201503;388;1142;297;982;67;241;159;524;226;765
432253;201503;1338;4261;934;3266;279;1025;233;826;512;1851
432254;201503;785;2121;238;779;53;184;32;88;85;272
432255;201503;239;614;131;434;34;118;42;138;76;256
432260;201503;7629;19136;5313;15345;1214;3622;2217;6618;3431;10240
432270;201503;2619;7798;2213;7106;612;2025;949;3140;1561;5165
432280;201503;1291;3576;682;2223;122;429;158;446;280;875
432285;201503;179;571;57;198;14;57;11;29;25;86
432290;201503;595;1783;392;1311;96;328;132;438;228;766
432300;201503;23598;70606;20926;66050;4414;15142;11728;36755;16142;51897
432310;201503;846;2513;681;2233;140;524;370;1179;510;1703
432320;201503;258;660;127;399;28;85;27;77;55;162
432330;201503;316;843;126;424;15;49;11;33;26;82
432335;201503;215;627;97;335;22;83;9;25;31;108
432340;201503;359;894;170;520;33;108;55;162;88;270
432345;201503;680;1883;622;1788;92;344;375;987;467;1331
432350;201503;438;1184;251;826;57;200;76;228;133;428
432360;201503;165;499;32;112;8;37;10;26;18;63
432370;201503;454;1283;360;1097;33;92;242;764;275;856
432375;201503;821;2080;643;1795;90;265;384;1089;474;1354
432377;201503;173;554;48;158;6;23;15;34;21;57
432380;201503;851;2884;757;2706;302;1207;265;862;567;2069
500020;201503;2265;6854;1710;5815;409;1623;650;2061;1059;3684
500025;201503;1201;2906;778;2172;108;308;430;1182;538;1490
500060;201503;6700;19707;5346;17489;756;2551;3488;11877;4244;14428
500070;201503;4089;12023;3440;10897;746;2741;1606;5011;2352;7752
500080;201503;1644;4794;1211;4022;350;1293;434;1479;784;2772
500085;201503;2250;5924;1640;5000;189;633;963;2820;1152;3453
500090;201503;2396;6890;1809;5837;374;1263;877;2907;1251;4170
500100;201503;2527;7483;2261;7048;588;2160;1085;3212;1673;5372
500110;201503;8558;25029;6877;22447;1122;3929;3806;13187;4928;17116
500124;201503;2004;6394;1731;5949;296;989;1005;3763;1301;4752
500150;201503;1426;3577;1040;2958;211;714;475;1177;686;1891
500190;201503;4883;12654;3805;11255;699;2231;2218;6755;2917;8986
500200;201503;2523;6395;1952;5430;277;890;1138;3126;1415;4016
500210;201503;4869;14496;4100;13298;903;3125;2076;6850;2979;9975
500215;201503;1666;5098;1353;4499;257;953;551;1764;808;2717
500220;201503;2889;9123;2390;8241;522;1931;896;3171;1418;5102
500230;201503;2688;6887;2026;5911;522;1669;895;2643;1417;4312
500240;201503;4760;14772;3408;12024;567;2201;1318;4912;1885;7113
500260;201503;2687;6952;2019;5881;315;1015;1005;2776;1320;3791
500270;201503;120171;309066;77631;236325;19717;65265;19004;57258;38721;122523
500280;201503;1407;3871;1183;3574;115;364;883;2723;998;3087
500290;201503;4180;10031;2560;7539;624;2128;803;2132;1427;4260
500295;201503;2595;7720;1760;5758;337;1241;452;1271;789;2512
500310;201503;807;2100;685;1923;157;512;325;854;482;1366
500315;201503;3166;9836;2663;9093;441;1566;1712;6079;2153;7645
500320;201503;15796;50826;12934;45571;3988;15088;4366;16328;8354;31416
500325;201503;4059;10488;2983;8803;662;2141;1474;4270;2136;6411
500330;201503;6386;17135;4844;14341;982;3183;2419;7059;3401;10242
500345;201503;2191;5796;1717;5042;271;916;1007;2897;1278;3813
500348;201503;2369;6770;2077;6309;165;613;1584;4762;1749;5375
500350;201503;1256;3812;789;2758;123;475;247;871;370;1346
500370;201503;23132;70120;17631;59897;4070;15493;5677;19305;9747;34798
500375;201503;2928;8041;2164;6596;526;1732;818;2524;1344;4256
500380;201503;2926;8311;2436;7459;759;2411;884;2736;1643;5147
500390;201503;609;1286;386;979;36;113;275;661;311;774
500400;201503;1335;4051;1014;3295;240;863;298;885;538;1748
500410;201503;2262;6323;1801;5640;481;1673;835;2587;1316;4260
500430;201503;2478;7105;1963;6370;402;1484;909;3013;1311;4497
500440;201503;1404;3824;1069;3287;210;720;539;1610;749;2330
500450;201503;1977;6043;1519;5161;328;1262;302;894;630;2156
500460;201503;3580;10912;2880;9580;806;3002;734;2365;1540;5367
500470;201503;2996;8863;2145;7018;595;2144;331;967;926;3111
500480;201503;1926;6235;1800;6066;164;549;1486;5130;1650;5679
500490;201503;1016;2811;801;2440;229;779;250;765;479;1544
500500;201503;3622;11266;2858;10097;1112;4443;836;2929;1948;7372
500510;201503;854;2214;546;1676;82;280;245;690;327;970
500515;201503;1868;4981;1541;4548;242;696;925;2999;1167;3695
500520;201503;3015;10314;2689;9849;485;1910;1728;6521;2213;8431
500525;201503;1208;3860;978;3414;206;772;465;1703;671;2475
500540;201503;6002;16707;3600;12113;1063;4185;570;1690;1633;5875
500560;201503;4675;15323;4259;14712;610;2313;3084;10693;3694;13006
500568;201503;3949;10087;2802;8414;591;2056;1236;3533;1827;5589
500570;201503;7440;19947;5017;15485;1399;4641;1354;4048;2753;8689
500580;201503;3629;10412;2914;9203;329;1123;2027;6423;2356;7546
500600;201503;3670;9893;2513;7751;575;1942;941;2890;1516;4832
500620;201503;8317;23168;6117;19278;1230;4315;2856;9036;4086;13351
500625;201503;751;2254;471;1621;103;393;145;482;248;875
500627;201503;497;1452;389;1261;79;259;123;433;202;692
500630;201503;6056;16620;4545;14178;1260;4382;1498;4538;2758;8920
500635;201503;2602;10012;2174;9329;326;1311;1365;6448;1691;7759
500640;201503;1659;3994;1280;3461;100;318;949;2539;1049;2857
500660;201503;18240;52969;14332;46518;4148;15238;4940;15885;9088;31123
500690;201503;2967;8471;2369;7690;915;3073;825;2934;1740;6007
500710;201503;3661;10869;3110;9954;650;2341;1565;4952;2215;7293
500720;201503;5903;15845;3847;12226;1069;3732;1077;3334;2146;7066
500730;201503;971;2725;707;2203;171;607;240;702;411;1309
500740;201503;3850;10723;3120;9360;474;1728;1399;4186;1873;5914
500750;201503;845;2402;769;2308;158;495;494;1538;652;2033
500755;201503;1235;3592;868;2830;196;719;280;795;476;1514
500769;201503;4992;13330;3085;9384;603;2105;751;1900;1354;4005
500770;201503;1784;5277;1347;4466;378;1391;421;1412;799;2803
500780;201503;1023;3018;853;2698;222;772;323;953;545;1725
500790;201503;9134;25444;7681;22937;1398;4854;4253;12242;5651;17096
500793;201503;2293;6626;1825;5860;405;1463;682;2011;1087;3474
500795;201503;2481;7243;2124;6753;256;681;1603;5421;1859;6102
500797;201503;869;2346;631;1943;105;358;255;751;360;1109
500800;201503;2697;7413;2107;6601;823;2933;659;2090;1482;5023
500830;201503;16804;46743;11790;37002;2723;9504;3636;10804;6359;20308
500840;201503;1385;3868;991;3099;140;482;451;1370;591;1852
510010;201503;1214;3738;1053;3466;313;1047;499;1697;812;2744
510020;201503;3170;9145;2087;6977;483;1753;635;2026;1118;3779
510025;201503;7969;23308;6649;20997;1568;5576;2816;8403;4384;13979
510030;201503;1765;4899;1473;4433;371;1278;638;1776;1009;3054
510035;201503;855;2465;691;2232;121;394;422;1398;543;1792
510040;201503;1714;4689;1324;4112;252;886;709;2198;961;3084
510050;201503;1891;5525;1380;4560;374;1354;458;1495;832;2849
510060;201503;1463;4196;1109;3564;247;850;404;1273;651;2123
510080;201503;1161;3599;917;3134;291;1110;209;638;500;1748
510100;201503;679;1811;473;1409;58;193;209;581;267;774
510120;201503;321;674;188;508;20;56;117;320;137;376
510125;201503;3149;8300;2507;7166;454;1604;1104;2935;1558;4539
510130;201503;1890;5156;1557;4645;404;1274;621;1848;1025;3122
510140;201503;2999;9605;2401;8669;953;3829;571;1846;1524;5675
510160;201503;1364;4568;1265;4439;123;494;992;3487;1115;3981
510170;201503;5689;17097;4677;15331;932;3449;2242;7112;3174;10561
510180;201503;11855;31172;8470;25817;2418;7772;2844;9546;5262;17318
510185;201503;1384;4055;1140;3742;162;488;775;2799;937;3287
510190;201503;2167;6532;1522;5533;382;1536;632;2381;1014;3917
510250;201503;13923;42823;11963;40011;3500;12725;5315;18222;8815;30947
510260;201503;2276;9059;2014;8519;632;2866;798;3715;1430;6581
510263;201503;4280;11475;3096;9530;785;2600;984;2914;1769;5514
510267;201503;5626;16200;4084;12961;963;3325;1245;3740;2208;7065
510268;201503;840;2446;719;2273;158;528;395;1268;553;1796
510269;201503;993;3028;767;2599;259;921;248;859;507;1780
510270;201503;2642;8427;2327;7850;401;1416;1235;4243;1636;5659
510279;201503;2008;6241;1741;5759;524;1899;569;1730;1093;3629
510285;201503;1419;4206;1118;3674;287;1034;419;1314;706;2348
510300;201503;3328;9821;2798;9054;219;847;2192;7115;2411;7962
510305;201503;1525;4687;1195;4052;310;1145;363;1203;673;2348
510310;201503;859;2603;722;2350;240;852;234;728;474;1580
510320;201503;3807;11050;2944;9426;858;3158;630;1850;1488;5008
510325;201503;5333;16952;4586;15943;1031;3685;2997;10710;4028;14395
510330;201503;2836;9032;2337;8148;582;2280;882;3038;1464;5318
510335;201503;4666;14397;3973;13500;610;2073;2792;9998;3402;12071
510336;201503;569;1724;446;1487;100;371;219;712;319;1083
510337;201503;2167;7103;1815;6429;726;2600;508;1982;1234;4582
510340;201503;67231;190972;51699;166756;18996;67474;11327;38167;30323;105641
510343;201503;1098;3236;970;3063;90;282;785;2555;875;2837
510345;201503;1667;4934;1375;4405;325;1123;496;1500;821;2623
510350;201503;3485;9603;2736;8579;664;2192;1350;4422;2014;6614
510360;201503;1805;4486;1197;3736;144;548;833;2529;977;3077
510370;201503;1028;3571;914;3405;206;815;553;2093;759;2908
510380;201503;539;1658;386;1364;158;616;59;187;217;803
510385;201503;980;3622;736;3053;116;505;346;1546;462;2051
510390;201503;1131;3452;1036;3337;266;699;656;2357;922;3056
510395;201503;847;2127;652;1865;107;337;311;1009;418;1346
510410;201503;3881;12692;3503;11970;845;3073;1897;6556;2742;9629
510420;201503;2396;6187;1767;5144;217;769;949;2725;1166;3494
510450;201503;601;1636;447;1406;107;394;184;563;291;957
510452;201503;624;2041;450;1633;98;387;188;663;286;1050
510454;201503;835;2671;729;2488;118;421;465;1640;583;2061
510455;201503;978;2997;736;2514;165;663;240;776;405;1439
510460;201503;2216;5870;1748;5216;231;839;1104;3176;1335;4015
510480;201503;4580;12265;3298;9926;826;2631;834;2348;1660;4979
510490;201503;1423;4630;1263;4392;258;1044;776;2618;1034;3662
510500;201503;1520;4539;1059;3626;269;1076;437;1434;706;2510
510510;201503;2748;9591;2404;8994;797;3285;932;3434;1729;6719
510515;201503;6268;19292;4859;16201;1156;4303;1252;3916;2408;8219
510517;201503;1772;5242;1504;4797;491;1636;620;2036;1111;3672
510520;201503;2129;5097;1561;4372;77;262;1152;3334;1229;3596
510523;201503;1045;3123;909;2901;155;514;589;1914;744;2428
510525;201503;7799;19860;5161;15780;1108;3609;1976;6008;3084;9617
510530;201503;536;1527;453;1415;68;282;273;814;341;1096
510550;201503;2559;8489;2165;7771;626;2417;827;2995;1453;5412
510558;201503;2037;5867;1694;5368;398;1385;822;2643;1220;4028
510560;201503;1684;5340;1168;4448;355;1490;297;1143;652;2633
510562;201503;5243;15689;4228;13681;1284;4664;1295;4200;2579;8864
510590;201503;2922;7762;2362;7055;590;1836;1165;3568;1755;5404
510600;201503;1546;3987;1022;3126;188;628;428;1215;616;1843
510610;201503;2793;7992;2396;7444;186;672;1921;5994;2107;6666
510615;201503;2294;7068;1942;6515;579;2080;908;3103;1487;5183
510617;201503;596;1792;487;1596;51;167;367;1246;418;1413
510618;201503;1434;4163;1033;3389;218;851;455;1411;673;2262
510619;201503;812;2217;505;1663;80;291;100;285;180;576
510620;201503;1462;3654;816;2647;241;893;171;498;412;1391
510621;201503;990;3450;878;3214;237;957;315;1096;552;2053
510622;201503;3827;11603;2628;9019;666;2513;373;1034;1039;3547
510623;201503;3503;10000;2830;8808;788;2649;1188;3578;1976;6227
510624;201503;1342;4049;981;3353;214;851;349;1084;563;1935
510625;201503;2231;6454;1767;5663;482;1720;429;1312;911;3032
510626;201503;1486;4130;1033;3508;328;1257;423;1450;751;2707
510627;201503;768;2171;508;1628;136;484;127;403;263;887
510628;201503;1619;4003;1174;3402;117;373;870;2522;987;2895
510629;201503;1849;5935;1523;5229;450;1731;513;1681;963;3412
510630;201503;2570;8650;2025;7583;582;2476;467;1758;1049;4234
510631;201503;393;1128;358;1074;51;153;250;748;301;901
510637;201503;2706;7844;2328;7231;595;2010;1098;3373;1693;5383
510642;201503;4725;15541;4091;14638;1192;4648;1960;7303;3152;11951
510645;201503;955;2160;613;1699;196;555;216;634;412;1189
510650;201503;6190;20875;5672;20251;1174;4216;3844;14403;5018;18619
510665;201503;1294;3529;877;2741;238;791;281;840;519;1631
510670;201503;395;915;221;662;32;123;96;268;128;391
510675;201503;6326;20139;5157;17841;1568;6185;1294;4205;2862;10390
510677;201503;2194;5780;1748;5201;222;674;1279;3964;1501;4638
510680;201503;792;2394;633;2095;126;458;242;745;368;1203
510682;201503;2312;7199;1787;6222;464;1819;477;1561;941;3380
510685;201503;949;2533;790;2320;75;256;586;1700;661;1956
510700;201503;4360;11381;3023;9479;665;2188;1589;5099;2254;7287
510704;201503;8732;23469;7240;21108;1472;4809;3940;11254;5412;16063
510706;201503;1880;5699;1374;4902;323;1192;714;2628;1037;3820
510710;201503;3507;9784;2534;7819;653;2137;658;1801;1311;3938
510715;201503;661;1676;414;1214;86;282;159;424;245;706
510718;201503;1886;5162;1465;4694;610;2014;552;1869;1162;3883
510719;201503;451;1022;278;792;35;142;120;308;155;450
510720;201503;1317;3108;992;2725;164;495;649;1792;813;2287
510724;201503;817;2479;679;2225;148;544;344;1060;492;1604
510726;201503;657;1741;504;1494;107;340;202;567;309;907
510729;201503;752;1912;489;1463;117;389;211;629;328;1018
510730;201503;2421;7349;2041;6673;518;1920;838;2595;1356;4515
510735;201503;1122;3741;898;3375;215;897;454;1698;669;2595
510740;201503;1131;2782;827;2339;206;576;443;1309;649;1885
510757;201503;655;2234;553;2026;171;659;216;809;387;1468
510760;201503;28655;75986;20572;62518;6083;20078;6236;18734;12319;38812
510770;201503;4396;11492;3803;10796;386;1037;2619;8346;3005;9383
510774;201503;434;1194;364;1087;78;276;172;527;250;803
510775;201503;783;2250;654;2042;224;760;225;693;449;1453
510776;201503;501;1399;401;1210;90;296;192;575;282;871
510777;201503;1639;4828;1222;4258;169;650;920;3228;1089;3878
510779;201503;700;2047;518;1722;84;304;228;767;312;1071
510780;201503;3737;11147;3162;10275;755;2557;1537;5238;2292;7795
510785;201503;1803;5301;1445;4685;486;1665;405;1331;891;2996
510787;201503;2086;6352;1684;5650;611;2170;407;1285;1018;3455
510788;201503;500;1346;376;1157;165;498;99;340;264;838
510790;201503;15689;45641;10703;36128;2607;10173;1267;4060;3874;14233
510792;201503;7101;21880;5150;18088;1174;4756;1113;3595;2287;8351
510794;201503;1230;3866;1021;3514;382;1439;277;861;659;2300
510795;201503;8602;26281;6358;21929;1777;6772;1584;5529;3361;12301
510800;201503;1728;4832;1389;4367;354;1237;611;1802;965;3039
510805;201503;1892;5359;1579;4911;146;466;1221;3845;1367;4311
510810;201503;694;1698;541;1497;145;417;264;701;409;1118
510820;201503;777;1845;534;1481;102;328;220;546;322;874
510830;201503;617;2019;530;1885;157;596;257;987;414;1583
510835;201503;655;1992;492;1667;145;555;172;521;317;1076
510840;201503;49927;122175;39070;108483;8689;25463;20382;58507;29071;83970
510850;201503;1445;4163;1102;3586;384;1420;198;505;582;1925
510860;201503;2484;8142;1874;6855;678;2684;200;735;878;3419
510880;201503;691;2270;595;2106;176;672;270;989;446;1661
510885;201503;614;1718;492;1551;83;302;220;691;303;993
510890;201503;844;2713;699;2474;238;958;234;728;472;1686
510895;201503;1110;3479;948;3168;262;1002;408;1296;670;2298
520005;201503;1240;4034;1131;3863;334;1185;526;1843;860;3028
520010;201503;1690;5729;1406;5131;549;2292;295;967;844;3259
520013;201503;3748;10315;2813;8645;644;2080;1129;3464;1773;5544
520015;201503;492;1393;395;1250;103;352;160;515;263;867
520017;201503;1114;3362;943;3086;255;929;380;1172;635;2101
520020;201503;395;1053;308;928;71;225;150;460;221;685
520025;201503;24935;78687;24020;77637;2392;8206;20155;65505;22547;73711
520030;201503;4463;14183;3848;13231;905;3422;1863;6453;2768;9875
520050;201503;331;904;272;807;24;73;196;585;220;658
520055;201503;769;2321;652;2090;126;393;336;1114;462;1507
520060;201503;1418;4420;1223;4026;259;981;510;1606;769;2587
520080;201503;1711;5188;1477;4856;340;1089;829;2882;1169;3971
520082;201503;861;2590;773;2444;146;416;474;1614;620;2030
520085;201503;965;2967;825;2695;179;615;283;915;462;1530
520090;201503;956;2234;710;1915;156;374;379;1099;535;1473
520110;201503;41457;121043;32471;107503;12074;45226;7440;24177;19514;69403
520120;201503;257;664;152;483;36;133;35;111;71;244
520130;201503;3486;9981;3179;9529;653;2129;1850;5540;2503;7669
520140;201503;42985;139427;37774;129761;13293;49936;9228;31013;22521;80949
520145;201503;433;1141;335;999;76;239;147;424;223;663
520150;201503;654;1753;538;1618;136;439;290;865;426;1304
520160;201503;809;2316;669;2106;213;713;207;651;420;1364
520170;201503;3990;9461;3196;8569;299;840;2567;7013;2866;7853
520180;201503;1915;5735;1600;5235;383;1455;657;2091;1040;3546
520215;201503;1889;4919;1601;4479;223;648;1019;2892;1242;3540
520235;201503;759;1997;573;1727;137;463;263;762;400;1225
520250;201503;1277;3984;1052;3599;304;1145;437;1498;741;2643
520260;201503;785;2028;549;1593;84;260;244;684;328;944
520280;201503;527;1556;486;1499;192;630;169;585;361;1215
520310;201503;1126;2755;858;2375;209;561;407;1247;616;1808
520320;201503;1748;5476;1444;4893;159;564;919;3201;1078;3765
520330;201503;2737;8479;2108;7398;643;2521;402;1316;1045;3837
520340;201503;1802;4573;1387;4073;182;464;1041;3222;1223;3686
520350;201503;2863;8180;2365;7256;621;2154;1089;3190;1710;5344
520355;201503;1089;3672;991;3516;346;1340;401;1377;747;2717
520357;201503;788;2161;674;1983;51;168;501;1461;552;1629
520360;201503;634;1834;568;1725;113;357;285;890;398;1247
520380;201503;1288;3488;882;2726;177;597;366;1111;543;1708
520390;201503;1000;2459;626;1953;153;583;259;731;412;1314
520393;201503;567;1439;466;1291;64;185;307;848;371;1033
520396;201503;737;2362;631;2156;81;317;435;1495;516;1812
520400;201503;1719;4899;1477;4571;232;792;988;3044;1220;3836
520410;201503;1494;3758;1117;3258;264;837;606;1755;870;2592
520420;201503;336;947;249;770;49;166;76;210;125;376
520425;201503;1177;3232;1026;2962;274;844;543;1552;817;2396
520430;201503;2058;5373;1332;4050;293;1014;471;1296;764;2310
520440;201503;3631;9345;2500;7419;782;2554;641;1891;1423;4445
520450;201503;10266;29023;7442;23865;1929;6818;1094;3230;3023;10048
520455;201503;678;2038;552;1824;184;666;177;588;361;1254
520460;201503;864;2483;702;2207;141;510;346;1041;487;1551
520465;201503;788;2189;679;2056;133;459;389;1156;522;1615
520470;201503;1777;5745;1605;5478;347;1170;1056;3781;1403;4951
520480;201503;954;2756;756;2442;135;476;398;1252;533;1728
520485;201503;1245;3959;1076;3673;319;1215;555;1874;874;3089
520490;201503;3844;12160;3102;10975;991;3669;1337;4851;2328;8520
520495;201503;1266;3568;1100;3356;99;316;920;2835;1019;3151
520500;201503;1466;4166;1304;3928;397;1261;584;1763;981;3024
520505;201503;845;2376;724;2202;171;551;416;1280;587;1831
520510;201503;10446;29198;7225;23951;1966;7197;1992;6666;3958;13863
520520;201503;1028;2913;826;2615;271;917;312;995;583;1912
520530;201503;2141;6969;1829;6444;479;1713;848;3194;1327;4907
520540;201503;3002;8515;2317;7262;620;2078;675;2089;1295;4167
520545;201503;1143;3445;951;3056;219;757;312;957;531;1714
520547;201503;721;2282;622;2101;229;816;207;672;436;1488
520549;201503;9567;27623;7884;25548;2342;8008;3943;12941;6285;20949
520551;201503;3399;10377;3181;10102;806;2765;2002;6365;2808;9130
520552;201503;770;2379;718;2309;112;405;494;1594;606;1999
520570;201503;531;1545;384;1284;151;541;84;264;235;805
520580;201503;3077;8011;2156;6659;653;2272;788;2343;1441;4615
520590;201503;1451;4061;1168;3595;278;902;359;1036;637;1938
520620;201503;7038;22403;6420;21500;1365;4874;3963;13396;5328;18270
520630;201503;733;1943;550;1666;121;372;260;792;381;1164
520640;201503;2762;7786;2304;7051;684;2198;979;3079;1663;5277
520650;201503;829;2295;640;1932;166;557;298;887;464;1444
520660;201503;353;1063;289;964;101;365;93;304;194;669
520670;201503;869;2640;799;2537;51;146;698;2257;749;2403
520680;201503;625;1768;511;1611;132;424;241;780;373;1204
520690;201503;389;995;271;822;54;143;127;423;181;566
520710;201503;521;1337;346;1006;12;36;196;566;208;602
520725;201503;1693;4299;1280;3686;288;905;713;2034;1001;2939
520735;201503;743;2133;558;1769;142;516;187;571;329;1087
520740;201503;1676;4802;1375;4399;289;1041;695;2172;984;3213
520750;201503;626;1706;496;1511;103;325;284;894;387;1219
520753;201503;1295;3718;1208;3587;154;426;894;2792;1048;3218
520760;201503;927;2507;800;2338;136;431;547;1635;683;2066
520780;201503;2013;4911;1654;4436;170;410;1222;3355;1392;3765
520790;201503;2646;7196;2245;6642;283;816;1643;5037;1926;5853
520800;201503;15279;44991;13462;42832;2617;8042;8761;29648;11378;37690
520810;201503;915;2464;802;2326;138;399;601;1804;739;2203
520815;201503;558;1803;421;1519;192;796;24;64;216;860
520830;201503;1526;4156;1312;3935;41;94;1204;3689;1245;3783
520840;201503;1473;4820;1239;4382;410;1615;264;934;674;2549
520850;201503;642;1930;515;1737;140;531;236;771;376;1302
520860;201503;6805;19273;5087;16761;1371;4892;2152;7294;3523;12186
520870;201503;110628;299115;75647;239750;21251;74905;19013;57506;40264;132411
520880;201503;7110;20394;5230;17485;1560;5878;836;2722;2396;8600
520890;201503;3934;11163;3274;10072;684;2252;1637;5040;2321;7292
520910;201503;3663;10865;2734;9025;877;3092;506;1607;1383;4699
520915;201503;843;2395;637;2008;129;437;277;846;406;1283
520920;201503;3378;9127;2392;7539;585;1975;787;2573;1372;4548
520929;201503;558;1545;434;1350;114;351;225;727;339;1078
520940;201503;1031;3015;876;2787;98;356;636;2003;734;2359
520945;201503;721;1739;588;1532;175;432;276;722;451;1154
520960;201503;778;2356;652;2131;78;249;356;1202;434;1451
520970;201503;3224;9542;2696;8614;638;2241;973;3036;1611;5277
520980;201503;824;2353;757;2252;254;831;382;1097;636;1928
520990;201503;2939;9701;2785;9478;538;1891;1812;6379;2350;8270
520993;201503;1089;2869;878;2541;73;223;622;1817;695;2040
520995;201503;2554;6996;2321;6691;341;985;1686;4920;2027;5905
521000;201503;7065;21478;5983;19600;1516;5670;2452;7777;3968;13447
521010;201503;3849;11597;3138;10264;814;2868;1165;3847;1979;6715
521015;201503;667;1869;560;1698;127;360;305;961;432;1321
521020;201503;3908;11099;2780;8813;798;2759;474;1302;1272;4061
521030;201503;598;1575;512;1436;111;309;267;763;378;1072
521040;201503;5766;15881;4985;14712;1771;5325;2075;6521;3846;11846
521056;201503;896;2765;752;2522;249;886;306;1086;555;1972
521060;201503;1290;3462;1058;3098;280;773;435;1343;715;2116
521080;201503;1206;2876;738;2103;113;397;288;681;401;1078
521090;201503;3051;8268;2398;7424;761;2477;983;3183;1744;5660
521100;201503;1652;3982;1396;3701;245;629;952;2647;1197;3276
521120;201503;4445;12530;3740;11534;902;2950;1863;5860;2765;8810
521130;201503;1048;2891;805;2438;141;525;456;1341;597;1866
521140;201503;1007;3213;864;2923;269;980;257;858;526;1838
521150;201503;12857;33213;8109;24114;2634;8482;2141;6233;4775;14715
521160;201503;828;2002;514;1445;107;327;220;586;327;913
521170;201503;1238;2989;961;2609;227;634;541;1448;768;2082
521180;201503;6568;21792;5982;20743;2186;8097;1848;6433;4034;14530
521190;201503;9503;27162;6553;21920;1827;6544;1765;5951;3592;12495
521200;201503;741;1943;632;1779;76;248;404;1109;480;1357
521205;201503;598;1778;470;1543;54;201;271;894;325;1095
521210;201503;908;2495;632;1976;206;745;213;575;419;1320
521220;201503;3728;10290;2939;9229;902;3119;1202;3718;2104;6837
521225;201503;364;906;288;816;31;82;206;614;237;696
521230;201503;1201;3769;1095;3555;359;1261;525;1646;884;2907
521250;201503;27264;88445;24810;84725;10135;37064;8292;28706;18427;65770
521260;201503;745;1811;599;1568;91;307;371;895;462;1202
521270;201503;1838;5716;1691;5499;159;413;1320;4513;1479;4926
521280;201503;1862;5756;1547;5156;480;1708;500;1643;980;3351
521290;201503;528;1513;392;1289;110;424;150;476;260;900
521295;201503;1060;2841;943;2686;84;252;794;2295;878;2547
521300;201503;1691;4971;1540;4739;285;888;947;2984;1232;3872
521305;201503;798;2220;665;2030;121;350;426;1364;547;1714
521308;201503;4693;14016;3765;12238;891;3051;1758;5668;2649;8719
521310;201503;7681;22980;5764;19330;1643;5975;1310;4077;2953;10052
521340;201503;253;738;228;701;32;117;149;440;181;557
521350;201503;1930;5274;1632;4832;222;671;1144;3472;1366;4143
521370;201503;1000;2985;799;2637;235;852;232;736;467;1588
521375;201503;1319;3888;1111;3527;262;932;530;1596;792;2528
521377;201503;1016;2737;970;2686;71;138;856;2468;927;2606
521380;201503;4927;13916;3556;11392;707;2438;741;2426;1448;4864
521385;201503;514;1411;442;1319;103;335;247;724;350;1059
521390;201503;898;2450;702;2184;197;701;228;693;425;1394
521400;201503;2171;6055;1968;5808;267;870;1509;4460;1776;5330
521405;201503;1345;3843;1068;3343;323;1139;472;1469;795;2608
521410;201503;717;2225;653;2123;233;736;289;1011;522;1747
521440;201503;1382;3894;1313;3767;106;303;1093;3141;1199;3444
521450;201503;4430;13895;3599;12336;1072;4019;914;3083;1986;7102
521460;201503;6568;19561;5734;18202;1397;4871;2890;9061;4287;13932
521470;201503;729;2065;545;1707;140;493;102;300;242;793
521480;201503;413;1227;289;954;70;240;103;336;173;576
521483;201503;2830;7361;2188;6279;600;1804;688;1902;1288;3706
521486;201503;1547;4005;1327;3679;133;398;1010;2777;1143;3175
521487;201503;635;1631;450;1351;106;319;154;477;260;796
521490;201503;780;2307;649;2094;67;280;462;1469;529;1749
521500;201503;1340;4295;1064;3689;205;821;374;1152;579;1973
521520;201503;889;2136;691;1868;187;504;326;928;513;1432
521523;201503;11941;44299;11135;42922;4264;17621;1916;8137;6180;25758
521525;201503;1040;2733;921;2574;107;366;671;1830;778;2196
521530;201503;1648;4754;1047;3514;252;911;196;598;448;1509
521540;201503;967;2643;673;2138;167;634;207;601;374;1235
521550;201503;1000;2550;875;2353;221;631;462;1212;683;1843
521560;201503;4315;13931;3632;12975;1399;5493;1156;4032;2555;9525
521565;201503;690;1762;591;1643;91;232;410;1173;501;1405
521570;201503;4447;12570;3110;9864;829;2849;950;2980;1779;5829
521580;201503;579;1346;397;1098;115;350;136;365;251;715
521590;201503;636;1840;515;1643;156;541;90;297;246;838
521600;201503;560;1466;390;1184;101;332;112;299;213;631
521630;201503;1527;3882;1119;3277;279;977;221;518;500;1495
521640;201503;1949;5090;1548;4545;460;1491;649;1947;1109;3438
521645;201503;594;1739;470;1458;70;245;211;599;281;844
521680;201503;1457;4660;1234;4204;640;2342;199;629;839;2971
521690;201503;564;1670;502;1557;112;410;239;681;351;1091
521710;201503;2589;7966;2198;7174;500;1722;992;3240;1492;4962
521720;201503;1880;5351;1600;4945;316;980;1020;3158;1336;4138
521730;201503;3804;12502;3397;11742;1373;5283;880;2770;2253;8053
521740;201503;3339;9172;2635;8238;842;2870;1232;4030;2074;6900
521760;201503;12219;41112;11148;39360;2397;9435;6110;21776;8507;31211
521770;201503;2629;7764;2152;6891;810;2780;640;1940;1450;4720
521800;201503;7661;22738;6614;21034;2116;7212;2591;8503;4707;15715
521805;201503;891;2043;641;1682;158;377;350;1000;508;1377
521810;201503;688;1942;568;1752;130;434;296;906;426;1340
521830;201503;5099;16844;4699;16241;856;3232;3110;10749;3966;13981
521839;201503;743;2078;571;1758;120;423;195;561;315;984
521850;201503;6515;17788;5069;15198;1162;3658;1686;4653;2848;8311
521860;201503;1825;5157;1447;4517;337;1171;483;1457;820;2628
521870;201503;478;1665;440;1570;137;531;132;434;269;965
521878;201503;727;2157;531;1739;114;425;230;726;344;1151
521880;201503;24552;62947;16286;49569;4489;14726;5082;15595;9571;30321
521890;201503;3567;10782;2877;9441;947;3360;686;2178;1633;5538
521900;201503;1440;3749;1097;3299;257;844;483;1381;740;2225
521910;201503;1046;2911;930;2775;189;585;569;1782;758;2367
521920;201503;352;1059;301;966;107;393;83;226;190;619
521925;201503;642;1919;555;1764;105;363;233;680;338;1043
521930;201503;3906;12612;3502;11865;1193;4319;920;3108;2113;7427
521935;201503;633;1823;564;1701;152;459;275;812;427;1271
521940;201503;1009;2841;835;2555;238;770;348;1058;586;1828
521945;201503;638;2152;600;2102;107;345;414;1549;521;1894
521950;201503;588;1649;468;1460;100;342;227;723;327;1065
521960;201503;778;2285;634;2031;140;522;280;856;420;1378
521970;201503;2376;6829;2122;6499;297;924;1565;4914;1862;5838
521971;201503;1087;2931;814;2431;170;537;256;713;426;1250
521973;201503;871;2779;738;2531;183;673;252;841;435;1514
521975;201503;12547;34587;11747;33663;1844;5531;8602;24717;10446;30248
521980;201503;1896;5619;1697;5375;252;703;1316;4367;1568;5070
521990;201503;1040;3109;893;2879;132;485;566;1814;698;2299
522000;201503;1817;5531;1563;5184;239;916;1014;3361;1253;4277
522005;201503;418;1027;283;812;79;222;95;276;174;498
522010;201503;3106;9147;2608;8337;969;3241;598;1893;1567;5134
522015;201503;874;2629;741;2421;182;627;377;1225;559;1852
522020;201503;5176;13614;4318;12490;936;2868;2637;7665;3573;10533
522026;201503;607;1626;435;1422;124;457;150;484;274;941
522028;201503;528;1570;436;1366;82;268;271;839;353;1107
522040;201503;2653;6607;2034;5824;470;1405;1115;3215;1585;4620
522045;201503;14705;47853;12396;43246;3900;15035;2669;9048;6569;24083
522050;201503;1108;3137;856;2695;241;825;318;915;559;1740
522060;201503;2796;8424;2195;7498;643;2437;1031;3440;1674;5877
522068;201503;1589;5101;1472;4971;112;293;1242;4425;1354;4718
522070;201503;793;2395;714;2272;77;305;510;1608;587;1913
522100;201503;642;1863;565;1745;202;703;254;732;456;1435
522108;201503;911;2779;780;2589;69;256;609;2014;678;2270
522119;201503;1369;4257;1185;3989;255;904;650;2270;905;3174
522130;201503;462;1339;405;1271;115;377;226;714;341;1091
522140;201503;17592;48539;14632;43799;4270;13856;5319;15345;9589;29201
522145;201503;805;2281;729;2166;351;1120;205;593;556;1713
522150;201503;917;2594;810;2416;240;731;318;937;558;1668
522155;201503;789;2287;699;2150;126;378;461;1467;587;1845
522157;201503;692;1984;591;1838;52;191;472;1462;524;1653
522160;201503;6048;17178;4388;14222;1514;5498;593;1778;2107;7276
522170;201503;3134;8752;2595;7901;828;2598;826;2598;1654;5196
522180;201503;346;1008;273;887;92;319;92;310;184;629
522185;201503;16030;47401;13708;44368;3253;11245;7620;24977;10873;36222
522190;201503;968;2443;750;2106;122;364;416;1188;538;1552
522200;201503;1618;5257;1418;4843;435;1624;410;1312;845;2936
522205;201503;1383;4039;1157;3677;308;1049;521;1637;829;2686
522220;201503;1394;3770;1121;3433;282;870;559;1901;841;2771
522230;201503;1157;3363;1005;3122;118;432;688;2138;806;2570
530010;201503;238116;752613;212240;706187;60112;221852;73190;239082;133302;460934
110001;201502;3893;12378;3251;11392;721;2710;1863;6578;2584;9288
110002;201502;12946;39769;10683;35771;3132;11550;4311;14273;7443;25823
110003;201502;857;2751;779;2621;231;826;254;818;485;1644
110004;201502;10202;32502;8518;29070;2797;10356;2172;7351;4969;17707
110005;201502;1914;6268;1749;5952;624;2186;732;2489;1356;4675
110006;201502;2201;6556;1539;5408;508;1908;314;991;822;2899
110007;201502;1403;4326;1324;4213;297;1047;675;2374;972;3421
110008;201502;2359;8066;2253;7905;392;1276;1681;6198;2073;7474
110009;201502;4792;14378;3934;13009;1089;4022;1619;5157;2708;9179
110010;201502;7823;22914;6873;21712;1578;4667;4052;14029;5630;18696
110011;201502;8548;26267;7198;23821;2366;8289;2794;9137;5160;17426
110012;201502;14185;42903;11988;38847;3775;12924;3998;12937;7773;25861
110013;201502;5309;16486;4277;14912;1453;5368;1544;5542;2997;10910
110014;201502;4450;12813;3670;11674;710;2346;2317;7480;3027;9826
110015;201502;5110;15487;3852;13264;1208;4577;1190;4073;2398;8650
110018;201502;4364;12461;3420;11247;916;3452;1584;5030;2500;8482
110020;201502;57802;163504;45038;146587;9576;32955;24258;81171;33834;114126
110025;201502;4254;12443;3543;11135;596;1994;2311;7231;2907;9225
110026;201502;654;2041;611;1977;151;485;373;1234;524;1719
110028;201502;7754;22214;5643;18692;1581;5774;1071;3374;2652;9148
110029;201502;1353;4065;1178;3751;353;1173;516;1658;869;2831
110030;201502;9841;27692;7961;25166;1945;6687;3871;12596;5816;19283
110032;201502;4072;13006;3610;12035;1128;3942;1305;4290;2433;8232
110033;201502;5408;17285;4999;16660;1535;4996;2534;9022;4069;14018
110034;201502;3578;9483;3057;8836;550;1504;2260;6682;2810;8186
110037;201502;2098;7065;1810;6534;419;1581;994;3631;1413;5212
110040;201502;3461;11011;3108;10387;930;3401;1462;4789;2392;8190
110045;201502;5108;16997;4543;16331;1421;5533;2422;8630;3843;14163
110050;201502;1650;5301;1431;4975;411;1440;798;2860;1209;4300
110060;201502;819;2770;731;2598;234;930;281;970;515;1900
110070;201502;2000;6742;1920;6575;443;1615;1144;3910;1587;5525
110080;201502;3751;11074;3439;10717;345;934;2868;9285;3213;10219
110090;201502;774;2359;653;2142;186;705;291;879;477;1584
110092;201502;1323;4523;1247;4422;200;729;864;3175;1064;3904
110094;201502;3441;10561;3163;10165;901;2967;1695;5599;2596;8566
110100;201502;2312;7382;2076;6977;600;2137;1087;3631;1687;5768
110110;201502;1702;5400;1568;5237;670;2349;617;2106;1287;4455
110120;201502;1831;5934;1461;5127;460;1687;404;1426;864;3113
110130;201502;2656;7614;1997;6583;648;2253;684;2248;1332;4501
110140;201502;2524;8358;2237;7850;461;1716;1302;4626;1763;6342
110143;201502;1256;4056;1002;3591;241;904;511;1807;752;2711
110145;201502;1040;3003;878;2745;182;623;522;1615;704;2238
110146;201502;446;1400;397;1330;84;289;224;767;308;1056
110147;201502;843;2435;649;2106;172;613;242;696;414;1309
110148;201502;1358;4071;1022;3391;306;1076;299;967;605;2043
110149;201502;3612;10740;2941;9688;868;2888;1536;5221;2404;8109
110150;201502;2493;7483;2193;7041;262;947;1463;4784;1725;5731
110155;201502;876;2766;814;2625;231;792;421;1329;652;2121
110160;201502;2186;6806;1813;6128;571;1993;793;2713;1364;4706
110170;201502;3116;8790;2326;7418;530;1800;1286;4071;1816;5871
110175;201502;1817;5406;1366;4830;236;913;806;2919;1042;3832
110180;201502;1480;4376;1233;4000;280;929;741;2455;1021;3384
120001;201502;2797;9798;2655;9563;499;1942;1715;6273;2214;8215
120005;201502;1468;6157;1432;6098;133;586;1162;5071;1295;5657
120010;201502;4481;15735;4256;15367;689;2425;3088;11513;3777;13938
120013;201502;1730;6867;1668;6771;392;1556;1060;4561;1452;6117
120017;201502;2031;7342;1905;7111;521;1961;926;3775;1447;5736
120020;201502;14020;62435;13616;61654;2109;9313;10024;47316;12133;56629
120025;201502;2607;9050;2514;8920;486;1868;1646;5904;2132;7772
120030;201502;6097;24106;5979;23972;286;1080;5438;22121;5724;23201
120032;201502;1425;6835;1368;6701;202;1171;987;4847;1189;6018
120033;201502;3420;13602;3394;13559;128;546;3157;12719;3285;13265
120034;201502;1932;7968;1873;7880;178;870;1564;6543;1742;7413
120035;201502;2881;13611;2840;13524;206;993;2474;12008;2680;13001
120038;201502;2679;9854;2565;9630;649;2531;1461;5600;2110;8131
120039;201502;1576;8226;1543;8147;186;1029;1231;6602;1417;7631
120040;201502;46224;165257;42146;157177;11086;44138;20900;79506;31986;123644
120042;201502;2864;12379;2732;12089;393;1884;1954;8812;2347;10696
120043;201502;889;4301;860;4251;66;298;730;3736;796;4034
120045;201502;4228;14546;4161;14455;720;2590;3196;11205;3916;13795
120050;201502;7909;33022;7575;32294;1310;5492;5116;22929;6426;28421
120060;201502;7242;33127;7134;32934;555;2783;6098;28608;6653;31391
120070;201502;2686;10181;2620;10031;471;1759;1789;7112;2260;8871
120080;201502;3617;13765;3463;13519;505;1958;2640;10619;3145;12577
130002;201502;2950;12456;2814;12220;202;985;2378;10408;2580;11393
130006;201502;1893;7996;1670;7581;272;1380;1125;5165;1397;6545
130008;201502;2062;8395;1974;8247;153;681;1642;6948;1795;7629
130010;201502;2839;9510;2485;9100;180;633;2170;8084;2350;8717
130014;201502;3265;10683;2894;10131;465;1752;1921;6794;2386;8546
130020;201502;2627;9410;2618;9399;23;75;2588;9308;2611;9383
130030;201502;7087;27115;6835;26820;627;2088;5791;23614;6418;25702
130040;201502;3815;11722;3438;11235;269;981;2906;9615;3175;10596
130050;201502;6172;24545;5580;23666;556;2272;4287;19152;4843;21424
130060;201502;5718;26093;5448;25675;501;2566;4434;21140;4935;23706
130063;201502;3427;15297;3382;15233;260;1115;2955;13602;3215;14717
130068;201502;3051;12834;2797;12345;392;1885;1914;8547;2306;10432
130070;201502;6663;21852;5976;20998;628;2162;4747;17171;5375;19333
130080;201502;4870;22086;4666;21779;851;4138;3206;15433;4057;19571
130083;201502;2155;8561;2037;8381;283;1384;1492;6118;1775;7502
130090;201502;2553;9243;2471;9127;135;581;2229;8234;2364;8815
130100;201502;5459;20595;5253;20327;256;1143;4777;18492;5033;19635
130110;201502;6566;21497;6166;21024;511;1639;5267;18422;5778;20061
130115;201502;4232;15094;4040;14840;75;236;3855;14267;3930;14503
130120;201502;13816;52953;13172;52121;1185;4317;11161;45505;12346;49822
130130;201502;3615;15231;3561;15128;311;1421;3001;12875;3312;14296
130140;201502;6224;24244;6155;24163;102;241;6022;23849;6124;24090
130150;201502;3412;13095;3342;13007;159;758;3061;11851;3220;12609
130160;201502;4083;16879;3978;16739;274;1050;3595;15346;3869;16396
130165;201502;2831;11697;2725;11527;335;1494;2173;9305;2508;10799
130170;201502;8847;32354;7948;31240;1008;4093;6137;24793;7145;28886
130180;201502;3461;11108;3380;10993;115;305;3144;10342;3259;10647
130185;201502;10494;34538;9597;33506;952;3004;7917;28873;8869;31877
130190;201502;16699;57803;14700;55258;2738;10316;9752;38451;12490;48767
130195;201502;1890;7879;1833;7797;105;453;1630;7028;1735;7481
130200;201502;1953;7051;1820;6833;502;1870;1075;4170;1577;6040
130210;201502;1170;4625;1108;4538;112;522;921;3793;1033;4315
130220;201502;1970;8153;1806;7839;330;1620;1049;4587;1379;6207
130230;201502;3620;16249;3424;15933;387;1764;2619;12750;3006;14514
130240;201502;8340;32117;7744;31235;382;1847;6801;27660;7183;29507
130250;201502;19260;67403;18282;66144;2228;7443;14341;54288;16569;61731
130255;201502;4175;14690;3954;14343;139;443;3625;13405;3764;13848
130260;201502;245957;804775;222929;767111;61951;223798;110652;389363;172603;613161
130270;201502;6993;29567;6462;28708;899;4065;4795;22054;5694;26119
130280;201502;3238;13034;3155;12914;113;425;2907;12138;3020;12563
130290;201502;11148;39500;10804;39089;160;316;10382;38223;10542;38539
130300;201502;4258;16761;4074;16470;294;1390;3448;13966;3742;15356
130310;201502;5051;18999;4663;18521;368;1445;3923;15943;4291;17388
130320;201502;2927;10259;2670;9910;345;1289;1971;7523;2316;8812
130330;201502;3444;12817;3227;12529;184;840;2811;10990;2995;11830
130340;201502;17713;68243;16613;66783;3091;11993;11656;49172;14747;61165
130350;201502;3193;13266;3129;13177;273;1277;2650;11256;2923;12533
130353;201502;5816;17845;5082;16893;1155;3754;3140;11196;4295;14950
130356;201502;4442;15954;4206;15611;360;1172;3491;13552;3851;14724
130360;201502;3092;8884;2846;8620;36;58;2754;8480;2790;8538
130370;201502;5209;20397;4479;19432;276;1466;3732;16285;4008;17751
130380;201502;7214;30380;6926;29986;467;2113;6004;26369;6471;28482
130390;201502;4825;21552;4502;20990;460;2342;3495;16620;3955;18962
130395;201502;2022;7336;1786;6853;242;987;1213;4645;1455;5632
130400;201502;2056;7866;1986;7767;135;554;1771;6982;1906;7536
130406;201502;10150;38675;9119;37142;2158;9020;5530;23387;7688;32407
130410;201502;3929;14979;3584;14348;1079;4638;1617;6653;2696;11291
130420;201502;10229;43351;9861;42745;2883;12140;5887;26894;8770;39034
130423;201502;3209;12460;3028;12215;266;1247;2557;10341;2823;11588
130426;201502;2067;9021;2006;8919;290;1290;1518;6973;1808;8263
130430;201502;3414;12214;3276;12015;422;1627;2497;9292;2919;10919
130440;201502;3549;13077;3416;12934;175;620;3126;12023;3301;12643
140002;201502;1632;5228;1536;5115;163;532;1181;4036;1344;4568
140005;201502;3042;8880;2873;8698;76;169;2745;8400;2821;8569
140010;201502;48682;150974;41996;140537;10278;36953;20834;71588;31112;108541
140015;201502;2954;9525;2794;9317;349;936;2212;7757;2561;8693
140017;201502;3299;10183;3006;9816;282;800;2411;8209;2693;9009
140020;201502;4475;15265;4195;14885;380;1260;3443;12593;3823;13853
140023;201502;2113;7172;1885;6825;237;904;1335;4934;1572;5838
140028;201502;2150;5918;2088;5851;64;120;1989;5666;2053;5786
140030;201502;3647;11499;3476;11290;437;1117;2874;9759;3311;10876
140040;201502;1552;7354;1509;7247;125;683;1195;5818;1320;6501
140045;201502;2406;8919;2212;8639;455;1610;1431;6128;1886;7738
140047;201502;5394;15100;4820;14352;1411;4319;2388;7538;3799;11857
140050;201502;1474;4629;1342;4451;209;738;930;3132;1139;3870
140060;201502;1480;4604;1339;4380;274;923;861;2899;1135;3822
140070;201502;1465;7533;1430;7414;91;543;1241;6431;1332;6974
150010;201502;33699;105995;32052;103828;1941;6514;27605;90603;29546;97117
150013;201502;1633;4808;1503;4663;157;448;1202;3833;1359;4281
150020;201502;12135;40880;11787;40409;894;3041;10247;35602;11141;38643
150030;201502;6583;28330;6383;28032;594;2232;5414;24694;6008;26926
150034;201502;4312;11932;4105;11676;231;583;3707;10684;3938;11267
150040;201502;12563;41846;10870;39788;2173;7367;7395;29082;9568;36449
150050;201502;5710;21976;5521;21648;376;1645;4725;18668;5101;20313
150060;201502;16094;51560;14970;49897;2677;8577;10436;36038;13113;44615
150070;201502;5872;24134;5281;23486;394;1876;4580;20647;4974;22523
150080;201502;64769;172357;55792;160604;9155;25108;37071;110760;46226;135868
150085;201502;5088;17762;4847;17429;539;1674;3953;14797;4492;16471
150090;201502;9742;37942;9321;37334;831;3260;7706;31527;8537;34787
150095;201502;5213;17537;4766;16880;426;1404;3856;14137;4282;15541
150100;201502;3275;12351;3110;12073;197;972;2610;10034;2807;11006
150110;201502;3255;16051;3245;16027;144;645;3025;15113;3169;15758
150120;201502;5955;23163;5809;22911;716;2795;4625;18530;5341;21325
150125;201502;729;2182;665;2101;127;456;432;1319;559;1775
150130;201502;21234;65174;19842;63246;1773;5482;15845;51704;17618;57186
150140;201502;148925;430992;142269;422699;14278;41673;117551;354315;131829;395988
150145;201502;4460;14426;4131;14005;577;2006;3154;10860;3731;12866
150150;201502;10880;34456;10134;33321;1719;5874;7044;23478;8763;29352
150157;201502;3100;9402;2726;8880;353;1266;2024;6676;2377;7942
150160;201502;2996;9825;2802;9545;748;2525;1638;5830;2386;8355
150170;201502;21702;80132;20431;78226;3471;13374;14592;56982;18063;70356
150172;201502;2970;10342;2672;9877;403;1532;1945;7342;2348;8874
150175;201502;1955;5939;1852;5828;113;270;1623;5348;1736;5618
150178;201502;10133;31844;9132;30749;730;2389;7476;26049;8206;28438
150180;201502;17793;71655;17117;70749;1426;6375;14401;60192;15827;66567
150190;201502;7194;23345;6823;22848;389;903;5968;20777;6357;21680
150195;201502;5075;16929;4714;16337;350;1310;3954;13819;4304;15129
150200;201502;5207;16843;4997;16598;140;440;4650;15640;4790;16080
150210;201502;23916;90610;23167;89548;2270;7996;19161;76780;21431;84776
150215;201502;6217;19756;5470;18634;1424;5134;2706;9416;4130;14550
150220;201502;12491;39156;11225;37213;2557;8748;6000;20365;8557;29113
150230;201502;11227;37546;10030;35835;1086;4496;7574;27083;8660;31579
150240;201502;34798;104033;30855;97453;9856;32300;11731;38617;21587;70917
150250;201502;4110;16627;3971;16425;523;2187;3063;13062;3586;15249
150260;201502;2108;8478;2012;8309;402;1706;1260;5357;1662;7063
150270;201502;8691;26954;6991;24833;1487;5631;4394;15903;5881;21534
150275;201502;5765;21146;5495;20733;717;2741;4177;16102;4894;18843
150276;201502;2056;6213;1875;5972;374;1273;1356;4328;1730;5601
150277;201502;4910;15383;4272;14598;596;2034;3164;11203;3760;13237
150280;201502;5804;25865;5644;25503;1090;4896;3815;17812;4905;22708
150285;201502;2642;10717;2533;10509;504;2168;1635;7028;2139;9196
150290;201502;9553;28510;9163;28074;721;1767;7907;25175;8628;26942
150293;201502;9319;26302;7343;23508;2217;7553;2863;9924;5080;17477
150295;201502;6684;20301;5609;19041;1055;3374;3888;14153;4943;17527
150300;201502;1778;6293;1713;6213;118;397;1422;5333;1540;5730
150304;201502;4017;12677;3528;11990;551;1897;2432;8527;2983;10424
150307;201502;6475;22070;6012;21425;399;1411;5150;18619;5549;20030
150309;201502;6289;22017;5836;21450;1275;4609;3929;15197;5204;19806
150310;201502;5687;25460;5534;25208;657;3082;4364;20314;5021;23396
150320;201502;8813;21301;8284;20759;439;739;7484;19386;7923;20125
150330;201502;13423;46802;12571;45580;1462;5153;9768;36569;11230;41722
150340;201502;2352;7682;2182;7431;311;1115;1604;5545;1915;6660
150345;201502;6465;21911;6061;21371;600;2091;4935;17828;5535;19919
150350;201502;7650;24547;7190;23940;1100;3204;5363;18597;6463;21801
150360;201502;20574;65124;18128;61945;2799;9662;12718;44923;15517;54585
150370;201502;9429;35432;9015;34885;1093;3762;7399;29726;8492;33488
150375;201502;2735;11907;2669;11816;260;1074;2280;10375;2540;11449
150380;201502;9630;28412;8599;27014;689;2275;7147;22745;7836;25020
150390;201502;7692;33410;7288;32692;1338;5840;4909;22956;6247;28796
150400;201502;5644;22677;5418;22201;520;2098;4233;17812;4753;19910
150405;201502;8025;24580;7162;23514;1322;3700;4993;17737;6315;21437
150410;201502;1627;6343;1555;6207;249;1085;1032;4194;1281;5279
150420;201502;35343;121627;30670;114016;8748;34883;13482;52390;22230;87273
150430;201502;6738;23724;6438;23235;820;2947;4799;17782;5619;20729
150440;201502;5400;18889;5198;18610;951;3275;3699;13687;4650;16962
150442;201502;19555;58614;17963;56345;3129;10149;11962;38277;15091;48426
150445;201502;5063;17866;4720;17319;573;2025;3622;13658;4195;15683
150450;201502;4300;20729;4141;20498;357;1789;3488;17627;3845;19416
150460;201502;6351;24744;5808;24111;338;1562;5115;21640;5453;23202
150470;201502;16933;51735;16314;50994;590;1411;15217;48404;15807;49815
150475;201502;1837;6359;1698;6182;189;684;1389;5202;1578;5886
150480;201502;13390;46351;12661;45270;1052;3932;10625;38490;11677;42422
150490;201502;6700;25858;6552;25644;287;1108;5954;23606;6241;24714
150495;201502;4941;18213;4825;18059;170;640;4509;17000;4679;17640
150497;201502;2895;10517;2628;10042;812;3262;1368;5262;2180;8524
150500;201502;3093;8659;2886;8361;372;1083;2168;6304;2540;7387
150503;201502;3672;11507;3190;10913;1116;3910;1610;5772;2726;9682
150506;201502;11291;40024;10292;38612;2275;7992;6748;26986;9023;34978
150510;201502;9472;37404;8776;36150;1270;5312;6247;26676;7517;31988
150520;201502;6651;25805;6560;25683;208;624;6214;24675;6422;25299
150530;201502;11651;40757;10584;39129;1168;4153;8119;30802;9287;34955
150540;201502;4529;14041;4116;13454;292;1004;3433;11254;3725;12258
150543;201502;5261;16561;4762;15837;1018;3536;3091;10482;4109;14018
150548;201502;8525;27508;8029;26887;346;1051;7333;24914;7679;25965
150549;201502;2143;6928;2005;6769;64;129;1868;6478;1932;6607
150550;201502;19684;62428;17282;58398;5319;18660;7331;25344;12650;44004
150553;201502;21368;74518;18183;67732;7001;27908;4686;17640;11687;45548
150555;201502;1623;5055;1451;4813;135;513;1159;3845;1294;4358
150560;201502;1919;6260;1820;6046;259;877;1257;4186;1516;5063
150563;201502;2897;9495;2702;9156;645;2345;1518;5176;2163;7521
150565;201502;3550;12433;3259;11981;192;849;2685;9974;2877;10823
150570;201502;5546;20712;5435;20525;379;1450;4615;17810;4994;19260
150580;201502;9475;39729;9273;39485;579;2217;8305;36230;8884;38447
150590;201502;5628;22798;5481;22623;93;279;5272;22000;5365;22279
150600;201502;7781;30078;7527;29704;398;1544;6765;27142;7163;28686
150610;201502;2370;8153;2173;7757;260;1023;1512;5347;1772;6370
150611;201502;2693;9558;2525;9219;230;913;1956;7185;2186;8098
150613;201502;11876;36588;10320;34328;3434;11825;4812;16601;8246;28426
150616;201502;3009;9194;2381;8251;609;2328;1084;3627;1693;5955
150618;201502;6259;22084;5906;21453;1697;6394;3161;11685;4858;18079
150619;201502;5070;17672;4762;17199;568;2281;3559;12892;4127;15173
150620;201502;6089;22297;5622;21710;748;2844;4468;17795;5216;20639
150630;201502;5559;16934;5295;16621;349;1080;4626;14789;4975;15869
150635;201502;4069;13494;3775;12929;770;2721;2163;7639;2933;10360
150640;201502;1740;5382;1689;5318;194;575;1377;4536;1571;5111
150650;201502;12321;37538;11021;35304;2947;9645;5248;17370;8195;27015
150655;201502;4973;17028;4754;16642;512;1887;3753;13299;4265;15186
150658;201502;4207;13314;3827;12771;806;3069;2465;8190;3271;11259
150660;201502;5535;17786;5072;17134;1268;4179;2936;10349;4204;14528
150670;201502;6190;17385;5197;16141;1087;3494;3505;11238;4592;14732
150680;201502;52216;195908;47888;188215;15072;60658;21629;90761;36701;151419
150690;201502;1992;6239;1813;5949;334;1017;1155;3959;1489;4976
150700;201502;6124;18813;5610;18162;1055;3495;3768;12518;4823;16013
150710;201502;4250;14166;3817;13478;422;1478;2883;10421;3305;11899
150715;201502;4909;15676;4311;14794;527;1926;3270;11380;3797;13306
150720;201502;6410;26321;6056;25703;893;3818;4399;19403;5292;23221
150730;201502;9127;31904;8734;31307;933;3262;7203;26377;8136;29639
150740;201502;3692;11760;3324;11125;516;1805;2108;7155;2624;8960
150745;201502;5304;16892;4915;16362;1008;3495;3314;11072;4322;14567
150746;201502;1404;4595;1337;4478;194;701;921;3115;1115;3816
150747;201502;5236;16631;4673;15912;491;1450;3589;12949;4080;14399
150750;201502;2960;10077;2826;9908;137;450;2582;9170;2719;9620
150760;201502;10704;35279;10095;34478;2155;7423;6554;23094;8709;30517
150770;201502;5789;21948;5493;21445;621;2300;4392;18092;5013;20392
150775;201502;1156;3568;1027;3341;206;816;593;1864;799;2680
150780;201502;3153;10388;3111;10342;55;136;2993;10046;3048;10182
150790;201502;5008;16111;4610;15623;400;1365;3803;13378;4203;14743
150795;201502;15682;48594;14109;46359;2822;9084;9079;31008;11901;40092
150796;201502;2909;8799;2695;8554;343;1056;2097;6891;2440;7947
150797;201502;3727;12571;3483;12210;145;575;3080;10878;3225;11453
150800;201502;13578;45569;12516;44278;2467;8097;8787;32798;11254;40895
150803;201502;6550;23807;6176;23222;686;2636;4725;18169;5411;20805
150805;201502;2734;9590;2558;9329;314;1113;1937;7253;2251;8366
150808;201502;5802;19776;4974;18252;2087;8194;1069;3975;3156;12169
150810;201502;18893;59803;16177;56496;2244;7482;11681;43065;13925;50547
150812;201502;5249;16543;4842;15893;481;2027;3614;11425;4095;13452
150815;201502;8505;27672;7695;26679;834;2812;6320;22448;7154;25260
150820;201502;11238;31948;9963;30548;683;1410;8683;27741;9366;29151
150830;201502;13095;49138;12031;47516;622;2701;10093;41200;10715;43901
150835;201502;1926;6939;1789;6641;465;1841;821;3069;1286;4910
150840;201502;6848;20712;5734;19002;1331;4810;3017;9910;4348;14720
160005;201502;667;2486;625;2415;81;374;445;1694;526;2068
160010;201502;1420;4721;1416;4716;77;170;1310;4480;1387;4650
160015;201502;1641;6150;1602;6088;95;326;1411;5514;1506;5840
160020;201502;1995;7042;1857;6853;249;901;1368;5271;1617;6172
160021;201502;942;4055;922;4022;161;765;669;2961;830;3726
160023;201502;1029;4140;1015;4118;68;241;901;3737;969;3978
160025;201502;1221;3757;1209;3744;8;30;1194;3698;1202;3728
160027;201502;8137;24532;7540;23879;2691;8088;3937;13522;6628;21610
160030;201502;42617;154244;38113;145733;9015;34500;21906;87976;30921;122476
160040;201502;4181;16316;4089;16180;124;580;3837;15181;3961;15761
160050;201502;3203;12120;2922;11743;1290;5146;1247;5342;2537;10488
160053;201502;2594;10139;2533;10045;551;2260;1729;6995;2280;9255
160055;201502;672;2646;660;2634;96;420;510;2047;606;2467
160060;201502;15517;52890;14559;51830;2943;9943;10334;38347;13277;48290
160070;201502;2362;9339;2303;9252;122;514;2064;8378;2186;8892
160080;201502;2515;9391;2508;9384;31;98;2464;9257;2495;9355
170025;201502;539;1808;497;1751;153;543;252;939;405;1482
170030;201502;1160;3765;1031;3531;310;1062;445;1582;755;2644
170035;201502;1487;4401;1203;3872;394;1355;393;1294;787;2649
170040;201502;1850;6038;1624;5726;276;1092;1040;3752;1316;4844
170070;201502;1980;5214;1551;4668;384;1250;827;2532;1211;3782
170100;201502;2482;7198;2182;6734;256;834;1691;5214;1947;6048
170105;201502;763;2405;618;2117;121;489;312;1016;433;1505
170110;201502;1084;3387;941;3156;221;802;473;1584;694;2386
170130;201502;1383;4378;1222;4115;282;992;676;2370;958;3362
170190;201502;1575;4613;1216;4052;501;1605;284;1105;785;2710
170200;201502;1537;4384;1075;3528;268;975;350;1114;618;2089
170210;201502;30830;89523;25186;80306;7551;26075;8395;27895;15946;53970
170215;201502;1144;3628;1002;3412;83;327;799;2729;882;3056
170220;201502;5794;19942;5359;19169;1087;4151;3166;11421;4253;15572
170230;201502;1446;4671;1219;4248;264;1100;596;1972;860;3072
170240;201502;2715;8164;2313;7582;289;1130;1619;5249;1908;6379
170255;201502;3579;11393;2979;10418;872;3128;1319;4853;2191;7981
170270;201502;1043;2633;729;2200;96;317;487;1453;583;1770
170290;201502;2707;8466;2536;8262;152;380;2245;7585;2397;7965
170300;201502;1941;6099;1647;5607;227;855;1066;3663;1293;4518
170305;201502;769;2356;620;2082;108;393;338;1156;446;1549
170307;201502;1072;3747;903;3439;182;762;481;1911;663;2673
170310;201502;1621;4500;1259;3924;277;879;649;2108;926;2987
170320;201502;1107;3224;838;2748;221;776;342;1149;563;1925
170330;201502;755;2462;699;2370;118;449;478;1593;596;2042
170360;201502;444;1463;384;1359;93;349;173;597;266;946
170370;201502;1358;3949;1095;3532;238;848;538;1738;776;2586
170380;201502;1861;6072;1534;5555;301;1281;843;2995;1144;4276
170382;201502;558;1859;484;1740;122;501;266;937;388;1438
170384;201502;1559;6374;1459;6201;352;1598;865;3730;1217;5328
170386;201502;946;2816;832;2653;206;742;439;1412;645;2154
170388;201502;643;1913;536;1734;113;435;221;689;334;1124
170389;201502;885;2995;820;2887;96;399;595;2070;691;2469
170390;201502;1302;3830;1141;3625;135;464;860;2792;995;3256
170410;201502;518;1669;459;1561;56;235;304;1016;360;1251
170460;201502;504;1377;356;1126;87;311;121;375;208;686
170510;201502;768;2612;634;2360;93;426;344;1259;437;1685
170550;201502;6322;18525;4861;15941;1688;6131;968;3134;2656;9265
170555;201502;1337;3879;1057;3449;235;844;569;1879;804;2723
170560;201502;996;3363;794;3102;173;737;468;1887;641;2624
170600;201502;1322;3783;1184;3601;242;719;776;2453;1018;3172
170610;201502;1641;4990;1280;4419;145;595;800;2792;945;3387
170625;201502;432;1337;339;1158;65;235;100;345;165;580
170650;201502;1247;4000;1087;3723;270;1004;511;1790;781;2794
170700;201502;4011;13007;3313;11852;681;2696;1651;6170;2332;8866
170710;201502;1847;5475;1503;4867;243;840;923;3025;1166;3865
170720;201502;1881;5037;1586;4590;314;836;1073;3254;1387;4090
170730;201502;1041;2967;853;2683;231;797;402;1279;633;2076
170740;201502;2223;7898;1971;7456;286;1194;1351;5171;1637;6365
170755;201502;840;2596;703;2310;162;595;252;802;414;1397
170765;201502;1353;3679;1071;3218;266;846;487;1498;753;2344
170770;201502;1766;6041;1625;5788;282;1091;1031;3712;1313;4803
170820;201502;3730;11902;3357;11312;854;3034;1573;5436;2427;8470
170825;201502;758;2318;608;2025;123;465;261;847;384;1312
170830;201502;1380;4075;1231;3862;27;49;1138;3629;1165;3678
170900;201502;2684;9435;2546;9194;249;903;2017;7458;2266;8361
170930;201502;3518;11075;3024;10212;966;3522;1046;3518;2012;7040
170950;201502;13928;40059;10355;33895;3510;12945;2215;7003;5725;19948
170980;201502;497;1491;378;1292;95;372;163;520;258;892
171050;201502;1426;4910;1322;4717;83;347;1106;3955;1189;4302
171070;201502;1587;4943;1450;4748;297;1000;907;3058;1204;4058
171090;201502;990;2793;832;2568;79;263;608;1876;687;2139
171110;201502;614;1788;470;1539;115;420;240;762;355;1182
171150;201502;867;2488;637;2084;123;447;352;1163;475;1610
171180;201502;678;2049;494;1678;131;474;200;720;331;1194
171190;201502;1768;6425;1539;5973;333;1399;758;3047;1091;4446
171195;201502;833;2982;731;2781;115;482;393;1545;508;2027
171200;201502;701;2265;587;2055;141;551;259;851;400;1402
171215;201502;458;1365;357;1172;67;246;158;527;225;773
171240;201502;751;2617;695;2513;87;357;489;1810;576;2167
171245;201502;655;2155;547;1913;122;495;204;662;326;1157
171250;201502;1107;3195;899;2854;93;327;645;2011;738;2338
171270;201502;436;1784;406;1732;127;536;177;827;304;1363
171280;201502;910;2793;787;2601;187;623;411;1473;598;2096
171320;201502;3873;11748;3312;10803;902;3039;1664;5522;2566;8561
171330;201502;2910;8543;2422;7787;604;2092;1184;3794;1788;5886
171360;201502;1463;4711;1270;4418;200;703;835;2981;1035;3684
171370;201502;714;2045;623;1917;133;454;343;1031;476;1485
171380;201502;1308;4290;1114;3927;416;1489;400;1446;816;2935
171395;201502;885;2685;710;2362;139;565;342;1100;481;1665
171420;201502;2269;6882;1814;6095;441;1585;800;2718;1241;4303
171430;201502;1051;3272;890;3016;198;674;505;1737;703;2411
171488;201502;2500;7650;2235;7285;534;1755;1265;4299;1799;6054
171500;201502;788;2415;683;2219;88;271;455;1522;543;1793
171510;201502;904;3188;807;3034;90;380;568;2173;658;2553
171515;201502;510;1468;396;1282;57;188;220;706;277;894
171525;201502;614;2019;519;1856;104;427;288;1008;392;1435
171550;201502;315;1059;249;929;89;369;35;138;124;507
171570;201502;1228;3884;1087;3613;164;575;766;2555;930;3130
171575;201502;1808;5266;1429;4545;281;923;682;2251;963;3174
171610;201502;5529;18371;4814;17108;1426;5581;1645;5732;3071;11313
171620;201502;2543;7556;2238;7126;139;526;1872;5981;2011;6507
171630;201502;865;2823;719;2572;216;832;271;963;487;1795
171650;201502;2252;6985;1787;6089;457;1698;702;2382;1159;4080
171660;201502;2491;6888;1944;5927;285;954;1153;3533;1438;4487
171665;201502;1429;4276;1185;3897;177;644;746;2551;923;3195
171670;201502;2058;5812;1709;5254;416;1432;833;2449;1249;3881
171700;201502;1088;3577;960;3334;135;535;631;2182;766;2717
171720;201502;746;2239;638;2050;221;744;256;838;477;1582
171750;201502;1156;3706;979;3340;287;1039;350;1197;637;2236
171780;201502;1263;3441;932;2985;117;427;544;1779;661;2206
171790;201502;1554;5138;1349;4856;236;817;882;3350;1118;4167
171800;201502;671;2136;595;2033;77;293;436;1501;513;1794
171820;201502;9821;29097;8531;27417;1668;5838;5208;16913;6876;22751
171830;201502;1491;5556;1352;5259;373;1520;630;2442;1003;3962
171840;201502;801;2248;703;2115;48;149;577;1763;625;1912
171845;201502;781;2113;607;1836;109;370;322;959;431;1329
171850;201502;968;3463;863;3251;108;501;546;2042;654;2543
171855;201502;1167;3756;1074;3585;93;383;832;2716;925;3099
171865;201502;473;1526;407;1421;100;388;199;673;299;1061
171870;201502;710;2183;588;1968;132;482;256;904;388;1386
171875;201502;1345;4195;1106;3833;122;503;782;2674;904;3177
171880;201502;875;3206;854;3170;86;346;685;2587;771;2933
171884;201502;944;2659;690;2287;156;603;232;848;388;1451
171886;201502;1469;4849;1227;4347;384;1496;383;1353;767;2849
171888;201502;697;2140;574;1917;77;277;337;1165;414;1442
171889;201502;480;1571;454;1527;83;283;288;992;371;1275
171890;201502;1160;3711;1008;3502;138;545;663;2321;801;2866
171900;201502;498;1873;447;1774;128;507;215;867;343;1374
172000;201502;596;1966;521;1830;90;350;295;1038;385;1388
172010;201502;1166;4080;1096;3965;106;449;857;3101;963;3550
172015;201502;350;1346;297;1255;59;260;167;739;226;999
172020;201502;2288;7676;2119;7404;269;995;1516;5374;1785;6369
172025;201502;733;2115;568;1830;71;267;315;1012;386;1279
172030;201502;1100;3715;987;3517;111;482;696;2468;807;2950
172049;201502;1283;3470;1002;2966;118;360;776;2335;894;2695
172065;201502;1178;3368;1019;3178;59;196;917;2888;976;3084
172080;201502;2570;7942;2184;7282;241;966;1503;4934;1744;5900
172085;201502;521;1423;380;1164;75;260;139;406;214;666
172090;201502;3114;9521;2530;8648;450;1673;1590;5524;2040;7197
172093;201502;590;1851;470;1651;119;524;233;780;352;1304
172097;201502;670;1959;538;1760;125;436;213;709;338;1145
172100;201502;29652;94878;24478;85135;7708;29692;6684;22961;14392;52653
172110;201502;1686;6249;1521;5994;189;780;1129;4580;1318;5360
172120;201502;5303;16121;4422;14969;458;1625;3291;11423;3749;13048
172125;201502;305;912;244;817;42;161;111;374;153;535
172130;201502;532;1494;427;1323;46;173;282;892;328;1065
172208;201502;2113;6457;1946;6205;358;1245;1124;3610;1482;4855
172210;201502;2380;7448;2152;7081;460;1659;1241;4014;1701;5673
210005;201502;21980;68996;18777;64120;5482;20209;8484;29284;13966;49493
210010;201502;1627;5814;1452;5555;142;586;1118;4351;1260;4937
210015;201502;3227;10390;2917;9933;201;485;2526;8942;2727;9427
210020;201502;6939;17201;6530;16703;287;783;5849;14942;6136;15725
210030;201502;5624;18739;5278;18266;400;1745;4361;15020;4761;16765
210040;201502;1867;5379;1713;5202;137;439;1401;4256;1538;4695
210043;201502;6409;18693;5625;17710;502;1540;4387;14332;4889;15872
210047;201502;6516;25362;6002;24507;749;3350;4308;17788;5057;21138
210050;201502;2377;8671;1971;7996;660;2796;786;3345;1446;6141
210055;201502;1698;5832;1567;5648;175;644;1192;4354;1367;4998
210060;201502;7510;28571;6906;27559;675;3029;5213;21190;5888;24219
210070;201502;6922;20621;6440;20039;179;624;5839;18282;6018;18906
210080;201502;3701;12809;3629;12720;51;214;3465;12176;3516;12390
210083;201502;4308;14961;4021;14653;108;328;3800;14050;3908;14378
210087;201502;2835;8545;2608;8268;170;543;2258;7261;2428;7804
210090;201502;9958;32595;9471;31826;409;1595;8309;28036;8718;29631
210095;201502;5942;22200;5774;21968;459;1786;4888;18924;5347;20710
210100;201502;7155;21389;6678;20842;255;957;5998;18710;6253;19667
210110;201502;2988;10559;2900;10453;114;495;2611;9451;2725;9946
210120;201502;26040;72346;22214;67860;2597;6940;16901;54417;19498;61357
210125;201502;3547;11338;3409;11189;234;616;3019;10181;3253;10797
210130;201502;4257;12709;4015;12381;314;1043;3342;10308;3656;11351
210135;201502;1659;4875;1466;4608;113;341;1210;3869;1323;4210
210140;201502;17086;54976;14890;51906;2831;10062;9378;34051;12209;44113
210150;201502;4491;11290;4063;10764;78;198;3773;10003;3851;10201
210160;201502;17288;55328;16291;53854;1654;4852;13245;45372;14899;50224
210170;201502;13908;50283;13622;49921;793;2579;12246;45813;13039;48392
210173;201502;1865;7847;1820;7763;107;523;1616;6908;1723;7431
210177;201502;2969;9369;2812;9182;205;750;2416;7869;2621;8619
210180;201502;1535;4694;1436;4550;77;284;1239;3918;1316;4202
210190;201502;4805;15436;4495;14909;259;1180;3569;11641;3828;12821
210193;201502;1392;4431;1261;4212;74;266;1063;3600;1137;3866
210197;201502;2071;6858;1917;6695;206;636;1560;5689;1766;6325
210200;201502;8680;29351;8058;28455;969;3192;6169;22686;7138;25878
210203;201502;6386;21105;6065;20694;385;1161;5408;18765;5793;19926
210207;201502;3037;10018;2845;9677;381;1204;2078;7307;2459;8511
210210;201502;8436;28771;8087;28328;136;597;7427;26382;7563;26979
210215;201502;1450;5832;1400;5754;121;560;1159;4781;1280;5341
210220;201502;6064;23412;5789;22985;419;1740;4812;19455;5231;21195
210230;201502;5070;17047;4707;16483;310;1142;3964;14037;4274;15179
210232;201502;11939;39951;10252;37875;1660;6210;7149;27992;8809;34202
210235;201502;3403;10699;3141;10368;197;722;2702;9001;2899;9723
210237;201502;2439;9199;2404;9153;35;108;2324;8920;2359;9028
210240;201502;3001;9492;2848;9281;176;539;2416;7989;2592;8528
210250;201502;5004;16129;4756;15818;132;547;4429;14723;4561;15270
210255;201502;2431;7884;2257;7577;394;1365;1534;5212;1928;6577
210260;201502;5372;17054;4890;16354;672;2191;3604;12410;4276;14601
210270;201502;5281;15166;4689;14348;111;434;4241;13001;4352;13435
210275;201502;3590;8921;3377;8695;67;106;3262;8507;3329;8613
210280;201502;5573;16909;4916;16069;291;1089;4142;13590;4433;14679
210290;201502;5627;18410;5164;17847;383;1267;4399;15536;4782;16803
210300;201502;36381;105153;30283;97636;2141;7145;24012;80267;26153;87412
210310;201502;2879;8256;2703;8025;103;260;2401;7192;2504;7452
210312;201502;2161;6971;2098;6882;83;345;1903;6240;1986;6585
210315;201502;2409;8408;2294;8251;118;491;2007;7248;2125;7739
210317;201502;4284;12931;4091;12688;235;696;3666;11524;3901;12220
210320;201502;19035;60819;17722;59256;969;3101;15576;53196;16545;56297
210325;201502;3536;11125;3168;10577;336;1213;2382;8041;2718;9254
210330;201502;36661;88447;28470;79795;3593;7753;20713;65226;24306;72979
210340;201502;11677;35747;10594;34410;1344;3545;7885;27632;9229;31177
210350;201502;10147;31936;9323;30801;647;2123;7733;26007;8380;28130
210355;201502;3915;14293;3625;13892;158;470;3285;13002;3443;13472
210360;201502;16644;50536;15380;48800;1156;3787;12473;40242;13629;44029
210370;201502;9127;22329;7815;20934;252;494;7115;19599;7367;20093
210375;201502;3180;9561;2668;8944;729;2516;1463;5082;2192;7598
210380;201502;6164;17393;5480;16482;455;1216;4575;14124;5030;15340
210390;201502;2799;9934;2561;9543;117;581;2220;8282;2337;8863
210400;201502;4894;15315;4695;15076;174;516;4312;14014;4486;14530
210405;201502;8423;23262;6860;21126;2037;6200;3105;10633;5142;16833
210407;201502;2038;7269;1803;6891;191;705;1412;5588;1603;6293
210408;201502;2330;9070;2183;8897;90;334;1954;8272;2044;8606
210409;201502;3757;13719;3555;13417;200;831;3015;11532;3215;12363
210410;201502;3435;11445;3310;11288;256;714;2891;10175;3147;10889
210420;201502;4057;13463;3755;12942;264;915;3112;10921;3376;11836
210430;201502;2189;6766;2120;6684;118;391;1887;5959;2005;6350
210440;201502;4096;12877;3996;12740;204;600;3607;11672;3811;12272
210450;201502;2869;9096;2584;8685;178;691;2130;7133;2308;7824
210455;201502;4060;11999;3571;11254;584;1872;2481;8009;3065;9881
210460;201502;3853;12486;3571;12101;142;573;3140;10698;3282;11271
210462;201502;1627;5894;1520;5695;105;458;1227;4634;1332;5092
210465;201502;2608;8633;2451;8435;282;767;1999;7205;2281;7972
210467;201502;6148;20420;5764;19971;389;1137;5003;17848;5392;18985
210470;201502;2031;5606;1575;4949;82;270;1269;4056;1351;4326
210480;201502;13879;45770;12131;43454;3239;11413;6972;26744;10211;38157
210490;201502;3447;10064;3127;9602;188;635;2619;8041;2807;8676
210500;201502;6366;25981;6103;25544;715;2848;4715;20497;5430;23345
210510;201502;6519;22197;6228;21852;334;854;5466;19925;5800;20779
210515;201502;3502;11713;3375;11563;132;382;3129;10888;3261;11270
210520;201502;2585;8063;2376;7779;101;336;2116;6997;2217;7333
210530;201502;35824;112112;29137;102175;7302;28833;14204;51074;21506;79907
210535;201502;3224;11335;3101;11152;134;490;2760;10038;2894;10528
210540;201502;13038;44267;11604;42051;2753;9679;6487;25487;9240;35166
210542;201502;5914;17591;5421;17054;309;759;4797;15570;5106;16329
210545;201502;2313;7589;2196;7400;78;371;1904;6385;1982;6756
210547;201502;3751;13215;3521;12842;286;976;2838;10629;3124;11605
210550;201502;5711;16749;5278;16298;211;447;4891;15501;5102;15948
210560;201502;4194;13120;3744;12401;220;826;3152;10429;3372;11255
210565;201502;1526;5320;1324;5023;115;541;993;3790;1108;4331
210570;201502;12461;35370;11195;33910;838;1913;9556;30027;10394;31940
210580;201502;3127;9564;2819;9177;352;920;2180;7716;2532;8636
210590;201502;4248;13295;3995;13003;246;799;3528;11632;3774;12431
210592;201502;2442;7682;2351;7536;61;241;2116;6789;2177;7030
210594;201502;2711;7722;2260;7092;128;343;1871;6069;1999;6412
210596;201502;2776;10361;2631;10089;271;1105;2004;7801;2275;8906
210598;201502;1941;6029;1805;5861;97;384;1615;5209;1712;5593
210600;201502;3237;9443;2879;8956;200;674;2359;7338;2559;8012
210610;201502;2701;8613;2448;8302;160;612;2083;7148;2243;7760
210620;201502;1929;6005;1789;5832;54;147;1634;5419;1688;5566
210630;201502;3620;12938;3195;12202;452;1784;2068;8150;2520;9934
210632;201502;4618;15995;4264;15500;388;1447;3488;12864;3876;14311
210635;201502;1908;6749;1818;6612;71;247;1652;6097;1723;6344
210637;201502;2779;9364;2599;9114;140;501;2245;7995;2385;8496
210640;201502;4263;14977;4188;14894;7;20;4107;14707;4114;14727
210650;201502;6765;20909;6627;20749;93;261;6438;20284;6531;20545
210660;201502;7717;23610;7179;22830;206;560;6700;21464;6906;22024
210663;201502;2666;7854;2510;7658;170;563;2137;6571;2307;7134
210667;201502;1786;6327;1704;6199;83;351;1497;5496;1580;5847
210670;201502;4470;16767;4308;16499;282;1189;3624;14074;3906;15263
210675;201502;4918;13811;4565;13378;319;856;3901;11679;4220;12535
210680;201502;4285;12204;3910;11757;200;545;3416;10432;3616;10977
210690;201502;7231;24021;6813;23576;261;784;6188;21977;6449;22761
210700;201502;2596;7798;2420;7605;515;1332;1610;5770;2125;7102
210710;201502;4757;15709;4537;15366;181;698;3986;13581;4167;14279
210720;201502;2542;9276;2392;9058;148;656;2097;7905;2245;8561
210725;201502;1093;4109;964;3876;141;622;581;2347;722;2969
210730;201502;1115;3601;1033;3494;78;220;880;3055;958;3275
210735;201502;4041;14348;3732;13822;678;2548;2515;9656;3193;12204
210740;201502;4937;14405;4676;14141;135;452;4449;13494;4584;13946
210745;201502;3872;11571;3618;11231;256;621;3085;9790;3341;10411
210750;201502;20292;55408;18102;52962;1967;5648;14454;43281;16421;48929
210760;201502;5976;16540;5639;16184;49;160;5510;15837;5559;15997
210770;201502;5742;16142;5106;15428;164;532;4677;14202;4841;14734
210780;201502;8520;28338;7836;27136;908;3307;5628;19874;6536;23181
210790;201502;4740;14577;4087;13865;291;738;3443;12266;3734;13004
210800;201502;4723;13749;4373;13345;135;397;3975;12301;4110;12698
210805;201502;3619;15472;3505;15273;151;676;3099;13742;3250;14418
210810;201502;5412;16672;5059;16248;360;651;4460;15105;4820;15756
210820;201502;8036;23149;7390;22262;1324;3917;4966;15404;6290;19321
210825;201502;5715;19273;5473;18970;333;1029;4801;17023;5134;18052
210830;201502;8396;25502;8019;25051;761;2101;6701;21547;7462;23648
210840;201502;3738;10354;3393;9836;229;593;2744;8019;2973;8612
210845;201502;5701;17769;5478;17525;163;378;5085;16642;5248;17020
210850;201502;6078;21949;5601;21134;728;3116;4077;15464;4805;18580
210860;201502;17367;52682;15874;50676;1432;4711;12657;41024;14089;45735
210870;201502;6036;19984;5510;19368;537;1735;4475;16222;5012;17957
210880;201502;4252;13793;4126;13617;184;590;3734;12463;3918;13053
210890;201502;5348;15825;4925;15324;406;1328;4126;13016;4532;14344
210900;201502;4977;15126;4194;13882;1354;4616;1657;5912;3011;10528
210905;201502;1852;5827;1712;5642;126;325;1426;4878;1552;5203
210910;201502;8957;28532;8215;27366;1350;4831;5669;19041;7019;23872
210920;201502;3185;11030;3075;10865;168;597;2673;9599;2841;10196
210923;201502;1488;5333;1385;5189;164;627;1016;3983;1180;4610
210927;201502;4801;15153;4616;14963;23;75;4540;14762;4563;14837
210930;201502;2534;9295;2420;9150;155;758;2076;7802;2231;8560
210940;201502;2807;11080;2758;10988;225;891;2320;9359;2545;10250
210945;201502;5963;17727;5756;17514;236;272;5468;17130;5704;17402
210950;201502;5336;16476;4729;15529;459;1563;3594;12047;4053;13610
210955;201502;1892;6140;1672;5815;265;907;1145;4196;1410;5103
210960;201502;8781;28957;8446;28498;2360;7681;5045;18182;7405;25863
210970;201502;1410;5061;1262;4836;175;801;893;3460;1068;4261
210975;201502;1762;5996;1680;5854;141;528;1348;4752;1489;5280
210980;201502;9754;23270;9508;23001;691;1340;8385;20832;9076;22172
210990;201502;16694;49535;13454;45443;2842;10040;8048;28150;10890;38190
211000;201502;15848;51020;14213;49035;745;2727;12418;43630;13163;46357
211003;201502;4775;16930;4381;16351;359;1511;3391;12982;3750;14493
211010;201502;6552;23292;6334;23040;90;298;6061;22271;6151;22569
211020;201502;7384;23421;7216;23169;290;972;6495;20973;6785;21945
211023;201502;2348;7932;2270;7792;111;409;2003;6940;2114;7349
211027;201502;2909;11388;2813;11241;250;916;2334;9600;2584;10516
211030;201502;4037;12266;3654;11859;613;1448;2831;9901;3444;11349
211040;201502;4268;16270;4134;16064;131;579;3683;14553;3814;15132
211050;201502;10120;26873;9956;26692;261;572;9519;25714;9780;26286
211060;201502;6009;21436;5861;21217;465;1653;4999;18415;5464;20068
211065;201502;1819;6125;1657;5921;34;103;1580;5721;1614;5824
211070;201502;8311;28225;7681;27172;499;1808;6367;22886;6866;24694
211080;201502;1398;4239;1152;3902;103;495;907;2979;1010;3474
211085;201502;1881;6558;1728;6310;244;878;1258;4720;1502;5598
211090;201502;3544;10703;3332;10418;131;537;2921;9046;3052;9583
211100;201502;6670;17411;6505;17226;49;182;6317;16710;6366;16892
211102;201502;3087;11462;2933;11251;256;928;2499;9801;2755;10729
211105;201502;2694;8567;2322;8046;155;624;1944;6720;2099;7344
211107;201502;4494;14270;4076;13726;244;773;3481;12059;3725;12832
211110;201502;6266;19030;5106;17312;953;3158;3187;11384;4140;14542
211120;201502;33639;92763;29764;88123;4582;12765;21485;66233;26067;78998
211125;201502;2123;6881;1910;6550;117;427;1635;5651;1752;6078
211130;201502;134562;381626;123920;368491;22623;67486;83811;254897;106434;322383
211140;201502;5421;17314;5080;16796;224;827;4396;14571;4620;15398
211150;201502;9807;29158;9061;28248;526;1766;7832;24573;8358;26339
211153;201502;2940;9026;2738;8788;367;1003;2195;7375;2562;8378
211157;201502;1225;3958;1046;3694;113;482;718;2626;831;3108
211160;201502;4051;13729;3503;12801;327;1507;2580;9345;2907;10852
211163;201502;1644;5511;1567;5399;53;182;1420;4992;1473;5174
211167;201502;1504;4995;1405;4850;28;110;1315;4570;1343;4680
211170;201502;6478;17298;6224;17010;115;354;5815;15885;5930;16239
211172;201502;2371;7042;2144;6708;143;574;1802;5524;1945;6098
211174;201502;2834;8316;2570;7989;79;341;2314;7131;2393;7472
211176;201502;4973;15470;4419;14801;471;1573;3418;11804;3889;13377
211178;201502;3410;9860;3355;9804;61;126;3244;9554;3305;9680
211180;201502;4297;15210;4065;14847;290;1152;3401;12611;3691;13763
211190;201502;2793;9441;2601;9176;79;358;2314;8216;2393;8574
211195;201502;1489;4590;1249;4297;86;260;1033;3706;1119;3966
211200;201502;2101;7346;1881;7050;222;754;1466;5746;1688;6500
211210;201502;7172;21820;6893;21445;400;1235;6001;18894;6401;20129
211220;201502;34187;100124;29572;94292;5743;18845;19134;62695;24877;81540
211223;201502;5198;15368;4750;14663;518;1609;3579;11249;4097;12858
211227;201502;1645;6030;1531;5856;132;598;1218;4696;1350;5294
211230;201502;8586;28480;7803;27202;1025;3630;5660;20199;6685;23829
211240;201502;8138;28044;7775;27624;262;954;7213;25756;7475;26710
211245;201502;5413;15697;5355;15629;102;199;5154;15206;5256;15405
211250;201502;12733;44018;12033;43236;1372;3597;9818;37674;11190;41271
211260;201502;8454;26318;8225;26017;568;1766;7292;23243;7860;25009
211270;201502;10437;35924;9433;34703;571;2406;7815;29327;8386;31733
211280;201502;12587;37339;11896;36523;1042;2518;10131;32365;11173;34883
211285;201502;1744;6434;1568;6050;334;1411;825;3297;1159;4708
211290;201502;7248;24020;7027;23744;620;1760;5991;20830;6611;22590
211300;201502;8190;25041;7661;24317;261;871;6908;22057;7169;22928
211400;201502;12852;37556;10803;35180;2622;8429;5945;21861;8567;30290
220005;201502;1808;5249;1671;5047;73;296;1396;4115;1469;4411
220010;201502;1451;4145;1278;3903;87;334;979;2959;1066;3293
220020;201502;3359;10568;3158;10232;519;1778;2178;7024;2697;8802
220025;201502;2248;5543;2023;5216;50;146;1765;4516;1815;4662
220027;201502;1365;3732;1254;3594;75;192;1067;3104;1142;3296
220030;201502;3290;9361;3232;9272;175;584;2841;8113;3016;8697
220040;201502;7785;24375;7296;23565;1394;4671;4664;15064;6058;19735
220045;201502;1407;4564;1293;4362;104;434;976;3223;1080;3657
220050;201502;4566;13447;3990;12559;253;956;3256;10145;3509;11101
220060;201502;1976;5208;1893;5114;56;145;1760;4771;1816;4916
220070;201502;2464;7292;2246;6957;147;500;1826;5640;1973;6140
220080;201502;728;2280;690;2219;68;282;553;1722;621;2004
220090;201502;1794;4614;1547;4290;92;318;1322;3602;1414;3920
220095;201502;743;2001;700;1942;26;77;651;1798;677;1875
220100;201502;1398;4234;1188;3891;120;412;882;2927;1002;3339
220105;201502;2198;7150;1988;6748;165;585;1487;5072;1652;5657
220110;201502;3367;9995;3173;9676;184;714;2664;7962;2848;8676
220115;201502;2326;8367;2246;8240;194;801;1903;6960;2097;7761
220117;201502;1382;3679;1132;3316;93;269;901;2654;994;2923
220120;201502;12265;35583;11458;34600;186;762;10818;32622;11004;33384
220130;201502;899;3171;798;3041;60;192;695;2717;755;2909
220140;201502;1627;4401;1470;4210;225;458;1177;3579;1402;4037
220150;201502;6994;21881;6653;21433;204;793;6067;19532;6271;20325
220155;201502;1098;3412;904;3049;72;303;616;2022;688;2325
220157;201502;1058;2700;947;2540;24;73;834;2216;858;2289
220160;201502;2753;8272;2431;7726;133;549;1952;6127;2085;6676
220170;201502;1365;4261;1212;4011;69;317;988;3239;1057;3556
220173;201502;2053;6267;1730;5650;61;302;1419;4573;1480;4875
220177;201502;1758;5167;1729;5123;62;190;1621;4812;1683;5002
220180;201502;1177;3177;1009;2886;40;155;772;2151;812;2306
220190;201502;4465;14941;4069;14402;480;1649;3211;11567;3691;13216
220191;201502;1436;4889;1371;4775;184;627;1021;3591;1205;4218
220192;201502;1784;5109;1423;4466;146;492;993;3121;1139;3613
220194;201502;1717;5113;1562;4853;144;509;1191;3606;1335;4115
220196;201502;1942;5795;1807;5575;176;589;1400;4329;1576;4918
220198;201502;1351;3803;1068;3437;17;59;997;3242;1014;3301
220200;201502;4357;15007;4153;14710;637;2315;2999;10739;3636;13054
220202;201502;2035;6405;1855;6079;39;174;1670;5439;1709;5613
220205;201502;2918;7543;2549;7052;56;214;2306;6324;2362;6538
220207;201502;868;2717;777;2560;74;292;589;1921;663;2213
220208;201502;1760;5848;1568;5506;195;806;1123;3903;1318;4709
220209;201502;1514;4696;1385;4491;61;266;1123;3614;1184;3880
220210;201502;1750;4737;1547;4440;48;188;1318;3730;1366;3918
220211;201502;1636;4801;1557;4699;93;384;1340;3978;1433;4362
220213;201502;1746;5080;1639;4892;56;221;1371;4024;1427;4245
220217;201502;1878;6154;1803;6065;43;117;1689;5757;1732;5874
220220;201502;11169;31519;10159;30002;934;2491;7530;22858;8464;25349
220225;201502;1052;3144;923;2968;40;180;804;2540;844;2720
220230;201502;5684;15355;4977;14396;162;458;4465;13003;4627;13461
220240;201502;2844;8956;2655;8637;193;702;2076;6742;2269;7444
220245;201502;1496;4037;1341;3819;53;152;1178;3402;1231;3554
220250;201502;3177;9026;2983;8745;52;153;2768;8171;2820;8324
220253;201502;1769;5276;1503;4820;125;475;1147;3670;1272;4145
220255;201502;1756;4994;1531;4629;77;315;1263;3722;1340;4037
220260;201502;4755;15289;4231;14330;347;1235;3233;11019;3580;12254
220265;201502;1332;4678;1230;4517;109;476;882;3270;991;3746
220270;201502;6796;22089;6592;21738;349;1618;5708;18396;6057;20014
220271;201502;1498;4224;1398;4076;51;127;1242;3684;1293;3811
220272;201502;1788;5513;1660;5292;86;356;1336;4219;1422;4575
220273;201502;1216;3593;1096;3395;97;329;848;2606;945;2935
220275;201502;2036;5358;1723;4980;29;102;1596;4590;1625;4692
220277;201502;2352;6570;2121;6222;113;371;1745;5138;1858;5509
220280;201502;1727;4588;1526;4268;127;456;1149;3119;1276;3575
220285;201502;1571;4333;1374;4055;45;177;1204;3573;1249;3750
220290;201502;6135;20586;5355;19532;514;2126;4121;15107;4635;17233
220300;201502;1949;6358;1743;6077;81;364;1485;5181;1566;5545
220310;201502;2497;8371;2227;8068;72;206;2026;7600;2098;7806
220320;201502;3356;9989;2861;9121;345;1201;2038;6509;2383;7710
220323;201502;1482;5314;1300;5054;135;591;993;3896;1128;4487
220325;201502;1115;3724;1006;3502;95;408;746;2571;841;2979
220327;201502;1373;4413;1244;4197;58;290;1006;3343;1064;3633
220330;201502;3623;10091;3393;9803;145;416;3037;8836;3182;9252
220335;201502;2037;5904;1815;5644;71;234;1618;5075;1689;5309
220340;201502;1901;5316;1639;4942;132;443;1264;3779;1396;4222
220342;201502;1081;3705;1023;3618;80;341;843;2994;923;3335
220345;201502;2929;7755;2558;7177;54;155;2302;6448;2356;6603
220350;201502;3996;10714;3507;9981;200;632;2864;8131;3064;8763
220360;201502;1281;3645;1126;3397;103;356;860;2570;963;2926
220370;201502;9117;26252;8286;25182;355;1074;7440;22713;7795;23787
220375;201502;1535;4814;1423;4676;38;140;1331;4396;1369;4536
220380;201502;1416;3832;1211;3554;66;223;988;2877;1054;3100
220385;201502;811;2150;672;1920;32;113;550;1539;582;1652
220390;201502;9480;29692;8568;28013;2247;7739;3341;11030;5588;18769
220400;201502;1520;3582;1266;3201;42;144;1077;2640;1119;2784
220410;201502;1408;4007;1180;3682;105;419;916;2788;1021;3207
220415;201502;861;2361;777;2249;65;195;594;1720;659;1915
220420;201502;2170;6341;1896;5794;104;333;1544;4734;1648;5067
220430;201502;2549;7458;2471;7349;153;478;2131;6335;2284;6813
220435;201502;1588;4738;1480;4562;46;158;1271;3916;1317;4074
220440;201502;2471;8089;2283;7869;113;390;2017;6977;2130;7367
220450;201502;2319;7093;1983;6613;443;1587;1187;3959;1630;5546
220455;201502;1331;4237;1241;4113;46;146;1130;3796;1176;3942
220460;201502;972;2632;898;2543;38;105;810;2289;848;2394
220465;201502;2341;7800;2138;7499;523;1950;1296;4577;1819;6527
220470;201502;4033;12030;3675;11442;210;755;2887;8877;3097;9632
220480;201502;2534;7334;2272;6958;164;516;1834;5633;1998;6149
220490;201502;2320;6711;2158;6511;76;287;1934;5825;2010;6112
220500;201502;3372;9029;2840;8138;120;521;2316;6459;2436;6980
220510;201502;3007;8373;2259;7229;109;467;1687;5359;1796;5826
220515;201502;1991;4902;1746;4599;86;215;1479;3932;1565;4147
220520;201502;5142;14299;4745;13759;132;403;4291;12518;4423;12921
220525;201502;1341;3828;1246;3687;61;226;1062;3099;1123;3325
220527;201502;1406;4341;1260;4031;128;410;943;3088;1071;3498
220530;201502;1234;3633;1119;3464;74;297;945;2856;1019;3153
220535;201502;881;2709;855;2679;83;286;675;2106;758;2392
220540;201502;3467;11371;3320;11149;161;664;2869;9613;3030;10277
220545;201502;1410;4819;1351;4712;166;674;1012;3474;1178;4148
220550;201502;9156;29702;8611;28810;1076;3811;6348;21350;7424;25161
220551;201502;1429;4747;1321;4575;83;379;1065;3650;1148;4029
220552;201502;1610;5091;1408;4716;97;469;1081;3481;1178;3950
220553;201502;1660;4882;1372;4445;63;241;1116;3642;1179;3883
220554;201502;816;2359;728;2234;76;236;563;1744;639;1980
220555;201502;2355;6969;2196;6774;52;195;1993;6148;2045;6343
220556;201502;1458;4556;1326;4315;71;284;1034;3331;1105;3615
220557;201502;1575;5169;1423;4879;175;657;972;3331;1147;3988
220558;201502;1058;3297;968;3139;76;333;737;2334;813;2667
220559;201502;1503;4222;1369;4012;42;155;1193;3482;1235;3637
220560;201502;1745;4294;1435;3885;67;180;1228;3313;1295;3493
220570;201502;7425;23814;6975;23078;1251;4111;4685;15911;5936;20022
220580;201502;6537;21220;6376;21028;299;916;5869;19579;6168;20495
220585;201502;1975;7168;1895;7024;115;464;1612;5998;1727;6462
220590;201502;1330;4070;1221;3922;200;665;839;2755;1039;3420
220595;201502;2384;6963;2194;6712;49;208;2009;6115;2058;6323
220600;201502;1285;3150;1056;2868;179;353;765;2226;944;2579
220605;201502;1990;5867;1742;5489;80;268;1450;4565;1530;4833
220610;201502;2663;8218;2585;8104;95;384;2311;7202;2406;7586
220620;201502;7772;26316;7542;25987;329;1337;6767;23342;7096;24679
220630;201502;397;1232;346;1135;62;226;187;619;249;845
220635;201502;1766;6315;1618;6002;126;589;1119;4109;1245;4698
220640;201502;2649;7757;2444;7474;141;492;2071;6310;2212;6802
220650;201502;2329;6715;2087;6305;116;411;1700;5103;1816;5514
220660;201502;2544;8153;2269;7790;196;860;1869;6281;2065;7141
220665;201502;1177;4122;1130;4043;37;178;1027;3655;1064;3833
220667;201502;1796;5957;1696;5827;53;199;1489;5149;1542;5348
220669;201502;1914;6227;1787;5998;267;1070;1217;4027;1484;5097
220670;201502;2041;6239;1869;6023;145;358;1607;5376;1752;5734
220672;201502;2536;7210;2412;7067;253;709;2002;5962;2255;6671
220675;201502;1294;3764;1209;3626;87;234;961;2907;1048;3141
220680;201502;2236;7274;2120;7118;166;560;1774;6027;1940;6587
220690;201502;1735;4850;1510;4492;91;306;1210;3600;1301;3906
220695;201502;918;2666;853;2559;47;169;685;2028;732;2197
220700;201502;8782;25328;7863;23949;595;2059;6167;18698;6762;20757
220710;201502;799;2373;671;2150;51;151;493;1604;544;1755
220720;201502;2074;5670;1974;5541;56;171;1776;5009;1832;5180
220730;201502;1400;3937;1199;3626;40;161;1014;3042;1054;3203
220735;201502;1022;2644;835;2314;40;145;681;1861;721;2006
220740;201502;1455;4582;1218;4266;154;531;944;3408;1098;3939
220750;201502;3974;11583;3725;11211;427;1091;2943;9167;3370;10258
220755;201502;1223;3525;1124;3361;57;199;935;2781;992;2980
220760;201502;2680;9328;2525;9124;115;504;2216;8049;2331;8553
220770;201502;22692;75673;20508;71487;6703;24540;7596;27334;14299;51874
220775;201502;1204;3134;1169;3095;8;12;1149;3053;1157;3065
220777;201502;1676;4686;1529;4465;98;279;1234;3587;1332;3866
220779;201502;1261;3523;1223;3476;37;140;1125;3146;1162;3286
220780;201502;6160;16231;5503;15310;381;1045;4589;12853;4970;13898
220785;201502;1310;3533;1275;3459;55;130;1184;3222;1239;3352
220790;201502;9828;30936;9234;29992;882;3096;7300;23611;8182;26707
220793;201502;850;2449;782;2342;39;147;668;1987;707;2134
220795;201502;1465;4117;1415;4046;81;246;1260;3607;1341;3853
220800;201502;16438;45568;14948;43488;1031;3676;11656;33500;12687;37176
220810;201502;3365;9813;2932;9090;156;629;2344;7195;2500;7824
220820;201502;5321;14858;4977;14389;182;581;4510;13026;4692;13607
220830;201502;7532;21433;7106;20766;701;2064;5617;16567;6318;18631
220840;201502;14479;46049;13012;43162;3154;10744;6229;21108;9383;31852
220850;201502;2834;9868;2707;9707;144;547;2390;8660;2534;9207
220855;201502;639;1979;567;1853;47;182;414;1334;461;1516
220860;201502;959;2607;862;2455;48;183;710;1985;758;2168
220865;201502;2716;7489;2190;6623;103;506;1773;5190;1876;5696
220870;201502;2375;7838;2100;7488;75;280;1922;6879;1997;7159
220880;201502;4839;13063;4548;12725;129;419;4242;11866;4371;12285
220885;201502;1337;4766;1190;4499;109;516;894;3365;1003;3881
220887;201502;1391;3508;1202;3244;21;67;1125;3044;1146;3111
220890;201502;1624;5712;1477;5464;117;402;1204;4601;1321;5003
220900;201502;1868;5392;1657;4985;75;217;1398;4219;1473;4436
220910;201502;1639;4936;1463;4678;61;196;1278;4120;1339;4316
220915;201502;1034;2962;896;2711;45;196;691;2039;736;2235
220920;201502;1333;4898;1230;4748;120;558;926;3532;1046;4090
220930;201502;1371;4623;1306;4530;72;303;1105;3850;1177;4153
220935;201502;1067;3249;963;3036;60;260;690;2096;750;2356
220937;201502;1540;4235;1302;3823;66;247;1020;2920;1086;3167
220940;201502;1415;4397;1311;4177;78;323;1017;3198;1095;3521
220945;201502;454;1642;420;1577;47;202;296;1097;343;1299
220950;201502;1319;3305;972;2741;36;140;721;1978;757;2118
220955;201502;1501;4311;1325;4017;89;282;1024;3102;1113;3384
220960;201502;898;2392;733;2114;21;88;591;1681;612;1769
220965;201502;1696;5103;1603;4971;61;277;1405;4293;1466;4570
220970;201502;2171;5796;1621;4919;152;474;1116;3421;1268;3895
220975;201502;645;2217;633;2201;32;125;585;2032;617;2157
220980;201502;1317;4056;1159;3780;97;370;847;2766;944;3136
220985;201502;1245;3681;1191;3597;99;347;948;2834;1047;3181
220987;201502;1518;4843;1394;4635;99;445;1066;3448;1165;3893
220990;201502;1862;5368;1621;4971;61;272;1268;3810;1329;4082
220995;201502;1310;3832;992;3330;81;326;742;2519;823;2845
220997;201502;2199;6938;2099;6790;74;250;1948;6319;2022;6569
221000;201502;4407;13529;4075;12973;440;1619;3044;9589;3484;11208
221005;201502;1440;4560;1334;4363;454;1371;637;2224;1091;3595
221010;201502;1175;3197;1011;2982;49;144;888;2629;937;2773
221020;201502;1838;5709;1716;5492;98;433;1321;4153;1419;4586
221030;201502;1629;4680;1440;4393;85;354;1187;3563;1272;3917
221035;201502;1436;3993;1359;3902;52;118;1259;3667;1311;3785
221037;201502;638;1921;574;1815;23;100;442;1342;465;1442
221038;201502;630;1776;508;1568;44;130;331;1045;375;1175
221039;201502;924;2669;845;2554;52;215;724;2133;776;2348
221040;201502;4693;14453;4434;14035;233;825;3684;11743;3917;12568
221050;201502;3509;10929;3339;10698;162;632;2927;9354;3089;9986
221060;201502;8208;23716;7364;22391;724;2382;5622;17150;6346;19532
221062;201502;1299;4567;1214;4432;27;101;1110;4093;1137;4194
221063;201502;1049;3497;975;3355;274;882;571;2128;845;3010
221065;201502;2805;7858;2568;7490;214;631;2099;6107;2313;6738
221070;201502;3957;12447;3516;11725;164;660;2917;9746;3081;10406
221080;201502;3499;9256;3062;8668;145;464;2633;7480;2778;7944
221090;201502;1373;3780;1183;3475;34;148;979;2823;1013;2971
221093;201502;1718;5135;1623;4943;347;1132;892;2653;1239;3785
221095;201502;969;2645;877;2517;28;80;770;2222;798;2302
221097;201502;806;2288;694;2098;55;220;519;1533;574;1753
221100;201502;117056;344045;108059;329330;20003;65856;68734;206368;88737;272224
221110;201502;10142;32804;9605;32143;453;1723;8416;28231;8869;29954
221120;201502;4127;13558;3930;13216;837;2916;2603;8853;3440;11769
221130;201502;4537;13269;3902;12005;1253;3906;1673;5157;2926;9063
221135;201502;1479;4676;1385;4546;155;598;1113;3591;1268;4189
221140;201502;1352;3378;1245;3239;57;137;1113;2901;1170;3038
221150;201502;1242;3208;1027;2844;28;126;823;2241;851;2367
221160;201502;838;2225;787;2146;38;115;629;1733;667;1848
221170;201502;1154;3617;1076;3485;68;247;872;2801;940;3048
230010;201502;3291;9073;2768;8180;146;502;2276;6695;2422;7197
230015;201502;2823;9849;2643;9454;395;1660;1698;5951;2093;7611
230020;201502;14316;47071;13856;46276;690;2546;11863;39885;12553;42431
230030;201502;12245;35614;11203;34006;609;2101;9388;28454;9997;30555
230040;201502;4628;12869;3919;11672;271;961;3025;8939;3296;9900
230050;201502;2594;8946;2056;7516;425;1656;861;3147;1286;4803
230060;201502;2168;6348;1897;5871;121;440;1460;4480;1581;4920
230070;201502;4480;12289;3869;11359;375;1204;2755;8211;3130;9415
230075;201502;8823;31903;8280;30803;640;3265;6596;24031;7236;27296
230080;201502;2387;6411;1974;5816;106;356;1638;4815;1744;5171
230090;201502;3719;11112;3323;10432;361;1256;2438;7681;2799;8937
230100;201502;16493;49897;15066;47267;2960;9997;8739;27541;11699;37538
230110;201502;13656;44100;12683;42109;2367;8471;7381;24322;9748;32793
230120;201502;7953;22025;6905;20549;762;2195;4995;15486;5757;17681
230125;201502;2933;8634;2441;7703;189;682;1802;5663;1991;6345
230130;201502;5829;19198;4956;17357;502;2101;3404;11711;3906;13812
230140;201502;3611;11618;3080;10664;414;1553;2061;7279;2475;8832
230150;201502;1634;5229;1448;4848;258;977;891;2898;1149;3875
230160;201502;6468;19482;5759;18409;402;1533;4507;14361;4909;15894
230170;201502;6522;20475;5578;18745;397;1607;4129;13776;4526;15383
230180;201502;1768;5204;1575;4843;101;394;1174;3504;1275;3898
230185;201502;4160;13743;3788;13063;659;2317;2383;8531;3042;10848
230190;201502;12938;41412;11571;38742;2451;9210;5796;19039;8247;28249
230195;201502;5161;15888;4585;14937;276;1208;3662;11617;3938;12825
230200;201502;5501;16018;4939;14933;468;1554;3672;11020;4140;12574
230205;201502;4280;13627;3838;12880;276;1210;2842;9475;3118;10685
230210;201502;9073;26382;7906;24574;1812;5732;4474;14380;6286;20112
230220;201502;13086;38056;11872;35983;1246;4342;8680;25907;9926;30249
230230;201502;7588;24805;6891;23440;1007;3613;4438;15247;5445;18860
230240;201502;13683;39155;12224;36653;664;2485;9691;28588;10355;31073
230250;201502;10128;31474;9956;31229;440;1646;8562;26729;9002;28375
230260;201502;14560;49354;13537;47333;2532;9465;7898;28166;10430;37631
230270;201502;7269;21883;6325;20252;769;2704;4337;13990;5106;16694
230280;201502;19841;59603;17767;56153;2220;7125;12636;40358;14856;47483
230290;201502;4835;14930;4201;13669;570;1898;2839;9270;3409;11168
230300;201502;4445;13656;4234;13349;333;1284;3390;10537;3723;11821
230310;201502;4839;14520;4230;13506;296;1243;3169;9941;3465;11184
230320;201502;7040;22649;6491;21686;535;2157;4993;16619;5528;18776
230330;201502;4800;14253;4181;13063;323;1177;3025;9360;3348;10537
230340;201502;3407;11680;3150;11144;434;1745;2040;7084;2474;8829
230350;201502;17747;54769;16088;51982;2298;8181;10155;33448;12453;41629
230360;201502;3298;9527;2715;8447;314;1109;1827;5632;2141;6741
230365;201502;3027;8400;2654;7800;121;461;2170;6317;2291;6778
230370;201502;54133;176901;49131;168395;13458;48662;23310;82200;36768;130862
230380;201502;6554;19396;5624;17729;371;1328;4171;13163;4542;14491
230390;201502;3571;11309;3183;10664;306;1315;2286;7504;2592;8819
230393;201502;3297;10956;2830;9997;261;1264;2007;6804;2268;8068
230395;201502;5251;15980;4769;15138;768;2547;2975;9596;3743;12143
230400;201502;5336;16460;4650;15381;302;1331;3618;11759;3920;13090
230410;201502;14197;45656;12564;42206;1879;6793;7867;26428;9746;33221
230420;201502;24547;79988;22450;75796;5312;19400;10818;36395;16130;55795
230423;201502;4123;13782;3832;13207;301;1250;2948;10108;3249;11358
230425;201502;5556;18576;5104;17566;703;2590;3406;11758;4109;14348
230426;201502;2782;7822;2245;6813;123;515;1690;4988;1813;5503
230427;201502;1814;5508;1425;4687;149;564;917;2951;1066;3515
230428;201502;8501;27233;8141;26618;1353;4999;5218;16882;6571;21881
230430;201502;4535;14588;4248;14040;369;1522;3099;10023;3468;11545
230435;201502;4684;15426;4257;14677;805;3182;2394;8181;3199;11363
230440;201502;350563;1066850;324924;1022406;77786;261510;159124;502708;236910;764218
230445;201502;4524;12306;3840;11315;270;790;2926;8775;3196;9565
230450;201502;3542;11423;3098;10622;365;1542;2094;7084;2459;8626
230460;201502;1917;6382;1708;6008;185;786;1211;4222;1396;5008
230465;201502;4154;12460;3490;11249;282;1190;2416;7623;2698;8813
230470;201502;10476;39206;9966;38163;1150;4879;7297;28022;8447;32901
230480;201502;1447;4690;1238;4303;172;655;817;2847;989;3502
230490;201502;2567;7774;2235;7155;393;1392;1181;3656;1574;5048
230495;201502;5788;19374;5230;18452;815;3471;3069;10780;3884;14251
230500;201502;9567;33590;9152;32834;622;2665;7290;26283;7912;28948
230510;201502;1533;5514;1258;4814;330;1358;437;1751;767;3109
230520;201502;4865;15033;4374;14156;459;1727;2945;9494;3404;11221
230523;201502;14379;47243;12684;43361;3145;11934;3535;12338;6680;24272
230526;201502;4006;12384;3528;11579;300;1198;2619;8565;2919;9763
230530;201502;5312;17442;4827;16792;934;3303;3251;11614;4185;14917
230533;201502;3956;11308;3565;10600;241;796;2772;8197;3013;8993
230535;201502;5545;16503;4843;15245;631;1977;3223;10460;3854;12437
230540;201502;18114;52889;16333;50122;745;2977;13773;41875;14518;44852
230550;201502;19627;59352;17721;55709;3702;12623;9542;29760;13244;42383
230560;201502;6688;19413;6009;18214;259;1046;4859;14577;5118;15623
230565;201502;3350;9458;2706;8229;160;600;1992;5975;2152;6575
230570;201502;3817;10327;3359;9761;134;523;2851;8204;2985;8727
230580;201502;10137;31083;9525;30229;448;1488;8502;27167;8950;28655
230590;201502;8852;28043;7773;26004;605;2604;5772;18849;6377;21453
230600;201502;3645;10324;2819;8658;195;686;1854;5663;2049;6349
230610;201502;5975;19677;5592;19068;710;2544;4064;14011;4774;16555
230620;201502;2182;6198;1754;5291;179;614;1062;3100;1241;3714
230625;201502;7819;25537;7004;23707;2076;7526;2161;7366;4237;14892
230630;201502;11434;36846;10452;35046;2750;8799;5009;18030;7759;26829
230640;201502;26059;85978;24190;83242;2746;10387;18511;63891;21257;74278
230650;201502;4934;15267;4454;14353;301;1268;3430;10784;3731;12052
230655;201502;8989;34056;8646;33486;682;2768;7222;28401;7904;31169
230660;201502;6092;19223;5291;17760;400;1704;3992;13180;4392;14884
230670;201502;6119;16560;4980;14629;223;883;3838;10973;4061;11856
230680;201502;2913;8511;2444;7643;368;1243;1461;4554;1829;5797
230690;201502;6267;20651;6164;20449;518;2148;4394;14285;4912;16433
230700;201502;9345;27016;8361;25294;755;2817;5953;17508;6708;20325
230710;201502;7469;24466;6542;22751;788;2816;4715;16638;5503;19454
230720;201502;1910;6064;1656;5585;206;737;1117;3835;1323;4572
230725;201502;3726;12642;3282;11581;761;2787;1426;5045;2187;7832
230730;201502;57252;174159;47722;158563;12965;47510;16642;56678;29607;104188
230740;201502;5864;18075;5407;17318;295;1290;4466;14084;4761;15374
230750;201502;8538;24628;7309;22669;473;1757;5736;17656;6209;19413
230760;201502;10277;31010;9652;29711;1048;3892;6876;20362;7924;24254
230763;201502;4319;13460;3945;12752;251;1183;3045;9528;3296;10711
230765;201502;38973;126069;35560;119259;9933;36215;12603;42595;22536;78810
230770;201502;24622;68739;22635;66010;2453;7733;16520;48338;18973;56071
230780;201502;6109;23782;5834;23181;1485;5995;2883;12110;4368;18105
230790;201502;2587;8656;2432;8409;250;948;1887;6563;2137;7511
230800;201502;7559;27190;6902;25758;1517;6161;3312;12298;4829;18459
230810;201502;12031;39484;11407;38427;962;3399;9243;31406;10205;34805
230820;201502;3331;11459;2935;10613;451;1869;1745;6261;2196;8130
230830;201502;7606;23268;6764;21739;614;2295;4886;15598;5500;17893
230835;201502;4056;10859;3375;9883;224;727;2677;7840;2901;8567
230837;201502;3174;10821;2774;10016;320;1365;1878;6711;2198;8076
230840;201502;9182;30239;8407;28899;822;3150;6332;21933;7154;25083
230850;201502;10167;31390;9370;30263;953;3423;7137;23013;8090;26436
230860;201502;5141;15144;4648;14346;290;1093;3697;11329;3987;12422
230870;201502;18886;50691;16513;47146;1029;3408;12943;36741;13972;40149
230880;201502;1912;6650;1797;6422;211;903;1204;4275;1415;5178
230890;201502;3986;14614;3694;13981;548;2495;2374;8766;2922;11261
230900;201502;3019;10116;2577;9194;546;1931;1329;4867;1875;6798
230910;201502;3166;9317;2563;8215;202;837;1850;5794;2052;6631
230920;201502;4525;13343;4215;12969;159;609;3777;11674;3936;12283
230930;201502;7471;22780;6623;21217;696;2387;4616;14891;5312;17278
230940;201502;7697;22146;6760;20756;398;1286;5436;16821;5834;18107
230945;201502;6199;18654;5362;17430;537;2010;3793;12518;4330;14528
230950;201502;7055;19329;6185;18183;384;1203;4939;14714;5323;15917
230960;201502;13650;42676;12428;40349;2645;9291;6119;20067;8764;29358
230970;201502;13189;41263;11764;38589;2429;9007;5576;17996;8005;27003
230980;201502;2962;9510;2612;8859;785;2690;1217;4322;2002;7012
230990;201502;1681;5127;1398;4555;148;612;924;2926;1072;3538
231000;201502;2864;7762;2266;6618;229;767;1457;4137;1686;4904
231010;201502;3182;8736;2666;7927;250;893;2007;5862;2257;6755
231020;201502;7845;26463;7464;25674;1321;4661;4737;16625;6058;21286
231025;201502;7907;24613;7179;23386;1044;3569;4736;15750;5780;19319
231030;201502;8066;26357;6841;23875;1220;4627;3931;13803;5151;18430
231040;201502;3149;10228;2804;9531;239;1008;2008;6687;2247;7695
231050;201502;12051;34596;10350;31563;860;2990;7656;23285;8516;26275
231060;201502;2465;7898;2255;7531;185;843;1616;5250;1801;6093
231070;201502;8926;28527;8174;27031;1387;4903;4851;16236;6238;21139
231080;201502;4227;13288;3853;12650;215;995;2948;9384;3163;10379
231085;201502;4676;14789;4495;14539;591;1841;3390;11323;3981;13164
231090;201502;4204;11882;3434;10369;188;711;2441;7239;2629;7950
231095;201502;2246;7365;1937;6743;215;831;1302;4573;1517;5404
231100;201502;3173;9862;2675;8886;238;922;1909;6266;2147;7188
231110;201502;3740;12513;3658;12373;368;1417;2735;9252;3103;10669
231120;201502;2133;7164;2015;6935;310;1143;1349;4681;1659;5824
231123;201502;2167;5953;1876;5482;154;436;1477;4366;1631;4802
231126;201502;6407;18139;5370;16520;349;1349;4037;12306;4386;13655
231130;201502;18705;58895;16963;55921;3624;12269;9877;33880;13501;46149
231135;201502;4280;12778;3655;11735;309;1172;2676;8507;2985;9679
231140;201502;16654;53255;14911;49948;1447;6524;10063;32485;11510;39009
231150;201502;5787;16745;4911;15144;828;2827;2725;8231;3553;11058
231160;201502;5757;19536;5420;18897;932;3426;3599;12614;4531;16040
231170;201502;4368;14160;3945;13289;333;1471;2820;9271;3153;10742
231180;201502;14277;42964;12852;40180;2181;7439;7853;24170;10034;31609
231190;201502;4722;13384;4031;12370;293;1077;3176;9601;3469;10678
231195;201502;4613;15716;4000;14505;397;1797;2886;10361;3283;12158
231200;201502;7801;26854;6830;24879;545;2684;4941;17611;5486;20295
231210;201502;5117;15847;4425;14900;256;1138;3520;11854;3776;12992
231220;201502;11630;34590;10614;32737;756;2911;7934;24051;8690;26962
231230;201502;8855;30412;8187;29367;807;3439;6336;22717;7143;26156
231240;201502;11873;38051;10778;35917;2100;7483;5854;19830;7954;27313
231250;201502;1975;5788;1368;4317;410;1270;306;988;716;2258
231260;201502;3708;10830;3347;10283;478;1463;2252;7069;2730;8532
231270;201502;7276;20360;6436;19030;427;1791;4932;14186;5359;15977
231280;201502;1748;5777;1629;5550;148;520;1202;4146;1350;4666
231290;201502;33629;116580;30642;109811;6833;27357;13373;46883;20206;74240
231300;201502;4656;13550;3782;11824;279;1104;2682;8155;2961;9259
231310;201502;7342;21054;6187;18706;1005;3219;3526;10467;4531;13686
231320;201502;6906;21390;5967;19574;325;1350;4384;14379;4709;15729
231325;201502;2675;8106;2378;7613;185;695;1762;5675;1947;6370
231330;201502;12711;40267;10964;36867;1675;5756;6953;23662;8628;29418
231335;201502;5338;15371;4626;14099;273;1102;3676;10968;3949;12070
231340;201502;17378;57565;16227;55907;977;3361;13561;47754;14538;51115
231350;201502;12867;42102;12537;41618;1188;3731;10439;35322;11627;39053
231355;201502;4317;14113;4098;13745;225;872;3361;11326;3586;12198
231360;201502;7388;24335;6710;23153;1454;5026;4092;14591;5546;19617
231370;201502;2496;6939;1958;6064;91;310;1497;4630;1588;4940
231375;201502;4187;14322;3934;13840;281;1275;3178;11037;3459;12312
231380;201502;5172;16796;4891;16405;676;2373;3444;11860;4120;14233
231390;201502;3400;10838;3160;10446;244;1034;2380;7753;2624;8787
231395;201502;3912;12943;3603;12396;662;2376;2178;7602;2840;9978
231400;201502;9239;28453;8624;27237;651;2526;6450;20154;7101;22680
231410;201502;13339;46154;12431;44685;1043;3989;9745;35288;10788;39277
240010;201502;2449;7519;2084;6763;416;1534;974;3021;1390;4555
240020;201502;11015;34944;9806;32639;2322;8301;4747;15984;7069;24285
240030;201502;2499;7336;2444;7249;167;583;2053;6009;2220;6592
240040;201502;841;2518;720;2278;38;180;516;1557;554;1737
240050;201502;3457;9422;2966;8578;129;468;2387;6809;2516;7277
240060;201502;1391;4078;1258;3822;70;273;1018;2992;1088;3265
240070;201502;2625;7512;2485;7265;383;1178;1707;4959;2090;6137
240080;201502;3045;8211;2629;7674;234;670;2040;5985;2274;6655
240090;201502;2305;6255;1935;5580;63;244;1533;4317;1596;4561
240100;201502;8655;24939;7831;23278;688;2400;5641;16291;6329;18691
240110;201502;5276;16164;4677;15056;818;2961;2677;8295;3495;11256
240120;201502;2753;9391;2632;9160;421;1620;1798;6256;2219;7876
240130;201502;2808;7587;2412;6984;155;540;1897;5413;2052;5953
240140;201502;2228;6738;1909;6156;341;1290;1088;3411;1429;4701
240145;201502;5960;18786;5359;17737;1381;5019;2733;9093;4114;14112
240150;201502;993;3010;814;2650;89;369;516;1597;605;1966
240160;201502;1457;4710;1279;4407;183;690;787;2802;970;3492
240165;201502;884;2826;770;2585;110;334;493;1746;603;2080
240170;201502;2420;7238;2115;6695;547;1917;973;3010;1520;4927
240180;201502;2636;8416;2419;8015;520;1856;1368;4621;1888;6477
240185;201502;1412;4760;1356;4659;119;436;1072;3718;1191;4154
240190;201502;974;2972;887;2820;54;233;675;2092;729;2325
240200;201502;14265;37173;11889;34075;2546;7447;6392;19067;8938;26514
240210;201502;2846;8081;2607;7741;200;680;2174;6414;2374;7094
240220;201502;7412;24309;7027;23768;476;2099;5907;19774;6383;21873
240230;201502;5489;15057;4889;14064;223;765;4113;11707;4336;12472
240240;201502;1820;5527;1273;4184;309;1136;259;730;568;1866
240250;201502;2724;7935;2571;7731;141;475;2165;6479;2306;6954
240260;201502;12947;43864;12278;42785;1955;7708;8059;28100;10014;35808
240270;201502;2262;7282;2086;6992;190;639;1639;5592;1829;6231
240280;201502;1552;4408;1390;4135;81;300;1116;3273;1197;3573
240290;201502;1357;4305;1187;3999;101;485;809;2607;910;3092
240300;201502;2250;6284;1643;4980;413;1337;573;1675;986;3012
240310;201502;9645;27689;8788;26352;1496;4980;4896;14796;6392;19776
240320;201502;2067;6164;1695;5413;90;408;1242;3832;1332;4240
240325;201502;38414;105566;29938;91946;9316;31021;8115;25388;17431;56409
240330;201502;1521;4585;1282;4118;122;495;847;2628;969;3123
240340;201502;1859;5300;1582;4870;182;606;1141;3506;1323;4112
240350;201502;1982;5860;1844;5674;129;482;1588;4841;1717;5323
240360;201502;7083;21282;6188;19966;1124;3903;3659;12196;4783;16099
240370;201502;1970;5434;1622;4826;187;585;1064;3164;1251;3749
240375;201502;858;2307;753;2145;125;419;476;1295;601;1714
240380;201502;2517;7596;1987;6412;239;817;1155;3721;1394;4538
240390;201502;957;2630;803;2348;55;216;596;1679;651;1895
240400;201502;1331;3661;1129;3312;104;357;830;2382;934;2739
240410;201502;518;1691;480;1616;84;335;299;991;383;1326
240420;201502;4763;18212;4512;17674;1070;4414;2504;10079;3574;14493
240430;201502;3260;9330;3005;8902;162;637;2439;7057;2601;7694
240440;201502;2646;7031;2396;6632;591;1654;1289;3563;1880;5217
240450;201502;3526;10695;3124;9938;328;1379;2041;6185;2369;7564
240460;201502;2956;9110;2794;8897;209;866;2316;7222;2525;8088
240470;201502;3688;11425;2969;9893;397;1445;1809;5980;2206;7425
240480;201502;510;1326;412;1127;40;111;238;638;278;749
240485;201502;2088;6450;1843;5988;345;1218;1070;3520;1415;4738
240490;201502;1647;4221;1400;3845;64;238;1137;3019;1201;3257
240500;201502;2063;6072;1903;5813;144;503;1489;4524;1633;5027
240510;201502;1784;5384;1658;5172;169;561;1296;4062;1465;4623
240520;201502;1349;3871;1162;3597;128;482;870;2626;998;3108
240530;201502;2123;6786;1914;6454;294;1031;1332;4520;1626;5551
240540;201502;1710;5300;1636;5182;126;470;1304;4100;1430;4570
240550;201502;837;2373;725;2183;59;200;554;1637;613;1837
240560;201502;3219;9428;3032;9162;266;806;2484;7564;2750;8370
240570;201502;3077;8751;2455;7381;534;1774;979;2641;1513;4415
240580;201502;7552;24050;7106;23268;943;3350;5308;17304;6251;20654
240590;201502;789;2234;683;2045;37;152;515;1509;552;1661
240600;201502;1633;4823;1302;4151;179;689;735;2236;914;2925
240610;201502;4895;13892;4224;12635;543;1786;2575;7490;3118;9276
240615;201502;1037;3026;852;2672;136;435;491;1519;627;1954
240620;201502;1743;5520;1565;5229;186;647;1198;4046;1384;4693
240630;201502;1999;6249;1859;6012;163;461;1425;4794;1588;5255
240640;201502;895;2655;753;2416;75;316;526;1648;601;1964
240650;201502;3769;11551;3443;11090;217;795;2825;9168;3042;9963
240660;201502;2376;7714;2253;7532;217;763;1773;5970;1990;6733
240670;201502;2717;8160;2264;7228;310;1109;1278;4009;1588;5118
240680;201502;1508;4451;1216;3921;128;470;773;2482;901;2952
240690;201502;979;2767;858;2569;58;229;695;2028;753;2257
240700;201502;2737;8196;2271;7322;101;481;1749;5502;1850;5983
240710;201502;18716;48465;16447;45394;2988;8134;10261;29162;13249;37296
240720;201502;5259;15062;4959;14604;1558;4828;2370;6766;3928;11594
240725;201502;1082;3249;850;2742;82;283;480;1512;562;1795
240730;201502;2179;6615;1886;6082;136;490;1420;4559;1556;5049
240740;201502;2009;5923;1816;5577;177;658;1274;3806;1451;4464
240750;201502;2239;8351;2048;7998;428;1860;1109;4386;1537;6246
240760;201502;1237;3531;1118;3380;110;264;851;2758;961;3022
240770;201502;3078;8954;2770;8523;159;611;2355;7164;2514;7775
240780;201502;6265;17305;5037;15412;962;3064;2807;8823;3769;11887
240790;201502;897;2745;734;2464;42;179;530;1791;572;1970
240800;201502;36431;105368;32634;99065;7994;25615;14545;44524;22539;70139
240810;201502;89824;262282;83384;251183;22296;69967;40432;122909;62728;192876
240820;201502;6759;20354;5801;18856;1313;4676;2696;9104;4009;13780
240830;201502;8725;27439;8226;26715;415;1502;7206;23493;7621;24995
240840;201502;1247;3486;1050;3167;100;346;676;1972;776;2318
240850;201502;1291;3842;942;3043;165;566;455;1439;620;2005
240860;201502;1343;3805;1128;3425;78;272;853;2536;931;2808
240870;201502;1164;3227;969;2857;102;355;635;1773;737;2128
240880;201502;1156;3967;1092;3870;120;519;826;2876;946;3395
240890;201502;5188;14757;4438;13389;877;2901;2203;6541;3080;9442
240895;201502;2700;9272;2462;8860;273;1046;1752;6424;2025;7470
240910;201502;2745;8437;2439;7857;169;652;1851;5903;2020;6555
240920;201502;805;2641;704;2413;171;661;304;995;475;1656
240930;201502;3470;9225;3077;8740;186;527;2555;7375;2741;7902
240933;201502;1380;4084;1228;3834;142;534;854;2594;996;3128
240940;201502;6445;17889;5312;15933;945;2932;2973;8945;3918;11877
240950;201502;1033;3371;979;3280;71;317;765;2492;836;2809
240960;201502;786;2473;689;2283;93;341;476;1577;569;1918
240970;201502;2030;5610;1702;5059;136;499;1257;3645;1393;4144
240980;201502;3053;10112;2842;9721;547;2038;1771;6012;2318;8050
240990;201502;2925;8682;2748;8324;469;1557;1727;5144;2196;6701
241000;201502;1080;3023;923;2745;51;191;688;2025;739;2216
241010;201502;2937;9873;2693;9406;352;1515;1898;6418;2250;7933
241020;201502;2237;6260;1826;5469;149;533;1170;3382;1319;3915
241025;201502;1611;4915;1453;4619;95;412;1049;3263;1144;3675
241030;201502;2495;8339;2275;7930;165;684;1780;6236;1945;6920
241040;201502;2290;7900;2097;7550;222;905;1501;5460;1723;6365
241050;201502;1309;3864;1151;3604;70;294;896;2738;966;3032
241060;201502;870;2542;796;2419;54;163;630;1924;684;2087
241070;201502;882;2534;782;2359;77;267;543;1599;620;1866
241080;201502;1173;3487;986;3134;62;276;718;2226;780;2502
241090;201502;2189;6403;1869;5832;128;558;1465;4484;1593;5042
241100;201502;1177;3544;1022;3186;124;413;640;1971;764;2384
241105;201502;1153;3509;1051;3323;199;659;605;1938;804;2597
241110;201502;833;2668;702;2388;61;284;453;1500;514;1784
241120;201502;7384;22639;6733;21626;1396;4599;4205;13827;5601;18426
241140;201502;3379;9355;2946;8524;319;958;2089;5975;2408;6933
241142;201502;711;2143;528;1742;136;520;163;491;299;1011
241150;201502;5574;16686;5005;15712;685;2226;3467;11025;4152;13251
241160;201502;999;2960;939;2848;125;416;678;2048;803;2464
241170;201502;1149;3493;1058;3326;112;365;785;2475;897;2840
241180;201502;919;2614;754;2297;92;309;419;1238;511;1547
241190;201502;1199;3308;968;2848;74;265;616;1725;690;1990
241200;201502;18933;56024;17103;53089;3929;13141;8632;27056;12561;40197
241210;201502;1452;4207;1191;3668;207;698;616;1857;823;2555
241220;201502;7488;25265;7065;24473;1569;5801;4032;14104;5601;19905
241230;201502;3067;9050;2807;8682;165;642;2360;7202;2525;7844
241240;201502;1183;3478;918;2923;104;350;463;1540;567;1890
241250;201502;5826;18334;4956;16639;294;1498;3921;12838;4215;14336
241255;201502;1720;6677;1623;6480;403;1721;776;3164;1179;4885
241260;201502;5127;13952;4194;12511;296;1155;3074;8966;3370;10121
241270;201502;1871;5795;1668;5402;187;705;1087;3471;1274;4176
241280;201502;1956;5688;1790;5374;218;707;1275;3801;1493;4508
241290;201502;3144;8941;2639;8074;406;1303;1653;5070;2059;6373
241300;201502;1456;4244;1286;3946;74;235;976;3042;1050;3277
241310;201502;1546;4762;1436;4581;211;688;1006;3274;1217;3962
241320;201502;913;3105;837;2946;132;518;511;1792;643;2310
241330;201502;1465;4660;1359;4520;104;419;1151;3799;1255;4218
241335;201502;2659;8167;2486;7856;155;520;2108;6669;2263;7189
241340;201502;1861;5803;1622;5290;377;1353;774;2449;1151;3802
241350;201502;1909;6130;1756;5846;159;692;1316;4252;1475;4944
241355;201502;1362;3854;1153;3497;65;208;1003;3046;1068;3254
241360;201502;1995;5484;1700;4933;77;260;1275;3576;1352;3836
241370;201502;1361;4195;1130;3718;194;691;575;1867;769;2558
241380;201502;674;1939;568;1729;109;362;323;968;432;1330
241390;201502;2747;9200;2571;8875;381;1438;1837;6351;2218;7789
241400;201502;3696;10908;3414;10532;369;1283;2634;8195;3003;9478
241410;201502;2616;7841;2351;7474;405;1372;1594;5074;1999;6446
241415;201502;1695;5139;1545;4896;105;437;1199;3718;1304;4155
241420;201502;2289;7926;2005;7458;692;2870;583;2118;1275;4988
241430;201502;550;1672;449;1445;49;181;280;871;329;1052
241440;201502;6278;22656;5904;22048;1205;4649;3853;14708;5058;19357
241445;201502;1051;3123;989;3042;104;276;791;2560;895;2836
241450;201502;3160;8760;2805;8259;427;1354;1885;5528;2312;6882
241460;201502;3472;10215;3022;9333;214;815;2259;6827;2473;7642
241470;201502;1381;3845;1132;3532;115;455;850;2602;965;3057
241475;201502;1214;3797;1080;3537;54;270;824;2644;878;2914
241480;201502;2810;9477;2592;9133;892;3185;1009;3866;1901;7051
241490;201502;653;1744;550;1596;48;152;339;972;387;1124
241500;201502;767;2424;683;2295;39;145;577;1944;616;2089
250010;201502;2666;8484;2345;7815;167;732;1814;5918;1981;6650
250020;201502;1685;4844;1315;4178;97;419;877;2680;974;3099
250030;201502;7252;21119;6775;20447;621;1894;5473;16673;6094;18567
250040;201502;4334;14651;3994;13933;669;2487;2533;8916;3202;11403
250050;201502;3423;10880;3234;10607;382;1360;2427;7948;2809;9308
250053;201502;1255;3744;1150;3606;164;523;784;2498;948;3021
250057;201502;645;2730;637;2722;18;40;602;2651;620;2691
250060;201502;4868;14967;4606;14597;428;1610;3698;11559;4126;13169
250070;201502;3927;12322;3668;11883;202;904;3034;9571;3236;10475
250073;201502;764;2344;680;2198;52;205;527;1682;579;1887
250077;201502;2213;6537;1871;5986;222;765;1154;3760;1376;4525
250080;201502;4209;12556;4069;12359;347;1146;3319;10017;3666;11163
250090;201502;2631;7713;2522;7542;114;378;2113;6245;2227;6623
250100;201502;3976;13161;3755;12782;382;1456;2935;9965;3317;11421
250110;201502;5279;15877;4997;15489;507;1830;3940;12056;4447;13886
250115;201502;530;1733;469;1594;31;164;292;923;323;1087
250120;201502;1985;6034;1726;5537;112;398;1356;4374;1468;4772
250130;201502;5479;17011;5173;16579;221;793;4591;14813;4812;15606
250135;201502;1057;3249;966;3091;86;308;695;2231;781;2539
250140;201502;2057;6812;1937;6640;187;741;1504;5198;1691;5939
250150;201502;5015;16987;4571;16159;415;1803;3334;11620;3749;13423
250153;201502;1433;3951;1276;3719;66;272;1083;3090;1149;3362
250157;201502;1726;5788;1585;5502;246;907;1067;3721;1313;4628
250160;201502;3242;9992;3132;9826;156;552;2838;8920;2994;9472
250170;201502;1543;4601;1411;4395;249;817;949;2996;1198;3813
250180;201502;15369;46640;14783;45728;1554;5901;11118;33479;12672;39380
250190;201502;4202;12269;3867;11743;669;2121;2459;7417;3128;9538
250200;201502;2192;6106;1717;5469;118;450;1417;4494;1535;4944
250205;201502;903;3105;838;2980;68;337;612;2145;680;2482
250210;201502;1506;5007;1406;4849;148;629;1061;3584;1209;4213
250215;201502;1329;4500;1282;4422;134;543;895;3071;1029;3614
250220;201502;783;2283;663;2128;36;126;575;1845;611;1971
250230;201502;1590;4063;1348;3668;90;291;1104;2922;1194;3213
250240;201502;2300;7793;2178;7560;136;521;1753;6092;1889;6613
250250;201502;4336;13108;3948;12596;218;732;3410;10951;3628;11683
250260;201502;1738;5375;1527;5032;102;426;1192;3888;1294;4314
250270;201502;1237;3944;1128;3806;107;354;870;3036;977;3390
250280;201502;3599;10834;3217;10259;499;1624;2302;7447;2801;9071
250290;201502;2005;5478;1687;5074;50;211;1495;4487;1545;4698
250300;201502;5436;15960;5140;15599;548;2281;4186;12148;4734;14429
250310;201502;1145;3550;1013;3334;118;444;779;2528;897;2972
250320;201502;7955;24847;7603;24185;1002;3636;5174;16027;6176;19663
250330;201502;2564;7939;2179;7404;173;713;1705;5734;1878;6447
250340;201502;1102;3244;1004;3086;35;109;886;2727;921;2836
250350;201502;4351;11999;3836;11397;134;472;3439;10292;3573;10764
250355;201502;1990;6332;1829;6090;121;578;1464;4744;1585;5322
250360;201502;1941;5811;1813;5631;76;263;1532;4791;1608;5054
250370;201502;12009;35035;10755;33638;942;2987;9130;28820;10072;31807
250375;201502;1086;3402;1016;3300;46;186;881;2857;927;3043
250380;201502;1719;4891;1625;4772;90;319;1427;4178;1517;4497
250390;201502;1956;5201;1561;4548;200;582;1055;3103;1255;3685
250400;201502;67951;184926;56436;166835;13399;42215;27241;81564;40640;123779
250403;201502;1542;5059;1449;4938;219;847;1013;3418;1232;4265
250407;201502;1181;3398;1022;3134;56;183;804;2445;860;2628
250410;201502;618;2009;546;1870;48;214;432;1455;480;1669
250415;201502;1723;5424;1582;5162;116;438;1221;3929;1337;4367
250420;201502;1246;3846;1159;3720;65;267;988;3115;1053;3382
250430;201502;6032;16940;5734;16489;301;1031;4901;13900;5202;14931
250435;201502;1401;4340;1255;4073;166;611;847;2726;1013;3337
250440;201502;4479;13153;4172;12726;202;605;3544;10884;3746;11489
250450;201502;2011;5763;1798;5483;74;257;1650;5042;1724;5299
250460;201502;6332;19210;5910;18623;673;2258;4490;14287;5163;16545
250470;201502;1506;4200;1321;3945;88;345;1020;2946;1108;3291
250480;201502;3786;11540;3515;11152;79;351;3173;10010;3252;10361
250485;201502;648;1666;539;1501;28;90;431;1168;459;1258
250490;201502;3769;12290;3686;12175;833;2882;2389;7892;3222;10774
250500;201502;1746;5329;1590;5085;339;1071;989;3261;1328;4332
250510;201502;4671;13400;4186;12703;207;754;3598;10879;3805;11633
250520;201502;1735;5406;1635;5241;251;947;1029;3206;1280;4153
250523;201502;1599;5236;1546;5155;213;768;1143;3835;1356;4603
250527;201502;1394;4248;1322;4158;30;141;1230;3837;1260;3978
250530;201502;649;1965;561;1854;25;78;493;1655;518;1733
250535;201502;1297;4162;1235;4035;70;321;997;3190;1067;3511
250540;201502;2354;7100;2209;6941;27;88;2117;6689;2144;6777
250550;201502;904;3011;822;2886;56;241;647;2242;703;2483
250560;201502;1655;5294;1610;5230;73;269;1463;4743;1536;5012
250570;201502;2559;8266;2255;7689;174;730;1724;5795;1898;6525
250580;201502;1126;3074;930;2768;87;370;688;1942;775;2312
250590;201502;916;2865;851;2781;66;280;707;2257;773;2537
250600;201502;7355;21552;6922;20933;493;1424;5747;17651;6240;19075
250610;201502;3236;9619;3006;9284;317;1080;2237;6919;2554;7999
250620;201502;723;2157;652;2010;120;394;412;1251;532;1645
250625;201502;2286;7364;2253;7323;46;110;2155;7074;2201;7184
250630;201502;9530;30399;9035;29548;1921;6644;5254;17243;7175;23887
250640;201502;3505;10797;3357;10624;163;679;2971;9300;3134;9979
250650;201502;837;2517;754;2376;76;309;508;1530;584;1839
250660;201502;2193;5427;1674;4803;29;75;1581;4565;1610;4640
250670;201502;2426;8247;2318;8060;151;673;1898;6501;2049;7174
250680;201502;4751;13789;4554;13532;176;634;4092;12162;4268;12796
250690;201502;5934;15760;5700;15470;386;1129;5060;13644;5446;14773
250700;201502;5053;14898;4633;14311;715;2365;3155;9685;3870;12050
250710;201502;4287;13788;3967;13376;525;1841;2895;9954;3420;11795
250720;201502;2535;7557;2429;7387;101;420;2142;6431;2243;6851
250730;201502;3559;11077;3380;10836;362;1332;2577;8184;2939;9516
250740;201502;1986;5860;1763;5490;156;574;1343;4114;1499;4688
250750;201502;98294;284043;92082;274950;13590;44910;63213;186488;76803;231398
250760;201502;2204;6447;1992;6145;109;446;1681;5122;1790;5568
250770;201502;3859;13211;3647;12943;640;2461;2423;8657;3063;11118
250780;201502;1871;5520;1621;5067;185;724;1056;3156;1241;3880
250790;201502;2404;7939;2304;7790;503;1644;1496;5244;1999;6888
250800;201502;2629;7544;2356;7083;112;386;1949;5756;2061;6142
250810;201502;1364;3991;1176;3720;101;408;929;2887;1030;3295
250820;201502;1802;5707;1738;5621;54;219;1594;5139;1648;5358
250830;201502;5719;18869;5346;18133;560;2302;3858;12848;4418;15150
250840;201502;938;3077;828;2848;82;333;565;1938;647;2271
250850;201502;2044;6309;1836;5959;134;597;1411;4491;1545;5088
250855;201502;1072;3244;989;3114;80;333;755;2298;835;2631
250860;201502;3076;10179;2748;9579;649;2576;1078;3725;1727;6301
250870;201502;1057;3115;973;2968;50;214;764;2257;814;2471
250880;201502;1354;3881;1205;3673;159;496;902;2768;1061;3264
250890;201502;9313;28878;8673;28008;1208;4741;6133;19319;7341;24060
250900;201502;2835;9366;2542;8798;278;940;1834;6421;2112;7361
250905;201502;1970;6350;1902;6263;289;973;1417;4738;1706;5711
250910;201502;4878;14385;4657;14063;294;1021;3914;11752;4208;12773
250915;201502;1494;4550;1440;4472;104;291;1247;3965;1351;4256
250920;201502;3419;9879;3231;9614;402;1116;2408;7432;2810;8548
250930;201502;1975;6319;1861;6131;283;1053;1311;4277;1594;5330
250933;201502;1130;3752;1093;3686;86;339;847;2863;933;3202
250937;201502;757;2363;665;2177;73;301;450;1443;523;1744
250939;201502;1553;4902;1453;4727;176;617;1005;3262;1181;3879
250940;201502;3690;11069;3470;10727;143;550;2925;9061;3068;9611
250950;201502;1217;3876;1116;3748;37;124;1001;3404;1038;3528
250960;201502;1141;3735;1080;3653;88;365;877;2940;965;3305
250970;201502;8466;23469;7387;21925;917;2815;5317;15841;6234;18656
250980;201502;2591;7805;2368;7412;199;837;1683;5063;1882;5900
250990;201502;2009;6985;1840;6640;216;950;1300;4613;1516;5563
251000;201502;2198;6671;2005;6381;94;357;1669;5308;1763;5665
251010;201502;2762;8119;2485;7680;131;497;2103;6486;2234;6983
251020;201502;1628;4781;1477;4595;85;294;1301;4052;1386;4346
251030;201502;1196;3378;1078;3174;88;296;771;2258;859;2554
251040;201502;1865;5919;1674;5621;140;684;1244;4020;1384;4704
251050;201502;1080;3170;947;2934;142;462;592;1844;734;2306
251060;201502;957;2281;768;2035;48;162;600;1550;648;1712
251065;201502;463;1432;426;1381;46;172;313;981;359;1153
251070;201502;632;1777;576;1699;50;204;456;1265;506;1469
251080;201502;19767;56158;18140;53499;4799;14728;9057;27390;13856;42118
251090;201502;2943;9316;2641;8740;218;854;1944;6349;2162;7203
251100;201502;952;3067;838;2855;127;504;507;1659;634;2163
251110;201502;2001;5894;1773;5463;171;582;1254;3826;1425;4408
251120;201502;5970;20342;5744;19946;682;2806;4410;15094;5092;17900
251130;201502;4102;10652;3699;10209;31;86;3583;9922;3614;10008
251140;201502;4229;13078;3949;12652;132;585;3298;10525;3430;11110
251150;201502;2613;8579;2383;8255;263;1103;1786;6122;2049;7225
251160;201502;1716;5785;1662;5715;56;234;1524;5237;1580;5471
251170;201502;1391;4334;1327;4258;98;391;1119;3547;1217;3938
251180;201502;2642;8122;2434;7842;496;1591;1531;5016;2027;6607
251190;201502;4237;12007;4093;11848;186;538;3778;10971;3964;11509
251200;201502;4139;12961;3911;12680;113;416;3599;11721;3712;12137
251203;201502;1144;3806;1073;3653;78;358;806;2708;884;3066
251207;201502;1135;3553;980;3272;76;355;688;2206;764;2561
251210;201502;7912;22570;6821;21140;783;2401;5186;16462;5969;18863
251220;201502;1143;3084;962;2813;102;312;737;2173;839;2485
251230;201502;4584;14032;4174;13569;216;829;3764;12231;3980;13060
251240;201502;3094;9985;3001;9858;276;962;2491;8196;2767;9158
251250;201502;10232;30412;9441;29238;997;3653;7234;22007;8231;25660
251260;201502;543;1657;475;1567;24;84;364;1196;388;1280
251270;201502;4185;13389;3936;13085;128;544;3575;11884;3703;12428
251272;201502;1375;4194;1315;4110;105;350;1107;3473;1212;3823
251274;201502;871;2816;802;2688;89;381;583;1898;672;2279
251275;201502;1247;3673;1191;3591;93;389;920;2673;1013;3062
251276;201502;1231;3845;1156;3708;103;398;869;2745;972;3143
251278;201502;578;1884;514;1747;68;269;338;1158;406;1427
251280;201502;2310;7224;2202;7053;187;715;1746;5494;1933;6209
251290;201502;5756;16175;5453;15815;607;2087;4260;12088;4867;14175
251300;201502;750;2594;697;2517;62;293;521;1843;583;2136
251310;201502;3151;9315;2903;8965;143;567;2406;7365;2549;7932
251315;201502;1564;5539;1508;5445;215;815;1036;3796;1251;4611
251320;201502;1890;5403;1532;4825;71;272;1171;3667;1242;3939
251330;201502;1840;4959;1609;4657;75;313;1424;4025;1499;4338
251335;201502;1026;3520;962;3403;87;406;703;2419;790;2825
251340;201502;3509;9972;3012;9221;228;920;2282;6765;2510;7685
251350;201502;1439;4501;1304;4305;140;529;949;3078;1089;3607
251360;201502;1790;5881;1649;5707;77;349;1435;4958;1512;5307
251365;201502;839;2489;677;2147;40;167;479;1481;519;1648
251370;201502;21739;70080;21229;69360;2256;9018;16801;53464;19057;62482
251380;201502;1381;4305;1190;3979;62;289;979;3186;1041;3475
251385;201502;836;2324;741;2175;80;243;532;1524;612;1767
251390;201502;5797;20256;5390;19581;1221;4680;3193;11709;4414;16389
251392;201502;1021;3056;927;2915;65;208;739;2329;804;2537
251394;201502;623;1897;514;1697;32;125;370;1208;402;1333
251396;201502;843;2399;743;2229;111;350;500;1476;611;1826
251398;201502;1002;2992;888;2780;57;217;649;2018;706;2235
251400;201502;1189;3390;1039;3189;97;379;777;2312;874;2691
251410;201502;1388;3741;1266;3541;83;285;1029;2831;1112;3116
251420;201502;2052;6052;1831;5793;150;534;1478;4652;1628;5186
251430;201502;1667;5978;1551;5795;97;452;1301;4847;1398;5299
251440;201502;1310;3898;1093;3474;86;299;800;2527;886;2826
251445;201502;1556;4786;1485;4689;76;323;1288;4003;1364;4326
251450;201502;4655;14794;4295;14357;138;610;3773;12629;3911;13239
251455;201502;1150;3687;1034;3496;94;384;730;2452;824;2836
251460;201502;810;2558;775;2502;106;337;607;1992;713;2329
251465;201502;453;1430;394;1298;25;108;284;907;309;1015
251470;201502;1174;3466;978;3098;105;393;603;1900;708;2293
251480;201502;990;2769;881;2592;29;143;749;2144;778;2287
251490;201502;1831;5560;1655;5300;229;854;1090;3456;1319;4310
251500;201502;1700;5576;1665;5521;142;536;1380;4546;1522;5082
251510;201502;2554;8522;2336;8082;369;1351;1506;5246;1875;6597
251520;201502;980;2742;882;2584;130;391;519;1530;649;1921
251530;201502;11678;33457;11164;32747;425;1706;9880;28592;10305;30298
251540;201502;2814;9173;2599;8739;202;850;2058;6834;2260;7684
251550;201502;3805;9541;3131;8699;101;368;2652;7254;2753;7622
251560;201502;768;2362;702;2251;106;409;418;1242;524;1651
251570;201502;1002;2998;824;2644;77;313;587;1846;664;2159
251580;201502;1963;5568;1845;5399;342;866;1273;3921;1615;4787
251590;201502;1590;5268;1541;5209;71;273;1379;4687;1450;4960
251593;201502;1090;3360;1005;3247;158;567;618;1948;776;2515
251597;201502;1928;5954;1844;5838;139;547;1508;4682;1647;5229
251600;201502;6528;19324;6123;18677;449;1532;5036;15319;5485;16851
251610;201502;3219;9825;2943;9461;252;871;2373;7639;2625;8510
251615;201502;1129;3307;923;2954;91;374;650;2056;741;2430
251620;201502;15671;44228;13591;41681;1178;3818;10740;33385;11918;37203
251630;201502;4804;12392;4130;11525;285;866;3384;9417;3669;10283
251640;201502;2587;7600;2163;6884;173;685;1582;4973;1755;5658
251650;201502;4024;11782;3684;11345;243;803;3189;9868;3432;10671
251660;201502;3412;11424;3202;11063;199;984;2652;8921;2851;9905
251670;201502;4216;12666;3732;12009;70;222;3426;11144;3496;11366
251675;201502;720;2376;672;2306;144;533;395;1332;539;1865
251680;201502;2645;7688;2229;7032;113;480;1824;5673;1937;6153
251690;201502;3400;10469;3140;9988;220;838;2374;7421;2594;8259
251700;201502;1919;6271;1814;6135;102;434;1577;5328;1679;5762
251710;201502;935;2431;685;1958;83;284;381;1044;464;1328
251720;201502;1370;4231;1233;3995;77;335;1003;3194;1080;3529
251740;201502;774;2202;620;1938;74;250;390;1216;464;1466
260005;201502;24997;61462;21575;56748;4710;12508;12462;32932;17172;45440
260010;201502;9801;26465;7933;24190;919;2937;5619;17545;6538;20482
260020;201502;5581;16497;4852;15390;356;1161;3803;12297;4159;13458
260030;201502;5675;16896;5200;16173;428;1528;4088;12645;4516;14173
260040;201502;10126;24451;8413;22528;655;1470;6748;18818;7403;20288
260050;201502;11177;34871;10374;33950;550;1912;9139;30252;9689;32164
260060;201502;3878;10960;3492;10316;295;861;2705;8110;3000;8971
260070;201502;9525;28177;8967;27340;1640;5396;5928;18015;7568;23411
260080;201502;5259;14735;4700;13941;446;1500;3637;10645;4083;12145
260090;201502;5135;14456;4868;14071;1069;2973;3278;9767;4347;12740
260100;201502;3259;8958;2867;8402;160;610;2420;7061;2580;7671
260105;201502;4652;13639;4458;13274;572;1908;3233;9477;3805;11385
260110;201502;20944;60312;19318;58346;924;2828;17049;51827;17973;54655
260120;201502;11242;34498;10322;32898;2696;8800;5415;17913;8111;26713
260130;201502;3196;9060;3016;8779;444;1241;2185;6506;2629;7747
260140;201502;13307;33515;11371;31186;907;2713;9105;25311;10012;28024
260150;201502;3114;8896;2792;8451;188;705;2280;6909;2468;7614
260160;201502;5736;17878;5123;17119;347;1341;4334;14597;4681;15938
260170;201502;17365;48321;16506;47175;1250;3790;13588;38937;14838;42727
260180;201502;3316;10256;3022;9830;201;797;2525;8143;2726;8940
260190;201502;15785;37560;14642;36141;533;1381;13004;32053;13537;33434
260200;201502;10530;30347;9730;29216;796;2577;7991;24160;8787;26737
260210;201502;10916;33881;9952;32497;606;2389;8306;27152;8912;29541
260220;201502;9170;27504;8866;27091;525;2049;7781;23386;8306;25435
260230;201502;9497;27682;8859;26828;449;1519;7507;23040;7956;24559
260240;201502;2972;9024;2559;8446;370;1324;1836;6100;2206;7424
260250;201502;2271;6319;2031;6015;116;362;1729;5129;1845;5491
260260;201502;11829;33594;11054;32606;1478;4662;8340;25089;9818;29751
260270;201502;3518;10510;3299;10187;295;1176;2626;7928;2921;9104
260280;201502;12742;41860;11788;40403;631;2400;10130;35047;10761;37447
260290;201502;29199;88686;27873;86439;4089;14476;18999;57704;23088;72180
260300;201502;8527;25927;7576;24521;481;2012;6044;19567;6525;21579
260310;201502;4674;13933;4303;13381;1315;3749;2293;7740;3608;11489
260320;201502;6860;22961;6409;22289;463;1683;5311;18709;5774;20392
260330;201502;2679;8726;2487;8407;180;778;1969;6601;2149;7379
260340;201502;1899;5629;1776;5444;87;318;1573;4796;1660;5114
260345;201502;23114;73406;21761;70760;5657;20494;9455;29371;15112;49865
260350;201502;4564;12727;4317;12360;301;987;3563;10135;3864;11122
260360;201502;2238;6736;2046;6438;242;933;1460;4518;1702;5451
260370;201502;5891;18358;5213;17133;531;2050;3832;12639;4363;14689
260380;201502;4739;15828;4392;15347;363;1424;3445;12092;3808;13516
260390;201502;4469;14267;3959;13327;397;1535;2846;9403;3243;10938
260392;201502;3543;11158;3289;10844;117;492;2968;9768;3085;10260
260400;201502;13384;38847;12788;37879;1907;6434;8962;25935;10869;32369
260410;201502;56000;166409;51947;159897;15294;49285;24085;75444;39379;124729
260415;201502;3931;12607;3405;11586;411;1742;2203;7252;2614;8994
260420;201502;12101;27777;10925;26534;366;979;9910;24089;10276;25068
260430;201502;2791;9257;2517;8799;273;1088;1833;6369;2106;7457
260440;201502;3152;9710;2860;9115;426;1535;1769;5469;2195;7004
260450;201502;4917;14676;4656;14283;220;786;4031;12348;4251;13134
260460;201502;5573;17113;5174;16491;832;2942;3365;10547;4197;13489
260470;201502;4790;14054;4503;13673;303;970;3856;11845;4159;12815
260480;201502;4004;11669;3599;11094;606;2063;2394;7414;3000;9477
260490;201502;4991;13463;4395;12471;379;1269;3460;9630;3839;10899
260500;201502;6147;17353;5522;16427;619;1962;4044;12047;4663;14009
260510;201502;8822;23588;8184;22822;260;677;7583;21352;7843;22029
260515;201502;4771;14659;3735;12561;337;1313;2363;7947;2700;9260
260520;201502;15716;41728;15164;40999;2710;7274;10808;29597;13518;36871
260530;201502;9949;30035;8811;28423;478;1542;7538;24678;8016;26220
260540;201502;5893;14900;5424;14401;597;1258;4482;12318;5079;13576
260545;201502;43;165;32;130;4;18;7;27;11;45
260550;201502;2728;9061;2376;8342;545;2153;1055;3678;1600;5831
260560;201502;6461;16924;5857;16066;214;667;5225;14296;5439;14963
260570;201502;6680;22591;6190;21774;839;3328;4453;15747;5292;19075
260580;201502;3712;10464;3472;10081;207;747;2965;8414;3172;9161
260590;201502;6061;15378;5798;15074;258;589;5260;13859;5518;14448
260600;201502;25958;78743;23834;75184;2641;9681;17207;53729;19848;63410
260610;201502;6714;20133;6356;19619;1059;3490;4448;13618;5507;17108
260620;201502;16165;49091;15511;47987;2649;9137;10121;30787;12770;39924
260630;201502;2153;6525;1928;6149;154;617;1529;4783;1683;5400
260640;201502;17181;47635;16190;46272;2296;6990;11381;32512;13677;39502
260650;201502;5149;16760;4687;15983;513;1735;3569;12471;4082;14206
260660;201502;8267;23028;7466;22019;412;1306;6508;19285;6920;20591
260670;201502;2356;6533;1935;5948;212;750;1375;4214;1587;4964
260680;201502;21609;60275;20084;57691;4395;13064;10655;30448;15050;43512
260690;201502;3655;10083;3162;9316;152;576;2643;7712;2795;8288
260700;201502;5588;17043;5447;16895;46;87;5335;16706;5381;16793
260710;201502;1213;3719;1115;3581;88;358;880;2780;968;3138
260720;201502;16105;53302;15232;51829;3628;12793;8476;29361;12104;42154
260730;201502;6851;23009;6345;22191;850;3085;4640;16443;5490;19528
260740;201502;1318;3998;1149;3701;154;557;714;2289;868;2846
260750;201502;6493;20909;5967;20197;543;1704;4961;17177;5504;18881
260760;201502;4624;12657;4321;12269;343;1051;3526;10051;3869;11102
260765;201502;7439;25738;7151;25307;957;4164;5281;18247;6238;22411
260770;201502;3910;10263;3558;9783;150;526;2998;8135;3148;8661
260775;201502;5152;14925;4891;14543;484;1782;3617;10431;4101;12213
260780;201502;3671;12056;3504;11760;738;2797;2174;7176;2912;9973
260790;201502;111471;282863;105062;273604;20099;54483;65582;170213;85681;224696
260795;201502;3008;9468;2746;9069;402;1453;1850;6172;2252;7625
260800;201502;4817;13090;4456;12597;195;812;3936;10811;4131;11623
260805;201502;3975;11567;3547;10928;431;1469;2496;7649;2927;9118
260810;201502;6811;19819;6668;19648;299;929;6085;18010;6384;18939
260820;201502;4316;12359;3976;11903;1047;3241;2240;6717;3287;9958
260825;201502;2802;9140;2581;8799;190;711;2104;7208;2294;7919
260830;201502;3665;11861;3319;11223;860;2811;1902;6749;2762;9560
260840;201502;4233;12240;3837;11670;268;1073;3167;9437;3435;10510
260845;201502;4247;12413;3957;11885;563;1791;2726;8201;3289;9992
260850;201502;4890;16357;4379;15231;971;3841;2159;7316;3130;11157
260860;201502;3264;10459;2999;9951;206;773;2370;7876;2576;8649
260870;201502;4214;11742;3805;11243;496;1354;2875;8749;3371;10103
260875;201502;6715;18376;5990;17262;1009;2973;3892;11300;4901;14273
260880;201502;9010;28284;8415;27352;656;2203;6922;22743;7578;24946
260890;201502;13368;38458;12512;37154;974;3343;9766;28867;10740;32210
260900;201502;5975;18555;5170;17033;767;2875;3149;10314;3916;13189
260910;201502;3036;9135;2778;8758;208;758;2247;7117;2455;7875
260915;201502;4453;15122;4286;14891;66;283;4068;14190;4134;14473
260920;201502;3427;10365;3245;10119;406;1405;2496;7876;2902;9281
260930;201502;4012;12907;3558;12206;410;1507;2576;8950;2986;10457
260940;201502;13445;36378;12259;34432;1497;5091;8471;23042;9968;28133
260950;201502;6156;19392;5738;18578;723;2995;3614;11107;4337;14102
260960;201502;56199;158927;52332;152675;10534;32855;29638;86199;40172;119054
260970;201502;4937;15823;4578;15326;348;1483;3593;11871;3941;13354
260980;201502;3833;12535;3617;12271;142;544;3268;11136;3410;11680
260990;201502;17124;54007;15720;52176;1360;4507;12788;43299;14148;47806
261000;201502;15953;43758;12878;38972;2484;7974;6866;21430;9350;29404
261010;201502;2573;7339;2386;7109;145;322;2117;6500;2262;6822
261020;201502;5972;17737;5458;16970;462;1708;4340;13187;4802;14895
261030;201502;3359;11040;3157;10684;244;1010;2563;8568;2807;9578
261040;201502;5218;17001;4632;15922;437;1772;3394;11549;3831;13321
261050;201502;8113;23588;7594;22685;982;2900;5316;15942;6298;18842
261060;201502;11648;34897;11003;33797;1245;4453;8276;24990;9521;29443
261070;201502;49139;123095;43474;115168;7632;20893;27354;72844;34986;93737
261080;201502;5783;17260;5440;16741;342;980;4658;14578;5000;15558
261090;201502;16242;45241;15083;43682;1324;3868;12166;35656;13490;39524
261100;201502;7696;24579;6963;23343;1134;4054;4463;15173;5597;19227
261110;201502;59326;176694;53547;168207;11947;39304;30656;98501;42603;137805
261120;201502;3603;9753;3208;9278;99;340;2882;8361;2981;8701
261130;201502;6986;18023;6629;17630;147;356;6248;16692;6395;17048
261140;201502;3232;9139;2942;8707;486;1593;1835;5364;2321;6957
261150;201502;5496;16385;5024;15652;562;1977;3793;11802;4355;13779
261153;201502;2042;5980;1671;5414;79;319;1313;4275;1392;4594
261160;201502;206727;538287;194364;521394;42676;117488;109420;299646;152096;417134
261170;201502;5724;15970;5256;15312;649;1925;4025;11845;4674;13770
261180;201502;9481;26656;8979;25958;749;2321;6999;20383;7748;22704
261190;201502;5204;16355;4885;15963;614;2701;3530;11116;4144;13817
261200;201502;3658;9206;3335;8805;463;1223;2507;6713;2970;7936
261210;201502;1920;5101;1837;4996;120;307;1640;4514;1760;4821
261220;201502;12792;40846;10777;36447;1980;7352;5551;18706;7531;26058
261230;201502;4330;13178;3982;12744;182;662;3486;11229;3668;11891
261240;201502;4743;14175;4429;13645;684;2062;3066;9622;3750;11684
261245;201502;3635;11505;3162;10697;197;908;2508;8365;2705;9273
261247;201502;3359;10359;2855;9435;287;1080;2053;6809;2340;7889
261250;201502;19689;52663;18891;51656;3461;9134;13832;38698;17293;47832
261255;201502;4078;12663;3725;12072;240;905;3133;10175;3373;11080
261260;201502;11883;34093;10794;32812;488;1277;9603;29830;10091;31107
261270;201502;3825;11203;3489;10684;493;1657;2319;7006;2812;8663
261280;201502;2537;7794;2318;7481;169;613;1893;6111;2062;6724
261290;201502;2908;8451;2681;8158;147;556;2274;6942;2421;7498
261300;201502;10642;34990;9438;32847;1616;6445;5761;19837;7377;26282
261310;201502;7365;22771;6968;22098;1606;5274;4094;13036;5700;18310
261320;201502;5548;17691;5196;17037;326;1217;4246;13968;4572;15185
261330;201502;5395;16003;5164;15684;494;1522;4146;12630;4640;14152
261340;201502;4177;13919;3984;13605;501;2070;2695;9131;3196;11201
261350;201502;8030;26936;7572;26174;420;1906;6178;21102;6598;23008
261360;201502;8095;21580;7265;20424;677;2027;5758;16059;6435;18086
261370;201502;19881;59197;18666;57364;3710;12162;11518;35353;15228;47515
261380;201502;4160;14258;3834;13629;561;2199;2612;9347;3173;11546
261390;201502;15774;48608;14353;46224;2118;7666;9189;29345;11307;37011
261400;201502;4817;16720;4369;15804;494;2062;3114;11277;3608;13339
261410;201502;8445;24252;7774;23223;940;2865;5831;17652;6771;20517
261420;201502;7343;25077;7048;24662;1697;6688;4232;14550;5929;21238
261430;201502;3376;10726;2985;10173;304;1035;2294;7998;2598;9033
261440;201502;1616;5092;1473;4873;87;394;1215;3966;1302;4360
261450;201502;13751;39376;13336;38866;477;1543;12306;35858;12783;37401
261460;201502;7071;21383;6658;20858;430;1144;5860;18890;6290;20034
261470;201502;3951;10753;3589;10308;144;474;3196;9143;3340;9617
261480;201502;3554;12960;3315;12544;363;1569;2495;9298;2858;10867
261485;201502;4959;15308;4518;14542;830;3097;2651;8359;3481;11456
261500;201502;5664;15850;5016;14997;522;1420;3905;12084;4427;13504
261510;201502;1954;6316;1812;6099;127;479;1459;4928;1586;5407
261520;201502;2635;8594;2394;8127;153;627;1693;5857;1846;6484
261530;201502;12177;39207;10719;36443;2396;8964;4624;15775;7020;24739
261540;201502;7366;23845;7063;23330;1416;4678;4603;15566;6019;20244
261550;201502;3415;9979;3241;9731;303;1165;2653;7786;2956;8951
261560;201502;7018;22804;6374;21973;1105;3991;4481;15736;5586;19727
261570;201502;3452;10585;3032;9950;439;1548;2011;6596;2450;8144
261580;201502;5634;17858;5044;16939;365;1479;4150;13912;4515;15391
261590;201502;2462;7053;2226;6712;224;713;1707;5217;1931;5930
261600;201502;5378;14672;4620;13642;396;1227;3575;10644;3971;11871
261610;201502;2462;7214;2083;6679;124;499;1701;5348;1825;5847
261618;201502;2469;7049;2296;6831;205;677;1844;5415;2049;6092
261620;201502;4227;13160;3945;12707;507;1716;2861;9291;3368;11007
261630;201502;7804;22902;6596;20661;1082;3907;3689;11235;4771;15142
261640;201502;31810;81845;29465;78988;2087;5392;24545;67548;26632;72940
261650;201502;3606;11455;3387;11146;421;1491;2500;8287;2921;9778
270010;201502;4513;17112;4159;16438;495;2242;2825;11267;3320;13509
270020;201502;3805;11339;3592;11015;346;1226;2862;8667;3208;9893
270030;201502;40177;120974;37823;117267;8948;28664;21794;68597;30742;97261
270040;201502;10556;32310;9897;31520;2010;6054;6544;21847;8554;27901
270050;201502;4072;11798;3806;11456;360;1265;3004;8984;3364;10249
270060;201502;1644;5301;1555;5186;277;1031;1013;3390;1290;4421
270070;201502;4270;13266;3948;12833;183;834;3426;10964;3609;11798
270080;201502;1232;3983;1117;3748;177;691;710;2304;887;2995
270090;201502;2123;6640;2028;6466;55;225;1825;5755;1880;5980
270100;201502;5925;18399;5659;17971;982;3358;3851;12170;4833;15528
270110;201502;3149;8961;2852;8634;389;1228;1992;6396;2381;7624
270120;201502;2993;8771;2731;8430;85;328;2459;7629;2544;7957
270130;201502;4924;15471;4709;15228;398;1140;4010;13363;4408;14503
270135;201502;1732;4790;1677;4733;113;142;1526;4521;1639;4663
270140;201502;10209;25027;8933;23423;750;2884;7111;17538;7861;20422
270150;201502;2675;9120;2619;9050;121;478;2407;8318;2528;8796
270160;201502;5206;17295;4781;16771;269;1006;4095;14442;4364;15448
270170;201502;3876;12673;3572;12248;671;2728;2136;7194;2807;9922
270180;201502;2195;7455;2024;7222;124;626;1675;5902;1799;6528
270190;201502;1867;6156;1774;6021;127;514;1423;4873;1550;5387
270200;201502;2630;8871;2464;8635;218;931;1915;6637;2133;7568
270210;201502;4540;14346;4332;14062;300;1270;3723;11922;4023;13192
270220;201502;1421;4657;1336;4504;244;917;789;2623;1033;3540
270230;201502;10973;35531;9716;33517;1363;5715;6317;21336;7680;27051
270235;201502;6360;20723;6002;20143;328;1415;5051;16805;5379;18220
270240;201502;9887;29470;8550;27761;1881;6347;4789;15818;6670;22165
270250;201502;3297;8572;3049;8281;128;300;2822;7721;2950;8021
270255;201502;5026;15271;4071;13579;312;1313;2927;9632;3239;10945
270260;201502;5765;18924;5597;18675;562;2328;4588;15015;5150;17343
270270;201502;1219;3490;1122;3354;206;646;652;1921;858;2567
270280;201502;3593;10443;3291;10005;374;1247;2435;7378;2809;8625
270290;201502;8364;29302;7910;28513;805;3419;6194;22172;6999;25591
270300;201502;3568;11881;3265;11546;211;841;2777;9899;2988;10740
270310;201502;7222;22258;6417;20939;300;1460;5374;17118;5674;18578
270320;201502;6347;20313;6126;19952;1184;4489;3889;12586;5073;17075
270330;201502;4566;15341;4278;14957;417;1615;3433;12070;3850;13685
270340;201502;1744;5438;1565;5198;155;576;1234;4099;1389;4675
270350;201502;1876;5331;1717;5134;187;614;1287;3915;1474;4529
270360;201502;2024;6339;1970;6273;188;549;1672;5464;1860;6013
270370;201502;1630;5388;1494;5154;141;574;1081;3770;1222;4344
270375;201502;2968;8808;2697;8415;347;1342;1854;5528;2201;6870
270380;201502;5700;17676;5387;17252;523;1737;4263;13861;4786;15598
270390;201502;1313;3647;1177;3454;135;481;873;2465;1008;2946
270400;201502;6178;18812;5625;18026;494;1867;4038;12742;4532;14609
270410;201502;4829;15037;4542;14521;488;1765;3305;10451;3793;12216
270420;201502;5826;18841;5634;18586;318;1488;4689;15158;5007;16646
270430;201502;132827;387865;125311;377231;31778;99559;66202;203971;97980;303530
270440;201502;4664;14368;4346;13908;243;946;3589;11545;3832;12491
270450;201502;6293;19650;6048;19342;374;1517;5088;16148;5462;17665
270460;201502;3463;9416;3116;8958;215;742;2610;7392;2825;8134
270470;201502;10190;33265;9538;32214;1271;4410;6558;22691;7829;27101
270480;201502;3032;9463;2711;8898;300;1206;1852;5861;2152;7067
270490;201502;965;3132;917;3064;73;302;720;2384;793;2686
270500;201502;4952;17271;4738;16992;354;1359;4001;14504;4355;15863
270510;201502;5965;18163;5399;17377;718;3041;3935;12066;4653;15107
270520;201502;3577;11554;3361;11212;835;3056;1682;5665;2517;8721
270530;201502;1484;4419;1322;4198;173;574;895;2938;1068;3512
270540;201502;2024;6935;1850;6688;151;731;1492;5297;1643;6028
270550;201502;7058;20956;6221;19868;894;2973;4281;14050;5175;17023
270560;201502;3076;9505;2880;9209;460;1755;2043;6310;2503;8065
270570;201502;4215;13571;3861;12999;418;1776;2785;9196;3203;10972
270580;201502;1942;6469;1861;6354;248;888;1399;4864;1647;5752
270590;201502;1383;4699;1309;4572;34;157;1223;4256;1257;4413
270600;201502;2841;9614;2576;9194;216;1082;1983;6905;2199;7987
270610;201502;3215;10222;2992;9905;270;1001;2413;7939;2683;8940
270620;201502;1363;4703;1296;4601;108;535;1064;3618;1172;4153
270630;201502;17247;49348;16062;47453;2358;6881;11338;34264;13696;41145
270640;201502;5869;18154;5277;17372;395;1640;4309;13939;4704;15579
270642;201502;2259;7997;2112;7776;288;1252;1526;5590;1814;6842
270644;201502;2571;7459;2310;7174;187;527;1965;6249;2152;6776
270650;201502;3774;12128;3616;11909;658;2731;2347;7357;3005;10088
270660;201502;2535;6433;1985;5655;124;464;1412;4004;1536;4468
270670;201502;16130;42551;13973;40042;1730;4784;10456;31113;12186;35897
270680;201502;4259;12793;4088;12604;174;478;3716;11600;3890;12078
270690;201502;8955;25037;8206;24178;2604;7405;4162;13098;6766;20503
270700;201502;688;2151;631;2055;98;395;426;1325;524;1720
270710;201502;5838;19522;5580;19185;597;2202;4456;15425;5053;17627
270720;201502;3264;11138;3005;10692;208;1034;2433;8515;2641;9549
270730;201502;6348;19450;6041;19105;681;2228;4919;15746;5600;17974
270740;201502;2371;6806;2230;6613;300;1026;1622;4710;1922;5736
270750;201502;5018;16031;4662;15506;496;1817;3619;12065;4115;13882
270760;201502;3409;10363;3096;9832;257;917;2386;7576;2643;8493
270770;201502;18333;49069;15601;45797;3006;8879;9563;29217;12569;38096
270780;201502;1838;6106;1745;5948;217;810;1256;4301;1473;5111
270790;201502;1644;5159;1509;4956;306;1119;883;2844;1189;3963
270800;201502;11410;33758;10660;32778;853;2936;8784;27016;9637;29952
270810;201502;3355;10190;2639;8888;291;1165;1689;5714;1980;6879
270820;201502;1798;6067;1649;5826;253;1015;1087;3838;1340;4853
270830;201502;5549;16545;5037;15908;960;3451;3287;10447;4247;13898
270840;201502;7743;25839;7149;25092;404;1998;6107;21086;6511;23084
270850;201502;7413;24029;7206;23777;1287;5226;5026;15779;6313;21005
270860;201502;11269;32058;9853;30216;1189;4429;7070;21250;8259;25679
270870;201502;2226;6665;1837;5857;266;913;1136;3583;1402;4496
270880;201502;8103;26267;7643;25599;581;2396;6308;20862;6889;23258
270890;201502;2475;7548;2317;7268;298;1138;1688;5170;1986;6308
270895;201502;2918;10934;2778;10749;211;934;2342;9124;2553;10058
270900;201502;1955;5340;1583;4802;108;404;1203;3580;1311;3984
270910;201502;3321;11396;3220;11203;312;1400;2553;8628;2865;10028
270915;201502;9788;33117;8868;31511;1559;6450;5260;18435;6819;24885
270920;201502;6270;19767;5927;19287;208;1009;5364;17222;5572;18231
270930;201502;17503;46939;14483;43210;2690;8365;8796;27109;11486;35474
270940;201502;5910;19854;5635;19551;606;2392;4370;15244;4976;17636
280010;201502;672;2029;590;1894;49;221;406;1246;455;1467
280020;201502;4819;14272;4182;13150;689;2351;2709;8451;3398;10802
280030;201502;71025;187601;62366;174898;15773;46473;30307;86220;46080;132693
280040;201502;3152;9786;2825;9311;302;1023;2127;7202;2429;8225
280050;201502;3757;12184;3493;11761;1137;4046;1494;5174;2631;9220
280060;201502;4284;14203;3997;13720;823;3069;2318;8077;3141;11146
280067;201502;7472;21338;6474;19927;729;2305;4663;14502;5392;16807
280070;201502;1904;6456;1809;6321;341;1245;1220;4312;1561;5557
280100;201502;3886;12168;3490;11487;873;2985;1732;5843;2605;8828
280110;201502;1404;4301;1304;4151;65;282;1104;3460;1169;3742
280120;201502;7720;24729;7156;23839;1073;3329;5101;17808;6174;21137
280130;201502;7279;21040;6732;20241;1157;3829;4369;13176;5526;17005
280140;201502;5508;15085;5009;14405;524;1488;3931;11461;4455;12949
280150;201502;3445;10461;3175;9994;427;1539;2129;6528;2556;8067
280160;201502;1398;4054;1255;3842;131;468;946;2879;1077;3347
280170;201502;4765;14157;4315;13515;460;1362;3342;10805;3802;12167
280190;201502;1079;3100;974;2930;71;283;758;2198;829;2481
280200;201502;1139;3476;1042;3334;151;614;722;2210;873;2824
280210;201502;12880;39866;11823;38379;2132;7126;7827;26148;9959;33274
280220;201502;1538;4743;1444;4599;88;350;1243;3923;1331;4273
280230;201502;3502;10458;3119;9852;469;1594;1950;6230;2419;7824
280240;201502;3427;10222;3136;9775;267;808;2491;7873;2758;8681
280250;201502;837;2197;700;1988;122;401;420;1110;542;1511
280260;201502;1981;5310;1840;5133;83;253;1650;4636;1733;4889
280270;201502;2304;7142;2026;6719;129;518;1578;5167;1707;5685
280280;201502;4147;13559;3819;13020;920;2633;2121;8149;3041;10782
280290;201502;16959;52537;15335;49979;2260;8074;10208;33746;12468;41820
280300;201502;9552;29640;8975;28958;675;2349;7573;24773;8248;27122
280310;201502;1333;3792;1200;3585;81;318;859;2512;940;2830
280320;201502;8225;27003;7612;25964;1445;5509;4182;14293;5627;19802
280330;201502;4518;12736;4118;12159;367;1280;3366;9824;3733;11104
280340;201502;3769;10971;3557;10686;298;967;2865;8763;3163;9730
280350;201502;21835;62401;19828;59477;2491;7806;14054;42890;16545;50696
280360;201502;5715;18103;5392;17603;1032;3827;3232;10384;4264;14211
280370;201502;1807;5123;1616;4827;137;470;1239;3653;1376;4123
280380;201502;1001;3050;927;2952;94;355;723;2294;817;2649
280390;201502;3175;9350;2738;8561;480;1523;1682;5295;2162;6818
280400;201502;4236;12334;3852;11801;964;2791;2255;7341;3219;10132
280410;201502;2147;6984;1894;6497;301;1180;1095;3621;1396;4801
280420;201502;4208;12256;3923;11817;236;766;3388;10240;3624;11006
280430;201502;2236;5777;2055;5553;112;381;1759;4745;1871;5126
280440;201502;4845;14270;4540;13907;326;978;3922;12172;4248;13150
280445;201502;2461;7077;2293;6798;90;355;1903;5565;1993;5920
280450;201502;8544;23661;8004;23000;503;1193;6920;20474;7423;21667
280460;201502;6976;18679;6282;17720;823;2448;4586;13135;5409;15583
280470;201502;1777;5434;1632;5200;187;600;1222;3931;1409;4531
280480;201502;30371;89706;28993;87751;4490;15608;19729;58475;24219;74083
280490;201502;3771;11480;3353;10713;336;1229;2447;7749;2783;8978
280500;201502;903;2428;841;2350;29;94;755;2093;784;2187
280510;201502;2706;7881;2341;7407;242;874;1774;5672;2016;6546
280520;201502;1720;4885;1567;4692;153;389;1279;3963;1432;4352
280530;201502;2168;6371;2038;6213;172;558;1704;5258;1876;5816
280540;201502;9233;25200;8665;24450;234;910;7871;22031;8105;22941
280550;201502;6854;18503;5940;17096;654;2050;4267;12266;4921;14316
280560;201502;7432;22126;7014;21508;381;1361;5989;18220;6370;19581
280570;201502;6406;17780;5700;16878;686;2336;4088;12051;4774;14387
280580;201502;5570;17291;4743;15869;890;3006;2872;9930;3762;12936
280590;201502;2291;7049;2134;6850;266;1148;1541;4830;1807;5978
280600;201502;3868;11869;3621;11497;339;1257;2739;8618;3078;9875
280610;201502;2474;6989;2285;6730;266;953;1615;4634;1881;5587
280620;201502;5056;15297;4450;14171;688;2057;2904;9614;3592;11671
280630;201502;3853;12526;3669;12259;372;1094;2974;10340;3346;11434
280640;201502;2194;6501;2088;6382;81;155;1958;6119;2039;6274
280650;201502;1128;3511;1020;3329;145;533;682;2231;827;2764
280660;201502;2623;7528;2502;7363;392;1113;1935;5759;2327;6872
280670;201502;15678;41409;14680;40083;2584;7356;9888;26978;12472;34334
280680;201502;2776;7527;2452;7044;160;516;2024;5811;2184;6327
280690;201502;991;2810;865;2633;124;397;586;1766;710;2163
280700;201502;1099;3288;963;3084;66;207;746;2421;812;2628
280710;201502;11327;30622;10491;29664;758;1981;8930;25652;9688;27633
280720;201502;2239;6284;2043;6054;248;767;1466;4427;1714;5194
280730;201502;950;2834;901;2769;73;230;773;2400;846;2630
280740;201502;12976;35515;11323;33042;1692;4865;7535;22601;9227;27466
280750;201502;3515;10773;3226;10272;308;1142;2335;7426;2643;8568
280760;201502;5574;17220;5095;16567;639;2129;3642;12289;4281;14418
290010;201502;3117;6990;2241;5650;68;279;1786;4272;1854;4551
290020;201502;4494;15131;4426;15046;330;927;3902;13610;4232;14537
290030;201502;3148;10007;2985;9760;479;1593;2133;7033;2612;8626
290035;201502;4641;12210;4109;11542;268;819;3344;9676;3612;10495
290040;201502;3742;10681;3340;10224;217;868;2753;8302;2970;9170
290050;201502;2441;8087;2252;7806;162;666;1819;6292;1981;6958
290060;201502;1329;3390;1107;3128;192;623;796;2184;988;2807
290070;201502;31612;80519;26972;74845;5785;16041;14399;42371;20184;58412
290080;201502;6038;18139;5224;17100;596;1938;3967;13397;4563;15335
290090;201502;2251;4862;1772;4358;190;434;1464;3691;1654;4125
290100;201502;9518;27409;8405;25689;1137;3630;5613;17577;6750;21207
290110;201502;5036;15057;4805;14670;685;2313;3350;10102;4035;12415
290115;201502;4907;14648;4344;13907;308;1035;3418;11180;3726;12215
290120;201502;6513;17530;5794;16670;257;800;5137;14786;5394;15586
290130;201502;4514;11955;3853;11163;258;886;3148;8975;3406;9861
290135;201502;4600;11905;4039;11049;292;993;3080;8137;3372;9130
290140;201502;4109;12797;3497;11970;222;833;3006;10349;3228;11182
290150;201502;2206;6566;2103;6399;176;542;1768;5407;1944;5949
290160;201502;3403;9273;3309;9159;203;368;3022;8574;3225;8942
290170;201502;2724;9196;2498;8850;174;766;2158;7581;2332;8347
290180;201502;2899;8512;2577;8019;212;773;1996;6199;2208;6972
290190;201502;3873;13063;3732;12839;292;1175;2945;10147;3237;11322
290195;201502;2188;6063;1883;5615;133;478;1517;4523;1650;5001
290200;201502;3753;11853;3384;11247;282;984;2685;8978;2967;9962
290205;201502;3061;9321;2775;8888;319;1252;2007;6284;2326;7536
290210;201502;15597;43125;14452;41732;2827;7140;9613;30102;12440;37242
290220;201502;2235;6780;2140;6637;181;750;1671;5024;1852;5774
290225;201502;2904;7762;2702;7542;150;343;2474;7028;2624;7371
290230;201502;2266;7504;2201;7425;155;592;1894;6416;2049;7008
290240;201502;3787;10144;3431;9647;339;1031;2597;7204;2936;8235
290250;201502;3643;11761;3235;11125;233;829;2581;9019;2814;9848
290260;201502;4807;14278;4254;13449;355;1263;3365;10651;3720;11914
290265;201502;3261;10453;2954;9903;185;777;2336;7799;2521;8576
290270;201502;12198;44200;11507;43164;1523;6032;8457;32247;9980;38279
290280;201502;5110;16979;4815;16483;385;1470;3785;13012;4170;14482
290290;201502;9498;30343;8608;28936;1447;5046;5677;19494;7124;24540
290300;201502;4512;12921;3225;10512;259;845;2209;7487;2468;8332
290310;201502;1491;4466;1327;4212;232;803;782;2479;1014;3282
290320;201502;27111;80810;23560;76115;5541;18941;12746;42123;18287;61064
290323;201502;3758;10172;3258;9628;181;592;2767;8166;2948;8758
290327;201502;4321;13476;3864;12654;634;2148;2503;8249;3137;10397
290330;201502;1838;4691;1719;4560;158;464;1476;3895;1634;4359
290340;201502;4689;14994;4436;14667;1327;4314;2430;8239;3757;12553
290350;201502;4655;14384;4003;13456;508;1736;2774;9599;3282;11335
290360;201502;4428;13710;3859;12951;183;669;3302;11219;3485;11888
290370;201502;4720;13649;4228;13048;431;1286;3469;10894;3900;12180
290380;201502;5479;16025;4794;15033;347;1213;3830;12077;4177;13290
290390;201502;14686;45964;13555;44238;2744;8999;7980;27378;10724;36377
290395;201502;2620;8609;2348;8134;168;746;1815;6268;1983;7014
290400;201502;3540;10647;3094;10040;269;878;2416;7907;2685;8785
290405;201502;4503;14408;3894;13306;486;1756;2567;8983;3053;10739
290410;201502;5990;17673;4990;16213;513;1990;3639;11589;4152;13579
290420;201502;3280;9592;2714;8817;228;842;2161;6993;2389;7835
290430;201502;3068;9845;2804;9390;527;1906;1747;5869;2274;7775
290440;201502;2895;7821;2422;7168;185;614;1944;5823;2129;6437
290450;201502;3286;9650;2878;9068;398;1285;2024;6486;2422;7771
290460;201502;12984;38297;11714;36269;3097;10148;5261;16271;8358;26419
290470;201502;4488;12408;3454;10977;734;2664;1819;5858;2553;8522
290475;201502;4940;17056;4516;16247;440;1957;3307;11736;3747;13693
290480;201502;2680;7003;2382;6612;381;1114;1548;4402;1929;5516
290485;201502;4794;15320;4213;14469;373;1741;3386;11411;3759;13152
290490;201502;7978;21165;7660;20753;605;1741;6422;17385;7027;19126
290500;201502;4319;13592;3588;12228;615;2299;1909;6455;2524;8754
290510;201502;3314;9794;2893;9217;178;685;2376;7603;2554;8288
290515;201502;3121;9280;2753;8772;227;717;2204;7184;2431;7901
290520;201502;12198;37489;9941;33382;934;3883;6397;21276;7331;25159
290530;201502;5114;14889;4443;13898;354;1120;3566;11251;3920;12371
290540;201502;3945;11436;3746;11185;431;1216;2968;9087;3399;10303
290550;201502;4452;12051;3911;11419;144;418;3559;10456;3703;10874
290560;201502;5916;17839;5271;16890;1174;4006;2996;9774;4170;13780
290570;201502;41412;116200;38076;111421;4609;14119;27258;79672;31867;93791
290580;201502;6914;23944;6544;23381;964;3541;4741;17335;5705;20876
290590;201502;7692;24161;6455;22099;420;1742;5104;17442;5524;19184
290600;201502;16886;52257;15647;50365;2595;8141;10659;35496;13254;43637
290610;201502;2489;8457;2111;7721;190;872;1512;5442;1702;6314
290620;201502;6516;19847;5971;19042;372;1284;5017;16020;5389;17304
290630;201502;7905;21155;7108;20303;632;1809;5959;17212;6591;19021
290640;201502;2619;7729;2135;6916;160;624;1607;5148;1767;5772
290650;201502;11141;31860;10402;30855;2269;6604;6468;19860;8737;26464
290660;201502;3549;10023;3076;9347;170;583;2457;7588;2627;8171
290670;201502;6959;21294;6303;20281;749;2381;4675;15506;5424;17887
290680;201502;10112;30159;9255;29135;437;1539;7988;25256;8425;26795
290682;201502;4511;13137;4029;12467;166;672;3402;10403;3568;11075
290685;201502;3521;8676;2466;7220;296;940;1503;4512;1799;5452
290687;201502;7640;21017;6046;18870;1381;4480;3260;10488;4641;14968
290689;201502;3115;9028;2677;8350;249;801;2068;6582;2317;7383
290690;201502;5470;15913;4974;15295;475;1537;3966;12291;4441;13828
290700;201502;2334;7286;2211;7102;208;751;1709;5519;1917;6270
290710;201502;7994;25257;7649;24681;449;1476;6369;21192;6818;22668
290720;201502;18529;54666;16772;52487;1496;4249;13923;44912;15419;49161
290730;201502;7103;19970;6447;19118;1044;3008;4490;13545;5534;16553
290740;201502;914;2741;778;2517;88;313;530;1739;618;2052
290750;201502;10270;29010;8680;26128;1626;5581;4685;13484;6311;19065
290755;201502;2404;6759;1995;6091;122;447;1533;4662;1655;5109
290760;201502;4229;12757;3527;11626;381;1209;2428;8173;2809;9382
290770;201502;2573;9111;2424;8921;122;577;1984;7362;2106;7939
290780;201502;8895;22828;7808;21347;778;1708;6051;17240;6829;18948
290790;201502;4312;13149;4023;12731;283;880;3387;10843;3670;11723
290800;201502;7332;15819;5868;14267;724;1532;4364;11276;5088;12808
290810;201502;4926;15609;4209;14495;261;993;3240;11281;3501;12274
290820;201502;5636;15881;5033;15094;455;1479;3902;11791;4357;13270
290830;201502;4142;11446;3824;10969;227;834;3172;8886;3399;9720
290840;201502;17246;49011;15507;46605;2450;7146;10551;33115;13001;40261
290850;201502;6238;18251;6086;18054;715;1942;4990;15272;5705;17214
290860;201502;4905;17021;4592;16633;612;2261;3472;12959;4084;15220
290870;201502;4602;13791;3824;12631;339;1385;2850;9327;3189;10712
290880;201502;1403;3897;1133;3459;86;283;803;2473;889;2756
290890;201502;6920;18464;5979;17420;690;1983;4717;13953;5407;15936
290900;201502;2569;7338;1906;6232;294;1016;949;3128;1243;4144
290910;201502;4509;12602;3971;11822;142;482;3490;10372;3632;10854
290920;201502;4707;14058;4369;13570;265;750;3681;11612;3946;12362
290930;201502;7613;23924;6750;22475;585;2335;5099;16788;5684;19123
290940;201502;3401;10973;3180;10678;194;690;2782;9500;2976;10190
290950;201502;1577;4431;1413;4198;196;571;979;2979;1175;3550
290960;201502;5734;16400;5236;15746;226;788;4435;13400;4661;14188
290970;201502;3528;11430;3170;10822;360;1277;2136;7417;2496;8694
290980;201502;10595;30803;9146;28139;2532;8124;3370;10288;5902;18412
290990;201502;9125;27496;8043;25757;852;2933;6057;19354;6909;22287
291000;201502;3056;9278;2796;8945;259;885;2303;7434;2562;8319
291005;201502;13696;36971;12276;35035;1761;5201;8562;24891;10323;30092
291010;201502;3145;10027;2520;8679;278;1016;1619;5629;1897;6645
291020;201502;1416;3717;1093;3157;120;411;671;1855;791;2266
291030;201502;2276;6225;1694;5079;180;602;1040;3048;1220;3650
291040;201502;5363;16376;4848;15658;479;1727;3838;12410;4317;14137
291050;201502;7645;25361;6952;24050;1875;7179;3372;11405;5247;18584
291060;201502;5976;22140;5697;21746;722;3215;4182;15901;4904;19116
291070;201502;15972;46551;14288;44150;1303;4141;10942;34255;12245;38396
291072;201502;21873;65403;18116;58013;4882;16887;6824;22330;11706;39217
291075;201502;5092;14463;4562;13797;282;721;3659;11469;3941;12190
291077;201502;1509;4303;1233;3865;122;440;837;2625;959;3065
291080;201502;78161;243454;70276;228269;23330;77985;20858;66944;44188;144929
291085;201502;5488;14708;4830;13857;471;1349;3894;11281;4365;12630
291090;201502;1537;3806;1343;3563;99;374;1100;2826;1199;3200
291100;201502;2783;7124;2249;6566;119;451;1875;5446;1994;5897
291110;201502;4773;17401;4400;16811;570;2522;3147;11857;3717;14379
291120;201502;7431;20060;6857;19234;802;2312;5152;14573;5954;16885
291125;201502;1786;3711;1387;3287;108;261;1092;2651;1200;2912
291130;201502;2856;8862;2462;8209;178;758;1815;5921;1993;6679
291140;201502;4266;12645;3832;11856;571;1792;2542;7982;3113;9774
291150;201502;1966;5187;1866;5071;145;429;1481;3997;1626;4426
291160;201502;5347;16591;4695;15581;1171;3927;2547;8605;3718;12532
291165;201502;2481;7142;1953;6149;89;412;1452;4441;1541;4853
291170;201502;21224;55087;18289;51350;953;3235;14370;40186;15323;43421
291180;201502;6454;16843;5192;15047;561;1844;3661;10548;4222;12392
291185;201502;3828;10492;3517;10072;302;903;2905;8320;3207;9223
291190;201502;7057;19668;6315;18711;577;1794;5075;15190;5652;16984
291200;201502;2858;8608;2343;7652;177;603;1670;5554;1847;6157
291210;201502;7219;17196;6167;16018;389;1145;5060;13116;5449;14261
291220;201502;4003;12631;3734;12205;437;1609;2789;9061;3226;10670
291230;201502;4039;10490;3662;10067;105;253;3383;9410;3488;9663
291240;201502;4642;12669;4020;11544;197;633;3248;9175;3445;9808
291250;201502;3658;11020;2888;9720;320;1117;1944;6656;2264;7773
291260;201502;1087;3204;1000;3086;61;244;827;2503;888;2747
291270;201502;4380;14403;4028;13767;1154;4107;2164;7515;3318;11622
291280;201502;2372;6261;1788;5437;401;1285;974;2939;1375;4224
291290;201502;5578;15679;4910;14847;804;2424;3209;9995;4013;12419
291300;201502;4206;12384;3552;11306;311;1167;2609;8178;2920;9345
291310;201502;5399;15424;4686;14184;323;1049;3685;11134;4008;12183
291320;201502;6011;19151;5122;17453;1183;4431;2704;9069;3887;13500
291330;201502;1594;4757;1437;4510;145;532;1017;3120;1162;3652
291340;201502;3830;11307;3226;10459;208;795;2620;8451;2828;9246
291345;201502;3536;11286;3295;11016;202;628;2914;10000;3116;10628
291350;201502;5756;17031;5086;15914;366;1247;3927;12435;4293;13682
291360;201502;32871;93252;30115;89363;7260;21402;17633;54094;24893;75496
291370;201502;8418;24721;8008;24196;658;1995;6417;19805;7075;21800
291380;201502;3747;11573;3251;10779;233;847;2390;8125;2623;8972
291390;201502;10382;28177;9398;27033;1264;3436;7172;21030;8436;24466
291400;201502;16325;42645;13511;38903;2331;6520;8476;25664;10807;32184
291410;201502;3312;8673;2468;7460;176;708;1883;5546;2059;6254
291420;201502;2154;5868;1878;5536;107;357;1638;4835;1745;5192
291430;201502;3358;9809;2980;9315;184;791;2402;7352;2586;8143
291440;201502;6388;19738;5484;18192;544;1902;4096;13768;4640;15670
291450;201502;7991;24235;7101;22976;318;1032;5896;19573;6214;20605
291460;201502;12839;38906;11515;36809;1945;6752;7119;22903;9064;29655
291465;201502;7937;22854;7110;21923;542;1891;5971;18407;6513;20298
291470;201502;15650;42757;13783;40498;1215;3427;10509;32060;11724;35487
291480;201502;33660;89030;29262;83034;3897;12570;19222;53931;23119;66501
291490;201502;4388;14274;4262;14105;380;1240;3577;12089;3957;13329
291500;201502;4268;12392;3673;11539;259;945;2925;9175;3184;10120
291510;201502;3544;10726;3244;10330;95;296;2967;9550;3062;9846
291520;201502;3806;10451;3304;9765;354;1112;2337;6987;2691;8099
291530;201502;2040;5884;1721;5395;410;1373;914;2962;1324;4335
291535;201502;4036;12094;3619;11499;237;841;2940;9429;3177;10270
291540;201502;2194;5225;1853;4872;157;308;1598;4357;1755;4665
291550;201502;5224;14329;4615;13492;1070;3038;2600;7818;3670;10856
291560;201502;17681;43227;13200;38096;1081;3129;10208;30402;11289;33531
291570;201502;2218;6111;2083;5951;144;333;1856;5447;2000;5780
291580;201502;5554;17029;4953;16163;577;2311;3617;11721;4194;14032
291590;201502;1817;5790;1631;5486;192;677;1189;4084;1381;4761
291600;201502;5805;15857;4340;13669;1035;3582;2002;6190;3037;9772
291610;201502;4884;15224;4729;15034;262;958;4139;13184;4401;14142
291620;201502;2974;7072;2389;6457;139;357;1932;5408;2071;5765
291630;201502;3124;7712;2660;7180;251;631;2153;5941;2404;6572
291640;201502;17162;46602;14077;42365;3529;11503;5388;16427;8917;27930
291650;201502;7926;23833;7347;23144;614;1615;6209;20195;6823;21810
291660;201502;2214;5860;1878;5370;159;563;1316;3644;1475;4207
291670;201502;1848;5299;1669;5044;118;395;1310;3954;1428;4349
291680;201502;4221;12404;3713;11589;780;2670;2082;6463;2862;9133
291685;201502;4681;11707;3892;10688;542;1443;2765;7870;3307;9313
291690;201502;3980;10793;3257;9666;244;719;2379;7126;2623;7845
291700;201502;9167;28694;8292;27191;865;2931;6296;20978;7161;23909
291710;201502;5133;13826;4309;12788;494;1601;3174;9516;3668;11117
291720;201502;4245;14223;3685;13100;380;1571;2622;9198;3002;10769
291730;201502;5994;18212;5437;17482;695;2377;4123;13490;4818;15867
291733;201502;2584;7549;2199;7038;271;927;1502;4872;1773;5799
291735;201502;2674;7518;2248;6894;130;475;1811;5495;1941;5970
291740;201502;3531;10729;3094;10055;283;1054;2350;7585;2633;8639
291750;201502;22449;57797;17429;50235;3896;11629;8953;26374;12849;38003
291760;201502;11352;36187;10091;34004;4008;14932;3183;10554;7191;25486
291770;201502;7532;21736;6562;20064;943;3106;4355;13222;5298;16328
291780;201502;4456;13538;4188;13076;387;1231;3312;10384;3699;11615
291790;201502;2616;8071;2477;7883;116;482;2132;6723;2248;7205
291800;201502;30474;85691;27217;81150;4752;14540;17083;52566;21835;67106
291810;201502;10574;29500;8885;27514;449;1626;7534;23421;7983;25047
291820;201502;3712;11035;3358;10535;269;880;2633;8362;2902;9242
291830;201502;4321;11567;3987;11091;449;1296;3034;8512;3483;9808
291835;201502;6265;19543;5054;17496;1350;5006;2647;9228;3997;14234
291840;201502;47526;132427;41866;126153;5444;15795;31416;97970;36860;113765
291845;201502;2932;8438;2607;8052;191;540;2292;7204;2483;7744
291850;201502;4682;13261;3857;11999;386;1116;2935;9422;3321;10538
291855;201502;1804;4642;1558;4333;180;631;1152;3083;1332;3714
291860;201502;2099;6105;1758;5469;136;517;1176;3590;1312;4107
291870;201502;1409;3765;1050;3133;101;362;669;1945;770;2307
291875;201502;2829;8982;2558;8568;176;757;1882;6179;2058;6936
291880;201502;4878;15463;4595;15008;354;1134;3778;12525;4132;13659
291890;201502;1348;3429;1125;3165;279;801;667;1951;946;2752
291900;201502;1308;3635;1095;3295;88;321;870;2602;958;2923
291905;201502;2770;7483;2250;6645;120;462;1704;4916;1824;5378
291910;201502;2720;7295;2288;6775;142;537;1929;5629;2071;6166
291915;201502;7019;21388;5952;19425;390;1382;4848;15938;5238;17320
291920;201502;30247;88020;27757;84482;5288;16721;16846;52098;22134;68819
291930;201502;2590;7668;2332;7275;216;763;1725;5364;1941;6127
291940;201502;3385;9644;2492;8031;352;1296;1417;4390;1769;5686
291950;201502;8632;29118;7832;27794;1413;5099;4679;17042;6092;22141
291955;201502;9198;28122;8723;27497;1980;6194;5281;17326;7261;23520
291960;201502;3155;9454;2634;8691;231;739;1984;6808;2215;7547
291970;201502;3956;12357;3692;11974;469;1602;2616;8620;3085;10222
291980;201502;11849;34030;9105;30121;983;3380;6433;21852;7416;25232
291990;201502;2264;6844;2052;6550;131;446;1641;5369;1772;5815
291992;201502;2801;8571;2730;8430;394;1279;2050;6295;2444;7574
291995;201502;1866;5689;1741;5476;150;547;1390;4347;1540;4894
292000;201502;2347;6774;2078;6396;308;1090;1456;4450;1764;5540
292010;201502;6368;16366;4949;14307;462;1336;3791;11023;4253;12359
292020;201502;4205;14414;3922;13960;632;2362;2811;10066;3443;12428
292030;201502;2089;6420;1845;6066;212;739;1158;3815;1370;4554
292040;201502;4306;11940;3735;11350;244;593;3247;10280;3491;10873
292045;201502;2839;9758;2798;9707;90;300;2645;9185;2735;9485
292050;201502;6305;19509;5506;17918;467;1867;3805;12224;4272;14091
292060;201502;11529;31192;10755;30235;1019;2725;8802;24997;9821;27722
292070;201502;4465;14151;4358;14008;398;1186;3691;12048;4089;13234
292080;201502;3579;9336;3032;8651;213;636;2510;7208;2723;7844
292090;201502;4070;10802;3521;10166;236;797;3000;8706;3236;9503
292100;201502;10970;29898;9219;27469;2635;8200;4011;12545;6646;20745
292105;201502;2975;9399;2685;8961;160;669;2202;7339;2362;8008
292110;201502;6733;17791;5191;15447;1126;3409;2929;8997;4055;12406
292120;201502;7745;22133;6771;20393;1377;4170;3802;11850;5179;16020
292130;201502;2964;8002;2596;7483;474;1277;1730;5135;2204;6412
292140;201502;4946;13005;4263;12103;869;2268;2779;8203;3648;10471
292145;201502;2476;7644;2265;7333;135;415;1806;6109;1941;6524
292150;201502;12850;39457;11962;38061;692;2519;9671;31063;10363;33582
292160;201502;2652;7692;2266;7198;110;336;1998;6430;2108;6766
292170;201502;8839;25367;7412;22959;977;3400;4771;14775;5748;18175
292180;201502;3262;9376;2534;8218;311;1010;1722;5681;2033;6691
292190;201502;3399;9538;2870;8777;567;1820;1763;5494;2330;7314
292200;201502;6318;20217;5478;18646;1560;5784;2237;7597;3797;13381
292205;201502;3894;12145;3556;11682;213;850;2926;9541;3139;10391
292210;201502;6434;17809;5427;16477;378;1314;4420;13501;4798;14815
292220;201502;1938;5369;1780;5151;345;944;1104;3237;1449;4181
292225;201502;3187;9841;2920;9462;178;665;2428;7897;2606;8562
292230;201502;6367;19079;6045;18564;447;1831;4755;14148;5202;15979
292240;201502;4590;14080;4195;13286;576;1910;2729;8600;3305;10510
292250;201502;5097;15797;4731;15132;1083;3631;2374;7623;3457;11254
292260;201502;3128;9423;2955;9188;209;714;2495;7759;2704;8473
292265;201502;2968;9433;2655;8907;187;763;1981;6586;2168;7349
292270;201502;4129;10618;3261;9614;202;712;2713;8023;2915;8735
292273;201502;2714;6530;2088;5767;228;584;1564;4563;1792;5147
292275;201502;1776;4760;1578;4469;211;620;1114;3188;1325;3808
292280;201502;2005;6016;1790;5784;128;336;1454;4975;1582;5311
292285;201502;2535;7020;2190;6539;151;542;1768;5289;1919;5831
292290;201502;7312;21837;6086;20211;417;1588;4771;16111;5188;17699
292300;201502;7981;24130;6944;22868;1625;5543;4174;14170;5799;19713
292303;201502;2771;8652;2571;8394;81;350;2292;7424;2373;7774
292305;201502;2941;8056;2826;7908;56;180;2670;7478;2726;7658
292310;201502;5881;17568;5520;17051;233;819;4666;14440;4899;15259
292320;201502;6567;18997;5673;17514;540;1823;4339;13419;4879;15242
292330;201502;2085;5759;1943;5559;174;566;1555;4391;1729;4957
292335;201502;5205;13604;4667;12910;458;1233;3825;10726;4283;11959
292340;201502;6385;18193;5410;16628;563;1755;3863;11958;4426;13713
292350;201502;2177;6591;1986;6325;194;734;1587;5045;1781;5779
292360;201502;5034;13712;4838;13277;175;354;4225;12130;4400;12484
292370;201502;7925;23814;7405;23074;811;2234;5887;18865;6698;21099
292380;201502;7154;21240;6626;20429;464;1435;5502;17097;5966;18532
292390;201502;3500;8048;3117;7633;95;166;2917;7234;3012;7400
292400;201502;20502;61801;19539;60349;2575;8363;14536;45175;17111;53538
292405;201502;4506;11583;3744;10650;246;686;3095;8880;3341;9566
292410;201502;1919;5167;1814;5048;124;317;1599;4492;1723;4809
292420;201502;3759;12169;3605;11981;125;370;3372;11342;3497;11712
292430;201502;5622;16846;4424;15189;328;1350;3263;11205;3591;12555
292440;201502;8524;28207;7843;27215;278;1131;6954;24395;7232;25526
292450;201502;4145;12356;3429;11238;317;1095;2512;8362;2829;9457
292460;201502;5282;15862;4576;14629;829;2824;2836;9116;3665;11940
292465;201502;2395;7257;2024;6639;203;782;1411;4667;1614;5449
292467;201502;1940;6266;1839;6101;322;1140;1247;4207;1569;5347
292470;201502;2898;7860;2448;7125;141;495;1944;5601;2085;6096
292480;201502;6038;16254;5272;15214;199;737;4646;13316;4845;14053
292490;201502;2390;6542;1998;5987;171;591;1545;4598;1716;5189
292500;201502;6521;19416;5597;17841;596;2063;3969;12826;4565;14889
292510;201502;12590;35882;10948;33577;920;3044;8572;26716;9492;29760
292520;201502;5628;16642;5038;15742;1274;4030;2664;8460;3938;12490
292525;201502;5314;13902;4530;12987;235;720;3835;11092;4070;11812
292530;201502;26025;75782;23191;72025;5966;19268;12043;38582;18009;57850
292540;201502;2831;7992;2518;7581;260;894;1994;6007;2254;6901
292550;201502;6467;20508;5736;19524;664;2411;4328;15080;4992;17491
292560;201502;4046;11198;3441;10343;222;886;2798;8249;3020;9135
292570;201502;3890;11652;3709;11460;79;196;3515;11066;3594;11262
292575;201502;6027;20236;5857;19962;752;2664;4587;15698;5339;18362
292580;201502;6807;20478;6449;20003;455;1425;5450;17078;5905;18503
292590;201502;7095;21868;6717;21282;620;2048;5424;17145;6044;19193
292593;201502;3060;8064;2616;7407;207;555;2085;5956;2292;6511
292595;201502;5972;16620;5277;15726;446;1441;4131;12405;4577;13846
292600;201502;10498;29679;9651;28611;895;2117;7877;24226;8772;26343
292610;201502;4469;12794;3640;11400;356;1150;2367;7679;2723;8829
292620;201502;6012;17548;5163;16563;157;526;4754;15371;4911;15897
292630;201502;9396;23772;7956;21616;699;1903;5941;16471;6640;18374
292640;201502;7758;25574;7198;24788;497;1827;5736;20111;6233;21938
292650;201502;4692;12961;4485;12687;353;621;3949;11683;4302;12304
292660;201502;10493;31814;9772;30785;1063;3465;7605;24282;8668;27747
292665;201502;2644;8010;2570;7907;50;110;2454;7639;2504;7749
292670;201502;3813;10740;2949;9283;234;834;1963;6200;2197;7034
292680;201502;3529;10679;3268;10265;372;1111;2533;8045;2905;9156
292690;201502;2921;7991;2143;6786;208;703;1527;4951;1735;5654
292700;201502;9208;27559;8114;25955;1124;3321;5635;18905;6759;22226
292710;201502;2003;6599;1908;6469;78;293;1717;5850;1795;6143
292720;201502;9136;23572;7919;22225;379;1167;6927;19553;7306;20720
292730;201502;3503;10553;3376;10371;357;1122;2611;8110;2968;9232
292740;201502;331507;896828;312554;870022;58125;172190;199950;553118;258075;725308
292750;201502;6393;17220;5513;16037;339;1048;4557;13345;4896;14393
292760;201502;4045;12850;3701;12245;499;1769;2487;8321;2986;10090
292770;201502;5544;17011;5144;16402;995;3298;3288;10704;4283;14002
292780;201502;1917;4576;1469;4022;164;564;1066;2867;1230;3431
292790;201502;3164;8451;3031;8312;108;224;2836;7897;2944;8121
292800;201502;8923;26760;8248;25661;576;2024;6725;20871;7301;22895
292805;201502;3010;8638;2713;8229;405;1339;1935;5850;2340;7189
292810;201502;9277;28504;7983;26723;1011;3561;5806;19832;6817;23393
292820;201502;7241;20819;5403;18177;320;1273;4318;14617;4638;15890
292830;201502;1865;5471;1691;5229;84;358;1433;4371;1517;4729
292840;201502;7663;23954;7176;23297;303;1179;6453;20811;6756;21990
292850;201502;3280;8686;2720;7860;339;1040;1842;5245;2181;6285
292860;201502;14019;37961;13324;37052;1159;3459;10896;30219;12055;33678
292870;201502;19030;52099;16638;48462;2337;7516;10249;29563;12586;37079
292880;201502;12627;36460;11274;34507;1384;4667;7801;23678;9185;28345
292890;201502;5458;18651;4907;17648;794;3058;3069;11178;3863;14236
292895;201502;2740;6761;2159;5904;278;753;1540;4218;1818;4971
292900;201502;2823;8836;2684;8631;236;1033;1989;6126;2225;7159
292905;201502;4184;12242;3546;11389;192;557;2943;9710;3135;10267
292910;201502;5007;15109;4557;14304;694;2381;2895;9072;3589;11453
292920;201502;8809;26121;8354;25482;674;2419;6723;20007;7397;22426
292925;201502;5120;15742;4550;14919;434;1445;3475;11520;3909;12965
292930;201502;6436;20811;6133;20293;553;2355;4655;15075;5208;17430
292935;201502;2138;6080;1778;5690;100;257;1500;5022;1600;5279
292937;201502;3233;8293;2713;7641;285;908;2065;5727;2350;6635
292940;201502;3225;8862;2570;7975;325;1034;1740;5609;2065;6643
292950;201502;7837;23250;7388;22502;675;2490;5538;16472;6213;18962
292960;201502;5034;13263;4393;12395;378;1170;3295;9230;3673;10400
292970;201502;4290;12942;3829;12347;159;671;3258;10528;3417;11199
292975;201502;3398;9181;3217;8939;309;794;2732;7721;3041;8515
292980;201502;3397;9121;2690;8192;262;931;1975;5953;2237;6884
292990;201502;11740;34040;10456;32086;489;1687;8902;27314;9391;29001
293000;201502;2744;7369;2409;6950;79;268;2122;6154;2201;6422
293010;201502;17914;50110;15415;46197;2556;8351;9528;28407;12084;36758
293015;201502;7430;25542;6614;24054;985;4014;4239;15347;5224;19361
293020;201502;9202;30763;8611;29946;409;1791;7418;25750;7827;27541
293030;201502;5507;15991;4381;14286;373;1234;3121;10647;3494;11881
293040;201502;3716;12224;3535;11885;185;664;3134;10528;3319;11192
293050;201502;19709;55031;17352;52090;2428;7593;11662;35905;14090;43498
293060;201502;3921;10197;3230;9101;286;894;2376;6618;2662;7512
293070;201502;20871;61425;18614;57818;4648;14706;9483;30316;14131;45022
293075;201502;3349;11101;3032;10666;227;876;2464;8742;2691;9618
293076;201502;3683;10258;3388;9860;233;640;2851;8473;3084;9113
293077;201502;4721;14973;4244;14310;1107;3902;2237;7689;3344;11591
293080;201502;4614;14604;4244;14027;248;1147;3466;11237;3714;12384
293090;201502;3333;10723;2820;9977;256;933;2142;7722;2398;8655
293100;201502;5692;16950;4773;15373;447;1528;3553;11586;4000;13114
293105;201502;3919;13059;3469;12219;466;1717;2383;8544;2849;10261
293110;201502;1970;5764;1763;5449;75;292;1500;4614;1575;4906
293120;201502;3825;12790;3613;12469;309;1015;2899;10240;3208;11255
293130;201502;3987;11349;3369;10663;164;567;3004;9655;3168;10222
293135;201502;30497;77007;23106;66901;4582;15355;10488;29995;15070;45350
293140;201502;2029;5908;1946;5787;148;531;1567;4555;1715;5086
293150;201502;5515;18339;4865;17069;904;3282;2969;10707;3873;13989
293160;201502;3747;9972;3502;9695;468;932;2707;8005;3175;8937
293170;201502;3307;9974;3044;9586;378;1336;2195;6936;2573;8272
293180;201502;5138;14518;4186;13027;223;887;3363;10322;3586;11209
293190;201502;13758;42034;12983;40894;469;2216;11413;35327;11882;37543
293200;201502;6707;19203;5865;18072;280;1003;4976;15409;5256;16412
293210;201502;4932;14446;4455;13665;346;1229;3427;10486;3773;11715
293220;201502;5108;15201;4492;14174;1138;3735;2125;6804;3263;10539
293230;201502;3829;11908;3531;11460;541;1905;2495;8143;3036;10048
293240;201502;4476;12135;3617;10737;161;516;2792;8277;2953;8793
293245;201502;4310;12386;3937;11831;403;1205;2998;9191;3401;10396
293250;201502;5820;16352;5307;15599;609;1888;3810;11199;4419;13087
293260;201502;4567;13805;3909;12860;318;1138;2987;9922;3305;11060
293270;201502;5620;15175;5287;14825;407;942;4667;13429;5074;14371
293280;201502;5354;15094;4596;14112;294;872;3714;11626;4008;12498
293290;201502;15461;51778;14562;50071;3466;12455;7604;26653;11070;39108
293300;201502;6847;16459;5807;15269;388;943;4691;12594;5079;13537
293305;201502;4755;11852;4115;10996;185;568;3523;9369;3708;9937
293310;201502;2511;6520;2065;5777;178;531;1504;4172;1682;4703
293315;201502;4209;10971;3731;10257;492;1352;2673;7471;3165;8823
293317;201502;2442;7147;2185;6678;194;625;1516;4642;1710;5267
293320;201502;8060;26971;7878;26757;605;2235;6721;22981;7326;25216
293325;201502;1881;5440;1559;4946;207;731;1078;3444;1285;4175
293330;201502;52130;165179;46854;156308;9932;35899;24498;82476;34430;118375
293340;201502;2697;7642;2117;6633;274;943;1411;4343;1685;5286
293345;201502;3312;9933;2917;9395;282;864;2228;7467;2510;8331
293350;201502;6707;18892;6369;18505;366;893;5680;16917;6046;17810
293360;201502;13232;40534;11966;38928;551;1903;10580;34693;11131;36596
310010;201502;1124;3020;828;2562;164;633;361;1034;525;1667
310020;201502;3261;10239;2687;9067;712;2685;495;1475;1207;4160
310030;201502;2336;7412;1954;6745;483;1865;1028;3494;1511;5359
310040;201502;996;2695;840;2490;69;238;647;1915;716;2153
310050;201502;1913;6608;1721;6171;317;1341;853;3002;1170;4343
310060;201502;3209;10410;2844;9938;329;1221;2174;7679;2503;8900
310070;201502;329;934;257;803;29;122;147;418;176;540
310080;201502;710;2156;574;1919;123;513;198;596;321;1109
310090;201502;4655;13927;4042;12849;599;2133;2501;7937;3100;10070
310100;201502;3317;10106;2776;9190;217;882;2140;7045;2357;7927
310110;201502;4941;13986;4220;12881;727;2637;2569;7684;3296;10321
310120;201502;483;1526;423;1432;144;624;185;499;329;1123
310130;201502;425;1303;385;1243;80;311;221;668;301;979
310140;201502;200;656;166;595;63;267;41;116;104;383
310150;201502;4693;14423;4143;13405;887;3237;1930;6175;2817;9412
310160;201502;7276;22679;5988;20424;1700;6433;1983;6739;3683;13172
310163;201502;907;2994;769;2710;206;798;273;940;479;1738
310170;201502;9054;25760;8214;24583;1283;3980;5465;16796;6748;20776
310180;201502;1622;4774;1376;4402;326;1185;647;1997;973;3182
310190;201502;2682;8970;2443;8589;768;2990;446;1617;1214;4607
310200;201502;1852;6072;1546;5462;384;1527;556;1933;940;3460
310205;201502;1096;3223;875;2869;164;547;501;1678;665;2225
310210;201502;2610;7922;2394;7615;273;995;1828;5801;2101;6796
310220;201502;1048;3273;988;3176;200;706;563;1768;763;2474
310230;201502;2605;8271;2190;7365;514;2025;971;3031;1485;5056
310240;201502;1044;3649;898;3387;151;649;471;1853;622;2502
310250;201502;855;2906;827;2856;157;649;512;1673;669;2322
310260;201502;3310;10591;2741;9436;719;2788;941;3086;1660;5874
310270;201502;2476;7249;2155;6779;163;563;1744;5528;1907;6091
310280;201502;2225;6112;1914;5649;373;1396;1038;2890;1411;4286
310285;201502;2076;7417;1940;7211;237;971;1507;5673;1744;6644
310290;201502;1256;3841;1171;3717;312;1132;573;1652;885;2784
310300;201502;1768;6001;1676;5823;436;1713;934;3154;1370;4867
310310;201502;374;1029;267;812;42;131;132;403;174;534
310320;201502;388;1262;327;1139;55;249;157;529;212;778
310330;201502;501;1252;361;1011;28;104;185;467;213;571
310340;201502;8335;25442;7018;23238;1328;4649;3889;13237;5217;17886
310350;201502;13987;38277;10356;32093;2863;9925;2975;8984;5838;18909
310360;201502;423;1297;408;1275;42;166;302;901;344;1067
310370;201502;1440;4955;1368;4841;354;1310;793;2826;1147;4136
310375;201502;1346;3590;890;2792;142;517;359;1082;501;1599
310380;201502;367;1003;278;876;102;353;110;320;212;673
310390;201502;511;1826;446;1688;116;476;78;256;194;732
310400;201502;9602;27944;7481;24189;1928;6883;2251;7303;4179;14186
310410;201502;822;2704;547;2219;153;680;106;417;259;1097
310420;201502;5926;16936;3700;12054;738;2680;604;1740;1342;4420
310430;201502;1456;4894;1164;4301;334;1379;247;871;581;2250
310440;201502;537;1559;443;1411;98;365;192;574;290;939
310445;201502;1259;4076;1049;3693;157;596;631;2208;788;2804
310450;201502;4671;13285;3788;12044;605;2071;2493;8088;3098;10159
310460;201502;1595;4998;1363;4627;418;1568;283;1009;701;2577
310470;201502;3392;8811;2883;8173;246;716;2397;6839;2643;7555
310480;201502;1188;3563;942;3069;209;809;398;1187;607;1996
310490;201502;2905;9622;2534;8914;718;2866;1011;3491;1729;6357
310500;201502;1302;4462;1186;4216;297;1199;502;1730;799;2929
310510;201502;2224;7048;1789;6081;510;1903;366;1166;876;3069
310520;201502;1412;3757;1120;3282;87;271;742;2178;829;2449
310530;201502;887;2749;532;1819;85;323;95;293;180;616
310540;201502;3106;10251;2850;9832;803;2946;1263;4374;2066;7320
310550;201502;1215;3549;992;3173;251;975;440;1277;691;2252
310560;201502;15511;47723;13190;43269;3759;13876;4274;13118;8033;26994
310570;201502;1187;3588;1075;3421;136;481;800;2533;936;3014
310590;201502;4233;12388;3381;10790;587;2126;1365;4133;1952;6259
310600;201502;1387;4677;1271;4428;385;1558;443;1398;828;2956
310610;201502;492;1661;449;1582;106;478;153;471;259;949
310620;201502;171261;528047;141609;470451;34961;131500;54089;170215;89050;301715
310630;201502;3888;12089;3646;11679;479;1806;2621;8240;3100;10046
310640;201502;1330;3986;1051;3493;353;1279;246;742;599;2021
310650;201502;2691;8741;2205;7907;380;1514;1282;4631;1662;6145
310660;201502;1383;4194;1205;3947;156;548;884;2877;1040;3425
310665;201502;1216;3808;1096;3633;172;613;771;2594;943;3207
310670;201502;46701;144787;42083;135013;10901;37742;16499;51241;27400;88983
310680;201502;705;2067;637;1966;142;463;349;1062;491;1525
310690;201502;1375;4509;1116;4036;315;1318;324;1086;639;2404
310700;201502;573;1505;460;1352;129;424;231;648;360;1072
310710;201502;6599;21600;5179;19242;1205;5204;1309;4711;2514;9915
310720;201502;763;2304;688;2170;172;640;330;967;502;1607
310730;201502;9280;29085;8277;27432;1591;5821;5076;16773;6667;22594
310740;201502;4760;15430;3884;13701;1125;4458;948;3189;2073;7647
310750;201502;1537;3850;1206;3432;142;404;893;2569;1035;2973
310760;201502;596;1813;499;1660;114;416;209;682;323;1098
310770;201502;787;2505;616;2246;173;728;301;1048;474;1776
310780;201502;3704;10384;3198;9512;530;1605;1986;5911;2516;7516
310790;201502;1909;6086;1712;5736;445;1567;796;2760;1241;4327
310800;201502;2748;8702;2126;7514;730;2941;264;874;994;3815
310810;201502;1261;3541;1144;3350;216;695;627;1767;843;2462
310820;201502;1346;3902;1023;3314;250;924;319;973;569;1897
310825;201502;2463;8355;1955;7448;154;803;1450;5453;1604;6256
310830;201502;1377;4501;1086;3933;339;1307;292;1009;631;2316
310840;201502;2183;6846;1805;6199;625;2407;511;1643;1136;4050
310850;201502;1518;4571;1276;4252;188;712;917;3042;1105;3754
310855;201502;2877;9221;2498;8633;481;1812;1571;5495;2052;7307
310860;201502;7674;23683;6582;21801;1013;3610;3835;12966;4848;16576
310870;201502;986;2785;800;2479;167;567;417;1277;584;1844
310880;201502;1222;3759;931;3227;176;721;452;1535;628;2256
310890;201502;2632;8234;2089;7292;563;2252;613;2008;1176;4260
310900;201502;3870;12515;3192;11132;841;3338;1171;3809;2012;7147
310910;201502;2073;5923;1408;4675;349;1301;300;932;649;2233
310920;201502;1897;5725;1519;5185;359;1378;709;2433;1068;3811
310925;201502;883;2913;794;2756;309;1185;289;977;598;2162
310930;201502;5881;16947;4731;15215;842;2947;2766;9114;3608;12061
310940;201502;6322;18263;5325;16734;1007;3451;2921;9133;3928;12584
310945;201502;1323;3694;1091;3376;186;686;684;2031;870;2717
310950;201502;1961;6291;1489;5258;420;1707;410;1305;830;3012
310960;201502;410;1347;338;1215;106;412;110;392;216;804
310970;201502;1455;4930;1054;3956;311;1312;131;410;442;1722
310980;201502;467;1186;308;899;43;157;137;347;180;504
310990;201502;1154;3864;984;3513;244;988;313;1029;557;2017
311000;201502;3641;12432;3237;11598;915;3765;1137;3807;2052;7572
311010;201502;757;2507;707;2426;216;797;336;1117;552;1914
311020;201502;937;2845;755;2523;178;668;305;956;483;1624
311030;201502;1674;4743;1219;3872;310;1124;421;1197;731;2321
311040;201502;491;1658;432;1503;97;355;99;330;196;685
311050;201502;2229;7100;1934;6599;535;2021;841;2871;1376;4892
311060;201502;2089;6338;1602;5298;356;1326;398;1214;754;2540
311070;201502;1452;5101;1278;4773;340;1469;491;1807;831;3276
311080;201502;884;2639;800;2499;116;404;528;1621;644;2025
311090;201502;1632;6038;1390;5554;466;2118;249;951;715;3069
311100;201502;2152;7373;1826;6694;736;2923;392;1396;1128;4319
311110;201502;3924;9245;2700;7521;436;1320;1448;4002;1884;5322
311115;201502;1186;3545;1012;3282;113;475;670;2147;783;2622
311120;201502;7881;22287;6145;19215;1584;5533;1621;4674;3205;10207
311130;201502;2061;6549;1739;6102;456;1929;775;2573;1231;4502
311140;201502;1353;3691;1112;3388;126;453;793;2370;919;2823
311150;201502;1943;6596;1795;6356;345;1327;1056;3760;1401;5087
311160;201502;4810;16236;4077;14942;1476;5882;1189;4280;2665;10162
311170;201502;776;2375;620;2088;84;296;317;1116;401;1412
311180;201502;1454;4089;1106;3422;328;1096;262;741;590;1837
311190;201502;1024;3086;874;2794;190;722;316;898;506;1620
311200;201502;2149;6590;1789;5856;558;2030;402;1169;960;3199
311205;201502;1067;3512;932;3246;201;813;405;1405;606;2218
311210;201502;915;2993;852;2899;156;525;597;2099;753;2624
311220;201502;887;2817;720;2459;178;653;249;835;427;1488
311230;201502;8277;25644;6845;22998;1315;4787;3192;11038;4507;15825
311240;201502;1167;3552;953;3212;259;987;332;1087;591;2074
311250;201502;958;3129;853;2975;251;1000;281;825;532;1825
311260;201502;2695;7269;2013;6118;546;1838;661;1941;1207;3779
311265;201502;1322;3631;1040;3186;171;624;621;1867;792;2491
311270;201502;3361;10830;2958;10286;446;1933;2030;6840;2476;8773
311280;201502;1305;3596;909;2833;196;703;276;812;472;1515
311290;201502;2108;7039;1971;6754;422;1456;1147;4007;1569;5463
311300;201502;4565;15277;4116;14526;556;2248;2850;10117;3406;12365
311310;201502;523;1822;482;1748;100;435;208;702;308;1137
311320;201502;4097;13662;3631;12660;826;3341;1298;4281;2124;7622
311330;201502;4912;14777;4236;13700;1329;4783;1678;5370;3007;10153
311340;201502;12219;38821;10858;36272;3276;11895;3359;11119;6635;23014
311350;201502;2233;6566;1820;5797;370;1400;835;2478;1205;3878
311360;201502;1208;3354;932;3009;403;1383;218;705;621;2088
311370;201502;3842;11650;3302;10749;783;3130;1446;4249;2229;7379
311380;201502;448;1429;374;1294;109;442;126;413;235;855
311390;201502;1816;6713;1688;6514;725;3193;551;1994;1276;5187
311400;201502;1456;4673;1267;4326;282;1135;572;1784;854;2919
311410;201502;1799;6297;1638;6083;465;1880;893;3371;1358;5251
311420;201502;2008;6535;1495;5333;393;1531;302;855;695;2386
311430;201502;3952;11981;2776;9400;603;2261;516;1697;1119;3958
311440;201502;2254;7403;1728;6398;621;2682;342;1215;963;3897
311450;201502;1966;6876;1689;6230;480;1949;388;1315;868;3264
311455;201502;1290;3445;1064;3093;234;762;582;1597;816;2359
311460;201502;681;2217;529;1907;119;532;131;438;250;970
311470;201502;549;1751;440;1523;112;487;137;424;249;911
311480;201502;763;2038;713;1973;190;509;395;1083;585;1592
311490;201502;255;978;238;933;84;349;84;315;168;664
311500;201502;462;1358;368;1182;98;347;162;516;260;863
311510;201502;3104;9613;2518;8495;903;3580;597;1811;1500;5391
311520;201502;635;2128;590;2034;219;819;213;700;432;1519
311530;201502;11910;30929;8325;24933;2019;7289;2419;6975;4438;14264
311535;201502;761;2285;548;1861;125;505;91;284;216;789
311540;201502;636;2246;606;2203;199;766;322;1151;521;1917
311545;201502;2080;6517;1911;6307;218;869;1419;4646;1637;5515
311547;201502;1542;4324;1292;3929;107;351;867;2652;974;3003
311550;201502;2971;9549;2530;8667;603;2381;847;2799;1450;5180
311560;201502;259;661;217;609;35;109;128;344;163;453
311570;201502;2176;5451;1726;4888;111;321;1381;4007;1492;4328
311580;201502;2330;4919;1828;4337;548;1223;989;2473;1537;3696
311590;201502;426;1350;371;1276;112;461;114;385;226;846
311600;201502;1185;3594;1021;3377;205;675;643;2199;848;2874
311610;201502;3107;10985;2830;10515;934;3453;1269;4987;2203;8440
311615;201502;2858;9187;2441;8489;267;1113;1749;6062;2016;7175
311620;201502;429;1364;386;1299;90;337;219;728;309;1065
311630;201502;1408;4158;1191;3780;262;816;668;2160;930;2976
311640;201502;842;2640;700;2409;135;525;409;1361;544;1886
311650;201502;2272;6701;1920;6123;251;864;1156;3788;1407;4652
311660;201502;2403;8046;1981;7114;441;1766;290;858;731;2624
311670;201502;1518;4589;1277;4178;437;1577;489;1585;926;3162
311680;201502;2090;6710;1801;6265;397;1463;1043;3694;1440;5157
311690;201502;537;1390;433;1267;53;171;326;952;379;1123
311700;201502;2212;6109;1875;5644;134;559;1506;4404;1640;4963
311710;201502;1682;5088;1255;4303;470;1807;348;1146;818;2953
311720;201502;397;1325;355;1239;65;264;189;635;254;899
311730;201502;5498;14022;3267;10060;926;3307;1031;2688;1957;5995
311740;201502;930;2639;796;2478;312;954;402;1303;714;2257
311750;201502;3835;12822;3436;12210;605;2464;2018;7107;2623;9571
311760;201502;796;2689;741;2576;198;813;324;1006;522;1819
311770;201502;2425;7654;1983;6840;505;1979;602;1964;1107;3943
311780;201502;1096;3987;927;3583;296;1309;215;772;511;2081
311783;201502;1953;6394;1656;5818;100;470;1238;4332;1338;4802
311787;201502;564;1954;413;1507;69;276;102;315;171;591
311790;201502;1431;4274;1049;3523;265;988;281;892;546;1880
311800;201502;4129;13924;3163;11276;649;2462;201;581;850;3043
311810;201502;1045;3521;993;3433;42;204;836;2868;878;3072
311820;201502;644;2065;530;1783;140;546;264;823;404;1369
311830;201502;7790;26563;6565;23587;2318;8998;934;3060;3252;12058
311840;201502;3178;9471;2772;8892;803;2944;1264;3910;2067;6854
311850;201502;302;894;259;825;69;243;118;368;187;611
311860;201502;49969;150803;43059;138357;10407;37076;19524;60560;29931;97636
311870;201502;2263;6656;1737;5646;373;1444;575;1671;948;3115
311880;201502;6864;20118;6133;19253;937;2866;4279;13992;5216;16858
311890;201502;1449;4437;1184;3896;297;1103;462;1450;759;2553
311900;201502;768;2404;690;2301;121;398;448;1578;569;1976
311910;201502;4430;13167;3699;12132;955;3442;1606;5263;2561;8705
311920;201502;1921;6350;1689;5960;178;714;1156;4090;1334;4804
311930;201502;3800;11061;3257;10210;1174;3912;1042;3212;2216;7124
311940;201502;12176;37090;10145;32980;2987;10665;2239;6839;5226;17504
311950;201502;2288;6720;1914;6221;162;580;1412;4568;1574;5148
311960;201502;358;1107;320;1030;69;283;163;451;232;734
311970;201502;365;1274;312;1169;79;350;68;239;147;589
311980;201502;659;1828;453;1465;75;269;191;620;266;889
311990;201502;446;1313;369;1189;137;484;125;368;262;852
311995;201502;1144;3455;716;2423;106;411;147;416;253;827
312000;201502;645;1983;593;1902;89;324;371;1180;460;1504
312010;201502;960;3136;836;2867;156;615;381;1271;537;1886
312015;201502;1493;4705;1294;4367;167;683;821;2741;988;3424
312020;201502;843;2635;726;2453;145;572;398;1359;543;1931
312030;201502;1767;5277;1607;5081;140;529;1324;4153;1464;4682
312040;201502;716;2696;621;2430;174;765;132;484;306;1249
312050;201502;1465;5065;1293;4736;383;1568;290;1021;673;2589
312060;201502;747;2273;657;2147;299;1042;195;570;494;1612
312070;201502;1016;3126;672;2377;162;623;236;823;398;1446
312080;201502;2595;7303;2047;6440;395;1498;1013;2945;1408;4443
312083;201502;965;2757;828;2559;140;504;515;1553;655;2057
312087;201502;2187;6753;1930;6382;270;959;1377;4618;1647;5577
312090;201502;8910;28110;7926;26457;2306;8461;3397;11081;5703;19542
312100;201502;1372;4605;1174;4298;256;1046;608;2246;864;3292
312110;201502;1123;3940;990;3665;345;1455;181;582;526;2037
312120;201502;730;2465;642;2280;160;672;205;628;365;1300
312125;201502;1148;3637;1017;3394;237;836;516;1769;753;2605
312130;201502;769;2269;614;1965;101;377;253;769;354;1146
312140;201502;986;3109;801;2665;156;590;281;808;437;1398
312150;201502;575;1641;486;1450;39;135;328;949;367;1084
312160;201502;7515;25700;6787;24201;1936;7605;2502;8814;4438;16419
312170;201502;965;2841;862;2648;104;334;526;1627;630;1961
312180;201502;1404;4294;1241;3992;299;1023;516;1604;815;2627
312190;201502;611;1955;462;1660;175;706;87;294;262;1000
312200;201502;4858;14201;4217;13234;448;1514;3065;9637;3513;11151
312210;201502;1048;2884;818;2527;217;753;364;1062;581;1815
312220;201502;1814;6039;1635;5832;150;568;1358;4970;1508;5538
312230;201502;13154;41109;10371;35729;3871;14738;1895;6352;5766;21090
312235;201502;1751;5054;1462;4627;156;615;989;3111;1145;3726
312240;201502;930;3097;771;2775;193;774;258;885;451;1659
312245;201502;2266;6707;1969;6315;117;367;1631;5284;1748;5651
312247;201502;817;2493;656;2218;166;627;328;1124;494;1751
312250;201502;1186;3345;952;2952;185;670;432;1292;617;1962
312260;201502;933;2955;785;2737;137;554;495;1707;632;2261
312270;201502;675;2044;559;1827;99;423;246;700;345;1123
312280;201502;381;1308;342;1221;132;508;48;155;180;663
312290;201502;733;2444;678;2364;230;936;204;683;434;1619
312300;201502;938;3120;755;2692;176;705;99;273;275;978
312310;201502;920;3469;849;3302;241;1029;339;1275;580;2304
312320;201502;2183;6226;1712;5290;426;1452;399;997;825;2449
312330;201502;995;2977;841;2751;154;596;576;1845;730;2441
312340;201502;311;810;275;763;35;137;217;564;252;701
312350;201502;334;851;307;819;29;89;259;674;288;763
312352;201502;1672;5405;1530;5208;426;1462;907;3217;1333;4679
312360;201502;2904;9503;2437;8564;631;2498;721;2488;1352;4986
312370;201502;1711;5499;1564;5272;570;2153;522;1638;1092;3791
312380;201502;1861;5383;1664;5094;143;466;1326;4139;1469;4605
312385;201502;1273;3835;1114;3572;131;566;785;2407;916;2973
312390;201502;2100;6904;1726;6091;521;1944;316;1025;837;2969
312400;201502;3298;10660;2816;9737;1007;3637;923;3315;1930;6952
312410;201502;10182;33628;9129;31639;2364;9060;3624;12300;5988;21360
312420;201502;3957;12261;3750;12017;539;1742;2765;9083;3304;10825
312430;201502;7302;22492;6695;21523;1101;3594;4512;14768;5613;18362
312440;201502;678;2154;603;2026;129;476;318;1110;447;1586
312450;201502;1098;3756;904;3343;356;1388;317;1158;673;2546
312460;201502;374;1139;334;1093;97;350;161;519;258;869
312470;201502;697;1916;449;1432;102;373;132;397;234;770
312480;201502;1245;3492;992;3205;280;1013;510;1571;790;2584
312490;201502;2064;5494;1645;4892;249;849;963;2755;1212;3604
312500;201502;666;2107;601;2011;115;485;329;1070;444;1555
312510;201502;2809;8429;2245;7252;406;1533;1077;3238;1483;4771
312520;201502;289;996;235;891;66;265;82;318;148;583
312530;201502;594;1833;537;1749;89;374;338;1039;427;1413
312540;201502;1469;4614;1155;3987;258;965;581;1985;839;2950
312550;201502;662;2094;586;1931;95;346;337;1072;432;1418
312560;201502;2031;5489;1729;5102;141;481;1392;4092;1533;4573
312570;201502;2596;7702;2185;7001;613;2100;690;2139;1303;4239
312580;201502;516;1746;442;1587;95;426;169;569;264;995
312590;201502;1798;5991;1569;5520;398;1628;585;1873;983;3501
312595;201502;2067;6964;1846;6458;494;1864;872;2992;1366;4856
312600;201502;681;2378;607;2227;116;539;314;1056;430;1595
312610;201502;7168;20532;5480;17564;1396;5044;1404;4214;2800;9258
312620;201502;2000;5917;1583;5349;123;453;1260;4380;1383;4833
312630;201502;360;1163;322;1090;71;281;178;590;249;871
312640;201502;554;1789;448;1573;93;391;170;535;263;926
312650;201502;2151;6417;1582;5297;167;638;918;3058;1085;3696
312660;201502;1368;3688;1123;3339;124;431;770;2256;894;2687
312670;201502;5851;17802;5090;16742;1191;4448;2560;8261;3751;12709
312675;201502;1357;4339;1146;3913;168;653;681;2295;849;2948
312680;201502;1468;4620;1311;4387;167;638;917;3025;1084;3663
312690;201502;2184;5867;1763;5290;342;1176;997;2870;1339;4046
312695;201502;817;3005;787;2965;143;546;556;2144;699;2690
312700;201502;1938;5746;1522;4925;227;836;761;2409;988;3245
312705;201502;1350;3853;1141;3523;133;452;795;2444;928;2896
312707;201502;1742;5358;1383;4680;209;834;717;2337;926;3171
312710;201502;6886;18298;4638;14433;1283;4591;1014;2857;2297;7448
312720;201502;752;2563;658;2359;163;653;233;774;396;1427
312730;201502;1952;4764;1413;4133;203;683;818;2402;1021;3085
312733;201502;1676;4511;1280;3780;97;384;875;2465;972;2849
312735;201502;862;2478;764;2348;210;727;410;1217;620;1944
312737;201502;904;2282;654;1931;211;622;279;848;490;1470
312738;201502;544;1667;405;1379;106;412;141;453;247;865
312740;201502;469;1321;315;1131;95;377;84;306;179;683
312750;201502;1244;4460;1193;4362;276;1192;595;2102;871;3294
312760;201502;2164;6939;1697;6060;441;1767;386;1374;827;3141
312770;201502;40704;113432;32554;100072;8793;29662;10009;29992;18802;59654
312780;201502;2738;9634;2456;9167;466;1903;1385;5319;1851;7222
312790;201502;338;867;197;618;51;195;48;113;99;308
312800;201502;5043;16752;4233;15129;1321;5105;1271;4556;2592;9661
312810;201502;2151;6611;1542;5495;476;1893;317;1043;793;2936
312820;201502;2041;5949;1845;5638;174;656;1242;3692;1416;4348
312825;201502;1353;3705;1189;3506;91;280;966;2867;1057;3147
312830;201502;2720;8577;1917;6932;485;1937;365;1293;850;3230
312840;201502;1186;3855;1008;3526;151;669;536;1801;687;2470
312850;201502;648;2109;536;1889;108;461;198;668;306;1129
312860;201502;1112;3296;881;2890;235;921;267;764;502;1685
312870;201502;5193;16261;3909;13730;896;3580;1074;3656;1970;7236
312880;201502;1288;3873;1112;3581;172;631;637;2062;809;2693
312890;201502;1556;4677;1088;3697;349;1327;340;1107;689;2434
312900;201502;1236;3738;1106;3563;211;714;750;2468;961;3182
312910;201502;1416;3092;1003;2534;190;581;539;1235;729;1816
312920;201502;841;2714;729;2548;195;773;380;1298;575;2071
312930;201502;2241;6525;1947;6105;444;1456;991;3199;1435;4655
312940;201502;893;2951;787;2776;230;963;226;748;456;1711
312950;201502;3306;9222;2593;8176;868;2965;850;2655;1718;5620
312960;201502;1967;5861;1763;5598;279;869;1279;4179;1558;5048
312965;201502;1765;5666;1498;5179;266;1015;869;3053;1135;4068
312970;201502;983;3345;821;3091;295;1291;152;508;447;1799
312980;201502;16784;57159;15792;55021;5096;19552;6270;20825;11366;40377
312990;201502;427;1302;326;1131;113;440;102;349;215;789
313000;201502;532;1764;432;1566;118;538;159;515;277;1053
313005;201502;2571;8327;2285;7846;412;1487;1388;4806;1800;6293
313010;201502;3714;11928;3186;11050;889;3424;1384;4681;2273;8105
313020;201502;940;3098;807;2828;226;915;240;719;466;1634
313030;201502;1458;3971;1097;3485;255;981;497;1485;752;2466
313040;201502;859;2927;735;2597;138;568;284;936;422;1504
313050;201502;1793;5764;1458;5281;446;1796;578;2017;1024;3813
313055;201502;1590;5203;1455;5016;134;499;1110;3880;1244;4379
313060;201502;593;1958;478;1667;171;629;63;211;234;840
313065;201502;1928;6300;1670;5894;283;1137;1191;4184;1474;5321
313070;201502;1143;3330;932;2953;224;833;436;1277;660;2110
313080;201502;471;1470;385;1304;98;406;126;343;224;749
313090;201502;5343;15490;4658;14437;707;2323;3122;9820;3829;12143
313100;201502;1084;3399;993;3248;103;360;769;2526;872;2886
313110;201502;1720;4932;1308;4157;286;1057;501;1445;787;2502
313115;201502;2466;8462;2360;8260;598;2419;1192;3894;1790;6313
313120;201502;3578;9771;3075;9108;633;2030;2030;5944;2663;7974
313130;201502;23272;70875;20041;64243;5068;17941;7375;22282;12443;40223
313140;201502;691;1806;531;1566;35;130;364;1056;399;1186
313150;201502;1442;4589;1253;4245;512;1857;334;1126;846;2983
313160;201502;1046;3154;928;2947;154;584;575;1769;729;2353
313170;201502;7658;26986;6586;24401;1974;7869;1350;4900;3324;12769
313180;201502;2438;6654;1936;5947;544;1855;707;2091;1251;3946
313190;201502;2968;10561;2515;9331;577;2384;813;2835;1390;5219
313200;201502;1293;4223;1147;3967;162;653;802;2743;964;3396
313210;201502;4443;13724;3714;12735;830;3365;1951;6404;2781;9769
313220;201502;1315;3972;965;3214;270;1011;248;717;518;1728
313230;201502;2311;8311;2135;8052;329;1315;1464;5567;1793;6882
313240;201502;7640;24156;6248;21734;1522;6056;2483;8391;4005;14447
313250;201502;7140;22580;6376;21340;1037;3631;3864;13164;4901;16795
313260;201502;600;1811;472;1558;84;322;127;383;211;705
313270;201502;5432;16043;4706;14930;709;2432;3105;9891;3814;12323
313280;201502;438;1448;333;1208;56;246;88;273;144;519
313290;201502;927;3283;766;2994;232;1020;198;701;430;1721
313300;201502;1877;6336;1567;5579;468;1830;260;815;728;2645
313310;201502;1115;3873;989;3610;262;1077;186;608;448;1685
313320;201502;2413;7112;1895;6267;366;1345;838;2778;1204;4123
313330;201502;3794;12173;3207;11115;615;2476;1739;5928;2354;8404
313340;201502;1988;4861;1582;4279;316;866;888;2384;1204;3250
313350;201502;3242;10016;2535;8531;578;2182;511;1545;1089;3727
313360;201502;1210;3562;914;3059;266;1056;426;1308;692;2364
313370;201502;1211;4089;1132;3881;173;735;603;1915;776;2650
313375;201502;2173;5692;1468;4650;303;1193;517;1588;820;2781
313380;201502;4887;15582;4051;13849;1082;4157;1357;4360;2439;8517
313390;201502;891;3177;853;3127;99;429;606;2205;705;2634
313400;201502;3577;10166;3253;9797;288;861;2703;8296;2991;9157
313410;201502;1263;3599;1060;3319;219;768;632;1958;851;2726
313420;201502;20263;48345;12519;35251;2546;8093;2674;7261;5220;15354
313430;201502;1071;3415;871;2991;192;793;362;1147;554;1940
313440;201502;6152;14093;4226;11839;376;1167;2909;8147;3285;9314
313450;201502;680;2010;546;1741;123;485;191;551;314;1036
313460;201502;2281;7964;2031;7552;603;2518;610;2153;1213;4671
313470;201502;3241;9229;3035;9003;267;688;2605;7908;2872;8596
313480;201502;1102;3172;847;2734;140;525;369;1121;509;1646
313490;201502;1499;4615;953;3682;346;1440;143;538;489;1978
313500;201502;390;1233;360;1172;70;276;182;554;252;830
313505;201502;8816;26425;8204;25722;351;671;7579;24460;7930;25131
313507;201502;1371;3868;1203;3638;191;668;777;2365;968;3033
313510;201502;15365;44411;13453;41792;2191;6964;8530;27290;10721;34254
313520;201502;14967;45612;12461;41384;1714;6631;7953;26130;9667;32761
313530;201502;575;1889;494;1745;73;306;198;651;271;957
313535;201502;2492;7454;2195;6950;210;727;1593;5009;1803;5736
313540;201502;1059;3351;828;2766;237;851;200;614;437;1465
313545;201502;1289;4784;1180;4551;171;852;756;2761;927;3613
313550;201502;1838;5986;1641;5595;415;1512;833;2768;1248;4280
313560;201502;2178;5342;1857;4983;239;581;1424;3969;1663;4550
313570;201502;814;2928;714;2742;254;1055;256;934;510;1989
313580;201502;5926;16826;4927;15469;805;2770;3256;10314;4061;13084
313590;201502;1032;2973;813;2714;389;1406;243;774;632;2180
313600;201502;3984;12057;3462;11244;570;2043;2148;7048;2718;9091
313610;201502;1024;3185;880;2896;192;693;415;1344;607;2037
313620;201502;5910;18651;5181;17348;1554;5615;1847;6079;3401;11694
313630;201502;8019;23211;6298;20621;1365;5062;2769;9403;4134;14465
313640;201502;826;2487;652;2220;205;777;212;699;417;1476
313650;201502;2112;6953;1866;6561;195;793;1434;5043;1629;5836
313652;201502;1002;3604;920;3445;155;630;561;2098;716;2728
313655;201502;930;3053;775;2789;134;587;463;1607;597;2194
313657;201502;1276;3961;1104;3705;134;614;796;2453;930;3067
313660;201502;853;2849;776;2713;170;712;380;1242;550;1954
313665;201502;3261;10769;3025;10272;673;2607;1468;4814;2141;7421
313670;201502;50126;141620;34549;115167;9402;34892;10287;33402;19689;68294
313680;201502;1089;3305;950;3086;131;450;661;2155;792;2605
313690;201502;885;3181;787;2967;218;865;292;1110;510;1975
313695;201502;1349;4480;1183;4188;130;518;818;2934;948;3452
313700;201502;3809;12692;3216;11910;552;2117;2167;8227;2719;10344
313710;201502;1224;3347;983;2995;240;797;476;1413;716;2210
313720;201502;5160;16848;4300;15081;981;3877;1398;4496;2379;8373
313730;201502;1333;3539;1000;3129;184;658;561;1736;745;2394
313740;201502;2115;7558;1778;6742;594;2569;221;761;815;3330
313750;201502;2396;7288;2030;6605;568;2032;650;1949;1218;3981
313753;201502;1801;5359;1465;4789;402;1473;577;1862;979;3335
313760;201502;4447;14402;3696;12906;1080;4154;1052;3437;2132;7591
313770;201502;3447;11487;3162;10965;1071;4006;1099;3642;2170;7648
313780;201502;3506;9799;2786;8735;515;1971;1361;4135;1876;6106
313790;201502;505;1740;487;1715;106;374;278;1019;384;1393
313800;201502;1180;3310;1027;3071;132;450;682;2038;814;2488
313810;201502;1470;4361;1419;4291;74;228;1247;3821;1321;4049
313820;201502;12244;33392;10131;30076;1844;6405;5130;14961;6974;21366
313830;201502;419;1410;358;1282;98;398;110;393;208;791
313835;201502;901;3038;851;2965;175;677;509;1727;684;2404
313840;201502;7729;22235;6076;19457;1597;5776;1849;5735;3446;11511
313850;201502;1229;3375;1090;3147;242;832;568;1535;810;2367
313860;201502;2791;8501;2211;7281;580;2140;504;1551;1084;3691
313862;201502;1170;2936;770;2271;141;411;300;909;441;1320
313865;201502;2252;6994;2043;6671;259;963;1467;4767;1726;5730
313867;201502;1105;3754;949;3443;327;1279;321;1186;648;2465
313868;201502;1588;5575;1411;5209;149;675;964;3540;1113;4215
313870;201502;839;2688;768;2583;240;950;255;750;495;1700
313880;201502;1655;5124;1475;4909;271;1128;932;2926;1203;4054
313890;201502;1834;5066;1553;4700;241;711;1034;3238;1275;3949
313900;201502;4073;15045;3766;14336;1233;5325;1170;4261;2403;9586
313910;201502;767;2608;659;2394;248;985;103;345;351;1330
313920;201502;3461;11337;3021;10579;476;1761;1858;6696;2334;8457
313925;201502;1916;5142;1396;4162;102;341;907;2698;1009;3039
313930;201502;5139;17110;4338;15671;763;3000;2445;9035;3208;12035
313940;201502;8120;27473;6882;25530;2276;9256;2472;9498;4748;18754
313950;201502;4152;12125;3365;10854;991;3709;1326;3988;2317;7697
313960;201502;5732;14889;4262;12917;1340;4532;1211;3445;2551;7977
313970;201502;1417;4052;1203;3807;159;557;824;2713;983;3270
313980;201502;1225;3888;980;3455;285;1170;362;1258;647;2428
313990;201502;1876;7026;1637;6480;539;2351;390;1404;929;3755
314000;201502;7500;24753;6884;23605;1487;6095;4067;13408;5554;19503
314010;201502;1092;3139;907;2908;134;523;569;1767;703;2290
314015;201502;1237;4502;1103;4231;344;1417;372;1401;716;2818
314020;201502;521;1618;405;1374;104;406;99;307;203;713
314030;201502;865;2801;692;2410;119;463;263;909;382;1372
314040;201502;680;1945;577;1766;260;821;206;639;466;1460
314050;201502;1786;5619;1429;4890;352;1383;465;1444;817;2827
314053;201502;1481;4834;1352;4680;187;626;962;3492;1149;4118
314055;201502;2105;6441;1909;6151;110;434;1500;4897;1610;5331
314060;201502;1130;3515;915;3160;86;362;588;2017;674;2379
314070;201502;3793;11774;2919;10103;800;2995;696;2296;1496;5291
314080;201502;1948;6001;1332;4596;271;1062;306;931;577;1993
314085;201502;1945;6639;1707;6309;507;2063;647;2377;1154;4440
314090;201502;3379;11530;3000;10808;902;3590;1096;4020;1998;7610
314100;201502;3339;8909;2855;8241;259;696;2320;6876;2579;7572
314110;201502;4213;13474;3706;12455;808;3200;1470;4511;2278;7711
314120;201502;990;2453;536;1707;142;518;143;439;285;957
314130;201502;715;2071;384;1324;64;240;73;251;137;491
314140;201502;4970;15528;4237;14135;909;3281;1908;6355;2817;9636
314150;201502;1633;4461;1342;3985;241;819;673;1962;914;2781
314160;201502;2499;6593;1957;5877;109;346;1561;4898;1670;5244
314170;201502;1089;3297;891;2858;133;513;482;1484;615;1997
314180;201502;5817;18385;5054;17260;1276;4804;2355;8189;3631;12993
314190;201502;729;2129;587;1908;138;550;256;772;394;1322
314200;201502;2963;9412;2607;8776;330;1331;1756;5797;2086;7128
314210;201502;1915;5794;1715;5427;244;911;1071;3244;1315;4155
314220;201502;1703;5411;1360;4730;431;1701;317;960;748;2661
314225;201502;1295;3832;1152;3638;79;245;994;3196;1073;3441
314230;201502;647;2183;588;2073;160;629;239;814;399;1443
314240;201502;1134;3534;975;3298;153;489;658;2345;811;2834
314250;201502;547;1650;418;1379;91;346;146;431;237;777
314260;201502;1098;3926;1005;3728;290;1179;376;1356;666;2535
314270;201502;2817;9418;2497;8852;273;1098;1737;6229;2010;7327
314280;201502;3149;8847;2195;7028;560;2095;675;1859;1235;3954
314290;201502;4943;13836;4271;12782;1076;3509;2465;7252;3541;10761
314300;201502;1633;5493;1444;5074;419;1585;531;1781;950;3366
314310;201502;5440;16590;4655;15068;1494;5286;1416;4367;2910;9653
314315;201502;894;3474;827;3345;131;624;511;2083;642;2707
314320;201502;3087;8642;2306;7625;659;2437;1133;3789;1792;6226
314330;201502;51750;160224;46561;151928;13126;47059;19175;61727;32301;108786
314340;201502;2673;7429;1558;5188;385;1420;130;287;515;1707
314345;201502;1242;4227;1116;4033;308;1164;620;2260;928;3424
314350;201502;1397;4048;1119;3612;434;1533;310;973;744;2506
314360;201502;697;2198;465;1671;115;500;116;392;231;892
314370;201502;530;1852;487;1782;156;615;250;907;406;1522
314380;201502;1224;3671;869;2993;278;1037;184;634;462;1671
314390;201502;14638;42549;11228;36180;2929;10411;2978;8930;5907;19341
314400;201502;4747;13793;3962;12700;1365;4553;1713;5701;3078;10254
314410;201502;2576;8201;2192;7428;627;2476;760;2399;1387;4875
314420;201502;748;2187;605;1992;60;271;441;1417;501;1688
314430;201502;6848;20521;6008;18918;1781;6134;1844;5859;3625;11993
314435;201502;1337;4293;1188;4039;150;644;766;2554;916;3198
314437;201502;1120;2934;968;2712;42;117;819;2298;861;2415
314440;201502;660;1917;500;1682;181;680;89;268;270;948
314450;201502;1580;4606;1343;4279;386;1449;651;1938;1037;3387
314460;201502;4220;14509;3624;13201;1010;4093;708;2484;1718;6577
314465;201502;2333;7382;2148;7081;156;658;1652;5344;1808;6002
314467;201502;1111;3123;933;2807;107;321;631;1931;738;2252
314470;201502;2396;7726;1927;6693;483;1945;490;1482;973;3427
314480;201502;6164;20587;4318;15700;735;2924;469;1457;1204;4381
314490;201502;982;2895;785;2504;215;757;310;945;525;1702
314500;201502;2103;5877;1536;4902;423;1458;605;1844;1028;3302
314505;201502;1813;5551;1708;5387;326;1133;1059;3368;1385;4501
314510;201502;1918;5291;1308;4418;446;1685;325;1051;771;2736
314520;201502;3304;12113;2625;10458;666;3017;384;1277;1050;4294
314530;201502;6531;23342;6175;22762;1172;4389;3756;14281;4928;18670
314535;201502;2764;7771;2394;7264;234;814;1846;5579;2080;6393
314537;201502;1234;3856;973;3397;166;691;534;1831;700;2522
314540;201502;410;1272;354;1152;89;339;123;361;212;700
314545;201502;1343;4183;1165;3917;199;779;737;2446;936;3225
314550;201502;625;1739;472;1534;98;415;190;557;288;972
314560;201502;4909;17166;4255;15597;913;3751;1189;4163;2102;7914
314570;201502;292;887;233;758;67;231;104;328;171;559
314580;201502;508;1744;411;1522;110;478;83;283;193;761
314585;201502;839;2755;602;2242;148;636;167;605;315;1241
314587;201502;1843;5777;1631;5401;344;1100;810;2791;1154;3891
314590;201502;3422;11646;2412;8922;438;1796;294;955;732;2751
314600;201502;1938;6574;1573;5901;563;2356;317;1128;880;3484
314610;201502;7168;24910;6585;23601;1724;7024;2573;8660;4297;15684
314620;201502;1746;5078;1529;4802;178;505;1180;3820;1358;4325
314625;201502;1487;5090;1448;5042;146;526;1192;4182;1338;4708
314630;201502;4911;14627;4264;13616;403;1518;3170;10122;3573;11640
314640;201502;586;1632;460;1419;119;414;138;364;257;778
314650;201502;1175;3332;858;2785;170;657;336;988;506;1645
314655;201502;1624;4864;1262;4194;256;900;635;2129;891;3029
314660;201502;254;699;195;588;19;65;103;297;122;362
314670;201502;1562;4302;1240;3740;192;660;734;2208;926;2868
314675;201502;1826;5603;1572;5160;165;643;1064;3476;1229;4119
314690;201502;2526;7991;2099;7262;575;2340;603;1915;1178;4255
314700;201502;8545;30386;6706;26317;2298;10103;1316;5104;3614;15207
314710;201502;8781;27146;6180;21534;1342;5270;957;3028;2299;8298
314720;201502;2311;7648;1959;6930;491;1983;809;2804;1300;4787
314730;201502;2355;7029;1902;6383;582;2196;615;1972;1197;4168
314740;201502;2902;9422;2568;8814;641;2502;1038;3374;1679;5876
314750;201502;325;1039;279;938;45;179;139;446;184;625
314760;201502;1712;5806;1274;4716;262;1158;290;897;552;2055
314770;201502;1201;3770;744;2530;85;360;125;322;210;682
314780;201502;295;787;213;680;61;233;93;289;154;522
314790;201502;12228;36346;9144;31106;3712;14518;1390;4191;5102;18709
314795;201502;1617;4763;1376;4377;144;590;1027;3140;1171;3730
314800;201502;12252;36001;9120;29825;2807;10025;1449;4537;4256;14562
314810;201502;12975;38119;10159;33241;3099;11322;2354;7679;5453;19001
314820;201502;1013;2776;685;2266;197;730;230;715;427;1445
314830;201502;1755;5822;1500;5395;495;1965;603;2187;1098;4152
314840;201502;968;3578;797;3314;192;952;426;1725;618;2677
314850;201502;1951;5756;1595;5110;242;973;986;3041;1228;4014
314860;201502;3243;11000;2946;10510;595;2364;1770;6339;2365;8703
314870;201502;5480;17702;4872;16907;623;2475;3571;12522;4194;14997
314875;201502;1783;6047;1720;5956;249;838;1383;4870;1632;5708
314880;201502;838;2349;730;2207;57;175;545;1696;602;1871
314890;201502;624;1885;437;1491;99;408;144;432;243;840
314900;201502;464;1438;374;1291;96;349;171;590;267;939
314910;201502;1563;5352;1322;4926;467;1959;370;1264;837;3223
314915;201502;2584;8107;2261;7635;207;838;1739;5810;1946;6648
314920;201502;581;1641;421;1399;71;283;216;665;287;948
314930;201502;4964;16825;4395;15628;1322;5143;1094;3813;2416;8956
314940;201502;403;1188;373;1136;86;295;204;581;290;876
314950;201502;335;1075;269;960;64;248;67;243;131;491
314960;201502;786;2485;611;2140;180;695;154;493;334;1188
314970;201502;553;1900;478;1767;130;554;134;477;264;1031
314980;201502;1763;5486;1513;5061;512;1922;193;577;705;2499
314990;201502;2724;8629;2127;7324;641;2549;404;1171;1045;3720
314995;201502;1613;4957;1440;4715;168;674;1018;3276;1186;3950
315000;201502;1054;3113;871;2811;149;573;518;1635;667;2208
315010;201502;459;1458;369;1268;103;423;128;383;231;806
315015;201502;1990;6130;1780;5876;240;811;1314;4510;1554;5321
315020;201502;793;2495;606;2081;110;425;279;930;389;1355
315030;201502;741;2229;605;1981;194;708;156;490;350;1198
315040;201502;880;2787;832;2686;149;515;529;1680;678;2195
315050;201502;1477;4278;1176;3783;297;1101;447;1390;744;2491
315053;201502;1062;3191;936;2981;200;798;411;1264;611;2062
315057;201502;1895;6439;1566;5934;256;998;941;3699;1197;4697
315060;201502;901;2949;669;2439;165;672;153;561;318;1233
315070;201502;734;2195;649;2077;172;623;346;1062;518;1685
315080;201502;3048;10411;2708;9700;635;2502;1319;4670;1954;7172
315090;201502;773;2789;692;2623;171;707;249;973;420;1680
315100;201502;1184;4024;890;3333;214;931;206;688;420;1619
315110;201502;1407;4374;1247;4063;307;1122;558;1778;865;2900
315120;201502;14283;33479;9747;27685;1626;4868;5114;15290;6740;20158
315130;201502;1486;4889;1328;4581;383;1493;404;1330;787;2823
315140;201502;2761;9161;2343;8287;640;2652;773;2433;1413;5085
315150;201502;4927;13356;3690;11311;813;2853;1383;4102;2196;6955
315160;201502;1308;3730;1116;3395;222;730;583;1708;805;2438
315170;201502;1429;4210;1202;3895;209;716;673;2392;882;3108
315180;201502;15314;44820;10206;34024;2180;8340;2103;6552;4283;14892
315190;201502;2155;5787;1828;5306;499;1539;922;2686;1421;4225
315200;201502;4193;14064;3453;12433;1005;4022;908;3121;1913;7143
315210;201502;8036;23677;6443;20536;1611;5690;2200;6749;3811;12439
315213;201502;1096;3558;1042;3485;67;205;911;3113;978;3318
315217;201502;2626;8969;2191;8233;318;1409;1286;4851;1604;6260
315220;201502;9937;28920;8342;26515;2273;7108;4256;14169;6529;21277
315230;201502;2671;7154;2384;6810;193;318;1988;6133;2181;6451
315240;201502;3096;9762;2719;9175;526;1939;1685;5628;2211;7567
315250;201502;9688;29850;7155;25024;1959;7753;2188;7594;4147;15347
315260;201502;976;3091;732;2558;211;836;139;424;350;1260
315270;201502;669;2262;558;2033;135;551;145;495;280;1046
315280;201502;3094;9167;2221;7256;577;2064;477;1361;1054;3425
315290;201502;1363;3863;1028;3324;360;1281;178;559;538;1840
315300;201502;466;1266;346;1122;169;578;116;374;285;952
315310;201502;1270;4147;1094;3835;147;602;715;2437;862;3039
315320;201502;840;2674;686;2469;159;644;327;1227;486;1871
315330;201502;691;2499;434;1806;123;563;42;189;165;752
315340;201502;3943;11366;3252;10300;741;2621;1454;4599;2195;7220
315350;201502;1775;4987;1342;4359;244;834;779;2610;1023;3444
315360;201502;1667;5527;1363;4760;273;1044;455;1469;728;2513
315370;201502;474;1409;405;1305;69;259;272;867;341;1126
315380;201502;215;752;173;650;48;209;32;104;80;313
315390;201502;1384;4796;1135;4218;331;1386;229;788;560;2174
315400;201502;4337;13175;3643;11877;797;2913;1722;5482;2519;8395
315410;201502;1913;5180;1618;4746;246;894;1014;2891;1260;3785
315415;201502;1108;3690;1020;3559;385;1356;440;1616;825;2972
315420;201502;1228;3960;937;3363;257;992;159;555;416;1547
315430;201502;3883;10534;2869;8840;719;2530;774;2287;1493;4817
315440;201502;890;2794;775;2606;140;548;414;1375;554;1923
315445;201502;2088;5910;1723;5408;172;687;1293;3989;1465;4676
315450;201502;2385;7663;2171;7339;471;1542;1358;4784;1829;6326
315460;201502;35909;118303;32021;110313;10556;39163;7425;24673;17981;63836
315470;201502;526;1571;443;1430;60;239;254;788;314;1027
315480;201502;1672;5123;1068;3744;208;835;178;583;386;1418
315490;201502;3071;8450;2459;7593;374;1363;1271;3837;1645;5200
315500;201502;475;1451;313;1072;61;257;112;314;173;571
315510;201502;1439;4119;1239;3814;69;239;965;2980;1034;3219
315520;201502;1108;3311;886;3012;131;516;568;1881;699;2397
315530;201502;506;1769;472;1707;208;805;157;542;365;1347
315540;201502;1171;3655;966;3309;190;803;368;1228;558;2031
315550;201502;1721;4875;1353;4380;453;1647;462;1466;915;3113
315560;201502;6696;22176;6050;21305;671;2720;4309;15289;4980;18009
315570;201502;2069;6528;1916;6297;434;1611;1034;3358;1468;4969
315580;201502;2521;7502;2004;6573;485;1902;741;2257;1226;4159
315590;201502;942;2726;841;2574;147;513;494;1463;641;1976
315600;201502;2533;9021;2091;8216;365;1504;1167;4817;1532;6321
315610;201502;999;2879;822;2518;163;642;311;798;474;1440
315620;201502;309;1091;291;1058;85;296;155;593;240;889
315630;201502;898;2825;759;2577;182;670;225;740;407;1410
315640;201502;615;1790;504;1599;117;439;220;639;337;1078
315645;201502;850;2692;736;2436;288;1039;180;576;468;1615
315650;201502;1911;5343;1594;4897;114;482;1212;3665;1326;4147
315660;201502;2573;6849;2196;6272;456;1339;1273;3631;1729;4970
315670;201502;10185;34525;9072;32384;2840;11032;3031;10568;5871;21600
315680;201502;2996;10335;2420;9186;926;3676;516;2042;1442;5718
315690;201502;3533;10125;2531;8372;699;2594;616;2079;1315;4673
315700;201502;7240;22736;6166;20612;1207;4666;2983;9560;4190;14226
315710;201502;1962;5696;1570;5082;178;704;975;3141;1153;3845
315720;201502;3147;10147;2900;9675;680;2719;1484;4645;2164;7364
315725;201502;1689;5104;1366;4680;395;1398;697;2431;1092;3829
315727;201502;622;1922;524;1728;121;448;236;745;357;1193
315730;201502;872;2682;791;2542;142;495;473;1506;615;2001
315733;201502;911;2825;819;2650;311;1092;244;751;555;1843
315737;201502;1328;4088;1060;3602;96;386;686;2360;782;2746
315740;201502;1065;3312;898;2984;176;714;469;1470;645;2184
315750;201502;1105;3489;1021;3348;84;338;773;2498;857;2836
315760;201502;1000;2754;962;2706;22;66;899;2532;921;2598
315765;201502;1420;4464;1308;4300;97;350;1047;3474;1144;3824
315770;201502;1575;5101;1406;4769;357;1359;454;1457;811;2816
315780;201502;23187;75878;21167;71650;6299;22956;6233;20973;12532;43929
315790;201502;3402;11532;3016;10752;374;1295;2024;7446;2398;8741
315800;201502;1531;5922;1247;5086;315;1464;254;980;569;2444
315810;201502;1403;3995;1211;3693;167;544;814;2452;981;2996
315820;201502;2688;9118;2390;8616;745;2777;1064;3956;1809;6733
315830;201502;1238;4197;1061;3801;202;886;293;896;495;1782
315840;201502;822;2164;602;1786;99;330;211;578;310;908
315850;201502;1197;4286;1152;4190;290;1113;513;1807;803;2920
315860;201502;486;1711;385;1517;105;485;75;283;180;768
315870;201502;477;1435;410;1343;120;442;134;400;254;842
315880;201502;1110;3000;918;2759;215;773;354;990;569;1763
315890;201502;1527;5229;1355;4965;482;1848;634;2348;1116;4196
315895;201502;5047;15621;4607;14777;1077;3872;2127;6644;3204;10516
315900;201502;730;2294;706;2249;112;458;489;1430;601;1888
315910;201502;536;1850;500;1785;173;654;262;919;435;1573
315920;201502;1556;4393;988;3198;244;901;227;639;471;1540
315930;201502;1096;3028;872;2648;221;739;291;862;512;1601
315935;201502;1061;3561;969;3364;288;1107;312;1061;600;2168
315940;201502;663;2104;585;1944;163;609;242;773;405;1382
315950;201502;1160;3558;1060;3382;219;680;672;2193;891;2873
315960;201502;2926;9642;2178;8159;1008;4331;111;325;1119;4656
315970;201502;771;2131;604;1896;56;160;452;1484;508;1644
315980;201502;4324;10480;2705;7790;700;2317;733;1806;1433;4123
315990;201502;3907;11541;3364;10701;629;2409;1884;5892;2513;8301
316000;201502;515;1606;445;1507;159;629;165;523;324;1152
316010;201502;515;1781;441;1647;102;448;151;498;253;946
316020;201502;1110;3589;923;3285;151;643;535;1898;686;2541
316030;201502;3549;10262;2626;8684;344;1273;1380;4709;1724;5982
316040;201502;3654;11552;2708;9530;455;1862;393;1067;848;2929
316045;201502;2122;6783;1944;6493;268;815;1405;4933;1673;5748
316050;201502;348;1101;278;994;59;232;161;555;220;787
316060;201502;743;2226;595;2004;95;423;336;1058;431;1481
316070;201502;5859;18832;5083;17063;1269;4828;2100;6676;3369;11504
316080;201502;722;2685;657;2519;158;673;119;467;277;1140
316090;201502;625;1815;425;1394;90;338;116;344;206;682
316095;201502;1401;4534;1226;4216;261;909;730;2568;991;3477
316100;201502;2772;9258;2133;7639;561;2317;406;1323;967;3640
316105;201502;957;2690;720;2300;191;674;272;878;463;1552
316110;201502;11942;41664;10745;39532;1418;5819;7357;27660;8775;33479
316120;201502;1181;3906;992;3453;282;1055;326;1069;608;2124
316130;201502;1420;3149;866;2389;137;448;470;1242;607;1690
316140;201502;1048;3118;812;2732;113;415;492;1689;605;2104
316150;201502;1450;4196;1345;4013;271;948;791;2348;1062;3296
316160;201502;1243;3702;970;3169;160;621;453;1451;613;2072
316165;201502;952;2579;792;2342;147;516;475;1377;622;1893
316170;201502;1399;4023;1056;3438;208;763;443;1358;651;2121
316180;201502;1355;4293;994;3523;267;1098;239;752;506;1850
316190;201502;2787;8691;1428;5068;290;1072;191;586;481;1658
316200;201502;4006;12929;3108;11157;761;3165;875;3057;1636;6222
316210;201502;4868;15555;4197;14345;1842;6673;848;2820;2690;9493
316220;201502;742;2312;531;1908;124;528;66;246;190;774
316225;201502;1171;3356;1022;3136;140;522;701;2089;841;2611
316230;201502;453;1293;358;1131;61;212;179;594;240;806
316240;201502;6719;20641;5786;19439;589;2074;4491;15302;5080;17376
316245;201502;3141;11005;2916;10638;231;1109;2304;8290;2535;9399
316250;201502;9726;29703;8174;26562;2641;9439;2408;7371;5049;16810
316255;201502;2570;7866;2270;7508;351;1175;1639;5497;1990;6672
316257;201502;1373;3879;1061;3326;221;775;400;1201;621;1976
316260;201502;1765;5054;1356;4442;170;630;806;2738;976;3368
316265;201502;1318;3677;958;2946;105;401;551;1614;656;2015
316270;201502;4342;14406;3985;13681;1002;3718;1875;6389;2877;10107
316280;201502;3256;10723;2947;10139;513;1972;1717;5918;2230;7890
316290;201502;3154;10064;2722;9244;584;2389;1194;3812;1778;6201
316292;201502;3316;10816;2987;10250;718;2732;1441;4688;2159;7420
316294;201502;871;2807;605;2199;131;563;63;213;194;776
316295;201502;1768;6072;1649;5839;309;1342;940;3103;1249;4445
316300;201502;1013;3111;861;2855;73;257;597;2015;670;2272
316310;201502;624;1927;483;1663;90;364;172;579;262;943
316320;201502;573;1828;467;1657;92;379;108;365;200;744
316330;201502;961;2964;762;2520;108;385;476;1566;584;1951
316340;201502;994;3205;831;2874;224;921;304;952;528;1873
316350;201502;1369;4394;1227;4160;217;746;687;2408;904;3154
316360;201502;734;1922;577;1703;56;177;436;1292;492;1469
316370;201502;4340;14269;3802;13202;1165;4448;751;2586;1916;7034
316380;201502;1529;4203;1240;3795;117;407;887;2737;1004;3144
316390;201502;876;2616;733;2367;222;801;303;978;525;1779
316400;201502;1310;4226;1069;3807;250;978;468;1636;718;2614
316410;201502;1091;3688;1020;3580;191;733;634;2229;825;2962
316420;201502;1884;6303;1695;6052;198;887;1166;4063;1364;4950
316430;201502;925;2842;724;2461;198;759;242;761;440;1520
316440;201502;672;2163;553;1991;215;884;133;461;348;1345
316443;201502;710;2101;582;1858;142;508;230;688;372;1196
316447;201502;1557;4824;1432;4648;93;305;1248;4094;1341;4399
316450;201502;2131;7366;1864;6862;317;1284;1186;4448;1503;5732
316460;201502;703;2226;649;2140;147;550;402;1257;549;1807
316470;201502;7527;24335;5932;20892;1582;6549;1784;5994;3366;12543
316480;201502;214;729;191;690;48;189;61;204;109;393
316490;201502;283;902;256;829;60;212;125;380;185;592
316500;201502;1094;3995;764;2986;148;629;37;137;185;766
316510;201502;839;3087;743;2890;279;1140;179;677;458;1817
316520;201502;1157;3526;957;3234;202;777;379;1158;581;1935
316530;201502;1115;3641;936;3271;221;970;344;1016;565;1986
316540;201502;994;3239;896;3083;207;866;341;1083;548;1949
316550;201502;1212;4085;1141;3970;224;871;735;2555;959;3426
316553;201502;1943;6871;1568;5998;475;2002;372;1388;847;3390
316555;201502;2905;9965;2521;9537;208;763;2049;7955;2257;8718
316556;201502;594;1639;478;1434;36;144;361;1050;397;1194
316557;201502;745;2737;715;2692;334;1342;183;643;517;1985
316560;201502;342;1181;293;1080;69;313;71;218;140;531
316570;201502;1343;4283;1173;3937;193;726;631;2116;824;2842
316580;201502;274;796;200;640;53;205;60;172;113;377
316590;201502;1497;4139;1118;3508;181;685;662;1976;843;2661
316600;201502;1008;3250;882;2996;293;1060;257;851;550;1911
316610;201502;562;2067;506;1966;109;472;303;1168;412;1640
316620;201502;2130;6634;1835;6075;369;1397;1036;3347;1405;4744
316630;201502;1513;5061;1320;4648;550;2031;371;1326;921;3357
316640;201502;190;608;166;556;31;137;69;198;100;335
316650;201502;908;3491;805;3327;188;797;445;1946;633;2743
316660;201502;181;488;109;333;14;54;42;124;56;178
316670;201502;1830;5370;1466;4689;572;2027;329;956;901;2983
316680;201502;1903;5329;1564;4855;144;432;1252;3975;1396;4407
316690;201502;1183;3994;1061;3745;342;1380;410;1401;752;2781
316695;201502;1112;3549;986;3318;73;257;708;2439;781;2696
316700;201502;357;1116;322;1056;64;261;176;516;240;777
316710;201502;3416;12941;2988;12014;1045;4482;860;3651;1905;8133
316720;201502;17087;56012;14345;50130;4412;16614;3163;10632;7575;27246
316730;201502;361;1115;312;1013;68;271;187;558;255;829
316740;201502;665;2238;590;2096;199;792;183;614;382;1406
316750;201502;419;1435;368;1323;87;362;127;429;214;791
316760;201502;3380;11439;2901;10855;1689;6363;827;3272;2516;9635
316770;201502;1284;3776;1160;3609;166;599;809;2504;975;3103
316780;201502;584;1989;513;1845;158;644;137;448;295;1092
316790;201502;851;2479;627;2090;178;658;197;645;375;1303
316800;201502;6000;19908;5456;18919;1117;4484;2714;8973;3831;13457
316805;201502;833;2271;780;2200;100;265;633;1852;733;2117
316810;201502;582;1811;509;1660;156;569;225;702;381;1271
316820;201502;383;1017;231;749;63;243;43;132;106;375
316830;201502;599;2083;573;2040;193;760;241;822;434;1582
316840;201502;2954;8998;2579;8320;688;2530;1038;3175;1726;5705
316850;201502;2069;6351;1844;5962;331;1197;1089;3522;1420;4719
316860;201502;18781;59833;16249;55120;4088;15923;6948;22547;11036;38470
316870;201502;6248;20365;5278;18138;1631;6123;964;3162;2595;9285
316880;201502;783;2550;721;2442;241;933;259;824;500;1757
316890;201502;1326;3296;1048;2931;337;1084;510;1348;847;2432
316900;201502;2462;7646;2025;6742;525;2039;710;2126;1235;4165
316905;201502;453;1521;396;1399;150;556;124;431;274;987
316910;201502;735;2480;569;2129;133;522;159;618;292;1140
316920;201502;1677;4962;1348;4478;265;968;613;2024;878;2992
316930;201502;8910;30486;7330;27018;1877;7761;1255;4238;3132;11999
316935;201502;4943;14579;3306;11284;926;3629;653;2037;1579;5666
316940;201502;7047;23326;5874;20840;1485;5819;1477;5037;2962;10856
316950;201502;1460;4324;1295;4083;156;605;903;2838;1059;3443
316960;201502;5103;12915;4076;11610;785;2458;2374;6728;3159;9186
316970;201502;3373;10864;3186;10568;990;3794;1099;3341;2089;7135
316980;201502;1057;3153;764;2648;308;1195;179;624;487;1819
316990;201502;9602;31410;8270;28339;2976;11164;965;3115;3941;14279
317000;201502;2751;9472;2659;9370;152;465;2142;8382;2294;8847
317005;201502;2533;7909;2284;7573;325;1071;1644;5586;1969;6657
317010;201502;30558;77253;18988;58760;4843;16859;4405;14209;9248;31068
317020;201502;55610;157887;34779;114730;7951;29226;8045;24658;15996;53884
317030;201502;806;2285;657;2050;82;324;404;1220;486;1544
317040;201502;10110;29877;8274;26607;2223;7857;3324;10573;5547;18430
317043;201502;743;2110;660;2008;92;274;456;1424;548;1698
317047;201502;1153;3049;848;2541;136;467;398;1169;534;1636
317050;201502;1550;5357;1244;4634;258;1108;535;1880;793;2988
317052;201502;2445;7811;2158;7386;208;829;1674;5730;1882;6559
317057;201502;1732;4910;1346;4243;160;626;759;2301;919;2927
317060;201502;395;1166;295;946;64;241;94;261;158;502
317065;201502;1242;4157;1130;3974;127;532;875;3051;1002;3583
317070;201502;9060;29045;6669;23631;1641;6560;1277;4531;2918;11091
317075;201502;1103;3359;919;3014;272;998;305;920;577;1918
317080;201502;6129;17214;5313;15835;1526;4890;1944;5627;3470;10517
317090;201502;4912;16481;4565;15903;663;2368;3192;11338;3855;13706
317100;201502;3109;8814;2482;7749;751;2618;981;2895;1732;5513
317103;201502;2021;7043;1711;6409;341;1581;775;2828;1116;4409
317107;201502;1356;4188;1165;3795;224;868;665;2025;889;2893
317110;201502;651;1683;401;1226;92;337;166;462;258;799
317115;201502;1147;3649;998;3336;146;507;638;2162;784;2669
317120;201502;11371;37901;9371;33156;2524;9995;3302;11294;5826;21289
317130;201502;7641;23288;6619;21491;1441;5392;3101;9868;4542;15260
317140;201502;597;2035;570;1983;64;245;402;1410;466;1655
317150;201502;1000;2811;868;2660;85;294;664;2044;749;2338
317160;201502;3450;9375;2662;8335;266;966;1920;5967;2186;6933
317170;201502;1769;5016;1497;4582;104;426;1000;2874;1104;3300
317180;201502;1866;6277;1494;5483;424;1711;466;1662;890;3373
317190;201502;1391;3998;1137;3658;140;469;798;2578;938;3047
317200;201502;4570;14618;4042;13572;1166;4383;1363;4349;2529;8732
317210;201502;1045;3170;860;2913;189;751;462;1547;651;2298
317220;201502;306;1083;295;1070;85;320;167;618;252;938
320010;201502;5446;17129;4759;15644;870;3044;2397;7891;3267;10935
320013;201502;2023;5935;1424;4800;210;757;733;2531;943;3288
320016;201502;3278;9298;2847;8664;405;1190;2039;6333;2444;7523
320020;201502;3902;12212;3382;11175;1055;3806;1242;4048;2297;7854
320030;201502;1598;5130;1293;4467;392;1445;464;1560;856;3005
320035;201502;1802;5373;1609;5087;431;1539;829;2478;1260;4017
320040;201502;3294;11018;2708;9646;664;2614;748;2539;1412;5153
320050;201502;1820;4910;1581;4491;237;756;1030;2866;1267;3622
320060;201502;11996;37978;9420;32063;2316;8724;3087;9902;5403;18626
320070;201502;1568;5127;1297;4481;338;1308;311;932;649;2240
320080;201502;5310;15319;4112;12893;1167;3900;1257;3901;2424;7801
320090;201502;8463;24639;6718;21133;1802;6084;2825;8564;4627;14648
320100;201502;3062;9234;2507;8160;580;2019;1177;3772;1757;5791
320110;201502;1380;4163;1228;3873;307;1039;464;1432;771;2471
320115;201502;1801;6419;1640;6121;862;3369;462;1734;1324;5103
320120;201502;16144;50700;12951;44417;3786;14179;3731;12867;7517;27046
320130;201502;36218;117810;33147;111498;7727;29136;15422;50131;23149;79267
320140;201502;4075;12960;2899;10209;703;2767;285;920;988;3687
320150;201502;17050;47245;12371;38441;3286;11235;2132;6396;5418;17631
320160;201502;5050;15669;4365;14420;1141;4279;1669;5081;2810;9360
320170;201502;1721;5580;1424;4906;397;1445;526;1826;923;3271
320180;201502;816;2664;720;2515;295;1070;224;801;519;1871
320190;201502;3862;13217;3075;11300;914;3569;873;3144;1787;6713
320200;201502;1068;3392;920;3125;227;835;396;1375;623;2210
320210;201502;5085;14258;4411;13035;914;3079;2348;6605;3262;9684
320220;201502;2832;8508;2202;7384;592;2199;870;2943;1462;5142
320225;201502;1471;5100;1212;4453;429;1694;248;936;677;2630
320230;201502;4095;13538;3681;12851;1247;4696;1282;4498;2529;9194
320240;201502;11499;34232;8938;29472;2526;9068;2297;7567;4823;16635
320245;201502;3857;13138;3586;12497;1181;4424;1174;3922;2355;8346
320250;201502;1717;5299;1248;4233;307;1184;272;811;579;1995
320255;201502;1869;6241;1606;5795;646;2534;590;2193;1236;4727
320260;201502;1070;3303;825;2718;215;800;242;661;457;1461
320265;201502;2447;7644;2136;7247;337;1185;1456;5091;1793;6276
320270;201502;2737;8247;2047;6867;505;1841;866;2849;1371;4690
320280;201502;6954;21167;6217;19772;1399;4952;2835;8663;4234;13615
320290;201502;1481;4878;1118;3966;379;1419;216;714;595;2133
320300;201502;4457;14980;4072;14114;1287;4770;1176;4039;2463;8809
320305;201502;4444;14438;3959;13347;954;3540;1878;6137;2832;9677
320310;201502;1977;5936;1708;5426;444;1514;728;2242;1172;3756
320313;201502;2263;6742;1586;5164;392;1527;284;797;676;2324
320316;201502;1869;5714;1583;5121;492;1676;634;1972;1126;3648
320320;201502;19583;61605;16201;55180;4604;17391;5874;19567;10478;36958
320330;201502;3174;9466;2739;8741;565;1764;1569;5252;2134;7016
320332;201502;4955;16744;4414;15753;1522;5793;1585;5761;3107;11554
320334;201502;1689;5535;1222;4484;395;1636;237;792;632;2428
320335;201502;2257;6737;1510;5028;451;1670;267;795;718;2465
320340;201502;5731;15766;4579;13811;1012;3369;2125;6352;3137;9721
320350;201502;5314;14208;3984;11778;922;2965;1538;4448;2460;7413
320360;201502;1711;4575;1277;3749;219;746;603;1643;822;2389
320370;201502;3294;10688;2669;9301;800;2870;960;3322;1760;6192
320380;201502;2482;7337;2186;6808;308;1090;1421;4342;1729;5432
320390;201502;7413;22408;6078;19635;1903;6815;1840;5544;3743;12359
320400;201502;4078;11830;3396;10814;1014;3650;1366;4032;2380;7682
320405;201502;3872;11505;3474;10946;997;3439;1859;5699;2856;9138
320410;201502;5667;14502;4158;12647;861;2775;2364;7246;3225;10021
320420;201502;1673;5163;1219;4359;390;1539;218;768;608;2307
320425;201502;2060;5547;1749;5050;259;862;1084;3081;1343;3943
320430;201502;2263;6544;2000;6029;423;1375;1065;3137;1488;4512
320435;201502;2683;8962;2283;8133;1077;3997;656;2450;1733;6447
320440;201502;1205;4007;1073;3653;270;1020;370;1186;640;2206
320450;201502;2054;6424;1691;5681;470;1756;738;2358;1208;4114
320455;201502;4392;14751;3216;11820;973;3796;790;2871;1763;6667
320460;201502;2918;9233;2266;7886;591;2259;808;2683;1399;4942
320465;201502;1689;5296;1323;4451;296;1087;501;1616;797;2703
320470;201502;4336;13302;3098;10468;895;3351;466;1375;1361;4726
320480;201502;2018;6064;1693;5456;414;1547;705;2155;1119;3702
320490;201502;15915;49491;13220;44242;4242;15365;3892;13103;8134;28468
320495;201502;1202;3725;888;3014;347;1227;133;488;480;1715
320500;201502;45699;140295;39738;129234;10809;38296;18181;57873;28990;96169
320501;201502;4147;13247;3699;12532;1149;4389;1591;5221;2740;9610
320503;201502;1798;6185;1485;5479;495;2022;436;1428;931;3450
320506;201502;3616;11405;2480;8548;771;2837;185;552;956;3389
320510;201502;8021;25189;6865;22851;1865;6840;2916;9432;4781;16272
320515;201502;2063;5894;1738;5225;484;1547;553;1599;1037;3146
320517;201502;2175;7039;1783;6237;675;2566;399;1285;1074;3851
320520;201502;34711;106611;28639;94968;8160;30020;10712;35054;18872;65074
320530;201502;28076;85866;23495;76932;5408;20571;10913;33578;16321;54149
330010;201502;19465;60065;17707;56561;3414;12189;10450;32511;13864;44700
330015;201502;1800;5033;1543;4567;291;1043;637;1796;928;2839
330020;201502;16715;49584;15286;47312;3220;10933;8919;27115;12139;38048
330022;201502;1711;5317;1491;4952;284;1111;822;2631;1106;3742
330023;201502;3132;10023;2902;9568;757;2724;1125;3510;1882;6234
330025;201502;3938;10949;3296;10015;764;2577;1860;5517;2624;8094
330030;201502;8095;27271;7168;25339;1758;6961;3268;11016;5026;17977
330040;201502;12687;36620;10914;33590;2581;8556;5474;16396;8055;24952
330045;201502;66061;186607;59117;176564;7632;24762;41268;122045;48900;146807
330050;201502;2645;8305;2355;7734;763;2819;715;2154;1478;4973
330060;201502;5576;16486;4919;15531;1121;3986;2800;8891;3921;12877
330070;201502;23164;70827;20677;66533;4825;17000;9722;30985;14547;47985
330080;201502;8287;23685;7779;22926;1127;3317;5369;16071;6496;19388
330090;201502;2749;7585;2522;7201;508;1618;1359;3785;1867;5403
330093;201502;1997;5918;1662;5266;386;1323;544;1631;930;2954
330095;201502;1061;3629;952;3393;320;1307;187;571;507;1878
330100;201502;55038;176871;50286;168739;9853;37203;26853;90478;36706;127681
330110;201502;2365;7536;2136;7122;582;2151;749;2440;1331;4591
330115;201502;2123;6185;1922;5867;442;1534;976;2871;1418;4405
330120;201502;2403;6871;2167;6545;620;2086;1046;3026;1666;5112
330130;201502;3560;11575;3168;10870;859;3246;1445;4894;2304;8140
330140;201502;3078;9550;2802;9143;702;2500;1436;4714;2138;7214
330150;201502;2562;7566;1980;6390;466;1639;483;1522;949;3161
330160;201502;1122;3840;1039;3680;333;1313;406;1374;739;2687
330170;201502;107925;325736;100530;314265;16093;54177;67651;211190;83744;265367
330180;201502;1903;5715;1658;5279;188;765;1058;3162;1246;3927
330185;201502;7541;23952;6729;22401;1562;5660;3516;11574;5078;17234
330187;201502;3790;10958;3296;10142;489;1743;2238;6739;2727;8482
330190;201502;26459;76760;24803;74100;5008;15868;15647;46276;20655;62144
330200;201502;13770;43860;12362;41310;2934;10183;6482;21935;9416;32118
330205;201502;2410;6536;2098;6010;434;1413;1136;3136;1570;4549
330210;201502;4437;11718;3327;9717;997;3159;805;2298;1802;5457
330220;201502;10283;31703;9172;29309;2578;9013;2751;8221;5329;17234
330225;201502;3977;12480;3717;12095;335;1307;2826;9355;3161;10662
330227;201502;18088;51405;16172;48607;4144;13091;8549;25614;12693;38705
330230;201502;1426;4263;1293;4032;342;1208;539;1568;881;2776
330240;201502;17122;53888;15175;50042;5551;20041;3078;9609;8629;29650
330245;201502;1267;3975;1036;3530;273;1024;237;808;510;1832
330250;201502;35513;104026;32638;99268;9506;29547;15019;46481;24525;76028
330260;201502;3646;11463;3194;10511;673;2495;1412;4354;2085;6849
330270;201502;14416;39831;11617;35717;3277;10952;4348;13323;7625;24275
330280;201502;2058;6343;1765;5750;344;1250;840;2580;1184;3830
330285;201502;18452;53600;16824;51289;2964;9828;10881;33054;13845;42882
330290;201502;3540;9879;3136;9305;559;1918;1926;5506;2485;7424
330300;201502;3507;11424;3228;10925;511;1978;1972;6585;2483;8563
330310;201502;2420;6939;2139;6462;377;1194;1201;3609;1578;4803
330320;201502;13542;40464;12712;39225;1988;6704;9016;27649;11004;34353
330330;201502;28727;81243;25791;76624;4639;15452;16249;47105;20888;62557
330340;201502;14160;42406;11348;37029;3291;11489;3269;10572;6560;22061
330350;201502;87884;270295;83281;263507;12785;41467;60518;193084;73303;234551
330360;201502;5478;16873;5348;16692;385;1343;4589;14275;4974;15618
330370;201502;3539;12783;3281;12208;1189;4680;1073;4026;2262;8706
330380;201502;4764;15380;4101;14121;908;3464;2009;6776;2917;10240
330385;201502;4058;14022;3751;13428;1262;4819;1415;5023;2677;9842
330390;201502;22673;75434;20494;71084;4749;18528;10129;34313;14878;52841
330395;201502;2966;8792;2698;8338;323;1201;1818;5482;2141;6683
330400;201502;2427;7925;2207;7539;387;1586;1240;3931;1627;5517
330410;201502;2915;9152;2493;8358;487;1778;1300;4340;1787;6118
330411;201502;2310;7240;2015;6609;289;1173;1152;3557;1441;4730
330412;201502;1317;4518;1072;4048;259;1129;413;1476;672;2605
330414;201502;25966;72797;22357;67995;3933;12348;14453;44321;18386;56669
330415;201502;3602;11046;3150;10244;813;2815;1347;4409;2160;7224
330420;201502;9280;27985;6575;22723;1738;6602;1103;3712;2841;10314
330430;201502;7789;23086;7047;21762;1557;5305;3638;11018;5195;16323
330440;201502;1926;6483;1642;5883;538;2183;362;1135;900;3318
330450;201502;1417;4762;1288;4538;330;1377;660;2260;990;3637
330452;201502;12407;37233;9953;32411;2701;9726;3688;11557;6389;21283
330455;201502;470929;1334909;397277;1217986;97691;319366;197844;603870;295535;923236
330460;201502;1280;4205;1160;3999;261;1052;577;1947;838;2999
330470;201502;4345;13459;3891;12611;1114;4006;1572;4922;2686;8928
330475;201502;7935;24906;7097;23474;1953;7126;3132;10250;5085;17376
330480;201502;5975;17771;5453;17000;1268;4312;2824;8660;4092;12972
330490;201502;101608;277201;93249;265302;9403;27831;73135;209505;82538;237336
330500;201502;5407;16881;5134;16379;710;2543;3557;11205;4267;13748
330510;201502;38372;120460;35374;115672;10781;36058;17415;58119;28196;94177
330513;201502;1531;4573;1394;4326;449;1413;557;1762;1006;3175
330515;201502;2986;9352;2684;8795;826;2859;944;3058;1770;5917
330520;201502;11796;35151;10582;33037;2327;7804;5373;16679;7700;24483
330530;201502;1527;4592;1370;4300;342;1162;600;1846;942;3008
330540;201502;3102;9276;2654;8508;692;2423;1090;3390;1782;5813
330550;201502;8221;27431;7245;25642;3106;11648;1521;5363;4627;17011
330555;201502;10329;30825;9241;29261;1713;5587;5856;18931;7569;24518
330560;201502;4229;12903;3903;12343;825;2977;2061;6278;2886;9255
330570;201502;3707;10710;3178;9861;823;2641;1593;5019;2416;7660
330575;201502;5281;15391;4730;14455;842;2926;2938;8603;3780;11529
330580;201502;15134;47790;13028;43551;3616;12881;5056;17034;8672;29915
330590;201502;1721;5281;1594;5066;349;1198;952;2987;1301;4185
330600;201502;10673;30594;8613;27319;1196;4600;5143;15782;6339;20382
330610;201502;9000;28702;8308;27467;1707;6436;4560;14860;6267;21296
330615;201502;1642;5821;1490;5463;648;2503;393;1500;1041;4003
330620;201502;3744;12983;3409;12364;1174;4594;950;3539;2124;8133
330630;201502;22040;66776;18454;60297;3861;14442;9500;29665;13361;44107
350010;201502;2258;6804;1614;5494;405;1522;281;825;686;2347
350020;201502;498;1344;346;1057;72;246;169;497;241;743
350030;201502;4249;13390;3372;11532;1278;4804;753;2305;2031;7109
350040;201502;501;1746;397;1504;107;458;90;284;197;742
350050;201502;1123;3449;913;3063;203;797;322;996;525;1793
350055;201502;579;1813;538;1745;131;499;304;928;435;1427
350060;201502;90;303;83;291;25;105;32;99;57;204
350070;201502;2712;8896;2118;7547;510;2006;396;1216;906;3222
350075;201502;507;1718;421;1572;130;542;118;404;248;946
350080;201502;551;1585;416;1326;77;276;178;554;255;830
350090;201502;550;1525;398;1268;88;304;121;351;209;655
350100;201502;1876;6055;1390;4983;357;1425;368;1214;725;2639
350110;201502;445;1324;334;1075;57;206;140;419;197;625
350115;201502;1281;4020;1130;3674;224;859;577;1700;801;2559
350120;201502;559;1478;283;889;63;222;47;132;110;354
350130;201502;3367;9983;3018;9300;559;1983;1546;4421;2105;6404
350140;201502;618;1980;542;1846;123;492;242;775;365;1267
350150;201502;382;1285;342;1196;112;418;103;349;215;767
350160;201502;6836;21182;5165;17599;1444;5516;1978;6131;3422;11647
350170;201502;1808;6253;1581;5694;472;1838;380;1281;852;3119
350180;201502;1211;3255;876;2578;196;597;386;1104;582;1701
350190;201502;3170;10111;2670;9126;605;2526;1399;4363;2004;6889
350200;201502;319;1036;282;972;63;241;117;402;180;643
350210;201502;6318;16826;4596;13935;1319;4503;1623;4631;2942;9134
350220;201502;2628;8255;2353;7770;698;2717;849;2506;1547;5223
350230;201502;709;2388;657;2302;189;734;252;878;441;1612
350240;201502;432;1352;402;1301;77;279;262;815;339;1094
350250;201502;2207;8070;2105;7871;798;3181;757;2808;1555;5989
350260;201502;986;2615;701;2115;130;422;336;983;466;1405
350270;201502;5222;15995;4547;14592;869;3005;2170;6877;3039;9882
350275;201502;1950;6468;1749;6137;466;1799;666;2172;1132;3971
350280;201502;21380;54195;13687;40728;3058;9803;3256;9590;6314;19393
350290;201502;1603;5299;1315;4684;325;1276;318;1081;643;2357
350300;201502;401;1231;350;1136;73;258;170;531;243;789
350310;201502;886;2969;793;2754;149;594;350;1175;499;1769
350315;201502;541;1694;444;1493;80;352;142;428;222;780
350320;201502;12056;37860;10424;34549;2934;10425;1584;5341;4518;15766
350330;201502;13478;38954;9063;28425;1938;6287;3146;9211;5084;15498
350335;201502;325;1019;293;962;48;151;187;625;235;776
350340;201502;1110;3343;809;2754;178;702;266;845;444;1547
350350;201502;769;2442;681;2303;162;650;251;843;413;1493
350360;201502;752;2564;632;2302;168;649;214;799;382;1448
350370;201502;698;2136;512;1717;95;367;99;289;194;656
350380;201502;3361;10497;2682;9391;937;3641;680;2180;1617;5821
350390;201502;8584;27122;7616;25318;2168;7669;3281;10585;5449;18254
350395;201502;328;941;184;644;32;130;43;144;75;274
350400;201502;7798;22365;6304;19688;1534;5369;2550;7581;4084;12950
350410;201502;7644;26669;6232;23515;1846;7705;1234;4397;3080;12102
350420;201502;541;1556;362;1228;86;355;42;111;128;466
350430;201502;741;2324;613;2094;134;561;310;1011;444;1572
350440;201502;1235;3930;1144;3750;317;1115;573;1821;890;2936
350450;201502;7519;22426;5853;19156;1522;5462;1472;4480;2994;9942
350460;201502;1391;3939;948;3020;215;772;289;818;504;1590
350470;201502;248;680;202;605;41;155;105;286;146;441
350480;201502;780;2410;539;1870;78;310;89;268;167;578
350490;201502;2064;6001;1767;5588;476;1740;778;2267;1254;4007
350500;201502;573;1687;494;1569;122;410;214;658;336;1068
350510;201502;991;3111;785;2634;167;652;278;833;445;1485
350520;201502;989;3612;792;3169;215;985;191;708;406;1693
350530;201502;2412;7170;1977;6260;632;2189;545;1560;1177;3749
350535;201502;1369;4196;1294;4062;68;292;1070;3292;1138;3584
350540;201502;1927;5429;1566;4784;451;1478;555;1689;1006;3167
350550;201502;11614;31439;8135;25631;1742;6263;3140;9454;4882;15717
350560;201502;3497;11538;3160;10848;554;2058;1644;5715;2198;7773
350570;201502;18968;64124;17139;60076;5106;19330;6296;21142;11402;40472
350580;201502;1689;5285;1230;4228;273;1045;185;539;458;1584
350590;201502;3981;12397;3003;10389;835;3230;997;3123;1832;6353
350600;201502;39617;97795;26866;77022;4305;13538;13661;37726;17966;51264
350610;201502;8034;23149;6210;19985;1349;4953;2801;8671;4150;13624
350620;201502;415;1198;326;1066;68;269;157;481;225;750
350630;201502;1645;4988;1279;4274;345;1354;296;850;641;2204
350635;201502;5366;16591;4176;14365;1121;4130;1574;5378;2695;9508
350640;201502;636;2037;496;1682;106;385;129;412;235;797
350650;201502;6733;20599;3699;13112;973;3821;333;1183;1306;5004
350660;201502;4041;12506;3508;11592;792;2908;1875;6063;2667;8971
350670;201502;1774;5493;1664;5295;310;1095;1052;3239;1362;4334
350680;201502;1139;3483;900;3000;221;881;372;1184;593;2065
350690;201502;914;3004;753;2679;196;768;233;765;429;1533
350700;201502;2929;10005;2574;9225;982;3825;834;2689;1816;6514
350710;201502;2420;7636;2184;7254;333;1230;1456;4798;1789;6028
350715;201502;904;2749;790;2548;235;882;281;798;516;1680
350720;201502;141;422;128;399;38;133;45;123;83;256
350730;201502;416;1556;396;1503;113;476;143;519;256;995
350740;201502;2020;6260;1647;5424;340;1251;751;2337;1091;3588
350745;201502;373;1143;286;945;45;180;131;382;176;562
350750;201502;10133;30576;7865;26106;1961;7204;1914;5907;3875;13111
350760;201502;12044;36798;10356;33672;2729;9963;4366;13426;7095;23389
350770;201502;747;2114;502;1634;79;298;225;698;304;996
350775;201502;542;1529;449;1378;80;293;253;740;333;1033
350780;201502;2146;6519;1621;5439;466;1728;224;702;690;2430
350790;201502;1986;6288;1522;5351;425;1616;352;1097;777;2713
350800;201502;3006;10047;2831;9757;512;2050;1777;5970;2289;8020
350810;201502;2184;6310;1791;5673;562;1937;632;1935;1194;3872
350820;201502;554;1502;403;1198;75;270;175;472;250;742
350830;201502;873;2738;613;2125;92;353;134;387;226;740
350840;201502;2401;8550;1994;7551;612;2557;386;1240;998;3797
350850;201502;6364;21225;5305;18837;1753;6607;1235;4197;2988;10804
350860;201502;3113;9878;2979;9686;287;1139;2371;7638;2658;8777
350870;201502;2508;8215;2155;7675;592;2332;1229;4398;1821;6730
350880;201502;1354;4474;1136;4024;306;1169;249;862;555;2031
350890;201502;648;1866;451;1443;76;296;108;263;184;559
350900;201502;4409;14741;3579;12852;967;3782;740;2469;1707;6251
350910;201502;822;2478;730;2290;246;831;267;779;513;1610
350920;201502;9651;28122;8809;26695;1399;4632;5908;17448;7307;22080
350925;201502;4598;14109;3882;12672;1000;3566;1587;4804;2587;8370
350930;201502;1579;4309;1297;3831;144;501;902;2585;1046;3086
350940;201502;2064;6822;1892;6554;361;1494;1175;3918;1536;5412
350945;201502;852;2811;740;2577;133;553;365;1188;498;1741
350950;201502;65483;203554;53891;180094;13621;50159;21746;69750;35367;119909
350960;201502;4654;15870;4042;14574;702;2953;2334;8078;3036;11031
350970;201502;4321;15116;3718;13680;1229;4973;949;3159;2178;8132
350980;201502;601;1989;541;1886;226;840;181;637;407;1477
350990;201502;1712;5942;1476;5480;493;1978;407;1458;900;3436
350995;201502;781;2710;746;2643;132;592;445;1497;577;2089
351000;201502;3401;10169;2890;9208;391;1415;1601;4945;1992;6360
351010;201502;372;1095;258;847;85;314;78;252;163;566
351015;201502;858;2864;737;2643;225;903;295;1017;520;1920
351020;201502;7887;25223;6928;23738;1766;6511;3379;11706;5145;18217
351030;201502;1576;5639;1442;5346;363;1583;550;1892;913;3475
351040;201502;3359;10354;3075;9856;527;1991;1950;5965;2477;7956
351050;201502;10884;33563;8461;28986;2517;9467;2662;8975;5179;18442
351060;201502;32787;99129;26906;88257;6854;24537;10754;34409;17608;58946
351070;201502;1691;4758;1182;3845;365;1314;201;534;566;1848
351080;201502;2737;8013;2130;7255;544;2090;994;3271;1538;5361
351090;201502;384;1313;307;1155;68;296;72;271;140;567
351100;201502;1824;5619;1477;4925;497;1722;464;1577;961;3299
351110;201502;8059;20444;4426;14223;1060;3864;1060;3109;2120;6973
351120;201502;603;1761;488;1532;60;215;260;736;320;951
351130;201502;943;2631;512;1748;91;372;111;338;202;710
351140;201502;1729;6037;1562;5678;523;2125;474;1633;997;3758
351150;201502;1794;6123;1360;4996;284;1159;316;1005;600;2164
351160;201502;1371;4697;1227;4377;334;1338;451;1530;785;2868
351170;201502;1520;4939;1228;4284;253;956;525;1706;778;2662
351190;201502;747;2414;625;2116;141;521;128;381;269;902
351200;201502;2182;6379;1829;5695;415;1494;700;1998;1115;3492
351210;201502;1022;3104;808;2669;203;751;267;795;470;1546
351220;201502;3178;10642;2811;9893;598;2347;1380;4778;1978;7125
351230;201502;1726;5516;1502;5120;294;1177;883;2921;1177;4098
351240;201502;1049;3324;772;2696;209;814;190;566;399;1380
351250;201502;907;2591;649;2066;132;454;262;791;394;1245
351260;201502;944;2774;825;2525;179;612;361;1034;540;1646
351270;201502;372;1292;339;1230;90;378;136;443;226;821
351280;201502;5254;15578;3931;12716;930;3207;1297;3862;2227;7069
351290;201502;1011;2920;780;2469;199;659;294;867;493;1526
351300;201502;11174;38144;8765;32781;2368;9782;2817;10368;5185;20150
351310;201502;3226;9895;2649;8863;528;2111;1325;4123;1853;6234
351320;201502;905;3090;786;2827;219;882;217;670;436;1552
351330;201502;291;813;246;737;106;322;60;175;166;497
351340;201502;5949;20114;5274;18772;1446;5526;2287;8085;3733;13611
351350;201502;7037;22801;6140;20893;1847;6636;2015;6470;3862;13106
351360;201502;4143;13016;3851;12486;932;3381;1710;5287;2642;8668
351370;201502;2240;6990;1797;6081;484;1847;597;1850;1081;3697
351380;201502;35587;106764;32441;100835;6626;22677;14998;45023;21624;67700
351385;201502;183;567;174;550;40;130;96;295;136;425
351390;201502;1155;3779;988;3443;322;1267;379;1202;701;2469
351400;201502;946;3132;885;2988;343;1210;310;1046;653;2256
351410;201502;2754;8336;2449;7811;453;1567;1393;4318;1846;5885
351420;201502;393;1145;268;893;63;224;63;206;126;430
351430;201502;837;2627;763;2501;76;261;584;1926;660;2187
351440;201502;3854;11439;3013;9613;846;2840;596;1670;1442;4510
351450;201502;1667;4711;1422;4383;391;1255;672;2162;1063;3417
351460;201502;779;2391;658;2179;306;1064;191;607;497;1671
351470;201502;1033;3120;909;2884;278;984;323;976;601;1960
351480;201502;2768;9109;2531;8717;518;2188;1316;4330;1834;6518
351490;201502;1863;6229;1660;5797;240;1026;987;3296;1227;4322
351492;201502;199;627;148;505;25;102;70;226;95;328
351495;201502;146;480;119;414;33;125;34;108;67;233
351500;201502;20977;62742;17019;55259;4830;17361;6625;20574;11455;37935
351510;201502;7993;25602;6820;23304;1664;6170;3337;11266;5001;17436
351512;201502;412;1190;340;1051;64;207;186;588;250;795
351515;201502;2285;7192;1691;5918;461;1735;461;1502;922;3237
351518;201502;1849;6034;1298;5000;351;1540;288;1010;639;2550
351519;201502;770;2363;623;2047;135;552;254;702;389;1254
351520;201502;808;2221;412;1447;70;284;64;200;134;484
351530;201502;372;1138;281;938;34;124;91;259;125;383
351535;201502;2343;6142;1880;5493;192;666;1311;3760;1503;4426
351540;201502;1763;5493;1478;4971;559;2069;259;817;818;2886
351550;201502;4527;13207;3289;10764;749;2817;1191;3774;1940;6591
351560;201502;379;1200;323;1073;73;272;70;224;143;496
351565;201502;206;682;188;634;48;195;80;242;128;437
351570;201502;11449;35814;9883;32702;2456;8753;5093;16471;7549;25224
351580;201502;359;992;244;751;55;174;79;235;134;409
351590;201502;426;1180;321;982;62;211;97;274;159;485
351600;201502;1646;4534;1458;4242;220;755;806;2224;1026;2979
351610;201502;660;1812;514;1561;74;266;246;697;320;963
351620;201502;18618;60054;14358;51243;3472;13843;3463;10839;6935;24682
351630;201502;17372;56706;15928;54320;3833;13719;9127;31148;12960;44867
351640;201502;9852;31246;8279;28449;1823;6914;4357;14679;6180;21593
351650;201502;414;1222;216;715;47;163;35;105;82;268
351660;201502;772;2435;581;1959;136;497;165;492;301;989
351670;201502;3901;12085;3233;10661;584;2280;1603;4943;2187;7223
351680;201502;683;2094;436;1479;94;334;79;251;173;585
351685;201502;431;1294;349;1156;91;305;151;514;242;819
351690;201502;1049;3078;727;2341;161;575;200;548;361;1123
351700;201502;1260;3647;1105;3361;318;995;457;1372;775;2367
351710;201502;650;2098;539;1857;106;374;205;656;311;1030
351720;201502;1612;4945;1124;3725;213;767;372;1115;585;1882
351730;201502;1012;2910;822;2651;291;1083;292;885;583;1968
351740;201502;4151;11430;3364;9870;752;2391;1165;3222;1917;5613
351750;201502;1165;3724;887;3099;229;926;310;974;539;1900
351760;201502;3711;11711;3174;10538;834;2991;1235;3885;2069;6876
351770;201502;2287;7082;1918;6456;533;1936;935;3066;1468;5002
351780;201502;1528;4278;936;2960;198;694;236;690;434;1384
351790;201502;1074;3201;942;3009;313;1023;413;1332;726;2355
351800;201502;419;938;310;791;42;115;175;437;217;552
351810;201502;1086;3123;997;3012;185;640;699;2069;884;2709
351820;201502;2001;6370;1619;5669;544;2009;190;641;734;2650
351830;201502;4016;12714;3172;10741;579;2229;1564;5018;2143;7247
351840;201502;7403;24727;6450;22873;1865;7156;2286;7901;4151;15057
351850;201502;1522;4599;1179;3926;229;925;476;1398;705;2323
351860;201502;3346;10667;2975;9909;818;2972;1326;4186;2144;7158
351870;201502;30583;93111;26841;86441;6676;23111;13670;43492;20346;66603
351880;201502;109437;352509;96251;324920;29293;104951;28712;95152;58005;200103
351885;201502;539;1946;501;1865;139;560;237;832;376;1392
351890;201502;693;2106;539;1779;133;494;137;404;270;898
351900;201502;1293;3972;1109;3685;303;1087;420;1399;723;2486
351905;201502;438;1438;372;1326;68;304;207;688;275;992
351907;201502;16062;49016;13711;44681;2379;9030;7783;24395;10162;33425
351910;201502;928;2851;842;2713;173;653;430;1321;603;1974
351920;201502;1037;2864;922;2687;136;471;601;1689;737;2160
351925;201502;924;2843;832;2669;126;483;491;1487;617;1970
351930;201502;2656;8789;2481;8442;577;2363;1438;4474;2015;6837
351940;201502;895;2649;808;2500;167;562;501;1501;668;2063
351950;201502;1382;3811;989;3072;152;519;522;1560;674;2079
351960;201502;4129;12208;3098;10352;750;2743;1437;4726;2187;7469
351970;201502;5472;19942;4861;18685;1532;6315;1676;6316;3208;12631
351980;201502;899;2676;704;2301;142;529;295;841;437;1370
351990;201502;1519;4337;1205;3734;313;1153;290;756;603;1909
352000;201502;2336;7520;2130;7113;543;1981;983;3111;1526;5092
352010;201502;1889;6371;1672;5871;462;1775;400;1356;862;3131
352020;201502;1396;4453;1216;4088;318;1176;445;1422;763;2598
352030;201502;4722;14072;3988;12992;972;3364;2180;7181;3152;10545
352040;201502;1918;6450;1603;5721;364;1440;408;1325;772;2765
352042;201502;2755;7864;1913;6012;405;1405;931;2847;1336;4252
352044;201502;1420;4772;1112;4028;250;1009;207;652;457;1661
352050;201502;7430;23823;5199;18886;1495;6056;1001;3111;2496;9167
352060;201502;772;2256;670;2094;166;629;284;800;450;1429
352070;201502;643;1778;588;1696;203;612;239;704;442;1316
352080;201502;460;1313;341;1098;68;253;140;412;208;665
352090;201502;1706;5534;1366;4809;323;1271;314;958;637;2229
352100;201502;2405;7378;1748;6112;435;1711;589;1874;1024;3585
352110;201502;493;1795;434;1661;132;547;158;575;290;1122
352115;201502;390;1266;333;1147;75;287;146;470;221;757
352120;201502;914;2798;789;2596;147;548;432;1396;579;1944
352130;201502;1855;5300;1310;4223;367;1247;422;1262;789;2509
352140;201502;1573;4749;1060;3614;208;767;470;1563;678;2330
352150;201502;710;2171;553;1869;137;478;247;812;384;1290
352160;201502;1075;3000;940;2802;183;586;533;1547;716;2133
352170;201502;2737;8287;2467;7772;557;1977;1311;3894;1868;5871
352180;201502;3450;9792;2937;8864;752;2518;1176;3325;1928;5843
352190;201502;1115;3377;1019;3215;200;710;549;1670;749;2380
352200;201502;388;1360;322;1232;51;219;187;731;238;950
352210;201502;16654;44664;13301;39803;2441;7680;7964;24346;10405;32026
352215;201502;553;1734;508;1675;74;291;303;986;377;1277
352220;201502;12495;41069;11256;38590;3659;13499;3746;12550;7405;26049
352230;201502;12988;43979;11311;40808;3356;13322;4345;15267;7701;28589
352240;201502;11296;34298;9454;31053;3013;11134;3432;10587;6445;21721
352250;201502;22560;72674;19941;67420;5615;20489;7412;24770;13027;45259
352260;201502;5330;15241;3325;11071;654;2494;1153;3565;1807;6059
352265;201502;875;2795;747;2583;99;444;455;1487;554;1931
352270;201502;2094;7099;1757;6355;543;2065;421;1448;964;3513
352280;201502;2353;7217;1942;6506;489;1879;664;2122;1153;4001
352290;201502;1168;3698;1009;3361;238;937;340;986;578;1923
352300;201502;905;2697;727;2372;190;689;308;941;498;1630
352310;201502;34643;108362;30285;101115;7706;27640;17209;57150;24915;84790
352320;201502;5715;17612;4959;16207;1477;5277;1636;4829;3113;10106
352330;201502;1883;6206;1647;5879;570;2173;543;1923;1113;4096
352340;201502;5585;18731;4514;16286;1298;5072;841;2762;2139;7834
352350;201502;1507;5369;1355;5036;301;1254;517;1833;818;3087
352360;201502;1087;3417;955;3158;205;835;582;1804;787;2639
352370;201502;890;3040;811;2874;162;677;397;1342;559;2019
352380;201502;954;3019;835;2815;282;1100;236;748;518;1848
352390;201502;17359;48210;11758;37405;2260;8339;5517;16335;7777;24674
352400;201502;3621;10268;2311;7725;580;2102;726;2253;1306;4355
352410;201502;3530;10573;2884;9464;899;3176;906;2847;1805;6023
352420;201502;981;2795;874;2614;258;872;425;1214;683;2086
352430;201502;6098;18982;5286;17673;1873;6856;1731;5665;3604;12521
352440;201502;15278;47083;12420;41549;3230;11645;4511;14785;7741;26430
352450;201502;649;1896;439;1493;109;419;99;295;208;714
352460;201502;2348;7772;2019;7174;657;2588;570;1883;1227;4471
352470;201502;4480;12362;2651;8573;461;1663;923;2801;1384;4464
352480;201502;4846;13352;3809;11466;768;2736;1585;4388;2353;7124
352490;201502;704;2454;579;2142;117;494;135;463;252;957
352500;201502;7516;23045;6962;22168;3314;11575;2018;5538;5332;17113
352510;201502;3084;10084;2479;8842;827;3236;576;1978;1403;5214
352520;201502;2151;7501;1910;6937;462;1820;934;3320;1396;5140
352530;201502;7491;24181;5614;19966;1612;6214;848;2706;2460;8920
352540;201502;485;1562;372;1314;56;239;108;360;164;599
352550;201502;886;2971;620;2317;153;655;108;354;261;1009
352560;201502;671;1986;500;1629;97;338;175;500;272;838
352570;201502;1647;5414;1225;4416;269;1121;270;845;539;1966
352580;201502;868;2563;741;2353;189;681;363;1085;552;1766
352585;201502;218;713;173;620;62;234;33;125;95;359
352590;201502;11370;36034;9942;33247;2305;8532;5267;16902;7572;25434
352600;201502;1603;4937;1430;4615;397;1399;630;1939;1027;3338
352610;201502;3273;10056;2756;9165;861;3176;842;2610;1703;5786
352620;201502;5050;15759;4742;15371;974;3432;3105;10044;4079;13476
352630;201502;651;2126;611;2026;150;570;288;917;438;1487
352640;201502;2856;8900;2331;7779;384;1458;1132;3654;1516;5112
352650;201502;834;2440;626;2001;137;471;202;607;339;1078
352660;201502;1008;3428;793;2925;181;750;189;645;370;1395
352670;201502;10425;31737;6353;22528;1687;6467;938;3072;2625;9539
352680;201502;3165;10855;2470;9220;554;2317;657;2165;1211;4482
352690;201502;29112;81821;20274;63741;4091;14228;9098;27435;13189;41663
352700;201502;765;2303;629;2092;189;712;285;899;474;1611
352710;201502;5596;16484;4195;13673;1055;3851;1538;4794;2593;8645
352720;201502;7579;24750;6924;23393;2080;7278;2627;8802;4707;16080
352725;201502;410;1162;255;835;38;155;92;271;130;426
352730;201502;2276;7623;2012;6924;437;1658;693;2138;1130;3796
352740;201502;1847;5302;1515;4745;292;1108;881;2590;1173;3698
352750;201502;378;1120;241;800;48;180;62;172;110;352
352760;201502;1051;3686;937;3449;280;1108;429;1504;709;2612
352770;201502;701;2170;615;2005;143;538;285;889;428;1427
352780;201502;606;2045;532;1875;116;474;173;553;289;1027
352790;201502;633;1817;465;1507;96;333;115;364;211;697
352800;201502;954;3444;699;2734;169;733;168;532;337;1265
352810;201502;1099;2853;742;2183;133;471;234;637;367;1108
352820;201502;592;1735;471;1553;164;578;96;309;260;887
352830;201502;490;1381;350;1099;74;263;65;166;139;429
352840;201502;3805;13107;3369;12176;1045;4020;1013;3634;2058;7654
352850;201502;8701;27447;7501;25347;1960;7114;2811;9399;4771;16513
352860;201502;817;2656;741;2483;205;761;248;749;453;1510
352870;201502;1001;2492;743;2008;79;296;445;1091;524;1387
352880;201502;2203;6382;1642;5190;365;1220;505;1479;870;2699
352885;201502;249;833;234;800;46;172;126;411;172;583
352890;201502;707;1914;536;1572;100;348;250;652;350;1000
352900;201502;19265;56758;14280;46621;3218;11523;5481;16943;8699;28466
352910;201502;258;821;196;687;50;194;27;86;77;280
352920;201502;2499;7511;2008;6577;529;1969;783;2294;1312;4263
352930;201502;5835;18391;4678;15823;1291;4725;1043;3334;2334;8059
352940;201502;25545;84940;21912;76450;7691;28405;3721;12278;11412;40683
352950;201502;334;1021;226;796;61;260;56;162;117;422
352960;201502;613;1883;405;1401;66;259;65;207;131;466
352965;201502;307;889;249;783;66;233;43;122;109;355
352970;201502;2946;7699;2522;7107;331;989;1741;4971;2072;5960
352980;201502;1446;4346;1226;3997;316;1056;632;2168;948;3224
352990;201502;3826;12365;3415;11637;1024;3931;1294;4187;2318;8118
353000;201502;491;1362;302;940;53;175;55;147;108;322
353010;201502;2943;8274;2189;6810;533;1905;718;2026;1251;3931
353020;201502;4233;11640;2834;8603;407;1426;1150;3132;1557;4558
353030;201502;4122;12092;3439;10843;1010;3457;879;2578;1889;6035
353040;201502;675;1932;574;1772;163;567;215;634;378;1201
353050;201502;5022;16848;4234;15258;1332;5271;1480;5008;2812;10279
353060;201502;33028;103463;30871;100091;3872;15302;22564;70465;26436;85767
353070;201502;9112;29634;6812;24577;1877;7291;1767;6305;3644;13596
353080;201502;4775;15572;3488;12668;902;3658;876;2877;1778;6535
353090;201502;517;1718;467;1612;53;235;259;831;312;1066
353100;201502;229;627;120;389;31;113;31;95;62;208
353110;201502;7247;22637;6440;21237;1547;5452;3509;11606;5056;17058
353120;201502;451;1477;377;1322;119;471;95;281;214;752
353130;201502;2601;7644;2172;6970;745;2637;763;2324;1508;4961
353140;201502;2368;6466;1820;5401;485;1580;689;1865;1174;3445
353150;201502;1742;5371;1436;4830;433;1584;391;1307;824;2891
353160;201502;623;1792;456;1443;123;396;82;216;205;612
353170;201502;458;1584;416;1512;126;532;181;633;307;1165
353180;201502;5998;18398;5183;16938;800;2995;3154;10060;3954;13055
353190;201502;3425;10696;2950;9648;591;2204;1464;4457;2055;6661
353200;201502;916;3093;766;2747;240;940;220;754;460;1694
353205;201502;496;1592;415;1420;91;318;163;559;254;877
353210;201502;959;2442;729;2040;39;146;532;1474;571;1620
353215;201502;471;1510;408;1368;70;274;138;412;208;686
353220;201502;693;2132;577;1882;126;436;178;549;304;985
353230;201502;967;3071;882;2923;231;852;253;766;484;1618
353240;201502;2029;6539;1833;6152;467;1775;892;2807;1359;4582
353250;201502;1070;2917;848;2527;159;508;381;1092;540;1600
353260;201502;880;2396;677;2072;113;411;332;951;445;1362
353270;201502;629;1894;542;1723;149;513;184;536;333;1049
353280;201502;585;1914;499;1744;142;546;143;485;285;1031
353282;201502;1593;5131;1521;5012;253;971;929;2909;1182;3880
353284;201502;310;855;196;624;42;137;57;183;99;320
353286;201502;143;418;99;317;25;83;13;41;38;124
353290;201502;506;1645;415;1480;120;474;189;637;309;1111
353300;201502;1499;4695;1268;4185;306;1149;482;1395;788;2544
353310;201502;215;649;187;596;55;197;74;208;129;405
353320;201502;504;1446;440;1338;85;289;241;705;326;994
353325;201502;535;1794;441;1589;82;336;70;203;152;539
353330;201502;577;1671;386;1238;77;295;176;502;253;797
353340;201502;2352;7239;1910;6393;585;2096;767;2537;1352;4633
353350;201502;3118;9412;2645;8567;846;2953;1167;3651;2013;6604
353360;201502;379;1248;331;1142;53;217;202;669;255;886
353370;201502;629;2067;551;1873;82;322;315;1038;397;1360
353380;201502;330;1088;287;1013;64;280;127;406;191;686
353390;201502;5804;15591;4128;12605;837;2911;1555;4296;2392;7207
353400;201502;497;1476;406;1293;111;403;111;294;222;697
353410;201502;595;1740;490;1573;110;396;274;868;384;1264
353420;201502;558;1554;407;1198;107;319;133;361;240;680
353430;201502;2404;8312;1768;6555;447;1739;172;570;619;2309
353440;201502;57842;187003;50190;169345;13983;49939;17328;56619;31311;106558
353450;201502;442;1354;376;1226;90;333;159;496;249;829
353460;201502;3574;9963;3084;9137;493;1596;1583;4767;2076;6363
353470;201502;9301;28179;6808;23148;1590;6114;1704;5409;3294;11523
353475;201502;1638;4684;1145;3608;215;733;338;966;553;1699
353480;201502;1461;4360;1292;4044;246;870;752;2267;998;3137
353490;201502;1162;3226;917;2757;212;713;335;899;547;1612
353500;201502;915;2528;792;2315;248;762;334;944;582;1706
353510;201502;1072;3426;860;2877;188;712;253;706;441;1418
353520;201502;1106;3240;873;2847;218;795;330;1065;548;1860
353530;201502;2549;7565;2269;7059;428;1538;1196;3580;1624;5118
353540;201502;1967;5940;1728;5535;443;1515;770;2459;1213;3974
353550;201502;6107;17009;5301;15764;666;2400;3360;9528;4026;11928
353560;201502;2147;7092;1787;6452;458;1859;627;2186;1085;4045
353570;201502;417;1291;345;1139;57;214;214;664;271;878
353580;201502;2187;6993;2031;6731;424;1633;1261;4081;1685;5714
353590;201502;695;1980;545;1720;166;567;164;514;330;1081
353600;201502;1713;4827;1546;4546;248;828;874;2505;1122;3333
353610;201502;578;1934;443;1638;93;412;128;427;221;839
353620;201502;2185;7209;1883;6620;533;2010;606;2005;1139;4015
353625;201502;280;758;182;585;45;165;64;195;109;360
353630;201502;1640;5617;1255;4640;257;1015;173;544;430;1559
353640;201502;1340;3852;1111;3378;188;574;584;1736;772;2310
353650;201502;6654;20064;4933;16385;1049;3776;1625;5112;2674;8888
353657;201502;316;993;282;922;48;181;109;330;157;511
353660;201502;1258;3244;923;2695;383;1225;161;340;544;1565
353670;201502;3930;12744;3328;11432;989;3867;1063;3282;2052;7149
353680;201502;640;2168;582;2061;261;994;207;709;468;1703
353690;201502;549;1459;339;1077;65;258;129;354;194;612
353700;201502;2169;6747;1878;6157;367;1341;735;2263;1102;3604
353710;201502;2936;7148;1325;4423;289;1025;280;883;569;1908
353715;201502;463;1345;359;1147;58;203;158;486;216;689
353720;201502;2023;6353;1755;5957;296;1143;1040;3485;1336;4628
353730;201502;4462;13669;3499;11583;784;2843;998;2994;1782;5837
353740;201502;2055;6173;1621;5289;484;1662;476;1513;960;3175
353750;201502;781;2649;609;2242;134;568;173;621;307;1189
353760;201502;8577;25033;7004;22482;1563;5531;3634;11543;5197;17074
353770;201502;790;2405;484;1661;98;371;41;64;139;435
353780;201502;4387;15105;3825;14003;1415;5510;1076;3944;2491;9454
353790;201502;1849;6507;1560;5912;454;1945;353;1301;807;3246
353800;201502;14927;46932;11843;41170;3160;12166;4520;15234;7680;27400
353810;201502;1034;3314;832;2878;195;767;300;988;495;1755
353820;201502;1194;4111;1093;3867;281;1172;523;1692;804;2864
353830;201502;749;2040;592;1764;109;352;270;790;379;1142
353850;201502;1610;5149;1478;4922;282;1042;757;2415;1039;3457
353860;201502;2368;7959;1976;7040;536;2057;540;1858;1076;3915
353870;201502;24042;73427;17892;60948;4044;15361;5781;17801;9825;33162
353880;201502;2430;7681;2041;7018;293;1244;1162;3896;1455;5140
353890;201502;2631;6538;1835;5254;386;1221;869;2372;1255;3593
353900;201502;1052;3293;779;2700;180;700;204;618;384;1318
353910;201502;1155;4239;1121;4170;316;1265;656;2383;972;3648
353920;201502;2320;6909;1724;5659;410;1440;298;859;708;2299
353930;201502;3598;12295;2921;10825;879;3508;675;2452;1554;5960
353940;201502;1239;3951;1024;3474;188;757;436;1348;624;2105
353950;201502;3441;10954;3143;10452;440;1731;2101;6779;2541;8510
353960;201502;590;1878;459;1595;95;370;116;332;211;702
353970;201502;541;1599;471;1502;42;160;351;1109;393;1269
353980;201502;13129;39500;11389;36293;2557;8779;5819;18240;8376;27019
353990;201502;398;1245;362;1167;76;290;143;414;219;704
354000;201502;1953;5648;1331;4426;292;1074;137;405;429;1479
354010;201502;362;1089;311;1005;92;307;144;476;236;783
354020;201502;4626;14118;4116;13006;1117;3895;1711;4990;2828;8885
354025;201502;896;2568;701;2235;169;579;201;620;370;1199
354030;201502;517;1410;367;1161;77;278;156;451;233;729
354040;201502;785;2127;599;1785;68;259;335;911;403;1170
354050;201502;956;3099;830;2853;260;1005;263;864;523;1869
354060;201502;5127;15957;3653;12713;912;3443;1272;4265;2184;7708
354070;201502;3062;10116;2665;9252;760;2856;574;1930;1334;4786
354075;201502;2089;7805;1989;7624;582;2480;917;3470;1499;5950
354080;201502;1687;5204;1218;4109;272;990;303;881;575;1871
354085;201502;295;764;266;718;20;75;213;554;233;629
354090;201502;1266;3778;1202;3679;130;439;912;2798;1042;3237
354100;201502;15651;52778;13231;48194;3387;13168;5970;21557;9357;34725
354105;201502;837;2595;731;2394;136;537;383;1157;519;1694
354110;201502;803;2272;656;2068;201;729;216;620;417;1349
354120;201502;1929;5352;1524;4598;307;1051;624;1714;931;2765
354130;201502;5675;16712;4578;14559;1861;6333;906;2516;2767;8849
354140;201502;24807;63119;15584;46267;3134;10199;5552;15276;8686;25475
354150;201502;4115;11173;3139;9445;671;2272;1464;4220;2135;6492
354160;201502;3645;11952;3133;10841;845;3193;1277;4268;2122;7461
354165;201502;354;1298;317;1210;102;433;92;347;194;780
354170;201502;1446;4527;1154;3861;225;864;437;1276;662;2140
354180;201502;488;1487;463;1445;60;235;293;840;353;1075
354190;201502;1429;4704;1211;4226;366;1415;382;1246;748;2661
354200;201502;1084;3086;886;2731;157;550;370;1021;527;1571
354210;201502;711;2359;619;2181;110;483;302;968;412;1451
354220;201502;2824;8482;2473;7816;662;2339;1087;3286;1749;5625
354230;201502;615;2031;566;1950;110;431;282;948;392;1379
354240;201502;1151;3780;878;3149;183;738;199;640;382;1378
354250;201502;650;1924;450;1566;183;714;122;404;305;1118
354260;201502;7733;23699;6985;22461;2045;7189;2676;8485;4721;15674
354270;201502;1133;3944;996;3637;265;1075;393;1431;658;2506
354280;201502;675;2061;628;1979;97;387;442;1320;539;1707
354290;201502;1037;3580;950;3414;239;939;360;1272;599;2211
354300;201502;3483;11745;3367;11536;895;3268;1745;5867;2640;9135
354310;201502;865;2737;662;2313;185;703;219;755;404;1458
354320;201502;759;2242;638;2006;160;565;214;610;374;1175
354323;201502;386;1098;301;937;67;233;98;266;165;499
354325;201502;1206;4041;1052;3678;223;904;420;1340;643;2244
354330;201502;6712;20583;5637;18470;1180;4373;2837;8785;4017;13158
354340;201502;26006;81576;21343;73244;6963;25945;7749;25794;14712;51739
354350;201502;1106;3302;1031;3167;271;917;536;1571;807;2488
354360;201502;431;1392;336;1206;64;244;29;98;93;342
354370;201502;1200;4067;1058;3786;151;662;652;2259;803;2921
354380;201502;1057;3157;847;2784;264;1039;139;353;403;1392
354390;201502;11869;36821;8630;30062;1982;7539;2057;6832;4039;14371
354400;201502;1727;5995;1434;5311;317;1261;461;1642;778;2903
354410;201502;5453;16728;4578;15231;931;3416;2330;7655;3261;11071
354420;201502;1248;3779;974;3181;256;920;368;1116;624;2036
354425;201502;2633;7451;2237;6739;716;2322;588;1703;1304;4025
354430;201502;1237;4077;1165;3951;294;1131;546;1774;840;2905
354440;201502;518;1538;398;1299;51;200;200;600;251;800
354450;201502;463;1337;277;933;45;190;62;180;107;370
354460;201502;801;2226;620;1920;198;663;246;735;444;1398
354470;201502;530;1502;419;1280;60;245;192;506;252;751
354480;201502;699;1985;601;1832;99;354;348;1014;447;1368
354490;201502;718;2386;568;2039;125;510;190;605;315;1115
354500;201502;2079;7033;1852;6609;719;2930;378;1228;1097;4158
354510;201502;691;2062;609;1916;110;359;379;1205;489;1564
354515;201502;309;1033;243;882;49;206;84;274;133;480
354520;201502;6525;21623;3950;14150;875;3625;1541;5166;2416;8791
354530;201502;2685;9471;2481;9067;669;2726;1216;4342;1885;7068
354540;201502;1217;3687;1004;3291;360;1318;192;558;552;1876
354550;201502;470;1454;408;1327;73;251;204;640;277;891
354560;201502;1489;4408;1111;3580;239;786;415;1285;654;2071
354570;201502;713;2136;522;1716;133;466;80;231;213;697
354580;201502;9861;28654;7889;24997;1632;5811;3493;10459;5125;16270
354600;201502;1565;5260;1389;4922;340;1441;660;2191;1000;3632
354610;201502;403;1163;260;833;37;112;56;151;93;263
354620;201502;375;1237;305;1111;83;361;127;429;210;790
354625;201502;254;844;212;760;50;206;65;222;115;428
354630;201502;1931;6529;1741;6121;794;2849;481;1620;1275;4469
354640;201502;3552;11630;2871;10168;721;2957;689;2172;1410;5129
354650;201502;874;2653;789;2491;102;364;515;1591;617;1955
354660;201502;2295;6752;1807;5900;364;1322;941;3072;1305;4394
354670;201502;1634;5333;1343;4616;378;1425;332;981;710;2406
354680;201502;4634;15510;4200;14606;1091;4151;1691;5666;2782;9817
354690;201502;769;2495;540;1941;99;376;172;579;271;955
354700;201502;1202;3397;819;2587;144;544;340;908;484;1452
354710;201502;514;1515;431;1355;79;295;195;549;274;844
354720;201502;195;545;151;460;49;145;40;119;89;264
354730;201502;7661;25423;6017;21910;1536;6141;2436;8558;3972;14699
354740;201502;243;729;173;606;38;138;46;166;84;304
354750;201502;2391;7309;1869;6426;568;2212;681;2249;1249;4461
354760;201502;2008;6503;1637;5679;477;1786;323;1042;800;2828
354765;201502;224;616;142;459;29;100;26;77;55;177
354770;201502;2172;6174;1702;5398;700;2392;366;1091;1066;3483
354780;201502;37438;112482;33334;103504;6927;23968;16745;49315;23672;73283
354790;201502;765;2451;649;2244;129;522;328;1052;457;1574
354800;201502;1833;5377;1630;5116;346;1220;1025;3218;1371;4438
354805;201502;931;2829;682;2268;81;295;135;410;216;705
354810;201502;598;1928;381;1384;85;360;71;199;156;559
354820;201502;1031;3571;896;3289;222;955;263;868;485;1823
354830;201502;387;1121;307;978;82;292;151;440;233;732
354840;201502;664;1936;560;1746;133;455;272;827;405;1282
354850;201502;15945;50507;12132;42735;3010;11813;4429;14475;7439;26288
354860;201502;1286;4141;1143;3892;248;987;537;1733;785;2720
354870;201502;42087;129282;38394;121570;9611;32610;17554;54648;27165;87258
354880;201502;3791;10929;2444;8083;489;1826;670;1826;1159;3652
354890;201502;15627;46817;13153;42123;3497;12035;4490;13887;7987;25922
354900;201502;476;1398;386;1250;110;384;142;457;252;841
354910;201502;6452;19351;3741;13339;653;2629;299;988;952;3617
354920;201502;434;1281;332;1096;84;316;89;276;173;592
354925;201502;354;1017;220;750;35;138;35;97;70;235
354930;201502;213;598;157;502;35;121;77;240;112;361
354940;201502;2218;7885;1762;6664;628;2531;242;827;870;3358
354950;201502;1459;4732;1282;4476;175;727;835;2883;1010;3610
354960;201502;762;2408;668;2256;183;689;271;891;454;1580
354970;201502;4045;13233;3551;12220;638;2571;1972;6506;2610;9077
354980;201502;33143;82414;19618;59701;4013;13775;6573;18516;10586;32291
354990;201502;43357;133105;35951;118095;7091;25799;18508;58873;25599;84672
354995;201502;1635;5112;1507;4931;325;1175;871;2820;1196;3995
355000;201502;1416;4617;1223;4278;374;1484;225;681;599;2165
355010;201502;3518;10962;2857;9503;751;2711;1174;3851;1925;6562
355020;201502;2672;9092;2138;8012;899;3656;496;1819;1395;5475
355030;201502;919132;2652944;812596;2442653;198651;651781;361589;1048225;560240;1700006
355040;201502;2534;7823;2241;7306;553;2018;1206;3805;1759;5823
355050;201502;1209;3748;975;3278;305;1095;225;753;530;1848
355060;201502;5099;17314;4140;15254;1052;4347;1014;3426;2066;7773
355070;201502;6650;20761;5971;19678;1319;5095;3199;9846;4518;14941
355080;201502;1145;3987;859;3288;201;892;115;352;316;1244
355090;201502;1103;3878;939;3503;200;830;396;1425;596;2255
355100;201502;20308;63990;17209;58780;5111;19009;6979;23406;12090;42415
355110;201502;1161;4004;1053;3772;316;1259;358;1240;674;2499
355120;201502;623;1994;532;1822;133;522;239;782;372;1304
355130;201502;558;1441;299;882;48;165;114;283;162;448
355140;201502;1030;3497;989;3420;232;894;504;1754;736;2648
355150;201502;3159;9594;2712;8855;662;2323;1344;4320;2006;6643
355160;201502;1531;4982;1319;4649;480;1925;408;1288;888;3213
355170;201502;9595;26673;6893;21947;2139;7360;1759;5557;3898;12917
355180;201502;2847;8783;2384;7926;627;2447;859;2610;1486;5057
355190;201502;1248;4281;1065;3884;408;1577;334;1171;742;2748
355200;201502;770;2789;715;2685;302;1219;181;646;483;1865
355210;201502;2519;8351;2268;7831;524;2126;1137;3679;1661;5805
355220;201502;28006;88054;23675;79907;8714;31228;6114;20142;14828;51370
355230;201502;1352;3789;759;2461;126;424;180;516;306;940
355240;201502;25502;74526;18348;59873;4013;14448;6794;20888;10807;35336
355250;201502;25426;83973;22749;78796;6840;25157;9515;32571;16355;57728
355255;201502;808;2275;574;1796;119;407;164;461;283;868
355260;201502;1352;3921;1208;3669;298;1040;500;1365;798;2405
355270;201502;1505;4571;1441;4477;133;522;1164;3535;1297;4057
355280;201502;23337;69030;19663;62117;4163;14932;8746;26244;12909;41176
355290;201502;805;2542;721;2398;145;526;338;1083;483;1609
355300;201502;992;3250;812;2864;193;737;272;916;465;1653
355310;201502;1001;3108;845;2820;156;573;439;1477;595;2050
355320;201502;596;1861;514;1677;99;394;200;542;299;936
355330;201502;1772;5632;1272;4649;344;1417;406;1423;750;2840
355340;201502;2527;6695;2315;6335;419;1261;1403;3714;1822;4975
355350;201502;1255;4334;1071;3937;302;1243;347;1197;649;2440
355360;201502;1101;3629;1009;3447;166;611;702;2442;868;3053
355365;201502;273;868;227;778;51;206;66;214;117;420
355370;201502;7182;17859;5164;15406;1440;4715;2220;6777;3660;11492
355380;201502;3384;10240;2630;8499;677;2452;551;1479;1228;3931
355385;201502;812;2601;758;2512;296;1080;246;745;542;1825
355390;201502;960;2732;777;2386;162;574;358;991;520;1565
355395;201502;1808;5424;1375;4470;226;814;592;1778;818;2592
355400;201502;8550;28391;7475;26223;2333;8956;2584;8653;4917;17609
355410;201502;14319;49453;12314;45234;4313;17171;2999;11077;7312;28248
355420;201502;752;2675;696;2550;238;947;220;804;458;1751
355430;201502;3549;10175;3002;9250;579;2015;1570;4655;2149;6670
355440;201502;865;2798;694;2367;136;500;210;634;346;1134
355450;201502;2587;8086;1863;6398;414;1558;613;1960;1027;3518
355460;201502;579;1590;427;1320;82;306;154;403;236;709
355465;201502;390;1189;331;1077;81;285;82;257;163;542
355470;201502;816;2520;669;2244;159;611;280;880;439;1491
355475;201502;111;435;99;399;20;84;41;172;61;256
355480;201502;3090;11165;2895;10763;838;3332;1364;4993;2202;8325
355490;201502;925;2658;665;2160;143;478;131;413;274;891
355495;201502;678;2289;610;2146;137;570;234;793;371;1363
355500;201502;8085;23371;5268;17300;943;3515;1126;3350;2069;6865
355510;201502;2018;5430;1214;3830;214;813;398;1121;612;1934
355520;201502;443;1098;252;728;41;138;101;261;142;399
355530;201502;319;737;135;408;14;46;39;113;53;159
355535;201502;710;2184;570;1927;171;661;143;403;314;1064
355540;201502;8308;26434;7856;25691;1969;6933;4293;13670;6262;20603
355550;201502;757;2252;654;2099;146;544;312;971;458;1515
355560;201502;1302;3872;921;3073;191;744;179;455;370;1199
355570;201502;185;584;145;499;23;81;24;64;47;145
355580;201502;1059;3044;815;2574;194;700;359;1091;553;1791
355590;201502;222;597;191;537;28;84;112;313;140;397
355600;201502;1123;3589;951;3218;374;1388;233;741;607;2129
355610;201502;1351;3812;1142;3475;238;818;542;1589;780;2407
355620;201502;3992;12617;3206;10828;646;2491;1373;4288;2019;6779
355630;201502;3326;9492;2082;6907;394;1482;614;1831;1008;3313
355635;201502;934;3051;807;2834;102;420;551;1937;653;2357
355640;201502;3279;10714;2560;9172;592;2396;394;1271;986;3667
355645;201502;3127;10995;2887;10583;494;2007;1828;6717;2322;8724
355650;201502;6674;20653;5792;18976;943;3718;3517;10813;4460;14531
355660;201502;1211;3818;983;3356;241;990;419;1328;660;2318
355670;201502;2426;7663;1701;5964;377;1544;653;2029;1030;3573
355680;201502;1452;4850;1115;4060;387;1520;257;886;644;2406
355690;201502;403;1262;295;1078;187;721;23;67;210;788
355695;201502;323;972;198;653;10;31;20;37;30;68
355700;201502;5731;19496;4974;17735;1352;5219;1975;6738;3327;11957
355710;201502;11375;28623;6959;20617;1870;6018;1836;5071;3706;11089
355715;201502;258;785;164;574;30;122;35;100;65;222
355720;201502;1585;5217;1317;4638;397;1537;381;1183;778;2720
355730;201502;714;2447;626;2256;211;783;140;497;351;1280
410010;201502;1481;4731;1320;4406;327;1211;393;1281;720;2492
410020;201502;1118;3794;1014;3580;277;1053;401;1372;678;2425
410030;201502;1092;3750;926;3342;266;1012;163;582;429;1594
410040;201502;9973;33359;8892;31199;2692;10616;2562;8568;5254;19184
410045;201502;995;2831;705;2261;181;641;216;635;397;1276
410050;201502;2238;6314;1434;4717;387;1351;262;803;649;2154
410060;201502;2165;6816;1933;6365;518;1873;788;2584;1306;4457
410070;201502;1730;4959;1340;4180;455;1580;283;752;738;2332
410080;201502;1202;3682;1024;3333;177;683;506;1532;683;2215
410090;201502;1034;3260;934;3067;275;1012;318;998;593;2010
410100;201502;2490;7610;1837;6103;514;1932;248;762;762;2694
410105;201502;416;1326;293;1032;59;250;43;113;102;363
410110;201502;2505;7540;2075;6724;426;1600;743;2277;1169;3877
410115;201502;504;1380;388;1154;58;192;156;428;214;620
410120;201502;2503;8645;2361;8421;789;2972;1047;3810;1836;6782
410130;201502;1154;3769;1033;3492;353;1222;330;1077;683;2299
410140;201502;15752;42042;10786;33102;2485;8528;3402;10210;5887;18738
410150;201502;16975;42056;8403;25035;1735;5721;1591;4208;3326;9929
410160;201502;2955;9320;2665;8833;794;2947;1001;3319;1795;6266
410165;201502;740;2177;595;1869;146;488;257;769;403;1257
410170;201502;1938;5734;1566;4962;506;1792;399;1195;905;2987
410180;201502;8845;28395;7657;25834;1883;7120;3112;9789;4995;16909
410185;201502;552;1538;469;1385;109;331;197;559;306;890
410190;201502;1961;5824;1631;5079;420;1436;382;1086;802;2522
410200;201502;3684;10386;2665;8333;596;2098;355;1007;951;3105
410210;201502;2450;7377;1874;6128;343;1301;430;1146;773;2447
410220;201502;632;1830;459;1478;91;330;136;411;227;741
410230;201502;1457;4694;1267;4351;402;1566;498;1614;900;3180
410240;201502;4220;12970;3795;12087;1108;4000;1263;3803;2371;7803
410250;201502;2483;6961;1710;5361;482;1686;319;910;801;2596
410260;201502;1550;4779;1317;4331;356;1282;490;1564;846;2846
410270;201502;503;1457;403;1260;74;269;164;489;238;758
410275;201502;857;2613;604;2047;97;356;300;1013;397;1369
410280;201502;2845;8408;2058;6746;435;1652;439;1303;874;2955
410290;201502;3314;10016;2827;9086;695;2434;1223;3938;1918;6372
410300;201502;659;1864;577;1694;78;265;288;758;366;1023
410302;201502;354;952;242;768;28;99;139;443;167;542
410304;201502;1240;4015;1121;3763;319;1118;444;1543;763;2661
410305;201502;1926;5111;1594;4598;403;1256;927;2669;1330;3925
410310;201502;2140;7068;1926;6690;451;1754;792;2712;1243;4466
410315;201502;698;2061;481;1636;109;388;145;463;254;851
410320;201502;1255;3712;811;2735;139;521;64;178;203;699
410322;201502;584;1746;415;1382;107;357;112;352;219;709
410330;201502;1302;3592;1080;3174;245;787;376;1062;621;1849
410335;201502;952;2826;818;2589;191;679;318;955;509;1634
410337;201502;768;2053;578;1685;88;312;240;611;328;923
410340;201502;519;1545;378;1181;49;190;148;391;197;581
410345;201502;1809;5275;1380;4390;366;1277;384;1132;750;2409
410347;201502;685;1860;435;1392;69;275;146;441;215;716
410350;201502;912;2780;636;2203;140;567;102;311;242;878
410360;201502;3134;9168;2645;8322;561;1946;1129;3480;1690;5426
410370;201502;12071;35147;8843;27900;1938;7017;2556;7099;4494;14116
410380;201502;1135;3578;1004;3289;161;609;524;1605;685;2214
410390;201502;2752;7983;2183;6918;775;2666;579;1641;1354;4307
410395;201502;861;2891;766;2688;178;730;360;1251;538;1981
410400;201502;4398;13977;3820;12847;957;3710;1421;4537;2378;8247
410405;201502;943;2733;757;2380;181;668;297;887;478;1555
410410;201502;1246;4125;1177;4022;408;1585;378;1193;786;2778
410420;201502;7714;25184;6552;22564;1964;7400;1340;4150;3304;11550
410425;201502;3267;10400;2362;8336;475;1857;289;951;764;2808
410430;201502;14793;40382;10807;32900;2449;8299;3416;10110;5865;18409
410440;201502;3060;9752;2724;9104;691;2567;1214;3981;1905;6548
410442;201502;2710;9241;2406;8532;761;2865;739;2617;1500;5482
410445;201502;2212;7407;1912;6861;538;2143;699;2594;1237;4737
410450;201502;2284;6515;1798;5580;588;1908;315;849;903;2757
410460;201502;2178;6505;1792;5754;453;1553;626;1885;1079;3438
410465;201502;1903;6599;1593;5896;425;1785;596;1998;1021;3783
410470;201502;1489;4841;1227;4226;309;1210;328;1104;637;2314
410480;201502;28613;81900;20870;65990;5866;20304;4144;12088;10010;32392
410490;201502;10795;34565;8593;29837;2380;9276;2464;8014;4844;17290
410500;201502;1584;4992;1300;4368;466;1734;382;1260;848;2994
410510;201502;2436;6487;1741;5099;373;1164;696;1847;1069;3011
410520;201502;3117;10950;2954;10613;1021;3901;1079;3874;2100;7775
410530;201502;1577;4416;1252;3774;241;859;534;1500;775;2359
410540;201502;3318;9880;2334;7833;550;1984;737;2442;1287;4426
410550;201502;6260;18197;4308;13939;901;3300;730;2106;1631;5406
410560;201502;1362;4201;1041;3485;252;949;276;735;528;1684
410570;201502;2501;8148;2250;7724;638;2308;859;3151;1497;5459
410580;201502;21568;66917;18012;59648;5125;18896;4906;15032;10031;33928
410590;201502;1298;4084;812;2729;129;463;166;478;295;941
410600;201502;1885;5571;1542;4896;358;1190;647;2070;1005;3260
410610;201502;739;2223;610;1974;106;417;265;800;371;1217
410620;201502;1426;5146;1169;4424;361;1450;177;642;538;2092
410630;201502;2440;7254;1828;5908;448;1603;427;1204;875;2807
410640;201502;4498;12673;3419;10660;1023;3696;750;2145;1773;5841
410645;201502;1100;3874;1049;3794;478;1874;290;1030;768;2904
410650;201502;2285;7081;1853;6166;627;2210;358;1126;985;3336
410655;201502;828;2458;660;2130;159;588;229;704;388;1292
410657;201502;675;1948;486;1554;107;397;189;532;296;929
410660;201502;2337;6684;1413;4615;326;1160;243;657;569;1817
410670;201502;902;2530;658;2052;156;532;183;501;339;1033
410680;201502;2653;9097;2186;7904;638;2310;706;2697;1344;5007
410685;201502;645;1861;566;1727;49;148;431;1337;480;1485
410690;201502;106879;311231;74602;243886;17244;62445;17401;51068;34645;113513
410700;201502;2230;6930;2078;6640;596;2089;891;2747;1487;4836
410710;201502;909;2775;655;2175;171;623;181;521;352;1144
410712;201502;808;2461;698;2254;272;966;216;718;488;1684
410715;201502;946;2998;766;2599;173;652;298;963;471;1615
410720;201502;3347;9874;2457;7992;581;2125;642;1916;1223;4041
410725;201502;1037;2928;741;2354;126;429;132;353;258;782
410730;201502;469;1386;410;1265;147;506;114;335;261;841
410740;201502;855;2558;600;2038;110;433;274;934;384;1367
410750;201502;1741;5103;1445;4495;341;1173;475;1351;816;2524
410752;201502;273;782;179;577;36;141;70;196;106;337
410753;201502;446;1302;293;954;59;224;105;314;164;538
410754;201502;1000;3107;872;2895;91;335;585;2001;676;2336
410755;201502;812;2074;632;1789;77;261;389;1065;466;1326
410760;201502;2159;6757;1939;6339;592;2109;692;2147;1284;4256
410765;201502;15937;47450;11712;38971;2559;9604;1553;4784;4112;14388
410770;201502;900;2500;683;2074;200;658;198;572;398;1230
410773;201502;1348;3911;1143;3594;256;938;612;1823;868;2761
410775;201502;1527;4456;1432;4319;327;1042;771;2331;1098;3373
410780;201502;512;1426;386;1209;105;334;160;562;265;896
410785;201502;691;2237;572;1948;224;800;131;447;355;1247
410790;201502;520;1621;430;1416;101;378;101;262;202;640
410800;201502;2652;6765;2048;5788;537;1759;798;2075;1335;3834
410810;201502;316;970;257;836;38;141;115;374;153;515
410820;201502;917;2763;719;2309;185;650;146;426;331;1076
410830;201502;31308;91464;25470;81299;7584;26916;8882;27602;16466;54518
410832;201502;999;2978;879;2755;130;487;504;1484;634;1971
410840;201502;6751;20011;4600;15424;1281;4691;578;1673;1859;6364
410845;201502;1325;3919;1107;3456;186;664;526;1571;712;2235
410850;201502;2770;8228;2481;7787;551;1999;1326;4149;1877;6148
410855;201502;562;1560;409;1232;98;339;158;406;256;745
410860;201502;3593;10159;2920;8904;531;1774;1374;4140;1905;5914
410865;201502;1620;5591;1510;5376;382;1462;832;3018;1214;4480
410870;201502;1220;3757;1122;3603;528;1788;375;1178;903;2966
410880;201502;4202;12865;3352;11268;771;2907;747;2280;1518;5187
410890;201502;1013;3218;790;2778;189;734;73;218;262;952
410895;201502;1065;3722;959;3492;358;1412;281;963;639;2375
410900;201502;826;2318;607;1948;118;469;213;623;331;1092
410910;201502;406;1083;344;980;52;177;188;509;240;686
410920;201502;749;2241;602;1975;148;545;240;756;388;1301
410930;201502;1774;5252;1497;4763;372;1417;602;1854;974;3271
410940;201502;20206;67048;17795;62610;5319;20633;6622;23501;11941;44134
410950;201502;1787;5937;1649;5694;311;1126;1043;3637;1354;4763
410960;201502;7053;19602;4607;14987;1423;5105;1189;3724;2612;8829
410965;201502;1004;3117;886;2895;301;1032;344;1101;645;2133
410970;201502;4428;13403;3527;11611;1117;4218;733;2345;1850;6563
410975;201502;1545;4477;1264;3973;221;823;573;1779;794;2602
410980;201502;5509;15552;3378;11209;742;2743;601;1902;1343;4645
410990;201502;851;2490;529;1776;168;618;89;233;257;851
411000;201502;446;1340;308;1023;69;262;51;138;120;400
411005;201502;479;1417;315;1022;78;259;49;137;127;396
411007;201502;2198;7031;1930;6432;567;2002;688;2270;1255;4272
411010;201502;3723;12891;3367;12124;1114;4561;730;2404;1844;6965
411020;201502;2549;8074;2282;7618;776;2925;744;2442;1520;5367
411030;201502;632;1731;505;1498;129;436;154;408;283;844
411040;201502;591;1721;301;976;67;247;71;217;138;464
411050;201502;2092;7398;1866;6895;574;2322;309;1049;883;3371
411060;201502;1612;5023;1341;4436;310;1124;191;548;501;1672
411065;201502;361;1104;282;942;54;189;110;351;164;540
411070;201502;5369;16674;4065;13909;1152;4374;652;1967;1804;6341
411080;201502;2111;6494;1892;6082;537;1931;577;1763;1114;3694
411090;201502;728;1795;535;1514;89;328;135;334;224;662
411095;201502;1580;4432;1159;3597;236;831;299;836;535;1667
411100;201502;1373;3982;1006;3252;183;682;200;562;383;1244
411110;201502;694;2070;458;1540;75;271;74;200;149;471
411120;201502;1753;5333;1361;4494;386;1400;426;1320;812;2720
411125;201502;4095;13524;3959;13249;1241;4475;1722;5600;2963;10075
411130;201502;716;2186;572;1864;134;470;177;585;311;1055
411140;201502;2096;7445;1806;6760;625;2447;507;1972;1132;4419
411150;201502;4478;12584;3477;10572;898;3068;741;1906;1639;4974
411155;201502;934;2592;746;2235;164;571;326;886;490;1457
411160;201502;229;662;192;586;39;134;68;190;107;324
411170;201502;662;2185;557;1938;136;517;211;701;347;1218
411180;201502;5631;16867;4694;15123;1172;4223;1608;5063;2780;9286
411190;201502;1440;4108;1202;3666;302;1081;365;991;667;2072
411200;201502;4397;13085;3565;11678;963;3565;1389;4372;2352;7937
411210;201502;2088;6045;1677;5299;616;2094;286;870;902;2964
411220;201502;1120;3200;920;2836;219;801;402;1116;621;1917
411230;201502;1200;3381;765;2488;213;779;178;504;391;1283
411240;201502;1296;3092;715;2159;161;511;231;657;392;1168
411250;201502;2450;7243;2057;6519;568;1961;599;1850;1167;3811
411260;201502;301;829;197;640;33;120;89;280;122;400
411270;201502;1761;5641;1591;5318;358;1381;781;2492;1139;3873
411275;201502;1389;4162;1155;3624;312;1049;291;847;603;1896
411280;201502;1473;4427;1079;3583;236;893;225;672;461;1565
411290;201502;776;2230;629;1926;157;503;232;691;389;1194
411295;201502;869;2492;791;2339;148;469;352;1060;500;1529
411300;201502;1244;3185;892;2489;84;265;395;1041;479;1306
411310;201502;826;2331;637;1993;91;326;237;731;328;1057
411320;201502;5587;16378;4155;13593;1138;3918;928;2860;2066;6778
411325;201502;1486;4699;1301;4330;243;911;777;2575;1020;3486
411330;201502;3305;10387;2854;9549;1022;3780;841;2725;1863;6505
411340;201502;913;2677;589;1926;108;406;232;733;340;1139
411342;201502;702;2013;576;1746;148;498;174;445;322;943
411345;201502;965;3031;882;2876;242;875;425;1392;667;2267
411350;201502;2782;8266;1922;6487;517;1938;232;723;749;2661
411360;201502;599;1532;393;1154;49;184;172;425;221;609
411370;201502;46452;132549;35720;112600;6839;25215;13400;38887;20239;64102
411373;201502;1411;4444;1183;3993;312;1194;327;1070;639;2264
411375;201502;1057;2945;797;2441;182;602;285;835;467;1437
411380;201502;1284;3435;772;2340;122;401;241;679;363;1080
411390;201502;1695;5028;1455;4606;342;1217;583;1746;925;2963
411400;201502;1945;5679;1469;4621;301;1055;392;1129;693;2184
411410;201502;2098;6329;1613;5194;410;1513;438;1199;848;2712
411420;201502;4204;12222;3100;9756;597;2155;570;1394;1167;3549
411430;201502;3000;9486;2550;8689;749;2779;1075;3602;1824;6381
411435;201502;401;1305;327;1110;86;319;133;423;219;742
411440;201502;2731;8863;2483;8381;881;3162;711;2493;1592;5655
411450;201502;2218;6800;2012;6421;440;1455;1151;3720;1591;5175
411460;201502;3233;9577;1864;6330;417;1591;230;629;647;2220
411470;201502;853;2546;570;1866;106;385;107;289;213;674
411480;201502;4196;12774;3206;10811;1032;3953;645;2013;1677;5966
411490;201502;1412;4328;1203;3954;355;1336;323;916;678;2252
411500;201502;1809;4990;1281;4017;322;1119;331;1001;653;2120
411510;201502;2065;6192;1642;5340;493;1801;378;1041;871;2842
411520;201502;26447;72217;16170;50588;3476;11995;3532;10215;7008;22210
411530;201502;963;2771;659;2194;218;827;104;276;322;1103
411535;201502;512;1526;247;882;40;164;28;78;68;242
411540;201502;2846;7648;2136;6342;324;1048;1073;3155;1397;4203
411545;201502;957;3265;878;3112;156;601;592;2124;748;2725
411550;201502;792;2151;631;1900;246;824;154;443;400;1267
411560;201502;2389;7191;1836;5909;431;1535;367;1037;798;2572
411570;201502;6334;17367;4682;14611;1240;4349;1074;3424;2314;7773
411573;201502;898;2731;850;2650;152;508;530;1664;682;2172
411575;201502;1401;4464;1192;4018;242;879;457;1531;699;2410
411580;201502;3700;10699;2582;8401;503;1950;408;1064;911;3014
411585;201502;570;1908;364;1300;89;346;64;215;153;561
411590;201502;420;1278;365;1180;75;280;173;529;248;809
411600;201502;291;865;213;724;47;192;80;261;127;453
411605;201502;2015;5468;1358;4181;234;824;575;1688;809;2512
411610;201502;2107;5888;1840;5495;334;1085;1248;3686;1582;4771
411620;201502;2642;8493;2464;8189;721;2566;1144;3855;1865;6421
411630;201502;443;1143;257;851;48;199;50;153;98;352
411640;201502;496;1496;392;1287;77;275;147;429;224;704
411650;201502;188;622;163;579;40;172;62;199;102;371
411660;201502;804;2270;641;1954;135;453;272;826;407;1279
411670;201502;1211;3384;1023;2997;251;850;418;1123;669;1973
411680;201502;1391;4377;1260;4133;210;672;855;2939;1065;3611
411690;201502;3339;9992;2714;8824;765;2647;681;2248;1446;4895
411695;201502;740;2406;594;2092;141;540;201;719;342;1259
411700;201502;1807;5279;1292;4232;279;1029;314;934;593;1963
411705;201502;2133;7284;1881;6778;430;1563;1039;3877;1469;5440
411710;201502;1754;5264;1376;4449;327;1153;373;1119;700;2272
411720;201502;782;2313;591;1889;99;348;154;445;253;793
411721;201502;703;2132;601;1936;178;627;106;305;284;932
411722;201502;658;1947;489;1581;99;374;145;397;244;771
411725;201502;1364;4414;872;3152;198;752;182;648;380;1400
411727;201502;1905;5596;1525;4793;358;1249;579;1694;937;2943
411729;201502;521;1421;377;1169;120;414;102;277;222;691
411730;201502;5379;15654;4553;14114;1988;6340;1258;3992;3246;10332
411740;201502;584;1694;395;1260;66;248;152;451;218;699
411745;201502;887;2679;726;2340;163;549;223;700;386;1249
411750;201502;4445;13425;3360;10879;874;3196;726;2141;1600;5337
411760;201502;7756;22967;6781;21302;2267;7805;2087;6514;4354;14319
411770;201502;3287;11220;2782;10008;931;3598;578;2066;1509;5664
411780;201502;2602;8460;2496;8346;180;538;2081;7351;2261;7889
411790;201502;2841;8169;2117;6743;593;2203;686;2078;1279;4281
411800;201502;1405;4061;904;2937;135;512;164;433;299;945
411810;201502;1504;4481;1290;4055;320;1146;438;1222;758;2368
411820;201502;14969;47125;12454;42392;4283;15203;3371;11843;7654;27046
411830;201502;428;1163;337;1028;153;469;34;114;187;583
411840;201502;9811;28918;7604;24713;2046;7264;1900;5967;3946;13231
411845;201502;517;1602;367;1235;61;231;97;284;158;515
411850;201502;6309;19078;5316;17094;1407;4894;1557;4965;2964;9859
411860;201502;853;2688;693;2354;188;659;204;655;392;1314
411870;201502;902;3085;661;2426;102;424;182;636;284;1060
411880;201502;2136;6200;1751;5512;490;1785;402;1066;892;2851
411885;201502;815;2224;655;1924;137;520;242;624;379;1144
411890;201502;1107;3384;719;2447;130;499;121;342;251;841
411900;201502;957;3077;694;2424;188;664;114;403;302;1067
411910;201502;1183;3976;995;3551;310;1222;290;953;600;2175
411915;201502;13561;38243;9081;29005;1936;6851;2174;6342;4110;13193
411920;201502;932;3204;807;2897;228;951;139;413;367;1364
411925;201502;587;1658;388;1293;106;368;107;340;213;708
411930;201502;5960;19713;5318;18488;1744;6507;1854;6488;3598;12995
411940;201502;3242;10864;2821;10001;799;3032;695;2388;1494;5420
411950;201502;11019;35210;9254;31696;2399;8998;4138;13920;6537;22918
411960;201502;5067;15314;4648;14513;1167;4098;2073;6293;3240;10391
411965;201502;591;1669;436;1424;83;316;168;566;251;882
411970;201502;750;2151;605;1927;180;641;184;554;364;1195
411980;201502;1491;4629;1279;4183;227;794;511;1686;738;2480
411990;201502;27008;89700;22933;81144;6568;25867;6443;22499;13011;48366
411995;201502;2532;7885;2201;7230;779;2906;527;1583;1306;4489
412000;201502;2081;5501;1684;4834;306;1053;846;2206;1152;3259
412010;201502;715;2417;588;2125;146;555;125;417;271;972
412015;201502;654;1983;533;1727;101;350;259;837;360;1187
412020;201502;385;1100;263;841;71;259;98;281;169;540
412030;201502;678;2122;470;1638;91;381;133;410;224;791
412033;201502;691;2083;482;1586;102;383;110;308;212;691
412035;201502;949;2640;684;2164;162;557;272;817;434;1374
412040;201502;556;1806;464;1586;109;408;170;549;279;957
412050;201502;1694;5051;1325;4308;310;1162;275;836;585;1998
412060;201502;6470;22535;5878;21307;1758;6857;2316;8441;4074;15298
412065;201502;884;2675;703;2275;179;657;227;668;406;1325
412070;201502;1143;3136;921;2697;169;512;337;973;506;1485
412080;201502;1374;4249;828;2962;140;576;58;152;198;728
412085;201502;352;1009;147;494;33;129;39;110;72;239
412090;201502;4246;13923;4036;13542;676;2534;2669;9013;3345;11547
412100;201502;1937;6191;1700;5735;526;1926;531;1723;1057;3649
412110;201502;1058;3016;706;2261;164;589;194;603;358;1192
412120;201502;1882;6403;1657;5881;431;1734;707;2348;1138;4082
412125;201502;757;2412;661;2252;147;540;282;964;429;1504
412130;201502;587;1774;455;1502;89;334;116;358;205;692
412135;201502;500;1426;358;1139;77;282;139;404;216;686
412140;201502;1496;4542;1240;4007;309;1066;354;1138;663;2204
412150;201502;3032;8879;2627;8091;387;1367;1561;4675;1948;6042
412160;201502;1007;3262;640;2305;173;719;163;550;336;1269
412170;201502;4278;13730;3521;12266;1085;4114;1296;4405;2381;8519
412175;201502;1314;4548;1164;4211;307;1222;493;1772;800;2994
412180;201502;1676;5221;1264;4430;340;1337;365;1249;705;2586
412190;201502;2970;8737;2283;7539;651;2372;643;2147;1294;4519
412200;201502;2267;7435;1603;5697;360;1404;511;1784;871;3188
412210;201502;721;2028;425;1404;88;346;59;178;147;524
412215;201502;3519;10972;3208;10418;556;1780;2069;6966;2625;8746
412217;201502;1087;3130;998;2976;137;511;703;1979;840;2490
412220;201502;5207;17404;4987;17006;1515;5410;2719;9291;4234;14701
412230;201502;2829;9495;2455;8748;661;2684;746;2528;1407;5212
412240;201502;9454;24484;5307;16548;998;3575;912;2492;1910;6067
412250;201502;1853;5536;1600;5000;419;1452;386;1062;805;2514
412260;201502;1256;3547;813;2585;137;520;278;780;415;1300
412265;201502;1019;3158;898;2943;187;729;448;1436;635;2165
412270;201502;688;2168;499;1747;119;471;124;405;243;876
412280;201502;601;1888;451;1570;232;852;45;148;277;1000
412290;201502;1025;2961;815;2543;164;571;286;822;450;1393
412300;201502;1868;5646;1560;5048;461;1657;402;1241;863;2898
412310;201502;1070;3163;960;3005;117;365;659;2208;776;2573
412320;201502;774;2148;564;1770;141;501;187;590;328;1091
412330;201502;1633;4608;1282;3919;221;759;685;2064;906;2823
412340;201502;835;2607;572;1942;81;305;98;315;179;620
412350;201502;2401;7543;1955;6571;541;1965;270;791;811;2756
412360;201502;269;825;189;620;23;93;71;195;94;288
412370;201502;807;2540;658;2235;185;707;175;557;360;1264
412380;201502;1668;5240;1407;4643;373;1334;421;1313;794;2647
412382;201502;683;1964;476;1531;100;340;135;402;235;742
412385;201502;2430;7688;2197;7166;676;2357;707;2281;1383;4638
412390;201502;2106;6182;1906;5841;537;1836;755;2322;1292;4158
412395;201502;897;2535;724;2250;101;326;428;1324;529;1650
412400;201502;1007;3157;879;2914;261;912;302;1028;563;1940
412402;201502;1885;5740;1552;5023;424;1555;412;1137;836;2692
412405;201502;3532;10251;2270;7501;484;1853;277;809;761;2662
412410;201502;4595;14814;3990;13640;1372;5494;824;2609;2196;8103
412420;201502;376;1118;277;892;56;216;108;280;164;496
412430;201502;482;1397;389;1210;88;316;157;441;245;757
412440;201502;3432;10422;2853;9422;527;1923;1222;4118;1749;6041
412450;201502;309;987;241;819;41;147;38;89;79;236
412460;201502;834;2490;625;2066;163;633;165;486;328;1119
412470;201502;1888;6457;1679;5947;554;2049;569;2057;1123;4106
412480;201502;1318;3894;920;3012;197;698;129;335;326;1033
412490;201502;909;2731;791;2483;166;552;255;738;421;1290
412500;201502;1954;5743;1653;5152;409;1463;408;1078;817;2541
412510;201502;2249;7576;1956;6848;543;2053;851;2978;1394;5031
412520;201502;1520;4347;1219;3756;328;1085;349;1028;677;2113
412530;201502;650;1901;530;1644;118;368;155;465;273;833
412535;201502;588;1742;376;1232;97;350;80;221;177;571
412540;201502;1188;3468;925;2929;154;561;312;983;466;1544
412545;201502;848;2440;672;2052;105;372;278;761;383;1133
412550;201502;26265;79425;18250;61449;4836;17634;3564;11190;8400;28824
412555;201502;318;960;216;716;42;161;40;103;82;264
412560;201502;5160;16442;4113;14273;1027;4087;975;3094;2002;7181
412570;201502;4259;12842;3018;10027;714;2717;582;1795;1296;4512
412575;201502;898;2760;716;2333;168;613;204;612;372;1225
412580;201502;1261;3481;917;2883;195;638;271;813;466;1451
412590;201502;396;1155;284;932;67;250;84;272;151;522
412600;201502;1414;4341;1186;3877;318;1173;388;1183;706;2356
412610;201502;621;1880;459;1487;118;453;149;408;267;861
412620;201502;1184;3855;947;3348;264;1049;185;606;449;1655
412625;201502;10588;29528;8022;24649;2086;7024;1577;4411;3663;11435
412627;201502;954;2917;636;2228;210;799;48;153;258;952
412630;201502;3271;10453;2799;9436;680;2426;920;2985;1600;5411
412635;201502;472;1454;334;1140;77;292;32;97;109;389
412640;201502;872;2645;618;2074;129;463;86;243;215;706
412650;201502;1975;5817;1631;5148;404;1465;536;1478;940;2943
412660;201502;2828;8337;2259;7164;481;1705;494;1421;975;3126
412665;201502;659;1711;369;1183;130;451;87;265;217;716
412667;201502;1505;4509;1216;3931;308;1139;294;884;602;2023
412670;201502;655;2049;444;1539;102;400;77;205;179;605
412680;201502;1294;3926;855;2921;173;661;237;718;410;1379
412690;201502;703;2205;542;1847;202;738;108;357;310;1095
412700;201502;1787;5692;1550;5313;569;2197;497;1645;1066;3842
412710;201502;8050;25286;6766;22675;1745;6540;1700;5352;3445;11892
412720;201502;1441;4509;995;3363;200;734;162;448;362;1182
412730;201502;2165;6495;1427;4817;333;1266;186;481;519;1747
412740;201502;1331;4334;1081;3772;298;1156;227;799;525;1955
412750;201502;3677;11694;3295;11064;559;2211;2129;6989;2688;9200
412760;201502;2265;7501;2155;7318;579;2263;1053;3392;1632;5655
412770;201502;11512;32339;6993;22516;1198;4315;1417;3993;2615;8308
412780;201502;1259;4078;1104;3748;288;1055;377;1209;665;2264
412785;201502;2321;6797;1700;5472;400;1430;781;2438;1181;3868
412788;201502;1399;4525;1270;4269;298;1157;463;1392;761;2549
412790;201502;1153;3480;930;3032;218;790;249;727;467;1517
412795;201502;930;2684;804;2462;234;747;260;771;494;1518
412796;201502;2771;8668;2563;8274;695;2534;1034;3108;1729;5642
412800;201502;3127;8927;2371;7426;498;1763;820;2431;1318;4194
412810;201502;10234;28278;5853;18680;1038;3680;1186;3191;2224;6871
412820;201502;6910;20586;5067;16973;1345;4911;1114;3761;2459;8672
412830;201502;334;1035;273;908;57;240;86;249;143;489
412840;201502;1887;5502;1540;4820;349;1213;408;1179;757;2392
412850;201502;2527;7642;2166;7061;409;1587;999;3060;1408;4647
412853;201502;1470;4221;1314;3945;144;557;815;2263;959;2820
412855;201502;1479;4302;1154;3612;340;1230;315;845;655;2075
412860;201502;1204;3498;1001;3116;215;762;440;1321;655;2083
412862;201502;751;1946;522;1497;87;278;209;553;296;831
412863;201502;1259;4237;1214;4162;194;719;824;2813;1018;3532
412865;201502;678;2111;510;1707;106;378;200;689;306;1067
412870;201502;901;2570;737;2302;258;890;194;578;452;1468
412880;201502;1069;3002;845;2617;211;727;244;684;455;1411
420005;201502;534;1592;353;1186;75;279;129;414;204;693
420010;201502;3155;9356;2605;8509;354;1245;1875;6262;2229;7507
420020;201502;785;2566;472;1727;75;329;54;148;129;477
420030;201502;545;1478;288;983;68;277;44;141;112;418
420040;201502;838;2590;532;1953;135;556;89;258;224;814
420050;201502;705;2153;533;1758;154;540;199;619;353;1159
420055;201502;242;721;152;506;31;109;30;85;61;194
420060;201502;242;819;168;622;45;194;25;80;70;274
420070;201502;1394;4459;1120;3802;180;661;595;2067;775;2728
420075;201502;196;563;109;361;23;92;34;100;57;192
420080;201502;618;1981;495;1724;164;613;119;415;283;1028
420090;201502;537;1837;399;1531;112;465;68;257;180;722
420100;201502;1325;4232;1203;4063;292;1034;700;2384;992;3418
420110;201502;351;1184;310;1096;85;312;127;454;212;766
420120;201502;312;1076;265;978;90;368;58;195;148;563
420125;201502;304;1201;277;1139;95;413;92;351;187;764
420127;201502;536;1613;216;804;65;253;25;91;90;344
420130;201502;1958;6519;1648;5930;436;1739;531;1742;967;3481
420140;201502;5393;15809;3774;12737;1006;3814;667;2042;1673;5856
420150;201502;769;2142;459;1503;101;376;159;465;260;841
420160;201502;305;882;193;640;33;126;54;167;87;293
420165;201502;216;682;132;460;27;109;33;101;60;210
420170;201502;213;654;141;511;47;210;19;45;66;255
420180;201502;427;1323;251;903;51;194;51;175;102;369
420190;201502;509;1537;277;996;58;235;42;129;100;364
420195;201502;1406;4091;1134;3699;283;985;521;1749;804;2734
420200;201502;2992;9716;1907;7161;551;2332;317;1045;868;3377
420205;201502;937;3124;828;2927;198;767;401;1400;599;2167
420207;201502;1467;4312;1021;3376;299;1142;272;798;571;1940
420208;201502;519;1496;328;1145;120;461;88;292;208;753
420209;201502;341;1086;212;769;41;172;70;235;111;407
420210;201502;1555;4809;998;3780;241;1130;186;630;427;1760
420213;201502;839;3006;793;2896;142;529;526;1962;668;2491
420215;201502;411;1357;282;1026;78;305;48;164;126;469
420220;201502;195;683;174;642;48;206;60;170;108;376
420230;201502;4244;12614;3120;10526;658;2603;1365;4403;2023;7006
420240;201502;12330;33727;7430;24670;1237;5049;3046;9028;4283;14077
420243;201502;600;1857;481;1598;105;413;168;529;273;942
420245;201502;1093;3299;736;2538;161;625;175;513;336;1138
420250;201502;587;1937;556;1884;164;647;248;809;412;1456
420253;201502;557;1488;446;1332;84;256;247;784;331;1040
420257;201502;325;943;218;743;38;139;112;379;150;518
420260;201502;1255;4024;1070;3701;254;1002;485;1668;739;2670
420270;201502;492;1529;142;527;26;107;30;95;56;202
420280;201502;2399;6439;1460;4734;300;1179;530;1519;830;2698
420285;201502;155;456;66;239;6;23;3;10;9;33
420287;201502;591;1825;503;1660;135;465;173;573;308;1038
420290;201502;6598;19482;4240;14098;889;3271;1236;3772;2125;7043
420300;201502;6382;19645;4292;15146;1039;4122;844;2930;1883;7052
420310;201502;771;2270;728;2201;134;436;480;1416;614;1852
420315;201502;974;3152;776;2747;226;893;293;1021;519;1914
420320;201502;5320;16555;4428;14975;1259;4749;1793;5916;3052;10665
420325;201502;357;1173;337;1132;80;299;129;419;209;718
420330;201502;1100;3849;843;3146;213;889;212;681;425;1570
420340;201502;1473;4591;1137;3822;251;926;245;765;496;1691
420350;201502;1370;4342;1137;3860;294;1056;470;1596;764;2652
420360;201502;3175;9838;2186;7595;619;2439;301;869;920;3308
420370;201502;1981;5515;1620;4956;158;468;1319;4070;1477;4538
420380;201502;4822;15786;3746;13242;1025;4014;944;3211;1969;7225
420390;201502;1680;4807;912;3152;194;785;195;570;389;1355
420395;201502;1600;5014;1128;3931;202;802;176;495;378;1297
420400;201502;1368;4002;967;3212;263;1042;276;823;539;1865
420410;201502;794;2132;541;1712;136;481;287;892;423;1373
420415;201502;463;1481;346;1189;118;425;96;317;214;742
420417;201502;779;2498;666;2221;124;440;342;1137;466;1577
420419;201502;411;1266;270;985;117;476;43;149;160;625
420420;201502;11979;36100;9238;30591;2823;10563;2687;8342;5510;18905
420425;201502;1340;3703;864;2732;95;374;362;1043;457;1417
420430;201502;3420;10494;2210;7689;509;1976;738;2517;1247;4493
420435;201502;289;906;205;709;42;176;100;327;142;503
420440;201502;1206;3367;645;2184;256;945;107;328;363;1273
420445;201502;338;1032;292;942;62;204;151;490;213;694
420450;201502;1091;3107;621;2116;122;471;133;379;255;850
420455;201502;1979;6089;1742;5679;358;1418;833;2624;1191;4042
420460;201502;8845;26667;6795;22953;1615;6410;2583;8265;4198;14675
420470;201502;1209;3258;755;2394;201;735;208;603;409;1338
420475;201502;129;390;67;239;18;68;9;27;27;95
420480;201502;4732;14074;3773;12400;1506;5600;474;1426;1980;7026
420490;201502;742;2016;432;1478;116;422;127;431;243;853
420500;201502;1862;5839;1470;5099;456;1769;644;2175;1100;3944
420510;201502;121;493;110;467;47;203;38;155;85;358
420515;201502;118;403;96;357;18;78;17;65;35;143
420517;201502;901;2794;805;2618;148;547;470;1498;618;2045
420519;201502;478;1341;359;1113;64;208;127;386;191;594
420520;201502;653;1702;479;1474;118;418;270;806;388;1224
420530;201502;1151;3899;882;3239;227;958;205;617;432;1575
420535;201502;273;819;165;584;55;220;20;55;75;275
420540;201502;20848;60766;14853;47806;4072;14471;4074;11776;8146;26247
420543;201502;418;1125;313;950;32;123;192;612;224;735
420545;201502;1630;5123;1308;4434;333;1301;419;1307;752;2608
420550;201502;4433;14351;3432;12108;851;3546;830;2641;1681;6187
420555;201502;443;1366;354;1188;104;392;114;352;218;744
420560;201502;551;1614;469;1454;76;252;240;744;316;996
420570;201502;2019;6586;1625;5661;455;1801;526;1716;981;3517
420580;201502;1277;4103;1044;3698;293;1166;455;1601;748;2767
420590;201502;3184;9766;2189;7466;518;1942;408;1232;926;3174
420600;201502;804;2687;732;2524;154;568;342;1218;496;1786
420610;201502;522;1649;324;1190;95;396;66;213;161;609
420620;201502;846;2595;721;2377;219;782;230;744;449;1526
420630;201502;1094;3395;769;2631;171;638;238;717;409;1355
420640;201502;727;2252;356;1335;86;370;27;77;113;447
420650;201502;2229;6685;1325;4619;261;1040;234;706;495;1746
420660;201502;511;1492;409;1301;74;277;197;600;271;877
420665;201502;780;2201;492;1616;81;281;140;413;221;694
420670;201502;1667;5178;1219;4181;242;971;264;773;506;1744
420675;201502;220;679;150;516;28;105;54;178;82;283
420680;201502;531;1284;321;967;62;210;110;308;172;518
420690;201502;881;3056;647;2393;123;482;163;525;286;1007
420700;201502;3732;10780;2842;8974;664;2455;882;2615;1546;5070
420710;201502;600;2022;473;1772;147;611;151;546;298;1157
420720;201502;1618;4792;1322;4400;272;973;837;2812;1109;3785
420730;201502;3456;10406;2828;9274;761;2745;1137;3562;1898;6307
420740;201502;824;2617;726;2443;183;648;421;1414;604;2062
420750;201502;2321;7349;1590;5615;290;1211;488;1488;778;2699
420757;201502;113;301;62;225;13;59;24;81;37;140
420760;201502;341;1054;233;766;48;183;56;151;104;334
420765;201502;580;1816;298;1104;56;236;52;163;108;399
420768;201502;1208;4263;955;3694;302;1241;347;1323;649;2564
420770;201502;705;2028;372;1300;76;310;91;288;167;598
420775;201502;699;2220;444;1528;121;421;92;298;213;719
420780;201502;1642;4998;1070;3598;277;1019;227;687;504;1706
420785;201502;326;993;236;762;43;152;76;221;119;373
420790;201502;1334;4642;1064;3968;297;1229;434;1533;731;2762
420800;201502;820;2347;446;1485;133;516;92;265;225;781
420810;201502;2386;8172;1898;7046;619;2604;486;1735;1105;4339
420820;201502;8232;26290;6105;22452;1773;7378;1869;6805;3642;14183
420830;201502;2559;8312;2154;7580;734;2841;780;2673;1514;5514
420840;201502;1035;3019;594;2134;155;629;158;515;313;1144
420845;201502;1294;4121;1000;3554;320;1306;223;718;543;2024
420850;201502;1728;5444;1040;3965;293;1261;156;579;449;1840
420860;201502;500;1424;321;1089;94;369;135;449;229;818
420870;201502;1227;3421;930;2994;308;1148;310;901;618;2049
420880;201502;1176;3911;923;3257;208;816;196;613;404;1429
420890;201502;13269;32022;5993;18915;1066;3822;1778;4860;2844;8682
420895;201502;243;662;123;399;35;112;13;35;48;147
420900;201502;2132;5973;1278;4288;282;1068;310;930;592;1998
420910;201502;23398;70808;15530;54403;3367;13579;4367;14174;7734;27753
420915;201502;544;2164;453;1914;117;524;213;878;330;1402
420917;201502;442;1362;221;706;53;198;83;219;136;417
420920;201502;193;536;90;298;35;128;10;25;45;153
420930;201502;18716;54447;14937;48128;3848;13945;5266;16452;9114;30397
420940;201502;4021;12146;3305;10612;892;3254;767;2052;1659;5306
420945;201502;212;665;138;489;37;153;32;102;69;255
420950;201502;618;1731;277;1028;40;191;33;94;73;285
420960;201502;1110;3244;927;2943;218;830;422;1230;640;2060
420970;201502;2507;8074;2217;7561;602;2333;989;3369;1591;5702
420980;201502;438;1343;336;1165;110;392;147;566;257;958
420985;201502;522;1495;264;929;57;229;78;253;135;482
420990;201502;813;2246;519;1765;110;430;169;523;279;953
421000;201502;577;1999;392;1524;92;402;61;198;153;600
421003;201502;692;1899;274;913;41;151;43;94;84;245
421005;201502;225;717;181;642;50;194;91;315;141;509
421010;201502;5986;17380;4147;13975;1154;4442;1018;3075;2172;7517
421020;201502;512;1633;401;1422;66;238;205;771;271;1009
421030;201502;948;3511;885;3357;310;1252;307;1173;617;2425
421040;201502;720;2049;559;1778;125;452;259;775;384;1227
421050;201502;1962;5356;1162;3826;299;1130;267;724;566;1854
421055;201502;234;715;138;483;39;159;41;118;80;277
421060;201502;467;1627;364;1347;68;280;127;443;195;723
421070;201502;746;2333;482;1694;120;484;107;358;227;842
421080;201502;510;1559;441;1443;89;305;262;841;351;1146
421085;201502;563;1489;299;1013;67;257;73;260;140;517
421090;201502;396;1097;240;767;38;140;104;312;142;452
421100;201502;968;2867;660;2211;181;626;145;435;326;1061
421105;201502;1443;4473;1219;4086;282;1040;481;1646;763;2686
421110;201502;1154;4128;1043;3914;393;1579;280;1018;673;2597
421120;201502;1525;4800;1067;3725;190;801;323;996;513;1797
421125;201502;412;1180;303;986;83;312;116;354;199;666
421130;201502;3524;11592;2958;10543;1037;4149;951;3362;1988;7511
421140;201502;373;1127;290;945;58;215;118;364;176;579
421145;201502;574;1859;401;1386;63;244;173;576;236;820
421150;201502;541;1703;409;1465;99;394;164;583;263;977
421160;201502;1145;3342;619;2091;122;480;224;703;346;1183
421165;201502;284;1002;222;811;42;154;99;365;141;519
421170;201502;1521;4564;1237;4079;262;968;732;2390;994;3358
421175;201502;1213;3486;911;3005;214;903;364;1057;578;1960
421180;201502;603;1686;325;1095;77;296;94;272;171;568
421185;201502;423;1191;301;953;55;168;149;496;204;664
421187;201502;294;912;220;755;45;164;109;364;154;528
421189;201502;459;1431;405;1328;89;309;155;487;244;796
421190;201502;10905;32458;7012;24223;1658;6231;1530;4967;3188;11198
421200;201502;973;3242;840;2966;211;832;289;960;500;1792
421205;201502;242;770;188;660;45;194;46;123;91;317
421210;201502;1666;5086;1296;4185;368;1270;382;1169;750;2439
421220;201502;2155;7323;1880;6740;627;2489;506;1776;1133;4265
421223;201502;737;2125;491;1684;127;470;196;653;323;1123
421225;201502;1131;3524;930;3116;231;861;346;1141;577;2002
421227;201502;794;2644;700;2495;153;549;451;1648;604;2197
421230;201502;588;1945;516;1785;125;484;213;690;338;1174
421240;201502;470;1527;278;975;40;154;64;198;104;352
421250;201502;1842;5389;1187;4209;365;1442;279;930;644;2372
421260;201502;378;1090;121;453;23;84;30;107;53;191
421265;201502;525;1735;463;1606;114;411;172;598;286;1009
421270;201502;779;2120;432;1441;123;442;111;408;234;850
421280;201502;1629;5162;1308;4641;403;1602;465;1624;868;3226
421290;201502;1718;4567;942;3049;207;726;209;571;416;1297
421300;201502;306;942;252;827;73;278;106;325;179;603
421310;201502;317;1036;250;863;60;218;78;252;138;470
421315;201502;392;1167;232;835;44;164;35;130;79;294
421320;201502;548;1809;370;1340;69;275;58;157;127;432
421330;201502;500;1756;418;1589;154;677;63;227;217;904
421335;201502;561;1836;456;1634;114;454;97;360;211;814
421340;201502;1712;5058;1421;4577;210;831;898;2846;1108;3677
421350;201502;898;2981;718;2591;180;745;241;798;421;1543
421360;201502;3135;9109;1996;6895;415;1665;620;1971;1035;3636
421370;201502;784;2614;629;2266;184;749;206;695;390;1444
421380;201502;1032;2968;827;2585;145;510;408;1267;553;1777
421390;201502;149;437;78;270;11;35;35;128;46;163
421400;201502;312;1123;239;952;77;339;64;241;141;580
421410;201502;328;961;229;764;34;118;124;421;158;539
421415;201502;349;1162;174;653;44;176;44;149;88;325
421420;201502;936;2873;658;2216;134;509;164;481;298;990
421430;201502;248;784;189;666;42;169;42;144;84;313
421440;201502;879;2583;594;2046;153;578;231;756;384;1334
421450;201502;578;1836;387;1431;97;406;61;202;158;608
421460;201502;648;1761;328;1145;50;210;78;252;128;462
421470;201502;435;1514;348;1317;92;376;146;548;238;924
421480;201502;2754;7974;1666;5878;392;1619;378;1160;770;2779
421490;201502;298;923;135;521;37;160;26;91;63;251
421500;201502;2335;8022;2021;7370;742;3088;435;1521;1177;4609
421505;201502;395;1329;349;1224;80;303;161;553;241;856
421507;201502;600;1844;396;1387;65;233;155;566;220;799
421510;201502;207;704;184;662;40;184;92;286;132;470
421520;201502;835;2252;558;1684;59;234;282;772;341;1006
421530;201502;424;1311;244;907;43;199;80;291;123;490
421535;201502;703;2102;404;1460;79;306;190;654;269;960
421540;201502;365;1012;298;889;66;215;121;347;187;562
421545;201502;1014;3386;776;2900;219;952;171;588;390;1540
421550;201502;1979;6543;1704;6027;540;2207;502;1654;1042;3861
421555;201502;347;1049;142;513;24;97;20;66;44;163
421560;201502;235;716;111;394;24;95;23;80;47;175
421565;201502;945;2870;849;2714;321;1148;319;971;640;2119
421567;201502;885;3252;760;2937;364;1466;151;572;515;2038
421568;201502;525;1672;381;1338;99;362;103;365;202;727
421569;201502;185;577;107;394;29;124;25;78;54;202
421570;201502;1268;3960;693;2531;200;815;145;509;345;1324
421575;201502;507;1703;443;1574;72;282;271;961;343;1243
421580;201502;3610;11451;2769;9592;821;3256;673;2008;1494;5264
421590;201502;234;724;190;641;34;120;103;338;137;458
421600;201502;601;1804;456;1504;130;481;104;313;234;794
421605;201502;636;1937;449;1573;95;405;116;354;211;759
421610;201502;1538;4231;1279;3823;184;636;753;2182;937;2818
421620;201502;4830;14645;3300;11420;979;3708;1074;3691;2053;7399
421625;201502;366;1076;174;606;27;99;51;182;78;281
421630;201502;2745;8161;1541;5312;361;1396;254;798;615;2194
421635;201502;267;796;167;554;25;88;82;252;107;340
421640;201502;1048;3238;838;2830;136;456;528;1834;664;2290
421650;201502;2160;7119;1819;6347;613;2424;309;964;922;3388
421660;201502;8716;27894;6850;24145;1874;7516;2170;7081;4044;14597
421670;201502;1068;3376;741;2623;209;834;218;741;427;1575
421680;201502;1244;4107;1072;3695;379;1401;208;677;587;2078
421690;201502;1908;6230;1463;5158;338;1316;226;714;564;2030
421700;201502;613;1783;327;1132;73;308;91;231;164;539
421710;201502;269;903;157;580;51;200;46;164;97;364
421715;201502;284;779;160;520;45;160;45;133;90;293
421720;201502;1767;5387;1177;4164;410;1600;304;1016;714;2616
421725;201502;112;382;104;364;39;153;29;101;68;254
421730;201502;620;1825;309;1097;67;256;57;158;124;414
421740;201502;725;2242;502;1717;122;493;108;271;230;764
421750;201502;1166;3217;781;2448;161;564;355;1018;516;1582
421755;201502;361;1103;241;806;53;212;75;224;128;436
421760;201502;618;2053;351;1278;80;336;117;400;197;736
421770;201502;3032;9083;2281;7546;689;2450;694;2260;1383;4710
421775;201502;596;1742;389;1366;88;327;112;377;200;704
421780;201502;1414;4670;1054;3859;300;1234;380;1307;680;2541
421790;201502;927;2542;533;1876;143;587;163;530;306;1117
421795;201502;357;1069;231;753;37;145;75;236;112;381
421800;201502;2567;7832;1920;6584;422;1690;775;2447;1197;4137
421810;201502;710;2279;538;1898;142;526;84;288;226;814
421820;201502;1154;3378;762;2595;130;510;190;565;320;1075
421825;201502;1498;4955;1402;4729;221;888;889;2876;1110;3764
421830;201502;2610;9002;2384;8556;550;2240;1176;4117;1726;6357
421835;201502;150;434;110;373;27;118;60;181;87;299
421840;201502;363;1215;295;1052;75;303;101;331;176;634
421850;201502;481;1403;310;1045;77;297;94;309;171;606
421860;201502;369;1146;241;872;44;172;53;171;97;343
421870;201502;4717;13366;3248;10420;922;3214;645;1982;1567;5196
421875;201502;428;1285;198;747;47;209;37;123;84;332
421880;201502;966;3058;762;2606;180;717;199;628;379;1345
421885;201502;329;1075;275;971;77;285;98;331;175;616
421890;201502;966;3283;826;2988;260;1078;268;921;528;1999
421895;201502;368;1213;329;1138;70;236;197;714;267;950
421900;201502;751;2394;596;2024;159;564;164;507;323;1071
421910;201502;538;1696;391;1368;88;347;113;350;201;697
421915;201502;567;1712;406;1348;87;299;113;337;200;636
421917;201502;575;1728;439;1496;128;523;154;474;282;997
421920;201502;798;2243;527;1873;216;813;182;644;398;1457
421930;201502;3388;9180;2040;6758;521;1954;397;1190;918;3144
421935;201502;765;2610;583;2200;134;588;207;737;341;1325
421940;201502;266;923;164;621;31;142;36;102;67;244
421950;201502;4078;11356;2091;7119;566;2076;362;1195;928;3271
421960;201502;239;751;194;650;51;190;52;157;103;347
421970;201502;2174;6334;1442;4723;514;1812;313;917;827;2729
421985;201502;511;1319;280;857;51;189;84;266;135;455
422000;201502;925;2733;748;2402;173;601;327;1079;500;1680
430003;201502;858;2502;669;2172;187;686;205;637;392;1323
430005;201502;285;913;236;810;44;165;138;464;182;629
430010;201502;2134;5865;1587;4921;403;1312;640;2021;1043;3333
430020;201502;794;2002;660;1810;81;264;464;1221;545;1485
430030;201502;1122;2938;845;2444;289;926;175;449;464;1375
430040;201502;11828;30660;9587;26965;2820;8428;2961;8073;5781;16501
430045;201502;742;2063;593;1763;104;352;333;964;437;1316
430047;201502;271;676;160;489;24;70;68;209;92;279
430050;201502;1144;3069;708;2219;145;496;182;522;327;1018
430055;201502;298;839;186;583;27;94;95;289;122;383
430057;201502;69;155;26;70;4;12;7;13;11;25
430060;201502;15697;50875;13731;47415;3808;13871;6769;23803;10577;37674
430063;201502;1024;3028;826;2610;212;698;402;1304;614;2002
430064;201502;1617;4769;1332;4293;377;1251;599;1966;976;3217
430066;201502;172;434;130;368;17;60;77;203;94;263
430070;201502;588;1583;261;839;58;204;69;184;127;388
430080;201502;632;1981;464;1616;103;397;144;470;247;867
430085;201502;741;2035;515;1637;130;469;197;607;327;1076
430087;201502;1027;3146;976;3046;123;435;716;2183;839;2618
430090;201502;879;2324;320;1060;42;161;59;197;101;358
430100;201502;918;2480;556;1724;151;520;166;445;317;965
430105;201502;836;2612;626;2201;176;709;162;523;338;1232
430107;201502;252;846;193;664;29;116;70;226;99;342
430110;201502;1855;5378;1585;4959;411;1390;755;2297;1166;3687
430120;201502;1691;5014;1297;4197;258;892;695;2201;953;3093
430130;201502;4022;10527;3534;9827;633;1917;2061;5683;2694;7600
430140;201502;1199;3737;885;3048;257;922;299;1003;556;1925
430150;201502;872;2312;580;1770;143;478;149;434;292;912
430155;201502;449;1305;286;966;43;150;117;395;160;545
430160;201502;16190;48085;14796;45836;2682;9288;8908;27634;11590;36922
430163;201502;1770;5345;1497;4856;291;1094;761;2473;1052;3567
430165;201502;451;1136;152;504;36;135;46;137;82;272
430170;201502;821;2375;387;1341;71;263;69;206;140;469
430175;201502;970;3059;782;2610;188;582;341;1237;529;1819
430180;201502;936;2568;773;2298;169;581;414;1172;583;1753
430185;201502;785;1964;413;1252;65;213;118;302;183;515
430187;201502;681;2033;520;1683;125;475;184;539;309;1014
430190;201502;1758;5286;1546;4879;303;1111;914;2809;1217;3920
430192;201502;190;586;95;301;6;17;26;77;32;94
430195;201502;304;927;90;327;8;29;10;34;18;63
430200;201502;1711;5511;1454;4972;435;1577;398;1344;833;2921
430205;201502;496;1431;375;1212;48;189;250;789;298;978
430210;201502;6509;17512;3555;11298;756;2606;763;2227;1519;4833
430215;201502;358;1047;255;824;50;174;107;338;157;512
430220;201502;725;1859;312;1021;56;202;62;190;118;392
430222;201502;300;899;231;752;38;160;104;314;142;474
430223;201502;346;1003;303;940;60;191;192;617;252;808
430225;201502;47;126;27;83;6;16;8;20;14;36
430230;201502;1883;5938;1759;5813;188;482;1530;5245;1718;5727
430235;201502;280;918;226;785;61;235;55;175;116;410
430237;201502;517;1398;386;1161;49;178;245;718;294;896
430240;201502;949;2483;625;1932;144;527;251;726;395;1253
430245;201502;946;2959;724;2483;190;678;329;1158;519;1836
430250;201502;1413;3980;1242;3685;512;1607;303;886;815;2493
430258;201502;172;492;126;407;17;64;51;165;68;229
430260;201502;848;2389;579;1840;71;255;310;1006;381;1261
430265;201502;326;1004;259;862;78;255;34;98;112;353
430270;201502;2901;8190;2535;7586;453;1605;1485;4225;1938;5830
430280;201502;4625;12896;3826;11458;930;2980;1767;5245;2697;8225
430290;201502;2449;6556;2262;6318;180;512;1961;5554;2141;6066
430300;201502;9420;28061;7698;24771;2255;7781;3126;10251;5381;18032
430310;201502;7139;22119;5900;19764;1642;6048;2410;7671;4052;13719
430320;201502;863;2520;592;1983;115;345;286;1020;401;1365
430330;201502;782;2107;617;1788;172;516;264;700;436;1216
430340;201502;786;1980;445;1473;94;355;208;687;302;1042
430350;201502;6272;19648;5319;17619;1877;6550;1841;5977;3718;12527
430355;201502;342;856;146;447;30;104;24;53;54;157
430360;201502;1088;2844;909;2511;176;550;444;1143;620;1693
430367;201502;312;810;193;601;44;150;60;187;104;337
430370;201502;503;1447;380;1209;108;385;94;265;202;650
430380;201502;876;2236;468;1491;115;392;171;556;286;948
430390;201502;4519;12988;3251;10422;783;2698;867;2670;1650;5368
430400;201502;1431;3438;995;2768;300;928;411;1053;711;1981
430410;201502;701;1887;529;1599;95;313;273;830;368;1143
430420;201502;3998;11583;3128;9666;806;2631;1301;3958;2107;6589
430430;201502;832;2269;532;1702;156;549;144;443;300;992
430435;201502;1958;5356;1537;4599;349;1133;782;2327;1131;3460
430440;201502;4220;13179;3338;11257;588;2082;1768;6215;2356;8297
430450;201502;7847;22101;6176;18827;2271;7394;1539;4631;3810;12025
430460;201502;28172;83939;22131;73083;6248;22494;7732;25447;13980;47941
430461;201502;509;1393;175;559;29;105;48;152;77;257
430462;201502;309;881;230;743;88;322;59;172;147;494
430463;201502;4081;13036;3550;12041;810;2999;1769;6029;2579;9028
430465;201502;657;1769;556;1597;116;378;345;960;461;1338
430466;201502;3644;10233;3244;9611;656;2184;1859;5346;2515;7530
430467;201502;583;1742;511;1630;108;385;255;778;363;1163
430468;201502;1451;4155;1270;3884;467;1527;391;1189;858;2716
430469;201502;245;693;65;244;8;35;16;60;24;95
430470;201502;7645;20376;5401;16548;1645;5485;1152;3435;2797;8920
430471;201502;834;2740;751;2571;257;933;185;630;442;1563
430480;201502;1006;2688;549;1766;83;287;133;372;216;659
430485;201502;224;648;113;384;21;77;39;131;60;208
430490;201502;456;1296;314;1032;87;300;112;372;199;672
430495;201502;406;1191;265;890;47;177;72;206;119;383
430500;201502;1345;3745;1090;3306;326;1109;462;1365;788;2474
430510;201502;20028;60098;16507;53364;5720;20328;5032;15312;10752;35640
430511;201502;476;1427;219;749;32;120;39;107;71;227
430512;201502;1221;3181;1063;2916;276;785;395;1126;671;1911
430513;201502;754;2062;483;1487;88;275;218;676;306;951
430515;201502;510;1516;387;1253;69;221;195;640;264;861
430517;201502;1365;4376;1160;3946;233;835;690;2350;923;3185
430520;201502;1603;4511;1169;3621;308;1061;438;1270;746;2331
430530;201502;988;2760;524;1685;86;320;140;403;226;723
430535;201502;2168;6747;1717;5802;404;1573;625;2033;1029;3606
430537;201502;517;1614;438;1452;44;139;330;1116;374;1255
430540;201502;739;1694;505;1387;98;288;301;808;399;1096
430543;201502;534;1389;472;1326;92;285;342;961;434;1246
430544;201502;699;2214;585;1975;119;439;315;1032;434;1471
430545;201502;1311;4226;1129;4003;367;1327;562;2134;929;3461
430550;201502;687;2004;456;1518;103;380;171;560;274;940
430558;201502;87;254;43;150;14;60;7;19;21;79
430560;201502;405;1008;242;720;30;107;82;230;112;337
430570;201502;1156;2955;760;2199;183;611;347;893;530;1504
430580;201502;1217;3254;749;2409;234;793;199;659;433;1452
430583;201502;160;438;53;176;4;15;4;12;8;27
430585;201502;366;962;240;695;65;209;99;260;164;469
430587;201502;229;701;195;636;59;206;64;216;123;422
430590;201502;1375;3860;1307;3752;219;708;917;2606;1136;3314
430593;201502;26;101;23;90;6;32;9;29;15;61
430595;201502;252;693;89;306;22;87;13;40;35;127
430597;201502;355;1053;259;829;51;182;73;202;124;384
430600;201502;2213;6019;1298;4002;263;861;420;1265;683;2126
430605;201502;1347;4121;1064;3544;235;868;458;1555;693;2423
430607;201502;766;1966;589;1681;86;262;368;1068;454;1330
430610;201502;8680;23228;6662;20033;1722;5692;2517;7573;4239;13265
430613;201502;265;653;118;360;28;79;25;63;53;142
430620;201502;756;2191;593;1845;146;511;252;725;398;1236
430630;201502;428;1287;234;771;52;174;38;109;90;283
430632;201502;742;2049;437;1378;83;298;212;619;295;917
430635;201502;694;1913;509;1561;108;363;240;727;348;1090
430637;201502;510;1463;453;1345;66;238;291;823;357;1061
430640;201502;1695;4486;744;2407;73;229;100;228;173;457
430642;201502;509;1340;309;975;58;197;123;378;181;575
430645;201502;194;529;100;319;17;56;28;93;45;149
430650;201502;1906;6233;1645;5715;331;1173;971;3470;1302;4643
430655;201502;203;577;171;511;34;118;73;178;107;296
430660;201502;5760;16377;4526;14202;1161;4022;1843;5740;3004;9762
430670;201502;495;1461;446;1366;33;105;338;1063;371;1168
430673;201502;716;1724;372;1134;80;263;153;452;233;715
430675;201502;289;843;130;420;23;81;49;150;72;231
430676;201502;3460;10524;2987;9734;839;2930;1096;3608;1935;6538
430680;201502;1152;3425;849;2775;172;648;304;887;476;1535
430690;201502;4433;12614;3568;10942;1087;3503;1208;3778;2295;7281
430692;201502;309;1045;224;880;29;119;139;548;168;667
430693;201502;1440;4023;988;3082;173;645;286;797;459;1442
430695;201502;524;1489;377;1202;85;313;139;392;224;705
430697;201502;480;1355;365;1158;105;326;140;486;245;812
430700;201502;9681;25185;4622;15286;885;3268;393;1234;1278;4502
430705;201502;285;878;254;829;82;295;75;226;157;521
430710;201502;1820;4687;1377;3952;301;942;599;1743;900;2685
430720;201502;920;2250;612;1809;168;545;223;661;391;1206
430730;201502;1766;4694;1258;3863;277;831;616;2003;893;2834
430740;201502;584;1629;342;1127;92;328;59;179;151;507
430745;201502;546;1539;334;1029;72;240;80;239;152;479
430750;201502;1800;4948;1443;4345;299;1009;719;2060;1018;3069
430755;201502;572;1522;371;1096;47;168;164;431;211;599
430760;201502;3246;7952;2315;6652;439;1446;1147;3425;1586;4871
430770;201502;6677;19341;5232;16675;1001;3541;2766;8693;3767;12234
430780;201502;2455;6621;1518;4806;328;1145;551;1691;879;2836
430781;201502;598;1751;414;1376;109;378;126;398;235;776
430783;201502;544;1350;380;1085;73;239;187;497;260;736
430786;201502;82;265;57;197;9;31;20;68;29;99
430790;201502;4597;12630;3120;9627;649;2297;1247;3553;1896;5850
430800;201502;850;2495;572;1836;126;430;195;590;321;1020
430805;201502;511;1439;371;1184;45;140;220;737;265;877
430807;201502;400;1161;267;861;55;212;78;227;133;439
430810;201502;762;2099;382;1255;62;228;66;191;128;419
430820;201502;1191;3744;864;2924;220;812;256;814;476;1626
430825;201502;433;1163;206;633;34;110;73;200;107;310
430830;201502;2166;6589;1990;6332;203;669;1517;4899;1720;5568
430840;201502;991;3029;901;2856;221;712;431;1410;652;2122
430843;201502;107;315;55;184;8;25;22;74;30;99
430845;201502;351;1064;287;933;110;381;37;112;147;493
430850;201502;2809;8395;2397;7646;595;2060;968;3041;1563;5101
430860;201502;923;2468;545;1835;167;658;138;413;305;1071
430865;201502;687;1853;630;1759;209;616;303;825;512;1441
430870;201502;706;1964;398;1321;104;351;97;301;201;652
430880;201502;1233;3507;931;2941;301;1034;245;800;546;1834
430885;201502;201;552;133;444;33;125;59;186;92;311
430890;201502;1823;4800;1309;3846;95;344;626;1739;721;2083
430900;201502;2991;7940;2575;7248;512;1656;1392;3746;1904;5402
430905;201502;1056;3013;664;2155;175;632;158;490;333;1122
430910;201502;1564;4620;1116;3705;289;1063;423;1299;712;2362
430912;201502;535;1534;433;1357;63;230;262;808;325;1038
430915;201502;495;1609;344;1304;105;423;93;374;198;797
430920;201502;14953;46003;13297;42919;3322;11679;7478;23649;10800;35328
430925;201502;93;257;65;202;16;58;31;93;47;151
430930;201502;9488;27808;6786;22547;1862;6667;1986;6808;3848;13475
430940;201502;1183;3581;740;2488;130;511;217;685;347;1196
430950;201502;1226;3404;831;2588;190;659;306;868;496;1527
430955;201502;146;433;75;238;19;64;21;64;40;128
430957;201502;280;936;225;829;57;232;107;398;164;630
430960;201502;1356;3771;1142;3397;347;1138;437;1319;784;2457
430965;201502;1481;4319;1283;3989;84;317;1053;3252;1137;3569
430970;201502;561;1556;334;1077;69;245;91;279;160;524
430975;201502;660;2143;522;1814;87;327;273;945;360;1272
430980;201502;455;1147;278;879;70;250;102;293;172;543
430990;201502;611;1939;454;1553;126;461;105;323;231;784
430995;201502;622;1836;518;1636;176;581;194;605;370;1186
431000;201502;1722;4466;912;2825;184;642;118;299;302;941
431010;201502;2796;7946;1770;5884;364;1371;479;1426;843;2797
431020;201502;12765;31487;8367;23641;2049;5932;2553;7329;4602;13261
431030;201502;376;1096;205;697;47;176;48;154;95;330
431033;201502;2376;6961;2124;6597;434;1427;1250;3962;1684;5389
431036;201502;216;565;85;298;11;43;18;52;29;95
431040;201502;1012;2872;794;2509;210;737;385;1185;595;1922
431041;201502;561;1551;502;1470;145;434;233;710;378;1144
431043;201502;399;1292;287;1029;136;538;76;238;212;776
431046;201502;121;345;87;272;16;56;30;88;46;144
431050;201502;1825;4607;1401;3899;304;937;774;2091;1078;3028
431053;201502;638;2102;534;1882;163;628;159;565;322;1193
431055;201502;696;1905;643;1814;52;154;484;1370;536;1524
431057;201502;391;1145;236;816;53;193;75;256;128;449
431060;201502;5822;17105;5390;16527;1513;4527;2916;9331;4429;13858
431065;201502;512;1457;424;1299;47;161;271;815;318;976
431070;201502;759;2219;461;1556;97;339;100;311;197;650
431075;201502;297;897;204;694;35;134;61;213;96;347
431080;201502;592;1874;467;1605;108;416;109;362;217;778
431085;201502;950;2539;761;2205;123;394;468;1328;591;1722
431087;201502;636;1826;556;1667;74;213;365;1106;439;1319
431090;201502;548;1338;266;807;82;259;61;175;143;434
431100;201502;4038;11227;3303;9968;862;2813;1306;3972;2168;6785
431110;201502;1593;4212;1185;3398;248;768;555;1516;803;2284
431112;201502;619;1939;585;1884;164;541;291;927;455;1468
431113;201502;521;1510;398;1260;112;374;105;339;217;713
431115;201502;1459;4248;1281;3940;226;741;793;2424;1019;3165
431120;201502;2697;8367;2148;7289;584;2260;877;2828;1461;5088
431123;201502;525;1529;382;1249;79;282;210;695;289;977
431125;201502;1385;4278;1044;3556;299;1017;337;1224;636;2241
431127;201502;210;538;62;205;6;16;4;9;10;25
431130;201502;3556;10117;2703;8621;624;2257;1062;3329;1686;5586
431140;201502;4375;10908;2390;7554;435;1583;553;1507;988;3090
431142;201502;533;1591;472;1480;48;157;326;1039;374;1196
431150;201502;1184;3546;928;3057;203;731;370;1224;573;1955
431160;201502;1019;3012;860;2691;160;506;420;1413;580;1919
431162;201502;501;1318;248;828;33;139;39;106;72;245
431164;201502;161;449;50;185;15;58;1;4;16;62
431170;201502;758;2143;552;1752;156;523;173;541;329;1064
431171;201502;843;2508;719;2260;243;813;188;562;431;1375
431173;201502;507;1493;452;1391;103;337;266;817;369;1154
431175;201502;1116;3163;969;2932;310;987;374;1126;684;2113
431177;201502;878;2868;725;2571;241;956;316;1073;557;2029
431179;201502;347;733;86;256;10;41;19;42;29;83
431180;201502;2272;6590;1625;5222;401;1376;419;1240;820;2616
431190;201502;740;1942;387;1253;73;264;92;291;165;555
431198;201502;391;1269;346;1182;152;549;83;279;235;828
431200;201502;348;986;118;399;27;95;9;26;36;121
431205;201502;333;1030;181;630;38;126;64;230;102;356
431210;201502;753;2073;644;1876;166;470;360;1079;526;1549
431213;201502;259;790;211;700;56;213;83;258;139;471
431215;201502;335;982;171;578;31;101;15;41;46;142
431217;201502;211;648;162;538;51;178;46;160;97;338
431220;201502;995;2600;658;1940;82;273;354;977;436;1250
431225;201502;1303;3828;1109;3495;228;759;631;1989;859;2748
431230;201502;895;2624;677;2179;77;276;382;1203;459;1479
431235;201502;89;231;33;99;7;24;7;18;14;42
431237;201502;456;1454;395;1366;117;459;176;590;293;1049
431238;201502;41;129;31;104;7;28;10;32;17;60
431240;201502;2920;8791;2531;8153;875;3054;752;2366;1627;5420
431242;201502;371;1191;334;1127;117;443;64;198;181;641
431244;201502;427;1007;276;766;48;158;141;362;189;520
431245;201502;1071;2840;824;2400;118;367;540;1580;658;1947
431247;201502;202;603;155;508;55;196;52;161;107;357
431250;201502;1649;5199;1436;4902;402;1480;685;2354;1087;3834
431260;201502;344;965;196;661;49;201;55;162;104;363
431261;201502;233;808;202;736;41;169;69;240;110;409
431262;201502;406;1099;176;582;24;106;69;224;93;330
431265;201502;1460;3837;827;2521;171;585;215;539;386;1124
431267;201502;163;462;133;408;26;95;79;234;105;329
431270;201502;2636;6884;1873;5680;470;1532;820;2538;1290;4070
431275;201502;234;719;133;477;35;124;25;78;60;202
431280;201502;283;794;115;392;19;76;24;63;43;139
431290;201502;355;1114;275;925;68;276;63;192;131;468
431295;201502;113;312;59;178;5;18;28;79;33;97
431300;201502;320;833;61;229;15;58;2;9;17;67
431301;201502;190;576;117;394;29;102;22;62;51;164
431303;201502;773;2046;480;1436;82;307;152;411;234;718
431306;201502;2175;5848;1585;4802;219;856;530;1386;749;2242
431308;201502;42;138;38;127;24;84;10;32;34;116
431310;201502;778;2327;493;1683;100;355;156;556;256;911
431320;201502;924;2527;502;1647;109;401;123;374;232;775
431330;201502;2658;6603;1273;4040;372;1311;148;429;520;1740
431333;201502;469;1247;221;658;44;141;70;178;114;319
431335;201502;67;194;51;154;15;45;10;22;25;67
431337;201502;2421;7457;1833;6217;451;1655;385;1209;836;2864
431339;201502;684;1901;471;1439;87;280;214;644;301;924
431340;201502;27556;73084;20011;60140;4713;15591;6293;18349;11006;33940
431342;201502;590;1535;486;1361;134;406;260;701;394;1107
431344;201502;409;1122;304;936;27;83;200;632;227;715
431346;201502;339;894;196;586;53;158;49;142;102;300
431349;201502;708;2045;487;1517;108;347;158;481;266;828
431350;201502;4053;11958;3432;10851;666;2430;1830;5614;2496;8044
431360;201502;741;1944;508;1560;133;430;173;545;306;975
431365;201502;1234;3680;1050;3370;321;1110;458;1512;779;2622
431370;201502;5190;14832;4179;13116;1169;3988;1468;4606;2637;8594
431380;201502;1042;3217;974;3073;147;496;669;2081;816;2577
431390;201502;3197;8530;2026;6309;438;1571;610;1708;1048;3279
431395;201502;1239;3741;1065;3457;252;928;532;1666;784;2594
431400;201502;268;841;153;538;44;162;17;39;61;201
431402;201502;1298;3083;748;2112;150;447;376;1035;526;1482
431403;201502;274;799;193;655;50;190;36;118;86;308
431405;201502;4421;12406;3558;11155;777;2828;1784;5401;2561;8229
431406;201502;820;2514;612;2063;180;648;265;873;445;1521
431407;201502;592;1747;392;1328;110;383;98;305;208;688
431410;201502;14506;42512;10520;34783;3287;12070;1655;5422;4942;17492
431413;201502;221;543;103;325;11;38;39;116;50;154
431415;201502;764;2158;581;1822;121;442;257;747;378;1189
431417;201502;676;1687;543;1499;73;204;318;901;391;1105
431420;201502;1469;4092;1296;3824;261;818;682;2118;943;2936
431430;201502;542;1450;367;1116;72;227;124;343;196;570
431440;201502;24703;70408;20529;63655;5929;19534;8122;25954;14051;45488
431442;201502;144;409;98;295;21;69;13;26;34;95
431445;201502;498;1390;254;790;36;114;100;289;136;403
431446;201502;497;1444;366;1181;78;246;149;490;227;736
431447;201502;739;2092;529;1661;109;374;232;732;341;1106
431449;201502;844;2389;677;2102;93;320;409;1287;502;1607
431450;201502;2176;5543;1942;5195;354;1027;1353;3563;1707;4590
431455;201502;713;1814;401;1140;123;348;104;283;227;631
431460;201502;3468;9722;2982;8820;848;2563;1063;3258;1911;5821
431470;201502;1974;5787;1611;5019;422;1312;656;2110;1078;3422
431475;201502;167;487;41;162;6;24;3;13;9;37
431477;201502;722;1907;492;1461;63;202;284;815;347;1017
431478;201502;259;674;101;307;22;68;23;61;45;129
431480;201502;3003;8371;2268;7051;616;2136;863;2559;1479;4695
431490;201502;111208;306202;96160;283848;12914;44938;66679;192228;79593;237166
431500;201502;825;2195;610;1788;117;340;315;911;432;1251
431505;201502;467;1167;370;1032;37;93;277;805;314;898
431507;201502;337;838;243;663;35;97;164;436;199;533
431510;201502;2156;5937;1744;5208;367;1190;837;2410;1204;3600
431513;201502;287;786;131;428;29;100;59;187;88;287
431514;201502;115;299;45;152;7;32;2;5;9;37
431515;201502;751;2188;520;1622;96;348;191;494;287;842
431517;201502;82;260;74;241;22;76;24;68;46;144
431520;201502;436;1273;273;869;42;150;71;215;113;365
431530;201502;4324;10407;3305;9217;1021;3008;1371;4042;2392;7050
431531;201502;293;830;194;627;45;152;73;234;118;386
431532;201502;516;1461;452;1330;128;404;196;572;324;976
431535;201502;353;940;181;551;32;102;59;161;91;263
431540;201502;2167;7095;1924;6747;226;765;1318;4913;1544;5678
431545;201502;283;774;58;193;6;19;11;49;17;68
431550;201502;2334;6845;2096;6430;399;1404;1090;3272;1489;4676
431555;201502;726;1859;586;1638;132;359;334;961;466;1320
431560;201502;19134;58851;14231;49129;4000;15276;3924;14064;7924;29340
431570;201502;5408;15154;4789;14183;1354;4114;2395;7210;3749;11324
431575;201502;452;1156;319;932;52;182;101;263;153;445
431580;201502;673;1925;438;1412;97;363;154;444;251;807
431590;201502;998;2758;683;2127;88;282;319;993;407;1275
431595;201502;508;1470;401;1248;90;285;167;515;257;800
431600;201502;2151;6165;1542;4970;329;1258;335;938;664;2196
431610;201502;1548;4573;1198;3885;264;882;516;1673;780;2555
431620;201502;451;1363;242;790;63;218;99;300;162;518
431630;201502;1512;4067;1051;3138;276;852;438;1317;714;2169
431640;201502;6078;17694;5454;16723;1152;4039;3138;9436;4290;13475
431642;201502;509;1407;415;1237;58;207;218;624;276;831
431643;201502;178;449;149;400;20;59;77;182;97;241
431645;201502;1801;5284;1594;4935;316;1037;919;2841;1235;3878
431647;201502;180;517;121;375;30;98;30;81;60;179
431650;201502;285;882;203;716;34;134;49;146;83;280
431660;201502;1220;3417;778;2506;187;667;200;555;387;1222
431670;201502;1354;3618;1034;3044;228;752;459;1279;687;2031
431673;201502;230;658;138;460;30;120;35;101;65;221
431675;201502;609;1656;189;634;29;105;45;125;74;230
431680;201502;10237;27805;7616;23142;2086;6866;2223;6760;4309;13626
431690;201502;25822;72383;20541;63892;5827;19498;8088;25757;13915;45255
431695;201502;136;435;97;336;23;87;23;49;46;136
431697;201502;460;1309;403;1206;102;306;188;578;290;884
431700;201502;1617;4559;1379;4105;245;776;769;2255;1014;3031
431710;201502;12874;37742;10502;33729;3379;11625;3188;10574;6567;22199
431720;201502;7293;20308;5769;17435;1213;4109;2700;7986;3913;12095
431725;201502;10;30;8;26;2;8;4;11;6;19
431730;201502;3936;11780;3144;10309;876;3201;924;3095;1800;6296
431740;201502;5251;15135;4428;13636;1519;5134;1035;2933;2554;8067
431750;201502;9861;27978;8473;25760;1733;5700;4468;13901;6201;19601
431755;201502;314;835;63;225;7;26;11;33;18;59
431760;201502;3848;11255;3123;9918;734;2550;1081;3282;1815;5832
431770;201502;2132;5741;1765;5161;372;1147;980;2846;1352;3993
431775;201502;225;609;161;489;61;203;34;86;95;289
431780;201502;2515;6745;1935;5684;520;1649;519;1448;1039;3097
431790;201502;1246;3864;1054;3483;206;727;607;2050;813;2777
431795;201502;412;1178;284;883;44;146;104;321;148;467
431800;201502;9065;26818;7358;23613;2346;8177;1858;5738;4204;13915
431805;201502;318;769;94;322;13;51;16;55;29;106
431810;201502;3662;10179;2917;8682;577;1874;1352;3946;1929;5820
431820;201502;2697;8432;2332;7699;551;1973;909;2921;1460;4894
431830;201502;10994;27481;8605;23938;2510;7581;3373;9396;5883;16977
431840;201502;2796;8339;2427;7712;620;2166;1131;3588;1751;5754
431842;201502;790;1987;401;1203;75;258;122;323;197;581
431843;201502;344;1004;295;920;43;155;168;507;211;662
431844;201502;226;601;122;405;24;98;41;121;65;219
431845;201502;515;1526;437;1365;41;138;297;933;338;1071
431846;201502;448;1324;378;1209;56;214;247;780;303;994
431848;201502;199;540;113;374;21;84;22;67;43;151
431849;201502;432;1060;109;334;25;79;24;58;49;137
431850;201502;5009;14547;4383;13363;1063;3459;1879;5678;2942;9137
431860;201502;832;2192;619;1829;88;307;367;1038;455;1345
431861;201502;98;303;61;217;10;34;9;28;19;62
431862;201502;462;1525;371;1335;119;480;87;289;206;769
431870;201502;19572;56037;15194;48173;4052;14081;4972;15547;9024;29628
431880;201502;4429;13288;3555;11459;873;3131;1515;4761;2388;7892
431890;201502;5323;14519;4093;12395;1331;4301;1241;3810;2572;8111
431900;201502;1090;3125;761;2495;215;812;289;842;504;1654
431910;201502;1036;2464;496;1431;94;300;176;462;270;762
431912;201502;622;1772;485;1516;156;476;161;534;317;1010
431915;201502;1471;3971;1122;3361;271;888;441;1313;712;2201
431920;201502;1395;3901;1253;3697;132;368;1009;3030;1141;3398
431930;201502;1348;3695;1014;3158;149;438;614;2040;763;2478
431935;201502;75;236;61;207;17;66;22;65;39;131
431936;201502;399;1174;313;984;43;123;180;608;223;731
431937;201502;326;839;184;551;42;135;36;90;78;225
431940;201502;2701;7360;1779;5545;444;1495;492;1482;936;2977
431950;201502;1638;5096;1434;4744;320;1199;648;2040;968;3239
431960;201502;3144;9288;2816;8659;736;2478;979;2952;1715;5430
431970;201502;514;1396;265;844;40;148;72;206;112;354
431971;201502;118;327;89;278;16;51;34;93;50;144
431973;201502;490;1701;433;1583;52;197;275;1051;327;1248
431975;201502;95;211;17;63;5;23;3;10;8;33
431980;201502;1426;4159;1208;3723;295;1014;409;1168;704;2182
431990;201502;8286;22878;6320;19659;1186;4282;2411;7052;3597;11334
432000;201502;10509;29630;8301;25802;2584;8459;3086;9558;5670;18017
432010;201502;2344;6730;1936;5981;437;1480;931;2835;1368;4315
432020;201502;2384;5879;1891;5245;230;715;1342;3695;1572;4410
432023;201502;553;1594;379;1214;92;343;118;341;210;684
432026;201502;1299;3893;974;3219;175;605;534;1760;709;2365
432030;201502;417;1218;320;1004;66;212;150;449;216;661
432032;201502;593;1555;402;1201;69;232;216;611;285;843
432035;201502;823;2557;725;2376;131;466;450;1450;581;1916
432040;201502;948;2270;475;1500;107;380;127;343;234;723
432045;201502;239;728;152;556;34;136;58;223;92;359
432050;201502;685;1916;588;1738;88;264;364;1110;452;1374
432055;201502;853;2602;712;2314;137;489;419;1323;556;1812
432057;201502;429;1090;331;919;38;112;224;591;262;703
432060;201502;472;1315;205;699;44;166;46;141;90;307
432065;201502;231;662;183;577;41;142;82;247;123;389
432067;201502;1000;3109;719;2491;159;581;365;1268;524;1849
432070;201502;2439;6635;1666;5120;444;1550;497;1404;941;2954
432080;201502;3763;10873;3236;9933;970;3155;1261;3833;2231;6988
432085;201502;316;898;217;733;48;193;106;351;154;544
432090;201502;1487;4353;1201;3757;415;1398;422;1213;837;2611
432100;201502;1273;3709;693;2367;168;605;100;267;268;872
432110;201502;2753;8351;2101;6999;576;2152;310;892;886;3044
432120;201502;5218;15507;4422;14120;1623;5506;1436;4572;3059;10078
432130;201502;2521;7039;2030;6403;639;2223;905;2850;1544;5073
432132;201502;460;1310;238;804;27;104;87;275;114;379
432135;201502;723;2242;695;2191;95;336;517;1600;612;1936
432140;201502;2132;6699;1720;5912;419;1510;770;2738;1189;4248
432143;201502;1401;4165;1178;3802;268;885;642;2141;910;3026
432145;201502;1083;3318;686;2386;146;553;121;383;267;936
432146;201502;232;737;164;577;41;160;41;136;82;296
432147;201502;652;2062;498;1727;130;470;183;665;313;1135
432149;201502;370;1074;227;728;55;188;90;291;145;479
432150;201502;3773;10606;2799;8852;687;2428;882;2656;1569;5084
432160;201502;4282;13609;3745;12712;1181;4231;1512;5322;2693;9553
432162;201502;402;971;87;283;14;53;20;56;34;109
432163;201502;381;991;95;299;5;17;8;23;13;40
432166;201502;734;2163;596;1880;92;354;314;928;406;1282
432170;201502;964;3117;643;2401;128;485;128;463;256;948
432180;201502;2998;7913;2086;6360;604;1968;597;1792;1201;3760
432183;201502;448;1421;368;1259;167;595;74;249;241;844
432185;201502;926;2508;574;1844;114;415;255;807;369;1222
432190;201502;3399;9321;2358;7038;588;1838;677;1862;1265;3700
432195;201502;1225;3380;1038;3110;138;455;716;2121;854;2576
432200;201502;3366;10107;2704;8976;688;2482;1250;4243;1938;6725
432210;201502;440;1204;337;1046;73;270;168;477;241;747
432215;201502;889;2751;764;2554;135;431;482;1707;617;2138
432218;201502;295;793;220;651;40;128;95;256;135;384
432220;201502;4238;11183;3499;10051;374;1268;2338;6612;2712;7880
432225;201502;66;215;55;197;24;87;15;51;39;138
432230;201502;1102;2993;688;2097;181;616;228;588;409;1204
432232;201502;546;1588;433;1376;106;377;189;590;295;967
432234;201502;421;1163;288;857;64;197;103;294;167;491
432235;201502;79;232;45;155;11;50;6;16;17;66
432237;201502;480;1337;440;1275;24;99;353;998;377;1097
432240;201502;14306;46152;12200;43357;2188;9016;7347;26736;9535;35752
432250;201502;4974;17091;4560;16272;1719;6710;1441;5168;3160;11878
432252;201502;386;1138;296;976;67;242;157;514;224;756
432253;201502;1335;4267;939;3298;280;1028;251;902;531;1930
432254;201502;772;2084;239;783;53;186;34;99;87;285
432255;201502;234;601;131;432;34;118;41;132;75;250
432260;201502;7601;19099;5291;15307;1212;3642;2225;6643;3437;10285
432270;201502;2590;7732;2197;7073;600;1979;987;3281;1587;5260
432280;201502;1281;3552;682;2230;126;443;155;439;281;882
432285;201502;177;566;57;199;14;57;11;29;25;86
432290;201502;591;1773;391;1309;98;352;132;427;230;779
432300;201502;23294;69962;20715;65559;4392;15085;11610;36528;16002;51613
432310;201502;835;2503;679;2235;143;532;373;1203;516;1735
432320;201502;253;649;126;397;29;92;27;77;56;169
432330;201502;317;847;127;428;17;55;11;34;28;89
432335;201502;216;629;99;340;23;86;10;27;33;113
432340;201502;355;884;166;508;34;111;53;158;87;269
432345;201502;676;1872;618;1777;92;345;376;988;468;1333
432350;201502;437;1181;250;823;57;201;76;227;133;428
432360;201502;164;496;32;112;8;37;10;26;18;63
432370;201502;455;1287;361;1101;33;92;241;762;274;854
432375;201502;822;2090;646;1810;91;270;385;1096;476;1366
432377;201502;172;555;48;160;7;31;14;31;21;62
432380;201502;843;2851;749;2673;288;1150;277;909;565;2059
500020;201502;2192;6657;1649;5633;398;1587;605;1922;1003;3509
500025;201502;1188;2870;766;2137;112;321;417;1143;529;1464
500060;201502;6675;19623;5338;17439;761;2544;3483;11843;4244;14387
500070;201502;4073;11980;3430;10872;742;2728;1613;5037;2355;7765
500080;201502;1635;4773;1206;4006;356;1318;421;1433;777;2751
500085;201502;2236;5899;1636;4992;196;655;970;2855;1166;3510
500090;201502;2393;6907;1807;5862;382;1308;870;2890;1252;4198
500100;201502;2503;7424;2245;7011;599;2206;1118;3336;1717;5542
500110;201502;8499;24864;6868;22382;1117;3920;3840;13286;4957;17206
500124;201502;1997;6376;1726;5933;306;1021;993;3728;1299;4749
500150;201502;1413;3536;1037;2934;207;701;482;1191;689;1892
500190;201502;4821;12513;3761;11145;661;2102;2236;6866;2897;8968
500200;201502;2484;6311;1929;5386;271;876;1144;3169;1415;4045
500210;201502;4819;14407;4083;13265;901;3127;2085;6899;2986;10026
500215;201502;1662;5100;1353;4509;258;962;559;1787;817;2749
500220;201502;2857;9029;2374;8176;541;2019;896;3159;1437;5178
500230;201502;2670;6839;2013;5871;533;1704;876;2588;1409;4292
500240;201502;4743;14729;3411;12035;571;2209;1345;5012;1916;7221
500260;201502;2654;6901;2006;5865;312;1000;1000;2777;1312;3777
500270;201502;118515;304980;77096;234648;19655;65173;19186;57914;38841;123087
500280;201502;1370;3812;1148;3517;111;358;853;2672;964;3030
500290;201502;4112;9890;2511;7416;624;2120;756;2025;1380;4145
500295;201502;2546;7604;1728;5671;333;1229;448;1266;781;2495
500310;201502;774;2039;669;1886;150;469;323;878;473;1347
500315;201502;3145;9790;2651;9060;449;1594;1709;6076;2158;7670
500320;201502;15482;49983;12777;45044;3965;14973;4443;16665;8408;31638
500325;201502;4044;10468;2984;8823;667;2160;1462;4252;2129;6412
500330;201502;6310;16963;4809;14249;1013;3298;2392;6970;3405;10268
500345;201502;2165;5766;1702;5030;264;901;1012;2931;1276;3832
500348;201502;2350;6739;2062;6283;162;605;1572;4747;1734;5352
500350;201502;1239;3781;795;2769;131;495;250;892;381;1387
500370;201502;22854;69508;17567;59692;4055;15394;5752;19611;9807;35005
500375;201502;2900;7964;2149;6561;523;1729;836;2599;1359;4328
500380;201502;2903;8266;2417;7425;755;2408;880;2729;1635;5137
500390;201502;609;1292;387;985;36;113;276;668;312;781
500400;201502;1326;4045;1012;3302;243;876;297;890;540;1766
500410;201502;2256;6321;1803;5651;465;1605;845;2641;1310;4246
500430;201502;2455;7069;1949;6345;392;1444;910;3029;1302;4473
500440;201502;1393;3809;1057;3269;209;716;534;1620;743;2336
500450;201502;1974;6044;1525;5176;339;1310;312;931;651;2241
500460;201502;3535;10838;2884;9615;841;3141;746;2437;1587;5578
500470;201502;2984;8858;2145;7050;599;2156;343;1021;942;3177
500480;201502;1909;6189;1782;6018;164;550;1468;5084;1632;5634
500490;201502;1009;2783;796;2417;229;779;250;766;479;1545
500500;201502;3603;11262;2860;10127;1107;4441;850;2978;1957;7419
500510;201502;851;2204;543;1666;87;307;238;660;325;967
500515;201502;1851;4925;1529;4501;239;689;920;2971;1159;3660
500520;201502;2978;10204;2656;9743;482;1904;1712;6470;2194;8374
500525;201502;1199;3830;971;3394;199;743;491;1808;690;2551
500540;201502;5903;16509;3569;12037;1057;4162;579;1738;1636;5900
500560;201502;4633;15212;4219;14604;630;2381;3054;10624;3684;13005
500568;201502;3912;9960;2788;8328;569;1959;1325;3833;1894;5792
500570;201502;7369;19838;5005;15482;1380;4581;1401;4213;2781;8794
500580;201502;3624;10418;2909;9205;334;1144;2020;6414;2354;7558
500600;201502;3563;9624;2461;7595;570;1932;939;2872;1509;4804
500620;201502;8253;23053;6097;19250;1247;4393;2836;9006;4083;13399
500625;201502;769;2309;487;1678;106;397;154;505;260;902
500627;201502;487;1423;382;1235;78;253;119;415;197;668
500630;201502;5959;16412;4548;14211;1285;4475;1530;4680;2815;9155
500635;201502;2576;9977;2158;9314;326;1316;1355;6428;1681;7744
500640;201502;1661;4012;1286;3487;99;319;958;2573;1057;2892
500660;201502;18083;52562;14229;46197;4094;15053;5020;16210;9114;31263
500690;201502;2956;8459;2366;7701;881;2954;857;3059;1738;6013
500710;201502;3635;10779;3095;9885;646;2328;1560;4936;2206;7264
500720;201502;5882;15780;3840;12187;1067;3715;1088;3366;2155;7081
500730;201502;960;2698;702;2192;163;582;257;762;420;1344
500740;201502;3809;10636;3089;9313;485;1788;1379;4114;1864;5902
500750;201502;836;2370;760;2276;157;493;489;1515;646;2008
500755;201502;1224;3559;865;2814;190;691;291;838;481;1529
500769;201502;4941;13215;3077;9370;604;2094;760;1961;1364;4055
500770;201502;1772;5268;1346;4479;384;1416;422;1418;806;2834
500780;201502;1016;3003;850;2692;217;757;332;993;549;1750
500790;201502;9088;25342;7653;22863;1402;4884;4210;12119;5612;17003
500793;201502;2283;6617;1825;5875;361;1309;793;2416;1154;3725
500795;201502;2469;7236;2117;6753;252;676;1604;5442;1856;6118
500797;201502;871;2352;636;1953;93;316;294;885;387;1201
500800;201502;2684;7409;2108;6615;822;2944;667;2114;1489;5058
500830;201502;16508;46263;11678;36861;2721;9545;3595;10769;6316;20314
500840;201502;1378;3849;989;3089;138;476;457;1385;595;1861
510010;201502;1204;3731;1050;3471;317;1072;491;1671;808;2743
510020;201502;3093;8924;2052;6872;491;1781;613;1973;1104;3754
510025;201502;7897;23171;6646;21005;1568;5600;2897;8672;4465;14272
510030;201502;1758;4898;1476;4442;381;1304;628;1751;1009;3055
510035;201502;830;2432;687;2221;115;370;430;1435;545;1805
510040;201502;1698;4648;1316;4083;237;835;722;2248;959;3083
510050;201502;1879;5508;1376;4562;365;1327;476;1552;841;2879
510060;201502;1438;4133;1095;3523;244;846;404;1268;648;2114
510080;201502;1155;3602;921;3164;286;1093;229;720;515;1813
510100;201502;679;1820;472;1416;62;204;211;600;273;804
510120;201502;318;663;186;498;20;56;115;307;135;363
510125;201502;3121;8210;2490;7101;462;1630;1112;2957;1574;4587
510130;201502;1889;5154;1562;4655;402;1262;635;1892;1037;3154
510140;201502;2998;9618;2409;8697;963;3859;578;1879;1541;5738
510160;201502;1360;4552;1261;4423;120;484;993;3490;1113;3974
510170;201502;5668;17125;4667;15374;939;3498;2238;7131;3177;10629
510180;201502;11741;30942;8405;25667;2379;7675;2857;9593;5236;17268
510185;201502;1367;3998;1126;3691;160;477;765;2765;925;3242
510190;201502;2140;6503;1505;5510;392;1593;604;2297;996;3890
510250;201502;13845;42652;11900;39863;3451;12588;5371;18394;8822;30982
510260;201502;2265;9008;2010;8480;636;2888;796;3675;1432;6563
510263;201502;4230;11343;3058;9420;769;2539;980;2916;1749;5455
510267;201502;5570;16087;4067;12943;953;3312;1256;3802;2209;7114
510268;201502;829;2405;712;2240;154;513;397;1269;551;1782
510269;201502;968;2934;751;2534;235;831;294;1010;529;1841
510270;201502;2641;8393;2337;7852;425;1499;1270;4375;1695;5874
510279;201502;1964;6158;1736;5747;528;1912;574;1740;1102;3652
510285;201502;1413;4195;1116;3676;283;1030;423;1327;706;2357
510300;201502;3224;9603;2750;8937;222;852;2155;7028;2377;7880
510305;201502;1512;4678;1193;4063;308;1143;362;1202;670;2345
510310;201502;860;2619;724;2370;243;863;235;738;478;1601
510320;201502;3778;11002;2935;9415;858;3183;615;1790;1473;4973
510325;201502;5319;16942;4588;15950;946;3406;3093;11027;4039;14433
510330;201502;2792;8936;2319;8112;580;2259;874;3040;1454;5299
510335;201502;4609;14303;3948;13452;616;2099;2774;9947;3390;12046
510336;201502;558;1697;437;1464;98;362;215;707;313;1069
510337;201502;2166;7121;1828;6479;736;2641;508;1987;1244;4628
510340;201502;66412;189318;51291;165792;18877;67186;11449;38721;30326;105907
510343;201502;1094;3221;966;3049;89;280;780;2533;869;2813
510345;201502;1656;4909;1371;4396;331;1153;495;1491;826;2644
510350;201502;3447;9517;2711;8516;666;2207;1326;4345;1992;6552
510360;201502;1793;4458;1191;3716;148;557;825;2507;973;3064
510370;201502;997;3496;890;3337;199;789;537;2054;736;2843
510380;201502;533;1644;386;1362;152;596;62;200;214;796
510385;201502;978;3613;740;3065;117;508;349;1549;466;2057
510390;201502;1124;3429;1029;3314;255;667;659;2360;914;3027
510395;201502;838;2115;656;1871;98;302;328;1062;426;1364
510410;201502;3835;12549;3475;11865;836;3045;1900;6548;2736;9593
510420;201502;2369;6138;1756;5113;220;784;948;2723;1168;3507
510450;201502;602;1645;448;1415;110;405;181;554;291;959
510452;201502;612;2009;444;1610;93;377;188;662;281;1039
510454;201502;831;2672;731;2504;119;427;471;1658;590;2085
510455;201502;970;2975;736;2513;169;672;245;794;414;1466
510460;201502;2199;5859;1738;5215;218;800;1120;3257;1338;4057
510480;201502;4520;12110;3278;9858;829;2627;833;2372;1662;4999
510490;201502;1422;4632;1261;4392;255;1046;779;2626;1034;3672
510500;201502;1523;4548;1062;3637;266;1068;445;1462;711;2530
510510;201502;2740;9592;2399;9002;796;3272;937;3469;1733;6741
510515;201502;6225;19260;4861;16249;1154;4295;1261;3969;2415;8264
510517;201502;1765;5224;1513;4820;486;1605;671;2214;1157;3819
510520;201502;2130;5106;1564;4383;78;267;1154;3340;1232;3607
510523;201502;1037;3110;903;2889;155;521;584;1893;739;2414
510525;201502;7728;19595;5117;15594;1107;3612;1956;5943;3063;9555
510530;201502;529;1510;448;1400;66;272;267;799;333;1071
510550;201502;2543;8458;2162;7761;610;2345;844;3070;1454;5415
510558;201502;2011;5798;1673;5303;399;1391;815;2617;1214;4008
510560;201502;1656;5289;1159;4426;354;1478;303;1188;657;2666
510562;201502;5138;15499;4198;13628;1284;4680;1326;4312;2610;8992
510590;201502;2900;7727;2346;7021;593;1854;1149;3522;1742;5376
510600;201502;1542;3983;1019;3127;191;653;431;1219;622;1872
510610;201502;2777;7958;2395;7437;183;663;1924;5997;2107;6660
510615;201502;2269;7012;1931;6485;581;2093;895;3057;1476;5150
510617;201502;585;1715;480;1531;54;176;359;1189;413;1365
510618;201502;1424;4142;1028;3381;223;887;456;1421;679;2308
510619;201502;810;2205;502;1648;82;305;105;304;187;609
510620;201502;1449;3633;813;2656;244;922;172;515;416;1437
510621;201502;983;3431;872;3200;239;968;314;1089;553;2057
510622;201502;3788;11464;2600;8920;671;2531;380;1061;1051;3592
510623;201502;3446;9842;2796;8711;787;2646;1159;3499;1946;6145
510624;201502;1329;4008;974;3332;217;856;347;1081;564;1937
510625;201502;2186;6365;1757;5637;490;1755;427;1300;917;3055
510626;201502;1413;4043;1015;3495;326;1256;432;1515;758;2771
510627;201502;757;2136;500;1600;134;475;129;407;263;882
510628;201502;1617;4006;1175;3410;115;368;874;2538;989;2906
510629;201502;1825;5852;1511;5178;441;1688;522;1716;963;3404
510630;201502;2552;8604;2055;7667;601;2550;491;1837;1092;4387
510631;201502;392;1137;359;1085;52;158;254;770;306;928
510637;201502;2653;7679;2285;7080;558;1894;1135;3473;1693;5367
510642;201502;4652;15376;4046;14522;1183;4596;1974;7373;3157;11969
510645;201502;953;2166;615;1711;199;561;214;636;413;1197
510650;201502;6132;20719;5620;20103;1171;4225;3788;14219;4959;18444
510665;201502;1277;3487;867;2716;240;800;273;823;513;1623
510670;201502;389;901;218;655;32;123;91;257;123;380
510675;201502;6243;19951;5114;17741;1556;6145;1287;4207;2843;10352
510677;201502;2204;5816;1759;5239;222;677;1290;3999;1512;4676
510680;201502;774;2365;628;2086;125;466;247;759;372;1225
510682;201502;2299;7173;1783;6211;460;1798;488;1603;948;3401
510685;201502;938;2492;783;2290;77;263;580;1672;657;1935
510700;201502;4348;11337;3012;9433;663;2202;1596;5118;2259;7320
510704;201502;8527;23043;7078;20746;1462;4793;3836;11022;5298;15815
510706;201502;1857;5621;1358;4839;318;1174;700;2573;1018;3747
510710;201502;3467;9688;2527;7804;651;2146;673;1846;1324;3992
510715;201502;656;1673;413;1216;87;292;162;430;249;722
510718;201502;1884;5164;1468;4701;603;1974;565;1918;1168;3892
510719;201502;451;1028;279;799;34;138;123;320;157;458
510720;201502;1301;3059;982;2687;125;345;704;1971;829;2316
510724;201502;809;2459;675;2210;149;551;342;1048;491;1599
510726;201502;654;1735;505;1496;109;344;201;568;310;912
510729;201502;741;1894;492;1481;120;396;219;661;339;1057
510730;201502;2391;7272;2030;6631;494;1815;902;2819;1396;4634
510735;201502;1099;3711;896;3375;216;898;459;1721;675;2619
510740;201502;1128;2783;829;2346;204;576;455;1342;659;1918
510757;201502;654;2231;555;2029;169;654;219;815;388;1469
510760;201502;28303;75275;20502;62290;6080;20055;6363;19166;12443;39221
510770;201502;4368;11426;3797;10766;395;1062;2597;8283;2992;9345
510774;201502;435;1198;365;1091;79;279;172;528;251;807
510775;201502;784;2261;658;2060;224;760;230;712;454;1472
510776;201502;493;1384;398;1204;92;307;192;573;284;880
510777;201502;1640;4840;1223;4273;178;689;912;3205;1090;3894
510779;201502;691;2018;514;1708;80;292;230;774;310;1066
510780;201502;3708;11077;3142;10218;752;2542;1546;5284;2298;7826
510785;201502;1752;5241;1427;4670;465;1614;442;1469;907;3083
510787;201502;2057;6259;1663;5573;589;2101;440;1420;1029;3521
510788;201502;496;1332;375;1147;160;474;105;367;265;841
510790;201502;15620;45460;10696;36102;2641;10294;1257;4036;3898;14330
510792;201502;7007;21625;5115;17977;1193;4863;1133;3664;2326;8527
510794;201502;1193;3751;993;3423;376;1416;266;831;642;2247
510795;201502;8540;26142;6314;21829;1763;6736;1582;5526;3345;12262
510800;201502;1715;4779;1383;4334;358;1248;625;1857;983;3105
510805;201502;1871;5309;1567;4873;137;435;1239;3901;1376;4336
510810;201502;689;1685;540;1488;145;424;266;703;411;1127
510820;201502;777;1848;536;1488;101;324;222;553;323;877
510830;201502;610;2031;528;1904;155;594;266;1032;421;1626
510835;201502;655;1991;492;1666;142;546;171;516;313;1062
510840;201502;49703;121699;39018;108293;8581;25172;20608;59128;29189;84300
510850;201502;1427;4117;1106;3597;391;1453;197;500;588;1953
510860;201502;2491;8185;1887;6910;661;2647;223;815;884;3462
510880;201502;687;2265;591;2101;171;660;274;1001;445;1661
510885;201502;611;1708;490;1546;81;297;226;708;307;1005
510890;201502;845;2718;702;2483;240;967;235;731;475;1698
510895;201502;1105;3462;944;3153;258;994;406;1282;664;2276
520005;201502;1249;4007;1140;3835;323;1137;548;1888;871;3025
520010;201502;1665;5646;1397;5095;547;2283;302;997;849;3280
520013;201502;3733;10273;2808;8626;637;2068;1144;3507;1781;5575
520015;201502;493;1406;397;1267;98;337;162;532;260;869
520017;201502;1104;3372;944;3115;256;946;396;1243;652;2189
520020;201502;396;1056;309;931;71;225;151;463;222;688
520025;201502;24766;78272;23885;77264;2410;8271;20024;65107;22434;73378
520030;201502;4413;14059;3818;13138;926;3492;1829;6344;2755;9836
520050;201502;311;865;263;785;26;80;191;572;217;652
520055;201502;770;2319;654;2091;123;383;343;1133;466;1516
520060;201502;1411;4424;1228;4060;264;1003;520;1651;784;2654
520080;201502;1710;5186;1477;4855;341;1097;827;2870;1168;3967
520082;201502;826;2514;756;2400;146;423;461;1569;607;1992
520085;201502;960;2955;823;2694;181;636;304;978;485;1614
520090;201502;950;2214;705;1899;152;359;379;1098;531;1457
520110;201502;40872;119713;32125;106558;12008;45051;7500;24507;19508;69558
520120;201502;255;662;150;481;36;133;35;115;71;248
520130;201502;3445;9895;3141;9450;560;1816;1950;5892;2510;7708
520140;201502;42690;138708;37626;129349;13222;49688;9403;31704;22625;81392
520145;201502;427;1130;332;992;73;229;146;421;219;650
520150;201502;656;1763;540;1628;139;451;291;869;430;1320
520160;201502;802;2300;668;2100;217;726;209;656;426;1382
520170;201502;3940;9368;3159;8490;301;852;2542;6959;2843;7811
520180;201502;1908;5717;1594;5217;380;1444;661;2107;1041;3551
520215;201502;1864;4878;1582;4447;227;672;1012;2882;1239;3554
520235;201502;748;1978;567;1715;140;474;259;752;399;1226
520250;201502;1259;3958;1052;3616;309;1160;457;1579;766;2739
520260;201502;782;2023;553;1600;85;262;251;705;336;967
520280;201502;520;1538;479;1481;211;704;145;498;356;1202
520310;201502;1120;2742;855;2367;208;558;407;1246;615;1804
520320;201502;1734;5452;1433;4873;169;613;910;3174;1079;3787
520330;201502;2732;8470;2110;7407;646;2539;401;1307;1047;3846
520340;201502;1806;4596;1393;4102;182;462;1053;3265;1235;3727
520350;201502;2811;8052;2329;7156;620;2157;1076;3150;1696;5307
520355;201502;1073;3633;982;3491;343;1342;400;1368;743;2710
520357;201502;791;2178;679;2004;49;163;508;1489;557;1652
520360;201502;626;1814;562;1706;112;349;289;902;401;1251
520380;201502;1280;3472;884;2731;170;579;389;1191;559;1770
520390;201502;990;2438;624;1946;153;578;262;743;415;1321
520393;201502;553;1422;464;1291;61;182;309;853;370;1035
520396;201502;730;2334;624;2128;75;292;434;1492;509;1784
520400;201502;1717;4886;1476;4562;232;791;991;3050;1223;3841
520410;201502;1501;3777;1123;3276;266;845;609;1763;875;2608
520420;201502;335;947;249;774;52;177;74;206;126;383
520425;201502;1158;3201;1020;2956;274;847;541;1547;815;2394
520430;201502;2046;5361;1340;4077;288;995;491;1369;779;2364
520440;201502;3596;9274;2501;7430;782;2565;656;1944;1438;4509
520450;201502;10160;28783;7416;23781;1940;6858;1105;3272;3045;10130
520455;201502;665;1989;540;1779;184;671;166;546;350;1217
520460;201502;856;2459;696;2188;140;507;342;1027;482;1534
520465;201502;775;2164;670;2038;147;509;366;1086;513;1595
520470;201502;1756;5680;1588;5422;320;1072;1077;3851;1397;4923
520480;201502;946;2744;753;2441;133;471;412;1311;545;1782
520485;201502;1218;3890;1052;3607;314;1195;540;1838;854;3033
520490;201502;3818;12100;3081;10928;1010;3775;1316;4767;2326;8542
520495;201502;1261;3546;1096;3336;99;315;918;2820;1017;3135
520500;201502;1463;4157;1302;3920;391;1233;601;1819;992;3052
520505;201502;848;2385;729;2214;174;565;426;1305;600;1870
520510;201502;10416;29097;7197;23853;1984;7252;1973;6627;3957;13879
520520;201502;1021;2901;823;2609;265;893;322;1032;587;1925
520530;201502;2144;6984;1837;6466;435;1531;946;3570;1381;5101
520540;201502;2962;8419;2315;7256;611;2032;762;2414;1373;4446
520545;201502;1142;3454;953;3073;217;758;322;997;539;1755
520547;201502;707;2254;615;2084;226;808;201;654;427;1462
520549;201502;9454;27337;7790;25299;2333;7997;3879;12791;6212;20788
520551;201502;3338;10198;3140;9957;788;2693;2011;6389;2799;9082
520552;201502;730;2322;692;2268;103;393;490;1584;593;1977
520570;201502;527;1535;380;1275;150;539;82;259;232;798
520580;201502;2966;7831;2113;6572;665;2318;773;2308;1438;4626
520590;201502;1448;4051;1172;3601;279;899;372;1088;651;1987
520620;201502;6982;22305;6374;21422;1342;4799;3980;13521;5322;18320
520630;201502;717;1924;543;1661;120;376;259;797;379;1173
520640;201502;2740;7745;2298;7040;676;2176;985;3107;1661;5283
520650;201502;797;2224;624;1889;162;545;293;872;455;1417
520660;201502;352;1064;288;965;97;346;94;315;191;661
520670;201502;853;2589;791;2496;51;146;693;2228;744;2374
520680;201502;616;1753;508;1610;126;419;246;791;372;1210
520690;201502;390;998;272;825;52;138;130;431;182;569
520710;201502;516;1325;342;997;11;33;194;559;205;592
520725;201502;1694;4318;1288;3725;290;914;722;2069;1012;2983
520735;201502;733;2102;554;1757;143;519;187;567;330;1086
520740;201502;1630;4713;1344;4328;287;1035;682;2158;969;3193
520750;201502;618;1685;496;1508;106;332;283;891;389;1223
520753;201502;1291;3695;1204;3563;155;424;891;2779;1046;3203
520760;201502;926;2510;801;2345;141;457;547;1624;688;2081
520780;201502;2008;4911;1658;4447;173;414;1229;3385;1402;3799
520790;201502;2632;7194;2240;6649;296;858;1627;5000;1923;5858
520800;201502;15119;44788;13377;42717;2577;7982;8780;29792;11357;37774
520810;201502;904;2463;797;2332;125;369;612;1852;737;2221
520815;201502;547;1768;417;1502;188;779;24;64;212;843
520830;201502;1512;4118;1299;3898;41;90;1191;3653;1232;3743
520840;201502;1464;4801;1233;4371;407;1605;262;930;669;2535
520850;201502;642;1933;516;1742;140;531;236;773;376;1304
520860;201502;6718;19098;5054;16690;1358;4857;2165;7354;3523;12211
520870;201502;109905;297597;75223;238739;21101;74462;19036;57750;40137;132212
520880;201502;7047;20181;5172;17285;1529;5781;811;2619;2340;8400
520890;201502;3906;11107;3264;10051;672;2209;1643;5080;2315;7289
520910;201502;3644;10823;2732;9028;863;3068;526;1666;1389;4734
520915;201502;841;2400;637;2019;129;442;279;857;408;1299
520920;201502;3364;9111;2383;7526;586;1992;780;2561;1366;4553
520929;201502;547;1508;429;1327;124;389;210;667;334;1056
520940;201502;1032;3018;878;2793;98;356;636;2005;734;2361
520945;201502;718;1744;589;1549;171;420;287;769;458;1189
520960;201502;762;2310;639;2094;105;360;340;1145;445;1505
520970;201502;3205;9475;2682;8564;629;2205;1009;3156;1638;5361
520980;201502;811;2324;751;2233;245;808;389;1114;634;1922
520990;201502;2907;9637;2762;9426;534;1883;1801;6347;2335;8230
520993;201502;1068;2842;873;2535;73;225;617;1807;690;2032
520995;201502;2532;6940;2301;6636;333;969;1672;4874;2005;5843
521000;201502;6958;21255;5969;19555;1485;5554;2537;8064;4022;13618
521010;201502;3805;11516;3128;10255;803;2840;1192;3940;1995;6780
521015;201502;664;1854;559;1686;129;368;304;950;433;1318
521020;201502;3901;11090;2785;8838;809;2794;481;1326;1290;4120
521030;201502;591;1557;510;1427;112;314;273;776;385;1090
521040;201502;5670;15633;4927;14534;1754;5276;2119;6656;3873;11932
521056;201502;880;2727;744;2503;241;865;312;1103;553;1968
521060;201502;1146;3208;1003;2990;275;769;437;1355;712;2124
521080;201502;1200;2881;742;2132;119;420;286;690;405;1110
521090;201502;2893;8090;2353;7379;765;2515;947;3127;1712;5642
521100;201502;1633;3941;1385;3669;242;624;948;2631;1190;3255
521120;201502;4421;12472;3735;11501;897;2938;1882;5899;2779;8837
521130;201502;1040;2876;802;2427;142;530;453;1324;595;1854
521140;201502;994;3181;856;2901;266;973;247;824;513;1797
521150;201502;12772;33005;8052;23945;2590;8373;2164;6296;4754;14669
521160;201502;830;2013;516;1456;103;317;228;608;331;925
521170;201502;1211;2944;956;2600;230;636;544;1475;774;2111
521180;201502;6525;21667;5946;20628;2176;8042;1831;6386;4007;14428
521190;201502;9413;26999;6537;21883;1837;6598;1795;6049;3632;12647
521200;201502;737;1942;629;1780;70;235;411;1133;481;1368
521205;201502;592;1760;468;1534;56;208;269;886;325;1094
521210;201502;905;2494;633;1982;208;754;215;586;423;1340
521220;201502;3677;10202;2912;9167;882;3062;1183;3672;2065;6734
521225;201502;358;895;283;806;31;85;202;603;233;688
521230;201502;1194;3740;1090;3534;358;1255;522;1635;880;2890
521250;201502;26935;87562;24598;84052;9905;36244;8537;29627;18442;65871
521260;201502;755;1835;607;1589;92;310;377;911;469;1221
521270;201502;1824;5683;1678;5468;158;416;1313;4492;1471;4908
521280;201502;1843;5714;1540;5145;468;1680;520;1708;988;3388
521290;201502;516;1485;383;1269;109;424;143;457;252;881
521295;201502;1062;2848;945;2693;84;252;796;2302;880;2554
521300;201502;1689;4975;1543;4752;277;846;987;3137;1264;3983
521305;201502;799;2226;666;2036;121;354;429;1373;550;1727
521308;201502;4649;13932;3744;12195;878;3006;1775;5759;2653;8765
521310;201502;7537;22593;5694;19115;1644;6005;1294;4014;2938;10019
521340;201502;246;723;222;689;32;118;143;426;175;544
521350;201502;1926;5275;1631;4839;220;664;1147;3492;1367;4156
521370;201502;913;2840;780;2602;242;881;244;774;486;1655
521375;201502;1308;3851;1107;3512;267;939;534;1615;801;2554
521377;201502;1012;2735;966;2684;69;130;855;2472;924;2602
521380;201502;4872;13757;3523;11254;709;2474;729;2347;1438;4821
521385;201502;515;1412;442;1318;105;341;246;719;351;1060
521390;201502;894;2435;699;2171;201;722;223;669;424;1391
521400;201502;2162;6035;1961;5789;271;880;1500;4432;1771;5312
521405;201502;1348;3855;1071;3355;324;1145;474;1475;798;2620
521410;201502;712;2218;651;2121;231;730;288;1011;519;1741
521440;201502;1380;3875;1332;3811;88;241;1180;3420;1268;3661
521450;201502;4424;13884;3610;12378;1070;4016;925;3131;1995;7147
521460;201502;6512;19486;5712;18185;1394;4884;2893;9086;4287;13970
521470;201502;726;2066;546;1717;141;498;101;298;242;796
521480;201502;385;1166;293;964;74;251;106;343;180;594
521483;201502;2804;7316;2179;6257;602;1833;702;1948;1304;3781
521486;201502;1531;3976;1319;3665;135;405;1006;2777;1141;3182
521487;201502;636;1639;456;1371;92;260;203;652;295;912
521490;201502;781;2318;652;2109;69;286;463;1476;532;1762
521500;201502;1331;4285;1065;3705;203;815;396;1245;599;2060
521520;201502;877;2120;681;1855;181;487;327;934;508;1421
521523;201502;11907;44226;11133;42915;4258;17636;1952;8262;6210;25898
521525;201502;1029;2705;915;2550;107;364;664;1804;771;2168
521530;201502;1618;4690;1036;3481;255;928;196;593;451;1521
521540;201502;965;2630;673;2131;166;630;210;608;376;1238
521550;201502;987;2513;867;2330;222;638;461;1206;683;1844
521560;201502;4231;13850;3632;12979;1404;5508;1157;4044;2561;9552
521565;201502;687;1756;588;1637;93;240;407;1169;500;1409
521570;201502;4392;12430;3090;9797;827;2833;964;3033;1791;5866
521580;201502;573;1333;397;1098;114;348;137;367;251;715
521590;201502;637;1851;517;1658;162;562;93;316;255;878
521600;201502;562;1474;391;1190;103;338;114;308;217;646
521630;201502;1495;3804;1100;3218;277;967;211;483;488;1450
521640;201502;1911;5019;1526;4490;460;1512;624;1872;1084;3384
521645;201502;589;1726;466;1448;71;248;210;599;281;847
521680;201502;1444;4624;1225;4175;641;2342;199;631;840;2973
521690;201502;565;1677;508;1576;116;429;244;698;360;1127
521710;201502;2561;7912;2179;7140;492;1699;1004;3305;1496;5004
521720;201502;1866;5352;1597;4967;316;997;1039;3240;1355;4237
521730;201502;3777;12475;3395;11752;1374;5314;892;2804;2266;8118
521740;201502;3286;9032;2596;8120;838;2853;1228;4011;2066;6864
521760;201502;12111;40855;11088;39204;2339;9250;6164;21989;8503;31239
521770;201502;2591;7685;2130;6842;809;2793;630;1916;1439;4709
521800;201502;7632;22714;6606;21040;2111;7218;2600;8560;4711;15778
521805;201502;875;2018;639;1675;158;378;349;995;507;1373
521810;201502;686;1943;568;1756;127;423;301;928;428;1351
521830;201502;5064;16778;4674;16198;844;3186;3114;10815;3958;14001
521839;201502;736;2069;568;1756;120;423;196;566;316;989
521850;201502;6447;17804;5213;15585;1212;3769;1836;5118;3048;8887
521860;201502;1805;5135;1440;4508;333;1159;490;1487;823;2646
521870;201502;479;1675;441;1579;138;536;132;438;270;974
521878;201502;717;2120;524;1712;118;439;220;688;338;1127
521880;201502;24324;62397;16165;49237;4469;14630;5088;15674;9557;30304
521890;201502;3528;10702;2859;9407;975;3482;711;2274;1686;5756
521900;201502;1432;3717;1094;3279;264;869;484;1371;748;2240
521910;201502;1038;2900;922;2764;186;580;573;1793;759;2373
521920;201502;344;1034;297;954;100;366;92;264;192;630
521925;201502;636;1911;553;1763;106;373;230;673;336;1046
521930;201502;3901;12592;3503;11862;1192;4316;933;3154;2125;7470
521935;201502;632;1821;565;1703;150;454;280;827;430;1281
521940;201502;1006;2835;832;2550;240;778;342;1038;582;1816
521945;201502;630;2131;592;2082;106;343;416;1554;522;1897
521950;201502;583;1648;467;1468;103;355;221;707;324;1062
521960;201502;771;2272;631;2025;133;497;281;862;414;1359
521970;201502;2370;6801;2120;6478;307;963;1549;4841;1856;5804
521971;201502;1082;2920;814;2433;170;541;261;726;431;1267
521973;201502;858;2746;731;2509;185;675;249;828;434;1503
521975;201502;12498;34521;11715;33615;1783;5323;8658;24956;10441;30279
521980;201502;1875;5595;1694;5379;245;685;1322;4397;1567;5082
521990;201502;1036;3095;892;2874;122;451;579;1858;701;2309
522000;201502;1802;5489;1555;5154;238;928;1019;3364;1257;4292
522005;201502;412;1017;278;803;78;216;92;271;170;487
522010;201502;3079;9064;2588;8263;961;3198;587;1860;1548;5058
522015;201502;870;2630;747;2443;193;662;384;1259;577;1921
522020;201502;5078;13438;4288;12398;929;2850;2626;7630;3555;10480
522026;201502;585;1579;423;1390;123;458;139;449;262;907
522028;201502;526;1564;435;1361;82;268;270;834;352;1102
522040;201502;2598;6520;2006;5770;472;1416;1094;3174;1566;4590
522045;201502;14651;47666;12376;43157;3942;15193;2690;9115;6632;24308
522050;201502;1086;3088;841;2654;244;836;312;911;556;1747
522060;201502;2793;8420;2194;7496;643;2435;1020;3398;1663;5833
522068;201502;1585;5096;1468;4967;116;306;1235;4411;1351;4717
522070;201502;791;2399;712;2276;76;305;508;1608;584;1913
522100;201502;635;1837;561;1727;196;684;258;739;454;1423
522108;201502;888;2743;770;2566;70;257;599;1991;669;2248
522119;201502;1355;4217;1171;3949;243;862;651;2280;894;3142
522130;201502;456;1338;404;1274;115;382;227;719;342;1101
522140;201502;17404;48056;14534;43505;4226;13721;5386;15551;9612;29272
522145;201502;802;2278;734;2174;360;1157;208;593;568;1750
522150;201502;924;2615;816;2435;243;748;328;966;571;1714
522155;201502;772;2243;686;2112;119;358;462;1469;581;1827
522157;201502;690;1983;592;1840;54;198;474;1468;528;1666
522160;201502;5979;17039;4371;14198;1537;5574;603;1817;2140;7391
522170;201502;3128;8754;2607;7943;821;2565;877;2776;1698;5341
522180;201502;344;1002;271;881;91;318;92;307;183;625
522185;201502;15975;47399;13699;44425;3228;11202;7656;25131;10884;36333
522190;201502;968;2442;755;2114;120;350;423;1211;543;1561
522200;201502;1575;5139;1391;4768;430;1604;417;1354;847;2958
522205;201502;1361;3987;1141;3636;305;1039;521;1651;826;2690
522220;201502;1400;3794;1126;3457;282;878;563;1912;845;2790
522230;201502;1157;3370;1009;3134;121;439;691;2150;812;2589
530010;201502;237049;750425;211539;704714;60030;221881;72857;238382;132887;460263
110001;201501;3876;12352;3249;11394;749;2779;1837;6533;2586;9312
110002;201501;12859;39617;10660;35751;3108;11446;4357;14463;7465;25909
110003;201501;854;2736;776;2606;229;815;253;815;482;1630
110004;201501;10165;32426;8516;29087;2810;10415;2179;7391;4989;17806
110005;201501;1900;6237;1736;5925;619;2178;733;2501;1352;4679
110006;201501;2195;6559;1543;5431;509;1920;321;1012;830;2932
110007;201501;1403;4331;1324;4218;286;1005;686;2424;972;3429
110008;201501;2350;8053;2242;7889;387;1274;1676;6180;2063;7454
110009;201501;4766;14336;3926;12993;1089;4021;1617;5158;2706;9179
110010;201501;7783;22805;6857;21634;1544;4539;4085;14117;5629;18656
110011;201501;8502;26197;7185;23820;2365;8281;2804;9185;5169;17466
110012;201501;14161;42853;11981;38834;3770;12922;4012;12978;7782;25900
110013;201501;5308;16493;4277;14923;1453;5366;1547;5563;3000;10929
110014;201501;4440;12786;3667;11661;726;2396;2292;7401;3018;9797
110015;201501;5085;15438;3853;13267;1214;4590;1197;4098;2411;8688
110018;201501;4335;12423;3407;11231;912;3439;1591;5069;2503;8508
110020;201501;57187;162293;44848;146135;9539;32863;24363;81586;33902;114449
110025;201501;4227;12374;3535;11108;587;1971;2324;7265;2911;9236
110026;201501;651;2032;611;1974;149;476;377;1248;526;1724
110028;201501;7735;22184;5655;18731;1616;5911;1086;3430;2702;9341
110029;201501;1343;4043;1173;3738;352;1171;515;1658;867;2829
110030;201501;9851;27739;7976;25219;1946;6692;3884;12645;5830;19337
110032;201501;4055;12978;3608;12043;1132;3953;1301;4292;2433;8245
110033;201501;5393;17266;5004;16677;1534;4995;2536;9030;4070;14025
110034;201501;3565;9461;3056;8828;548;1506;2253;6647;2801;8153
110037;201501;2094;7049;1808;6522;419;1577;998;3644;1417;5221
110040;201501;3442;10997;3095;10381;924;3381;1471;4849;2395;8230
110045;201501;5058;16886;4512;16244;1412;5487;2415;8628;3827;14115
110050;201501;1638;5271;1424;4958;407;1426;798;2871;1205;4297
110060;201501;820;2773;737;2611;234;929;296;1021;530;1950
110070;201501;1940;6593;1866;6439;406;1481;1156;3993;1562;5474
110080;201501;3690;10966;3406;10637;326;865;2874;9316;3200;10181
110090;201501;772;2364;657;2158;187;708;292;883;479;1591
110092;201501;1324;4528;1247;4426;200;729;863;3174;1063;3903
110094;201501;3399;10457;3130;10075;870;2855;1726;5718;2596;8573
110100;201501;2301;7361;2077;6983;610;2169;1081;3621;1691;5790
110110;201501;1702;5406;1571;5247;677;2372;617;2107;1294;4479
110120;201501;1826;5926;1459;5126;459;1684;414;1464;873;3148
110130;201501;2631;7539;1994;6564;630;2184;742;2444;1372;4628
110140;201501;2496;8280;2228;7827;456;1694;1315;4686;1771;6380
110143;201501;1257;4067;1005;3604;242;909;512;1810;754;2719
110145;201501;1034;2990;875;2738;181;618;525;1624;706;2242
110146;201501;435;1377;388;1309;79;277;227;777;306;1054
110147;201501;831;2405;640;2081;171;613;238;683;409;1296
110148;201501;1348;4036;1015;3363;306;1074;295;951;601;2025
110149;201501;3607;10732;2943;9689;870;2909;1552;5264;2422;8173
110150;201501;2489;7474;2193;7036;259;950;1464;4774;1723;5724
110155;201501;875;2763;815;2629;231;792;421;1330;652;2122
110160;201501;2191;6823;1822;6155;579;2020;799;2724;1378;4744
110170;201501;3103;8777;2324;7426;523;1792;1298;4110;1821;5902
110175;201501;1809;5384;1360;4810;236;912;812;2941;1048;3853
110180;201501;1477;4377;1231;4003;279;931;742;2459;1021;3390
120001;201501;2799;9815;2657;9580;509;1979;1699;6225;2208;8204
120005;201501;1465;6126;1430;6070;134;588;1159;5041;1293;5629
120010;201501;4473;15692;4249;15324;694;2440;3074;11448;3768;13888
120013;201501;1725;6870;1667;6779;390;1555;1061;4570;1451;6125
120017;201501;2026;7313;1902;7087;519;1947;923;3763;1442;5710
120020;201501;14005;62288;13603;61512;2100;9210;10036;47363;12136;56573
120025;201501;2607;9050;2515;8921;487;1878;1649;5904;2136;7782
120030;201501;6068;23995;5950;23861;287;1083;5405;21995;5692;23078
120032;201501;1425;6832;1367;6695;204;1169;985;4848;1189;6017
120033;201501;3416;13563;3390;13520;126;540;3155;12686;3281;13226
120034;201501;1934;7949;1878;7865;178;867;1575;6555;1753;7422
120035;201501;2866;13587;2826;13501;207;991;2459;11984;2666;12975
120038;201501;2669;9844;2559;9628;656;2573;1456;5587;2112;8160
120039;201501;1542;8167;1513;8100;181;1029;1208;6559;1389;7588
120040;201501;45690;163636;41707;155737;10996;43840;20685;78834;31681;122674
120042;201501;2864;12354;2733;12068;394;1888;1953;8783;2347;10671
120043;201501;873;4243;844;4191;63;287;717;3687;780;3974
120045;201501;4228;14564;4161;14473;725;2609;3191;11205;3916;13814
120050;201501;7888;32983;7557;32260;1313;5522;5104;22875;6417;28397
120060;201501;7221;33059;7115;32870;556;2788;6085;28558;6641;31346
120070;201501;2677;10173;2611;10023;471;1761;1784;7115;2255;8876
120080;201501;3620;13772;3465;13525;506;1965;2644;10628;3150;12593
130002;201501;2924;12385;2790;12153;203;993;2354;10335;2557;11328
130006;201501;1884;7973;1662;7558;271;1373;1121;5158;1392;6531
130008;201501;2042;8323;1956;8180;159;713;1615;6839;1774;7552
130010;201501;2837;9492;2483;9082;181;629;2167;8070;2348;8699
130014;201501;3243;10605;2874;10058;462;1740;1912;6761;2374;8501
130020;201501;2629;9399;2620;9388;23;75;2590;9297;2613;9372
130030;201501;7050;27020;6798;26724;630;2094;5746;23496;6376;25590
130040;201501;3791;11668;3424;11192;266;975;2898;9578;3164;10553
130050;201501;6136;24439;5545;23558;559;2291;4251;19025;4810;21316
130060;201501;5711;26006;5443;25591;505;2583;4427;21051;4932;23634
130063;201501;3417;15265;3372;15201;267;1143;2935;13534;3202;14677
130068;201501;3044;12825;2792;12338;391;1884;1911;8544;2302;10428
130070;201501;6632;21794;5949;20944;627;2164;4730;17134;5357;19298
130080;201501;4847;22005;4646;21701;853;4134;3182;15343;4035;19477
130083;201501;2162;8577;2044;8396;287;1387;1496;6132;1783;7519
130090;201501;2548;9228;2466;9112;135;581;2224;8216;2359;8797
130100;201501;5445;20541;5241;20275;255;1134;4763;18437;5018;19571
130110;201501;6540;21440;6143;20970;509;1647;5248;18365;5757;20012
130115;201501;4222;15050;4043;14819;72;223;3880;14321;3952;14544
130120;201501;13807;52906;13166;52078;1191;4315;11153;45478;12344;49793
130130;201501;3589;15165;3538;15068;313;1428;2977;12811;3290;14239
130140;201501;6211;24229;6142;24148;99;237;6012;23838;6111;24075
130150;201501;3419;13101;3348;13009;159;758;3067;11854;3226;12612
130160;201501;4075;16840;3973;16704;272;1042;3595;15332;3867;16374
130165;201501;2842;11712;2737;11541;345;1535;2182;9308;2527;10843
130170;201501;8790;32248;7911;31158;1022;4137;6102;24718;7124;28855
130180;201501;3452;11080;3372;10966;115;314;3136;10308;3251;10622
130185;201501;10397;34355;9530;33355;982;3132;7818;28579;8800;31711
130190;201501;16569;57512;14597;55002;2724;10303;9666;38206;12390;48509
130195;201501;1885;7859;1829;7779;105;444;1627;7024;1732;7468
130200;201501;1941;7023;1811;6808;498;1854;1075;4176;1573;6030
130210;201501;1164;4609;1103;4523;112;521;917;3784;1029;4305
130220;201501;1972;8166;1809;7854;332;1626;1049;4588;1381;6214
130230;201501;3618;16244;3422;15928;388;1767;2615;12740;3003;14507
130240;201501;8308;32018;7723;31152;389;1884;6777;27553;7166;29437
130250;201501;19152;67134;18190;65898;2204;7365;14315;54239;16519;61604
130255;201501;4168;14675;3951;14333;139;442;3623;13398;3762;13840
130260;201501;244572;800911;221934;763943;61562;222335;110695;389803;172257;612138
130270;201501;6994;29574;6466;28720;901;4071;4792;22051;5693;26122
130280;201501;3227;12989;3148;12876;116;436;2901;12096;3017;12532
130290;201501;11044;39245;10731;38864;153;321;10330;38009;10483;38330
130300;201501;4240;16709;4058;16422;293;1387;3429;13914;3722;15301
130310;201501;5037;18963;4651;18487;369;1449;3908;15899;4277;17348
130320;201501;2880;10170;2655;9860;347;1294;1960;7484;2307;8778
130330;201501;3450;12847;3233;12559;184;840;2817;11020;3001;11860
130340;201501;17609;68033;16560;66626;3090;12015;11611;48988;14701;61003
130350;201501;3185;13249;3121;13160;276;1295;2640;11223;2916;12518
130353;201501;5819;17833;5085;16879;1161;3779;3139;11161;4300;14940
130356;201501;4342;15772;4143;15478;347;1132;3469;13535;3816;14667
130360;201501;2996;8735;2751;8472;35;57;2660;8334;2695;8391
130370;201501;5178;20281;4448;19316;281;1490;3700;16160;3981;17650
130380;201501;7144;30091;6859;29703;474;2148;5932;26056;6406;28204
130390;201501;4817;21509;4498;20954;463;2339;3489;16591;3952;18930
130395;201501;2017;7327;1780;6841;228;915;1222;4716;1450;5631
130400;201501;2058;7851;1989;7753;140;575;1768;6944;1908;7519
130406;201501;10103;38537;9075;37000;2142;8971;5490;23258;7632;32229
130410;201501;3913;14962;3580;14361;1073;4635;1620;6656;2693;11291
130420;201501;10218;43314;9856;42721;2883;12163;5859;26737;8742;38900
130423;201501;3205;12468;3025;12228;265;1248;2554;10348;2819;11596
130426;201501;2037;8930;1977;8830;285;1276;1493;6890;1778;8166
130430;201501;3397;12173;3261;11976;418;1620;2483;9241;2901;10861
130440;201501;3546;13093;3414;12951;174;617;3124;12038;3298;12655
140002;201501;1639;5248;1542;5134;164;535;1185;4050;1349;4585
140005;201501;3024;8840;2855;8658;78;174;2724;8353;2802;8527
140010;201501;47438;148509;41235;138792;10084;36463;20713;71527;30797;107990
140015;201501;2944;9506;2794;9310;356;952;2207;7740;2563;8692
140017;201501;3303;10181;3013;9819;284;794;2420;8229;2704;9023
140020;201501;4457;15225;4185;14857;377;1252;3436;12575;3813;13827
140023;201501;2105;7150;1878;6804;238;910;1330;4913;1568;5823
140028;201501;2144;5900;2083;5834;64;118;1985;5654;2049;5772
140030;201501;3617;11487;3449;11282;431;1110;2855;9763;3286;10873
140040;201501;1542;7318;1500;7212;126;686;1186;5784;1312;6470
140045;201501;2387;8849;2195;8570;438;1564;1432;6112;1870;7676
140047;201501;5394;15100;4823;14356;1415;4333;2387;7544;3802;11877
140050;201501;1470;4622;1342;4449;205;724;934;3144;1139;3868
140060;201501;1465;4568;1325;4345;284;963;838;2832;1122;3795
140070;201501;1469;7553;1434;7434;91;543;1245;6451;1336;6994
150010;201501;33587;105821;31960;103686;1952;6539;27512;90468;29464;97007
150013;201501;1622;4775;1497;4635;162;452;1194;3807;1356;4259
150020;201501;12104;40748;11769;40300;885;3012;10234;35498;11119;38510
150030;201501;6538;28196;6341;27903;588;2211;5389;24622;5977;26833
150034;201501;4312;11929;4104;11669;233;589;3704;10667;3937;11256
150040;201501;12514;41753;10840;39715;2169;7351;7367;29015;9536;36366
150050;201501;5678;21868;5494;21549;378;1663;4699;18545;5077;20208
150060;201501;15979;51283;14879;49656;2671;8586;10365;35820;13036;44406
150070;201501;5873;24130;5282;23482;395;1876;4580;20643;4975;22519
150080;201501;63678;170463;55215;159359;8935;24570;36991;110636;45926;135206
150085;201501;5059;17702;4821;17375;538;1677;3925;14729;4463;16406
150090;201501;9699;37865;9291;37274;824;3261;7688;31483;8512;34744
150095;201501;5180;17490;4743;16849;424;1403;3834;14095;4258;15498
150100;201501;3281;12387;3121;12125;199;981;2626;10108;2825;11089
150110;201501;3243;15995;3232;15969;143;646;3013;15053;3156;15699
150120;201501;5956;23164;5811;22915;726;2837;4620;18501;5346;21338
150125;201501;713;2166;660;2098;126;455;430;1325;556;1780
150130;201501;21094;64830;19734;62942;1754;5475;15782;51488;17536;56963
150140;201501;147289;427341;140894;419403;14003;41013;116718;352336;130721;393349
150145;201501;4429;14347;4113;13942;568;1991;3154;10836;3722;12827
150150;201501;10713;34102;10022;33058;1702;5829;6981;23351;8683;29180
150157;201501;3061;9328;2705;8828;357;1282;2004;6619;2361;7901
150160;201501;2956;9741;2774;9485;721;2440;1648;5873;2369;8313
150170;201501;21478;79629;20306;77891;3493;13477;14526;56760;18019;70237
150172;201501;2937;10275;2652;9829;397;1510;1941;7346;2338;8856
150175;201501;1946;5952;1851;5849;100;234;1646;5438;1746;5672
150178;201501;10112;31833;9118;30746;730;2388;7462;26033;8192;28421
150180;201501;17736;71462;17064;70562;1444;6430;14325;59939;15769;66369
150190;201501;7191;23306;6823;22815;395;914;5955;20722;6350;21636
150195;201501;4995;16805;4646;16234;361;1353;3891;13708;4252;15061
150200;201501;5185;16766;4980;16526;141;432;4632;15572;4773;16004
150210;201501;23550;89911;22821;88874;2170;7783;18939;76341;21109;84124
150215;201501;6158;19616;5429;18527;1407;5074;2713;9469;4120;14543
150220;201501;12433;39068;11213;37215;2558;8761;6025;20449;8583;29210
150230;201501;11214;37576;10039;35915;1050;4370;7684;27496;8734;31866
150240;201501;34705;103829;30840;97417;9832;32216;11898;39186;21730;71402
150250;201501;4109;16620;3970;16418;523;2191;3063;13055;3586;15246
150260;201501;2110;8489;2015;8321;402;1706;1261;5362;1663;7068
150270;201501;8691;26961;6999;24848;1466;5547;4439;16063;5905;21610
150275;201501;5734;21010;5473;20617;712;2731;4167;16010;4879;18741
150276;201501;2053;6217;1874;5978;365;1247;1365;4363;1730;5610
150277;201501;4901;15362;4269;14589;588;2011;3174;11227;3762;13238
150280;201501;5790;25813;5631;25454;1088;4884;3806;17777;4894;22661
150285;201501;2628;10679;2528;10487;497;2141;1635;7032;2132;9173
150290;201501;9478;28373;9094;27943;713;1763;7848;25052;8561;26815
150293;201501;9282;26275;7336;23524;2228;7586;2865;9968;5093;17554
150295;201501;6639;20181;5571;18933;1063;3401;3843;14016;4906;17417
150300;201501;1782;6299;1718;6221;119;403;1426;5335;1545;5738
150304;201501;3986;12590;3505;11914;529;1817;2441;8566;2970;10383
150307;201501;6436;21983;5978;21348;397;1406;5128;18573;5525;19979
150309;201501;6259;21938;5811;21377;1278;4642;3907;15108;5185;19750
150310;201501;5639;25309;5486;25057;670;3166;4301;20069;4971;23235
150320;201501;8785;21342;8278;20822;445;751;7473;19439;7918;20190
150330;201501;13340;46631;12498;45426;1453;5127;9720;36486;11173;41613
150340;201501;2337;7639;2171;7392;311;1123;1593;5499;1904;6622
150345;201501;6450;21911;6048;21374;602;2103;4932;17858;5534;19961
150350;201501;7604;24442;7163;23854;1083;3155;5355;18557;6438;21712
150360;201501;20448;64825;18031;61694;2763;9547;12671;44819;15434;54366
150370;201501;9336;35188;8937;34661;1078;3703;7344;29576;8422;33279
150375;201501;2727;11850;2663;11761;268;1112;2265;10281;2533;11393
150380;201501;9565;28279;8554;26912;694;2308;7105;22632;7799;24940
150390;201501;7675;33352;7277;32646;1337;5818;4904;22944;6241;28762
150400;201501;5576;22472;5353;22002;531;2169;4169;17588;4700;19757
150405;201501;7959;24423;7097;23351;1266;3571;5024;17775;6290;21346
150410;201501;1611;6293;1544;6167;246;1085;1035;4190;1281;5275
150420;201501;34962;120815;30461;113502;8614;34391;13610;52987;22224;87378
150430;201501;6666;23616;6374;23139;797;2914;4773;17755;5570;20669
150440;201501;5384;18851;5186;18574;952;3270;3684;13652;4636;16922
150442;201501;19476;58413;17924;56221;3095;10071;12007;38382;15102;48453
150445;201501;5056;17845;4718;17304;570;2007;3626;13667;4196;15674
150450;201501;4301;20732;4142;20501;357;1789;3491;17636;3848;19425
150460;201501;6327;24696;5791;24074;338;1571;5112;21639;5450;23210
150470;201501;16904;51690;16291;50955;586;1404;15198;48369;15784;49773
150475;201501;1781;6174;1651;6008;196;699;1335;5015;1531;5714
150480;201501;13343;46293;12656;45278;1046;3921;10633;38534;11679;42455
150490;201501;6676;25797;6530;25586;280;1100;5937;23549;6217;24649
150495;201501;4904;18098;4790;17946;166;626;4476;16890;4642;17516
150497;201501;2891;10508;2629;10046;806;3241;1376;5295;2182;8536
150500;201501;3073;8618;2879;8338;376;1097;2163;6279;2539;7376
150503;201501;3622;11393;3147;10807;1118;3927;1575;5669;2693;9596
150506;201501;11294;40082;10302;38688;2270;7988;6769;27080;9039;35068
150510;201501;9417;37289;8738;36068;1270;5329;6246;26714;7516;32043
150520;201501;6631;25748;6543;25629;210;637;6196;24610;6406;25247
150530;201501;11579;40617;10531;39014;1166;4163;8082;30722;9248;34885
150540;201501;4503;14005;4102;13430;295;1005;3415;11221;3710;12226
150543;201501;5254;16548;4769;15848;1033;3593;3087;10449;4120;14042
150548;201501;8500;27392;8009;26776;348;1059;7312;24799;7660;25858
150549;201501;2131;6866;1993;6707;65;130;1857;6415;1922;6545
150550;201501;19612;62228;17246;58289;5284;18550;7385;25542;12669;44092
150553;201501;20977;73416;17958;66974;6944;27704;4623;17409;11567;45113
150555;201501;1615;5037;1447;4802;139;527;1150;3820;1289;4347
150560;201501;1915;6247;1819;6042;254;863;1268;4223;1522;5086
150563;201501;2895;9498;2701;9160;646;2353;1523;5198;2169;7551
150565;201501;3526;12378;3252;11951;201;884;2661;9885;2862;10769
150570;201501;5535;20680;5425;20495;384;1464;4603;17778;4987;19242
150580;201501;9476;39690;9276;39450;582;2234;8306;36178;8888;38412
150590;201501;5601;22697;5457;22526;94;285;5246;21893;5340;22178
150600;201501;7756;30002;7506;29635;405;1565;6738;27058;7143;28623
150610;201501;2360;8140;2163;7744;256;1018;1515;5367;1771;6385
150611;201501;2683;9532;2516;9197;230;911;1945;7151;2175;8062
150613;201501;11892;36658;10340;34402;3442;11853;4823;16640;8265;28493
150616;201501;2983;9127;2366;8207;602;2301;1098;3690;1700;5991
150618;201501;6194;21939;5869;21364;1680;6353;3166;11721;4846;18074
150619;201501;5020;17586;4725;17135;571;2303;3521;12803;4092;15106
150620;201501;6081;22300;5624;21725;746;2837;4475;17821;5221;20658
150630;201501;5519;16896;5264;16594;350;1076;4594;14763;4944;15839
150635;201501;4054;13475;3775;12950;764;2701;2179;7698;2943;10399
150640;201501;1728;5353;1677;5289;197;583;1364;4503;1561;5086
150650;201501;12216;37362;10956;35190;2926;9634;5260;17435;8186;27069
150655;201501;4940;16963;4732;16600;513;1902;3739;13254;4252;15156
150658;201501;4206;13325;3828;12784;774;2939;2502;8343;3276;11282
150660;201501;5501;17697;5050;17066;1266;4179;2948;10378;4214;14557
150670;201501;6111;17236;5131;16008;1138;3645;3376;10904;4514;14549
150680;201501;51880;195253;47700;187853;15023;60471;21676;91183;36699;151654
150690;201501;1967;6189;1790;5900;335;1038;1144;3929;1479;4967
150700;201501;6115;18789;5607;18143;1062;3532;3756;12456;4818;15988
150710;201501;4217;14074;3796;13411;421;1472;2886;10427;3307;11899
150715;201501;4898;15694;4310;14824;528;1937;3270;11397;3798;13334
150720;201501;6392;26282;6042;25668;891;3808;4394;19404;5285;23212
150730;201501;9054;31707;8677;31150;916;3191;7181;26348;8097;29539
150740;201501;3675;11731;3321;11123;498;1761;2141;7260;2639;9021
150745;201501;5300;16900;4913;16374;1007;3511;3329;11130;4336;14641
150746;201501;1404;4598;1337;4481;195;710;918;3101;1113;3811
150747;201501;5178;16515;4628;15809;490;1456;3550;12836;4040;14292
150750;201501;2945;10031;2813;9864;134;439;2571;9135;2705;9574
150760;201501;10716;35341;10105;34538;2163;7449;6558;23129;8721;30578
150770;201501;5773;21920;5529;21572;642;2370;4404;18133;5046;20503
150775;201501;1153;3577;1024;3350;206;823;594;1874;800;2697
150780;201501;3141;10373;3100;10328;55;136;2982;10032;3037;10168
150790;201501;4949;16054;4574;15584;392;1349;3812;13383;4204;14732
150795;201501;15599;48318;14056;46132;2789;8961;9090;31005;11879;39966
150796;201501;2905;8797;2697;8559;344;1053;2100;6905;2444;7958
150797;201501;3720;12562;3481;12207;144;566;3080;10883;3224;11449
150800;201501;13513;45386;12449;44088;2461;8047;8752;32729;11213;40776
150803;201501;6511;23700;6154;23145;686;2633;4712;18129;5398;20762
150805;201501;2720;9542;2544;9285;309;1107;1931;7220;2240;8327
150808;201501;5754;19678;4966;18229;2082;8165;1088;4060;3170;12225
150810;201501;18823;59665;16128;56382;2235;7458;11691;43105;13926;50563
150812;201501;5245;16532;4840;15888;481;2021;3620;11452;4101;13473
150815;201501;8472;27597;7681;26629;835;2818;6310;22401;7145;25219
150820;201501;11144;31791;9912;30441;661;1372;8671;27696;9332;29068
150830;201501;13051;49026;11982;47385;620;2692;10050;41068;10670;43760
150835;201501;1930;6962;1794;6665;468;1857;821;3067;1289;4924
150840;201501;6933;20830;5820;19154;1352;4873;3101;10103;4453;14976
160005;201501;669;2492;627;2421;81;374;447;1700;528;2074
160010;201501;1420;4724;1416;4719;79;181;1308;4472;1387;4653
160015;201501;1599;6028;1560;5966;89;304;1382;5430;1471;5734
160020;201501;1987;7019;1850;6831;256;925;1353;5227;1609;6152
160021;201501;936;4032;916;3999;160;761;662;2935;822;3696
160023;201501;1023;4110;1009;4091;68;244;895;3705;963;3949
160025;201501;1219;3748;1207;3735;8;30;1192;3689;1200;3719
160027;201501;8100;24478;7507;23829;2676;8062;3936;13519;6612;21581
160030;201501;42606;154214;38100;145695;9023;34539;21877;87849;30900;122388
160040;201501;4179;16314;4088;16182;125;589;3838;15188;3963;15777
160050;201501;3205;12125;2924;11747;1286;5133;1253;5359;2539;10492
160053;201501;2592;10130;2531;10036;551;2258;1726;6984;2277;9242
160055;201501;671;2643;659;2631;96;420;509;2044;605;2464
160060;201501;15469;52739;14517;51687;2947;9955;10291;38201;13238;48156
160070;201501;2349;9308;2293;9224;124;522;2061;8374;2185;8896
160080;201501;2517;9396;2510;9389;31;98;2466;9262;2497;9360
170025;201501;539;1811;498;1756;159;569;246;915;405;1484
170030;201501;1131;3707;1010;3490;299;1041;444;1585;743;2626
170035;201501;1474;4379;1205;3890;401;1361;403;1347;804;2708
170040;201501;1835;6012;1597;5683;259;1066;1076;3866;1335;4932
170070;201501;1966;5212;1556;4693;392;1281;828;2530;1220;3811
170100;201501;2489;7216;2189;6751;257;835;1698;5239;1955;6074
170105;201501;757;2396;618;2118;125;505;312;1017;437;1522
170110;201501;1073;3352;934;3130;212;774;480;1605;692;2379
170130;201501;1381;4395;1225;4144;284;998;677;2388;961;3386
170190;201501;1575;4619;1219;4068;499;1601;288;1119;787;2720
170200;201501;1534;4400;1086;3576;272;990;365;1172;637;2162
170210;201501;29843;87890;24753;79441;7473;25952;8429;28128;15902;54080
170215;201501;1146;3630;1005;3416;83;327;800;2724;883;3051
170220;201501;5776;19902;5347;19135;1077;4118;3176;11464;4253;15582
170230;201501;1440;4668;1225;4272;267;1118;599;1984;866;3102
170240;201501;2707;8143;2305;7558;292;1140;1619;5261;1911;6401
170255;201501;3562;11365;2963;10392;874;3147;1320;4864;2194;8011
170270;201501;1027;2618;727;2200;98;328;487;1454;585;1782
170290;201501;2685;8402;2512;8195;144;370;2234;7539;2378;7909
170300;201501;1929;6069;1643;5591;227;857;1072;3675;1299;4532
170305;201501;757;2333;615;2071;108;393;339;1161;447;1554
170307;201501;1071;3744;906;3443;183;767;478;1894;661;2661
170310;201501;1616;4482;1270;3944;263;819;674;2197;937;3016
170320;201501;1104;3229;844;2778;209;733;359;1220;568;1953
170330;201501;757;2469;701;2377;117;448;481;1601;598;2049
170360;201501;437;1444;381;1346;94;353;169;583;263;936
170370;201501;1351;3948;1089;3532;232;829;527;1716;759;2545
170380;201501;1856;6061;1534;5555;300;1277;847;3006;1147;4283
170382;201501;558;1862;482;1739;120;499;270;954;390;1453
170384;201501;1545;6343;1451;6179;354;1615;863;3713;1217;5328
170386;201501;946;2814;833;2653;205;739;436;1407;641;2146
170388;201501;642;1916;542;1752;109;428;228;714;337;1142
170389;201501;883;2982;819;2875;97;410;595;2058;692;2468
170390;201501;1295;3837;1137;3638;139;483;854;2790;993;3273
170410;201501;508;1653;457;1561;59;251;301;1004;360;1255
170460;201501;502;1374;357;1127;88;316;123;378;211;694
170510;201501;763;2605;631;2357;95;435;340;1250;435;1685
170550;201501;6220;18314;4804;15813;1692;6173;991;3244;2683;9417
170555;201501;1331;3861;1053;3436;230;824;573;1891;803;2715
170560;201501;991;3340;788;3078;172;734;461;1859;633;2593
170600;201501;1322;3776;1183;3592;243;718;775;2449;1018;3167
170610;201501;1635;4960;1281;4405;149;596;796;2790;945;3386
170625;201501;426;1328;336;1153;66;245;98;340;164;585
170650;201501;1252;4022;1092;3745;270;1006;514;1803;784;2809
170700;201501;3967;12913;3298;11823;693;2739;1654;6198;2347;8937
170710;201501;1844;5455;1504;4856;246;848;921;3015;1167;3863
170720;201501;1879;5038;1591;4604;307;828;1085;3277;1392;4105
170730;201501;1037;2965;855;2694;225;790;420;1333;645;2123
170740;201501;2228;7911;1975;7468;291;1214;1352;5167;1643;6381
170755;201501;835;2585;702;2311;160;580;263;841;423;1421
170765;201501;1346;3674;1067;3220;259;827;494;1531;753;2358
170770;201501;1764;6037;1622;5779;283;1101;1026;3696;1309;4797
170820;201501;3700;11830;3338;11266;854;3039;1585;5479;2439;8518
170825;201501;756;2313;607;2021;126;473;261;845;387;1318
170830;201501;1376;4061;1226;3846;28;51;1132;3611;1160;3662
170900;201501;2686;9456;2553;9224;253;917;2021;7479;2274;8396
170930;201501;3473;10985;2998;10147;955;3478;1045;3525;2000;7003
170950;201501;13759;39628;10278;33640;3542;13042;2268;7216;5810;20258
170980;201501;493;1475;376;1283;94;369;161;511;255;880
171050;201501;1418;4908;1322;4729;83;353;1112;3984;1195;4337
171070;201501;1582;4945;1451;4756;295;994;909;3070;1204;4064
171090;201501;969;2744;819;2529;77;261;600;1848;677;2109
171110;201501;605;1762;467;1531;111;399;252;811;363;1210
171150;201501;870;2507;641;2104;123;450;356;1178;479;1628
171180;201501;673;2041;493;1676;130;469;202;731;332;1200
171190;201501;1763;6414;1532;5955;334;1404;759;3051;1093;4455
171195;201501;839;2986;738;2791;118;488;396;1553;514;2041
171200;201501;697;2254;586;2051;142;552;265;877;407;1429
171215;201501;458;1361;357;1168;69;249;157;523;226;772
171240;201501;763;2640;708;2538;88;355;508;1860;596;2215
171245;201501;655;2165;547;1922;123;503;212;695;335;1198
171250;201501;1102;3194;904;2874;86;313;672;2110;758;2423
171270;201501;436;1788;406;1736;127;536;177;831;304;1367
171280;201501;904;2773;783;2583;187;621;408;1459;595;2080
171320;201501;3830;11650;3285;10750;905;3063;1657;5515;2562;8578
171330;201501;2868;8434;2395;7705;602;2093;1190;3826;1792;5919
171360;201501;1458;4700;1267;4410;200;707;832;2969;1032;3676
171370;201501;708;2026;620;1902;134;460;340;1017;474;1477
171380;201501;1306;4296;1115;3938;412;1479;403;1464;815;2943
171395;201501;882;2671;710;2357;138;562;354;1133;492;1695
171420;201501;2276;6906;1823;6122;440;1582;807;2739;1247;4321
171430;201501;1052;3272;892;3018;200;679;505;1736;705;2415
171488;201501;2493;7605;2240;7264;542;1779;1274;4294;1816;6073
171500;201501;779;2402;678;2215;87;272;449;1507;536;1779
171510;201501;890;3148;799;3000;96;404;553;2113;649;2517
171515;201501;508;1466;395;1283;60;201;216;694;276;895
171525;201501;611;2015;517;1853;104;430;285;1001;389;1431
171550;201501;314;1057;250;934;90;372;32;128;122;500
171570;201501;1217;3857;1084;3606;166;591;763;2533;929;3124
171575;201501;1794;5240;1427;4544;277;904;691;2288;968;3192
171610;201501;5483;18272;4788;17050;1423;5567;1655;5781;3078;11348
171620;201501;2530;7532;2226;7106;142;532;1860;5957;2002;6489
171630;201501;857;2802;714;2557;212;819;275;976;487;1795
171650;201501;2239;6981;1790;6125;457;1710;704;2391;1161;4101
171660;201501;2492;6904;1950;5953;286;960;1148;3527;1434;4487
171665;201501;1424;4273;1182;3898;179;651;751;2573;930;3224
171670;201501;2045;5769;1701;5225;407;1405;839;2454;1246;3859
171700;201501;1085;3570;962;3335;128;503;646;2231;774;2734
171720;201501;746;2255;641;2072;221;744;257;855;478;1599
171750;201501;1155;3714;979;3350;289;1047;350;1201;639;2248
171780;201501;1252;3421;931;2980;115;422;543;1781;658;2203
171790;201501;1545;5106;1344;4833;230;799;888;3361;1118;4160
171800;201501;669;2144;594;2043;79;299;434;1509;513;1808
171820;201501;9785;28995;8532;27389;1686;5900;5246;17012;6932;22912
171830;201501;1492;5562;1354;5268;374;1524;631;2447;1005;3971
171840;201501;799;2246;703;2116;53;164;570;1745;623;1909
171845;201501;784;2129;614;1859;104;343;336;1013;440;1356
171850;201501;970;3465;866;3255;110;495;548;2055;658;2550
171855;201501;1164;3761;1074;3597;89;373;836;2739;925;3112
171865;201501;468;1520;404;1418;104;418;202;694;306;1112
171870;201501;701;2173;582;1961;130;474;258;918;388;1392
171875;201501;1344;4206;1109;3858;121;511;794;2723;915;3234
171880;201501;874;3200;854;3166;87;350;685;2579;772;2929
171884;201501;948;2657;690;2280;153;590;234;851;387;1441
171886;201501;1460;4862;1226;4377;381;1495;392;1391;773;2886
171888;201501;694;2138;569;1911;77;279;334;1160;411;1439
171889;201501;478;1573;452;1528;80;271;290;1009;370;1280
171890;201501;1159;3709;1008;3501;135;529;666;2330;801;2859
171900;201501;500;1881;449;1782;127;506;217;872;344;1378
172000;201501;599;1976;525;1842;88;345;298;1050;386;1395
172010;201501;1163;4082;1093;3967;103;444;858;3109;961;3553
172015;201501;348;1338;295;1247;58;255;167;740;225;995
172020;201501;2275;7639;2108;7372;268;999;1512;5351;1780;6350
172025;201501;735;2114;570;1831;70;265;317;1013;387;1278
172030;201501;1102;3726;989;3527;111;486;700;2482;811;2968
172049;201501;1288;3494;1007;2990;119;365;780;2354;899;2719
172065;201501;1179;3377;1021;3188;60;200;918;2893;978;3093
172080;201501;2553;7892;2176;7249;242;962;1499;4919;1741;5881
172085;201501;520;1417;384;1171;79;269;138;400;217;669
172090;201501;3090;9493;2502;8617;468;1741;1545;5418;2013;7159
172093;201501;588;1851;471;1655;119;529;235;791;354;1320
172097;201501;668;1947;537;1750;130;458;207;682;337;1140
172100;201501;29271;94220;24328;84904;7706;29736;6657;23001;14363;52737
172110;201501;1686;6264;1521;6009;184;769;1133;4600;1317;5369
172120;201501;5283;16058;4405;14916;440;1542;3305;11486;3745;13028
172125;201501;303;907;242;811;43;163;110;373;153;536
172130;201501;529;1490;428;1327;44;164;286;912;330;1076
172208;201501;2087;6381;1930;6147;343;1212;1136;3621;1479;4833
172210;201501;2359;7401;2139;7046;454;1645;1245;4019;1699;5664
210005;201501;21831;68730;18677;63938;5449;20146;8479;29318;13928;49464
210010;201501;1619;5797;1443;5534;141;575;1111;4342;1252;4917
210015;201501;3212;10342;2906;9890;201;481;2512;8888;2713;9369
210020;201501;6926;17168;6516;16669;292;803;5829;14887;6121;15690
210030;201501;5600;18717;5264;18258;400;1756;4355;15015;4755;16771
210040;201501;1844;5322;1692;5147;131;433;1386;4207;1517;4640
210043;201501;6389;18653;5606;17674;497;1533;4383;14319;4880;15852
210047;201501;6511;25353;5998;24499;761;3392;4295;17750;5056;21142
210050;201501;2370;8648;1970;7992;658;2776;783;3345;1441;6121
210055;201501;1693;5815;1561;5630;177;655;1184;4324;1361;4979
210060;201501;7470;28439;6872;27440;670;3019;5194;21129;5864;24148
210070;201501;6894;20546;6417;19969;176;613;5826;18231;6002;18844
210080;201501;3698;12787;3626;12698;50;208;3465;12168;3515;12376
210083;201501;4285;14899;4008;14601;107;328;3789;14002;3896;14330
210087;201501;2822;8526;2600;8254;165;530;2259;7271;2424;7801
210090;201501;9885;32446;9413;31698;404;1580;8261;27935;8665;29515
210095;201501;5934;22218;5767;21987;461;1796;4882;18941;5343;20737
210100;201501;7155;21392;6680;20846;254;954;6002;18718;6256;19672
210110;201501;2989;10562;2901;10456;113;487;2610;9450;2723;9937
210120;201501;25849;72084;21967;67531;2450;6813;16823;54221;19273;61034
210125;201501;3536;11299;3399;11151;229;606;3017;10156;3246;10762
210130;201501;4242;12651;4011;12336;316;1045;3336;10263;3652;11308
210135;201501;1659;4869;1468;4606;113;340;1214;3875;1327;4215
210140;201501;16892;54528;14792;51630;2793;9881;9479;34496;12272;44377
210150;201501;4475;11272;4052;10754;78;202;3764;9992;3842;10194
210160;201501;17227;55170;16237;53702;1652;4847;13200;45244;14852;50091
210170;201501;13808;50200;13562;49895;789;2588;12222;45842;13011;48430
210173;201501;1850;7813;1805;7729;106;527;1602;6871;1708;7398
210177;201501;2953;9339;2795;9148;201;745;2403;7837;2604;8582
210180;201501;1529;4682;1431;4539;79;291;1232;3902;1311;4193
210190;201501;4777;15366;4481;14869;261;1196;3566;11630;3827;12826
210193;201501;1390;4426;1260;4208;73;265;1066;3607;1139;3872
210197;201501;2067;6844;1910;6678;207;637;1552;5667;1759;6304
210200;201501;8663;29297;8048;28408;974;3229;6152;22599;7126;25828
210203;201501;6373;21093;6052;20682;384;1161;5399;18759;5783;19920
210207;201501;3030;10005;2842;9673;382;1206;2072;7291;2454;8497
210210;201501;8391;28678;8059;28260;137;600;7395;26302;7532;26902
210215;201501;1452;5845;1402;5767;120;559;1162;4795;1282;5354
210220;201501;6059;23396;5788;22977;408;1712;4823;19475;5231;21187
210230;201501;5029;16978;4669;16419;314;1171;3919;13930;4233;15101
210232;201501;11896;39904;10246;37873;1660;6187;7160;28055;8820;34242
210235;201501;3390;10673;3135;10355;202;730;2695;8983;2897;9713
210237;201501;2439;9196;2404;9150;35;108;2324;8917;2359;9025
210240;201501;2985;9441;2833;9230;178;548;2402;7945;2580;8493
210250;201501;5001;16121;4758;15819;130;534;4453;14809;4583;15343
210255;201501;2415;7867;2249;7568;399;1382;1517;5170;1916;6552
210260;201501;5352;16996;4876;16305;666;2177;3591;12357;4257;14534
210270;201501;5269;15160;4679;14343;110;436;4233;12996;4343;13432
210275;201501;3579;8925;3358;8691;69;108;3240;8500;3309;8608
210280;201501;5548;16831;4905;16011;292;1102;4142;13556;4434;14658
210290;201501;5627;18394;5164;17830;384;1263;4398;15516;4782;16779
210300;201501;35980;104477;30005;97122;2128;7182;23924;80075;26052;87257
210310;201501;2876;8247;2704;8019;111;287;2396;7168;2507;7455
210312;201501;2154;6944;2093;6857;83;348;1899;6219;1982;6567
210315;201501;2409;8413;2294;8256;117;490;2007;7253;2124;7743
210317;201501;4254;12850;4064;12612;234;693;3639;11449;3873;12142
210320;201501;19005;60753;17703;59207;971;3111;15564;53153;16535;56264
210325;201501;3516;11067;3151;10523;339;1225;2366;7982;2705;9207
210330;201501;36547;88232;28431;79659;3549;7631;20739;65272;24288;72903
210340;201501;11601;35614;10533;34304;1324;3494;7901;27687;9225;31181
210350;201501;10146;31927;9323;30788;654;2160;7730;25977;8384;28137
210355;201501;3909;14257;3623;13861;157;462;3286;12986;3443;13448
210360;201501;16611;50497;15349;48765;1134;3748;12469;40255;13603;44003
210370;201501;9119;22326;7815;20940;250;488;7116;19607;7366;20095
210375;201501;3151;9506;2654;8907;717;2476;1478;5130;2195;7606
210380;201501;6141;17369;5462;16463;460;1227;4553;14091;5013;15318
210390;201501;2794;9915;2558;9528;120;594;2216;8263;2336;8857
210400;201501;4870;15277;4679;15047;177;532;4295;13973;4472;14505
210405;201501;8372;23123;6838;21041;2017;6138;3127;10691;5144;16829
210407;201501;2027;7225;1796;6864;190;700;1412;5587;1602;6287
210408;201501;2300;9020;2172;8874;88;336;1949;8265;2037;8601
210409;201501;3714;13620;3513;13319;202;843;2975;11432;3177;12275
210410;201501;3425;11374;3301;11218;248;701;2891;10118;3139;10819
210420;201501;4043;13427;3745;12915;267;925;3103;10896;3370;11821
210430;201501;2185;6749;2114;6662;119;389;1879;5938;1998;6327
210440;201501;4087;12851;3988;12715;204;604;3600;11645;3804;12249
210450;201501;2865;9081;2583;8675;180;696;2127;7120;2307;7816
210455;201501;4020;11972;3536;11226;581;1873;2463;8000;3044;9873
210460;201501;3857;12497;3576;12114;142;577;3147;10720;3289;11297
210462;201501;1626;5897;1521;5705;104;461;1231;4648;1335;5109
210465;201501;2599;8591;2443;8396;269;739;2005;7198;2274;7937
210467;201501;6122;20379;5761;19950;391;1158;5002;17818;5393;18976
210470;201501;2026;5595;1573;4941;83;274;1265;4042;1348;4316
210480;201501;13814;45617;12088;43333;3247;11442;6924;26576;10171;38018
210490;201501;3434;10044;3128;9603;191;644;2614;8020;2805;8664
210500;201501;6348;25925;6085;25488;707;2820;4712;20487;5419;23307
210510;201501;6507;22149;6218;21805;335;857;5451;19870;5786;20727
210515;201501;3484;11622;3363;11480;135;389;3113;10800;3248;11189
210520;201501;2585;8066;2376;7782;101;336;2118;7005;2219;7341
210530;201501;35757;112009;29089;102105;7260;28706;14269;51333;21529;80039
210535;201501;3221;11323;3098;11140;135;497;2755;10015;2890;10512
210540;201501;12984;44132;11557;41928;2747;9672;6454;25382;9201;35054
210542;201501;5882;17524;5400;16999;304;755;4783;15520;5087;16275
210545;201501;2308;7564;2190;7374;82;391;1899;6360;1981;6751
210547;201501;3754;13230;3526;12859;286;976;2841;10640;3127;11616
210550;201501;5654;16613;5240;16182;208;438;4866;15408;5074;15846
210560;201501;4170;13066;3720;12346;224;837;3136;10405;3360;11242
210565;201501;1533;5322;1331;5026;123;562;1006;3818;1129;4380
210570;201501;12403;35270;11164;33847;828;1908;9547;30009;10375;31917
210580;201501;3121;9547;2815;9164;354;922;2173;7693;2527;8615
210590;201501;4244;13299;3994;13010;238;776;3533;11652;3771;12428
210592;201501;2445;7691;2354;7545;61;241;2119;6798;2180;7039
210594;201501;2706;7722;2260;7099;130;351;1872;6077;2002;6428
210596;201501;2763;10320;2621;10053;273;1120;2002;7790;2275;8910
210598;201501;1950;6053;1817;5888;98;389;1623;5225;1721;5614
210600;201501;3224;9413;2880;8947;206;687;2355;7320;2561;8007
210610;201501;2695;8594;2445;8288;161;621;2081;7127;2242;7748
210620;201501;1930;5999;1790;5825;53;141;1634;5414;1687;5555
210630;201501;3615;12923;3193;12189;457;1805;2059;8113;2516;9918
210632;201501;4611;15991;4261;15503;391;1461;3486;12863;3877;14324
210635;201501;1902;6748;1817;6621;71;247;1650;6103;1721;6350
210637;201501;2779;9358;2601;9110;138;492;2249;7993;2387;8485
210640;201501;4264;14884;4189;14801;7;20;4108;14615;4115;14635
210650;201501;6760;20867;6624;20711;95;263;6433;20244;6528;20507
210660;201501;7671;23520;7143;22752;207;562;6664;21385;6871;21947
210663;201501;2661;7837;2510;7646;167;558;2136;6555;2303;7113
210667;201501;1771;6301;1690;6174;82;347;1484;5469;1566;5816
210670;201501;4439;16723;4293;16480;280;1182;3611;14058;3891;15240
210675;201501;4859;13707;4524;13295;319;860;3866;11600;4185;12460
210680;201501;4268;12191;3901;11754;195;542;3411;10430;3606;10972
210690;201501;7183;23911;6766;23467;253;772;6163;21894;6416;22666
210700;201501;2562;7690;2401;7514;504;1309;1602;5691;2106;7000
210710;201501;4748;15682;4535;15347;181;701;3985;13563;4166;14264
210720;201501;2523;9202;2375;8987;146;651;2089;7864;2235;8515
210725;201501;1090;4100;961;3867;145;635;573;2320;718;2955
210730;201501;1110;3587;1030;3482;75;209;883;3065;958;3274
210735;201501;4014;14335;3713;13817;651;2440;2537;9786;3188;12226
210740;201501;4887;14276;4640;14026;131;451;4420;13387;4551;13838
210745;201501;3848;11518;3596;11183;255;624;3068;9747;3323;10371
210750;201501;20147;55131;18024;52751;1928;5539;14437;43228;16365;48767
210760;201501;5978;16545;5646;16194;50;160;5514;15840;5564;16000
210770;201501;5733;16109;5096;15394;161;519;4670;14176;4831;14695
210780;201501;8481;28273;7805;27085;904;3308;5604;19829;6508;23137
210790;201501;4724;14542;4077;13839;293;747;3434;12235;3727;12982
210800;201501;4696;13695;4359;13306;136;400;3962;12264;4098;12664
210805;201501;3604;15440;3492;15245;152;681;3088;13718;3240;14399
210810;201501;5380;16608;5029;16184;354;650;4441;15049;4795;15699
210820;201501;8016;23115;7389;22250;1316;3889;4974;15424;6290;19313
210825;201501;5712;19242;5472;18942;322;1005;4815;17037;5137;18042
210830;201501;8369;25536;8007;25103;688;1904;6798;21872;7486;23776
210840;201501;3724;10333;3384;9823;230;588;2733;8007;2963;8595
210845;201501;5676;17700;5454;17457;168;388;5057;16570;5225;16958
210850;201501;6043;21873;5585;21090;728;3134;4073;15437;4801;18571
210860;201501;17308;52611;15853;50677;1422;4702;12661;41070;14083;45772
210870;201501;5990;19867;5470;19259;541;1756;4434;16102;4975;17858
210880;201501;4248;13780;4122;13604;181;576;3738;12473;3919;13049
210890;201501;5336;15793;4921;15300;406;1327;4124;12999;4530;14326
210900;201501;4833;14862;4135;13764;1334;4520;1711;6131;3045;10651
210905;201501;1847;5808;1711;5632;122;321;1432;4880;1554;5201
210910;201501;8918;28403;8191;27265;1322;4751;5693;19078;7015;23829
210920;201501;3189;11035;3084;10879;167;585;2686;9638;2853;10223
210923;201501;1492;5351;1390;5208;165;637;1021;4001;1186;4638
210927;201501;4768;15040;4584;14851;23;75;4517;14671;4540;14746
210930;201501;2533;9290;2419;9145;156;761;2076;7801;2232;8562
210940;201501;2793;11067;2747;10979;229;907;2306;9337;2535;10244
210945;201501;5947;17700;5746;17494;226;261;5468;17122;5694;17383
210950;201501;5305;16416;4720;15505;455;1562;3586;12020;4041;13582
210955;201501;1876;6093;1661;5779;263;903;1140;4172;1403;5075
210960;201501;8745;28895;8421;28453;2292;7462;5110;18414;7402;25876
210970;201501;1411;5055;1263;4831;175;803;895;3459;1070;4262
210975;201501;1762;5997;1681;5858;141;529;1349;4754;1490;5283
210980;201501;9665;23110;9439;22861;660;1276;8357;20773;9017;22049
210990;201501;16605;49217;13400;45213;2805;9912;8093;28241;10898;38153
211000;201501;15804;50942;14191;48984;746;2747;12410;43594;13156;46341
211003;201501;4774;16922;4381;16345;364;1529;3384;12947;3748;14476
211010;201501;6543;23231;6327;22981;90;298;6053;22210;6143;22508
211020;201501;7331;23287;7161;23031;283;942;6449;20852;6732;21794
211023;201501;2350;7940;2272;7800;111;409;2005;6948;2116;7357
211027;201501;2908;11373;2812;11226;252;915;2331;9586;2583;10501
211030;201501;4019;12236;3644;11837;647;1587;2789;9746;3436;11333
211040;201501;4223;16166;4091;15962;133;582;3638;14441;3771;15023
211050;201501;10068;26736;9916;26568;268;589;9469;25565;9737;26154
211060;201501;6012;21443;5867;21228;468;1656;4999;18406;5467;20062
211065;201501;1811;6104;1649;5900;34;103;1573;5701;1607;5804
211070;201501;8305;28171;7679;27127;515;1867;6362;22840;6877;24707
211080;201501;1399;4242;1153;3905;104;498;907;2979;1011;3477
211085;201501;1884;6572;1731;6324;245;881;1260;4731;1505;5612
211090;201501;3536;10713;3325;10430;134;551;2910;9035;3044;9586
211100;201501;6654;17372;6497;17195;49;182;6311;16684;6360;16866
211102;201501;3092;11477;2939;11267;259;943;2504;9811;2763;10754
211105;201501;2687;8568;2320;8058;154;627;1943;6729;2097;7356
211107;201501;4483;14211;4068;13672;248;794;3469;11981;3717;12775
211110;201501;6253;19038;5102;17338;929;3058;3223;11574;4152;14632
211120;201501;33335;91932;29463;87292;4469;12476;21325;65743;25794;78219
211125;201501;2120;6864;1909;6536;120;439;1632;5625;1752;6064
211130;201501;133629;379982;123360;367297;22452;67071;83682;254781;106134;321852
211140;201501;5398;17276;5065;16771;222;824;4383;14539;4605;15363
211150;201501;9750;29046;9025;28158;534;1777;7816;24565;8350;26342
211153;201501;2937;9023;2735;8785;370;1009;2191;7371;2561;8380
211157;201501;1215;3951;1041;3694;116;490;718;2642;834;3132
211160;201501;4050;13739;3502;12809;329;1514;2583;9358;2912;10872
211163;201501;1640;5499;1565;5389;55;191;1419;4985;1474;5176
211167;201501;1493;4981;1396;4837;28;110;1307;4558;1335;4668
211170;201501;6474;17265;6227;16985;118;363;5811;15841;5929;16204
211172;201501;2369;7037;2140;6699;145;583;1798;5509;1943;6092
211174;201501;2822;8279;2560;7956;79;342;2304;7096;2383;7438
211176;201501;4970;15443;4417;14779;463;1545;3421;11810;3884;13355
211178;201501;3412;9871;3357;9815;61;126;3246;9565;3307;9691
211180;201501;4277;15151;4052;14800;289;1153;3390;12563;3679;13716
211190;201501;2743;9367;2581;9139;83;378;2304;8198;2387;8576
211195;201501;1487;4595;1247;4301;86;263;1032;3710;1118;3973
211200;201501;2096;7326;1877;7032;225;766;1459;5717;1684;6483
211210;201501;7174;21838;6903;21472;402;1240;6009;18919;6411;20159
211220;201501;34067;99900;29493;94119;5679;18657;19187;62899;24866;81556
211223;201501;5178;15315;4733;14615;492;1541;3602;11303;4094;12844
211227;201501;1636;6011;1527;5848;131;598;1217;4685;1348;5283
211230;201501;8562;28455;7789;27196;1023;3624;5660;20225;6683;23849
211240;201501;8116;27958;7757;27541;262;955;7192;25674;7454;26629
211245;201501;5386;15590;5326;15519;103;200;5124;15094;5227;15294
211250;201501;12637;43900;11979;43165;1345;3523;9834;37777;11179;41300
211260;201501;8430;26270;8211;25985;569;1774;7277;23201;7846;24975
211270;201501;10408;35844;9425;34653;573;2399;7815;29315;8388;31714
211280;201501;12563;37273;11879;36469;1017;2471;10158;32394;11175;34865
211285;201501;1738;6419;1565;6043;333;1410;822;3286;1155;4696
211290;201501;7233;23980;7017;23711;616;1747;5982;20799;6598;22546
211300;201501;8140;24951;7616;24237;271;915;6850;21929;7121;22844
211400;201501;13069;37722;10796;35134;2558;8136;6083;22342;8641;30478
220005;201501;1806;5245;1674;5052;69;284;1405;4136;1474;4420
220010;201501;1448;4129;1276;3889;89;340;981;2969;1070;3309
220020;201501;3345;10512;3149;10186;501;1730;2195;7060;2696;8790
220025;201501;2238;5530;2019;5212;50;151;1762;4507;1812;4658
220027;201501;1363;3728;1252;3589;78;199;1064;3093;1142;3292
220030;201501;3284;9364;3228;9278;177;588;2844;8143;3021;8731
220040;201501;7734;24267;7278;23523;1395;4683;4671;15075;6066;19758
220045;201501;1399;4530;1286;4332;103;425;967;3191;1070;3616
220050;201501;4547;13390;3988;12547;257;970;3255;10133;3512;11103
220060;201501;1954;5186;1879;5100;55;142;1748;4760;1803;4902
220070;201501;2449;7266;2239;6945;145;497;1829;5655;1974;6152
220080;201501;722;2262;684;2201;67;279;548;1707;615;1986
220090;201501;1792;4616;1549;4296;94;324;1325;3608;1419;3932
220095;201501;737;1993;697;1938;28;87;649;1794;677;1881
220100;201501;1390;4222;1186;3890;119;409;881;2926;1000;3335
220105;201501;2184;7121;1976;6719;165;585;1475;5046;1640;5631
220110;201501;3346;9967;3157;9657;188;732;2643;7923;2831;8655
220115;201501;2307;8316;2231;8195;194;795;1890;6925;2084;7720
220117;201501;1371;3659;1137;3325;96;285;908;2661;1004;2946
220120;201501;12224;35423;11434;34469;188;766;10787;32476;10975;33242
220130;201501;898;3168;797;3037;61;197;694;2712;755;2909
220140;201501;1631;4396;1474;4205;223;443;1183;3589;1406;4032
220150;201501;6960;21839;6621;21398;202;789;6027;19455;6229;20244
220155;201501;1097;3411;905;3054;73;307;617;2028;690;2335
220157;201501;1042;2681;937;2532;23;75;828;2212;851;2287
220160;201501;2734;8241;2431;7724;136;558;1950;6116;2086;6674
220170;201501;1352;4230;1202;3985;73;329;983;3230;1056;3559
220173;201501;2046;6253;1726;5643;61;302;1415;4565;1476;4867
220177;201501;1753;5162;1724;5118;62;190;1616;4807;1678;4997
220180;201501;1155;3129;1016;2905;45;175;774;2153;819;2328
220190;201501;4461;14945;4067;14407;482;1657;3210;11571;3692;13228
220191;201501;1432;4877;1369;4768;182;623;1021;3588;1203;4211
220192;201501;1777;5101;1422;4475;149;504;988;3107;1137;3611
220194;201501;1703;5075;1550;4818;143;502;1183;3586;1326;4088
220196;201501;1932;5792;1803;5581;175;595;1395;4324;1570;4919
220198;201501;1345;3784;1066;3422;18;63;994;3222;1012;3285
220200;201501;4338;14968;4138;14675;628;2302;3001;10737;3629;13039
220202;201501;2033;6400;1856;6075;38;169;1672;5438;1710;5607
220205;201501;2902;7521;2549;7060;62;237;2300;6309;2362;6546
220207;201501;860;2710;775;2562;75;295;584;1913;659;2208
220208;201501;1727;5775;1557;5488;196;823;1122;3906;1318;4729
220209;201501;1501;4678;1385;4494;61;262;1124;3623;1185;3885
220210;201501;1735;4709;1550;4445;49;193;1318;3730;1367;3923
220211;201501;1634;4794;1555;4692;95;396;1338;3971;1433;4367
220213;201501;1744;5074;1638;4888;57;226;1369;4015;1426;4241
220217;201501;1870;6118;1795;6029;44;113;1681;5722;1725;5835
220220;201501;11111;31435;10123;29955;943;2526;7500;22813;8443;25339
220225;201501;1043;3139;920;2970;41;182;800;2542;841;2724
220230;201501;5669;15319;4965;14364;165;467;4444;12941;4609;13408
220240;201501;2836;8944;2647;8626;203;734;2066;6717;2269;7451
220245;201501;1495;4024;1342;3810;53;149;1181;3401;1234;3550
220250;201501;3168;8997;2984;8732;51;144;2774;8182;2825;8326
220253;201501;1761;5261;1493;4800;118;455;1155;3694;1273;4149
220255;201501;1755;4989;1533;4630;75;306;1265;3725;1340;4031
220260;201501;4738;15247;4235;14332;340;1216;3245;11039;3585;12255
220265;201501;1338;4702;1236;4541;110;478;886;3287;996;3765
220270;201501;6801;22116;6599;21769;349;1618;5712;18415;6061;20033
220271;201501;1491;4206;1399;4074;50;124;1246;3691;1296;3815
220272;201501;1773;5482;1659;5291;87;365;1334;4210;1421;4575
220273;201501;1216;3589;1097;3394;99;336;848;2601;947;2937
220275;201501;1989;5317;1711;4976;33;120;1579;4561;1612;4681
220277;201501;2342;6557;2120;6221;113;375;1744;5134;1857;5509
220280;201501;1727;4604;1534;4302;126;459;1156;3144;1282;3603
220285;201501;1558;4306;1365;4032;44;173;1190;3535;1234;3708
220290;201501;6088;20514;5332;19496;508;2130;4113;15101;4621;17231
220300;201501;1945;6350;1744;6082;78;348;1486;5195;1564;5543
220310;201501;2491;8355;2221;8052;72;206;2021;7585;2093;7791
220320;201501;3353;9994;2861;9129;348;1214;2041;6524;2389;7738
220323;201501;1470;5290;1293;5037;133;586;989;3883;1122;4469
220325;201501;1115;3726;1006;3505;96;407;746;2577;842;2984
220327;201501;1365;4404;1241;4199;59;296;1002;3342;1061;3638
220330;201501;3589;10045;3377;9779;146;430;3021;8797;3167;9227
220335;201501;2035;5897;1819;5643;72;241;1621;5067;1693;5308
220340;201501;1900;5311;1644;4950;130;432;1273;3801;1403;4233
220342;201501;1072;3682;1016;3598;75;327;844;2999;919;3326
220345;201501;2928;7752;2557;7174;53;152;2302;6448;2355;6600
220350;201501;3897;10540;3496;9966;211;671;2861;8129;3072;8800
220360;201501;1278;3639;1124;3392;104;363;856;2554;960;2917
220370;201501;9094;26192;8278;25141;360;1090;7430;22662;7790;23752
220375;201501;1529;4790;1417;4652;37;140;1331;4377;1368;4517
220380;201501;1411;3814;1208;3540;67;227;983;2854;1050;3081
220385;201501;804;2139;665;1908;31;111;547;1536;578;1647
220390;201501;9449;29649;8554;28009;2240;7713;3356;11101;5596;18814
220400;201501;1508;3554;1259;3182;42;144;1070;2621;1112;2765
220410;201501;1409;4003;1185;3691;109;436;922;2797;1031;3233
220415;201501;861;2363;776;2250;67;196;594;1723;661;1919
220420;201501;2157;6326;1903;5822;109;353;1545;4746;1654;5099
220430;201501;2539;7447;2462;7339;152;481;2123;6322;2275;6803
220435;201501;1580;4695;1475;4524;50;172;1265;3874;1315;4046
220440;201501;2456;8063;2269;7846;113;390;2003;6950;2116;7340
220450;201501;2316;7081;1987;6618;445;1595;1192;3966;1637;5561
220455;201501;1329;4231;1239;4107;46;149;1129;3789;1175;3938
220460;201501;975;2634;903;2549;38;108;821;2314;859;2422
220465;201501;2333;7785;2134;7491;517;1925;1303;4615;1820;6540
220470;201501;3999;11963;3647;11383;200;724;2871;8848;3071;9572
220480;201501;2497;7265;2255;6924;172;539;1819;5609;1991;6148
220490;201501;2319;6702;2161;6513;78;288;1934;5819;2012;6107
220500;201501;3356;9011;2831;8133;120;525;2308;6454;2428;6979
220510;201501;3002;8373;2254;7230;110;471;1685;5369;1795;5840
220515;201501;1975;4896;1751;4625;80;209;1485;3951;1565;4160
220520;201501;5126;14250;4747;13736;131;405;4298;12504;4429;12909
220525;201501;1333;3818;1238;3677;69;257;1051;3077;1120;3334
220527;201501;1405;4349;1263;4049;123;397;947;3105;1070;3502
220530;201501;1234;3625;1119;3456;80;314;937;2824;1017;3138
220535;201501;878;2705;853;2676;82;277;675;2117;757;2394
220540;201501;3464;11381;3326;11171;166;685;2873;9626;3039;10311
220545;201501;1405;4818;1348;4714;169;687;1008;3468;1177;4155
220550;201501;9127;29637;8594;28768;1093;3880;6312;21234;7405;25114
220551;201501;1418;4728;1313;4560;85;388;1057;3632;1142;4020
220552;201501;1600;5073;1404;4713;96;462;1075;3476;1171;3938
220553;201501;1652;4870;1366;4435;61;236;1114;3641;1175;3877
220554;201501;816;2356;730;2236;77;238;565;1750;642;1988
220555;201501;2349;6945;2190;6750;52;194;1991;6137;2043;6331
220556;201501;1450;4546;1324;4318;74;303;1035;3340;1109;3643
220557;201501;1566;5157;1417;4871;178;670;968;3322;1146;3992
220558;201501;1059;3305;970;3151;78;334;749;2385;827;2719
220559;201501;1492;4209;1368;4017;43;152;1189;3482;1232;3634
220560;201501;1738;4278;1428;3869;62;170;1230;3315;1292;3485
220570;201501;7366;23668;6945;22999;1221;4041;4741;16076;5962;20117
220580;201501;6513;21159;6355;20971;297;911;5851;19529;6148;20440
220585;201501;1962;7145;1886;7010;116;466;1604;5986;1720;6452
220590;201501;1323;4062;1218;3919;200;670;836;2750;1036;3420
220595;201501;2370;6935;2181;6685;49;204;1999;6105;2048;6309
220600;201501;1284;3152;1058;2874;184;367;762;2222;946;2589
220605;201501;1981;5855;1743;5493;81;269;1446;4557;1527;4826
220610;201501;2639;8154;2564;8047;96;388;2290;7143;2386;7531
220620;201501;7768;26296;7542;25972;333;1353;6765;23320;7098;24673
220630;201501;396;1231;345;1133;53;203;197;640;250;843
220635;201501;1767;6315;1629;6019;131;613;1127;4117;1258;4730
220640;201501;2637;7741;2442;7470;145;507;2066;6294;2211;6801
220650;201501;2313;6669;2108;6341;118;411;1727;5168;1845;5579
220660;201501;2523;8129;2265;7787;203;882;1861;6263;2064;7145
220665;201501;1179;4102;1131;4022;37;178;1029;3638;1066;3816
220667;201501;1786;5959;1690;5835;54;210;1485;5153;1539;5363
220669;201501;1912;6227;1788;6002;269;1075;1219;4029;1488;5104
220670;201501;2038;6232;1868;6018;144;356;1607;5371;1751;5727
220672;201501;2523;7172;2401;7031;250;701;1997;5944;2247;6645
220675;201501;1290;3761;1209;3631;92;248;964;2930;1056;3178
220680;201501;2223;7257;2115;7111;167;567;1766;6013;1933;6580
220690;201501;1723;4823;1513;4496;95;315;1217;3619;1312;3934
220695;201501;914;2655;852;2553;50;182;683;2020;733;2202
220700;201501;8725;25268;7850;23959;604;2090;6155;18693;6759;20783
220710;201501;790;2365;670;2154;53;157;489;1599;542;1756
220720;201501;2064;5661;1963;5530;51;156;1776;5022;1827;5178
220730;201501;1393;3912;1199;3617;44;178;1010;3021;1054;3199
220735;201501;1009;2617;829;2304;39;142;676;1856;715;1998
220740;201501;1437;4556;1208;4253;155;538;932;3382;1087;3920
220750;201501;3965;11577;3719;11210;426;1091;2939;9165;3365;10256
220755;201501;1223;3531;1127;3372;57;200;940;2798;997;2998
220760;201501;2666;9310;2514;9108;118;516;2205;8033;2323;8549
220770;201501;22669;75624;20499;71460;6691;24485;7655;27571;14346;52056
220775;201501;1193;3104;1158;3065;9;13;1137;3024;1146;3037
220777;201501;1672;4682;1524;4460;101;284;1242;3624;1343;3908
220779;201501;1243;3505;1205;3457;38;144;1109;3128;1147;3272
220780;201501;6143;16211;5506;15330;379;1040;4597;12883;4976;13923
220785;201501;1308;3529;1273;3455;55;130;1182;3218;1237;3348
220790;201501;9744;30781;9191;29891;879;3103;7266;23508;8145;26611
220793;201501;851;2450;782;2342;39;147;668;1987;707;2134
220795;201501;1463;4112;1415;4043;81;247;1260;3603;1341;3850
220800;201501;16369;45416;14903;43371;1044;3730;11635;33410;12679;37140
220810;201501;3322;9715;2905;9028;155;629;2324;7148;2479;7777
220820;201501;5298;14839;4977;14405;178;579;4518;13059;4696;13638
220830;201501;7493;21377;7087;20742;701;2078;5604;16546;6305;18624
220840;201501;14375;45873;12953;43062;3147;10731;6218;21143;9365;31874
220850;201501;2822;9824;2697;9664;150;559;2374;8602;2524;9161
220855;201501;638;1979;567;1854;48;183;412;1332;460;1515
220860;201501;957;2602;865;2458;47;179;714;1990;761;2169
220865;201501;2710;7480;2191;6626;105;507;1770;5191;1875;5698
220870;201501;2363;7815;2098;7489;80;303;1912;6845;1992;7148
220880;201501;4822;13031;4535;12697;128;415;4229;11840;4357;12255
220885;201501;1328;4756;1182;4489;113;537;882;3335;995;3872
220887;201501;1388;3506;1201;3246;21;67;1123;3045;1144;3112
220890;201501;1621;5698;1474;5450;118;407;1200;4582;1318;4989
220900;201501;1863;5395;1655;4989;77;221;1394;4221;1471;4442
220910;201501;1636;4914;1461;4657;60;186;1286;4137;1346;4323
220915;201501;1022;2935;895;2709;48;206;688;2029;736;2235
220920;201501;1329;4885;1230;4741;123;567;924;3522;1047;4089
220930;201501;1363;4592;1304;4510;72;303;1100;3822;1172;4125
220935;201501;1067;3248;964;3037;61;264;691;2096;752;2360
220937;201501;1541;4232;1304;3821;69;259;1022;2917;1091;3176
220940;201501;1412;4390;1310;4173;78;326;1020;3204;1098;3530
220945;201501;453;1631;419;1566;49;209;296;1090;345;1299
220950;201501;1317;3327;976;2768;39;152;731;2019;770;2171
220955;201501;1501;4305;1331;4021;91;293;1035;3119;1126;3412
220960;201501;882;2369;725;2102;23;93;581;1664;604;1757
220965;201501;1689;5087;1597;4956;61;277;1398;4275;1459;4552
220970;201501;2166;5788;1618;4912;152;472;1109;3406;1261;3878
220975;201501;640;2209;631;2198;32;125;583;2029;615;2154
220980;201501;1312;4048;1158;3779;97;373;845;2760;942;3133
220985;201501;1240;3663;1186;3579;100;351;947;2824;1047;3175
220987;201501;1506;4813;1387;4615;99;447;1063;3439;1162;3886
220990;201501;1856;5349;1615;4953;63;278;1262;3791;1325;4069
220995;201501;1308;3836;1000;3355;81;328;750;2543;831;2871
220997;201501;2185;6898;2088;6755;79;269;1931;6262;2010;6531
221000;201501;4402;13530;4074;12985;446;1642;3036;9573;3482;11215
221005;201501;1434;4538;1336;4358;456;1369;644;2250;1100;3619
221010;201501;1174;3196;1013;2985;50;145;888;2629;938;2774
221020;201501;1838;5713;1719;5504;98;434;1326;4172;1424;4606
221030;201501;1623;4665;1438;4383;84;352;1185;3554;1269;3906
221035;201501;1432;3992;1356;3903;53;122;1257;3666;1310;3788
221037;201501;643;1956;583;1858;30;136;452;1386;482;1522
221038;201501;627;1776;508;1575;43;129;333;1056;376;1185
221039;201501;915;2648;839;2537;51;209;720;2123;771;2332
221040;201501;4691;14453;4436;14047;235;835;3691;11767;3926;12602
221050;201501;3508;10948;3344;10727;161;639;2936;9385;3097;10024
221060;201501;8184;23607;7363;22330;726;2370;5616;17091;6342;19461
221062;201501;1285;4547;1201;4415;26;100;1099;4079;1125;4179
221063;201501;1047;3483;974;3344;276;887;569;2113;845;3000
221065;201501;2785;7835;2551;7470;217;642;2076;6069;2293;6711
221070;201501;3921;12369;3522;11732;165;671;2928;9761;3093;10432
221080;201501;3476;9232;3061;8677;145;465;2629;7476;2774;7941
221090;201501;1368;3773;1179;3469;34;151;975;2813;1009;2964
221093;201501;1710;5125;1627;4963;354;1157;905;2703;1259;3860
221095;201501;971;2642;880;2516;26;69;775;2233;801;2302
221097;201501;794;2279;698;2120;57;232;529;1578;586;1810
221100;201501;116454;342751;107795;328694;19623;64870;69485;208615;89108;273485
221110;201501;10081;32692;9558;32047;466;1785;8371;28123;8837;29908
221120;201501;4107;13527;3920;13206;833;2905;2604;8878;3437;11783
221130;201501;4515;13226;3895;11987;1260;3934;1679;5179;2939;9113
221135;201501;1479;4680;1385;4550;155;598;1113;3594;1268;4192
221140;201501;1344;3363;1240;3229;62;147;1101;2874;1163;3021
221150;201501;1242;3213;1032;2860;29;135;827;2251;856;2386
221160;201501;837;2221;786;2142;39;120;626;1721;665;1841
221170;201501;1149;3611;1072;3480;73;274;873;2806;946;3080
230010;201501;3289;9056;2769;8168;147;507;2279;6690;2426;7197
230015;201501;2827;9869;2645;9470;406;1720;1708;5978;2114;7698
230020;201501;14288;46979;13830;46188;692;2568;11837;39781;12529;42349
230030;201501;12182;35543;11176;34002;615;2134;9366;28443;9981;30577
230040;201501;4611;12870;3899;11661;275;983;3027;8966;3302;9949
230050;201501;2584;8919;2051;7513;415;1624;870;3181;1285;4805
230060;201501;2160;6336;1892;5860;120;434;1461;4492;1581;4926
230070;201501;4466;12280;3869;11382;378;1217;2771;8276;3149;9493
230075;201501;8807;31851;8265;30750;645;3284;6583;23977;7228;27261
230080;201501;2362;6390;1967;5825;107;366;1632;4815;1739;5181
230090;201501;3671;11029;3274;10350;363;1267;2393;7579;2756;8846
230100;201501;16416;49792;14992;47150;2983;10067;8679;27434;11662;37501
230110;201501;13613;44064;12670;42142;2351;8429;7417;24525;9768;32954
230120;201501;7891;21881;6870;20460;752;2181;5003;15511;5755;17692
230125;201501;2920;8610;2429;7675;195;714;1790;5623;1985;6337
230130;201501;5832;19219;4961;17374;503;2106;3407;11720;3910;13826
230140;201501;3586;11569;3071;10645;417;1558;2050;7245;2467;8803
230150;201501;1602;5152;1426;4794;256;989;877;2853;1133;3842
230160;201501;6436;19431;5743;18384;417;1605;4474;14253;4891;15858
230170;201501;6490;20441;5555;18732;404;1645;4111;13763;4515;15408
230180;201501;1762;5189;1572;4834;103;400;1171;3499;1274;3899
230185;201501;4145;13774;3789;13121;656;2313;2410;8650;3066;10963
230190;201501;12793;41114;11503;38624;2441;9211;5821;19191;8262;28402
230195;201501;5127;15795;4564;14877;275;1207;3648;11570;3923;12777
230200;201501;5479;15982;4926;14910;473;1567;3666;11016;4139;12583
230205;201501;4271;13609;3835;12881;273;1208;2843;9474;3116;10682
230210;201501;9031;26305;7856;24487;1820;5768;4457;14321;6277;20089
230220;201501;13036;37975;11836;35925;1242;4360;8663;25873;9905;30233
230230;201501;7563;24767;6863;23377;1004;3604;4444;15281;5448;18885
230240;201501;13555;38862;12169;36517;670;2535;9661;28525;10331;31060
230250;201501;10107;31436;9934;31192;442;1668;8551;26707;8993;28375
230260;201501;14479;49146;13473;47147;2551;9549;7877;28082;10428;37631
230270;201501;7193;21721;6276;20139;775;2724;4324;13960;5099;16684
230280;201501;19778;59539;17731;56118;2235;7158;12617;40379;14852;47537
230290;201501;4814;14905;4200;13685;577;1924;2832;9269;3409;11193
230300;201501;4401;13565;4216;13295;330;1273;3389;10525;3719;11798
230310;201501;4774;14385;4188;13402;296;1240;3145;9856;3441;11096
230320;201501;6980;22548;6441;21601;537;2165;4968;16591;5505;18756
230330;201501;4772;14201;4166;13030;327;1201;3012;9327;3339;10528
230340;201501;3381;11620;3136;11108;432;1747;2042;7085;2474;8832
230350;201501;17596;54420;15916;51602;2285;8138;10171;33543;12456;41681
230360;201501;3236;9413;2704;8431;325;1157;1825;5630;2150;6787
230365;201501;3004;8374;2630;7770;126;484;2158;6295;2284;6779
230370;201501;53730;176087;48848;167799;13413;48595;23259;82227;36672;130822
230380;201501;6536;19364;5617;17712;378;1367;4160;13123;4538;14490
230390;201501;3558;11277;3178;10654;308;1329;2284;7498;2592;8827
230393;201501;3292;10959;2832;10014;262;1272;2008;6810;2270;8082
230395;201501;5208;15937;4745;15116;759;2525;2986;9649;3745;12174
230400;201501;5302;16403;4622;15333;309;1356;3601;11722;3910;13078
230410;201501;14049;45332;12564;42236;1907;6916;7893;26505;9800;33421
230420;201501;24506;79973;22417;75793;5321;19516;10855;36528;16176;56044
230423;201501;4074;13673;3792;13113;305;1263;2914;10026;3219;11289
230425;201501;5555;18573;5108;17576;703;2593;3415;11774;4118;14367
230426;201501;2766;7799;2242;6816;126;531;1696;5003;1822;5534
230427;201501;1810;5499;1422;4684;153;580;915;2941;1068;3521
230428;201501;8421;27092;8073;26502;1341;4970;5226;16998;6567;21968
230430;201501;4518;14581;4242;14048;365;1510;3115;10103;3480;11613
230435;201501;4660;15425;4243;14689;801;3186;2396;8220;3197;11406
230440;201501;348719;1063638;323632;1020143;77170;260336;159629;504910;236799;765246
230445;201501;4511;12277;3825;11288;268;781;2924;8783;3192;9564
230450;201501;3512;11373;3077;10589;373;1573;2093;7106;2466;8679
230460;201501;1908;6382;1711;6031;184;786;1213;4238;1397;5024
230465;201501;4134;12427;3465;11205;283;1205;2399;7583;2682;8788
230470;201501;10475;39206;9968;38173;1151;4881;7301;28038;8452;32919
230480;201501;1440;4678;1235;4299;170;648;813;2843;983;3491
230490;201501;2562;7773;2233;7157;388;1377;1191;3691;1579;5068
230495;201501;5758;19316;5211;18409;820;3501;3073;10812;3893;14313
230500;201501;9571;33601;9170;32872;617;2637;7329;26405;7946;29042
230510;201501;1532;5511;1257;4809;327;1346;442;1775;769;3121
230520;201501;4852;15027;4365;14162;448;1704;2962;9564;3410;11268
230523;201501;14265;46971;12613;43180;3162;12019;3555;12407;6717;24426
230526;201501;4002;12405;3523;11596;306;1217;2620;8592;2926;9809
230530;201501;5293;17389;4802;16740;937;3318;3254;11615;4191;14933
230533;201501;3947;11294;3562;10596;237;788;2779;8218;3016;9006
230535;201501;5536;16470;4828;15211;632;2004;3221;10434;3853;12438
230540;201501;18036;52745;16289;50048;752;3000;13737;41795;14489;44795
230550;201501;19473;59059;17619;55511;3663;12523;9562;29882;13225;42405
230560;201501;6670;19361;5992;18162;260;1054;4856;14557;5116;15611
230565;201501;3338;9445;2687;8192;173;655;1975;5928;2148;6583
230570;201501;3796;10305;3346;9748;133;516;2857;8251;2990;8767
230580;201501;10095;30998;9495;30158;446;1490;8475;27088;8921;28578
230590;201501;8904;28193;7826;26159;613;2642;5810;18941;6423;21583
230600;201501;3638;10304;2807;8618;195;683;1850;5632;2045;6315
230610;201501;5932;19608;5565;19018;715;2569;4047;13975;4762;16544
230620;201501;2174;6198;1754;5304;175;610;1065;3107;1240;3717
230625;201501;7751;25404;6959;23620;2067;7529;2161;7397;4228;14926
230630;201501;11419;36858;10441;35065;2745;8810;5006;18037;7751;26847
230640;201501;26020;85947;24177;83255;2759;10464;18492;63847;21251;74311
230650;201501;4925;15288;4457;14401;310;1307;3428;10813;3738;12120
230655;201501;8919;33859;8588;33309;674;2740;7203;28329;7877;31069
230660;201501;6078;19220;5291;17793;400;1705;3993;13211;4393;14916
230670;201501;6081;16482;4952;14565;233;925;3805;10892;4038;11817
230680;201501;2902;8493;2435;7627;369;1244;1468;4591;1837;5835
230690;201501;6265;20661;6162;20460;517;2154;4406;14339;4923;16493
230700;201501;9295;26951;8310;25234;761;2853;5934;17499;6695;20352
230710;201501;7463;24462;6546;22779;793;2816;4731;16725;5524;19541
230720;201501;1908;6059;1654;5581;205;734;1116;3830;1321;4564
230725;201501;3722;12629;3295;11625;753;2766;1470;5191;2223;7957
230730;201501;57093;173715;47638;158372;12876;47205;17217;58558;30093;105763
230740;201501;5793;17918;5343;17166;291;1281;4423;13983;4714;15264
230750;201501;8478;24480;7267;22554;483;1799;5712;17592;6195;19391
230760;201501;10160;30720;9552;29454;1041;3898;6861;20338;7902;24236
230763;201501;4325;13506;3956;12810;254;1199;3055;9568;3309;10767
230765;201501;38664;125443;35355;118845;9913;36210;12593;42667;22506;78877
230770;201501;24447;68399;22516;65742;2405;7645;16517;48330;18922;55975
230780;201501;6101;23777;5830;23187;1493;6022;2890;12139;4383;18161
230790;201501;2574;8647;2427;8406;250;952;1889;6587;2139;7539
230800;201501;7541;27174;6893;25761;1518;6167;3322;12357;4840;18524
230810;201501;11946;39330;11344;38319;967;3426;9198;31321;10165;34747
230820;201501;3334;11470;2939;10620;456;1893;1752;6274;2208;8167
230830;201501;7556;23174;6725;21668;634;2389;4850;15496;5484;17885
230835;201501;4026;10811;3365;9882;230;763;2667;7821;2897;8584
230837;201501;3169;10801;2767;9993;316;1342;1885;6755;2201;8097
230840;201501;9130;30161;8349;28808;838;3204;6283;21847;7121;25051
230850;201501;10115;31313;9341;30220;916;3329;7197;23213;8113;26542
230860;201501;5082;15048;4614;14289;295;1113;3656;11229;3951;12342
230870;201501;18680;50463;16433;47053;1055;3499;12898;36692;13953;40191
230880;201501;1906;6645;1793;6423;214;918;1202;4276;1416;5194
230890;201501;3978;14590;3687;13953;545;2480;2385;8799;2930;11279
230900;201501;3016;10118;2587;9228;550;1939;1327;4870;1877;6809
230910;201501;3161;9314;2569;8230;204;840;1851;5797;2055;6637
230920;201501;4502;13301;4186;12916;157;595;3753;11647;3910;12242
230930;201501;7411;22672;6591;21166;697;2397;4627;14944;5324;17341
230940;201501;7627;21991;6713;20651;397;1291;5412;16781;5809;18072
230945;201501;6218;18652;5351;17399;540;2018;3779;12470;4319;14488
230950;201501;7020;19277;6133;18105;381;1195;4907;14654;5288;15849
230960;201501;13515;42442;12322;40159;2618;9276;6139;20167;8757;29443
230970;201501;13117;41154;11734;38570;2400;8932;5582;18065;7982;26997
230980;201501;2938;9462;2582;8790;784;2694;1205;4290;1989;6984
230990;201501;1664;5119;1383;4549;150;627;915;2929;1065;3556
231000;201501;2858;7747;2276;6654;231;773;1464;4155;1695;4928
231010;201501;3159;8678;2656;7888;253;906;2020;5895;2273;6801
231020;201501;7767;26251;7397;25494;1298;4610;4731;16615;6029;21225
231025;201501;7874;24569;7140;23327;1037;3559;4736;15779;5773;19338
231030;201501;8056;26376;6851;23925;1231;4675;3935;13829;5166;18504
231040;201501;3135;10217;2789;9514;243;1032;2002;6688;2245;7720
231050;201501;11999;34502;10325;31524;877;3043;7619;23201;8496;26244
231060;201501;2460;7888;2253;7528;189;862;1612;5231;1801;6093
231070;201501;8962;28663;8217;27180;1410;4987;4886;16321;6296;21308
231080;201501;4225;13283;3848;12638;221;1035;2948;9365;3169;10400
231085;201501;4628;14673;4454;14428;580;1815;3368;11251;3948;13066
231090;201501;4191;11844;3431;10361;189;711;2449;7272;2638;7983
231095;201501;2249;7391;1941;6770;215;833;1306;4598;1521;5431
231100;201501;3155;9840;2663;8878;235;913;1908;6285;2143;7198
231110;201501;3741;12513;3657;12371;369;1415;2735;9258;3104;10673
231120;201501;2131;7174;2013;6944;310;1153;1353;4697;1663;5850
231123;201501;2159;5939;1869;5469;152;431;1476;4367;1628;4798
231126;201501;6377;18104;5357;16516;355;1374;4024;12297;4379;13671
231130;201501;18521;58527;16815;55600;3613;12259;9824;33757;13437;46016
231135;201501;4267;12735;3654;11733;308;1183;2692;8549;3000;9732
231140;201501;16619;53194;14889;49909;1457;6572;10076;32558;11533;39130
231150;201501;5742;16685;4901;15141;830;2834;2738;8283;3568;11117
231160;201501;5747;19512;5412;18880;939;3458;3592;12586;4531;16044
231170;201501;4348;14150;3940;13305;325;1451;2825;9307;3150;10758
231180;201501;14249;42886;12827;40122;2178;7431;7870;24234;10048;31665
231190;201501;4721;13393;4031;12381;293;1077;3176;9613;3469;10690
231195;201501;4620;15741;4006;14527;397;1797;2891;10380;3288;12177
231200;201501;7778;26817;6818;24862;550;2702;4930;17590;5480;20292
231210;201501;5101;15816;4411;14871;260;1158;3517;11860;3777;13018
231220;201501;11542;34454;10559;32645;774;2974;7891;23996;8665;26970
231230;201501;8730;30151;8096;29163;805;3464;6325;22686;7130;26150
231240;201501;11846;38002;10767;35914;2088;7450;5907;20019;7995;27469
231250;201501;1982;5794;1361;4275;408;1255;321;1019;729;2274
231260;201501;3686;10763;3332;10233;472;1441;2258;7099;2730;8540
231270;201501;7237;20257;6389;18915;431;1798;4915;14150;5346;15948
231280;201501;1732;5725;1611;5487;145;512;1201;4137;1346;4649
231290;201501;33424;116231;30471;109532;6826;27434;13330;46865;20156;74299
231300;201501;4637;13512;3767;11792;281;1112;2683;8158;2964;9270
231310;201501;7320;21031;6181;18717;1017;3251;3525;10491;4542;13742
231320;201501;6913;21423;5971;19594;334;1385;4392;14411;4726;15796
231325;201501;2668;8092;2376;7604;184;693;1761;5665;1945;6358
231330;201501;12704;40284;10980;36929;1691;5815;6967;23704;8658;29519
231335;201501;5284;15277;4579;14013;277;1114;3643;10911;3920;12025
231340;201501;17336;57380;16214;55785;984;3373;13568;47724;14552;51097
231350;201501;12790;41974;12486;41527;1207;3774;10374;35178;11581;38952
231355;201501;4300;14078;4087;13722;231;899;3364;11342;3595;12241
231360;201501;7347;24252;6687;23099;1454;5009;4096;14637;5550;19646
231370;201501;2492;6948;1959;6082;89;311;1499;4639;1588;4950
231375;201501;4175;14283;3927;13814;282;1280;3171;11012;3453;12292
231380;201501;5140;16773;4850;16373;669;2391;3439;11862;4108;14253
231390;201501;3382;10795;3151;10424;244;1031;2380;7761;2624;8792
231395;201501;3899;12927;3596;12392;672;2409;2186;7640;2858;10049
231400;201501;9208;28382;8604;27192;661;2575;6435;20114;7096;22689
231410;201501;13247;45959;12330;44460;1019;3943;9658;35066;10677;39009
240010;201501;2426;7484;2082;6775;420;1553;978;3047;1398;4600
240020;201501;10979;34871;9794;32624;2328;8318;4750;16023;7078;24341
240030;201501;2486;7307;2431;7220;167;590;2055;6015;2222;6605
240040;201501;848;2532;728;2296;45;211;521;1575;566;1786
240050;201501;3440;9380;2963;8571;131;479;2392;6820;2523;7299
240060;201501;1368;4027;1250;3803;71;276;1015;2992;1086;3268
240070;201501;2617;7478;2479;7236;379;1154;1713;4979;2092;6133
240080;201501;3031;8186;2619;7654;230;654;2043;6009;2273;6663
240090;201501;2277;6197;1927;5564;66;259;1528;4308;1594;4567
240100;201501;8533;24724;7797;23234;696;2458;5632;16281;6328;18739
240110;201501;5261;16121;4677;15048;827;2982;2706;8382;3533;11364
240120;201501;2750;9379;2632;9156;421;1608;1801;6267;2222;7875
240130;201501;2799;7570;2413;6993;161;553;1899;5427;2060;5980
240140;201501;2222;6730;1916;6171;345;1299;1087;3408;1432;4707
240145;201501;5941;18774;5351;17746;1368;5006;2750;9145;4118;14151
240150;201501;989;3004;817;2659;90;372;513;1586;603;1958
240160;201501;1455;4704;1280;4408;181;680;787;2805;968;3485
240165;201501;867;2786;764;2571;103;323;503;1771;606;2094
240170;201501;2396;7175;2102;6658;554;1950;968;3003;1522;4953
240180;201501;2604;8349;2407;7992;521;1857;1365;4622;1886;6479
240185;201501;1408;4741;1353;4642;119;435;1069;3701;1188;4136
240190;201501;971;2958;885;2810;55;238;671;2077;726;2315
240200;201501;14255;37140;11894;34069;2531;7407;6475;19284;9006;26691
240210;201501;2823;8026;2594;7710;194;664;2168;6400;2362;7064
240220;201501;7398;24221;7020;23687;465;2072;5931;19776;6396;21848
240230;201501;5460;15010;4867;14031;229;789;4093;11658;4322;12447
240240;201501;1810;5505;1270;4174;308;1140;261;732;569;1872
240250;201501;2693;7870;2555;7686;139;465;2158;6457;2297;6922
240260;201501;12898;43781;12243;42727;1939;7655;8066;28159;10005;35814
240270;201501;2246;7262;2071;6974;175;591;1645;5639;1820;6230
240280;201501;1531;4383;1385;4137;81;300;1107;3260;1188;3560
240290;201501;1355;4301;1189;4000;105;513;807;2594;912;3107
240300;201501;2247;6290;1641;4988;415;1349;573;1677;988;3026
240310;201501;9496;27283;8653;25973;1519;5080;4872;14695;6391;19775
240320;201501;2059;6149;1688;5402;93;424;1232;3802;1325;4226
240325;201501;38229;105251;29849;91817;9274;30961;8175;25605;17449;56566
240330;201501;1492;4525;1266;4076;128;520;835;2594;963;3114
240340;201501;1837;5261;1570;4845;188;622;1132;3491;1320;4113
240350;201501;1966;5837;1831;5654;123;474;1586;4834;1709;5308
240360;201501;7062;21246;6175;19949;1096;3827;3692;12312;4788;16139
240370;201501;1932;5353;1620;4807;169;529;1108;3288;1277;3817
240375;201501;851;2285;751;2137;127;422;474;1287;601;1709
240380;201501;2503;7573;1987;6426;242;830;1155;3721;1397;4551
240390;201501;955;2628;803;2348;55;211;596;1684;651;1895
240400;201501;1312;3608;1128;3301;104;355;843;2403;947;2758
240410;201501;517;1691;480;1619;84;334;299;994;383;1328
240420;201501;4762;18211;4511;17673;1071;4417;2502;10079;3573;14496
240430;201501;3238;9268;2992;8861;162;638;2436;7050;2598;7688
240440;201501;2638;7030;2386;6627;593;1673;1292;3574;1885;5247
240450;201501;3604;10891;3215;10165;341;1409;2155;6554;2496;7963
240460;201501;2902;9027;2748;8823;209;863;2273;7158;2482;8021
240470;201501;3688;11421;2977;9914;389;1425;1838;6075;2227;7500
240480;201501;508;1319;411;1123;39;109;239;640;278;749
240485;201501;2071;6400;1833;5951;345;1218;1065;3490;1410;4708
240490;201501;1637;4194;1393;3828;65;243;1131;3003;1196;3246
240500;201501;2049;6049;1904;5814;144;512;1497;4538;1641;5050
240510;201501;1781;5382;1656;5170;163;547;1299;4072;1462;4619
240520;201501;1332;3846;1157;3600;128;487;872;2640;1000;3127
240530;201501;2127;6813;1918;6481;272;950;1359;4627;1631;5577
240540;201501;1710;5309;1639;5197;129;478;1301;4096;1430;4574
240550;201501;838;2375;725;2184;59;203;557;1645;616;1848
240560;201501;3160;9317;2993;9077;260;788;2465;7522;2725;8310
240570;201501;3058;8711;2453;7377;531;1776;984;2653;1515;4429
240580;201501;7520;23943;7078;23170;950;3389;5274;17168;6224;20557
240590;201501;784;2216;681;2035;37;152;513;1498;550;1650
240600;201501;1629;4813;1296;4137;175;666;737;2246;912;2912
240610;201501;4888;13870;4224;12626;562;1850;2571;7470;3133;9320
240615;201501;1037;3025;854;2675;133;428;497;1535;630;1963
240620;201501;1739;5519;1570;5242;187;648;1199;4046;1386;4694
240630;201501;1985;6216;1854;5994;164;469;1422;4783;1586;5252
240640;201501;897;2658;754;2417;75;316;527;1649;602;1965
240650;201501;3731;11474;3430;11049;223;817;2816;9139;3039;9956
240660;201501;2370;7696;2245;7510;218;768;1768;5952;1986;6720
240670;201501;2702;8131;2272;7268;322;1159;1276;4001;1598;5160
240680;201501;1495;4409;1210;3900;130;477;770;2475;900;2952
240690;201501;978;2768;858;2572;58;230;694;2026;752;2256
240700;201501;2737;8197;2291;7369;113;536;1756;5508;1869;6044
240710;201501;18635;48212;16400;45209;2997;8128;10254;29154;13251;37282
240720;201501;5232;15001;4938;14554;1514;4700;2409;6891;3923;11591
240725;201501;1084;3268;853;2769;87;309;484;1538;571;1847
240730;201501;2163;6576;1880;6068;137;496;1418;4546;1555;5042
240740;201501;1995;5894;1811;5565;177;659;1269;3792;1446;4451
240750;201501;2241;8352;2050;7999;431;1874;1105;4364;1536;6238
240760;201501;1207;3475;1112;3358;106;252;855;2757;961;3009
240770;201501;3241;9374;2914;8924;195;735;2402;7284;2597;8019
240780;201501;6223;17214;5016;15356;943;3023;2807;8821;3750;11844
240790;201501;891;2740;731;2462;46;194;524;1777;570;1971
240800;201501;36323;105205;32569;98964;7993;25643;14570;44610;22563;70253
240810;201501;89297;261327;83076;250684;22245;69992;40571;123415;62816;193407
240820;201501;6727;20308;5797;18861;1276;4560;2771;9350;4047;13910
240830;201501;8691;27337;8205;26634;421;1511;7213;23497;7634;25008
240840;201501;1239;3467;1049;3159;103;356;682;1991;785;2347
240850;201501;1268;3793;943;3056;166;578;456;1439;622;2017
240860;201501;1339;3797;1142;3456;84;293;860;2554;944;2847
240870;201501;1152;3193;968;2845;104;362;635;1777;739;2139
240880;201501;1152;3958;1089;3862;123;523;822;2871;945;3394
240890;201501;5171;14724;4451;13423;866;2868;2226;6607;3092;9475
240895;201501;2673;9224;2450;8832;282;1080;1737;6381;2019;7461
240910;201501;2724;8397;2435;7850;166;658;1846;5883;2012;6541
240920;201501;800;2619;701;2396;172;661;303;990;475;1651
240930;201501;3422;9160;3066;8728;184;528;2556;7382;2740;7910
240933;201501;1377;4079;1224;3828;140;528;853;2596;993;3124
240940;201501;6401;17834;5312;15974;937;2943;2980;8970;3917;11913
240950;201501;1029;3358;974;3265;73;322;763;2483;836;2805
240960;201501;783;2464;691;2289;89;325;484;1607;573;1932
240970;201501;2018;5592;1693;5048;136;489;1243;3627;1379;4116
240980;201501;3043;10089;2836;9706;543;2036;1784;6053;2327;8089
240990;201501;2917;8682;2744;8331;467;1572;1725;5135;2192;6707
241000;201501;1071;3001;918;2730;53;194;688;2023;741;2217
241010;201501;2927;9861;2687;9406;359;1546;1891;6409;2250;7955
241020;201501;2229;6236;1822;5458;148;534;1168;3371;1316;3905
241025;201501;1591;4879;1440;4593;98;425;1041;3248;1139;3673
241030;201501;2491;8319;2275;7920;167;692;1782;6227;1949;6919
241040;201501;2271;7852;2083;7515;219;898;1495;5450;1714;6348
241050;201501;1285;3814;1141;3580;71;298;892;2735;963;3033
241060;201501;860;2523;796;2414;56;168;632;1925;688;2093
241070;201501;888;2550;790;2383;83;293;550;1616;633;1909
241080;201501;1159;3442;982;3112;64;286;715;2201;779;2487
241090;201501;2180;6351;1865;5795;131;572;1466;4465;1597;5037
241100;201501;1175;3538;1022;3184;128;422;634;1958;762;2380
241105;201501;1135;3469;1045;3305;202;672;607;1945;809;2617
241110;201501;827;2661;704;2397;64;299;452;1496;516;1795
241120;201501;7362;22573;6712;21561;1389;4586;4210;13833;5599;18419
241140;201501;3354;9308;2941;8519;315;950;2089;5985;2404;6935
241142;201501;713;2150;530;1749;137;526;159;478;296;1004
241150;201501;5555;16646;5001;15705;693;2247;3470;11026;4163;13273
241160;201501;1001;2967;941;2855;126;418;679;2053;805;2471
241170;201501;1149;3489;1058;3322;113;367;784;2469;897;2836
241180;201501;926;2624;761;2313;91;308;425;1255;516;1563
241190;201501;1193;3294;971;2858;79;286;616;1719;695;2005
241200;201501;18788;55725;17032;52927;3926;13137;8666;27190;12592;40327
241210;201501;1431;4161;1190;3672;205;696;616;1854;821;2550
241220;201501;7454;25232;7047;24467;1567;5797;4034;14147;5601;19944
241230;201501;3090;9125;2825;8753;173;676;2362;7221;2535;7897
241240;201501;1183;3476;915;2912;106;359;460;1532;566;1891
241250;201501;5794;18254;4936;16585;297;1516;3904;12783;4201;14299
241255;201501;1719;6672;1624;6481;401;1701;774;3166;1175;4867
241260;201501;5107;13906;4187;12482;295;1159;3068;8949;3363;10108
241270;201501;1866;5783;1663;5389;189;715;1082;3453;1271;4168
241280;201501;1939;5666;1793;5390;221;716;1281;3828;1502;4544
241290;201501;3129;8907;2632;8051;402;1289;1648;5065;2050;6354
241300;201501;1453;4230;1286;3940;76;241;982;3054;1058;3295
241310;201501;1538;4755;1436;4592;208;676;1013;3312;1221;3988
241320;201501;901;3057;824;2897;128;498;501;1758;629;2256
241330;201501;1456;4635;1355;4504;105;423;1144;3774;1249;4197
241335;201501;2643;8119;2478;7828;154;513;2106;6665;2260;7178
241340;201501;1864;5825;1648;5370;383;1374;790;2515;1173;3889
241350;201501;1880;6068;1735;5800;155;691;1302;4221;1457;4912
241355;201501;1356;3838;1156;3499;65;208;1006;3048;1071;3256
241360;201501;1976;5446;1689;4909;76;258;1273;3572;1349;3830
241370;201501;1358;4194;1129;3721;197;700;571;1859;768;2559
241380;201501;661;1912;562;1713;107;349;319;969;426;1318
241390;201501;2734;9153;2559;8830;385;1450;1825;6312;2210;7762
241400;201501;3677;10874;3400;10505;369;1283;2626;8180;2995;9463
241410;201501;2612;7827;2356;7482;377;1274;1673;5334;2050;6608
241415;201501;1682;5116;1534;4877;106;442;1190;3700;1296;4142
241420;201501;2287;7932;2008;7469;690;2869;601;2194;1291;5063
241430;201501;550;1674;449;1447;49;181;280;872;329;1053
241440;201501;6261;22628;5894;22031;1161;4517;3902;14879;5063;19396
241445;201501;1040;3126;975;3042;112;297;781;2561;893;2858
241450;201501;3154;8761;2804;8268;426;1358;1883;5528;2309;6886
241460;201501;3442;10139;3019;9318;205;790;2267;6841;2472;7631
241470;201501;1370;3832;1133;3537;118;465;846;2594;964;3059
241475;201501;1211;3789;1082;3538;56;277;826;2647;882;2924
241480;201501;2789;9442;2581;9118;895;3202;1010;3879;1905;7081
241490;201501;646;1729;545;1585;46;157;339;966;385;1123
241500;201501;761;2406;676;2273;38;147;573;1927;611;2074
250010;201501;2644;8419;2335;7781;173;756;1809;5901;1982;6657
250020;201501;1687;4850;1318;4188;98;423;879;2687;977;3110
250030;201501;7251;21115;6780;20456;621;1895;5477;16681;6098;18576
250040;201501;4308;14591;3992;13933;670;2505;2534;8911;3204;11416
250050;201501;3392;10831;3205;10561;379;1357;2406;7918;2785;9275
250053;201501;1242;3716;1142;3585;166;529;781;2488;947;3017
250057;201501;639;2708;631;2700;18;40;597;2630;615;2670
250060;201501;4803;14842;4568;14503;426;1614;3674;11493;4100;13107
250070;201501;3905;12272;3653;11846;209;939;3019;9534;3228;10473
250073;201501;762;2344;678;2198;53;210;526;1685;579;1895
250077;201501;2194;6507;1860;5967;222;771;1142;3726;1364;4497
250080;201501;4187;12521;4050;12328;342;1143;3306;9986;3648;11129
250090;201501;2632;7707;2523;7537;121;408;2114;6239;2235;6647
250100;201501;3955;13146;3742;12780;384;1495;2930;9969;3314;11464
250110;201501;5273;15903;4999;15529;515;1864;3937;12069;4452;13933
250115;201501;530;1734;469;1594;32;168;290;914;322;1082
250120;201501;1980;6017;1726;5531;112;401;1354;4359;1466;4760
250130;201501;5439;16940;5148;16538;220;789;4574;14790;4794;15579
250135;201501;1054;3230;963;3072;90;315;687;2201;777;2516
250140;201501;2053;6783;1934;6612;183;719;1510;5211;1693;5930
250150;201501;5002;16952;4564;16136;437;1888;3334;11643;3771;13531
250153;201501;1418;3910;1268;3691;68;279;1077;3066;1145;3345
250157;201501;1709;5750;1573;5476;249;925;1050;3669;1299;4594
250160;201501;3233;9990;3126;9828;157;555;2835;8930;2992;9485
250170;201501;1531;4593;1412;4410;253;835;950;2999;1203;3834
250180;201501;15257;46464;14686;45573;1557;5930;11035;33319;12592;39249
250190;201501;4188;12235;3857;11721;670;2124;2450;7390;3120;9514
250200;201501;2183;6082;1710;5446;118;456;1412;4469;1530;4925
250205;201501;898;3102;834;2978;71;350;608;2146;679;2496
250210;201501;1493;4983;1401;4837;150;645;1057;3572;1207;4217
250215;201501;1320;4485;1276;4413;136;555;890;3059;1026;3614
250220;201501;818;2332;680;2158;39;141;584;1847;623;1988
250230;201501;1579;4044;1342;3657;93;296;1098;2914;1191;3210
250240;201501;2283;7755;2162;7529;138;527;1734;6049;1872;6576
250250;201501;4295;13048;3924;12556;222;750;3381;10886;3603;11636
250260;201501;1723;5345;1518;5014;102;431;1186;3877;1288;4308
250270;201501;1226;3920;1118;3783;111;370;864;3017;975;3387
250280;201501;3545;10758;3211;10255;505;1641;2297;7452;2802;9093
250290;201501;1993;5466;1678;5068;50;212;1488;4476;1538;4688
250300;201501;5421;15934;5127;15577;547;2287;4177;12128;4724;14415
250310;201501;1142;3545;1011;3332;116;440;780;2532;896;2972
250320;201501;7934;24841;7584;24182;990;3630;5179;16064;6169;19694
250330;201501;2553;7917;2177;7400;176;730;1703;5742;1879;6472
250340;201501;1101;3233;1010;3093;35;116;893;2732;928;2848
250350;201501;4334;11952;3824;11357;139;488;3420;10230;3559;10718
250355;201501;1998;6312;1836;6068;119;564;1480;4767;1599;5331
250360;201501;1932;5798;1808;5623;80;284;1530;4784;1610;5068
250370;201501;11975;34959;10743;33587;934;2975;9120;28760;10054;31735
250375;201501;1063;3369;1002;3279;47;193;865;2827;912;3020
250380;201501;1715;4878;1623;4761;88;313;1426;4173;1514;4486
250390;201501;1953;5198;1564;4558;198;575;1056;3109;1254;3684
250400;201501;67470;183838;56155;166101;13233;41822;27399;82097;40632;123919
250403;201501;1543;5060;1450;4939;211;813;1029;3480;1240;4293
250407;201501;1179;3394;1022;3134;54;177;806;2452;860;2629
250410;201501;601;1974;537;1850;49;222;428;1441;477;1663
250415;201501;1706;5387;1566;5121;123;466;1204;3886;1327;4352
250420;201501;1244;3849;1160;3731;68;277;989;3126;1057;3403
250430;201501;6019;16924;5722;16473;300;1031;4896;13900;5196;14931
250435;201501;1402;4339;1258;4075;166;611;849;2725;1015;3336
250440;201501;4468;13114;4162;12688;203;605;3532;10842;3735;11447
250450;201501;2008;5745;1796;5466;74;258;1647;5022;1721;5280
250460;201501;6314;19153;5904;18590;652;2198;4520;14369;5172;16567
250470;201501;1487;4166;1315;3930;89;351;1013;2926;1102;3277
250480;201501;3756;11458;3494;11081;82;364;3148;9930;3230;10294
250485;201501;646;1661;540;1499;28;94;430;1155;458;1249
250490;201501;3757;12276;3673;12158;823;2846;2394;7936;3217;10782
250500;201501;1724;5284;1577;5053;343;1082;986;3250;1329;4332
250510;201501;4656;13343;4186;12671;210;770;3592;10826;3802;11596
250520;201501;1733;5402;1633;5233;253;953;1026;3194;1279;4147
250523;201501;1599;5242;1546;5161;204;731;1153;3880;1357;4611
250527;201501;1393;4249;1321;4159;31;141;1229;3841;1260;3982
250530;201501;646;1964;562;1858;26;85;494;1658;520;1743
250535;201501;1294;4156;1234;4032;72;331;996;3189;1068;3520
250540;201501;2338;7072;2194;6914;30;101;2101;6655;2131;6756
250550;201501;895;2994;819;2882;57;244;643;2239;700;2483
250560;201501;1643;5273;1599;5210;73;269;1453;4720;1526;4989
250570;201501;2550;8253;2247;7678;175;735;1713;5768;1888;6503
250580;201501;1127;3076;931;2770;87;370;689;1944;776;2314
250590;201501;916;2866;851;2782;66;279;709;2266;775;2545
250600;201501;7316;21457;6912;20889;494;1427;5749;17652;6243;19079
250610;201501;3229;9590;3000;9258;315;1079;2235;6899;2550;7978
250620;201501;718;2139;651;2004;115;380;419;1269;534;1649
250625;201501;2268;7311;2238;7273;47;113;2139;7021;2186;7134
250630;201501;9493;30327;9009;29501;1890;6553;5315;17497;7205;24050
250640;201501;3477;10724;3334;10558;162;674;2949;9236;3111;9910
250650;201501;829;2501;755;2375;78;319;510;1526;588;1845
250660;201501;2168;5388;1653;4771;28;72;1573;4572;1601;4644
250670;201501;2422;8242;2316;8057;154;689;1896;6495;2050;7184
250680;201501;4731;13756;4548;13514;176;630;4088;12158;4264;12788
250690;201501;5888;15683;5663;15405;379;1112;5030;13598;5409;14710
250700;201501;5032;14857;4617;14278;683;2284;3192;9790;3875;12074
250710;201501;4264;13735;3948;13329;524;1840;2889;9939;3413;11779
250720;201501;2512;7529;2410;7365;104;437;2121;6397;2225;6834
250730;201501;3547;11041;3372;10807;364;1341;2572;8161;2936;9502
250740;201501;1975;5842;1755;5476;156;576;1335;4097;1491;4673
250750;201501;97849;283372;91754;274460;13559;44887;63034;186368;76593;231255
250760;201501;2178;6414;1989;6143;111;452;1671;5097;1782;5549
250770;201501;3847;13210;3642;12949;638;2465;2428;8667;3066;11132
250780;201501;1864;5496;1617;5053;182;712;1054;3148;1236;3860
250790;201501;2392;7904;2296;7759;504;1641;1494;5237;1998;6878
250800;201501;2608;7500;2342;7051;116;400;1935;5724;2051;6124
250810;201501;1363;3983;1174;3709;101;410;926;2868;1027;3278
250820;201501;1789;5662;1727;5581;53;215;1586;5107;1639;5322
250830;201501;5703;18834;5331;18098;555;2290;3849;12827;4404;15117
250840;201501;939;3077;830;2851;85;343;563;1930;648;2273
250850;201501;2027;6277;1831;5952;138;614;1405;4483;1543;5097
250855;201501;1067;3231;986;3106;79;331;759;2306;838;2637
250860;201501;3071;10173;2747;9580;648;2579;1077;3719;1725;6298
250870;201501;1054;3106;970;2960;52;224;763;2251;815;2475
250880;201501;1350;3872;1204;3668;155;484;904;2772;1059;3256
250890;201501;9273;28793;8635;27926;1196;4713;6119;19296;7315;24009
250900;201501;2821;9353;2542;8811;280;962;1835;6421;2115;7383
250905;201501;1963;6342;1895;6255;285;964;1415;4739;1700;5703
250910;201501;4868;14368;4648;14048;294;1021;3901;11724;4195;12745
250915;201501;1492;4537;1438;4459;100;286;1248;3953;1348;4239
250920;201501;3390;9814;3209;9560;390;1090;2406;7419;2796;8509
250930;201501;1957;6288;1861;6141;283;1068;1323;4329;1606;5397
250933;201501;1123;3736;1088;3674;86;338;842;2850;928;3188
250937;201501;754;2357;664;2177;73;301;449;1444;522;1745
250939;201501;1546;4905;1452;4739;176;619;1003;3265;1179;3884
250940;201501;3659;11001;3449;10676;148;581;2910;9013;3058;9594
250950;201501;1214;3864;1115;3740;37;124;1002;3401;1039;3525
250960;201501;1138;3739;1078;3659;88;369;877;2950;965;3319
250970;201501;8370;23304;7348;21859;915;2836;5302;15821;6217;18657
250980;201501;2581;7794;2362;7407;201;850;1680;5056;1881;5906
250990;201501;2006;6975;1842;6644;217;954;1303;4618;1520;5572
251000;201501;2191;6648;1997;6356;94;358;1663;5283;1757;5641
251010;201501;2747;8090;2478;7661;135;507;2088;6452;2223;6959
251020;201501;1611;4750;1471;4579;86;299;1295;4036;1381;4335
251030;201501;1189;3365;1076;3170;89;300;770;2259;859;2559
251040;201501;1859;5903;1668;5606;142;691;1238;4005;1380;4696
251050;201501;1064;3142;937;2917;146;474;579;1816;725;2290
251060;201501;943;2254;763;2020;49;173;597;1535;646;1708
251065;201501;453;1410;423;1366;45;169;310;966;355;1135
251070;201501;625;1753;569;1674;51;209;449;1238;500;1447
251080;201501;19720;56057;18113;53426;4811;14779;9065;27406;13876;42185
251090;201501;2932;9277;2633;8709;220;860;1940;6331;2160;7191
251100;201501;940;3035;828;2821;135;532;498;1633;633;2165
251110;201501;1995;5885;1769;5460;171;581;1249;3824;1420;4405
251120;201501;5947;20294;5730;19914;678;2799;4413;15113;5091;17912
251130;201501;4099;10637;3697;10195;31;86;3582;9911;3613;9997
251140;201501;4200;13017;3921;12592;133;585;3281;10487;3414;11072
251150;201501;2608;8559;2381;8240;264;1105;1785;6115;2049;7220
251160;201501;1718;5795;1664;5725;55;232;1527;5249;1582;5481
251170;201501;1389;4333;1327;4259;99;394;1118;3545;1217;3939
251180;201501;2625;8096;2428;7834;493;1588;1529;5012;2022;6600
251190;201501;4225;11979;4081;11820;189;544;3763;10937;3952;11481
251200;201501;4117;12869;3894;12593;120;443;3573;11602;3693;12045
251203;201501;1140;3793;1070;3641;78;358;804;2697;882;3055
251207;201501;1130;3560;979;3286;80;371;686;2211;766;2582
251210;201501;7851;22474;6801;21096;784;2406;5173;16414;5957;18820
251220;201501;1138;3081;964;2821;101;311;739;2182;840;2493
251230;201501;4568;13981;4162;13522;220;841;3749;12174;3969;13015
251240;201501;3047;9921;2971;9812;269;953;2480;8187;2749;9140
251250;201501;10145;30240;9368;29081;989;3622;7175;21893;8164;25515
251260;201501;538;1649;469;1557;27;94;356;1183;383;1277
251270;201501;4177;13338;3928;13035;126;536;3568;11838;3694;12374
251272;201501;1373;4180;1313;4096;104;346;1106;3463;1210;3809
251274;201501;867;2809;800;2686;87;372;582;1897;669;2269
251275;201501;1231;3638;1181;3565;96;402;914;2656;1010;3058
251276;201501;1223;3820;1149;3686;103;401;864;2727;967;3128
251278;201501;572;1881;511;1747;70;276;335;1155;405;1431
251280;201501;2305;7228;2198;7058;190;726;1741;5492;1931;6218
251290;201501;5750;16176;5456;15826;613;2100;4262;12109;4875;14209
251300;201501;750;2588;698;2512;62;293;522;1838;584;2131
251310;201501;3146;9295;2900;8946;142;564;2407;7359;2549;7923
251315;201501;1549;5508;1496;5419;214;822;1029;3776;1243;4598
251320;201501;1870;5363;1533;4821;73;275;1180;3699;1253;3974
251330;201501;1831;4948;1604;4650;77;328;1420;4014;1497;4342
251335;201501;1014;3495;950;3378;87;409;695;2398;782;2807
251340;201501;3480;9938;2994;9197;230;919;2269;6759;2499;7678
251350;201501;1439;4502;1304;4306;143;538;947;3074;1090;3612
251360;201501;1781;5863;1647;5700;78;338;1439;4984;1517;5322
251365;201501;825;2452;675;2148;42;175;477;1472;519;1647
251370;201501;21648;70015;21151;69311;2255;9068;16761;53502;19016;62570
251380;201501;1372;4268;1185;3951;64;296;974;3160;1038;3456
251385;201501;825;2300;736;2163;79;235;528;1521;607;1756
251390;201501;5778;20215;5377;19552;1217;4675;3200;11739;4417;16414
251392;201501;1016;3041;924;2902;65;207;736;2320;801;2527
251394;201501;621;1892;513;1693;32;125;369;1202;401;1327
251396;201501;839;2393;744;2228;111;345;506;1490;617;1835
251398;201501;998;2975;885;2765;57;218;644;1998;701;2216
251400;201501;1179;3372;1035;3181;98;388;771;2293;869;2681
251410;201501;1376;3721;1263;3539;79;277;1027;2828;1106;3105
251420;201501;2038;6021;1825;5772;149;531;1471;4630;1620;5161
251430;201501;1658;5962;1552;5797;94;444;1308;4865;1402;5309
251440;201501;1307;3895;1095;3484;90;315;798;2522;888;2837
251445;201501;1548;4769;1478;4673;76;319;1281;3989;1357;4308
251450;201501;4611;14736;4269;14322;138;609;3752;12615;3890;13224
251455;201501;1150;3690;1035;3501;90;379;733;2457;823;2836
251460;201501;801;2550;771;2502;106;340;604;1995;710;2335
251465;201501;452;1429;396;1301;26;107;285;912;311;1019
251470;201501;1162;3448;981;3112;107;404;611;1926;718;2330
251480;201501;986;2762;879;2590;29;143;747;2140;776;2283
251490;201501;1812;5518;1639;5263;232;870;1079;3427;1311;4297
251500;201501;1697;5567;1661;5509;142;538;1376;4531;1518;5069
251510;201501;2540;8487;2333;8073;370;1362;1503;5232;1873;6594
251520;201501;974;2725;877;2570;129;388;516;1521;645;1909
251530;201501;11654;33417;11142;32709;425;1720;9866;28556;10291;30276
251540;201501;2801;9150;2590;8726;198;837;2053;6834;2251;7671
251550;201501;3790;9510;3133;8687;103;374;2656;7244;2759;7618
251560;201501;761;2349;697;2242;108;418;413;1230;521;1648
251570;201501;989;2964;817;2618;78;317;583;1830;661;2147
251580;201501;1957;5551;1841;5386;341;858;1275;3928;1616;4786
251590;201501;1579;5258;1533;5205;69;272;1376;4693;1445;4965
251593;201501;1090;3361;1008;3252;158;567;623;1959;781;2526
251597;201501;1923;5942;1838;5825;141;553;1497;4652;1638;5205
251600;201501;6491;19269;6107;18649;452;1543;5028;15326;5480;16869
251610;201501;3201;9797;2930;9441;256;892;2362;7613;2618;8505
251615;201501;1124;3282;922;2938;90;369;647;2040;737;2409
251620;201501;15655;44208;13606;41698;1200;3940;10706;33191;11906;37131
251630;201501;4786;12346;4123;11497;266;792;3397;9466;3663;10258
251640;201501;2571;7561;2153;6861;187;731;1555;4896;1742;5627
251650;201501;4001;11768;3665;11335;240;802;3174;9862;3414;10664
251660;201501;3391;11376;3191;11034;204;1008;2642;8885;2846;9893
251670;201501;4194;12568;3716;11916;71;224;3401;11024;3472;11248
251675;201501;717;2370;669;2300;144;533;393;1327;537;1860
251680;201501;2635;7653;2242;7035;111;462;1833;5674;1944;6136
251690;201501;3384;10437;3132;9975;220;842;2364;7396;2584;8238
251700;201501;1917;6274;1815;6141;106;445;1574;5320;1680;5765
251710;201501;914;2390;677;1948;83;281;379;1054;462;1335
251720;201501;1366;4211;1237;3992;81;352;1002;3173;1083;3525
251740;201501;774;2188;619;1922;76;256;388;1197;464;1453
260005;201501;24802;61088;21494;56539;4699;12473;12477;32984;17176;45457
260010;201501;9735;26334;7875;24081;906;2927;5641;17607;6547;20534
260020;201501;5488;16335;4795;15289;359;1165;3782;12290;4141;13455
260030;201501;5630;16808;5166;16101;430;1533;4064;12597;4494;14130
260040;201501;10099;24368;8385;22449;648;1455;6752;18812;7400;20267
260050;201501;11090;34693;10288;33775;544;1914;9090;30135;9634;32049
260060;201501;3866;10935;3486;10305;297;870;2705;8115;3002;8985
260070;201501;9440;28008;8913;27218;1644;5392;5894;17959;7538;23351
260080;201501;5225;14688;4678;13911;445;1504;3635;10650;4080;12154
260090;201501;5124;14424;4862;14045;1070;2978;3276;9757;4346;12735
260100;201501;3191;8802;2871;8361;170;637;2431;7062;2601;7699
260105;201501;4618;13590;4430;13238;586;1944;3188;9381;3774;11325
260110;201501;20812;60160;19236;58258;919;2825;16973;51740;17892;54565
260120;201501;11443;35070;10566;33549;2730;8924;5540;18224;8270;27148
260130;201501;3189;9047;3012;8769;446;1240;2182;6502;2628;7742
260140;201501;13254;33434;11326;31126;912;2736;9059;25234;9971;27970
260150;201501;3098;8864;2778;8419;188;711;2269;6878;2457;7589
260160;201501;5715;17796;5111;17063;357;1376;4323;14548;4680;15924
260170;201501;17347;48292;16508;47185;1252;3801;13597;38977;14849;42778
260180;201501;3317;10270;3025;9851;203;806;2524;8147;2727;8953
260190;201501;15533;37085;14466;35776;519;1366;12907;31865;13426;33231
260200;201501;10471;30273;9669;29137;802;2599;7937;24080;8739;26679
260210;201501;10886;33795;9944;32455;613;2416;8306;27135;8919;29551
260220;201501;9105;27388;8809;26987;531;2072;7729;23285;8260;25357
260230;201501;9460;27599;8847;26793;445;1515;7502;23010;7947;24525
260240;201501;2923;8921;2530;8375;363;1307;1815;6047;2178;7354
260250;201501;2254;6295;2022;6001;117;369;1721;5112;1838;5481
260260;201501;11692;33353;10974;32446;1420;4462;8398;25299;9818;29761
260270;201501;3500;10463;3283;10144;297;1188;2617;7905;2914;9093
260280;201501;12672;41697;11742;40277;630;2416;10095;34942;10725;37358
260290;201501;28986;88138;27706;85971;4010;14278;18999;57696;23009;71974
260300;201501;8491;25852;7535;24435;488;2051;6019;19484;6507;21535
260310;201501;4628;13856;4284;13338;1305;3731;2305;7770;3610;11501
260320;201501;6834;22895;6392;22237;487;1758;5262;18551;5749;20309
260330;201501;2676;8713;2495;8422;182;784;1970;6593;2152;7377
260340;201501;1898;5628;1780;5451;87;313;1576;4804;1663;5117
260345;201501;22695;72547;21418;70061;5599;20344;9528;29768;15127;50112
260350;201501;4536;12658;4293;12295;303;994;3544;10080;3847;11074
260360;201501;2188;6637;1997;6342;255;970;1444;4494;1699;5464
260370;201501;5853;18284;5207;17125;538;2075;3836;12655;4374;14730
260380;201501;4694;15732;4370;15288;365;1437;3435;12078;3800;13515
260390;201501;4449;14228;3962;13343;401;1552;2844;9407;3245;10959
260392;201501;3542;11137;3289;10824;117;492;2965;9740;3082;10232
260400;201501;13304;38734;12732;37808;1937;6556;8904;25816;10841;32372
260410;201501;55644;165751;51757;159511;15244;49182;24153;75665;39397;124847
260415;201501;3910;12580;3390;11572;421;1774;2190;7237;2611;9011
260420;201501;11977;27622;10856;26434;381;1017;9814;23931;10195;24948
260430;201501;2776;9234;2508;8785;272;1094;1836;6387;2108;7481
260440;201501;3143;9692;2864;9134;431;1558;1773;5478;2204;7036
260450;201501;4900;14635;4639;14241;218;790;4017;12304;4235;13094
260460;201501;5549;17074;5163;16478;828;2937;3371;10581;4199;13518
260470;201501;4781;14022;4493;13641;313;1018;3843;11780;4156;12798
260480;201501;3991;11655;3587;11072;586;2020;2418;7471;3004;9491
260490;201501;4959;13391;4383;12445;386;1297;3450;9608;3836;10905
260500;201501;6104;17270;5514;16406;614;1948;4049;12055;4663;14003
260510;201501;8794;23536;8165;22780;257;672;7575;21334;7832;22006
260515;201501;4742;14607;3732;12559;344;1345;2350;7901;2694;9246
260520;201501;15633;41548;15095;40837;2751;7371;10699;29336;13450;36707
260530;201501;9914;29954;8791;28363;480;1545;7525;24648;8005;26193
260540;201501;5841;14834;5415;14383;597;1261;4482;12316;5079;13577
260545;201501;43;165;32;130;4;18;7;27;11;45
260550;201501;2700;8994;2360;8308;541;2137;1056;3694;1597;5831
260560;201501;6421;16847;5846;16028;223;691;5206;14242;5429;14933
260570;201501;6668;22552;6181;21737;840;3331;4446;15719;5286;19050
260580;201501;3693;10436;3465;10076;206;743;2961;8418;3167;9161
260590;201501;6050;15332;5788;15029;260;602;5260;13824;5520;14426
260600;201501;25698;78295;23717;74974;2677;9791;17116;53529;19793;63320
260610;201501;6666;20017;6315;19520;1057;3490;4440;13620;5497;17110
260620;201501;16100;48936;15472;47890;2656;9201;10115;30749;12771;39950
260630;201501;2137;6491;1919;6125;154;623;1522;4759;1676;5382
260640;201501;17173;47560;16186;46206;2270;6929;11455;32646;13725;39575
260650;201501;5096;16660;4667;15936;519;1758;3550;12421;4069;14179
260660;201501;8250;23022;7467;22034;422;1339;6491;19250;6913;20589
260670;201501;2329;6490;1931;5953;215;767;1370;4214;1585;4981
260680;201501;21519;60057;20027;57526;4388;13067;10661;30449;15049;43516
260690;201501;3643;10056;3160;9300;151;574;2649;7722;2800;8296
260700;201501;5634;17098;5501;16959;49;90;5411;16796;5460;16886
260710;201501;1193;3689;1100;3554;86;362;875;2766;961;3128
260720;201501;15907;52891;15081;51494;3587;12747;8411;29209;11998;41956
260730;201501;6831;22988;6336;22194;840;3063;4646;16484;5486;19547
260740;201501;1311;3989;1147;3703;160;583;710;2280;870;2863
260750;201501;6487;20893;5963;20183;532;1676;4975;17213;5507;18889
260760;201501;4614;12646;4312;12258;343;1055;3522;10044;3865;11099
260765;201501;7379;25627;7108;25223;958;4184;5254;18203;6212;22387
260770;201501;3895;10255;3553;9791;144;503;3000;8163;3144;8666
260775;201501;5141;14906;4885;14530;486;1791;3628;10457;4114;12248
260780;201501;3645;12009;3486;11734;739;2797;2165;7160;2904;9957
260790;201501;110354;280681;104499;272334;19984;54261;65616;170389;85600;224650
260795;201501;2993;9469;2740;9075;405;1480;1851;6180;2256;7660
260800;201501;4813;13097;4452;12599;198;823;3932;10815;4130;11638
260805;201501;3963;11547;3536;10899;436;1474;2485;7627;2921;9101
260810;201501;6805;19809;6663;19639;291;917;6085;18007;6376;18924
260820;201501;4296;12324;3963;11878;1048;3243;2233;6698;3281;9941
260825;201501;2784;9123;2578;8813;184;697;2123;7286;2307;7983
260830;201501;3651;11831;3317;11219;862;2814;1906;6757;2768;9571
260840;201501;4232;12240;3847;11694;267;1071;3175;9453;3442;10524
260845;201501;4234;12396;3942;11861;573;1832;2701;8130;3274;9962
260850;201501;4860;16302;4376;15244;982;3877;2162;7339;3144;11216
260860;201501;3234;10408;2985;9927;205;783;2358;7850;2563;8633
260870;201501;4185;11691;3794;11211;497;1358;2867;8722;3364;10080
260875;201501;6690;18329;5984;17246;1004;2957;3911;11368;4915;14325
260880;201501;8842;27882;8337;27125;649;2171;6925;22786;7574;24957
260890;201501;13303;38352;12463;37087;975;3370;9764;28897;10739;32267
260900;201501;5942;18495;5164;17037;779;2895;3149;10350;3928;13245
260910;201501;3022;9100;2762;8719;212;765;2239;7096;2451;7861
260915;201501;4435;15070;4272;14847;64;276;4060;14165;4124;14441
260920;201501;3415;10348;3241;10115;412;1426;2488;7855;2900;9281
260930;201501;4010;12909;3557;12206;412;1514;2577;8955;2989;10469
260940;201501;13261;36021;12133;34184;1515;5172;8407;22905;9922;28077
260950;201501;6119;19354;5728;18570;717;2991;3620;11128;4337;14119
260960;201501;55779;158115;52124;152241;10518;32813;29637;86283;40155;119096
260970;201501;4933;15841;4585;15366;354;1507;3594;11886;3948;13393
260980;201501;3824;12497;3615;12240;143;558;3266;11097;3409;11655
260990;201501;17093;53881;15693;52053;1373;4548;12754;43141;14127;47689
261000;201501;15892;43687;12815;38904;2489;8004;6865;21471;9354;29475
261010;201501;2553;7302;2386;7095;146;318;2117;6493;2263;6811
261020;201501;5949;17733;5450;16984;459;1695;4338;13208;4797;14903
261030;201501;3341;10989;3146;10645;249;1020;2556;8558;2805;9578
261040;201501;5177;16907;4606;15866;447;1821;3376;11492;3823;13313
261050;201501;8091;23521;7586;22660;981;2905;5319;15940;6300;18845
261060;201501;11494;34499;10930;33601;1240;4449;8252;24939;9492;29388
261070;201501;48568;122013;43058;114333;7642;20969;27120;72392;34762;93361
261080;201501;5775;17294;5441;16791;339;982;4665;14639;5004;15621
261090;201501;16155;45093;15039;43606;1318;3867;12145;35621;13463;39488
261100;201501;7667;24523;6959;23341;1114;4002;4504;15305;5618;19307
261110;201501;58827;175744;53302;167715;11878;39185;30721;98783;42599;137968
261120;201501;3579;9721;3195;9260;101;345;2868;8344;2969;8689
261130;201501;6958;17958;6614;17580;151;367;6232;16638;6383;17005
261140;201501;3219;9112;2933;8681;487;1592;1825;5340;2312;6932
261150;201501;5493;16386;5027;15662;571;2013;3794;11799;4365;13812
261153;201501;2034;5960;1667;5404;79;318;1316;4285;1395;4603
261160;201501;205442;535885;193758;520062;42348;116569;110132;301746;152480;418315
261170;201501;5706;15961;5234;15297;644;1909;4022;11864;4666;13773
261180;201501;9436;26600;8953;25925;747;2318;6997;20405;7744;22723
261190;201501;5174;16292;4860;15905;610;2699;3517;11077;4127;13776
261200;201501;3640;9192;3315;8788;466;1234;2487;6693;2953;7927
261210;201501;1916;5099;1833;4994;120;309;1637;4511;1757;4820
261220;201501;12701;40704;10764;36515;1985;7378;5555;18768;7540;26146
261230;201501;4330;13200;3987;12771;187;686;3490;11236;3677;11922
261240;201501;4719;14127;4418;13616;692;2089;3070;9636;3762;11725
261245;201501;3617;11480;3151;10685;199;911;2495;8350;2694;9261
261247;201501;3338;10312;2831;9386;292;1095;2039;6781;2331;7876
261250;201501;19630;52560;18836;51553;3426;9085;13807;38631;17233;47716
261255;201501;4031;12600;3689;12029;241;919;3097;10116;3338;11035
261260;201501;11775;33925;10735;32696;475;1264;9585;29780;10060;31044
261270;201501;3807;11168;3484;10668;492;1637;2324;7029;2816;8666
261280;201501;2530;7777;2313;7469;174;630;1886;6090;2060;6720
261290;201501;2897;8426;2675;8138;150;559;2270;6936;2420;7495
261300;201501;10540;34841;9422;32881;1620;6484;5763;19878;7383;26362
261310;201501;7353;22749;6961;22088;1605;5265;4106;13092;5711;18357
261320;201501;5497;17566;5160;16946;336;1256;4216;13886;4552;15142
261330;201501;5371;15948;5160;15655;496;1521;4148;12621;4644;14142
261340;201501;4161;13886;3973;13579;501;2090;2693;9112;3194;11202
261350;201501;7974;26817;7543;26108;431;1949;6157;21066;6588;23015
261360;201501;8058;21482;7244;20352;673;2013;5749;16028;6422;18041
261370;201501;19794;58993;18604;57208;3695;12146;11548;35434;15243;47580
261380;201501;4129;14168;3823;13591;563;2220;2603;9300;3166;11520
261390;201501;15761;48562;14337;46171;2136;7734;9191;29333;11327;37067
261400;201501;4787;16650;4358;15780;500;2092;3099;11225;3599;13317
261410;201501;8360;24152;7729;23194;912;2809;5849;17763;6761;20572
261420;201501;7262;24890;6970;24481;1678;6652;4192;14440;5870;21092
261430;201501;3328;10622;2962;10118;302;1032;2282;7966;2584;8998
261440;201501;1608;5061;1468;4849;87;393;1215;3954;1302;4347
261450;201501;13618;39186;13223;38697;497;1607;12181;35635;12678;37242
261460;201501;7038;21327;6624;20798;424;1136;5842;18861;6266;19997
261470;201501;3918;10673;3570;10258;148;491;3175;9078;3323;9569
261480;201501;3549;12943;3315;12536;366;1581;2493;9288;2859;10869
261485;201501;4939;15262;4503;14501;829;3102;2643;8335;3472;11437
261500;201501;5655;15831;5000;14966;529;1445;3904;12090;4433;13535
261510;201501;1951;6317;1813;6107;127;475;1461;4938;1588;5413
261520;201501;2623;8572;2376;8100;152;626;1696;5866;1848;6492
261530;201501;12120;39088;10686;36369;2393;8938;4639;15848;7032;24786
261540;201501;7348;23806;7059;23309;1423;4683;4616;15602;6039;20285
261550;201501;3409;9970;3234;9720;306;1178;2652;7789;2958;8967
261560;201501;6986;22670;6359;21869;1117;4023;4476;15679;5593;19702
261570;201501;3438;10549;3021;9918;438;1534;2016;6623;2454;8157
261580;201501;5613;17828;5026;16913;367;1483;4132;13882;4499;15365
261590;201501;2450;7023;2227;6703;227;720;1728;5278;1955;5998
261600;201501;5319;14576;4565;13550;397;1248;3527;10556;3924;11804
261610;201501;2442;7159;2067;6632;121;500;1693;5313;1814;5813
261618;201501;2450;7022;2292;6821;204;678;1848;5432;2052;6110
261620;201501;4200;13100;3933;12676;486;1643;2887;9378;3373;11021
261630;201501;7793;22891;6586;20649;1084;3915;3688;11239;4772;15154
261640;201501;31579;81554;29156;78608;2047;5362;24457;67363;26504;72725
261650;201501;3587;11430;3363;11113;420;1504;2493;8274;2913;9778
270010;201501;4515;17136;4166;16473;501;2265;2832;11297;3333;13562
270020;201501;3796;11329;3594;11024;349;1237;2860;8665;3209;9902
270030;201501;40004;120674;37758;117163;8923;28606;21836;68753;30759;97359
270040;201501;10407;32043;9780;31298;1894;5635;6677;22437;8571;28072
270050;201501;4036;11713;3783;11387;360;1293;2990;8917;3350;10210
270060;201501;1639;5290;1551;5176;278;1035;1007;3370;1285;4405
270070;201501;4261;13219;3941;12790;183;833;3417;10919;3600;11752
270080;201501;1203;3914;1102;3703;176;697;707;2297;883;2994
270090;201501;2122;6628;2027;6454;56;229;1825;5744;1881;5973
270100;201501;5899;18355;5674;18019;989;3368;3894;12302;4883;15670
270110;201501;3132;8949;2848;8635;385;1224;1996;6410;2381;7634
270120;201501;2964;8706;2718;8385;88;334;2443;7575;2531;7909
270130;201501;4875;15396;4677;15173;395;1147;4003;13354;4398;14501
270135;201501;1708;4761;1657;4708;107;137;1513;4502;1620;4639
270140;201501;10169;25026;8927;23465;760;2899;7087;17519;7847;20418
270150;201501;2665;9113;2609;9043;131;534;2384;8243;2515;8777
270160;201501;5173;17234;4750;16713;272;1016;4064;14382;4336;15398
270170;201501;3857;12653;3562;12238;675;2729;2129;7207;2804;9936
270180;201501;2179;7421;2013;7193;124;626;1666;5877;1790;6503
270190;201501;1869;6160;1775;6023;126;513;1426;4877;1552;5390
270200;201501;2616;8846;2462;8622;220;942;1912;6616;2132;7558
270210;201501;4515;14312;4315;14048;300;1274;3722;11948;4022;13222
270220;201501;1411;4632;1331;4494;249;938;790;2622;1039;3560
270230;201501;10935;35482;9705;33518;1374;5752;6324;21406;7698;27158
270235;201501;6342;20688;5998;20126;332;1430;5048;16782;5380;18212
270240;201501;9851;29435;8547;27775;1820;6154;4917;16241;6737;22395
270250;201501;3285;8555;3046;8276;126;298;2822;7722;2948;8020
270255;201501;4996;15235;4076;13617;316;1347;2936;9673;3252;11020
270260;201501;5739;18886;5577;18646;558;2317;4574;14997;5132;17314
270270;201501;1209;3465;1116;3333;206;644;650;1909;856;2553
270280;201501;3570;10400;3289;9994;372;1259;2435;7357;2807;8616
270290;201501;8346;29263;7905;28501;815;3455;6176;22111;6991;25566
270300;201501;3556;11866;3257;11536;214;852;2765;9877;2979;10729
270310;201501;7176;22199;6415;20944;313;1526;5357;17042;5670;18568
270320;201501;6295;20268;6100;19946;1230;4674;3816;12402;5046;17076
270330;201501;4562;15340;4278;14964;423;1628;3426;12058;3849;13686
270340;201501;1731;5407;1557;5172;156;578;1228;4078;1384;4656
270350;201501;1873;5334;1718;5140;188;616;1289;3928;1477;4544
270360;201501;2016;6327;1965;6264;190;560;1668;5448;1858;6008
270370;201501;1627;5382;1499;5169;142;581;1082;3770;1224;4351
270375;201501;2971;8848;2700;8455;354;1375;1843;5513;2197;6888
270380;201501;5676;17610;5369;17201;505;1684;4270;13888;4775;15572
270390;201501;1305;3629;1178;3461;138;491;872;2461;1010;2952
270400;201501;6175;18850;5631;18078;494;1875;4033;12753;4527;14628
270410;201501;4798;14975;4530;14492;493;1801;3300;10428;3793;12229
270420;201501;5798;18786;5612;18542;312;1471;4678;15144;4990;16615
270430;201501;131922;385735;124863;375868;31370;98163;67095;206715;98465;304878
270440;201501;4616;14276;4326;13861;246;963;3582;11533;3828;12496
270450;201501;6282;19616;6037;19310;379;1528;5075;16109;5454;17637
270460;201501;3451;9407;3112;8959;213;733;2608;7394;2821;8127
270470;201501;10111;33076;9499;32106;1271;4463;6562;22657;7833;27120
270480;201501;3036;9491;2717;8931;300;1210;1862;5896;2162;7106
270490;201501;960;3124;916;3062;75;310;717;2373;792;2683
270500;201501;4952;17286;4742;17015;350;1348;4019;14563;4369;15911
270510;201501;5916;18089;5371;17334;733;3111;3914;12021;4647;15132
270520;201501;3544;11480;3337;11161;819;2999;1720;5801;2539;8800
270530;201501;1467;4390;1314;4183;178;589;898;2953;1076;3542
270540;201501;2033;6962;1857;6713;152;735;1497;5313;1649;6048
270550;201501;7040;20908;6211;19831;894;2977;4279;14037;5173;17014
270560;201501;3060;9485;2872;9201;461;1771;2039;6299;2500;8070
270570;201501;4422;14149;4023;13530;451;1891;2798;9269;3249;11160
270580;201501;1939;6469;1859;6356;249;886;1395;4860;1644;5746
270590;201501;1373;4679;1302;4557;36;166;1215;4234;1251;4400
270600;201501;2836;9590;2575;9178;214;1076;1984;6894;2198;7970
270610;201501;3203;10193;2979;9873;272;990;2395;7909;2667;8899
270620;201501;1356;4693;1292;4596;107;538;1062;3616;1169;4154
270630;201501;17199;49272;16046;47434;2354;6879;11362;34343;13716;41222
270640;201501;5851;18100;5268;17336;394;1643;4307;13924;4701;15567
270642;201501;2255;7992;2108;7771;291;1262;1516;5562;1807;6824
270644;201501;2556;7430;2298;7150;179;507;1965;6250;2144;6757
270650;201501;3775;12131;3621;11918;664;2750;2348;7362;3012;10112
270660;201501;2539;6438;1986;5661;128;474;1401;3979;1529;4453
270670;201501;16131;42576;13975;40071;1731;4806;10467;31152;12198;35958
270680;201501;4240;12754;4075;12571;178;496;3695;11540;3873;12036
270690;201501;8904;24991;8184;24165;2600;7421;4145;13075;6745;20496
270700;201501;681;2128;636;2062;92;370;435;1347;527;1717
270710;201501;5806;19474;5548;19141;602;2243;4424;15358;5026;17601
270720;201501;3246;11096;2993;10662;206;1018;2429;8526;2635;9544
270730;201501;6286;19383;5992;19051;683;2262;4865;15640;5548;17902
270740;201501;2361;6802;2231;6629;300;1027;1615;4696;1915;5723
270750;201501;4989;15948;4641;15433;500;1809;3588;11982;4088;13791
270760;201501;3372;10290;3070;9779;265;946;2359;7511;2624;8457
270770;201501;18210;48811;15517;45580;2973;8802;9570;29212;12543;38014
270780;201501;1819;6060;1733;5915;213;802;1250;4283;1463;5085
270790;201501;1643;5141;1510;4942;300;1101;899;2887;1199;3988
270800;201501;11346;33652;10613;32698;853;2932;8753;26974;9606;29906
270810;201501;3325;10137;2630;8880;288;1160;1688;5718;1976;6878
270820;201501;1795;6056;1647;5817;258;1031;1089;3838;1347;4869
270830;201501;5540;16536;5030;15907;967;3474;3286;10453;4253;13927
270840;201501;7683;25784;7098;25046;413;2038;6051;21002;6464;23040
270850;201501;7387;23985;7188;23743;1269;5194;5045;15839;6314;21033
270860;201501;10699;31301;9774;30102;1170;4395;7239;21788;8409;26183
270870;201501;2216;6652;1830;5849;265;908;1131;3584;1396;4492
270880;201501;8072;26218;7617;25560;590;2439;6271;20773;6861;23212
270890;201501;2466;7521;2311;7247;299;1141;1681;5148;1980;6289
270895;201501;2915;10929;2776;10746;211;935;2342;9125;2553;10060
270900;201501;1957;5354;1585;4816;108;404;1205;3594;1313;3998
270910;201501;3293;11326;3202;11161;312;1410;2549;8630;2861;10040
270915;201501;9752;33017;8843;31435;1560;6461;5251;18379;6811;24840
270920;201501;6246;19714;5907;19237;218;1069;5332;17109;5550;18178
270930;201501;17447;46832;14437;43112;2662;8319;8783;27064;11445;35383
270940;201501;5898;19824;5627;19527;609;2404;4365;15225;4974;17629
280010;201501;665;2004;584;1871;49;215;403;1244;452;1459
280020;201501;4778;14195;4166;13113;690;2350;2692;8419;3382;10769
280030;201501;71638;189126;62989;176511;15774;46378;30969;88103;46743;134481
280040;201501;3142;9777;2829;9333;305;1032;2124;7201;2429;8233
280050;201501;3741;12167;3480;11747;1125;4012;1500;5211;2625;9223
280060;201501;4262;14150;3981;13682;819;3048;2331;8123;3150;11171
280067;201501;7418;21220;6436;19849;708;2254;4674;14559;5382;16813
280070;201501;1905;6460;1811;6326;328;1209;1247;4397;1575;5606
280100;201501;3861;12131;3470;11454;880;3000;1705;5793;2585;8793
280110;201501;1397;4286;1299;4138;65;278;1102;3458;1167;3736
280120;201501;7691;24661;7134;23787;1069;3326;5095;17793;6164;21119
280130;201501;7254;20990;6718;20212;1158;3832;4357;13152;5515;16984
280140;201501;5483;15042;4999;14382;520;1482;3931;11460;4451;12942
280150;201501;3423;10414;3159;9955;425;1538;2116;6494;2541;8032
280160;201501;1395;4042;1252;3830;129;455;943;2876;1072;3331
280170;201501;4714;14058;4289;13461;461;1370;3327;10776;3788;12146
280190;201501;1078;3092;973;2922;74;296;757;2190;831;2486
280200;201501;1137;3471;1039;3324;154;627;722;2203;876;2830
280210;201501;12834;39793;11804;38349;2112;7061;7857;26274;9969;33335
280220;201501;1532;4727;1441;4591;87;346;1242;3921;1329;4267
280230;201501;3493;10443;3117;9846;472;1603;1948;6223;2420;7826
280240;201501;3425;10239;3138;9798;262;798;2501;7918;2763;8716
280250;201501;834;2198;701;1993;125;414;421;1117;546;1531
280260;201501;1974;5293;1835;5119;83;253;1647;4626;1730;4879
280270;201501;2297;7118;2022;6698;131;511;1572;5150;1703;5661
280280;201501;4135;13520;3808;12982;923;2639;2112;8124;3035;10763
280290;201501;16872;52367;15289;49873;2273;8116;10167;33637;12440;41753
280300;201501;9565;29645;8990;28966;675;2391;7594;24751;8269;27142
280310;201501;1330;3791;1201;3594;84;328;858;2514;942;2842
280320;201501;8190;26949;7587;25930;1434;5486;4160;14235;5594;19721
280330;201501;4490;12682;4097;12115;364;1265;3353;9803;3717;11068
280340;201501;3763;10966;3553;10687;293;946;2869;8793;3162;9739
280350;201501;21425;61824;19640;59212;2458;7778;14035;42900;16493;50678
280360;201501;5682;18032;5368;17557;1034;3846;3230;10399;4264;14245
280370;201501;1804;5115;1621;4836;135;471;1248;3669;1383;4140
280380;201501;998;3053;925;2956;90;349;727;2307;817;2656
280390;201501;3166;9347;2732;8562;482;1538;1680;5299;2162;6837
280400;201501;4237;12332;3858;11811;925;2648;2325;7565;3250;10213
280410;201501;2142;6980;1893;6501;297;1168;1099;3639;1396;4807
280420;201501;4205;12241;3933;11823;233;753;3412;10294;3645;11047
280430;201501;2227;5763;2050;5545;111;372;1758;4753;1869;5125
280440;201501;4834;14240;4532;13882;331;992;3910;12134;4241;13126
280445;201501;2456;7061;2294;6796;90;355;1903;5558;1993;5913
280450;201501;8524;23607;7992;22957;506;1205;6910;20434;7416;21639
280460;201501;6944;18638;6258;17693;822;2452;4566;13106;5388;15558
280470;201501;1771;5402;1629;5176;182;582;1225;3931;1407;4513
280480;201501;30240;89433;28894;87530;4481;15606;19695;58412;24176;74018
280490;201501;3765;11489;3353;10731;339;1239;2440;7742;2779;8981
280500;201501;900;2414;838;2336;29;90;752;2083;781;2173
280510;201501;2681;7829;2325;7374;248;901;1768;5668;2016;6569
280520;201501;1714;4872;1563;4681;154;393;1274;3947;1428;4340
280530;201501;2159;6356;2034;6205;173;565;1703;5249;1876;5814
280540;201501;9201;25081;8646;24358;238;931;7851;21936;8089;22867
280550;201501;6829;18501;5934;17114;661;2083;4265;12275;4926;14358
280560;201501;7412;22063;6996;21452;378;1356;5972;18156;6350;19512
280570;201501;6379;17742;5695;16878;686;2345;4088;12056;4774;14401
280580;201501;5559;17253;4745;15860;890;3006;2869;9920;3759;12926
280590;201501;2269;6997;2114;6802;273;1185;1528;4806;1801;5991
280600;201501;3862;11873;3619;11506;335;1253;2745;8640;3080;9893
280610;201501;2468;6990;2281;6733;265;947;1610;4638;1875;5585
280620;201501;5040;15298;4440;14182;699;2113;2895;9584;3594;11697
280630;201501;3850;12532;3670;12269;376;1103;2966;10325;3342;11428
280640;201501;2193;6500;2087;6381;80;154;1958;6119;2038;6273
280650;201501;1123;3501;1015;3318;142;527;681;2229;823;2756
280660;201501;2614;7514;2493;7349;379;1093;1944;5770;2323;6863
280670;201501;15589;41239;14630;39973;2510;7146;9943;27156;12453;34302
280680;201501;2776;7522;2455;7044;154;495;2036;5841;2190;6336
280690;201501;992;2815;866;2638;124;397;587;1771;711;2168
280700;201501;1095;3272;961;3071;65;206;746;2413;811;2619
280710;201501;11229;30448;10419;29519;762;1986;8850;25485;9612;27471
280720;201501;2227;6260;2041;6047;247;767;1479;4459;1726;5226
280730;201501;944;2836;900;2778;69;207;776;2428;845;2635
280740;201501;12930;35394;11289;32947;1702;4904;7544;22606;9246;27510
280750;201501;3501;10750;3214;10255;300;1129;2343;7451;2643;8580
280760;201501;5552;17182;5082;16547;623;2078;3673;12421;4296;14499
290010;201501;3114;6979;2237;5639;69;282;1782;4260;1851;4542
290020;201501;4482;15110;4415;15028;329;925;3892;13595;4221;14520
290030;201501;3137;9999;2974;9752;450;1512;2150;7106;2600;8618
290035;201501;4616;12173;4091;11515;273;830;3339;9675;3612;10505
290040;201501;3711;10631;3320;10184;213;860;2740;8271;2953;9131
290050;201501;2424;8067;2239;7789;161;665;1816;6295;1977;6960
290060;201501;1323;3375;1104;3118;193;627;792;2173;985;2800
290070;201501;31369;80128;26805;74559;5697;15922;14414;42399;20111;58321
290080;201501;6009;18109;5213;17096;589;1938;3967;13399;4556;15337
290090;201501;2232;4846;1765;4360;186;433;1462;3700;1648;4133
290100;201501;9448;27297;8329;25549;1136;3640;5590;17554;6726;21194
290110;201501;5020;15027;4792;14651;680;2311;3347;10099;4027;12410
290115;201501;4884;14591;4328;13859;308;1039;3407;11138;3715;12177
290120;201501;6439;17424;5774;16626;257;805;5130;14765;5387;15570
290130;201501;4491;11911;3848;11141;262;907;3144;8959;3406;9866
290135;201501;4587;11892;4041;11056;292;989;3090;8168;3382;9157
290140;201501;4066;12713;3476;11930;227;857;2982;10292;3209;11149
290150;201501;2198;6531;2096;6367;176;543;1767;5394;1943;5937
290160;201501;3407;9282;3313;9168;204;369;3025;8582;3229;8951
290170;201501;2718;9186;2494;8842;177;765;2150;7574;2327;8339
290180;201501;2892;8480;2578;8004;223;817;1981;6136;2204;6953
290190;201501;3865;13034;3723;12809;288;1163;2941;10128;3229;11291
290195;201501;2180;6046;1876;5599;133;476;1514;4520;1647;4996
290200;201501;3728;11816;3370;11228;280;985;2675;8957;2955;9942
290205;201501;3033;9298;2756;8887;319;1260;1987;6276;2306;7536
290210;201501;15512;42980;14390;41613;2804;7076;9630;30125;12434;37201
290220;201501;2218;6752;2124;6611;177;736;1662;5018;1839;5754
290225;201501;2893;7761;2695;7547;125;226;2499;7168;2624;7394
290230;201501;2266;7506;2202;7428;156;596;1898;6424;2054;7020
290240;201501;3777;10118;3422;9621;339;1035;2590;7179;2929;8214
290250;201501;3625;11729;3219;11097;237;847;2563;8974;2800;9821
290260;201501;4777;14219;4239;13415;358;1283;3370;10670;3728;11953
290265;201501;3235;10406;2935;9870;194;809;2319;7776;2513;8585
290270;201501;12172;44109;11493;43100;1521;6025;8450;32209;9971;38234
290280;201501;5070;16888;4777;16386;381;1463;3782;13001;4163;14464
290290;201501;9407;30127;8547;28769;1440;5007;5646;19441;7086;24448
290300;201501;4495;12891;3224;10519;260;847;2203;7478;2463;8325
290310;201501;1487;4456;1324;4205;231;804;783;2477;1014;3281
290320;201501;27064;80742;23529;76066;5550;18967;12785;42280;18335;61247
290323;201501;3741;10141;3251;9607;182;596;2762;8146;2944;8742
290327;201501;4277;13399;3846;12622;628;2142;2510;8281;3138;10423
290330;201501;1827;4663;1713;4537;160;469;1472;3877;1632;4346
290340;201501;4663;14948;4414;14629;1265;4124;2490;8473;3755;12597
290350;201501;4658;14400;4009;13485;515;1764;2773;9603;3288;11367
290360;201501;4385;13615;3831;12878;183;673;3277;11150;3460;11823
290370;201501;4663;13574;4212;13035;412;1244;3487;10968;3899;12212
290380;201501;5456;16006;4779;15031;355;1232;3810;12058;4165;13290
290390;201501;14376;45681;13361;44092;2654;8756;8101;27906;10755;36662
290395;201501;2613;8595;2339;8118;174;769;1814;6264;1988;7033
290400;201501;3510;10592;3066;9978;268;878;2412;7892;2680;8770
290405;201501;4477;14347;3891;13296;473;1709;2585;9065;3058;10774
290410;201501;5958;17615;4976;16192;517;2024;3628;11566;4145;13590
290420;201501;3269;9584;2711;8822;224;834;2162;7001;2386;7835
290430;201501;3063;9832;2801;9379;536;1939;1747;5859;2283;7798
290440;201501;2893;7796;2426;7156;185;612;1946;5810;2131;6422
290450;201501;3272;9613;2865;9032;402;1307;2018;6462;2420;7769
290460;201501;12852;38134;11653;36242;3127;10271;5210;16217;8337;26488
290470;201501;4469;12310;3438;10926;728;2630;1832;5904;2560;8534
290475;201501;4885;16969;4480;16197;448;1998;3271;11672;3719;13670
290480;201501;2672;6977;2372;6585;384;1121;1546;4383;1930;5504
290485;201501;4759;15254;4194;14426;375;1762;3376;11372;3751;13134
290490;201501;7958;21138;7646;20735;607;1754;6402;17340;7009;19094
290500;201501;4249;13432;3554;12152;613;2308;1904;6450;2517;8758
290510;201501;3306;9767;2888;9194;183;710;2368;7563;2551;8273
290515;201501;3075;9196;2744;8740;231;723;2190;7134;2421;7857
290520;201501;12141;37386;9900;33309;960;3971;6379;21261;7339;25232
290530;201501;5093;14830;4431;13861;350;1116;3562;11232;3912;12348
290540;201501;3940;11434;3745;11189;425;1204;2981;9127;3406;10331
290550;201501;4442;12030;3908;11407;145;424;3556;10440;3701;10864
290560;201501;5900;17839;5266;16900;1163;3982;3012;9825;4175;13807
290570;201501;40905;115389;37771;110902;4577;14103;27175;79619;31752;93722
290580;201501;6850;23829;6510;23310;969;3561;4723;17292;5692;20853
290590;201501;7680;24125;6450;22075;423;1752;5094;17406;5517;19158
290600;201501;16733;52039;15517;50173;2659;8413;10456;34988;13115;43401
290610;201501;2479;8442;2105;7714;192;881;1508;5444;1700;6325
290620;201501;6526;19867;5980;19064;371;1285;5031;16056;5402;17341
290630;201501;7841;21047;7059;20211;637;1828;5906;17096;6543;18924
290640;201501;2605;7705;2134;6920;157;606;1607;5161;1764;5767
290650;201501;11081;31725;10361;30749;2280;6662;6423;19713;8703;26375
290660;201501;3519;9939;3041;9258;171;585;2455;7573;2626;8158
290670;201501;6943;21259;6295;20263;753;2391;4662;15470;5415;17861
290680;201501;10058;29997;9212;28989;435;1549;7957;25126;8392;26675
290682;201501;4493;13113;4028;12466;165;655;3400;10414;3565;11069
290685;201501;3414;8544;2471;7246;297;949;1514;4549;1811;5498
290687;201501;7606;20847;6009;18736;1374;4457;3287;10539;4661;14996
290689;201501;3094;8979;2663;8315;246;791;2062;6570;2308;7361
290690;201501;5437;15830;4952;15226;473;1527;3961;12274;4434;13801
290700;201501;2329;7271;2211;7096;200;734;1731;5583;1931;6317
290710;201501;7983;25270;7644;24704;459;1512;6366;21229;6825;22741
290720;201501;18409;54410;16661;52241;1499;4269;13867;44758;15366;49027
290730;201501;7106;19942;6440;19079;1051;3034;4492;13522;5543;16556
290740;201501;911;2742;776;2520;89;319;528;1736;617;2055
290750;201501;10167;28784;8607;25973;1591;5529;4681;13470;6272;18999
290755;201501;2398;6745;1993;6084;120;439;1536;4670;1656;5109
290760;201501;4210;12707;3533;11632;384;1217;2445;8212;2829;9429
290770;201501;2571;9107;2423;8918;125;589;1983;7361;2108;7950
290780;201501;8838;22713;7773;21269;769;1703;6021;17155;6790;18858
290790;201501;4280;13093;4002;12689;284;882;3365;10800;3649;11682
290800;201501;7303;15794;5841;14244;733;1576;4334;11220;5067;12796
290810;201501;4890;15543;4187;14458;258;994;3233;11282;3491;12276
290820;201501;5553;15753;4960;14982;457;1514;3854;11701;4311;13215
290830;201501;4100;11374;3807;10939;224;823;3161;8876;3385;9699
290840;201501;17139;48765;15416;46402;2417;7036;10563;33190;12980;40226
290850;201501;6179;18131;6035;17939;709;1947;4950;15160;5659;17107
290860;201501;4882;16977;4576;16595;613;2266;3455;12913;4068;15179
290870;201501;4554;13716;3816;12626;335;1387;2850;9326;3185;10713
290880;201501;1384;3866;1130;3462;91;298;798;2468;889;2766
290890;201501;6868;18378;5955;17364;696;2001;4695;13902;5391;15903
290900;201501;2559;7317;1897;6216;295;1023;942;3108;1237;4131
290910;201501;4491;12571;3965;11815;146;497;3481;10350;3627;10847
290920;201501;4703;14050;4368;13566;267;769;3675;11584;3942;12353
290930;201501;7566;23846;6716;22418;590;2356;5062;16709;5652;19065
290940;201501;3385;10913;3172;10634;196;695;2778;9462;2974;10157
290950;201501;1564;4410;1403;4182;199;588;969;2954;1168;3542
290960;201501;5715;16375;5225;15731;230;801;4423;13375;4653;14176
290970;201501;3523;11413;3171;10821;359;1274;2139;7428;2498;8702
290980;201501;10514;30647;9108;28061;2525;8123;3400;10391;5925;18514
290990;201501;9084;27413;8008;25685;853;2944;6034;19313;6887;22257
291000;201501;3034;9233;2776;8904;261;891;2277;7374;2538;8265
291005;201501;13701;36978;12279;35035;1772;5238;8546;24853;10318;30091
291010;201501;3137;10016;2520;8683;279;1021;1628;5656;1907;6677
291020;201501;1409;3712;1094;3170;119;413;673;1857;792;2270
291030;201501;2281;6240;1705;5105;181;603;1048;3065;1229;3668
291040;201501;5323;16294;4812;15579;478;1727;3817;12367;4295;14094
291050;201501;7612;25297;6933;24012;1869;7146;3363;11417;5232;18563
291060;201501;5966;22099;5694;21714;719;3205;4199;15926;4918;19131
291070;201501;15806;46195;14219;43961;1309;4181;10902;34143;12211;38324
291072;201501;21349;64038;17828;57245;4898;16961;6748;22182;11646;39143
291075;201501;5066;14420;4557;13777;279;713;3660;11463;3939;12176
291077;201501;1508;4297;1235;3866;122;437;838;2624;960;3061
291080;201501;77863;242710;70221;228118;23125;77559;21540;69054;44665;146613
291085;201501;5459;14683;4809;13840;462;1340;3880;11263;4342;12603
291090;201501;1528;3784;1334;3541;99;373;1097;2820;1196;3193
291100;201501;2748;7138;2239;6605;122;458;1885;5547;2007;6005
291110;201501;4763;17369;4399;16791;572;2525;3152;11861;3724;14386
291120;201501;7416;20016;6842;19187;811;2332;5145;14547;5956;16879
291125;201501;1776;3702;1388;3291;110;263;1090;2648;1200;2911
291130;201501;2861;8876;2466;8220;183;777;1821;5938;2004;6715
291140;201501;4253;12612;3832;11855;567;1772;2552;8013;3119;9785
291150;201501;1965;5188;1868;5075;145;429;1479;3991;1624;4420
291160;201501;5340;16560;4693;15565;1167;3884;2563;8673;3730;12557
291165;201501;2471;7129;1944;6138;89;409;1443;4427;1532;4836
291170;201501;21048;54473;18045;50695;964;3274;14337;40072;15301;43346
291180;201501;6424;16793;5172;15029;561;1850;3649;10534;4210;12384
291185;201501;3824;10462;3520;10054;303;914;2914;8313;3217;9227
291190;201501;6966;19494;6253;18601;576;1815;5039;15139;5615;16954
291200;201501;2844;8586;2343;7667;181;622;1672;5561;1853;6183
291210;201501;7224;17203;6174;16027;389;1147;5070;13135;5459;14282
291220;201501;3986;12601;3729;12190;434;1592;2791;9072;3225;10664
291230;201501;4014;10443;3660;10043;107;259;3379;9380;3486;9639
291240;201501;4603;12598;3997;11502;202;649;3225;9135;3427;9784
291250;201501;3640;10970;2879;9695;312;1091;1946;6664;2258;7755
291260;201501;1085;3204;1000;3088;62;248;826;2501;888;2749
291270;201501;4369;14458;4025;13846;1146;4121;2159;7554;3305;11675
291280;201501;2365;6191;1774;5394;406;1307;974;2933;1380;4240
291290;201501;5557;15659;4902;14840;801;2425;3215;10017;4016;12442
291300;201501;4177;12376;3553;11364;327;1239;2596;8180;2923;9419
291310;201501;5371;15342;4667;14120;322;1039;3673;11102;3995;12141
291320;201501;5988;19105;5111;17439;1181;4446;2709;9092;3890;13538
291330;201501;1579;4717;1430;4481;146;541;1014;3103;1160;3644
291340;201501;3809;11275;3215;10440;214;824;2610;8424;2824;9248
291345;201501;3506;11289;3273;11028;192;611;2907;10030;3099;10641
291350;201501;5801;17178;5144;16085;389;1315;3935;12454;4324;13769
291360;201501;32730;93038;30040;89229;7224;21322;17640;54135;24864;75457
291370;201501;8399;24699;7993;24185;656;1997;6415;19832;7071;21829
291380;201501;3720;11547;3229;10758;231;845;2371;8105;2602;8950
291390;201501;10350;28112;9381;26988;1251;3388;7168;21034;8419;24422
291400;201501;16243;42475;13435;38755;2300;6460;8486;25719;10786;32179
291410;201501;3293;8624;2458;7425;178;722;1876;5516;2054;6238
291420;201501;2153;5859;1878;5528;107;357;1638;4830;1745;5187
291430;201501;3339;9769;2970;9288;187;802;2394;7329;2581;8131
291440;201501;6338;19649;5448;18132;544;1917;4067;13699;4611;15616
291450;201501;7949;24170;7076;22921;323;1039;5880;19527;6203;20566
291460;201501;12767;38695;11451;36614;1934;6716;7102;22857;9036;29573
291465;201501;7911;22823;7092;21902;551;1930;5941;18343;6492;20273
291470;201501;15577;42646;13730;40405;1219;3430;10486;32013;11705;35443
291480;201501;33223;88307;29034;82622;3838;12449;19318;54319;23156;66768
291490;201501;4383;14266;4262;14105;378;1241;3589;12109;3967;13350
291500;201501;4258;12372;3665;11524;264;968;2917;9158;3181;10126
291510;201501;3534;10721;3238;10333;94;295;2963;9552;3057;9847
291520;201501;3770;10368;3272;9687;363;1145;2295;6875;2658;8020
291530;201501;2027;5852;1715;5381;411;1380;917;2969;1328;4349
291535;201501;4035;12102;3623;11514;239;846;2943;9442;3182;10288
291540;201501;2181;5206;1845;4858;156;307;1593;4347;1749;4654
291550;201501;5206;14279;4605;13459;1073;3053;2594;7788;3667;10841
291560;201501;16837;42226;13011;37836;1035;3029;10243;30596;11278;33625
291570;201501;2209;6086;2073;5925;146;345;1845;5410;1991;5755
291580;201501;5557;17032;4933;16134;584;2350;3599;11666;4183;14016
291590;201501;1805;5766;1621;5463;202;702;1169;4035;1371;4737
291600;201501;5755;15759;4328;13653;1044;3623;2000;6188;3044;9811
291610;201501;4862;15190;4713;15005;267;979;4116;13127;4383;14106
291620;201501;2868;6962;2380;6446;140;363;1936;5416;2076;5779
291630;201501;3110;7708;2659;7193;258;668;2149;5926;2407;6594
291640;201501;17057;46423;14018;42259;3525;11515;5383;16428;8908;27943
291650;201501;7912;23823;7341;23142;618;1617;6204;20208;6822;21825
291660;201501;2197;5824;1868;5345;156;559;1320;3653;1476;4212
291670;201501;1835;5279;1660;5030;119;399;1302;3938;1421;4337
291680;201501;4192;12368;3707;11593;783;2691;2082;6465;2865;9156
291685;201501;4669;11685;3880;10673;534;1431;2759;7856;3293;9287
291690;201501;3924;10702;3246;9645;246;731;2375;7121;2621;7852
291700;201501;9119;28590;8253;27110;860;2945;6276;20925;7136;23870
291710;201501;5100;13766;4297;12751;496;1611;3165;9479;3661;11090
291720;201501;4220;14149;3670;13046;383;1586;2619;9197;3002;10783
291730;201501;5954;18176;5412;17470;718;2483;4091;13413;4809;15896
291733;201501;2546;7455;2162;6951;274;947;1494;4845;1768;5792
291735;201501;2636;7448;2233;6853;129;471;1805;5480;1934;5951
291740;201501;3504;10685;3077;10027;283;1058;2329;7539;2612;8597
291750;201501;22315;57528;17362;50128;3868;11539;8976;26512;12844;38051
291760;201501;11316;36144;10077;34011;4002;14940;3215;10691;7217;25631
291770;201501;7492;21649;6548;20022;940;3101;4364;13238;5304;16339
291780;201501;4433;13485;4170;13030;392;1248;3286;10311;3678;11559
291790;201501;2608;8060;2470;7873;120;496;2128;6716;2248;7212
291800;201501;30245;85397;27082;80983;4700;14460;17062;52597;21762;67057
291810;201501;10528;29415;8857;27446;443;1616;7514;23361;7957;24977
291820;201501;3703;11010;3346;10510;268;869;2640;8390;2908;9259
291830;201501;4319;11593;3988;11123;440;1287;3051;8567;3491;9854
291835;201501;6246;19501;5050;17487;1343;4974;2660;9275;4003;14249
291840;201501;47355;132137;41784;125974;5340;15518;31494;98199;36834;113717
291845;201501;2922;8408;2598;8024;189;533;2287;7188;2476;7721
291850;201501;4679;13226;3856;11972;390;1128;2929;9381;3319;10509
291855;201501;1795;4636;1557;4335;183;644;1146;3068;1329;3712
291860;201501;2086;6082;1752;5462;135;509;1172;3587;1307;4096
291870;201501;1402;3752;1048;3130;101;354;668;1949;769;2303
291875;201501;2805;8931;2541;8531;178;774;1881;6183;2059;6957
291880;201501;4816;15316;4538;14879;342;1110;3763;12499;4105;13609
291890;201501;1349;3439;1126;3175;280;808;667;1954;947;2762
291900;201501;1301;3639;1103;3331;88;315;870;2615;958;2930
291905;201501;2759;7455;2248;6629;133;514;1705;4911;1838;5425
291910;201501;2701;7258;2278;6751;142;536;1917;5605;2059;6141
291915;201501;6981;21266;5927;19337;394;1387;4834;15886;5228;17273
291920;201501;30348;88511;27880;85017;5330;16883;16941;52513;22271;69396
291930;201501;2587;7664;2326;7266;217;765;1724;5369;1941;6134
291940;201501;3381;9637;2490;8021;357;1316;1407;4351;1764;5667
291950;201501;8582;29009;7800;27731;1436;5193;4664;17003;6100;22196
291955;201501;8941;27679;8507;27094;1949;6127;5133;17069;7082;23196
291960;201501;3142;9436;2631;8687;230;733;1991;6838;2221;7571
291970;201501;3916;12261;3665;11901;469;1617;2607;8585;3076;10202
291980;201501;11801;33962;9083;30098;963;3345;6430;21855;7393;25200
291990;201501;2262;6834;2051;6540;132;448;1635;5349;1767;5797
291992;201501;2796;8557;2725;8416;398;1294;2042;6267;2440;7561
291995;201501;1861;5687;1739;5479;150;548;1387;4345;1537;4893
292000;201501;2323;6734;2053;6354;309;1094;1445;4425;1754;5519
292010;201501;6343;16332;4939;14290;456;1327;3785;11016;4241;12343
292020;201501;4190;14357;3915;13923;617;2299;2822;10105;3439;12404
292030;201501;2087;6427;1845;6078;203;713;1185;3924;1388;4637
292040;201501;4287;11913;3724;11330;243;594;3247;10277;3490;10871
292045;201501;2839;9752;2800;9703;91;303;2645;9175;2736;9478
292050;201501;6275;19450;5492;17897;472;1880;3797;12218;4269;14098
292060;201501;11513;31160;10744;30209;1021;2729;8795;24979;9816;27708
292070;201501;4458;14127;4352;13985;394;1179;3688;12028;4082;13207
292080;201501;3574;9311;3033;8631;218;649;2512;7194;2730;7843
292090;201501;4051;10765;3508;10138;235;800;2992;8685;3227;9485
292100;201501;10908;29760;9172;27364;2617;8164;4026;12593;6643;20757
292105;201501;2969;9390;2684;8961;162;677;2207;7357;2369;8034
292110;201501;6700;17728;5184;15436;1119;3398;2936;9012;4055;12410
292120;201501;7709;22059;6764;20394;1363;4123;3819;11915;5182;16038
292130;201501;2940;7962;2586;7462;470;1269;1736;5142;2206;6411
292140;201501;4934;12977;4255;12078;841;2202;2805;8260;3646;10462
292145;201501;2483;7660;2272;7349;135;413;1811;6123;1946;6536
292150;201501;12805;39418;11923;38030;676;2480;9642;31063;10318;33543
292160;201501;2647;7679;2263;7188;110;339;1995;6417;2105;6756
292170;201501;8818;25344;7411;22967;983;3408;4761;14765;5744;18173
292180;201501;3251;9360;2530;8218;301;979;1736;5735;2037;6714
292190;201501;3383;9479;2859;8731;564;1809;1770;5504;2334;7313
292200;201501;6257;20152;5451;18640;1536;5715;2253;7690;3789;13405
292205;201501;3877;12115;3550;11665;213;851;2924;9534;3137;10385
292210;201501;6414;17819;5427;16516;365;1299;4442;13574;4807;14873
292220;201501;1934;5367;1777;5151;347;948;1100;3233;1447;4181
292225;201501;3174;9815;2912;9442;180;670;2421;7891;2601;8561
292230;201501;6351;19007;6036;18508;454;1857;4756;14121;5210;15978
292240;201501;4568;14100;4202;13350;571;1910;2718;8591;3289;10501
292250;201501;5082;15759;4720;15106;1081;3615;2375;7631;3456;11246
292260;201501;3087;9350;2937;9140;211;723;2479;7713;2690;8436
292265;201501;2956;9466;2655;8959;191;782;1981;6629;2172;7411
292270;201501;4112;10597;3263;9615;199;703;2716;8026;2915;8729
292273;201501;2696;6498;2070;5735;226;581;1554;4538;1780;5119
292275;201501;1778;4764;1580;4473;213;627;1114;3185;1327;3812
292280;201501;1985;5992;1782;5773;127;335;1451;4971;1578;5306
292285;201501;2525;6998;2184;6523;150;545;1766;5274;1916;5819
292290;201501;7318;21837;6094;20220;419;1593;4777;16110;5196;17703
292300;201501;7908;24020;6922;22845;1554;5284;4330;14749;5884;20033
292303;201501;2749;8607;2552;8354;79;345;2278;7395;2357;7740
292305;201501;2940;8050;2825;7902;55;178;2673;7482;2728;7660
292310;201501;5857;17514;5503;17005;230;813;4661;14430;4891;15243
292320;201501;6508;18874;5635;17431;537;1821;4322;13376;4859;15197
292330;201501;2067;5724;1932;5547;177;579;1542;4366;1719;4945
292335;201501;5190;13572;4651;12876;458;1228;3810;10699;4268;11927
292340;201501;6380;18168;5405;16611;564;1766;3860;11941;4424;13707
292350;201501;2166;6575;1980;6321;195;739;1581;5036;1776;5775
292360;201501;4902;13547;4718;13095;149;326;4195;12088;4344;12414
292370;201501;7893;23767;7388;23046;817;2233;5870;18851;6687;21084
292380;201501;7132;21194;6612;20396;459;1432;5496;17077;5955;18509
292390;201501;3481;8019;3117;7624;94;165;2923;7237;3017;7402
292400;201501;20387;61564;19468;60184;2578;8383;14492;45059;17070;53442
292405;201501;4444;11476;3731;10607;243;680;3106;8906;3349;9586
292410;201501;1909;5145;1808;5034;125;318;1594;4479;1719;4797
292420;201501;3763;12183;3609;11995;125;370;3376;11356;3501;11726
292430;201501;5624;16862;4429;15219;329;1355;3266;11224;3595;12579
292440;201501;8513;28169;7837;27182;279;1134;6953;24369;7232;25503
292450;201501;4104;12259;3403;11175;301;1037;2509;8379;2810;9416
292460;201501;5281;15870;4577;14640;843;2878;2820;9067;3663;11945
292465;201501;2384;7235;2021;6629;203;782;1408;4654;1611;5436
292467;201501;1939;6272;1840;6116;318;1133;1254;4232;1572;5365
292470;201501;2891;7834;2445;7105;142;499;1943;5588;2085;6087
292480;201501;6018;16222;5260;15192;199;737;4633;13290;4832;14027
292490;201501;2374;6511;1985;5957;170;591;1536;4574;1706;5165
292500;201501;6498;19375;5580;17805;599;2076;3962;12818;4561;14894
292510;201501;12537;35820;10916;33542;936;3083;8542;26687;9478;29770
292520;201501;5602;16574;5024;15706;1271;4026;2656;8439;3927;12465
292525;201501;5283;13831;4512;12931;234;717;3824;11054;4058;11771
292530;201501;25861;75434;23087;71780;5905;19072;12081;38769;17986;57841
292540;201501;2821;7986;2514;7582;266;925;1983;5974;2249;6899
292550;201501;6436;20509;5728;19553;657;2413;4336;15128;4993;17541
292560;201501;4005;11102;3413;10270;228;908;2787;8220;3015;9128
292570;201501;3863;11601;3688;11416;78;193;3498;11030;3576;11223
292575;201501;6003;20173;5829;19892;753;2673;4563;15628;5316;18301
292580;201501;6806;20504;6453;20039;456;1436;5458;17122;5914;18558
292590;201501;7045;21805;6708;21267;642;2119;5399;17091;6041;19210
292593;201501;3043;8015;2600;7363;208;560;2073;5919;2281;6479
292595;201501;5947;16581;5261;15699;455;1464;4100;12342;4555;13806
292600;201501;10448;29564;9619;28515;895;2116;7867;24172;8762;26288
292610;201501;4428;12708;3586;11309;363;1188;2365;7678;2728;8866
292620;201501;5972;17456;5138;16488;150;495;4754;15375;4904;15870
292630;201501;9343;23641;7932;21547;687;1881;5966;16531;6653;18412
292640;201501;7732;25515;7193;24763;495;1819;5738;20110;6233;21929
292650;201501;4675;12924;4474;12656;355;626;3937;11653;4292;12279
292660;201501;10408;31644;9716;30646;1048;3419;7587;24259;8635;27678
292665;201501;2657;8001;2584;7899;51;115;2472;7637;2523;7752
292670;201501;3802;10721;2945;9278;234;833;1959;6195;2193;7028
292680;201501;3516;10642;3261;10237;374;1121;2532;8041;2906;9162
292690;201501;2925;8004;2148;6800;209;707;1533;4963;1742;5670
292700;201501;9213;27603;8116;25998;1120;3337;5673;19022;6793;22359
292710;201501;1999;6611;1904;6481;80;300;1711;5855;1791;6155
292720;201501;9039;23420;7871;22120;386;1210;6891;19443;7277;20653
292730;201501;3487;10522;3362;10343;366;1153;2593;8061;2959;9214
292740;201501;328279;889690;309794;863688;57478;170721;199014;551362;256492;722083
292750;201501;6298;17040;5462;15930;328;1032;4539;13307;4867;14339
292760;201501;4030;12850;3695;12257;487;1734;2501;8395;2988;10129
292770;201501;5540;17028;5145;16429;996;3301;3288;10725;4284;14026
292780;201501;1873;4491;1451;3970;158;548;1060;2844;1218;3392
292790;201501;3145;8421;3014;8284;107;219;2819;7869;2926;8088
292800;201501;8882;26677;8218;25610;577;2044;6707;20843;7284;22887
292805;201501;2970;8558;2683;8161;406;1357;1913;5794;2319;7151
292810;201501;9275;28496;7984;26723;1005;3524;5826;19916;6831;23440
292820;201501;7188;20739;5377;18146;328;1316;4294;14579;4622;15895
292830;201501;1855;5454;1686;5220;85;362;1428;4363;1513;4725
292840;201501;7663;23964;7176;23307;303;1180;6453;20820;6756;22000
292850;201501;3300;8774;2750;7971;299;926;1975;5683;2274;6609
292860;201501;13956;37842;13289;36971;1159;3450;10891;30221;12050;33671
292870;201501;18915;51850;16522;48214;2330;7556;10234;29512;12564;37068
292880;201501;12566;36369;11234;34437;1386;4689;7754;23569;9140;28258
292890;201501;5464;18670;4912;17666;795;3065;3073;11189;3868;14254
292895;201501;2716;6726;2150;5896;273;748;1547;4236;1820;4984
292900;201501;2809;8792;2674;8592;229;997;1983;6109;2212;7106
292905;201501;4181;12232;3542;11382;193;560;2947;9727;3140;10287
292910;201501;4978;15073;4524;14252;702;2405;2882;9051;3584;11456
292920;201501;8760;25991;8304;25346;687;2453;6651;19793;7338;22246
292925;201501;5101;15740;4534;14925;422;1424;3480;11557;3902;12981
292930;201501;6399;20729;6100;20216;562;2392;4612;14946;5174;17338
292935;201501;2137;6060;1759;5651;102;263;1496;5015;1598;5278
292937;201501;3215;8244;2705;7606;272;868;2087;5790;2359;6658
292940;201501;3219;8838;2561;7951;322;1014;1729;5586;2051;6600
292950;201501;7747;23125;7334;22446;668;2499;5526;16483;6194;18982
292960;201501;5014;13234;4374;12366;381;1186;3280;9196;3661;10382
292970;201501;4290;12934;3834;12343;160;677;3266;10532;3426;11209
292975;201501;3398;9177;3222;8942;309;800;2735;7713;3044;8513
292980;201501;3361;9041;2674;8161;268;955;1963;5926;2231;6881
292990;201501;11700;33963;10438;32049;490;1700;8917;27349;9407;29049
293000;201501;2734;7341;2391;6911;81;280;2119;6129;2200;6409
293010;201501;17837;49982;15370;46115;2575;8411;9496;28356;12071;36767
293015;201501;7410;25475;6605;24002;988;4033;4245;15356;5233;19389
293020;201501;9185;30679;8598;29868;416;1823;7406;25674;7822;27497
293030;201501;5473;15939;4354;14243;378;1270;3103;10602;3481;11872
293040;201501;3680;12138;3507;11807;182;666;3111;10455;3293;11121
293050;201501;19569;54709;17229;51810;2402;7534;11709;36072;14111;43606
293060;201501;3891;10142;3226;9097;286;892;2371;6620;2657;7512
293070;201501;20589;60961;18450;57510;4617;14677;9447;30244;14064;44921
293075;201501;3339;11082;3028;10657;224;870;2467;8741;2691;9611
293076;201501;3678;10255;3391;9869;234;648;2855;8484;3089;9132
293077;201501;4668;14855;4204;14204;1105;3907;2211;7610;3316;11517
293080;201501;4584;14541;4222;13975;247;1147;3449;11194;3696;12341
293090;201501;3325;10698;2818;9963;252;926;2143;7713;2395;8639
293100;201501;5619;16826;4740;15325;435;1508;3539;11579;3974;13087
293105;201501;3896;13003;3456;12187;462;1710;2382;8541;2844;10251
293110;201501;1955;5743;1762;5453;74;289;1499;4618;1573;4907
293120;201501;3821;12783;3612;12467;313;1030;2898;10237;3211;11267
293130;201501;3968;11273;3346;10583;161;566;2984;9578;3145;10144
293135;201501;30334;76586;22966;66546;4554;15256;10535;30140;15089;45396
293140;201501;2024;5898;1944;5782;155;559;1562;4533;1717;5092
293150;201501;5463;18241;4847;17047;905;3278;2945;10656;3850;13934
293160;201501;3724;9935;3477;9657;471;945;2695;7980;3166;8925
293170;201501;3292;9945;3029;9556;375;1327;2198;6950;2573;8277
293180;201501;5112;14445;4173;12981;222;878;3361;10307;3583;11185
293190;201501;13738;41965;12968;40832;477;2246;11402;35263;11879;37509
293200;201501;6682;19154;5852;18037;276;997;4976;15400;5252;16397
293210;201501;4900;14381;4445;13639;351;1252;3425;10479;3776;11731
293220;201501;5107;15208;4494;14185;1139;3738;2129;6817;3268;10555
293230;201501;3822;11916;3531;11477;540;1904;2505;8194;3045;10098
293240;201501;4462;12091;3605;10699;165;529;2783;8243;2948;8772
293245;201501;4294;12367;3924;11814;408;1228;2989;9169;3397;10397
293250;201501;5798;16291;5295;15558;605;1887;3807;11181;4412;13068
293260;201501;4548;13773;3907;12859;322;1160;2985;9910;3307;11070
293270;201501;5609;15173;5283;14831;408;948;4667;13438;5075;14386
293280;201501;5314;15047;4587;14108;306;914;3719;11665;4025;12579
293290;201501;15437;51785;14563;50133;3435;12367;7693;26979;11128;39346
293300;201501;6750;16309;5711;15123;374;925;4683;12610;5057;13535
293305;201501;4733;11788;4098;10938;182;559;3509;9320;3691;9879
293310;201501;2507;6514;2068;5784;180;538;1505;4173;1685;4711
293315;201501;4178;10947;3720;10265;492;1353;2667;7470;3159;8823
293317;201501;2437;7143;2185;6682;192;625;1515;4638;1707;5263
293320;201501;8053;26978;7870;26763;608;2243;6709;22975;7317;25218
293325;201501;1874;5418;1552;4925;208;735;1075;3437;1283;4172
293330;201501;51944;164636;46736;155947;9813;35609;24731;83236;34544;118845
293340;201501;2685;7624;2105;6619;278;971;1407;4342;1685;5313
293345;201501;3261;9857;2898;9354;279;862;2217;7425;2496;8287
293350;201501;6701;18869;6367;18486;365;904;5680;16890;6045;17794
293360;201501;13123;40387;11887;38817;542;1911;10534;34638;11076;36549
310010;201501;1120;3003;822;2542;166;643;362;1032;528;1675
310020;201501;3250;10208;2679;9042;716;2703;496;1471;1212;4174
310030;201501;2320;7381;1950;6737;481;1857;1024;3483;1505;5340
310040;201501;998;2699;842;2494;69;238;648;1916;717;2154
310050;201501;1906;6596;1713;6158;311;1316;859;3034;1170;4350
310060;201501;3193;10387;2831;9919;322;1202;2173;7695;2495;8897
310070;201501;329;937;258;807;29;122;147;418;176;540
310080;201501;706;2143;571;1908;127;525;200;596;327;1121
310090;201501;4630;13889;4029;12837;585;2080;2521;8036;3106;10116
310100;201501;3309;10070;2778;9176;225;920;2135;7006;2360;7926
310110;201501;4898;13919;4200;12852;726;2636;2566;7701;3292;10337
310120;201501;471;1498;416;1415;143;620;183;493;326;1113
310130;201501;426;1308;387;1249;81;316;222;669;303;985
310140;201501;200;655;166;594;63;266;40;114;103;380
310150;201501;4647;14296;4119;13327;865;3172;1960;6281;2825;9453
310160;201501;7202;22481;5949;20307;1691;6426;2020;6871;3711;13297
310163;201501;895;2957;762;2687;208;807;276;947;484;1754
310170;201501;8993;25657;8177;24503;1289;3982;5443;16771;6732;20753
310180;201501;1617;4769;1373;4398;325;1181;651;2012;976;3193
310190;201501;2665;8935;2431;8561;765;2984;442;1604;1207;4588
310200;201501;1827;6029;1529;5439;392;1565;549;1917;941;3482
310205;201501;1069;3160;866;2837;160;538;501;1677;661;2215
310210;201501;2600;7905;2386;7600;277;1010;1812;5763;2089;6773
310220;201501;1040;3256;984;3168;202;712;564;1774;766;2486
310230;201501;2592;8264;2187;7389;526;2098;960;2985;1486;5083
310240;201501;1040;3644;894;3383;147;636;461;1820;608;2456
310250;201501;849;2877;825;2838;158;657;513;1668;671;2325
310260;201501;3313;10602;2764;9489;713;2754;980;3229;1693;5983
310270;201501;2467;7225;2158;6775;163;565;1738;5501;1901;6066
310280;201501;2191;6066;1907;5646;379;1411;1032;2881;1411;4292
310285;201501;2076;7427;1943;7227;236;965;1513;5700;1749;6665
310290;201501;1252;3832;1167;3707;306;1109;576;1663;882;2772
310300;201501;1760;5985;1671;5816;433;1713;928;3139;1361;4852
310310;201501;372;1024;267;810;42;129;132;402;174;531
310320;201501;382;1248;323;1131;53;244;155;527;208;771
310330;201501;502;1258;364;1023;29;107;191;486;220;593
310340;201501;8271;25321;7000;23223;1327;4645;3902;13309;5229;17954
310350;201501;13815;38031;10265;31943;2872;9958;2979;9070;5851;19028
310360;201501;424;1299;409;1277;42;166;303;903;345;1069
310370;201501;1433;4952;1363;4844;381;1424;763;2722;1144;4146
310375;201501;1341;3592;893;2806;140;508;362;1098;502;1606
310380;201501;365;1001;277;876;104;364;111;327;215;691
310390;201501;508;1822;444;1686;115;474;78;262;193;736
310400;201501;9506;27814;7458;24205;1940;6968;2273;7404;4213;14372
310410;201501;823;2707;548;2222;153;680;106;417;259;1097
310420;201501;5905;16923;3686;12054;742;2706;603;1743;1345;4449
310430;201501;1457;4899;1167;4309;335;1385;249;875;584;2260
310440;201501;534;1551;440;1403;98;365;190;569;288;934
310445;201501;1257;4067;1048;3687;160;616;628;2186;788;2802
310450;201501;4658;13263;3786;12040;606;2072;2481;8064;3087;10136
310460;201501;1585;4985;1353;4607;415;1559;286;1020;701;2579
310470;201501;3346;8763;2856;8150;221;680;2401;6858;2622;7538
310480;201501;1184;3561;942;3076;211;823;396;1178;607;2001
310490;201501;2874;9555;2527;8911;724;2898;1010;3506;1734;6404
310500;201501;1293;4462;1185;4238;306;1245;509;1761;815;3006
310510;201501;2212;7023;1793;6096;511;1907;368;1175;879;3082
310520;201501;1407;3758;1120;3292;80;245;745;2207;825;2452
310530;201501;875;2711;523;1792;82;318;99;302;181;620
310540;201501;3075;10172;2834;9789;807;2962;1260;4382;2067;7344
310550;201501;1207;3540;989;3167;251;974;436;1267;687;2241
310560;201501;15373;47417;13137;43149;3741;13832;4318;13315;8059;27147
310570;201501;1173;3570;1083;3443;125;438;827;2616;952;3054
310590;201501;4208;12317;3351;10716;591;2145;1323;4023;1914;6168
310600;201501;1383;4674;1272;4435;385;1551;446;1415;831;2966
310610;201501;486;1657;448;1587;108;492;153;476;261;968
310620;201501;170052;525392;140987;468985;34912;131469;53933;170102;88845;301571
310630;201501;3819;11961;3608;11603;467;1774;2607;8229;3074;10003
310640;201501;1317;3941;1044;3471;348;1265;248;748;596;2013
310650;201501;2668;8716;2204;7923;383;1529;1287;4667;1670;6196
310660;201501;1375;4172;1200;3928;158;554;886;2888;1044;3442
310665;201501;1207;3793;1091;3623;171;607;765;2579;936;3186
310670;201501;46406;144092;41918;134610;10862;37755;16557;51454;27419;89209
310680;201501;705;2072;637;1971;141;460;351;1075;492;1535
310690;201501;1356;4460;1103;4001;323;1350;314;1057;637;2407
310700;201501;559;1487;455;1350;126;424;228;644;354;1068
310710;201501;6613;21665;5211;19370;1237;5324;1346;4863;2583;10187
310720;201501;757;2293;683;2159;175;653;323;945;498;1598
310730;201501;9190;28883;8249;27384;1600;5861;5111;16922;6711;22783
310740;201501;4688;15258;3865;13655;1155;4589;956;3219;2111;7808
310750;201501;1526;3833;1194;3414;143;420;880;2532;1023;2952
310760;201501;590;1808;499;1665;108;405;218;708;326;1113
310770;201501;764;2443;601;2195;170;712;293;1025;463;1737
310780;201501;3697;10379;3202;9525;529;1607;1993;5933;2522;7540
310790;201501;1896;6042;1698;5691;437;1539;794;2756;1231;4295
310800;201501;2709;8598;2094;7435;744;2999;269;894;1013;3893
310810;201501;1248;3515;1138;3341;215;690;627;1776;842;2466
310820;201501;1343;3897;1022;3312;252;931;319;973;571;1904
310825;201501;2444;8310;1943;7415;155;813;1438;5414;1593;6227
310830;201501;1364;4470;1076;3909;338;1308;296;1016;634;2324
310840;201501;2159;6806;1802;6203;633;2448;514;1655;1147;4103
310850;201501;1522;4585;1279;4265;189;714;919;3053;1108;3767
310855;201501;2866;9208;2492;8630;473;1779;1582;5550;2055;7329
310860;201501;7655;23630;6586;21814;1019;3630;3852;13016;4871;16646
310870;201501;979;2766;799;2476;157;531;421;1287;578;1818
310880;201501;1217;3751;932;3233;179;732;446;1520;625;2252
310890;201501;2635;8247;2092;7305;563;2252;615;2016;1178;4268
310900;201501;3831;12438;3191;11158;834;3325;1184;3875;2018;7200
310910;201501;2064;5900;1408;4676;359;1338;300;940;659;2278
310920;201501;1892;5713;1517;5179;360;1386;711;2441;1071;3827
310925;201501;879;2900;793;2751;312;1194;286;972;598;2166
310930;201501;5830;16821;4687;15105;829;2922;2747;9055;3576;11977
310940;201501;6306;18238;5319;16734;1012;3481;2935;9193;3947;12674
310945;201501;1315;3683;1082;3364;189;699;674;2008;863;2707
310950;201501;1942;6251;1480;5243;422;1718;409;1304;831;3022
310960;201501;400;1314;333;1191;104;404;115;415;219;819
310970;201501;1444;4897;1052;3956;311;1315;130;401;441;1716
310980;201501;461;1177;308;900;43;157;137;348;180;505
310990;201501;1153;3883;994;3563;242;991;319;1055;561;2046
311000;201501;3651;12501;3250;11673;924;3828;1139;3808;2063;7636
311010;201501;756;2508;710;2434;218;806;344;1143;562;1949
311020;201501;933;2834;754;2517;180;674;302;942;482;1616
311030;201501;1655;4694;1208;3839;304;1102;421;1202;725;2304
311040;201501;491;1656;432;1504;99;364;98;325;197;689
311050;201501;2212;7070;1918;6569;533;2021;830;2845;1363;4866
311060;201501;2071;6288;1596;5272;350;1303;391;1199;741;2502
311070;201501;1440;5075;1272;4764;348;1511;484;1784;832;3295
311080;201501;870;2616;792;2494;110;379;539;1674;649;2053
311090;201501;1631;6064;1393;5602;476;2180;259;990;735;3170
311100;201501;2137;7332;1818;6667;746;2954;389;1401;1135;4355
311110;201501;3906;9239;2699;7535;439;1340;1443;3983;1882;5323
311115;201501;1178;3523;1011;3269;112;468;673;2153;785;2621
311120;201501;7828;22175;6111;19147;1584;5545;1625;4696;3209;10241
311130;201501;2059;6548;1736;6102;460;1947;777;2575;1237;4522
311140;201501;1350;3704;1115;3405;128;463;797;2387;925;2850
311150;201501;1926;6558;1786;6334;345;1334;1054;3753;1399;5087
311160;201501;4804;16232;4078;14960;1491;5932;1199;4337;2690;10269
311170;201501;765;2349;609;2063;76;260;324;1157;400;1417
311180;201501;1448;4071;1101;3406;319;1067;265;754;584;1821
311190;201501;1013;3049;860;2748;197;745;322;923;519;1668
311200;201501;2130;6543;1779;5827;560;2038;398;1159;958;3197
311205;201501;1059;3494;934;3255;205;823;403;1402;608;2225
311210;201501;913;2991;851;2899;152;517;598;2103;750;2620
311220;201501;882;2804;719;2458;181;669;248;831;429;1500
311230;201501;8220;25493;6844;22995;1336;4917;3235;11165;4571;16082
311240;201501;1168;3556;954;3216;260;990;333;1090;593;2080
311250;201501;993;3249;890;3102;257;1040;296;877;553;1917
311260;201501;2700;7283;2018;6131;546;1838;663;1947;1209;3785
311265;201501;1289;3529;1030;3154;165;606;632;1907;797;2513
311270;201501;3339;10796;2955;10280;449;1942;2032;6847;2481;8789
311280;201501;1303;3591;913;2843;195;697;279;821;474;1518
311290;201501;2091;7004;1962;6737;383;1329;1183;4136;1566;5465
311300;201501;4555;15258;4112;14519;560;2256;2847;10113;3407;12369
311310;201501;516;1814;481;1748;101;438;207;702;308;1140
311320;201501;4073;13621;3616;12646;837;3384;1299;4319;2136;7703
311330;201501;4909;14795;4230;13710;1330;4786;1665;5338;2995;10124
311340;201501;12158;38688;10833;36229;3274;11920;3376;11165;6650;23085
311350;201501;2221;6550;1817;5808;364;1386;838;2503;1202;3889
311360;201501;1199;3334;924;2992;405;1389;220;714;625;2103
311370;201501;3808;11578;3292;10723;766;3077;1456;4272;2222;7349
311380;201501;439;1422;371;1301;110;452;125;408;235;860
311390;201501;1794;6660;1673;6468;722;3187;551;1993;1273;5180
311400;201501;1424;4594;1243;4267;282;1136;579;1823;861;2959
311410;201501;1784;6272;1628;6067;457;1846;894;3388;1351;5234
311420;201501;1991;6494;1493;5327;400;1557;311;892;711;2449
311430;201501;3936;11940;2763;9371;610;2286;528;1742;1138;4028
311440;201501;2215;7295;1697;6321;620;2689;342;1218;962;3907
311450;201501;1936;6795;1677;6211;484;1975;382;1303;866;3278
311455;201501;1291;3460;1075;3133;238;773;588;1624;826;2397
311460;201501;680;2214;529;1908;124;554;130;438;254;992
311470;201501;539;1723;435;1505;112;483;138;426;250;909
311480;201501;747;2012;702;1952;202;548;371;1018;573;1566
311490;201501;250;972;236;937;84;352;84;319;168;671
311500;201501;459;1351;368;1181;99;351;161;513;260;864
311510;201501;3088;9580;2515;8499;923;3655;602;1827;1525;5482
311520;201501;634;2134;591;2044;223;834;214;709;437;1543
311530;201501;11800;30682;8245;24760;2022;7329;2423;6988;4445;14317
311535;201501;762;2288;550;1867;126;509;91;285;217;794
311540;201501;635;2248;606;2206;200;770;323;1154;523;1924
311545;201501;2056;6485;1901;6289;219;871;1415;4639;1634;5510
311547;201501;1532;4311;1293;3941;112;368;864;2655;976;3023
311550;201501;2973;9581;2538;8710;612;2418;840;2780;1452;5198
311560;201501;254;647;212;595;35;112;127;339;162;451
311570;201501;2167;5432;1724;4883;110;322;1385;4010;1495;4332
311580;201501;2322;4909;1827;4333;543;1211;992;2482;1535;3693
311590;201501;424;1344;369;1270;112;461;115;387;227;848
311600;201501;1175;3570;1020;3368;207;684;642;2190;849;2874
311610;201501;3110;11000;2837;10539;935;3456;1275;5010;2210;8466
311615;201501;2806;9099;2401;8424;265;1122;1716;5994;1981;7116
311620;201501;431;1365;388;1302;92;342;219;728;311;1070
311630;201501;1402;4155;1192;3793;260;814;664;2155;924;2969
311640;201501;845;2657;705;2428;133;514;420;1409;553;1923
311650;201501;2255;6674;1908;6101;253;874;1149;3766;1402;4640
311660;201501;2393;8026;1979;7117;443;1788;297;885;740;2673
311670;201501;1493;4535;1263;4136;432;1560;495;1609;927;3169
311680;201501;2081;6697;1800;6269;394;1463;1045;3702;1439;5165
311690;201501;536;1386;431;1262;52;169;326;952;378;1121
311700;201501;2197;6090;1874;5644;135;560;1506;4407;1641;4967
311710;201501;1649;5023;1258;4332;471;1814;348;1145;819;2959
311720;201501;394;1324;356;1245;60;241;195;664;255;905
311730;201501;5422;13857;3236;10001;887;3168;1063;2839;1950;6007
311740;201501;922;2629;790;2470;318;968;391;1285;709;2253
311750;201501;3806;12755;3420;12170;603;2437;2018;7140;2621;9577
311760;201501;793;2693;743;2591;192;792;330;1036;522;1828
311770;201501;2423;7662;1991;6878;505;1986;605;1982;1110;3968
311780;201501;1084;3952;915;3545;302;1337;210;754;512;2091
311783;201501;1945;6381;1652;5811;101;476;1232;4315;1333;4791
311787;201501;567;1970;417;1523;70;272;103;325;173;597
311790;201501;1419;4246;1049;3523;267;998;290;929;557;1927
311800;201501;4129;13962;3228;11483;664;2533;220;630;884;3163
311810;201501;1044;3523;992;3435;41;202;837;2873;878;3075
311820;201501;641;2056;528;1778;138;543;265;827;403;1370
311830;201501;7635;26185;6488;23392;2310;8970;922;3064;3232;12034
311840;201501;3168;9454;2763;8880;813;2985;1248;3854;2061;6839
311850;201501;303;902;260;833;70;245;119;375;189;620
311860;201501;49473;149846;42776;137742;10408;37179;19361;60193;29769;97372
311870;201501;2219;6560;1731;5641;379;1469;580;1687;959;3156
311880;201501;6815;20053;6115;19233;914;2810;4287;14035;5201;16845
311890;201501;1434;4413;1178;3891;295;1106;462;1445;757;2551
311900;201501;768;2413;693;2316;119;397;452;1601;571;1998
311910;201501;4415;13132;3703;12129;966;3478;1609;5264;2575;8742
311920;201501;1910;6331;1684;5954;179;718;1153;4083;1332;4801
311930;201501;3776;11005;3238;10169;1165;3889;1048;3244;2213;7133
311940;201501;12112;36939;10118;32919;2996;10699;2270;6952;5266;17651
311950;201501;2279;6716;1918;6243;166;596;1417;4590;1583;5186
311960;201501;354;1095;316;1018;69;281;159;442;228;723
311970;201501;362;1273;310;1167;76;342;68;240;144;582
311980;201501;658;1828;459;1483;76;274;196;632;272;906
311990;201501;446;1316;370;1193;138;488;124;365;262;853
311995;201501;1133;3426;715;2426;113;437;149;419;262;856
312000;201501;640;1978;590;1902;91;332;368;1176;459;1508
312010;201501;955;3119;835;2858;159;626;385;1281;544;1907
312015;201501;1493;4695;1293;4355;172;713;821;2737;993;3450
312020;201501;818;2553;706;2384;141;560;395;1337;536;1897
312030;201501;1758;5261;1599;5066;137;520;1320;4147;1457;4667
312040;201501;709;2680;617;2422;172;761;131;478;303;1239
312050;201501;1463;5067;1294;4744;385;1572;287;1010;672;2582
312060;201501;746;2270;658;2149;302;1054;194;565;496;1619
312070;201501;1016;3136;671;2381;165;637;238;834;403;1471
312080;201501;2591;7301;2045;6443;395;1500;1012;2949;1407;4449
312083;201501;953;2729;817;2533;136;487;508;1545;644;2032
312087;201501;2185;6748;1934;6393;273;965;1383;4634;1656;5599
312090;201501;8860;28035;7912;26448;2302;8479;3399;11099;5701;19578
312100;201501;1354;4584;1174;4303;254;1040;617;2286;871;3326
312110;201501;1121;3945;992;3678;347;1465;183;587;530;2052
312120;201501;723;2453;642;2292;158;667;202;624;360;1291
312125;201501;1145;3629;1016;3391;239;842;514;1762;753;2604
312130;201501;758;2252;610;1961;101;378;249;766;350;1144
312140;201501;983;3107;801;2668;157;592;280;811;437;1403
312150;201501;572;1634;485;1449;39;136;325;943;364;1079
312160;201501;7463;25549;6753;24111;1937;7608;2486;8764;4423;16372
312170;201501;964;2851;864;2663;108;345;525;1635;633;1980
312180;201501;1387;4249;1236;3981;306;1049;518;1610;824;2659
312190;201501;605;1935;464;1659;178;715;87;290;265;1005
312200;201501;4829;14153;4196;13193;448;1517;3041;9582;3489;11099
312210;201501;1043;2863;821;2527;214;739;371;1083;585;1822
312220;201501;1796;6005;1623;5804;156;592;1341;4918;1497;5510
312230;201501;13010;40720;10283;35462;3856;14686;1895;6369;5751;21055
312235;201501;1740;5038;1461;4625;155;620;988;3101;1143;3721
312240;201501;921;3079;767;2768;186;739;258;905;444;1644
312245;201501;2253;6691;1961;6304;119;374;1620;5261;1739;5635
312247;201501;818;2498;657;2223;167;632;328;1124;495;1756
312250;201501;1170;3328;948;2952;187;684;436;1303;623;1987
312260;201501;914;2922;774;2720;127;525;500;1729;627;2254
312270;201501;658;2011;548;1814;101;438;243;698;344;1136
312280;201501;377;1302;341;1223;138;538;49;158;187;696
312290;201501;723;2413;672;2341;235;953;199;666;434;1619
312300;201501;927;3104;754;2696;178;718;103;290;281;1008
312310;201501;920;3469;851;3310;237;1006;337;1268;574;2274
312320;201501;2177;6212;1719;5306;431;1470;404;1008;835;2478
312330;201501;994;2972;840;2746;154;592;574;1837;728;2429
312340;201501;310;805;274;758;39;147;212;549;251;696
312350;201501;335;855;308;823;30;93;259;674;289;767
312352;201501;1667;5391;1531;5201;423;1457;912;3218;1335;4675
312360;201501;2998;9857;2541;8951;669;2635;746;2580;1415;5215
312370;201501;1688;5474;1560;5274;571;2161;528;1667;1099;3828
312380;201501;1839;5344;1653;5070;146;472;1315;4118;1461;4590
312385;201501;1270;3838;1111;3576;129;555;782;2412;911;2967
312390;201501;2068;6843;1718;6083;523;1963;315;1026;838;2989
312400;201501;3266;10598;2805;9713;997;3605;935;3368;1932;6973
312410;201501;10118;33472;9089;31538;2381;9139;3586;12171;5967;21310
312420;201501;3924;12200;3721;11961;538;1752;2746;9040;3284;10792
312430;201501;7198;22238;6619;21337;1078;3526;4539;14859;5617;18385
312440;201501;674;2139;597;2009;130;481;314;1096;444;1577
312450;201501;1034;3552;885;3276;362;1408;314;1149;676;2557
312460;201501;374;1139;334;1093;97;350;161;519;258;869
312470;201501;686;1901;452;1446;101;368;129;393;230;761
312480;201501;1234;3474;982;3188;275;1004;504;1556;779;2560
312490;201501;2043;5455;1634;4878;242;854;977;2808;1219;3662
312500;201501;654;2093;592;2002;116;498;328;1070;444;1568
312510;201501;2669;8101;2155;7014;396;1505;1033;3137;1429;4642
312520;201501;289;996;236;893;66;265;82;318;148;583
312530;201501;582;1812;529;1732;88;370;332;1028;420;1398
312540;201501;1461;4615;1154;4003;261;987;580;1984;841;2971
312550;201501;658;2097;588;1946;57;214;391;1276;448;1490
312560;201501;2015;5441;1720;5065;140;476;1387;4075;1527;4551
312570;201501;2578;7668;2183;6998;614;2115;690;2133;1304;4248
312580;201501;514;1754;443;1605;99;440;169;574;268;1014
312590;201501;1796;5988;1568;5520;406;1674;578;1838;984;3512
312595;201501;2061;6943;1841;6438;491;1850;867;2981;1358;4831
312600;201501;672;2359;600;2208;115;534;313;1055;428;1589
312610;201501;7057;20355;5457;17520;1397;5066;1420;4258;2817;9324
312620;201501;1987;5893;1572;5325;120;444;1256;4375;1376;4819
312630;201501;355;1148;318;1080;72;283;177;589;249;872
312640;201501;553;1788;450;1581;101;426;176;557;277;983
312650;201501;2137;6396;1582;5308;170;651;918;3060;1088;3711
312660;201501;1361;3679;1122;3338;126;439;768;2251;894;2690
312670;201501;5817;17757;5096;16759;1201;4508;2578;8305;3779;12813
312675;201501;1349;4314;1145;3903;170;669;680;2278;850;2947
312680;201501;1453;4607;1309;4385;170;649;914;3026;1084;3675
312690;201501;2190;5897;1772;5329;326;1153;1025;2938;1351;4091
312695;201501;815;3002;785;2962;137;525;560;2158;697;2683
312700;201501;1935;5742;1525;4936;235;864;755;2388;990;3252
312705;201501;1346;3869;1150;3564;135;453;808;2502;943;2955
312707;201501;1749;5436;1402;4791;219;903;774;2576;993;3479
312710;201501;6860;18260;4626;14428;1279;4571;1013;2871;2292;7442
312720;201501;751;2554;657;2352;164;655;230;760;394;1415
312730;201501;1946;4746;1410;4124;206;695;821;2407;1027;3102
312733;201501;1691;4547;1288;3802;100;391;878;2472;978;2863
312735;201501;849;2447;753;2320;211;731;404;1203;615;1934
312737;201501;900;2285;657;1944;212;628;279;848;491;1476
312738;201501;545;1672;407;1386;104;406;144;463;248;869
312740;201501;473;1334;317;1139;97;384;85;311;182;695
312750;201501;1228;4427;1177;4329;277;1197;590;2095;867;3292
312760;201501;2163;6951;1703;6081;440;1769;388;1380;828;3149
312770;201501;40512;113061;32462;99892;8780;29642;10000;30029;18780;59671
312780;201501;2732;9617;2450;9150;466;1905;1384;5315;1850;7220
312790;201501;339;873;198;624;53;203;47;111;100;314
312800;201501;5018;16697;4238;15155;1323;5113;1276;4596;2599;9709
312810;201501;2147;6612;1552;5530;480;1912;322;1063;802;2975
312820;201501;2037;5942;1847;5647;185;701;1250;3724;1435;4425
312825;201501;1344;3715;1197;3539;93;287;981;2926;1074;3213
312830;201501;2723;8601;1926;6978;499;1994;365;1301;864;3295
312840;201501;1163;3791;988;3473;158;697;505;1698;663;2395
312850;201501;642;2092;535;1882;106;454;199;676;305;1130
312860;201501;1101;3292;882;2909;235;924;262;759;497;1683
312870;201501;5143;16160;3899;13709;896;3615;1093;3724;1989;7339
312880;201501;1275;3843;1099;3549;171;632;630;2037;801;2669
312890;201501;1551;4691;1091;3713;356;1359;357;1158;713;2517
312900;201501;1228;3724;1099;3550;209;712;747;2462;956;3174
312910;201501;1397;3073;994;2528;189;581;530;1220;719;1801
312920;201501;828;2667;724;2526;194;768;386;1313;580;2081
312930;201501;2215;6470;1933;6071;439;1441;990;3199;1429;4640
312940;201501;887;2939;787;2774;231;967;232;765;463;1732
312950;201501;3294;9206;2589;8172;853;2907;874;2736;1727;5643
312960;201501;1955;5852;1754;5590;275;853;1276;4185;1551;5038
312965;201501;1754;5630;1485;5141;264;1006;862;3036;1126;4042
312970;201501;976;3326;815;3074;301;1319;151;505;452;1824
312980;201501;16665;56832;15689;54719;5087;19516;6220;20696;11307;40212
312990;201501;425;1295;325;1125;114;442;100;344;214;786
313000;201501;527;1752;427;1554;122;549;156;508;278;1057
313005;201501;2566;8339;2290;7882;414;1511;1391;4822;1805;6333
313010;201501;3702;11912;3181;11050;896;3459;1373;4649;2269;8108
313020;201501;917;3059;805;2827;225;908;244;732;469;1640
313030;201501;1431;3909;1079;3440;251;960;506;1522;757;2482
313040;201501;836;2874;721;2567;137;570;278;923;415;1493
313050;201501;1784;5745;1461;5287;450;1821;580;2014;1030;3835
313055;201501;1591;5209;1456;5022;134;499;1109;3879;1243;4378
313060;201501;825;2767;699;2449;268;988;99;338;367;1326
313065;201501;1917;6275;1665;5880;279;1120;1192;4187;1471;5307
313070;201501;1137;3319;925;2938;222;826;436;1278;658;2104
313080;201501;473;1475;388;1309;99;406;129;353;228;759
313090;201501;5319;15453;4636;14399;677;2241;3136;9869;3813;12110
313100;201501;1073;3375;988;3233;102;358;765;2515;867;2873
313110;201501;1708;4937;1315;4197;292;1074;503;1471;795;2545
313115;201501;2438;8395;2336;8199;602;2434;1177;3865;1779;6299
313120;201501;3563;9752;3071;9103;635;2036;2029;5942;2664;7978
313130;201501;23088;70430;19940;64004;5074;18002;7319;22175;12393;40177
313140;201501;689;1802;529;1562;35;131;362;1051;397;1182
313150;201501;1431;4570;1262;4278;522;1886;340;1145;862;3031
313160;201501;1046;3156;929;2950;156;587;575;1770;731;2357
313170;201501;7589;26816;6569;24359;2007;8005;1366;4946;3373;12951
313180;201501;2437;6657;1936;5952;545;1860;705;2086;1250;3946
313190;201501;2908;10401;2498;9276;576;2383;821;2866;1397;5249
313200;201501;1291;4228;1149;3986;161;654;805;2759;966;3413
313210;201501;4436;13741;3712;12760;830;3383;1974;6489;2804;9872
313220;201501;1303;3945;963;3214;263;996;250;724;513;1720
313230;201501;2293;8309;2128;8065;315;1275;1483;5665;1798;6940
313240;201501;7575;24031;6218;21673;1523;6074;2480;8397;4003;14471
313250;201501;7146;22610;6383;21371;1039;3643;3870;13185;4909;16828
313260;201501;589;1785;471;1557;86;330;124;374;210;704
313270;201501;5393;15934;4695;14871;709;2429;3107;9877;3816;12306
313280;201501;437;1443;332;1203;56;246;88;273;144;519
313290;201501;928;3290;767;3001;233;1023;198;705;431;1728
313300;201501;1873;6327;1570;5592;464;1816;266;832;730;2648
313310;201501;1105;3846;981;3587;259;1067;187;610;446;1677
313320;201501;2402;7105;1898;6285;367;1352;842;2796;1209;4148
313330;201501;3776;12145;3204;11117;614;2468;1730;5916;2344;8384
313340;201501;1974;4839;1577;4272;312;853;889;2405;1201;3258
313350;201501;3233;9991;2534;8530;581;2187;511;1552;1092;3739
313360;201501;1195;3533;909;3041;261;1038;424;1307;685;2345
313370;201501;1203;4078;1124;3870;167;715;604;1933;771;2648
313375;201501;2145;5605;1436;4553;310;1220;516;1583;826;2803
313380;201501;4838;15455;4025;13786;1078;4153;1341;4315;2419;8468
313390;201501;894;3196;856;3146;100;433;609;2223;709;2656
313400;201501;3555;10151;3242;9791;286;862;2695;8292;2981;9154
313410;201501;1263;3609;1063;3334;216;761;641;1989;857;2750
313420;201501;20124;48124;12504;35233;2556;8118;2704;7348;5260;15466
313430;201501;1058;3389;875;2992;194;796;366;1156;560;1952
313440;201501;6089;13963;4174;11728;375;1161;2895;8145;3270;9306
313450;201501;677;2005;542;1733;122;487;188;540;310;1027
313460;201501;2272;7962;2027;7563;607;2541;605;2149;1212;4690
313470;201501;3222;9210;3020;8988;271;708;2589;7879;2860;8587
313480;201501;1095;3170;842;2740;145;541;374;1150;519;1691
313490;201501;1480;4581;948;3666;353;1470;146;552;499;2022
313500;201501;386;1222;359;1166;72;279;183;558;255;837
313505;201501;8800;26395;8189;25693;351;674;7564;24431;7915;25105
313507;201501;1369;3873;1204;3647;190;668;783;2390;973;3058
313510;201501;15302;44268;13417;41704;2183;6967;8556;27352;10739;34319
313520;201501;14902;45496;12433;41344;1710;6627;7941;26164;9651;32791
313530;201501;558;1841;481;1703;74;312;197;646;271;958
313535;201501;2486;7439;2193;6947;212;739;1592;5010;1804;5749
313540;201501;1057;3345;830;2768;237;851;198;602;435;1453
313545;201501;1279;4765;1181;4561;174;871;757;2760;931;3631
313550;201501;1840;5992;1643;5601;415;1512;835;2770;1250;4282
313560;201501;2180;5356;1859;4997;239;582;1425;3978;1664;4560
313570;201501;809;2922;713;2744;255;1052;254;935;509;1987
313580;201501;5896;16770;4908;15435;783;2702;3287;10421;4070;13123
313590;201501;1013;2954;808;2715;377;1378;279;898;656;2276
313600;201501;3967;12023;3453;11227;579;2078;2130;7001;2709;9079
313610;201501;1024;3188;883;2907;191;696;421;1358;612;2054
313620;201501;5779;18447;5132;17268;1558;5645;1828;6053;3386;11698
313630;201501;7957;23118;6273;20583;1381;5134;2738;9312;4119;14446
313640;201501;826;2487;652;2220;205;775;212;699;417;1474
313650;201501;2097;6945;1855;6561;184;762;1443;5093;1627;5855
313652;201501;998;3593;917;3436;157;635;559;2094;716;2729
313655;201501;923;3039;770;2779;136;598;457;1592;593;2190
313657;201501;1276;3963;1104;3707;134;614;796;2455;930;3069
313660;201501;852;2849;775;2713;173;723;381;1253;554;1976
313665;201501;3237;10726;3012;10249;681;2643;1447;4749;2128;7392
313670;201501;49888;141083;34439;114887;9381;34907;10339;33531;19720;68438
313680;201501;1086;3291;947;3072;127;434;665;2168;792;2602
313690;201501;883;3166;786;2954;220;866;295;1125;515;1991
313695;201501;1350;4479;1187;4195;130;519;820;2932;950;3451
313700;201501;3805;12695;3218;11920;553;2125;2171;8249;2724;10374
313710;201501;1224;3357;981;3001;237;790;480;1431;717;2221
313720;201501;5091;16719;4279;15050;984;3905;1397;4499;2381;8404
313730;201501;1314;3509;999;3129;187;678;572;1765;759;2443
313740;201501;2106;7530;1773;6724;593;2565;221;759;814;3324
313750;201501;2359;7201;2000;6531;577;2066;649;1948;1226;4014
313753;201501;1774;5314;1449;4771;405;1487;571;1856;976;3343
313760;201501;4472;14524;3725;13037;1104;4252;1065;3499;2169;7751
313770;201501;3421;11427;3150;10921;1064;3983;1089;3604;2153;7587
313780;201501;3467;9723;2774;8702;527;2007;1360;4121;1887;6128
313790;201501;505;1741;487;1716;105;371;281;1028;386;1399
313800;201501;1173;3295;1026;3067;132;450;681;2032;813;2482
313810;201501;1445;4302;1392;4230;78;243;1216;3736;1294;3979
313820;201501;12145;33205;10061;29935;1849;6418;5083;14877;6932;21295
313830;201501;419;1411;358;1283;98;398;111;396;209;794
313835;201501;907;3070;862;3004;181;692;515;1749;696;2441
313840;201501;7719;22218;6079;19473;1580;5729;1928;5959;3508;11688
313850;201501;1220;3357;1092;3148;246;842;573;1549;819;2391
313860;201501;2764;8467;2222;7331;590;2203;504;1541;1094;3744
313862;201501;1146;2867;758;2224;142;410;287;864;429;1274
313865;201501;2235;6980;2033;6665;264;985;1461;4771;1725;5756
313867;201501;1096;3751;948;3457;328;1290;320;1195;648;2485
313868;201501;1577;5550;1401;5185;151;683;957;3519;1108;4202
313870;201501;839;2691;769;2589;242;960;257;756;499;1716
313880;201501;1654;5120;1476;4907;270;1131;936;2930;1206;4061
313890;201501;1818;5041;1546;4686;240;704;1032;3232;1272;3936
313900;201501;4033;14954;3759;14330;1246;5375;1158;4245;2404;9620
313910;201501;764;2602;660;2395;247;982;104;345;351;1327
313920;201501;3455;11320;3017;10568;472;1757;1862;6704;2334;8461
313925;201501;1904;5121;1394;4167;99;334;905;2703;1004;3037
313930;201501;5119;17081;4335;15671;767;3019;2435;9001;3202;12020
313940;201501;8079;27429;6871;25548;2297;9343;2492;9588;4789;18931
313950;201501;4113;12044;3351;10820;994;3723;1316;3952;2310;7675
313960;201501;5675;14845;4275;12955;1342;4546;1220;3475;2562;8021
313970;201501;1422;4071;1208;3826;160;562;828;2727;988;3289
313980;201501;1197;3818;967;3414;289;1183;360;1253;649;2436
313990;201501;1868;7012;1637;6482;540;2354;393;1421;933;3775
314000;201501;7431;24563;6850;23493;1496;6123;4066;13425;5562;19548
314010;201501;1092;3140;907;2909;134;523;569;1768;703;2291
314015;201501;1224;4466;1097;4209;347;1425;363;1375;710;2800
314020;201501;521;1614;408;1379;107;416;100;309;207;725
314030;201501;865;2801;692;2409;120;468;262;905;382;1373
314040;201501;673;1929;576;1764;197;642;268;814;465;1456
314050;201501;1780;5602;1424;4876;352;1380;460;1432;812;2812
314053;201501;1468;4804;1343;4655;191;642;953;3462;1144;4104
314055;201501;2091;6413;1899;6133;111;435;1491;4887;1602;5322
314060;201501;1125;3536;921;3211;91;388;604;2094;695;2482
314070;201501;3846;11985;2977;10327;822;3087;716;2368;1538;5455
314080;201501;1955;6017;1336;4609;282;1105;321;986;603;2091
314085;201501;1937;6633;1698;6299;505;2076;644;2362;1149;4438
314090;201501;3357;11488;2989;10783;909;3608;1111;4077;2020;7685
314100;201501;3318;8885;2856;8250;263;709;2317;6865;2580;7574
314110;201501;4188;13407;3694;12425;826;3269;1457;4488;2283;7757
314120;201501;966;2416;535;1707;145;526;144;437;289;963
314130;201501;698;2039;386;1325;66;247;72;249;138;496
314140;201501;4926;15463;4235;14152;897;3265;1942;6474;2839;9739
314150;201501;1616;4420;1335;3960;238;807;672;1955;910;2762
314160;201501;2482;6558;1941;5847;106;331;1568;4918;1674;5249
314170;201501;1076;3270;887;2854;130;501;482;1493;612;1994
314180;201501;5827;18416;5063;17290;1278;4810;2361;8207;3639;13017
314190;201501;725;2121;589;1913;140;558;255;770;395;1328
314200;201501;2952;9412;2607;8793;333;1342;1762;5832;2095;7174
314210;201501;1912;5792;1715;5429;240;900;1074;3252;1314;4152
314220;201501;1696;5391;1364;4753;431;1705;317;961;748;2666
314225;201501;1281;3818;1142;3630;76;230;988;3208;1064;3438
314230;201501;637;2161;584;2068;165;648;233;799;398;1447
314240;201501;1118;3496;965;3271;152;491;662;2357;814;2848
314250;201501;545;1648;419;1384;93;352;145;432;238;784
314260;201501;1076;3862;998;3701;293;1191;381;1372;674;2563
314270;201501;2810;9413;2494;8854;273;1105;1739;6242;2012;7347
314280;201501;3112;8762;2179;6989;559;2090;662;1829;1221;3919
314290;201501;4922;13808;4266;12777;1057;3473;2476;7265;3533;10738
314300;201501;1622;5469;1440;5064;418;1583;533;1791;951;3374
314310;201501;5382;16458;4614;14968;1502;5328;1391;4300;2893;9628
314315;201501;894;3474;827;3345;131;624;511;2083;642;2707
314320;201501;3067;8614;2299;7617;663;2446;1138;3812;1801;6258
314330;201501;51375;159565;46407;151638;13068;46956;19394;62541;32462;109497
314340;201501;2647;7361;1541;5143;403;1491;134;299;537;1790
314345;201501;1241;4222;1116;4033;308;1167;621;2261;929;3428
314350;201501;1387;4030;1114;3606;431;1528;316;998;747;2526
314360;201501;696;2190;465;1667;119;511;115;381;234;892
314370;201501;530;1855;487;1785;160;627;241;878;401;1505
314380;201501;1214;3642;879;3019;298;1107;216;761;514;1868
314390;201501;14594;42470;11219;36181;2957;10544;2997;8979;5954;19523
314400;201501;4724;13730;3945;12657;1347;4494;1759;5847;3106;10341
314410;201501;2557;8149;2172;7371;629;2481;755;2386;1384;4867
314420;201501;746;2183;602;1986;61;276;439;1411;500;1687
314430;201501;6809;20441;5996;18884;1786;6156;1845;5861;3631;12017
314435;201501;1329;4262;1182;4013;157;669;762;2533;919;3202
314437;201501;1115;2927;966;2712;42;118;815;2290;857;2408
314440;201501;653;1888;493;1654;181;676;88;263;269;939
314450;201501;1569;4581;1335;4260;387;1460;652;1935;1039;3395
314460;201501;4192;14463;3627;13239;1058;4282;726;2545;1784;6827
314465;201501;2322;7381;2145;7093;160;686;1652;5353;1812;6039
314467;201501;1108;3117;934;2809;107;322;632;1931;739;2253
314470;201501;2397;7741;1925;6703;487;1963;489;1476;976;3439
314480;201501;6140;20536;4320;15723;746;2976;467;1458;1213;4434
314490;201501;974;2882;782;2502;216;764;305;928;521;1692
314500;201501;2049;5760;1522;4853;422;1459;592;1801;1014;3260
314505;201501;1807;5539;1700;5370;330;1148;1055;3352;1385;4500
314510;201501;1911;5270;1308;4410;447;1700;321;1027;768;2727
314520;201501;3277;12020;2603;10379;664;3015;381;1269;1045;4284
314530;201501;6520;23324;6168;22755;1171;4398;3750;14276;4921;18674
314535;201501;2739;7712;2377;7220;238;834;1834;5543;2072;6377
314537;201501;1226;3840;969;3394;169;704;533;1830;702;2534
314540;201501;412;1283;357;1166;90;347;127;379;217;726
314545;201501;1339;4175;1163;3911;197;769;733;2443;930;3212
314550;201501;614;1719;464;1519;98;416;183;547;281;963
314560;201501;4887;17111;4269;15632;919;3764;1193;4183;2112;7947
314570;201501;289;885;236;769;71;250;104;328;175;578
314580;201501;506;1733;412;1519;111;475;80;277;191;752
314585;201501;836;2751;600;2245;148;625;170;627;318;1252
314587;201501;1834;5756;1627;5395;318;1042;854;2919;1172;3961
314590;201501;3381;11564;2389;8881;434;1792;293;952;727;2744
314600;201501;1915;6501;1561;5856;559;2348;321;1127;880;3475
314610;201501;7085;24721;6545;23527;1732;7086;2564;8648;4296;15734
314620;201501;1745;5087;1531;4817;181;516;1181;3834;1362;4350
314625;201501;1481;5081;1442;5033;146;525;1190;4186;1336;4711
314630;201501;4888;14577;4258;13594;410;1539;3153;10078;3563;11617
314640;201501;585;1636;463;1430;119;414;139;366;258;780
314650;201501;1173;3331;868;2809;169;653;342;1006;511;1659
314655;201501;1611;4838;1254;4176;259;912;631;2117;890;3029
314660;201501;247;682;192;579;19;65;103;298;122;363
314670;201501;1561;4293;1242;3738;197;678;722;2166;919;2844
314675;201501;1843;5665;1603;5256;176;678;1070;3492;1246;4170
314690;201501;2515;7974;2103;7277;564;2296;610;1945;1174;4241
314700;201501;8383;30000;6649;26193;2285;10045;1346;5248;3631;15293
314710;201501;8655;26832;6104;21340;1338;5270;949;3028;2287;8298
314720;201501;2314;7659;1962;6941;493;1989;810;2809;1303;4798
314730;201501;2328;6968;1876;6324;586;2206;609;1962;1195;4168
314740;201501;2861;9325;2547;8758;658;2563;1021;3329;1679;5892
314750;201501;320;1029;280;941;45;182;136;434;181;616
314760;201501;1718;5856;1292;4811;267;1194;297;922;564;2116
314770;201501;1197;3756;748;2541;88;371;124;313;212;684
314780;201501;293;786;213;681;62;238;93;289;155;527
314790;201501;12174;36229;9104;31034;3703;14479;1397;4238;5100;18717
314795;201501;1608;4765;1371;4385;146;598;1026;3160;1172;3758
314800;201501;12160;35794;9092;29740;2837;10122;1467;4590;4304;14712
314810;201501;12910;38000;10166;33289;3110;11377;2358;7699;5468;19076
314820;201501;1007;2758;681;2256;199;740;226;698;425;1438
314830;201501;1747;5809;1496;5389;504;2001;597;2160;1101;4161
314840;201501;965;3572;796;3308;197;959;430;1749;627;2708
314850;201501;1940;5755;1594;5124;244;983;984;3049;1228;4032
314860;201501;3224;10958;2937;10490;594;2365;1767;6335;2361;8700
314870;201501;5439;17658;4866;16921;637;2519;3562;12528;4199;15047
314875;201501;1781;6051;1721;5964;247;839;1386;4877;1633;5716
314880;201501;822;2330;720;2193;59;184;537;1676;596;1860
314890;201501;610;1850;435;1487;99;406;139;418;238;824
314900;201501;456;1410;367;1266;96;349;166;571;262;920
314910;201501;1551;5330;1314;4912;476;1999;367;1258;843;3257
314915;201501;2576;8094;2256;7627;208;841;1743;5838;1951;6679
314920;201501;576;1625;418;1391;72;287;212;654;284;941
314930;201501;4921;16710;4365;15547;1321;5175;1096;3822;2417;8997
314940;201501;404;1191;374;1139;89;301;203;578;292;879
314950;201501;332;1073;269;963;65;249;65;239;130;488
314960;201501;770;2442;605;2119;171;671;158;506;329;1177
314970;201501;556;1917;481;1784;131;558;133;478;264;1036
314980;201501;1734;5422;1502;5036;516;1933;194;582;710;2515
314990;201501;2685;8525;2113;7279;642;2547;404;1178;1046;3725
314995;201501;1610;4942;1443;4714;170;679;1023;3285;1193;3964
315000;201501;1051;3098;869;2798;149;568;515;1626;664;2194
315010;201501;457;1452;368;1268;103;426;128;386;231;812
315015;201501;1971;6083;1767;5836;246;832;1299;4455;1545;5287
315020;201501;785;2466;600;2055;110;420;268;890;378;1310
315030;201501;731;2212;602;1976;195;714;160;504;355;1218
315040;201501;881;2781;834;2681;149;515;533;1682;682;2197
315050;201501;1470;4264;1173;3780;300;1108;444;1381;744;2489
315053;201501;1053;3173;926;2962;201;799;409;1257;610;2056
315057;201501;1894;6447;1567;5946;263;1026;939;3702;1202;4728
315060;201501;894;2935;668;2441;167;679;154;564;321;1243
315070;201501;725;2163;640;2046;173;629;339;1035;512;1664
315080;201501;3043;10421;2713;9733;638;2523;1322;4688;1960;7211
315090;201501;771;2783;690;2617;172;714;250;977;422;1691
315100;201501;1165;3970;882;3309;211;926;203;679;414;1605
315110;201501;1400;4350;1243;4043;310;1126;555;1768;865;2894
315120;201501;13643;32530;9549;27275;1584;4762;5157;15470;6741;20232
315130;201501;1473;4863;1318;4566;381;1494;396;1307;777;2801
315140;201501;2738;9116;2330;8264;642;2682;766;2417;1408;5099
315150;201501;4899;13288;3704;11326;828;2924;1388;4096;2216;7020
315160;201501;1296;3703;1115;3394;221;726;590;1742;811;2468
315170;201501;1403;4116;1179;3807;210;715;658;2330;868;3045
315180;201501;15129;44417;10225;34061;2234;8533;2173;6785;4407;15318
315190;201501;2120;5726;1810;5266;498;1534;908;2654;1406;4188
315200;201501;4164;14008;3435;12399;1004;4023;902;3108;1906;7131
315210;201501;7926;23376;6399;20396;1626;5749;2192;6734;3818;12483
315213;201501;1097;3562;1043;3489;68;206;913;3121;981;3327
315217;201501;2613;8941;2186;8220;318;1406;1280;4837;1598;6243
315220;201501;10101;29333;8485;26916;2294;7195;4330;14358;6624;21553
315230;201501;2640;7050;2342;6694;161;292;2003;6063;2164;6355
315240;201501;3071;9713;2696;9130;493;1840;1704;5721;2197;7561
315250;201501;9559;29478;7089;24803;1941;7686;2177;7575;4118;15261
315260;201501;970;3083;735;2572;215;856;142;438;357;1294
315270;201501;664;2251;555;2031;134;550;145;500;279;1050
315280;201501;3082;9146;2232;7289;584;2085;476;1364;1060;3449
315290;201501;1353;3840;1035;3339;366;1307;184;580;550;1887
315300;201501;466;1267;346;1123;164;564;120;387;284;951
315310;201501;1256;4121;1094;3840;156;633;721;2477;877;3110
315320;201501;834;2663;684;2466;160;649;331;1238;491;1887
315330;201501;691;2501;434;1808;123;563;42;191;165;754
315340;201501;3907;11297;3253;10301;749;2634;1492;4723;2241;7357
315350;201501;1772;4982;1341;4363;243;819;789;2662;1032;3481
315360;201501;1662;5516;1359;4749;272;1032;449;1458;721;2490
315370;201501;474;1411;405;1307;70;265;272;867;342;1132
315380;201501;215;751;173;649;48;211;32;104;80;315
315390;201501;1378;4782;1133;4217;331;1389;227;779;558;2168
315400;201501;4304;13104;3625;11830;787;2887;1745;5560;2532;8447
315410;201501;1893;5161;1605;4736;246;904;1005;2869;1251;3773
315415;201501;1090;3654;1008;3530;384;1352;437;1609;821;2961
315420;201501;1227;3956;938;3362;259;999;159;551;418;1550
315430;201501;3858;10478;2861;8820;723;2573;793;2348;1516;4921
315440;201501;879;2769;769;2592;141;548;414;1380;555;1928
315445;201501;2086;5903;1723;5407;174;693;1293;3985;1467;4678
315450;201501;2364;7636;2162;7330;460;1523;1370;4822;1830;6345
315460;201501;35758;117902;31931;110057;10547;39121;7474;24896;18021;64017
315470;201501;526;1572;442;1428;60;239;255;792;315;1031
315480;201501;1601;4921;1058;3703;211;845;179;585;390;1430
315490;201501;3044;8406;2456;7589;376;1383;1293;3891;1669;5274
315500;201501;471;1438;313;1071;58;245;112;317;170;562
315510;201501;1431;4114;1244;3830;71;249;971;2993;1042;3242
315520;201501;1091;3275;878;2989;131;518;565;1875;696;2393
315530;201501;492;1726;462;1672;205;800;159;552;364;1352
315540;201501;1165;3631;963;3294;195;828;362;1201;557;2029
315550;201501;1706;4842;1355;4381;452;1646;469;1485;921;3131
315560;201501;6690;22161;6048;21295;669;2721;4307;15273;4976;17994
315570;201501;2060;6506;1910;6282;434;1612;1047;3400;1481;5012
315580;201501;2494;7418;1980;6495;479;1886;745;2262;1224;4148
315590;201501;938;2718;837;2566;145;517;495;1461;640;1978
315600;201501;2525;9004;2087;8226;367;1536;1170;4843;1537;6379
315610;201501;998;2881;824;2530;165;650;314;807;479;1457
315620;201501;310;1094;292;1061;86;299;155;593;241;892
315630;201501;890;2795;752;2548;178;651;227;750;405;1401
315640;201501;610;1783;503;1598;120;447;222;643;342;1090
315645;201501;844;2676;732;2428;288;1050;178;568;466;1618
315650;201501;1909;5347;1593;4902;114;485;1215;3683;1329;4168
315660;201501;2546;6805;2182;6249;449;1334;1274;3641;1723;4975
315670;201501;10030;34093;8971;32067;2815;10961;3009;10504;5824;21465
315680;201501;2967;10255;2417;9185;916;3630;527;2112;1443;5742
315690;201501;3515;10104;2522;8362;704;2619;612;2063;1316;4682
315700;201501;7182;22582;6131;20508;1215;4685;2976;9557;4191;14242
315710;201501;1950;5666;1561;5055;181;713;964;3105;1145;3818
315720;201501;3120;10087;2873;9621;678;2687;1489;4716;2167;7403
315725;201501;1659;5022;1340;4605;382;1356;692;2418;1074;3774
315727;201501;620;1927;527;1742;120;449;237;752;357;1201
315730;201501;870;2684;789;2544;144;507;473;1510;617;2017
315733;201501;889;2770;799;2599;304;1068;243;754;547;1822
315737;201501;1326;4084;1062;3608;99;400;684;2351;783;2751
315740;201501;1058;3302;894;2978;175;711;469;1469;644;2180
315750;201501;1094;3475;1009;3332;89;365;766;2490;855;2855
315760;201501;987;2716;949;2668;20;61;889;2502;909;2563
315765;201501;1418;4459;1308;4297;97;350;1049;3477;1146;3827
315770;201501;1568;5092;1405;4766;354;1345;461;1484;815;2829
315780;201501;23024;75434;21069;71356;6278;22917;6237;21004;12515;43921
315790;201501;3382;11492;3008;10737;371;1292;2022;7445;2393;8737
315800;201501;1529;5917;1252;5101;318;1484;256;984;574;2468
315810;201501;1404;3996;1213;3695;167;543;818;2463;985;3006
315820;201501;2671;9085;2381;8596;732;2749;1074;3993;1806;6742
315830;201501;1212;4133;1065;3822;202;884;295;906;497;1790
315840;201501;810;2139;615;1814;96;321;236;641;332;962
315850;201501;1198;4288;1154;4195;292;1120;513;1803;805;2923
315860;201501;480;1694;383;1506;102;473;81;307;183;780
315870;201501;475;1429;408;1337;121;444;130;390;251;834
315880;201501;1107;2994;915;2753;215;775;357;1000;572;1775
315890;201501;1524;5223;1353;4960;482;1848;633;2345;1115;4193
315895;201501;5022;15575;4592;14749;1080;3890;2139;6706;3219;10596
315900;201501;728;2291;705;2249;113;461;487;1425;600;1886
315910;201501;532;1845;496;1780;174;659;259;916;433;1575
315920;201501;1522;4321;989;3205;253;931;244;682;497;1613
315930;201501;1093;3038;877;2677;222;757;301;893;523;1650
315935;201501;1053;3543;967;3362;293;1130;320;1089;613;2219
315940;201501;659;2089;588;1947;165;614;244;778;409;1392
315950;201501;1159;3570;1062;3399;215;668;678;2218;893;2886
315960;201501;2888;9552;2167;8117;1005;4327;114;337;1119;4664
315970;201501;765;2113;601;1886;54;152;453;1487;507;1639
315980;201501;4301;10426;2701;7777;708;2358;734;1810;1442;4168
315990;201501;3827;11364;3341;10640;639;2453;1901;5939;2540;8392
316000;201501;506;1592;437;1494;159;627;164;519;323;1146
316010;201501;505;1759;437;1629;96;422;150;496;246;918
316020;201501;1110;3590;923;3286;150;641;536;1901;686;2542
316030;201501;3527;10216;2613;8655;351;1307;1367;4660;1718;5967
316040;201501;3648;11562;2719;9583;464;1914;370;992;834;2906
316045;201501;2115;6769;1938;6484;265;810;1402;4927;1667;5737
316050;201501;346;1096;277;991;58;230;161;553;219;783
316060;201501;741;2230;597;2015;96;428;337;1062;433;1490
316070;201501;5829;18752;5056;16985;1278;4859;2088;6639;3366;11498
316080;201501;719;2676;656;2518;157;671;121;472;278;1143
316090;201501;625;1808;428;1395;93;350;119;357;212;707
316095;201501;1383;4496;1220;4197;270;949;751;2652;1021;3601
316100;201501;2763;9262;2144;7697;558;2302;419;1397;977;3699
316105;201501;954;2685;718;2298;193;683;267;863;460;1546
316110;201501;11879;41592;10711;39499;1428;5887;7366;27746;8794;33633
316120;201501;1177;3909;998;3486;289;1083;334;1101;623;2184
316130;201501;1409;3129;865;2389;133;432;479;1274;612;1706
316140;201501;1040;3105;810;2729;104;393;501;1712;605;2105
316150;201501;1431;4177;1325;3994;262;930;794;2361;1056;3291
316160;201501;1240;3694;967;3161;163;630;450;1439;613;2069
316165;201501;937;2553;779;2318;150;528;468;1354;618;1882
316170;201501;1388;4011;1050;3432;209;772;441;1361;650;2133
316180;201501;1331;4226;997;3519;266;1097;242;758;508;1855
316190;201501;2777;8663;1434;5102;296;1102;196;601;492;1703
316200;201501;3983;12889;3104;11159;770;3208;884;3084;1654;6292
316210;201501;4840;15474;4187;14310;1845;6690;856;2848;2701;9538
316220;201501;730;2277;527;1895;121;517;66;246;187;763
316225;201501;1165;3344;1023;3140;141;525;705;2102;846;2627
316230;201501;446;1275;356;1126;62;217;180;596;242;813
316240;201501;6678;20530;5757;19347;587;2058;4473;15245;5060;17303
316245;201501;3127;10978;2907;10618;235;1127;2287;8238;2522;9365
316250;201501;9654;29534;8153;26518;2688;9602;2426;7451;5114;17053
316255;201501;2539;7826;2246;7477;347;1172;1638;5521;1985;6693
316257;201501;1365;3862;1054;3310;221;775;394;1191;615;1966
316260;201501;1753;5044;1343;4429;197;750;785;2654;982;3404
316265;201501;1318;3676;955;2936;105;405;546;1592;651;1997
316270;201501;4339;14409;3989;13700;996;3706;1888;6429;2884;10135
316280;201501;3239;10677;2940;10117;507;1953;1718;5931;2225;7884
316290;201501;3117;9993;2703;9208;576;2362;1206;3870;1782;6232
316292;201501;3304;10779;2982;10226;732;2781;1420;4612;2152;7393
316294;201501;867;2792;598;2174;130;559;64;215;194;774
316295;201501;1753;6040;1639;5819;309;1337;931;3091;1240;4428
316300;201501;1011;3101;860;2848;70;246;598;2016;668;2262
316310;201501;616;1918;479;1658;85;352;176;594;261;946
316320;201501;544;1733;446;1578;93;386;106;345;199;731
316330;201501;964;2979;766;2537;106;376;482;1591;588;1967
316340;201501;986;3173;827;2853;220;900;304;952;524;1852
316350;201501;1365;4390;1228;4163;227;782;683;2388;910;3170
316360;201501;736;1924;579;1705;56;177;438;1294;494;1471
316370;201501;4321;14201;3788;13152;1156;4416;768;2640;1924;7056
316380;201501;1526;4210;1240;3805;114;409;891;2749;1005;3158
316390;201501;864;2590;727;2351;224;806;303;980;527;1786
316400;201501;1295;4200;1064;3800;246;957;478;1684;724;2641
316410;201501;1086;3674;1018;3574;188;722;635;2230;823;2952
316420;201501;1873;6289;1688;6044;203;916;1174;4100;1377;5016
316430;201501;924;2837;730;2479;202;775;248;782;450;1557
316440;201501;668;2152;553;1988;213;878;136;472;349;1350
316443;201501;700;2092;578;1864;137;499;228;696;365;1195
316447;201501;1545;4811;1426;4641;92;308;1246;4087;1338;4395
316450;201501;2123;7350;1860;6855;325;1311;1169;4392;1494;5703
316460;201501;698;2229;646;2147;148;560;401;1262;549;1822
316470;201501;7479;24221;5886;20780;1583;6581;1755;5910;3338;12491
316480;201501;216;732;193;693;50;193;60;201;110;394
316490;201501;274;876;253;824;62;222;123;376;185;598
316500;201501;1099;4015;782;3047;159;670;38;144;197;814
316510;201501;835;3069;740;2874;278;1137;187;706;465;1843
316520;201501;1155;3523;960;3243;208;802;379;1161;587;1963
316530;201501;1111;3639;932;3269;221;977;339;1001;560;1978
316540;201501;990;3235;893;3080;211;883;346;1097;557;1980
316550;201501;1200;4064;1131;3951;221;858;727;2545;948;3403
316553;201501;1927;6837;1559;5975;473;2001;371;1382;844;3383
316555;201501;2899;9944;2516;9516;209;774;2045;7929;2254;8703
316556;201501;591;1625;478;1424;36;143;360;1041;396;1184
316557;201501;746;2746;715;2698;340;1372;187;661;527;2033
316560;201501;342;1176;291;1067;72;321;70;213;142;534
316570;201501;1340;4273;1167;3919;194;730;631;2114;825;2844
316580;201501;272;791;199;637;53;205;60;172;113;377
316590;201501;1486;4130;1111;3507;181;684;659;1984;840;2668
316600;201501;1038;3362;912;3106;309;1119;262;872;571;1991
316610;201501;559;2056;504;1957;107;474;303;1163;410;1637
316620;201501;2117;6614;1835;6085;365;1386;1045;3378;1410;4764
316630;201501;1498;5038;1320;4662;551;2040;370;1328;921;3368
316640;201501;189;602;165;550;28;120;70;206;98;326
316650;201501;905;3488;801;3321;188;790;442;1949;630;2739
316660;201501;175;472;107;332;15;59;44;128;59;187
316670;201501;1827;5363;1464;4683;570;2019;329;956;899;2975
316680;201501;1891;5329;1568;4871;146;439;1258;3995;1404;4434
316690;201501;1176;3980;1056;3737;349;1405;407;1396;756;2801
316695;201501;1104;3531;990;3334;69;236;714;2469;783;2705
316700;201501;324;1065;299;1015;64;261;156;485;220;746
316710;201501;3412;12942;2989;12027;1046;4488;861;3657;1907;8145
316720;201501;17018;55869;14322;50086;4436;16725;3183;10714;7619;27439
316730;201501;356;1104;315;1022;69;277;186;554;255;831
316740;201501;658;2222;587;2091;201;805;180;603;381;1408
316750;201501;411;1413;366;1316;86;359;125;417;211;776
316760;201501;3357;11377;2877;10791;1680;6342;829;3276;2509;9618
316770;201501;1282;3780;1157;3610;166;596;814;2535;980;3131
316780;201501;585;1994;517;1859;162;658;137;448;299;1106
316790;201501;853;2482;628;2092;178;658;198;647;376;1305
316800;201501;6000;19938;5470;18981;1125;4526;2731;9046;3856;13572
316805;201501;825;2241;772;2170;100;259;631;1833;731;2092
316810;201501;584;1817;513;1670;158;572;230;717;388;1289
316820;201501;379;1015;232;760;63;244;46;149;109;393
316830;201501;592;2065;572;2038;191;755;242;824;433;1579
316840;201501;2948;8976;2578;8310;690;2545;1046;3188;1736;5733
316850;201501;2046;6310;1828;5932;342;1234;1070;3473;1412;4707
316860;201501;18642;59552;16184;54994;4077;15928;6951;22592;11028;38520
316870;201501;6215;20309;5270;18137;1645;6178;989;3266;2634;9444
316880;201501;771;2523;715;2424;238;926;260;827;498;1753
316890;201501;1315;3281;1039;2918;339;1090;499;1329;838;2419
316900;201501;2405;7508;2012;6719;539;2100;719;2146;1258;4246
316905;201501;452;1516;395;1394;150;557;125;434;275;991
316910;201501;726;2453;567;2121;133;520;158;615;291;1135
316920;201501;1670;4959;1349;4489;267;972;619;2058;886;3030
316930;201501;8900;30470;7342;27045;1881;7775;1259;4255;3140;12030
316935;201501;4906;14488;3294;11251;929;3637;664;2071;1593;5708
316940;201501;7009;23224;5853;20800;1488;5865;1492;5095;2980;10960
316950;201501;1447;4290;1281;4048;154;600;893;2813;1047;3413
316960;201501;5064;12845;4078;11604;784;2440;2395;6791;3179;9231
316970;201501;3343;10810;3164;10524;998;3821;1084;3314;2082;7135
316980;201501;1057;3146;760;2633;308;1192;180;623;488;1815
316990;201501;9516;31234;8241;28291;3006;11273;982;3172;3988;14445
317000;201501;2694;9375;2610;9281;153;475;2120;8317;2273;8792
317005;201501;2529;7902;2289;7580;300;996;1719;5840;2019;6836
317010;201501;30410;76922;18967;58672;4838;16841;4442;14343;9280;31184
317020;201501;54890;156248;34518;114053;7902;29096;8037;24713;15939;53809
317030;201501;798;2276;654;2053;88;351;403;1225;491;1576
317040;201501;10025;29728;8245;26557;2226;7876;3336;10637;5562;18513
317043;201501;727;2084;649;1987;89;269;450;1411;539;1680
317047;201501;1152;3048;848;2540;138;473;395;1159;533;1632
317050;201501;1543;5339;1245;4646;257;1087;536;1902;793;2989
317052;201501;2435;7794;2152;7375;205;827;1669;5717;1874;6544
317057;201501;1724;4897;1344;4242;163;635;756;2298;919;2933
317060;201501;392;1159;295;945;62;233;95;265;157;498
317065;201501;1244;4157;1131;3973;128;531;874;3049;1002;3580
317070;201501;8928;28751;6629;23532;1647;6588;1278;4545;2925;11133
317075;201501;1100;3362;918;3021;271;1001;309;934;580;1935
317080;201501;6037;17044;5269;15762;1502;4840;1984;5767;3486;10607
317090;201501;4865;16438;4537;15887;631;2286;3193;11385;3824;13671
317100;201501;3067;8744;2469;7739;745;2606;991;2925;1736;5531
317103;201501;2014;7030;1709;6409;348;1630;772;2806;1120;4436
317107;201501;1345;4168;1161;3797;229;889;657;2005;886;2894
317110;201501;635;1659;399;1225;96;346;162;459;258;805
317115;201501;1140;3634;994;3325;149;519;633;2144;782;2663
317120;201501;11295;37709;9326;33056;2537;10064;3275;11213;5812;21277
317130;201501;7572;23127;6592;21418;1429;5338;3124;9943;4553;15281
317140;201501;596;2032;569;1980;63;240;402;1412;465;1652
317150;201501;992;2791;863;2643;83;288;664;2042;747;2330
317160;201501;3441;9368;2663;8340;267;977;1926;5974;2193;6951
317170;201501;1743;4962;1484;4550;109;450;997;2863;1106;3313
317180;201501;1863;6270;1493;5479;426;1728;465;1656;891;3384
317190;201501;1391;3996;1138;3655;144;477;795;2566;939;3043
317200;201501;4521;14513;4009;13498;1157;4357;1360;4366;2517;8723
317210;201501;1037;3150;852;2893;191;754;455;1528;646;2282
317220;201501;302;1081;292;1069;87;328;163;611;250;939
320010;201501;5435;17111;4748;15627;852;2988;2419;7970;3271;10958
320013;201501;2021;5931;1428;4807;207;750;745;2569;952;3319
320016;201501;3265;9278;2837;8649;407;1199;2025;6312;2432;7511
320020;201501;3878;12167;3369;11158;1057;3807;1245;4074;2302;7881
320030;201501;1577;5078;1276;4425;387;1430;465;1571;852;3001
320035;201501;1796;5359;1603;5073;432;1544;823;2465;1255;4009
320040;201501;3268;10954;2691;9594;667;2627;745;2530;1412;5157
320050;201501;1817;4902;1582;4495;234;748;1035;2879;1269;3627
320060;201501;11915;37808;9397;32007;2326;8772;3103;9957;5429;18729
320070;201501;1568;5133;1306;4518;346;1355;313;932;659;2287
320080;201501;5278;15284;4111;12920;1173;3931;1274;3970;2447;7901
320090;201501;8436;24601;6714;21139;1813;6120;2824;8590;4637;14710
320100;201501;3043;9199;2496;8139;576;2017;1177;3771;1753;5788
320110;201501;1379;4165;1234;3891;305;1036;465;1436;770;2472
320115;201501;1794;6400;1635;6105;863;3365;460;1734;1323;5099
320120;201501;16030;50457;12890;44276;3782;14197;3711;12832;7493;27029
320130;201501;35925;117050;32911;110856;7695;29076;15378;50087;23073;79163
320140;201501;4058;12917;2904;10227;697;2756;287;923;984;3679
320150;201501;16980;47101;12382;38467;3298;11276;2137;6407;5435;17683
320160;201501;4991;15531;4327;14334;1138;4295;1672;5090;2810;9385
320170;201501;1709;5555;1424;4920;395;1436;528;1850;923;3286
320180;201501;803;2643;712;2506;289;1059;230;823;519;1882
320190;201501;3859;13218;3077;11312;910;3556;880;3174;1790;6730
320200;201501;1063;3384;919;3122;231;845;393;1366;624;2211
320210;201501;5075;14230;4412;13038;922;3100;2348;6605;3270;9705
320220;201501;2802;8443;2188;7356;593;2218;861;2923;1454;5141
320225;201501;1467;5087;1214;4457;431;1706;245;924;676;2630
320230;201501;4046;13422;3663;12792;1231;4639;1277;4480;2508;9119
320240;201501;11369;33957;8868;29312;2514;9035;2282;7564;4796;16599
320245;201501;3845;13101;3579;12474;1176;4404;1178;3943;2354;8347
320250;201501;1700;5255;1249;4236;316;1218;271;812;587;2030
320255;201501;1858;6216;1604;5788;645;2528;594;2206;1239;4734
320260;201501;1082;3340;834;2743;216;799;249;685;465;1484
320265;201501;2415;7553;2113;7174;334;1182;1453;5072;1787;6254
320270;201501;2710;8189;2033;6836;504;1854;863;2836;1367;4690
320280;201501;6923;21088;6203;19744;1384;4900;2872;8791;4256;13691
320290;201501;1483;4879;1128;3998;384;1437;219;711;603;2148
320300;201501;4430;14925;4070;14120;1300;4818;1196;4110;2496;8928
320305;201501;4389;14281;3931;13263;955;3543;1868;6116;2823;9659
320310;201501;1961;5900;1701;5410;444;1509;730;2254;1174;3763
320313;201501;2236;6685;1577;5156;392;1518;280;800;672;2318
320316;201501;1856;5689;1578;5117;494;1684;630;1965;1124;3649
320320;201501;19447;61379;16183;55186;4589;17382;5928;19787;10517;37169
320330;201501;3154;9429;2720;8710;564;1777;1558;5216;2122;6993
320332;201501;4922;16684;4403;15732;1522;5798;1582;5755;3104;11553
320334;201501;1673;5516;1221;4500;397;1647;249;841;646;2488
320335;201501;2244;6729;1532;5090;463;1722;282;862;745;2584
320340;201501;5674;15669;4515;13709;1000;3345;2128;6383;3128;9728
320350;201501;5303;14189;3994;11804;932;3006;1539;4437;2471;7443
320360;201501;1701;4561;1271;3745;222;765;596;1626;818;2391
320370;201501;3289;10662;2664;9280;798;2866;959;3310;1757;6176
320380;201501;2467;7314;2176;6796;298;1053;1433;4408;1731;5461
320390;201501;7364;22285;6043;19564;1888;6793;1845;5555;3733;12348
320400;201501;4067;11782;3388;10771;1009;3616;1368;4031;2377;7647
320405;201501;3878;11521;3481;10963;1004;3472;1878;5754;2882;9226
320410;201501;5657;14453;4162;12639;834;2672;2416;7394;3250;10066
320420;201501;1644;5071;1194;4280;387;1530;209;737;596;2267
320425;201501;2058;5547;1747;5050;259;864;1084;3087;1343;3951
320430;201501;2243;6507;1993;6018;425;1371;1063;3148;1488;4519
320435;201501;2662;8897;2263;8069;1074;3988;650;2427;1724;6415
320440;201501;1205;4010;1072;3652;270;1020;371;1191;641;2211
320450;201501;2047;6412;1690;5685;472;1771;735;2353;1207;4124
320455;201501;4380;14710;3209;11793;971;3783;784;2854;1755;6637
320460;201501;2912;9234;2270;7911;598;2287;810;2702;1408;4989
320465;201501;1678;5277;1316;4443;307;1128;489;1575;796;2703
320470;201501;4320;13296;3091;10484;891;3361;470;1394;1361;4755
320480;201501;2020;6071;1695;5463;415;1551;705;2155;1120;3706
320490;201501;15841;49355;13178;44175;4266;15458;3889;13120;8155;28578
320495;201501;1252;3910;941;3208;377;1341;132;486;509;1827
320500;201501;45500;139877;39615;128977;10835;38370;18101;57741;28936;96111
320501;201501;4091;13107;3671;12430;1145;4376;1593;5208;2738;9584
320503;201501;1759;6075;1463;5404;478;1941;442;1472;920;3413
320506;201501;3589;11351;2469;8524;769;2834;187;550;956;3384
320510;201501;7922;24936;6797;22647;1866;6855;2872;9286;4738;16141
320515;201501;2042;5839;1731;5204;479;1537;558;1613;1037;3150
320517;201501;2165;7006;1779;6220;685;2591;394;1273;1079;3864
320520;201501;34314;105599;28381;94237;8098;29824;10681;34987;18779;64811
320530;201501;27851;85437;23390;76730;5419;20654;10854;33479;16273;54133
330010;201501;19307;59652;17577;56194;3392;12146;10371;32256;13763;44402
330015;201501;1794;5023;1543;4569;283;1021;642;1811;925;2832
330020;201501;16597;49349;15205;47129;3222;10936;8869;27021;12091;37957
330022;201501;1684;5273;1479;4923;284;1112;815;2611;1099;3723
330023;201501;3132;10021;2905;9569;756;2722;1127;3509;1883;6231
330025;201501;3888;10842;3270;9963;758;2565;1853;5513;2611;8078
330030;201501;8039;27131;7130;25235;1775;7017;3251;10987;5026;18004
330040;201501;12579;36322;10831;33356;2558;8493;5465;16390;8023;24883
330045;201501;65553;185632;58804;175873;7609;24739;41050;121594;48659;146333
330050;201501;2740;8618;2438;8018;780;2885;727;2196;1507;5081
330060;201501;5501;16354;4861;15425;1100;3926;2805;8929;3905;12855
330070;201501;23017;70518;20596;66361;4809;16947;9727;31075;14536;48022
330080;201501;8263;23636;7776;22918;1121;3297;5420;16224;6541;19521
330090;201501;2741;7580;2512;7193;512;1631;1349;3769;1861;5400
330093;201501;1998;5926;1664;5275;386;1323;545;1635;931;2958
330095;201501;1057;3618;952;3392;320;1302;186;569;506;1871
330100;201501;55031;176830;50294;168725;9889;37314;26834;90408;36723;127722
330110;201501;2353;7517;2125;7102;581;2155;749;2445;1330;4600
330115;201501;2117;6163;1920;5852;444;1538;971;2851;1415;4389
330120;201501;2395;6850;2165;6536;621;2086;1042;3015;1663;5101
330130;201501;3545;11557;3161;10871;861;3255;1438;4888;2299;8143
330140;201501;3064;9504;2789;9098;702;2495;1434;4703;2136;7198
330150;201501;2549;7539;1978;6387;472;1669;482;1516;954;3185
330160;201501;1121;3837;1037;3676;331;1308;406;1375;737;2683
330170;201501;107418;324568;100185;313415;15752;53179;67891;212080;83643;265259
330180;201501;1890;5704;1652;5280;193;794;1050;3141;1243;3935
330185;201501;7501;23859;6704;22340;1551;5620;3513;11589;5064;17209
330187;201501;3786;10944;3291;10127;489;1745;2236;6732;2725;8477
330190;201501;26324;76469;24731;73921;4980;15794;15650;46304;20630;62098
330200;201501;13707;43672;12308;41135;2930;10164;6439;21788;9369;31952
330205;201501;2398;6504;2086;5974;431;1409;1133;3123;1564;4532
330210;201501;4486;11843;3329;9749;981;3114;812;2346;1793;5460
330220;201501;10192;31460;9129;29186;2581;9030;2777;8326;5358;17356
330225;201501;3945;12381;3693;12012;339;1322;2814;9291;3153;10613
330227;201501;17970;51148;16095;48435;4096;12968;8638;25895;12734;38863
330230;201501;1426;4268;1293;4037;344;1216;537;1567;881;2783
330240;201501;16951;53498;15112;49894;5589;20191;3065;9573;8654;29764
330245;201501;1263;3961;1033;3518;271;1018;238;809;509;1827
330250;201501;35300;103533;32489;98885;9413;29251;15097;46790;24510;76041
330260;201501;3556;11234;3135;10363;667;2515;1404;4345;2071;6860
330270;201501;14212;39491;11534;35552;3252;10889;4341;13337;7593;24226
330280;201501;2036;6289;1759;5728;348;1267;848;2610;1196;3877
330285;201501;18385;53463;16780;51193;2945;9747;10875;33089;13820;42836
330290;201501;3536;9862;3131;9288;557;1917;1927;5498;2484;7415
330300;201501;3499;11395;3219;10895;515;1987;1966;6572;2481;8559
330310;201501;2415;6927;2139;6461;377;1194;1204;3614;1581;4808
330320;201501;13444;40209;12624;38986;1950;6581;8987;27604;10937;34185
330330;201501;28664;81134;25759;76575;4634;15440;16217;47057;20851;62497
330340;201501;14071;42191;11293;36874;3264;11396;3259;10559;6523;21955
330350;201501;87395;269308;82947;262749;12600;40782;60399;193037;72999;233819
330360;201501;5433;16779;5312;16607;383;1344;4555;14179;4938;15523
330370;201501;3517;12729;3264;12167;1186;4665;1083;4062;2269;8727
330380;201501;4731;15284;4080;14060;903;3437;2020;6818;2923;10255
330385;201501;4044;13987;3741;13399;1264;4824;1409;5005;2673;9829
330390;201501;22639;75374;20474;71049;4741;18506;10140;34369;14881;52875
330395;201501;2968;8814;2704;8357;333;1231;1814;5475;2147;6706
330400;201501;2403;7860;2186;7481;385;1587;1221;3875;1606;5462
330410;201501;2869;9040;2453;8257;484;1786;1282;4289;1766;6075
330411;201501;2294;7191;2005;6580;291;1179;1148;3547;1439;4726
330412;201501;1317;4520;1074;4053;260;1135;412;1469;672;2604
330414;201501;25826;72584;22279;67874;3907;12324;14441;44326;18348;56650
330415;201501;3602;11044;3150;10242;810;2804;1350;4415;2160;7219
330420;201501;9187;27779;6546;22668;1727;6580;1104;3714;2831;10294
330430;201501;7769;23055;7034;21747;1548;5291;3643;11043;5191;16334
330440;201501;1918;6468;1638;5877;542;2196;360;1141;902;3337
330450;201501;1412;4754;1284;4533;330;1377;657;2256;987;3633
330452;201501;11942;36013;9613;31454;2608;9451;3620;11399;6228;20850
330455;201501;468372;1329748;395773;1214579;97287;318480;197405;603182;294692;921662
330460;201501;1274;4189;1156;3989;262;1057;575;1939;837;2996
330470;201501;4324;13415;3876;12577;1125;4055;1565;4911;2690;8966
330475;201501;7914;24874;7093;23473;1949;7109;3147;10313;5096;17422
330480;201501;5964;17753;5443;16985;1279;4349;2794;8570;4073;12919
330490;201501;100089;273798;92066;262436;9131;27126;72730;208694;81861;235820
330500;201501;5380;16815;5109;16314;715;2567;3532;11137;4247;13704
330510;201501;38161;120016;35248;115365;10685;35788;17458;58295;28143;94083
330513;201501;1529;4564;1392;4317;454;1428;552;1744;1006;3172
330515;201501;2952;9298;2680;8788;828;2864;942;3055;1770;5919
330520;201501;11743;35057;10573;33026;2318;7796;5410;16790;7728;24586
330530;201501;1525;4586;1370;4298;343;1168;602;1847;945;3015
330540;201501;3091;9252;2651;8492;691;2416;1093;3401;1784;5817
330550;201501;8353;27824;7363;26022;3118;11675;1608;5662;4726;17337
330555;201501;10282;30752;9213;29208;1706;5586;5858;18962;7564;24548
330560;201501;4214;12864;3894;12320;830;2996;2048;6240;2878;9236
330570;201501;3697;10694;3175;9855;815;2618;1597;5034;2412;7652
330575;201501;5268;15368;4720;14436;844;2932;2916;8532;3760;11464
330580;201501;15101;47691;13011;43499;3620;12891;5036;16970;8656;29861
330590;201501;1717;5269;1590;5054;349;1200;948;2973;1297;4173
330600;201501;10610;30437;8574;27208;1182;4557;5146;15777;6328;20334
330610;201501;8950;28576;8273;27374;1711;6463;4538;14804;6249;21267
330615;201501;1627;5788;1476;5433;648;2504;390;1496;1038;4000
330620;201501;3736;12969;3406;12364;1175;4602;951;3547;2126;8149
330630;201501;21705;66147;18283;59938;3839;14417;9410;29492;13249;43909
350010;201501;2261;6812;1617;5503;405;1520;278;817;683;2337
350020;201501;492;1336;342;1051;74;254;163;483;237;737
350030;201501;4222;13307;3355;11475;1268;4762;749;2295;2017;7057
350040;201501;499;1738;396;1499;108;463;88;277;196;740
350050;201501;1123;3449;916;3071;205;802;322;993;527;1795
350055;201501;572;1796;532;1731;137;521;295;900;432;1421
350060;201501;90;303;83;291;25;105;32;99;57;204
350070;201501;2703;8873;2109;7523;502;1974;400;1234;902;3208
350075;201501;508;1718;422;1574;128;542;122;411;250;953
350080;201501;553;1591;418;1332;79;282;178;554;257;836
350090;201501;550;1530;400;1277;91;317;119;343;210;660
350100;201501;1831;5982;1393;5012;377;1508;379;1249;756;2757
350110;201501;439;1306;333;1072;59;213;140;417;199;630
350115;201501;1267;3978;1121;3642;223;848;571;1682;794;2530
350120;201501;557;1474;289;906;66;232;51;149;117;381
350130;201501;3350;9945;3006;9267;560;1988;1532;4385;2092;6373
350140;201501;614;1978;546;1860;125;501;246;779;371;1280
350150;201501;382;1286;341;1195;112;418;103;352;215;770
350160;201501;6772;21041;5146;17549;1445;5524;1975;6138;3420;11662
350170;201501;1802;6248;1577;5695;477;1854;383;1298;860;3152
350180;201501;1158;3117;890;2627;196;603;398;1140;594;1743
350190;201501;3148;10065;2659;9110;607;2529;1389;4346;1996;6875
350200;201501;319;1036;282;972;63;241;117;402;180;643
350210;201501;6274;16747;4583;13913;1317;4505;1620;4631;2937;9136
350220;201501;2620;8243;2350;7768;713;2775;847;2498;1560;5273
350230;201501;705;2375;653;2289;192;750;249;867;441;1617
350240;201501;426;1338;398;1290;76;276;260;812;336;1088
350250;201501;2207;8072;2107;7878;795;3170;767;2845;1562;6015
350260;201501;982;2607;701;2115;130;423;336;981;466;1404
350270;201501;5201;15935;4551;14593;860;2971;2199;6954;3059;9925
350275;201501;1936;6429;1737;6102;463;1781;662;2166;1125;3947
350280;201501;20979;53486;13569;40478;3058;9866;3242;9557;6300;19423
350290;201501;1579;5235;1299;4635;325;1264;305;1055;630;2319
350300;201501;398;1226;347;1131;74;260;167;526;241;786
350310;201501;874;2945;787;2741;156;633;344;1145;500;1778
350315;201501;541;1697;445;1497;80;352;142;428;222;780
350320;201501;12020;37801;10397;34510;2931;10438;1593;5370;4524;15808
350330;201501;13411;38828;9022;28336;1893;6194;3152;9213;5045;15407
350335;201501;323;1012;295;965;51;161;187;624;238;785
350340;201501;1094;3310;801;2737;179;705;260;833;439;1538
350350;201501;762;2435;674;2294;161;650;247;841;408;1491
350360;201501;752;2564;632;2302;168;649;214;799;382;1448
350370;201501;693;2123;512;1712;93;364;96;273;189;637
350380;201501;3344;10467;2682;9394;942;3668;684;2191;1626;5859
350390;201501;8537;27021;7582;25251;2144;7605;3288;10621;5432;18226
350395;201501;314;900;174;613;31;125;40;131;71;256
350400;201501;7785;22315;6307;19694;1546;5420;2576;7664;4122;13084
350410;201501;7595;26537;6209;23454;1842;7696;1232;4400;3074;12096
350420;201501;520;1508;345;1186;86;362;40;107;126;469
350430;201501;728;2290;608;2076;135;573;313;1014;448;1587
350440;201501;1210;3868;1121;3693;314;1100;571;1817;885;2917
350450;201501;7486;22358;5844;19137;1502;5375;1509;4631;3011;10006
350460;201501;1388;3948;951;3037;217;781;294;833;511;1614
350470;201501;247;678;201;603;41;155;105;286;146;441
350480;201501;770;2369;535;1847;80;318;91;269;171;587
350490;201501;2054;5976;1764;5577;475;1737;781;2275;1256;4012
350500;201501;571;1687;491;1566;126;421;212;657;338;1078
350510;201501;992;3115;787;2641;171;668;273;814;444;1482
350520;201501;966;3530;782;3125;214;982;189;687;403;1669
350530;201501;2391;7123;1968;6238;634;2191;541;1553;1175;3744
350535;201501;1368;4195;1293;4061;65;281;1076;3317;1141;3598
350540;201501;1909;5404;1558;4783;450;1486;556;1701;1006;3187
350550;201501;11071;30453;7970;25239;1763;6371;3165;9559;4928;15930
350560;201501;3483;11502;3150;10820;552;2038;1639;5715;2191;7753
350570;201501;18870;63864;17059;59841;5073;19231;6295;21137;11368;40368
350580;201501;1670;5254;1232;4242;275;1059;186;542;461;1601
350590;201501;3953;12355;2988;10371;829;3218;995;3123;1824;6341
350600;201501;39154;96596;26680;76532;4290;13503;13642;37813;17932;51316
350610;201501;7990;23024;6177;19878;1341;4929;2787;8622;4128;13551
350620;201501;416;1196;326;1062;69;264;158;488;227;752
350630;201501;1636;4979;1269;4262;346;1360;290;844;636;2204
350635;201501;5292;16436;4147;14290;1123;4139;1560;5340;2683;9479
350640;201501;634;2038;497;1687;108;392;129;412;237;804
350650;201501;7065;21588;3963;13988;1042;4111;356;1253;1398;5364
350660;201501;4010;12427;3485;11535;791;2912;1868;6052;2659;8964
350670;201501;1771;5493;1660;5287;308;1093;1063;3275;1371;4368
350680;201501;1132;3477;895;2998;223;893;370;1180;593;2073
350690;201501;908;2992;748;2669;192;761;233;770;425;1531
350700;201501;2924;10006;2576;9241;985;3838;837;2693;1822;6531
350710;201501;2395;7561;2162;7185;325;1196;1447;4785;1772;5981
350715;201501;900;2743;785;2540;231;869;284;811;515;1680
350720;201501;140;423;129;403;40;139;44;118;84;257
350730;201501;416;1554;396;1501;112;473;144;522;256;995
350740;201501;2016;6263;1658;5462;343;1269;767;2390;1110;3659
350745;201501;374;1148;287;950;45;180;130;377;175;557
350750;201501;10072;30413;7824;25993;1973;7261;1922;5951;3895;13212
350760;201501;11891;36487;10289;33513;2710;9939;4396;13540;7106;23479
350770;201501;736;2082;502;1630;83;311;229;712;312;1023
350775;201501;533;1509;441;1360;85;318;253;738;338;1056
350780;201501;2141;6508;1623;5445;467;1736;223;701;690;2437
350790;201501;1980;6270;1520;5341;423;1605;349;1086;772;2691
350800;201501;2997;10033;2822;9741;513;2057;1771;5954;2284;8011
350810;201501;2139;6238;1779;5648;567;1956;641;1970;1208;3926
350820;201501;549;1495;402;1196;75;268;171;467;246;735
350830;201501;859;2698;610;2105;85;329;136;391;221;720
350840;201501;2494;8888;2085;7880;643;2675;402;1289;1045;3964
350850;201501;6308;21047;5272;18715;1743;6577;1220;4146;2963;10723
350860;201501;3108;9876;2975;9686;286;1138;2367;7636;2653;8774
350870;201501;2483;8172;2145;7656;589;2318;1221;4385;1810;6703
350880;201501;1347;4460;1132;4014;306;1168;250;866;556;2034
350890;201501;643;1852;451;1440;80;310;113;274;193;584
350900;201501;4393;14717;3586;12881;971;3814;744;2484;1715;6298
350910;201501;817;2474;726;2287;246;836;260;762;506;1598
350920;201501;9570;27951;8752;26573;1425;4722;5847;17305;7272;22027
350925;201501;4550;13988;3854;12594;999;3551;1574;4781;2573;8332
350930;201501;1561;4268;1291;3820;139;489;904;2595;1043;3084
350940;201501;2052;6782;1879;6511;367;1520;1163;3877;1530;5397
350945;201501;837;2773;733;2557;132;546;360;1182;492;1728
350950;201501;64750;201839;53462;179019;13587;50147;21565;69389;35152;119536
350960;201501;4543;15660;3989;14450;699;2942;2284;7973;2983;10915
350970;201501;4266;14972;3701;13643;1228;4988;964;3223;2192;8211
350980;201501;595;1977;535;1874;225;847;179;625;404;1472
350990;201501;1699;5902;1466;5446;493;1990;409;1468;902;3458
350995;201501;766;2679;732;2614;131;588;439;1498;570;2086
351000;201501;3394;10151;2890;9205;391;1420;1605;4953;1996;6373
351010;201501;369;1091;256;846;87;322;77;251;164;573
351015;201501;849;2846;730;2627;228;921;289;993;517;1914
351020;201501;7876;25209;6925;23738;1770;6526;3377;11715;5147;18241
351030;201501;1573;5633;1438;5334;363;1584;548;1884;911;3468
351040;201501;3335;10298;3055;9806;534;2037;1932;5897;2466;7934
351050;201501;10664;33067;8367;28735;2521;9498;2645;8926;5166;18424
351060;201501;32505;98443;26752;87855;6854;24586;10687;34264;17541;58850
351070;201501;1687;4733;1177;3825;361;1300;204;544;565;1844
351080;201501;2733;8013;2127;7256;550;2118;993;3279;1543;5397
351090;201501;383;1312;305;1151;68;297;70;264;138;561
351100;201501;1808;5571;1466;4892;507;1755;455;1546;962;3301
351110;201501;8056;20450;4424;14224;1069;3903;1058;3101;2127;7004
351120;201501;606;1776;494;1550;59;215;267;756;326;971
351130;201501;927;2587;509;1735;93;379;118;365;211;744
351140;201501;1722;6019;1557;5665;520;2112;478;1650;998;3762
351150;201501;1784;6100;1354;4985;280;1140;309;996;589;2136
351160;201501;1364;4677;1219;4356;330;1325;450;1533;780;2858
351170;201501;1512;4916;1220;4257;259;974;513;1664;772;2638
351190;201501;741;2403;621;2111;141;523;125;369;266;892
351200;201501;2178;6376;1825;5694;419;1510;695;1986;1114;3496
351210;201501;1023;3101;809;2668;204;750;268;795;472;1545
351220;201501;3159;10583;2797;9844;604;2361;1371;4741;1975;7102
351230;201501;1701;5471;1486;5090;295;1187;868;2884;1163;4071
351240;201501;1048;3313;765;2672;207;802;186;561;393;1363
351250;201501;893;2542;643;2036;130;442;272;823;402;1265
351260;201501;928;2740;820;2512;179;615;360;1026;539;1641
351270;201501;372;1293;339;1231;90;379;135;440;225;819
351280;201501;5224;15525;3895;12641;928;3205;1266;3788;2194;6993
351290;201501;999;2892;774;2456;197;655;292;860;489;1515
351300;201501;10887;37412;8654;32429;2340;9677;2833;10440;5173;20117
351310;201501;3215;9865;2647;8858;522;2093;1334;4157;1856;6250
351320;201501;899;3077;778;2809;219;883;211;650;430;1533
351330;201501;291;814;247;740;108;333;58;167;166;500
351340;201501;5885;19950;5235;18656;1428;5461;2302;8146;3730;13607
351350;201501;7158;23133;6241;21213;1900;6814;2008;6472;3908;13286
351360;201501;4121;12961;3849;12471;949;3437;1718;5316;2667;8753
351370;201501;2214;6923;1778;6033;490;1877;578;1794;1068;3671
351380;201501;34612;104241;31580;98540;6576;22548;14839;44637;21415;67185
351385;201501;180;564;171;547;41;134;93;289;134;423
351390;201501;1127;3695;963;3360;319;1257;375;1193;694;2450
351400;201501;941;3108;881;2965;333;1163;311;1053;644;2216
351410;201501;2749;8327;2449;7813;459;1593;1399;4343;1858;5936
351420;201501;386;1129;267;888;66;234;63;203;129;437
351430;201501;832;2620;757;2492;76;261;577;1916;653;2177
351440;201501;3806;11342;2997;9575;851;2859;598;1674;1449;4533
351450;201501;1649;4677;1420;4370;391;1259;674;2151;1065;3410
351460;201501;772;2371;653;2162;307;1078;190;598;497;1676
351470;201501;1025;3105;907;2882;282;994;318;968;600;1962
351480;201501;2768;9104;2534;8716;527;2218;1322;4345;1849;6563
351490;201501;1861;6229;1659;5798;242;1034;985;3292;1227;4326
351492;201501;197;620;145;496;26;106;65;211;91;317
351495;201501;146;486;120;421;33;127;34;108;67;235
351500;201501;20128;60885;16684;54343;4814;17358;6488;20216;11302;37574
351510;201501;7908;25383;6761;23145;1642;6106;3323;11249;4965;17355
351512;201501;403;1164;331;1026;68;224;178;561;246;785
351515;201501;2257;7196;1655;5844;457;1750;451;1471;908;3221
351518;201501;1827;5985;1289;4976;348;1540;287;1007;635;2547
351519;201501;759;2340;616;2036;138;568;245;684;383;1252
351520;201501;804;2212;411;1445;69;279;64;197;133;476
351530;201501;372;1137;281;934;34;124;93;264;127;388
351535;201501;2334;6132;1878;5488;192;665;1314;3770;1506;4435
351540;201501;1751;5470;1473;4965;564;2096;259;817;823;2913
351550;201501;4468;13045;3260;10688;748;2816;1178;3735;1926;6551
351560;201501;378;1201;321;1073;75;281;70;224;145;505
351565;201501;205;676;187;628;49;194;80;242;129;436
351570;201501;11344;35507;9816;32502;2441;8702;5067;16415;7508;25117
351580;201501;356;984;250;762;40;120;100;301;140;421
351590;201501;417;1149;312;951;63;216;86;236;149;452
351600;201501;1605;4445;1428;4164;217;746;794;2196;1011;2942
351610;201501;676;1854;529;1604;79;283;262;747;341;1030
351620;201501;18450;59642;14269;51001;3465;13801;3425;10773;6890;24574
351630;201501;17136;56081;15718;53745;3801;13638;8993;30769;12794;44407
351640;201501;9768;31029;8214;28278;1817;6913;4309;14540;6126;21453
351650;201501;403;1197;215;718;47;166;35;110;82;276
351660;201501;768;2422;579;1953;136;497;166;494;302;991
351670;201501;3886;12040;3229;10648;577;2250;1620;5003;2197;7253
351680;201501;673;2065;429;1456;92;331;67;200;159;531
351685;201501;426;1289;345;1150;90;303;153;526;243;829
351690;201501;1002;2975;701;2279;152;555;195;540;347;1095
351700;201501;1249;3615;1096;3336;315;987;454;1359;769;2346
351710;201501;642;2069;532;1830;104;375;203;636;307;1011
351720;201501;1587;4897;1113;3702;212;767;372;1126;584;1893
351730;201501;993;2869;807;2618;290;1076;297;907;587;1983
351740;201501;4253;11768;3461;10196;782;2493;1205;3363;1987;5856
351750;201501;1133;3616;895;3132;239;970;314;996;553;1966
351760;201501;3678;11655;3177;10568;841;3022;1246;3921;2087;6943
351770;201501;2260;7048;1919;6458;526;1901;951;3132;1477;5033
351780;201501;1517;4261;939;2990;198;701;233;692;431;1393
351790;201501;1074;3202;942;3010;316;1035;411;1322;727;2357
351800;201501;419;933;313;789;42;115;182;446;224;561
351810;201501;1078;3115;996;3015;191;663;703;2081;894;2744
351820;201501;1969;6275;1590;5580;529;1970;191;646;720;2616
351830;201501;3975;12618;3154;10678;577;2221;1573;5054;2150;7275
351840;201501;7393;24739;6453;22904;1874;7184;2291;7936;4165;15120
351850;201501;1471;4493;1149;3853;233;946;438;1290;671;2236
351860;201501;3317;10594;2957;9863;819;2983;1327;4201;2146;7184
351870;201501;30370;92680;26806;86362;6602;22874;13804;43980;20406;66854
351880;201501;108227;349664;95645;323365;29283;105079;28323;94229;57606;199308
351885;201501;539;1945;502;1869;139;560;240;844;379;1404
351890;201501;692;2108;540;1786;137;510;138;410;275;920
351900;201501;1293;3982;1108;3694;303;1094;427;1421;730;2515
351905;201501;431;1420;367;1312;69;309;203;678;272;987
351907;201501;15718;48208;13531;44180;2384;9031;7657;24076;10041;33107
351910;201501;919;2826;838;2698;176;665;430;1320;606;1985
351920;201501;1009;2816;912;2669;133;460;597;1691;730;2151
351925;201501;921;2837;832;2668;120;458;499;1506;619;1964
351930;201501;2643;8755;2468;8407;580;2368;1425;4445;2005;6813
351940;201501;897;2654;811;2507;168;565;504;1507;672;2072
351950;201501;1378;3797;987;3061;148;514;525;1556;673;2070
351960;201501;4076;12084;3069;10277;735;2691;1440;4765;2175;7456
351970;201501;5474;19962;4864;18709;1530;6309;1682;6348;3212;12657
351980;201501;895;2668;706;2308;146;549;295;840;441;1389
351990;201501;1509;4315;1187;3696;318;1161;288;759;606;1920
352000;201501;2328;7500;2123;7095;546;1990;973;3084;1519;5074
352010;201501;1890;6385;1674;5887;464;1786;399;1355;863;3141
352020;201501;1391;4444;1213;4082;319;1181;440;1407;759;2588
352030;201501;4635;13900;3970;12939;967;3351;2205;7266;3172;10617
352040;201501;1902;6427;1596;5715;364;1437;406;1328;770;2765
352042;201501;2651;7505;1854;5772;396;1361;902;2735;1298;4096
352044;201501;1407;4714;1106;3994;248;979;207;665;455;1644
352050;201501;7306;23500;5133;18691;1472;5975;997;3130;2469;9105
352060;201501;770;2249;668;2087;165;626;282;792;447;1418
352070;201501;638;1773;585;1692;203;616;241;713;444;1329
352080;201501;458;1305;339;1090;68;255;141;415;209;670
352090;201501;1707;5537;1367;4809;327;1300;321;989;648;2289
352100;201501;2392;7339;1737;6077;433;1706;585;1860;1018;3566
352110;201501;492;1796;437;1670;136;555;160;584;296;1139
352115;201501;377;1232;321;1111;69;272;144;456;213;728
352120;201501;908;2774;783;2570;145;538;428;1386;573;1924
352130;201501;1864;5330;1320;4272;370;1267;420;1254;790;2521
352140;201501;1563;4720;1060;3613;206;764;470;1561;676;2325
352150;201501;709;2163;552;1861;138;477;245;804;383;1281
352160;201501;1068;2975;954;2832;162;509;640;1881;802;2390
352170;201501;2720;8253;2454;7745;551;1963;1304;3884;1855;5847
352180;201501;3448;9798;2940;8880;744;2487;1205;3414;1949;5901
352190;201501;1111;3358;1019;3207;199;715;565;1708;764;2423
352200;201501;389;1363;322;1232;52;222;184;722;236;944
352210;201501;16580;44528;13255;39710;2441;7680;7954;24352;10395;32032
352215;201501;553;1736;509;1679;74;294;306;1000;380;1294
352220;201501;12456;41018;11248;38598;3662;13542;3765;12615;7427;26157
352230;201501;12936;43877;11307;40810;3348;13289;4374;15413;7722;28702
352240;201501;10881;33524;9342;30789;3012;11174;3450;10668;6462;21842
352250;201501;22373;72274;19884;67282;5604;20467;7405;24763;13009;45230
352260;201501;5270;15076;3287;10947;637;2431;1146;3545;1783;5976
352265;201501;870;2779;743;2569;97;433;456;1498;553;1931
352270;201501;2081;7063;1745;6328;545;2077;418;1442;963;3519
352280;201501;2337;7188;1933;6488;496;1906;666;2129;1162;4035
352290;201501;1160;3680;1006;3358;237;935;339;987;576;1922
352300;201501;898;2672;725;2357;190;688;309;941;499;1629
352310;201501;34199;107361;30043;100448;7611;27348;17183;57128;24794;84476
352320;201501;5703;17601;4956;16225;1480;5303;1645;4861;3125;10164
352330;201501;1881;6215;1646;5892;569;2173;546;1940;1115;4113
352340;201501;5564;18670;4525;16288;1311;5122;844;2756;2155;7878
352350;201501;1498;5341;1349;5017;300;1251;516;1829;816;3080
352360;201501;1081;3403;953;3154;203;825;578;1791;781;2616
352370;201501;877;3001;801;2842;160;672;391;1326;551;1998
352380;201501;945;2982;829;2786;276;1060;239;767;515;1827
352390;201501;17112;47738;11644;37192;2253;8360;5486;16309;7739;24669
352400;201501;3420;9834;2243;7539;564;2075;707;2194;1271;4269
352410;201501;3515;10531;2873;9425;907;3208;904;2827;1811;6035
352420;201501;957;2741;866;2589;257;872;422;1199;679;2071
352430;201501;6033;18810;5250;17560;1888;6912;1731;5645;3619;12557
352440;201501;15122;46706;12325;41289;3209;11580;4483;14727;7692;26307
352450;201501;642;1872;434;1475;108;415;98;291;206;706
352460;201501;2323;7714;2002;7131;659;2593;574;1901;1233;4494
352470;201501;4516;12460;2682;8658;469;1700;946;2860;1415;4560
352480;201501;4812;13274;3800;11447;747;2683;1626;4522;2373;7205
352490;201501;686;2400;574;2131;117;492;127;431;244;923
352500;201501;7469;22948;6928;22088;3303;11567;2004;5503;5307;17070
352510;201501;3059;10034;2460;8803;818;3221;567;1958;1385;5179
352520;201501;2131;7451;1891;6895;462;1821;917;3277;1379;5098
352530;201501;7381;23832;5540;19721;1588;6119;842;2708;2430;8827
352540;201501;479;1549;368;1305;55;236;105;356;160;592
352550;201501;877;2938;615;2296;149;648;111;357;260;1005
352560;201501;659;1946;496;1606;94;328;180;519;274;847
352570;201501;1623;5348;1202;4351;271;1124;259;826;530;1950
352580;201501;861;2544;738;2339;198;718;353;1041;551;1759
352585;201501;221;723;176;630;63;236;34;129;97;365
352590;201501;11334;35971;9944;33278;2237;8308;5411;17431;7648;25739
352600;201501;1587;4900;1415;4585;392;1387;625;1935;1017;3322
352610;201501;3271;10051;2758;9168;866;3195;848;2628;1714;5823
352620;201501;5042;15764;4737;15382;977;3447;3104;10055;4081;13502
352630;201501;644;2106;604;2004;149;567;287;912;436;1479
352640;201501;2830;8847;2309;7734;390;1476;1105;3590;1495;5066
352650;201501;825;2425;620;2000;133;475;202;603;335;1078
352660;201501;991;3379;790;2913;186;768;193;660;379;1428
352670;201501;10371;31590;6326;22443;1693;6484;942;3100;2635;9584
352680;201501;3146;10780;2452;9150;542;2274;653;2140;1195;4414
352690;201501;27787;79045;19911;62922;4065;14199;8932;27122;12997;41321
352700;201501;756;2275;622;2074;188;709;280;883;468;1592
352710;201501;5532;16361;4164;13598;1050;3832;1533;4792;2583;8624
352720;201501;7538;24633;6912;23354;2087;7334;2658;8885;4745;16219
352725;201501;406;1150;258;847;38;155;92;272;130;427
352730;201501;2248;7548;1983;6847;431;1659;680;2094;1111;3753
352740;201501;1828;5260;1496;4701;295;1124;866;2552;1161;3676
352750;201501;366;1084;241;798;46;175;65;183;111;358
352760;201501;1057;3703;941;3461;283;1126;436;1523;719;2649
352770;201501;661;2084;609;1993;146;552;282;887;428;1439
352780;201501;590;1990;515;1816;115;469;167;532;282;1001
352790;201501;625;1809;458;1500;98;341;109;347;207;688
352800;201501;939;3401;694;2735;167;727;164;524;331;1251
352810;201501;1085;2835;737;2176;136;477;233;641;369;1118
352820;201501;585;1719;466;1541;169;595;92;298;261;893
352830;201501;489;1383;349;1100;76;269;64;163;140;432
352840;201501;3781;13038;3344;12102;1028;3954;1001;3608;2029;7562
352850;201501;8657;27356;7472;25274;1952;7091;2807;9425;4759;16516
352860;201501;797;2612;726;2455;206;762;238;732;444;1494
352870;201501;992;2477;736;1996;79;295;439;1082;518;1377
352880;201501;2184;6347;1637;5186;367;1228;497;1455;864;2683
352885;201501;249;836;235;806;46;172;128;423;174;595
352890;201501;685;1856;530;1554;102;351;250;651;352;1002
352900;201501;19164;56578;14270;46622;3223;11530;5491;17017;8714;28547
352910;201501;257;817;195;683;50;194;26;82;76;276
352920;201501;2491;7494;2007;6573;528;1960;793;2335;1321;4295
352930;201501;5830;18362;4703;15890;1307;4779;1052;3380;2359;8159
352940;201501;26358;87911;22723;79415;8012;29597;3925;13005;11937;42602
352950;201501;325;1011;228;804;61;260;57;162;118;422
352960;201501;612;1884;405;1405;68;266;65;207;133;473
352965;201501;308;892;250;786;64;226;45;128;109;354
352970;201501;2911;7673;2525;7137;333;1005;1750;5011;2083;6016
352980;201501;1430;4290;1217;3954;314;1042;621;2124;935;3166
352990;201501;3807;12342;3415;11649;1040;3994;1287;4159;2327;8153
353000;201501;486;1354;312;969;55;187;59;154;114;341
353010;201501;2932;8261;2184;6805;534;1907;721;2042;1255;3949
353020;201501;4221;11636;2836;8635;417;1481;1146;3111;1563;4592
353030;201501;4104;12051;3427;10814;1012;3465;873;2569;1885;6034
353040;201501;675;1930;576;1774;163;565;217;637;380;1202
353050;201501;5001;16776;4216;15195;1313;5186;1477;5019;2790;10205
353060;201501;32709;102671;30604;99392;3883;15362;22314;69781;26197;85143
353070;201501;9021;29414;6772;24472;1869;7271;1770;6347;3639;13618
353080;201501;4761;15543;3485;12666;902;3661;869;2859;1771;6520
353090;201501;517;1715;468;1610;54;241;260;829;314;1070
353100;201501;214;595;118;382;34;123;31;95;65;218
353110;201501;7217;22602;6429;21234;1543;5465;3513;11618;5056;17083
353120;201501;448;1474;378;1327;118;470;96;284;214;754
353130;201501;2583;7610;2163;6944;744;2627;762;2324;1506;4951
353140;201501;2348;6433;1808;5386;480;1577;681;1843;1161;3420
353150;201501;1743;5382;1439;4846;437;1600;389;1302;826;2902
353160;201501;611;1745;449;1414;120;382;83;222;203;604
353170;201501;457;1583;415;1511;127;536;183;638;310;1174
353180;201501;5873;18136;5104;16751;774;2917;3115;9980;3889;12897
353190;201501;3400;10632;2938;9615;598;2232;1447;4399;2045;6631
353200;201501;904;3065;761;2731;239;937;218;746;457;1683
353205;201501;496;1593;415;1421;87;304;165;567;252;871
353210;201501;956;2439;731;2048;38;141;539;1499;577;1640
353215;201501;469;1508;407;1367;70;277;140;419;210;696
353220;201501;694;2140;577;1886;127;442;184;572;311;1014
353230;201501;969;3079;884;2931;232;857;254;769;486;1626
353240;201501;2026;6537;1834;6159;472;1795;884;2779;1356;4574
353250;201501;1064;2909;850;2540;158;506;382;1096;540;1602
353260;201501;877;2392;682;2089;113;413;340;971;453;1384
353270;201501;621;1875;539;1711;152;524;176;513;328;1037
353280;201501;582;1897;498;1736;146;566;144;477;290;1043
353282;201501;1580;5098;1508;4979;255;974;922;2906;1177;3880
353284;201501;300;833;195;623;44;143;55;179;99;322
353286;201501;143;419;99;318;25;83;13;42;38;125
353290;201501;490;1597;406;1455;119;474;185;629;304;1103
353300;201501;1492;4657;1261;4151;310;1154;475;1366;785;2520
353310;201501;215;650;187;597;55;197;74;209;129;406
353320;201501;498;1429;434;1321;84;285;236;692;320;977
353325;201501;528;1766;434;1563;80;324;71;213;151;537
353330;201501;576;1660;389;1239;76;286;181;513;257;799
353340;201501;2355;7249;1912;6400;583;2092;773;2556;1356;4648
353350;201501;3121;9415;2651;8576;849;2966;1174;3665;2023;6631
353360;201501;378;1245;330;1138;54;219;201;666;255;885
353370;201501;630;2071;552;1877;82;322;316;1042;398;1364
353380;201501;330;1091;287;1016;64;280;127;409;191;689
353390;201501;5728;15399;4082;12484;839;2923;1532;4243;2371;7166
353400;201501;493;1462;404;1283;106;382;113;301;219;683
353410;201501;594;1739;489;1572;111;402;273;866;384;1268
353420;201501;540;1506;395;1165;102;309;130;351;232;660
353430;201501;2395;8301;1764;6556;439;1708;170;571;609;2279
353440;201501;57475;186098;49964;168721;13931;49845;17184;56201;31115;106046
353450;201501;440;1346;374;1218;90;333;158;492;248;825
353460;201501;3551;9895;3052;9051;493;1608;1569;4716;2062;6324
353470;201501;9179;27924;6792;23111;1604;6189;1725;5488;3329;11677
353475;201501;1629;4655;1151;3625;225;780;332;943;557;1723
353480;201501;1455;4349;1287;4037;249;880;747;2252;996;3132
353490;201501;1151;3204;912;2749;209;706;336;903;545;1609
353500;201501;913;2529;792;2319;246;762;340;955;586;1717
353510;201501;1072;3422;862;2884;192;727;259;729;451;1456
353520;201501;1099;3239;877;2861;220;803;333;1078;553;1881
353530;201501;2526;7520;2249;7018;432;1558;1175;3522;1607;5080
353540;201501;1948;5896;1714;5499;445;1526;766;2447;1211;3973
353550;201501;6064;16894;5268;15665;675;2438;3337;9451;4012;11889
353560;201501;2151;7108;1801;6497;452;1819;650;2292;1102;4111
353570;201501;397;1218;331;1080;56;210;208;637;264;847
353580;201501;2173;6976;2020;6719;424;1634;1250;4066;1674;5700
353590;201501;690;1978;541;1721;168;582;164;519;332;1101
353600;201501;1695;4814;1532;4540;248;833;869;2514;1117;3347
353610;201501;582;1946;447;1650;93;412;130;434;223;846
353620;201501;2164;7172;1875;6616;544;2058;606;2016;1150;4074
353625;201501;275;750;180;583;47;171;65;199;112;370
353630;201501;1634;5599;1259;4659;259;1036;180;575;439;1611
353640;201501;1321;3818;1109;3372;189;579;584;1741;773;2320
353650;201501;6615;19979;4902;16322;1046;3782;1620;5101;2666;8883
353657;201501;317;989;283;918;48;185;117;350;165;535
353660;201501;1246;3225;916;2683;384;1232;162;343;546;1575
353670;201501;3898;12665;3314;11396;977;3812;1068;3315;2045;7127
353680;201501;635;2161;579;2059;264;1011;204;700;468;1711
353690;201501;548;1451;348;1106;67;262;135;381;202;643
353700;201501;2170;6753;1879;6163;368;1348;734;2260;1102;3608
353710;201501;2935;7146;1326;4425;287;1023;281;888;568;1911
353715;201501;442;1301;361;1152;59;207;162;496;221;703
353720;201501;2017;6341;1751;5950;296;1143;1041;3497;1337;4640
353730;201501;4451;13656;3494;11579;789;2852;992;2978;1781;5830
353740;201501;2036;6136;1612;5271;485;1662;479;1527;964;3189
353750;201501;776;2643;609;2248;135;573;175;631;310;1204
353760;201501;8490;24843;6938;22315;1561;5510;3571;11398;5132;16908
353770;201501;805;2450;507;1731;101;377;43;75;144;452
353780;201501;4348;15002;3798;13923;1422;5541;1065;3906;2487;9447
353790;201501;1835;6462;1546;5867;453;1943;350;1296;803;3239
353800;201501;14829;46662;11781;40985;3128;12055;4527;15251;7655;27306
353810;201501;1021;3290;833;2885;197;777;301;987;498;1764
353820;201501;1179;4065;1081;3829;287;1190;509;1649;796;2839
353830;201501;746;2030;590;1756;110;354;267;780;377;1134
353850;201501;1599;5119;1473;4900;278;1028;761;2424;1039;3452
353860;201501;2460;8280;2067;7359;581;2223;560;1929;1141;4152
353870;201501;23744;72773;17810;60761;4022;15340;5788;17846;9810;33186
353880;201501;2400;7586;2017;6940;294;1236;1152;3881;1446;5117
353890;201501;2617;6506;1829;5237;383;1211;871;2386;1254;3597
353900;201501;1047;3279;773;2683;179;697;199;602;378;1299
353910;201501;1147;4222;1116;4159;314;1260;658;2395;972;3655
353920;201501;2370;7066;1768;5809;416;1465;307;886;723;2351
353930;201501;3576;12239;2907;10789;880;3516;673;2446;1553;5962
353940;201501;1230;3933;1027;3489;187;758;443;1375;630;2133
353950;201501;3438;10949;3142;10453;438;1723;2103;6789;2541;8512
353960;201501;581;1851;456;1575;95;362;124;362;219;724
353970;201501;541;1599;471;1502;42;160;351;1109;393;1269
353980;201501;13081;39354;11354;36178;2540;8733;5827;18274;8367;27007
353990;201501;345;1086;312;1012;75;285;110;307;185;592
354000;201501;1927;5570;1323;4392;292;1072;139;412;431;1484
354010;201501;358;1085;311;1007;93;311;143;472;236;783
354020;201501;4613;14080;4111;12994;1119;3899;1732;5054;2851;8953
354025;201501;892;2558;699;2229;173;598;199;612;372;1210
354030;201501;519;1414;368;1164;78;281;156;451;234;732
354040;201501;774;2094;596;1766;66;246;335;910;401;1156
354050;201501;949;3075;828;2836;256;984;266;879;522;1863
354060;201501;5111;15897;3642;12666;898;3384;1286;4302;2184;7686
354070;201501;3062;10121;2663;9253;758;2849;583;1966;1341;4815
354075;201501;2076;7775;1978;7599;581;2483;915;3471;1496;5954
354080;201501;1676;5177;1219;4115;277;1008;299;871;576;1879
354085;201501;290;756;262;711;20;76;209;546;229;622
354090;201501;1260;3762;1196;3663;130;442;908;2786;1038;3228
354100;201501;15625;52728;13240;48240;3396;13214;5995;21648;9391;34862
354105;201501;828;2576;725;2378;137;541;376;1137;513;1678
354110;201501;792;2248;648;2050;200;726;217;630;417;1356
354120;201501;1911;5297;1513;4559;309;1063;617;1691;926;2754
354130;201501;5622;16594;4565;14517;1848;6287;921;2569;2769;8856
354140;201501;24704;62864;15544;46154;3096;10105;5594;15390;8690;25495
354150;201501;4094;11108;3129;9409;684;2314;1456;4191;2140;6505
354160;201501;3644;11944;3139;10853;840;3172;1293;4325;2133;7497
354165;201501;353;1297;317;1210;103;438;90;339;193;777
354170;201501;1441;4518;1162;3886;228;868;433;1264;661;2132
354180;201501;490;1489;466;1450;61;240;299;853;360;1093
354190;201501;1411;4666;1206;4217;369;1426;383;1250;752;2676
354200;201501;1078;3083;880;2729;159;561;371;1029;530;1590
354210;201501;703;2341;611;2163;112;489;296;957;408;1446
354220;201501;2820;8483;2472;7821;666;2359;1084;3273;1750;5632
354230;201501;612;2030;565;1955;110;434;284;957;394;1391
354240;201501;1146;3763;878;3152;188;763;205;663;393;1426
354250;201501;648;1924;451;1570;184;720;125;410;309;1130
354260;201501;7686;23605;6950;22395;2043;7208;2665;8475;4708;15683
354270;201501;1116;3890;993;3627;269;1096;399;1449;668;2545
354280;201501;672;2066;628;1989;95;383;438;1319;533;1702
354290;201501;1025;3556;943;3402;234;915;354;1264;588;2179
354300;201501;3480;11729;3364;11521;896;3276;1742;5847;2638;9123
354310;201501;860;2726;662;2313;184;701;215;739;399;1440
354320;201501;748;2210;636;1995;163;576;218;615;381;1191
354323;201501;386;1102;302;942;68;239;96;262;164;501
354325;201501;1189;3986;1043;3653;225;915;416;1329;641;2244
354330;201501;6646;20410;5628;18439;1175;4363;2850;8825;4025;13188
354340;201501;25917;81412;21289;73142;6944;25894;7745;25849;14689;51743
354350;201501;1098;3291;1024;3159;269;916;533;1572;802;2488
354360;201501;430;1389;338;1212;72;276;30;104;102;380
354370;201501;1191;4032;1048;3754;149;651;653;2261;802;2912
354380;201501;1050;3139;844;2778;269;1051;138;356;407;1407
354390;201501;11699;36454;8562;29854;1974;7541;2051;6828;4025;14369
354400;201501;1716;5971;1425;5288;325;1300;466;1658;791;2958
354410;201501;5440;16706;4574;15228;921;3387;2339;7686;3260;11073
354420;201501;1250;3792;980;3202;258;925;372;1133;630;2058
354425;201501;2623;7427;2237;6746;711;2309;601;1752;1312;4061
354430;201501;1226;4048;1152;3920;290;1117;545;1773;835;2890
354440;201501;512;1517;396;1291;49;196;200;600;249;796
354450;201501;458;1329;278;941;43;180;66;195;109;375
354460;201501;800;2225;622;1925;197;663;252;750;449;1413
354470;201501;524;1489;412;1263;61;248;187;492;248;740
354480;201501;699;1986;601;1833;99;354;348;1014;447;1368
354490;201501;701;2313;558;1985;123;487;193;614;316;1101
354500;201501;2077;7025;1850;6606;711;2907;385;1246;1096;4153
354510;201501;657;1990;576;1843;103;350;366;1173;469;1523
354515;201501;315;1058;250;908;49;206;86;282;135;488
354520;201501;6236;20662;3888;13944;878;3638;1517;5109;2395;8747
354530;201501;2647;9358;2457;8984;651;2650;1225;4390;1876;7040
354540;201501;1202;3644;987;3240;363;1327;201;592;564;1919
354550;201501;468;1452;411;1338;71;245;209;660;280;905
354560;201501;1488;4404;1114;3592;245;805;401;1242;646;2047
354570;201501;699;2100;516;1695;132;458;80;231;212;689
354580;201501;9802;28528;7876;24964;1627;5808;3503;10496;5130;16304
354600;201501;1554;5230;1379;4893;339;1441;655;2174;994;3615
354610;201501;404;1162;263;840;38;114;58;155;96;269
354620;201501;373;1237;305;1112;85;369;125;425;210;794
354625;201501;253;844;211;759;51;209;64;219;115;428
354630;201501;1930;6529;1742;6124;792;2841;487;1638;1279;4479
354640;201501;3528;11569;2874;10166;724;2957;693;2182;1417;5139
354650;201501;864;2623;778;2457;100;360;505;1559;605;1919
354660;201501;2272;6701;1794;5868;371;1353;924;3012;1295;4365
354670;201501;1632;5324;1342;4606;378;1426;333;992;711;2418
354680;201501;4629;15524;4204;14636;1098;4198;1691;5663;2789;9861
354690;201501;764;2485;538;1941;100;381;168;574;268;955
354700;201501;1195;3387;810;2568;141;540;344;925;485;1465
354710;201501;511;1511;429;1351;82;305;193;547;275;852
354720;201501;195;545;151;460;49;145;40;119;89;264
354730;201501;7557;25175;5980;21813;1520;6086;2452;8629;3972;14715
354740;201501;243;729;173;606;38;138;46;166;84;304
354750;201501;2363;7261;1867;6440;558;2166;692;2311;1250;4477
354760;201501;1990;6457;1634;5670;475;1785;324;1037;799;2822
354765;201501;223;615;142;459;29;101;25;74;54;175
354770;201501;2137;6107;1690;5372;699;2388;363;1092;1062;3480
354780;201501;36557;110326;32712;101920;6809;23713;16428;48611;23237;72324
354790;201501;751;2402;640;2206;127;515;325;1036;452;1551
354800;201501;1829;5367;1627;5104;345;1219;1026;3212;1371;4431
354805;201501;924;2807;677;2255;82;296;128;387;210;683
354810;201501;601;1942;394;1434;94;396;72;210;166;606
354820;201501;1027;3564;901;3307;224;966;269;885;493;1851
354830;201501;388;1125;308;982;82;292;151;442;233;734
354840;201501;649;1898;554;1731;138;472;266;810;404;1282
354850;201501;15858;50359;12092;42678;3024;11901;4402;14413;7426;26314
354860;201501;1266;4091;1134;3865;247;987;546;1768;793;2755
354870;201501;40890;126209;37460;119073;9444;32153;17358;54179;26802;86332
354880;201501;3766;10889;2444;8075;496;1852;672;1823;1168;3675
354890;201501;15487;46506;13084;41951;3493;12028;4461;13826;7954;25854
354900;201501;465;1368;381;1232;107;374;147;470;254;844
354910;201501;6421;19267;3727;13288;658;2654;303;1003;961;3657
354920;201501;429;1273;333;1104;89;336;88;273;177;609
354925;201501;355;1020;221;753;35;138;35;97;70;235
354930;201501;214;602;158;506;37;128;76;237;113;365
354940;201501;2214;7889;1761;6672;624;2527;241;825;865;3352
354950;201501;1426;4641;1260;4416;176;731;827;2873;1003;3604
354960;201501;761;2404;667;2252;184;695;271;887;455;1582
354970;201501;4019;13177;3526;12166;637;2577;1939;6413;2576;8990
354980;201501;33179;82557;19684;59904;4039;13896;6611;18601;10650;32497
354990;201501;42514;131100;35560;117001;7053;25701;18324;58411;25377;84112
354995;201501;1621;5093;1503;4933;327;1195;868;2818;1195;4013
355000;201501;1398;4579;1212;4258;381;1519;223;677;604;2196
355010;201501;3520;10970;2862;9522;751;2713;1176;3859;1927;6572
355020;201501;2854;9760;2333;8732;1021;4144;550;2008;1571;6152
355030;201501;905366;2620482;803670;2420741;197451;649074;356623;1036947;554074;1686021
355040;201501;2519;7791;2226;7274;558;2046;1195;3781;1753;5827
355050;201501;1199;3726;971;3266;307;1104;227;760;534;1864
355060;201501;5083;17292;4133;15252;1062;4404;1011;3413;2073;7817
355070;201501;6626;20686;5951;19611;1318;5086;3192;9835;4510;14921
355080;201501;1141;3971;855;3273;198;877;117;359;315;1236
355090;201501;1098;3869;936;3497;204;842;395;1427;599;2269
355100;201501;20480;64647;17393;59480;5197;19335;7001;23528;12198;42863
355110;201501;1157;3990;1049;3761;311;1242;365;1263;676;2505
355120;201501;628;2013;537;1841;134;527;242;793;376;1320
355130;201501;555;1433;300;883;48;165;115;283;163;448
355140;201501;992;3397;953;3322;233;904;483;1686;716;2590
355150;201501;3146;9586;2703;8841;667;2344;1343;4308;2010;6652
355160;201501;1514;4940;1301;4605;477;1919;400;1272;877;3191
355170;201501;9519;26508;6849;21834;2140;7378;1764;5576;3904;12954
355180;201501;2837;8778;2378;7931;615;2416;875;2663;1490;5079
355190;201501;1234;4240;1057;3859;407;1579;332;1159;739;2738
355200;201501;767;2786;713;2685;301;1215;182;655;483;1870
355210;201501;2488;8258;2245;7758;520;2113;1130;3653;1650;5766
355220;201501;27392;86581;23374;79104;8680;31139;5960;19725;14640;50864
355230;201501;1340;3771;756;2468;115;392;182;527;297;919
355240;201501;25459;74471;18355;59937;4003;14426;6823;20994;10826;35420
355250;201501;25357;83842;22707;78726;6824;25113;9513;32630;16337;57743
355255;201501;800;2269;573;1801;118;407;162;454;280;861
355260;201501;1347;3899;1203;3648;298;1038;500;1361;798;2399
355270;201501;1498;4551;1435;4459;133;523;1159;3520;1292;4043
355280;201501;23145;68580;19590;61901;4147;14888;8732;26196;12879;41084
355290;201501;791;2500;712;2368;144;520;342;1101;486;1621
355300;201501;984;3220;804;2835;193;739;266;893;459;1632
355310;201501;995;3097;845;2822;155;562;436;1465;591;2027
355320;201501;596;1862;513;1675;99;399;203;554;302;953
355330;201501;1760;5593;1261;4607;333;1378;404;1413;737;2791
355340;201501;2524;6702;2315;6345;413;1247;1406;3726;1819;4973
355350;201501;1242;4300;1066;3932;303;1246;344;1191;647;2437
355360;201501;1098;3636;1008;3457;166;611;702;2453;868;3064
355365;201501;270;861;225;773;51;206;66;216;117;422
355370;201501;7072;17614;5069;15182;1424;4670;2185;6690;3609;11360
355380;201501;3387;10268;2644;8557;688;2497;553;1485;1241;3982
355385;201501;813;2613;759;2523;298;1090;246;748;544;1838
355390;201501;946;2706;772;2373;164;583;358;989;522;1572
355395;201501;1799;5417;1378;4490;233;845;588;1772;821;2617
355400;201501;8464;28169;7431;26109;2314;8905;2612;8776;4926;17681
355410;201501;14148;49036;12227;45002;4315;17224;3009;11134;7324;28358
355420;201501;750;2675;700;2562;244;972;224;818;468;1790
355430;201501;3514;10092;2973;9172;568;1976;1558;4623;2126;6599
355440;201501;849;2761;684;2347;137;508;208;632;345;1140
355450;201501;2373;7579;1842;6345;416;1591;618;1987;1034;3578
355460;201501;576;1579;422;1308;89;334;149;388;238;722
355465;201501;387;1183;329;1072;82;289;79;248;161;537
355470;201501;817;2522;670;2246;159;611;281;882;440;1493
355475;201501;111;435;99;399;20;84;41;172;61;256
355480;201501;3063;11131;2891;10766;839;3347;1357;4974;2196;8321
355490;201501;916;2647;670;2172;150;511;133;419;283;930
355495;201501;679;2295;617;2173;140;575;237;817;377;1392
355500;201501;8073;23356;5271;17322;951;3539;1134;3377;2085;6916
355510;201501;1992;5370;1209;3820;214;814;396;1113;610;1927
355520;201501;432;1081;251;729;42;142;98;255;140;397
355530;201501;315;740;135;419;15;48;38;120;53;168
355535;201501;704;2164;569;1918;166;641;146;410;312;1051
355540;201501;8278;26368;7834;25641;1957;6898;4296;13698;6253;20596
355550;201501;749;2240;653;2100;148;559;310;959;458;1518
355560;201501;1283;3839;925;3084;202;783;183;466;385;1249
355570;201501;182;572;144;494;23;82;25;64;48;146
355580;201501;1056;3040;819;2586;193;692;365;1112;558;1804
355590;201501;217;597;189;542;29;92;110;313;139;405
355600;201501;1121;3592;952;3227;373;1391;232;737;605;2128
355610;201501;1325;3754;1119;3423;234;805;539;1601;773;2406
355620;201501;3964;12520;3184;10755;653;2516;1349;4201;2002;6717
355630;201501;3313;9466;2068;6879;386;1460;610;1822;996;3282
355635;201501;929;3044;803;2830;101;419;547;1929;648;2348
355640;201501;3249;10622;2548;9124;601;2430;393;1267;994;3697
355645;201501;3116;10962;2882;10561;491;1993;1830;6720;2321;8713
355650;201501;6715;20872;5844;19206;968;3827;3538;10919;4506;14746
355660;201501;1201;3785;975;3333;240;978;424;1357;664;2335
355670;201501;2407;7610;1692;5936;377;1550;643;1993;1020;3543
355680;201501;1435;4800;1105;4026;388;1526;253;867;641;2393
355690;201501;403;1262;297;1081;187;723;25;69;212;792
355695;201501;323;965;203;673;15;46;19;35;34;81
355700;201501;5701;19433;4954;17696;1347;5224;1982;6773;3329;11997
355710;201501;11315;28470;6931;20549;1860;5990;1845;5105;3705;11095
355715;201501;255;782;163;575;30;125;35;101;65;226
355720;201501;1575;5179;1315;4623;396;1533;383;1197;779;2730
355730;201501;714;2450;629;2264;213;786;141;506;354;1292
410010;201501;1470;4726;1310;4403;333;1229;404;1333;737;2562
410020;201501;1111;3799;1011;3589;277;1065;400;1379;677;2444
410030;201501;1089;3748;925;3347;269;1034;163;581;432;1615
410040;201501;9893;33169;8833;31057;2686;10612;2545;8536;5231;19148
410045;201501;999;2851;711;2283;185;657;216;634;401;1291
410050;201501;2199;6265;1443;4772;395;1385;277;858;672;2243
410060;201501;2152;6781;1932;6359;525;1902;785;2573;1310;4475
410070;201501;1724;4949;1343;4194;454;1583;289;766;743;2349
410080;201501;1167;3602;1011;3301;171;660;521;1587;692;2247
410090;201501;1031;3267;930;3071;275;1020;330;1043;605;2063
410100;201501;2450;7493;1816;6045;515;1944;242;749;757;2693
410105;201501;413;1319;294;1033;60;249;43;110;103;359
410110;201501;2495;7522;2079;6734;428;1613;745;2281;1173;3894
410115;201501;498;1369;384;1146;60;200;152;416;212;616
410120;201501;2496;8614;2359;8410;784;2952;1053;3836;1837;6788
410130;201501;1151;3769;1030;3491;350;1215;341;1120;691;2335
410140;201501;15595;41730;10760;33059;2483;8563;3474;10459;5957;19022
410150;201501;16896;41874;8423;25080;1745;5765;1615;4266;3360;10031
410160;201501;2939;9299;2658;8827;797;2959;1000;3314;1797;6273
410165;201501;731;2156;590;1854;145;487;254;759;399;1246
410170;201501;1883;5573;1540;4899;503;1775;405;1223;908;2998
410180;201501;9563;30735;8367;28174;2065;7859;3470;10859;5535;18718
410185;201501;552;1529;470;1380;110;333;206;587;316;920
410190;201501;1954;5804;1629;5066;421;1440;382;1080;803;2520
410200;201501;3722;10523;2718;8515;634;2220;365;1037;999;3257
410210;201501;2403;7257;1858;6088;345;1326;423;1120;768;2446
410220;201501;626;1809;452;1452;91;329;134;403;225;732
410230;201501;1454;4688;1269;4357;410;1599;500;1616;910;3215
410240;201501;4187;12934;3762;12051;1100;3981;1296;3906;2396;7887
410250;201501;2470;6939;1702;5345;487;1701;325;922;812;2623
410260;201501;1540;4753;1310;4316;355;1281;486;1557;841;2838
410270;201501;500;1460;404;1271;80;296;167;493;247;789
410275;201501;854;2600;601;2034;97;357;298;1004;395;1361
410280;201501;2834;8399;2059;6757;441;1660;433;1297;874;2957
410290;201501;3292;9972;2815;9065;689;2424;1225;3938;1914;6362
410300;201501;652;1838;573;1675;77;260;287;754;364;1014
410302;201501;352;951;243;770;29;104;139;440;168;544
410304;201501;1238;4017;1124;3774;321;1117;445;1553;766;2670
410305;201501;1921;5102;1593;4598;418;1313;926;2656;1344;3969
410310;201501;2130;7050;1922;6684;459;1779;787;2703;1246;4482
410315;201501;696;2057;479;1633;109;386;146;471;255;857
410320;201501;1255;3719;815;2747;140;526;66;186;206;712
410322;201501;578;1716;416;1370;110;365;108;332;218;697
410330;201501;1264;3483;1051;3084;249;807;388;1090;637;1897
410335;201501;950;2828;816;2591;189;679;317;949;506;1628
410337;201501;760;2034;573;1668;88;313;243;615;331;928
410340;201501;504;1507;373;1164;49;188;150;392;199;580
410345;201501;1793;5235;1373;4367;368;1282;380;1120;748;2402
410347;201501;666;1820;427;1377;70;273;150;467;220;740
410350;201501;897;2727;619;2147;138;554;100;307;238;861
410360;201501;3092;9071;2612;8241;565;1963;1118;3447;1683;5410
410370;201501;11952;34851;8793;27796;1949;7070;2540;7065;4489;14135
410380;201501;1118;3538;999;3284;164;617;523;1609;687;2226
410390;201501;2747;7973;2193;6944;780;2684;578;1636;1358;4320
410395;201501;859;2887;766;2688;177;730;361;1250;538;1980
410400;201501;4576;14624;4003;13485;1006;3912;1453;4615;2459;8527
410405;201501;943;2734;757;2381;181;668;297;887;478;1555
410410;201501;1240;4116;1175;4017;411;1600;376;1183;787;2783
410420;201501;7704;25183;6560;22604;1969;7441;1367;4230;3336;11671
410425;201501;3255;10361;2359;8325;475;1861;300;993;775;2854
410430;201501;14662;40128;10716;32730;2472;8414;3381;10034;5853;18448
410440;201501;3062;9751;2731;9125;691;2570;1225;4013;1916;6583
410442;201501;2681;9174;2394;8510;758;2857;750;2659;1508;5516
410445;201501;2210;7412;1912;6871;540;2148;699;2599;1239;4747
410450;201501;2259;6453;1793;5572;603;1968;327;900;930;2868
410460;201501;2171;6496;1795;5765;451;1544;631;1900;1082;3444
410465;201501;1869;6498;1561;5803;420;1773;582;1962;1002;3735
410470;201501;1497;4860;1254;4314;314;1230;338;1130;652;2360
410480;201501;28467;81593;21013;66387;6045;20954;4368;12806;10413;33760
410490;201501;10772;34545;8609;29898;2389;9311;2498;8147;4887;17458
410500;201501;1565;4934;1285;4321;459;1708;384;1265;843;2973
410510;201501;2430;6495;1748;5128;372;1172;706;1872;1078;3044
410520;201501;3101;10899;2938;10559;1031;3948;1075;3857;2106;7805
410530;201501;1547;4352;1244;3750;245;871;537;1507;782;2378
410540;201501;3321;9887;2342;7844;550;1979;754;2497;1304;4476
410550;201501;6163;17962;4279;13871;901;3313;720;2075;1621;5388
410560;201501;1347;4160;1028;3452;255;968;277;730;532;1698
410570;201501;2476;8091;2231;7677;633;2294;853;3141;1486;5435
410580;201501;21475;66758;17982;59611;5113;18884;4928;15157;10041;34041
410590;201501;1290;4060;816;2734;130;461;179;525;309;986
410600;201501;1870;5530;1537;4879;356;1187;651;2080;1007;3267
410610;201501;743;2236;614;1987;106;417;268;810;374;1227
410620;201501;1402;5063;1165;4414;363;1464;181;653;544;2117
410630;201501;2420;7213;1824;5906;450;1616;434;1227;884;2843
410640;201501;4436;12548;3408;10621;1016;3661;776;2225;1792;5886
410645;201501;1097;3871;1046;3791;482;1899;286;1015;768;2914
410650;201501;2274;7033;1847;6130;630;2207;365;1157;995;3364
410655;201501;819;2443;654;2121;161;595;225;691;386;1286
410657;201501;659;1900;476;1530;109;401;179;506;288;907
410660;201501;2785;8036;1911;6101;482;1664;391;1052;873;2716
410670;201501;900;2554;673;2112;169;582;185;521;354;1103
410680;201501;2643;9080;2203;7965;651;2357;709;2711;1360;5068
410685;201501;640;1847;560;1713;52;157;427;1327;479;1484
410690;201501;105963;308876;74204;242828;17246;62476;17346;51068;34592;113544
410700;201501;2225;6928;2078;6650;601;2115;895;2759;1496;4874
410710;201501;894;2742;654;2180;171;626;179;516;350;1142
410712;201501;806;2458;695;2248;276;978;212;709;488;1687
410715;201501;944;3004;767;2607;174;657;302;980;476;1637
410720;201501;3306;9756;2429;7909;588;2149;640;1917;1228;4066
410725;201501;1028;2912;738;2351;130;441;138;371;268;812
410730;201501;483;1440;427;1327;152;530;113;331;265;861
410740;201501;862;2552;606;2031;112;442;282;933;394;1375
410750;201501;1728;5101;1436;4499;343;1173;481;1390;824;2563
410752;201501;271;776;178;574;37;145;70;196;107;341
410753;201501;446;1307;295;961;59;226;108;325;167;551
410754;201501;992;3074;868;2877;94;347;579;1978;673;2325
410755;201501;812;2077;635;1796;78;265;394;1074;472;1339
410760;201501;2095;6612;1913;6304;596;2136;742;2301;1338;4437
410765;201501;15790;47130;11680;38884;2581;9713;1579;4869;4160;14582
410770;201501;896;2503;686;2092;202;672;205;594;407;1266
410773;201501;1340;3900;1137;3585;253;925;609;1825;862;2750
410775;201501;1504;4414;1409;4277;320;1025;793;2397;1113;3422
410780;201501;511;1430;390;1226;109;343;160;563;269;906
410785;201501;694;2241;578;1960;234;842;132;444;366;1286
410790;201501;506;1587;420;1390;101;375;101;262;202;637
410800;201501;2631;6725;2030;5763;552;1808;790;2062;1342;3870
410810;201501;310;957;250;822;36;134;115;378;151;512
410820;201501;913;2758;721;2317;184;643;155;456;339;1099
410830;201501;31060;91027;25352;81072;7573;26886;8898;27749;16471;54635
410832;201501;983;2942;862;2718;134;511;500;1470;634;1981
410840;201501;6698;19880;4586;15390;1297;4756;588;1731;1885;6487
410845;201501;1315;3893;1105;3447;188;674;523;1555;711;2229
410850;201501;2759;8194;2471;7756;548;1982;1342;4197;1890;6179
410855;201501;558;1547;407;1224;96;332;159;410;255;742
410860;201501;3785;10687;3121;9454;606;1988;1463;4419;2069;6407
410865;201501;1617;5584;1507;5369;378;1442;834;3031;1212;4473
410870;201501;1209;3738;1119;3597;541;1837;363;1134;904;2971
410880;201501;4178;12799;3348;11244;775;2925;764;2334;1539;5259
410890;201501;1007;3215;788;2786;192;745;73;219;265;964
410895;201501;1057;3704;954;3481;359;1418;280;960;639;2378
410900;201501;814;2285;595;1916;122;477;213;629;335;1106
410910;201501;406;1083;343;978;54;186;187;503;241;689
410920;201501;740;2218;600;1969;147;548;235;730;382;1278
410930;201501;1762;5244;1489;4762;368;1409;606;1891;974;3300
410940;201501;20100;66768;17721;62425;5320;20679;6642;23587;11962;44266
410950;201501;1777;5913;1640;5672;320;1162;1038;3625;1358;4787
410960;201501;7027;19531;4600;14967;1416;5085;1226;3853;2642;8938
410965;201501;996;3098;880;2876;302;1038;338;1082;640;2120
410970;201501;4395;13317;3507;11559;1110;4194;736;2363;1846;6557
410975;201501;1525;4431;1251;3951;217;804;572;1796;789;2600
410980;201501;5724;16306;3575;11921;793;2928;616;1960;1409;4888
410990;201501;846;2473;528;1769;169;622;91;238;260;860
411000;201501;460;1392;322;1076;71;270;49;133;120;403
411005;201501;481;1425;318;1034;80;268;50;138;130;406
411007;201501;2177;6986;1931;6436;554;1954;720;2402;1274;4356
411010;201501;3684;12758;3334;12014;1114;4564;729;2403;1843;6967
411020;201501;2557;8112;2297;7671;784;2952;760;2501;1544;5453
411030;201501;635;1738;509;1507;127;430;159;422;286;852
411040;201501;535;1585;292;957;68;249;68;210;136;459
411050;201501;2079;7387;1858;6896;574;2330;310;1058;884;3388
411060;201501;1583;4949;1324;4397;306;1111;194;557;500;1668
411065;201501;363;1113;288;960;55;190;118;378;173;568
411070;201501;5315;16561;4024;13825;1136;4325;621;1887;1757;6212
411080;201501;2101;6467;1883;6055;532;1913;578;1761;1110;3674
411090;201501;709;1758;527;1496;91;334;134;335;225;669
411095;201501;1569;4409;1162;3606;243;861;311;873;554;1734
411100;201501;1355;3964;1012;3287;199;749;207;586;406;1335
411110;201501;693;2069;461;1548;77;280;76;204;153;484
411120;201501;1736;5294;1358;4491;389;1414;432;1348;821;2762
411125;201501;4058;13421;3930;13171;1231;4452;1727;5626;2958;10078
411130;201501;704;2150;572;1864;134;469;177;586;311;1055
411140;201501;2085;7428;1802;6755;626;2452;505;1969;1131;4421
411150;201501;4460;12574;3459;10560;904;3084;741;1918;1645;5002
411155;201501;928;2580;740;2224;167;575;321;873;488;1448
411160;201501;223;647;188;575;40;137;71;198;111;335
411170;201501;661;2185;557;1940;134;511;210;700;344;1211
411180;201501;5531;16666;4687;15118;1188;4289;1602;5025;2790;9314
411190;201501;1424;4075;1194;3650;295;1065;366;997;661;2062
411200;201501;4361;12987;3544;11614;979;3623;1391;4388;2370;8011
411210;201501;2058;5978;1655;5249;619;2101;285;862;904;2963
411220;201501;1120;3210;921;2848;222;813;403;1124;625;1937
411230;201501;1190;3365;759;2477;213;787;172;492;385;1279
411240;201501;1285;3059;707;2130;160;512;225;630;385;1142
411250;201501;2440;7240;2057;6534;569;1961;606;1893;1175;3854
411260;201501;300;826;196;637;33;120;89;279;122;399
411270;201501;1761;5640;1590;5316;358;1381;780;2490;1138;3871
411275;201501;1368;4116;1153;3627;315;1063;293;861;608;1924
411280;201501;1434;4342;1062;3543;240;922;219;648;459;1570
411290;201501;758;2198;628;1929;156;504;243;730;399;1234
411295;201501;851;2442;775;2293;148;470;353;1058;501;1528
411300;201501;1196;3081;857;2416;85;275;384;1003;469;1278
411310;201501;810;2299;628;1982;92;333;252;783;344;1116
411320;201501;5571;16333;4155;13580;1143;3936;939;2908;2082;6844
411325;201501;1569;4959;1394;4619;257;964;820;2693;1077;3657
411330;201501;3291;10358;2838;9517;1012;3745;855;2780;1867;6525
411340;201501;911;2669;589;1927;109;413;231;727;340;1140
411342;201501;695;1998;570;1733;146;494;173;442;319;936
411345;201501;959;3016;879;2868;245;886;428;1402;673;2288
411350;201501;2761;8198;1912;6436;521;1952;234;731;755;2683
411360;201501;595;1509;388;1127;48;183;167;398;215;581
411370;201501;46173;132201;35628;112601;6924;25588;13286;38612;20210;64200
411373;201501;1399;4418;1174;3973;310;1186;325;1070;635;2256
411375;201501;1142;3197;889;2711;213;692;315;909;528;1601
411380;201501;1270;3415;779;2372;125;427;245;684;370;1111
411390;201501;1673;4971;1445;4579;341;1209;607;1826;948;3035
411400;201501;1927;5641;1462;4610;302;1064;396;1140;698;2204
411410;201501;2060;6231;1609;5177;415;1532;451;1223;866;2755
411420;201501;4168;12144;3097;9755;621;2230;577;1418;1198;3648
411430;201501;2991;9476;2545;8689;752;2794;1071;3592;1823;6386
411435;201501;398;1298;326;1108;87;323;130;414;217;737
411440;201501;2710;8808;2464;8332;888;3189;726;2561;1614;5750
411450;201501;2188;6739;1991;6380;441;1466;1157;3744;1598;5210
411460;201501;3209;9518;1862;6318;418;1589;230;630;648;2219
411470;201501;849;2544;572;1878;105;380;107;292;212;672
411480;201501;4146;12642;3181;10733;1040;3983;634;1974;1674;5957
411490;201501;1404;4307;1199;3939;366;1384;329;936;695;2320
411500;201501;1800;4983;1277;4017;328;1146;329;1000;657;2146
411510;201501;2040;6139;1627;5315;498;1811;376;1036;874;2847
411520;201501;26160;71563;16133;50513;3489;12058;3531;10264;7020;22322
411530;201501;957;2758;669;2235;232;872;107;289;339;1161
411535;201501;505;1507;241;865;40;164;27;73;67;237
411540;201501;2830;7625;2133;6345;318;1031;1080;3189;1398;4220
411545;201501;949;3247;873;3099;153;591;590;2120;743;2711
411550;201501;783;2135;622;1884;246;818;150;441;396;1259
411560;201501;2384;7190;1851;5941;437;1543;376;1061;813;2604
411570;201501;6268;17199;4649;14528;1242;4353;1081;3457;2323;7810
411573;201501;898;2735;852;2658;160;536;531;1664;691;2200
411575;201501;1385;4423;1176;3979;245;893;441;1479;686;2372
411580;201501;3632;10563;2589;8441;518;2008;417;1091;935;3099
411585;201501;536;1807;355;1270;90;347;63;211;153;558
411590;201501;408;1248;355;1153;76;283;165;508;241;791
411600;201501;283;849;211;718;48;197;78;254;126;451
411605;201501;2010;5460;1363;4198;235;831;573;1682;808;2513
411610;201501;2107;5896;1842;5507;335;1088;1249;3697;1584;4785
411620;201501;2625;8447;2454;8159;718;2558;1144;3862;1862;6420
411630;201501;442;1140;258;848;47;194;51;152;98;346
411640;201501;494;1492;398;1302;86;310;150;437;236;747
411650;201501;185;615;160;572;39;167;62;202;101;369
411660;201501;789;2251;631;1943;133;452;276;846;409;1298
411670;201501;1212;3389;1025;3004;252;856;420;1128;672;1984
411680;201501;1379;4344;1246;4096;211;669;855;2937;1066;3606
411690;201501;3309;9946;2707;8821;771;2659;692;2294;1463;4953
411695;201501;736;2388;601;2105;142;543;207;736;349;1279
411700;201501;1785;5238;1301;4266;283;1036;335;1010;618;2046
411705;201501;2127;7279;1878;6778;428;1561;1040;3883;1468;5444
411710;201501;1739;5228;1370;4436;321;1132;383;1153;704;2285
411720;201501;770;2276;594;1891;101;356;154;444;255;800
411721;201501;698;2122;597;1930;175;624;108;310;283;934
411722;201501;656;1938;493;1586;101;377;143;393;244;770
411725;201501;1364;4409;868;3136;200;761;184;654;384;1415
411727;201501;1904;5587;1526;4792;358;1225;589;1733;947;2958
411729;201501;515;1402;374;1157;121;418;106;288;227;706
411730;201501;5358;15624;4553;14129;1997;6371;1262;4013;3259;10384
411740;201501;579;1689;394;1267;67;248;151;459;218;707
411745;201501;873;2648;713;2310;160;545;213;675;373;1220
411750;201501;4376;13277;3329;10819;876;3207;709;2103;1585;5310
411760;201501;7657;22744;6748;21214;2270;7793;2115;6636;4385;14429
411770;201501;3257;11149;2777;10018;947;3682;584;2082;1531;5764
411780;201501;2593;8453;2488;8340;185;554;2074;7333;2259;7887
411790;201501;2800;8068;2099;6689;587;2193;683;2065;1270;4258
411800;201501;1389;4022;893;2910;133;509;162;428;295;937
411810;201501;1478;4422;1273;4016;320;1149;434;1212;754;2361
411820;201501;14927;47039;12453;42386;4287;15223;3382;11885;7669;27108
411830;201501;428;1163;337;1028;153;469;34;114;187;583
411840;201501;9723;28690;7595;24659;2077;7358;1946;6102;4023;13460
411845;201501;509;1587;362;1225;61;233;91;268;152;501
411850;201501;6258;18969;5281;17016;1409;4888;1545;4947;2954;9835
411860;201501;841;2654;689;2342;188;662;205;657;393;1319
411870;201501;893;3067;659;2426;105;438;182;638;287;1076
411880;201501;2097;6112;1720;5441;504;1836;435;1164;939;3000
411885;201501;800;2188;646;1904;137;524;240;617;377;1141
411890;201501;1097;3354;720;2449;135;511;121;343;256;854
411900;201501;953;3063;693;2420;190;670;112;397;302;1067
411910;201501;1173;3972;995;3571;308;1226;294;980;602;2206
411915;201501;13394;37843;8972;28718;1919;6808;2134;6252;4053;13060
411920;201501;927;3202;803;2895;226;943;137;416;363;1359
411925;201501;583;1666;399;1328;111;382;113;361;224;743
411930;201501;5924;19625;5305;18440;1734;6473;1862;6517;3596;12990
411940;201501;3212;10808;2801;9958;808;3083;695;2396;1503;5479
411950;201501;10915;34926;9183;31476;2387;8950;4128;13906;6515;22856
411960;201501;5030;15236;4616;14444;1158;4075;2084;6341;3242;10416
411965;201501;591;1669;438;1430;85;318;170;574;255;892
411970;201501;742;2135;598;1911;186;666;169;505;355;1171
411980;201501;1476;4591;1267;4150;220;774;515;1693;735;2467
411990;201501;26665;88905;22708;80621;6576;25977;6414;22443;12990;48420
411995;201501;2522;7865;2200;7225;779;2906;527;1584;1306;4490
412000;201501;2048;5435;1665;4793;305;1049;845;2209;1150;3258
412010;201501;710;2405;593;2139;153;577;123;408;276;985
412015;201501;654;1984;534;1731;101;350;259;837;360;1187
412020;201501;384;1096;262;838;73;267;98;280;171;547
412030;201501;670;2103;464;1621;91;378;129;406;220;784
412033;201501;682;2068;478;1585;97;364;112;323;209;687
412035;201501;950;2645;686;2171;160;556;277;828;437;1384
412040;201501;544;1787;460;1583;108;409;172;559;280;968
412050;201501;1689;5044;1336;4333;321;1200;277;844;598;2044
412060;201501;6959;24243;6381;23057;1927;7464;2462;8940;4389;16404
412065;201501;871;2648;696;2267;177;657;227;673;404;1330
412070;201501;1134;3109;919;2686;168;506;343;994;511;1500
412080;201501;1453;4485;881;3150;150;611;63;166;213;777
412085;201501;346;991;143;481;32;128;40;111;72;239
412090;201501;4234;13908;4028;13533;678;2540;2673;9035;3351;11575
412100;201501;1917;6153;1695;5727;538;1959;530;1728;1068;3687
412110;201501;1051;2996;701;2246;165;589;195;608;360;1197
412120;201501;1880;6394;1658;5883;432;1740;718;2382;1150;4122
412125;201501;749;2393;653;2233;145;531;282;976;427;1507
412130;201501;581;1762;451;1494;91;339;120;374;211;713
412135;201501;499;1426;358;1140;77;282;139;405;216;687
412140;201501;1479;4505;1231;3986;304;1048;359;1151;663;2199
412150;201501;3010;8856;2622;8108;394;1397;1557;4670;1951;6067
412160;201501;1005;3262;670;2398;185;772;190;643;375;1415
412170;201501;4251;13695;3516;12277;1092;4145;1297;4423;2389;8568
412175;201501;1311;4543;1162;4205;310;1239;497;1777;807;3016
412180;201501;1590;5074;1253;4430;354;1398;389;1327;743;2725
412190;201501;2903;8590;2261;7478;657;2384;629;2097;1286;4481
412200;201501;2259;7421;1610;5716;360;1396;511;1784;871;3180
412210;201501;721;2041;424;1415;90;352;59;184;149;536
412215;201501;3505;10961;3195;10407;553;1777;2070;6982;2623;8759
412217;201501;1083;3114;995;2962;136;503;697;1957;833;2460
412220;201501;5198;17385;4980;16990;1513;5416;2718;9278;4231;14694
412230;201501;2821;9460;2459;8745;662;2663;770;2613;1432;5276
412240;201501;9399;24335;5282;16473;995;3569;905;2470;1900;6039
412250;201501;1842;5502;1598;4990;429;1473;391;1074;820;2547
412260;201501;1245;3519;809;2571;141;534;275;764;416;1298
412265;201501;1007;3134;890;2927;188;735;446;1425;634;2160
412270;201501;675;2132;491;1722;116;463;122;399;238;862
412280;201501;600;1901;452;1587;239;885;46;153;285;1038
412290;201501;1020;2949;817;2547;165;569;290;838;455;1407
412300;201501;1859;5628;1557;5046;465;1673;403;1243;868;2916
412310;201501;1054;3138;954;2996;121;366;681;2287;802;2653
412320;201501;758;2098;555;1734;139;492;185;586;324;1078
412330;201501;1615;4565;1274;3892;214;732;689;2072;903;2804
412340;201501;825;2577;566;1929;84;314;98;316;182;630
412350;201501;2373;7471;1937;6516;551;1996;273;805;824;2801
412360;201501;258;793;189;618;25;105;69;182;94;287
412370;201501;802;2532;657;2237;181;690;183;587;364;1277
412380;201501;1665;5240;1411;4658;375;1337;426;1328;801;2665
412382;201501;683;1961;478;1531;99;336;139;412;238;748
412385;201501;2422;7673;2197;7170;681;2370;705;2283;1386;4653
412390;201501;2051;6061;1861;5740;535;1831;757;2333;1292;4164
412395;201501;891;2522;720;2243;102;331;439;1360;541;1691
412400;201501;999;3139;873;2899;254;904;321;1080;575;1984
412402;201501;1872;5714;1550;5023;429;1580;411;1130;840;2710
412405;201501;3495;10157;2253;7465;491;1873;284;846;775;2719
412410;201501;4535;14676;3951;13540;1369;5490;831;2632;2200;8122
412420;201501;368;1101;273;884;57;223;105;270;162;493
412430;201501;474;1366;385;1186;89;318;151;420;240;738
412440;201501;3433;10431;2858;9443;529;1935;1227;4136;1756;6071
412450;201501;322;1033;256;871;45;161;39;92;84;253
412460;201501;835;2494;626;2068;163;633;165;486;328;1119
412470;201501;1887;6458;1678;5945;553;2049;571;2066;1124;4115
412480;201501;1309;3874;920;3029;200;711;135;357;335;1068
412490;201501;889;2696;774;2457;170;579;255;742;425;1321
412500;201501;1930;5680;1645;5124;416;1496;419;1112;835;2608
412510;201501;2236;7547;1954;6845;549;2075;850;2977;1399;5052
412520;201501;1486;4261;1205;3722;338;1125;363;1068;701;2193
412530;201501;645;1893;532;1651;116;363;162;485;278;848
412535;201501;567;1688;368;1201;93;337;80;220;173;557
412540;201501;1182;3452;919;2916;157;572;317;996;474;1568
412545;201501;849;2446;674;2060;105;372;278;762;383;1134
412550;201501;25957;78568;18115;61008;4797;17504;3575;11236;8372;28740
412555;201501;319;961;217;717;43;162;40;103;83;265
412560;201501;5112;16355;4103;14288;1035;4131;989;3165;2024;7296
412570;201501;4222;12782;3026;10077;713;2742;601;1858;1314;4600
412575;201501;888;2742;716;2339;169;627;215;644;384;1271
412580;201501;1256;3473;916;2885;200;647;275;827;475;1474
412590;201501;386;1124;282;922;65;238;87;283;152;521
412600;201501;1412;4339;1186;3878;323;1196;389;1183;712;2379
412610;201501;623;1888;461;1495;118;453;151;415;269;868
412620;201501;1170;3823;943;3336;270;1069;186;616;456;1685
412625;201501;10515;29368;8009;24607;2099;7065;1585;4467;3684;11532
412627;201501;947;2895;634;2217;213;812;48;147;261;959
412630;201501;3255;10408;2791;9412;683;2457;922;2978;1605;5435
412635;201501;479;1475;341;1161;77;292;34;102;111;394
412640;201501;874;2649;618;2072;128;459;87;247;215;706
412650;201501;1952;5777;1618;5126;415;1513;537;1478;952;2991
412660;201501;2826;8341;2265;7186;480;1703;510;1468;990;3171
412665;201501;689;1789;402;1262;136;471;104;294;240;765
412667;201501;1499;4491;1208;3908;307;1145;301;900;608;2045
412670;201501;656;2049;451;1554;99;391;81;216;180;607
412680;201501;1264;3842;846;2889;169;648;241;731;410;1379
412690;201501;690;2169;526;1801;193;711;108;354;301;1065
412700;201501;1774;5671;1543;5304;575;2218;506;1687;1081;3905
412710;201501;8034;25238;6770;22675;1748;6530;1707;5396;3455;11926
412720;201501;1429;4471;980;3319;201;738;157;431;358;1169
412730;201501;2133;6430;1423;4825;341;1308;188;495;529;1803
412740;201501;1324;4327;1077;3772;296;1149;231;816;527;1965
412750;201501;3670;11688;3289;11060;551;2175;2149;7067;2700;9242
412760;201501;2236;7413;2129;7235;578;2256;1027;3308;1605;5564
412770;201501;11462;32246;6987;22527;1202;4337;1429;4038;2631;8375
412780;201501;1259;4073;1104;3743;290;1059;383;1226;673;2285
412785;201501;2305;6742;1689;5426;391;1397;782;2435;1173;3832
412788;201501;1391;4498;1264;4247;292;1135;470;1417;762;2552
412790;201501;1153;3484;932;3039;219;792;253;742;472;1534
412795;201501;929;2690;801;2465;238;764;263;785;501;1549
412796;201501;2758;8638;2556;8249;712;2598;1031;3091;1743;5689
412800;201501;3092;8847;2355;7383;503;1787;818;2418;1321;4205
412810;201501;10096;27946;5797;18518;1048;3718;1168;3166;2216;6884
412820;201501;6867;20507;5077;17019;1356;4972;1129;3813;2485;8785
412830;201501;331;1022;271;898;59;245;88;255;147;500
412840;201501;1884;5491;1537;4812;354;1225;413;1189;767;2414
412850;201501;2504;7593;2145;7018;413;1614;1010;3104;1423;4718
412853;201501;1565;4511;1408;4228;158;622;832;2307;990;2929
412855;201501;1466;4263;1148;3588;341;1233;316;849;657;2082
412860;201501;1201;3492;998;3109;216;761;440;1326;656;2087
412862;201501;743;1933;515;1488;84;268;210;561;294;829
412863;201501;1255;4229;1211;4156;193;714;826;2823;1019;3537
412865;201501;671;2089;503;1685;104;370;195;672;299;1042
412870;201501;896;2558;738;2302;249;861;201;604;450;1465
412880;201501;1059;2972;840;2602;210;727;248;691;458;1418
420005;201501;535;1596;356;1195;76;280;129;413;205;693
420010;201501;3148;9346;2603;8507;357;1254;1874;6261;2231;7515
420020;201501;786;2571;473;1732;74;328;55;151;129;479
420030;201501;541;1470;286;978;67;274;44;141;111;415
420040;201501;835;2585;534;1956;135;553;93;270;228;823
420050;201501;707;2160;536;1765;156;543;205;641;361;1184
420055;201501;242;721;152;506;31;109;30;85;61;194
420060;201501;242;820;168;622;45;194;25;80;70;274
420070;201501;1394;4456;1126;3816;185;682;606;2096;791;2778
420075;201501;194;559;107;357;23;92;34;100;57;192
420080;201501;612;1970;493;1719;166;624;118;410;284;1034
420090;201501;537;1842;400;1538;112;465;68;257;180;722
420100;201501;1322;4225;1202;4058;294;1038;700;2384;994;3422
420110;201501;350;1180;310;1095;85;312;126;449;211;761
420120;201501;312;1079;265;981;88;363;58;195;146;558
420125;201501;305;1204;278;1142;96;416;92;351;188;767
420127;201501;538;1620;218;811;65;254;26;94;91;348
420130;201501;1963;6547;1656;5962;439;1760;539;1763;978;3523
420140;201501;5359;15722;3787;12774;1009;3831;686;2114;1695;5945
420150;201501;768;2141;459;1504;103;385;159;466;262;851
420160;201501;305;882;193;640;33;126;54;167;87;293
420165;201501;214;676;131;457;28;119;33;103;61;222
420170;201501;213;659;141;516;48;217;19;45;67;262
420180;201501;427;1322;251;902;51;194;51;175;102;369
420190;201501;507;1535;277;996;57;231;42;129;99;360
420195;201501;1395;4062;1128;3678;278;967;537;1814;815;2781
420200;201501;2995;9734;1910;7180;556;2353;314;1040;870;3393
420205;201501;937;3124;828;2927;200;776;399;1391;599;2167
420207;201501;1452;4274;1014;3354;296;1135;274;804;570;1939
420208;201501;507;1473;325;1138;120;465;87;281;207;746
420209;201501;339;1079;210;762;38;155;69;238;107;393
420210;201501;1547;4802;1004;3807;253;1197;177;579;430;1776
420213;201501;825;2970;781;2863;139;516;523;1959;662;2475
420215;201501;409;1345;280;1014;80;309;49;167;129;476
420220;201501;194;679;173;638;48;206;59;165;107;371
420230;201501;4223;12572;3102;10485;656;2593;1361;4405;2017;6998
420240;201501;12256;33550;7405;24616;1223;4993;3069;9164;4292;14157
420243;201501;597;1848;480;1594;105;414;167;529;272;943
420245;201501;1088;3286;737;2541;162;628;175;516;337;1144
420250;201501;580;1920;548;1864;154;614;256;848;410;1462
420253;201501;556;1488;446;1334;85;260;245;780;330;1040
420257;201501;324;941;218;742;38;139;112;378;150;517
420260;201501;1253;4010;1069;3688;250;986;490;1680;740;2666
420270;201501;482;1492;137;508;23;92;28;89;51;181
420280;201501;2436;6581;1501;4886;310;1226;548;1579;858;2805
420285;201501;155;455;66;238;6;23;3;10;9;33
420287;201501;591;1824;503;1659;136;462;170;566;306;1028
420290;201501;6528;19281;4182;13912;866;3192;1216;3720;2082;6912
420300;201501;6371;19636;4306;15206;1044;4162;855;2966;1899;7128
420310;201501;771;2270;728;2201;134;436;480;1416;614;1852
420315;201501;970;3143;774;2741;224;886;295;1032;519;1918
420320;201501;5281;16467;4410;14930;1264;4773;1779;5877;3043;10650
420325;201501;353;1152;332;1110;81;299;131;422;212;721
420330;201501;1097;3840;842;3143;213;884;211;674;424;1558
420340;201501;1471;4590;1138;3825;254;940;252;781;506;1721
420350;201501;1362;4321;1131;3843;289;1045;474;1608;763;2653
420360;201501;3157;9804;2184;7596;621;2453;302;871;923;3324
420370;201501;1971;5476;1612;4921;156;464;1316;4048;1472;4512
420380;201501;4771;15692;3732;13236;1029;4037;956;3280;1985;7317
420390;201501;1677;4799;908;3138;193;779;195;571;388;1350
420395;201501;1679;5294;1212;4232;228;910;199;560;427;1470
420400;201501;1363;3993;966;3214;262;1044;278;830;540;1874
420410;201501;791;2123;540;1706;135;477;288;892;423;1369
420415;201501;463;1479;345;1186;119;429;96;316;215;745
420417;201501;778;2498;666;2227;123;441;340;1133;463;1574
420419;201501;411;1266;270;985;118;482;44;152;162;634
420420;201501;11946;36015;9225;30540;2810;10506;2750;8557;5560;19063
420425;201501;1333;3685;857;2713;97;385;357;1029;454;1414
420430;201501;3406;10449;2201;7657;508;1975;734;2492;1242;4467
420435;201501;288;908;207;717;42;176;101;333;143;509
420440;201501;1204;3365;644;2185;251;932;109;335;360;1267
420445;201501;340;1035;294;945;62;204;153;493;215;697
420450;201501;1091;3112;622;2122;122;475;134;381;256;856
420455;201501;1967;6070;1733;5665;359;1428;822;2595;1181;4023
420460;201501;8732;26511;6786;22934;1608;6392;2578;8255;4186;14647
420470;201501;1208;3263;753;2396;200;729;210;613;410;1342
420475;201501;129;390;67;239;18;68;9;27;27;95
420480;201501;4719;14054;3767;12393;1518;5654;467;1401;1985;7055
420490;201501;739;2007;430;1471;113;415;128;436;241;851
420500;201501;1864;5849;1474;5112;457;1774;646;2180;1103;3954
420510;201501;121;493;110;467;47;203;38;155;85;358
420515;201501;116;399;95;354;17;74;18;69;35;143
420517;201501;894;2783;801;2609;147;541;471;1507;618;2048
420519;201501;476;1331;356;1100;64;208;129;391;193;599
420520;201501;646;1693;475;1468;115;406;268;807;383;1213
420530;201501;1149;3897;881;3241;225;949;203;612;428;1561
420535;201501;274;816;166;581;53;208;22;62;75;270
420540;201501;20681;60518;14797;47802;4078;14507;4013;11693;8091;26200
420543;201501;418;1126;313;951;32;123;192;613;224;736
420545;201501;1607;5059;1292;4383;330;1288;413;1292;743;2580
420550;201501;4414;14282;3438;12106;841;3501;857;2738;1698;6239
420555;201501;438;1352;351;1177;102;382;113;351;215;733
420560;201501;545;1603;463;1443;71;239;249;780;320;1019
420570;201501;2022;6600;1634;5683;450;1793;535;1734;985;3527
420580;201501;1279;4114;1046;3709;293;1166;457;1612;750;2778
420590;201501;3174;9748;2189;7474;518;1940;407;1234;925;3174
420600;201501;802;2681;730;2518;151;556;342;1217;493;1773
420610;201501;522;1649;324;1190;95;396;66;213;161;609
420620;201501;845;2589;722;2375;218;778;232;751;450;1529
420630;201501;1088;3382;763;2617;167;627;238;720;405;1347
420640;201501;728;2260;358;1345;86;370;28;81;114;451
420650;201501;2191;6601;1311;4572;258;1030;230;688;488;1718
420660;201501;506;1480;406;1292;78;293;194;591;272;884
420665;201501;775;2193;489;1612;80;283;140;415;220;698
420670;201501;1661;5162;1218;4177;242;968;262;773;504;1741
420675;201501;220;679;150;516;28;105;53;175;81;280
420680;201501;526;1276;318;961;62;212;107;299;169;511
420690;201501;879;3050;645;2387;126;500;167;545;293;1045
420700;201501;3743;10813;2854;9017;669;2469;887;2639;1556;5108
420710;201501;594;2008;467;1758;147;615;151;548;298;1163
420720;201501;1589;4743;1312;4374;268;957;837;2821;1105;3778
420730;201501;3450;10390;2830;9278;761;2747;1149;3607;1910;6354
420740;201501;818;2601;741;2466;182;638;453;1503;635;2141
420750;201501;2301;7281;1574;5556;289;1207;479;1454;768;2661
420757;201501;113;300;62;225;13;59;24;81;37;140
420760;201501;341;1054;233;766;48;183;56;151;104;334
420765;201501;577;1808;296;1098;54;227;53;169;107;396
420768;201501;1192;4227;949;3677;302;1241;345;1316;647;2557
420770;201501;705;2032;373;1305;75;305;93;298;168;603
420775;201501;694;2217;440;1523;123;428;89;286;212;714
420780;201501;1640;4998;1075;3621;279;1031;227;685;506;1716
420785;201501;325;992;236;763;44;159;74;212;118;371
420790;201501;1332;4630;1064;3962;298;1233;439;1550;737;2783
420800;201501;816;2335;445;1480;131;505;92;268;223;773
420810;201501;2378;8156;1896;7040;616;2580;494;1779;1110;4359
420820;201501;8198;26218;6099;22438;1770;7377;1883;6860;3653;14237
420830;201501;2541;8274;2146;7559;734;2825;778;2685;1512;5510
420840;201501;1032;3024;594;2144;157;641;157;516;314;1157
420845;201501;1293;4126;1003;3568;322;1317;223;715;545;2032
420850;201501;1727;5444;1040;3966;298;1281;156;579;454;1860
420860;201501;500;1424;321;1089;95;374;135;449;230;823
420870;201501;1223;3406;925;2978;305;1135;309;903;614;2038
420880;201501;1176;3911;923;3257;208;816;196;613;404;1429
420890;201501;13203;31831;5986;18890;1065;3846;1787;4896;2852;8742
420895;201501;239;658;119;395;35;117;21;68;56;185
420900;201501;2121;5952;1277;4285;280;1065;309;925;589;1990
420910;201501;23234;70404;15443;54153;3371;13601;4311;14023;7682;27624
420915;201501;536;2149;449;1912;119;537;212;878;331;1415
420917;201501;442;1368;223;718;56;211;81;213;137;424
420920;201501;194;546;92;310;36;130;10;31;46;161
420930;201501;18657;54329;14926;48109;3840;13932;5293;16533;9133;30465
420940;201501;4015;12152;3302;10625;891;3267;769;2060;1660;5327
420945;201501;212;664;137;488;38;157;33;106;71;263
420950;201501;619;1733;277;1028;42;198;35;99;77;297
420960;201501;1110;3244;927;2943;218;830;422;1230;640;2060
420970;201501;2493;8024;2211;7524;603;2310;1015;3457;1618;5767
420980;201501;440;1348;338;1170;109;387;151;578;260;965
420985;201501;523;1501;263;929;58;233;80;262;138;495
420990;201501;803;2227;514;1755;115;454;167;521;282;975
421000;201501;575;1996;390;1517;94;412;60;193;154;605
421003;201501;686;1885;274;913;41;151;44;98;85;249
421005;201501;225;718;181;643;50;195;91;315;141;510
421010;201501;5876;17195;4134;13939;1163;4480;1033;3134;2196;7614
421020;201501;513;1637;400;1421;67;241;206;775;273;1016
421030;201501;948;3513;885;3359;309;1244;308;1182;617;2426
421040;201501;720;2046;559;1775;125;451;259;772;384;1223
421050;201501;1956;5357;1167;3851;304;1149;268;730;572;1879
421055;201501;233;713;139;483;40;161;42;119;82;280
421060;201501;465;1625;364;1352;68;280;126;443;194;723
421070;201501;742;2338;481;1703;121;495;107;360;228;855
421080;201501;507;1554;438;1438;92;316;257;829;349;1145
421085;201501;564;1493;302;1024;66;253;75;267;141;520
421090;201501;398;1105;242;775;40;148;104;312;144;460
421100;201501;965;2856;659;2204;182;638;148;440;330;1078
421105;201501;1431;4455;1218;4085;278;1025;485;1668;763;2693
421110;201501;1150;4109;1041;3897;393;1576;282;1013;675;2589
421120;201501;1524;4799;1070;3731;193;811;323;995;516;1806
421125;201501;411;1177;302;983;83;312;115;351;198;663
421130;201501;3526;11601;2959;10550;1039;4151;951;3369;1990;7520
421140;201501;371;1123;289;946;59;221;118;364;177;585
421145;201501;568;1851;402;1395;61;235;176;591;237;826
421150;201501;538;1700;406;1462;99;394;164;588;263;982
421160;201501;1142;3338;621;2099;124;488;223;700;347;1188
421165;201501;283;1000;222;812;40;147;98;361;138;508
421170;201501;1515;4547;1231;4062;261;964;727;2377;988;3341
421175;201501;1206;3472;907;2996;213;899;360;1045;573;1944
421180;201501;603;1683;326;1094;77;290;93;270;170;560
421185;201501;422;1187;301;951;55;169;149;494;204;663
421187;201501;295;914;220;755;47;178;110;361;157;539
421189;201501;460;1428;407;1326;85;287;162;513;247;800
421190;201501;10719;32017;7000;24183;1670;6289;1542;5013;3212;11302
421200;201501;970;3233;839;2960;209;824;287;954;496;1778
421205;201501;237;746;183;636;42;175;43;118;85;293
421210;201501;1660;5075;1300;4204;374;1295;391;1192;765;2487
421220;201501;2154;7321;1877;6733;623;2473;507;1783;1130;4256
421223;201501;738;2134;492;1694;135;495;207;694;342;1189
421225;201501;1129;3516;928;3108;229;852;352;1167;581;2019
421227;201501;797;2658;703;2509;154;554;452;1655;606;2209
421230;201501;585;1936;514;1778;125;484;213;691;338;1175
421240;201501;468;1517;275;962;40;157;63;192;103;349
421250;201501;1836;5378;1184;4202;363;1437;280;939;643;2376
421260;201501;376;1086;121;453;23;84;30;107;53;191
421265;201501;505;1671;446;1552;109;397;166;578;275;975
421270;201501;779;2120;432;1441;122;440;112;410;234;850
421280;201501;1614;5120;1302;4612;407;1614;454;1583;861;3197
421290;201501;1712;4559;944;3055;209;736;210;574;419;1310
421300;201501;307;948;254;835;74;282;108;333;182;615
421310;201501;317;1036;250;863;60;218;78;252;138;470
421315;201501;390;1161;231;832;44;163;34;129;78;292
421320;201501;547;1814;371;1349;70;281;59;161;129;442
421330;201501;497;1751;416;1586;144;640;66;240;210;880
421335;201501;561;1840;457;1640;113;448;98;368;211;816
421340;201501;1702;5033;1411;4550;208;830;891;2823;1099;3653
421350;201501;895;2969;717;2582;181;753;243;801;424;1554
421360;201501;3133;9098;1999;6900;418;1677;629;1997;1047;3674
421370;201501;785;2614;630;2266;184;749;207;695;391;1444
421380;201501;1031;2966;826;2583;146;513;407;1263;553;1776
421390;201501;149;437;78;270;11;35;35;128;46;163
421400;201501;312;1123;239;952;78;344;64;241;142;585
421410;201501;325;949;229;758;34;113;126;428;160;541
421415;201501;350;1162;174;652;45;180;44;150;89;330
421420;201501;932;2861;652;2196;134;511;162;471;296;982
421430;201501;247;779;189;665;43;172;42;144;85;316
421440;201501;868;2568;588;2035;150;570;228;749;378;1319
421450;201501;578;1839;387;1434;97;406;61;202;158;608
421460;201501;613;1689;317;1108;50;215;81;266;131;481
421470;201501;432;1504;344;1304;91;373;141;533;232;906
421480;201501;2731;7924;1661;5865;394;1628;377;1156;771;2784
421490;201501;298;923;135;521;37;160;26;91;63;251
421500;201501;2337;8035;2024;7384;743;3087;438;1540;1181;4627
421505;201501;392;1328;348;1226;84;318;158;545;242;863
421507;201501;600;1844;396;1387;65;233;155;566;220;799
421510;201501;203;698;180;656;40;184;87;275;127;459
421520;201501;837;2256;559;1689;59;234;283;777;342;1011
421530;201501;424;1314;244;910;43;199;80;294;123;493
421535;201501;705;2112;406;1470;79;306;192;664;271;970
421540;201501;365;1011;298;888;66;215;121;346;187;561
421545;201501;1009;3375;773;2893;214;939;172;588;386;1527
421550;201501;1973;6545;1703;6037;539;2197;505;1675;1044;3872
421555;201501;346;1048;142;513;24;97;21;68;45;165
421560;201501;240;729;113;402;24;95;23;80;47;175
421565;201501;944;2869;848;2713;320;1146;318;971;638;2117
421567;201501;885;3259;760;2945;365;1469;148;565;513;2034
421568;201501;525;1672;381;1337;98;356;104;369;202;725
421569;201501;185;582;107;399;29;124;26;84;55;208
421570;201501;1224;3827;686;2507;194;792;148;520;342;1312
421575;201501;506;1697;442;1568;72;282;270;955;342;1237
421580;201501;3598;11424;2764;9578;816;3245;671;2001;1487;5246
421590;201501;234;724;190;641;34;120;103;338;137;458
421600;201501;599;1798;454;1497;129;474;106;321;235;795
421605;201501;636;1936;448;1570;92;391;117;362;209;753
421610;201501;1532;4223;1278;3820;178;618;769;2226;947;2844
421620;201501;4807;14610;3293;11415;983;3731;1072;3692;2055;7423
421625;201501;367;1083;177;618;29;108;52;184;81;292
421630;201501;2715;8053;1523;5240;360;1390;261;828;621;2218
421635;201501;267;796;168;557;25;88;83;255;108;343
421640;201501;1042;3232;839;2840;136;457;545;1903;681;2360
421650;201501;2132;7055;1806;6316;610;2425;310;969;920;3394
421660;201501;8642;27686;6800;23989;1864;7490;2163;7064;4027;14554
421670;201501;1060;3357;734;2608;204;818;220;752;424;1570
421680;201501;1243;4106;1072;3695;380;1399;210;688;590;2087
421690;201501;1899;6198;1468;5174;348;1348;227;715;575;2063
421700;201501;611;1781;325;1118;73;300;95;246;168;546
421710;201501;270;907;160;592;52;204;49;176;101;380
421715;201501;283;777;160;520;45;160;45;133;90;293
421720;201501;1746;5335;1179;4163;429;1689;324;1069;753;2758
421725;201501;112;382;104;364;41;162;29;101;70;263
421730;201501;606;1784;302;1070;69;270;56;149;125;419
421740;201501;724;2236;504;1714;118;477;112;281;230;758
421750;201501;1149;3170;779;2433;160;564;356;1019;516;1583
421755;201501;352;1069;235;782;53;214;70;202;123;416
421760;201501;616;2049;350;1275;80;336;117;402;197;738
421770;201501;3018;9050;2278;7538;691;2451;695;2258;1386;4709
421775;201501;594;1735;387;1360;86;318;117;396;203;714
421780;201501;1407;4666;1050;3863;304;1254;372;1292;676;2546
421790;201501;929;2548;536;1888;146;602;162;524;308;1126
421795;201501;357;1069;231;753;37;145;75;236;112;381
421800;201501;2539;7759;1902;6532;414;1657;773;2451;1187;4108
421810;201501;704;2265;532;1887;146;544;84;291;230;835
421820;201501;1148;3370;760;2595;124;492;194;581;318;1073
421825;201501;1490;4932;1392;4702;224;893;885;2869;1109;3762
421830;201501;2604;9001;2379;8557;543;2214;1180;4150;1723;6364
421835;201501;149;431;109;370;27;118;59;178;86;296
421840;201501;362;1220;295;1058;73;295;104;348;177;643
421850;201501;483;1408;313;1056;76;294;99;328;175;622
421860;201501;367;1148;240;875;45;177;53;174;98;351
421870;201501;4697;13315;3238;10389;915;3193;648;1995;1563;5188
421875;201501;437;1311;207;773;52;225;42;136;94;361
421880;201501;964;3057;760;2603;180;718;201;636;381;1354
421885;201501;325;1074;278;983;76;281;99;335;175;616
421890;201501;964;3274;825;2982;260;1071;268;927;528;1998
421895;201501;360;1192;324;1121;70;236;194;704;264;940
421900;201501;747;2381;598;2027;160;567;165;509;325;1076
421910;201501;536;1687;390;1361;86;337;113;350;199;687
421915;201501;566;1721;416;1387;89;314;123;372;212;686
421917;201501;568;1713;437;1493;125;519;161;497;286;1016
421920;201501;794;2239;526;1873;215;809;184;657;399;1466
421930;201501;3371;9150;2032;6742;518;1949;398;1197;916;3146
421935;201501;764;2611;583;2205;134;592;212;758;346;1350
421940;201501;265;918;163;616;31;142;36;102;67;244
421950;201501;4070;11350;2097;7139;570;2088;361;1198;931;3286
421960;201501;241;757;195;654;51;191;53;160;104;351
421970;201501;2139;6250;1426;4680;507;1796;303;889;810;2685
421985;201501;510;1318;279;856;51;189;83;265;134;454
422000;201501;910;2687;736;2362;163;568;324;1065;487;1633
430003;201501;856;2493;668;2167;185;670;208;650;393;1320
430005;201501;282;904;233;801;46;172;137;458;183;630
430010;201501;2130;5859;1586;4919;405;1320;640;2022;1045;3342
430020;201501;793;2000;661;1811;84;274;466;1225;550;1499
430030;201501;1114;2926;847;2455;289;928;174;448;463;1376
430040;201501;11792;30573;9598;26980;2820;8401;3006;8215;5826;16616
430045;201501;742;2061;594;1764;103;350;333;963;436;1313
430047;201501;270;667;159;482;25;73;66;199;91;272
430050;201501;1131;3039;710;2223;148;512;193;542;341;1054
430055;201501;298;840;185;580;28;98;95;290;123;388
430057;201501;69;155;26;70;4;12;7;13;11;25
430060;201501;15524;50405;13633;47092;3761;13711;6767;23797;10528;37508
430063;201501;1022;3026;825;2608;212;698;401;1302;613;2000
430064;201501;1624;4798;1339;4322;381;1265;600;1978;981;3243
430066;201501;170;432;128;366;18;62;75;200;93;262
430070;201501;578;1548;263;841;57;199;70;186;127;385
430080;201501;613;1956;463;1613;103;398;146;477;249;875
430085;201501;739;2032;513;1635;130;469;197;609;327;1078
430087;201501;1027;3135;979;3050;122;431;726;2218;848;2649
430090;201501;879;2323;323;1067;42;161;60;200;102;361
430100;201501;898;2425;555;1716;152;525;164;435;316;960
430105;201501;830;2593;622;2191;174;704;163;527;337;1231
430107;201501;246;824;190;652;28;106;73;236;101;342
430110;201501;1840;5361;1588;4968;416;1431;778;2356;1194;3787
430120;201501;1674;4972;1288;4169;254;880;692;2188;946;3068
430130;201501;4010;10498;3534;9816;624;1896;2089;5748;2713;7644
430140;201501;1168;3679;885;3055;257;927;302;1015;559;1942
430150;201501;863;2299;574;1764;139;466;147;437;286;903
430155;201501;443;1291;283;961;43;149;116;393;159;542
430160;201501;16112;47889;14743;45688;2613;9032;8996;27977;11609;37009
430163;201501;1763;5338;1490;4850;291;1099;760;2478;1051;3577
430165;201501;443;1118;151;502;38;143;45;135;83;278
430170;201501;817;2373;385;1342;70;265;68;204;138;469
430175;201501;969;3062;782;2615;186;581;345;1253;531;1834
430180;201501;933;2558;775;2300;168;579;417;1178;585;1757
430185;201501;785;1963;418;1267;63;211;132;355;195;566
430187;201501;681;2032;521;1688;129;490;184;540;313;1030
430190;201501;1752;5272;1543;4869;306;1125;913;2800;1219;3925
430192;201501;190;586;95;301;6;17;26;77;32;94
430195;201501;301;914;89;320;8;29;11;36;19;65
430200;201501;1708;5507;1452;4970;435;1578;398;1344;833;2922
430205;201501;490;1416;370;1199;48;196;245;768;293;964
430210;201501;6467;17405;3531;11236;765;2626;757;2226;1522;4852
430215;201501;355;1039;253;818;51;179;104;327;155;506
430220;201501;715;1835;313;1026;58;211;62;190;120;401
430222;201501;299;900;232;757;39;163;104;316;143;479
430223;201501;342;991;299;928;61;195;188;602;249;797
430225;201501;47;126;27;83;6;16;8;20;14;36
430230;201501;1876;5923;1752;5798;184;478;1529;5236;1713;5714
430235;201501;279;914;225;781;61;235;55;175;116;410
430237;201501;511;1383;381;1146;49;183;243;705;292;888
430240;201501;930;2421;613;1880;139;495;244;704;383;1199
430245;201501;941;2944;725;2478;187;659;332;1174;519;1833
430250;201501;1408;3969;1239;3679;513;1600;307;902;820;2502
430258;201501;175;495;126;407;17;64;51;164;68;228
430260;201501;845;2384;577;1835;73;265;308;993;381;1258
430265;201501;326;1004;259;862;78;255;34;98;112;353
430270;201501;2865;8112;2506;7521;453;1621;1459;4151;1912;5772
430280;201501;4624;12906;3828;11472;927;2975;1776;5275;2703;8250
430290;201501;2429;6533;2244;6301;178;510;1951;5551;2129;6061
430300;201501;9376;27974;7677;24740;2260;7816;3112;10222;5372;18038
430310;201501;7093;22016;5879;19713;1644;6066;2411;7675;4055;13741
430320;201501;855;2499;586;1964;105;315;294;1040;399;1355
430330;201501;782;2114;619;1799;173;520;267;712;440;1232
430340;201501;785;1977;446;1476;94;355;208;685;302;1040
430350;201501;6266;19635;5315;17615;1871;6535;1847;5998;3718;12533
430355;201501;341;852;146;449;29;101;23;52;52;153
430360;201501;1089;2849;913;2522;174;548;454;1174;628;1722
430367;201501;310;807;193;600;43;147;60;187;103;334
430370;201501;500;1448;383;1221;108;388;99;284;207;672
430380;201501;875;2234;471;1498;116;393;171;558;287;951
430390;201501;4507;12961;3254;10429;784;2705;878;2693;1662;5398
430400;201501;1429;3436;991;2763;298;931;416;1056;714;1987
430410;201501;690;1863;527;1588;94;309;274;827;368;1136
430420;201501;3985;11552;3119;9642;804;2625;1297;3953;2101;6578
430430;201501;831;2273;532;1709;159;564;142;438;301;1002
430435;201501;1940;5331;1530;4592;344;1122;782;2339;1126;3461
430440;201501;4175;13087;3333;11243;591;2093;1778;6254;2369;8347
430450;201501;7825;22071;6146;18779;2284;7443;1547;4654;3831;12097
430460;201501;27908;83401;22075;72933;6267;22552;7749;25504;14016;48056
430461;201501;504;1382;176;559;31;112;47;147;78;259
430462;201501;307;876;229;740;88;322;59;172;147;494
430463;201501;4036;12917;3521;11944;804;2988;1755;5967;2559;8955
430465;201501;654;1762;551;1587;112;372;353;979;465;1351
430466;201501;3644;10235;3243;9610;658;2190;1858;5347;2516;7537
430467;201501;582;1738;510;1626;107;383;255;777;362;1160
430468;201501;1452;4159;1272;3889;467;1527;391;1188;858;2715
430469;201501;244;685;70;258;8;36;18;63;26;99
430470;201501;7607;20273;5385;16488;1641;5461;1170;3486;2811;8947
430471;201501;833;2734;750;2565;256;927;185;629;441;1556
430480;201501;987;2644;545;1756;83;289;134;374;217;663
430485;201501;224;654;113;390;21;80;39;134;60;214
430490;201501;455;1295;314;1033;88;303;112;371;200;674
430495;201501;405;1188;267;899;49;187;73;210;122;397
430500;201501;1328;3711;1086;3297;309;1050;481;1424;790;2474
430510;201501;19779;59506;16387;53049;5647;20090;5073;15493;10720;35583
430511;201501;475;1424;218;746;37;140;39;108;76;248
430512;201501;1218;3180;1065;2924;281;800;401;1140;682;1940
430513;201501;753;2063;485;1494;83;259;224;697;307;956
430515;201501;507;1514;386;1255;66;209;195;648;261;857
430517;201501;1364;4376;1158;3945;228;826;696;2369;924;3195
430520;201501;1589;4479;1163;3600;302;1042;436;1267;738;2309
430530;201501;994;2786;531;1711;89;334;143;415;232;749
430535;201501;2145;6691;1707;5772;399;1557;631;2058;1030;3615
430537;201501;517;1615;439;1458;42;135;332;1122;374;1257
430540;201501;737;1694;504;1389;100;301;300;802;400;1103
430543;201501;535;1391;473;1328;93;288;341;957;434;1245
430544;201501;697;2206;583;1967;118;434;314;1029;432;1463
430545;201501;1304;4208;1122;3985;365;1326;562;2135;927;3461
430550;201501;683;1995;457;1521;99;366;174;571;273;937
430558;201501;88;256;44;152;14;58;7;19;21;77
430560;201501;405;1008;242;720;30;107;82;230;112;337
430570;201501;1141;2913;763;2207;182;602;356;924;538;1526
430580;201501;1182;3203;744;2402;233;795;193;643;426;1438
430583;201501;157;429;53;177;7;25;3;10;10;35
430585;201501;366;966;240;699;66;214;99;261;165;475
430587;201501;228;699;194;634;59;206;64;216;123;422
430590;201501;1376;3859;1308;3751;222;714;914;2597;1136;3311
430593;201501;26;101;23;90;6;32;9;29;15;61
430595;201501;251;690;89;309;22;87;14;43;36;130
430597;201501;354;1053;259;832;52;183;70;195;122;378
430600;201501;2202;6000;1295;4000;264;858;423;1272;687;2130
430605;201501;1336;4099;1058;3528;240;884;457;1554;697;2438
430607;201501;761;1950;589;1672;87;264;366;1055;453;1319
430610;201501;8648;23175;6671;20045;1711;5663;2559;7680;4270;13343
430613;201501;265;657;118;364;27;76;26;67;53;143
430620;201501;756;2194;594;1850;148;520;254;731;402;1251
430630;201501;425;1277;233;769;53;176;37;108;90;284
430632;201501;743;2052;438;1380;83;298;214;624;297;922
430635;201501;686;1894;500;1542;108;367;235;714;343;1081
430637;201501;509;1462;452;1344;66;238;292;830;358;1068
430640;201501;1698;4502;747;2420;75;235;99;227;174;462
430642;201501;509;1341;309;976;58;197;123;379;181;576
430645;201501;194;534;100;324;18;62;27;93;45;155
430650;201501;1903;6228;1642;5710;328;1168;973;3475;1301;4643
430655;201501;203;577;171;511;33;115;74;181;107;296
430660;201501;5744;16354;4516;14192;1151;4011;1863;5798;3014;9809
430670;201501;496;1469;447;1374;34;108;339;1070;373;1178
430673;201501;699;1693;367;1125;81;269;153;453;234;722
430675;201501;289;846;130;423;24;86;48;146;72;232
430676;201501;3441;10495;2980;9722;831;2910;1116;3684;1947;6594
430680;201501;1152;3426;850;2778;171;642;311;912;482;1554
430690;201501;4421;12620;3566;10968;1083;3506;1224;3834;2307;7340
430692;201501;311;1051;226;886;29;119;141;554;170;673
430693;201501;1440;4025;990;3088;173;645;287;798;460;1443
430695;201501;520;1486;377;1206;85;314;139;395;224;709
430697;201501;478;1354;366;1162;108;334;139;483;247;817
430700;201501;9626;25047;4621;15256;899;3309;397;1258;1296;4567
430705;201501;284;878;254;830;83;298;77;231;160;529
430710;201501;1815;4685;1371;3941;301;941;599;1752;900;2693
430720;201501;918;2245;612;1809;168;542;224;668;392;1210
430730;201501;1767;4703;1266;3886;278;830;628;2054;906;2884
430740;201501;583;1627;340;1122;93;331;58;177;151;508
430745;201501;544;1535;338;1039;71;234;85;260;156;494
430750;201501;1783;4916;1442;4347;306;1032;718;2062;1024;3094
430755;201501;561;1503;365;1087;46;162;162;435;208;597
430760;201501;3237;7938;2319;6665;427;1396;1173;3523;1600;4919
430770;201501;6594;19136;5187;16543;990;3495;2748;8649;3738;12144
430780;201501;2499;6789;1575;4998;349;1235;581;1778;930;3013
430781;201501;594;1742;412;1369;108;373;126;398;234;771
430783;201501;544;1355;381;1091;76;251;190;506;266;757
430786;201501;83;267;57;197;10;35;20;68;30;103
430790;201501;4560;12562;3103;9597;643;2296;1263;3597;1906;5893
430800;201501;847;2488;572;1839;125;427;197;595;322;1022
430805;201501;508;1428;370;1179;44;134;221;739;265;873
430807;201501;395;1154;265;859;58;222;77;225;135;447
430810;201501;759;2095;383;1261;63;231;66;191;129;422
430820;201501;1178;3730;861;2926;223;818;251;797;474;1615
430825;201501;428;1150;206;633;36;117;73;200;109;317
430830;201501;2167;6591;1991;6334;200;654;1520;4911;1720;5565
430840;201501;984;3010;894;2837;219;710;426;1394;645;2104
430843;201501;107;315;55;184;8;25;22;74;30;99
430845;201501;355;1075;290;942;111;385;38;113;149;498
430850;201501;2766;8313;2390;7644;604;2113;978;3070;1582;5183
430860;201501;926;2491;554;1872;173;678;143;435;316;1113
430865;201501;686;1853;629;1759;207;617;305;827;512;1444
430870;201501;698;1939;394;1307;105;357;96;298;201;655
430880;201501;1228;3494;928;2932;301;1031;240;789;541;1820
430885;201501;194;545;133;447;33;125;59;189;92;314
430890;201501;1820;4804;1308;3853;93;337;635;1777;728;2114
430900;201501;2963;7902;2587;7292;501;1622;1426;3832;1927;5454
430905;201501;1050;2996;661;2140;175;629;155;480;330;1109
430910;201501;1551;4582;1115;3695;287;1052;428;1312;715;2364
430912;201501;532;1522;431;1347;62;226;261;803;323;1029
430915;201501;495;1610;344;1305;104;419;94;379;198;798
430920;201501;14749;45459;13150;42476;3330;11693;7375;23376;10705;35069
430925;201501;88;248;65;202;18;64;31;93;49;157
430930;201501;9365;27574;6745;22478;1845;6625;2045;7034;3890;13659
430940;201501;1163;3531;734;2477;136;535;220;698;356;1233
430950;201501;1216;3381;823;2568;190;661;300;855;490;1516
430955;201501;145;434;74;239;18;59;22;71;40;130
430957;201501;281;939;227;835;56;227;108;399;164;626
430960;201501;1350;3760;1138;3385;348;1146;435;1307;783;2453
430965;201501;1467;4302;1272;3975;86;324;1039;3229;1125;3553
430970;201501;556;1545;334;1076;69;248;92;282;161;530
430975;201501;662;2152;524;1823;87;327;275;954;362;1281
430980;201501;475;1168;295;895;73;260;120;312;193;572
430990;201501;608;1935;453;1552;128;473;104;321;232;794
430995;201501;614;1813;516;1625;169;563;200;619;369;1182
431000;201501;1713;4439;913;2826;183;635;117;296;300;931
431010;201501;2782;7899;1772;5885;379;1413;494;1477;873;2890
431020;201501;12735;31433;8364;23631;2046;5914;2568;7380;4614;13294
431030;201501;376;1102;205;703;47;178;47;153;94;331
431033;201501;2368;6940;2121;6581;427;1405;1264;4003;1691;5408
431036;201501;217;569;86;302;11;43;19;56;30;99
431040;201501;1002;2855;787;2502;214;753;381;1183;595;1936
431041;201501;562;1553;502;1470;146;439;234;711;380;1150
431043;201501;398;1293;286;1030;134;532;80;251;214;783
431046;201501;121;349;87;276;16;58;30;90;46;148
431050;201501;1815;4600;1404;3916;305;940;777;2111;1082;3051
431053;201501;634;2096;533;1883;161;623;160;566;321;1189
431055;201501;691;1897;640;1809;52;154;481;1365;533;1519
431057;201501;391;1145;236;816;54;196;80;277;134;473
431060;201501;5811;17076;5386;16508;1481;4434;2976;9503;4457;13937
431065;201501;511;1457;429;1313;44;149;284;866;328;1015
431070;201501;761;2223;462;1557;97;339;102;314;199;653
431075;201501;296;897;204;697;36;141;61;211;97;352
431080;201501;582;1843;460;1580;107;410;105;346;212;756
431085;201501;972;2588;778;2246;128;408;473;1336;601;1744
431087;201501;633;1817;553;1661;73;211;365;1106;438;1317
431090;201501;547;1340;267;811;83;263;62;178;145;441
431100;201501;4032;11213;3300;9961;861;2809;1314;4003;2175;6812
431110;201501;1587;4193;1180;3382;254;783;557;1531;811;2314
431112;201501;613;1923;582;1873;166;548;291;926;457;1474
431113;201501;522;1512;399;1262;112;374;106;341;218;715
431115;201501;1455;4235;1281;3934;231;755;793;2421;1024;3176
431120;201501;2681;8324;2145;7273;595;2297;892;2885;1487;5182
431123;201501;525;1529;382;1249;82;294;207;683;289;977
431125;201501;1380;4264;1041;3548;296;1006;341;1244;637;2250
431127;201501;205;526;63;209;6;16;4;9;10;25
431130;201501;3525;10054;2693;8593;626;2272;1066;3343;1692;5615
431140;201501;4464;11207;2485;7871;449;1643;577;1572;1026;3215
431142;201501;523;1568;465;1461;47;157;323;1026;370;1183
431150;201501;1185;3544;932;3064;207;737;369;1223;576;1960
431160;201501;1017;3006;859;2688;161;509;419;1410;580;1919
431162;201501;494;1312;249;837;34;145;38;101;72;246
431164;201501;161;450;50;186;15;59;1;4;16;63
431170;201501;758;2147;554;1762;154;517;174;544;328;1061
431171;201501;839;2507;716;2261;243;819;184;555;427;1374
431173;201501;507;1490;452;1388;101;327;268;824;369;1151
431175;201501;1108;3143;965;2920;310;986;376;1131;686;2117
431177;201501;873;2853;722;2560;240;959;321;1089;561;2048
431179;201501;347;736;88;262;11;42;20;45;31;87
431180;201501;2260;6557;1624;5214;403;1389;419;1236;822;2625
431190;201501;734;1928;385;1245;74;264;91;288;165;552
431198;201501;392;1271;347;1184;154;558;84;279;238;837
431200;201501;348;985;119;400;25;90;10;29;35;119
431205;201501;328;1020;179;626;36;118;64;233;100;351
431210;201501;748;2067;641;1872;167;478;357;1071;524;1549
431213;201501;259;790;211;700;56;213;83;258;139;471
431215;201501;336;992;175;593;31;101;15;41;46;142
431217;201501;211;647;162;537;51;177;46;160;97;337
431220;201501;990;2583;661;1940;82;270;357;981;439;1251
431225;201501;1294;3815;1106;3494;228;760;630;1992;858;2752
431230;201501;892;2615;680;2181;79;287;386;1215;465;1502
431235;201501;74;175;32;96;7;24;7;18;14;42
431237;201501;448;1435;391;1353;116;456;174;583;290;1039
431238;201501;39;120;29;95;3;9;9;31;12;40
431240;201501;2907;8750;2514;8104;866;3032;748;2349;1614;5381
431242;201501;366;1185;332;1124;117;443;63;196;180;639
431244;201501;426;1003;275;762;47;154;141;362;188;516
431245;201501;1064;2821;824;2400;116;361;544;1592;660;1953
431247;201501;203;607;156;512;55;196;53;165;108;361
431250;201501;1649;5208;1436;4911;405;1494;684;2354;1089;3848
431260;201501;344;966;197;665;49;201;56;166;105;367
431261;201501;234;811;203;739;42;172;69;240;111;412
431262;201501;399;1078;173;568;23;103;66;209;89;312
431265;201501;1451;3823;826;2526;167;577;214;535;381;1112
431267;201501;161;459;132;406;26;95;78;232;104;327
431270;201501;2607;6835;1865;5666;461;1510;840;2607;1301;4117
431275;201501;233;717;132;475;32;114;27;84;59;198
431280;201501;283;795;116;397;19;76;24;64;43;140
431290;201501;356;1123;276;934;69;284;63;193;132;477
431295;201501;111;309;58;176;5;18;28;79;33;97
431300;201501;295;784;63;239;16;64;3;10;19;74
431301;201501;187;568;116;390;29;102;22;62;51;164
431303;201501;775;2053;482;1443;83;311;156;422;239;733
431306;201501;2135;5792;1582;4804;223;873;528;1388;751;2261
431308;201501;42;138;38;127;24;84;10;32;34;116
431310;201501;777;2323;494;1683;100;355;156;555;256;910
431320;201501;912;2498;500;1646;109;401;123;377;232;778
431330;201501;2639;6548;1266;4008;365;1274;153;450;518;1724
431333;201501;469;1249;220;658;43;140;69;173;112;313
431335;201501;67;194;51;154;15;45;10;22;25;67
431337;201501;2415;7437;1831;6208;445;1638;388;1220;833;2858
431339;201501;681;1893;468;1431;86;276;213;643;299;919
431340;201501;27407;72803;19979;60076;4715;15610;6363;18544;11078;34154
431342;201501;578;1511;478;1344;134;407;256;689;390;1096
431344;201501;409;1121;304;935;27;83;200;631;227;714
431346;201501;339;894;196;586;53;158;49;142;102;300
431349;201501;701;2026;483;1504;107;340;157;481;264;821
431350;201501;4029;11904;3429;10838;654;2391;1865;5724;2519;8115
431360;201501;742;1945;509;1561;133;430;174;546;307;976
431365;201501;1221;3643;1038;3335;321;1121;447;1472;768;2593
431370;201501;5164;14780;4194;13153;1177;4017;1502;4709;2679;8726
431380;201501;1041;3220;974;3078;149;504;667;2078;816;2582
431390;201501;3177;8498;2022;6310;440;1578;613;1730;1053;3308
431395;201501;1241;3753;1067;3469;252;928;534;1680;786;2608
431400;201501;258;810;149;524;41;148;17;39;58;187
431402;201501;1297;3079;748;2112;151;452;375;1034;526;1486
431403;201501;272;799;192;656;50;195;36;118;86;313
431405;201501;4412;12395;3553;11148;778;2833;1774;5375;2552;8208
431406;201501;819;2515;612;2067;183;656;263;870;446;1526
431407;201501;592;1747;392;1328;107;372;100;314;207;686
431410;201501;14355;42194;10506;34729;3297;12133;1671;5465;4968;17598
431413;201501;220;539;104;327;11;38;39;116;50;154
431415;201501;762;2149;578;1812;117;429;260;755;377;1184
431417;201501;672;1681;539;1493;71;200;314;891;385;1091
431420;201501;1468;4089;1295;3820;259;814;690;2139;949;2953
431430;201501;538;1441;370;1121;72;228;126;343;198;571
431440;201501;24584;70152;20482;63537;5901;19431;8205;26242;14106;45673
431442;201501;142;403;97;293;22;73;13;27;35;100
431445;201501;495;1376;262;812;34;108;109;321;143;429
431446;201501;494;1443;365;1182;82;266;145;473;227;739
431447;201501;739;2089;529;1660;106;363;237;745;343;1108
431449;201501;837;2369;670;2082;92;320;407;1280;499;1600
431450;201501;2167;5537;1934;5188;358;1036;1340;3544;1698;4580
431455;201501;713;1819;403;1149;123;351;105;287;228;638
431460;201501;3452;9703;2976;8817;844;2551;1075;3298;1919;5849
431470;201501;1955;5752;1599;4991;416;1299;665;2154;1081;3453
431475;201501;167;487;41;162;6;24;3;13;9;37
431477;201501;723;1911;492;1464;63;202;283;815;346;1017
431478;201501;259;674;101;307;22;68;23;61;45;129
431480;201501;2975;8310;2256;7015;606;2104;865;2569;1471;4673
431490;201501;110251;304149;95504;282301;12891;44927;66237;191243;79128;236170
431500;201501;822;2190;612;1795;119;348;314;911;433;1259
431505;201501;471;1174;375;1040;37;92;282;814;319;906
431507;201501;337;838;243;663;35;97;164;436;199;533
431510;201501;2146;5923;1751;5220;362;1179;861;2469;1223;3648
431513;201501;286;784;131;428;29;100;58;185;87;285
431514;201501;114;296;44;149;6;29;2;5;8;34
431515;201501;748;2189;522;1635;96;348;192;504;288;852
431517;201501;83;258;75;239;22;76;26;71;48;147
431520;201501;437;1278;273;872;41;149;72;218;113;367
431530;201501;4296;10352;3291;9176;1004;2941;1403;4144;2407;7085
431531;201501;294;833;195;630;46;155;73;234;119;389
431532;201501;516;1465;452;1334;127;405;200;581;327;986
431535;201501;353;941;181;551;32;102;59;161;91;263
431540;201501;2150;7070;1908;6722;228;777;1303;4881;1531;5658
431545;201501;268;759;61;211;6;22;11;49;17;71
431550;201501;2320;6812;2088;6412;396;1407;1097;3298;1493;4705
431555;201501;722;1847;583;1628;134;365;329;939;463;1304
431560;201501;18902;58410;14136;48919;4012;15362;3914;14041;7926;29403
431570;201501;5402;15147;4783;14175;1355;4121;2402;7222;3757;11343
431575;201501;450;1152;316;927;52;186;99;258;151;444
431580;201501;673;1925;438;1412;97;363;154;444;251;807
431590;201501;993;2748;680;2119;86;274;318;994;404;1268
431595;201501;507;1468;401;1248;94;296;162;501;256;797
431600;201501;2138;6139;1537;4958;332;1267;328;919;660;2186
431610;201501;1547;4569;1205;3900;265;882;523;1693;788;2575
431620;201501;446;1351;239;782;62;216;99;300;161;516
431630;201501;1505;4057;1054;3147;277;856;443;1328;720;2184
431640;201501;6010;17552;5401;16604;1148;4042;3122;9399;4270;13441
431642;201501;503;1394;411;1229;54;195;226;651;280;846
431643;201501;177;450;149;402;18;55;79;188;97;243
431645;201501;1792;5267;1592;4931;321;1054;918;2845;1239;3899
431647;201501;180;517;121;375;30;98;30;81;60;179
431650;201501;280;871;198;705;33;131;46;140;79;271
431660;201501;1214;3406;777;2509;185;661;200;558;385;1219
431670;201501;1338;3572;1025;3011;228;754;465;1291;693;2045
431673;201501;229;656;139;464;29;113;36;108;65;221
431675;201501;602;1634;190;634;31;112;45;123;76;235
431680;201501;10160;27584;7594;23079;2084;6841;2258;6896;4342;13737
431690;201501;25627;71977;20465;63724;5814;19492;8111;25824;13925;45316
431695;201501;136;435;97;336;23;87;23;49;46;136
431697;201501;455;1295;398;1193;100;305;188;577;288;882
431700;201501;1617;4559;1379;4105;245;776;769;2255;1014;3031
431710;201501;12824;37621;10463;33633;3353;11543;3229;10711;6582;22254
431720;201501;7192;20115;5763;17415;1203;4078;2759;8158;3962;12236
431725;201501;9;26;7;22;1;4;4;11;5;15
431730;201501;3919;11760;3134;10300;881;3227;931;3123;1812;6350
431740;201501;5226;15077;4435;13643;1534;5195;1067;3018;2601;8213
431750;201501;9823;27898;8461;25731;1730;5688;4511;14024;6241;19712
431755;201501;312;835;65;230;6;24;13;38;19;62
431760;201501;3837;11245;3117;9919;733;2552;1074;3270;1807;5822
431770;201501;2124;5719;1758;5141;373;1160;975;2823;1348;3983
431775;201501;225;608;161;488;61;202;35;90;96;292
431780;201501;2496;6694;1927;5659;519;1645;525;1460;1044;3105
431790;201501;1218;3788;1043;3447;208;733;601;2031;809;2764
431795;201501;412;1178;283;880;44;144;105;328;149;472
431800;201501;9043;26792;7357;23633;2355;8211;1902;5897;4257;14108
431805;201501;318;773;95;327;13;51;16;55;29;106
431810;201501;3642;10129;2907;8654;580;1887;1349;3934;1929;5821
431820;201501;2684;8403;2326;7684;558;1998;896;2879;1454;4877
431830;201501;10972;27447;8593;23918;2507;7577;3382;9417;5889;16994
431840;201501;2790;8307;2418;7677;615;2150;1139;3604;1754;5754
431842;201501;768;1947;397;1204;76;259;120;321;196;580
431843;201501;344;1005;296;923;42;150;171;518;213;668
431844;201501;225;598;122;405;24;98;42;124;66;222
431845;201501;507;1511;436;1364;41;138;297;932;338;1070
431846;201501;447;1320;377;1205;57;218;245;772;302;990
431848;201501;199;541;113;375;22;87;21;65;43;152
431849;201501;428;1052;113;345;25;79;27;69;52;148
431850;201501;4994;14525;4375;13348;1060;3453;1888;5699;2948;9152
431860;201501;830;2188;618;1825;89;310;366;1037;455;1347
431861;201501;99;305;62;219;10;34;10;30;20;64
431862;201501;461;1526;371;1336;118;476;88;291;206;767
431870;201501;19094;54887;14929;47439;3984;13902;4932;15444;8916;29346
431880;201501;4405;13240;3552;11450;870;3127;1513;4756;2383;7883
431890;201501;5277;14447;4115;12444;1355;4374;1243;3821;2598;8195
431900;201501;1079;3104;760;2494;217;818;287;838;504;1656
431910;201501;1032;2444;498;1426;96;299;177;463;273;762
431912;201501;619;1770;485;1519;157;475;161;538;318;1013
431915;201501;1469;3967;1120;3361;272;886;442;1321;714;2207
431920;201501;1388;3887;1252;3695;134;378;1009;3027;1143;3405
431930;201501;1341;3683;1014;3161;150;441;613;2037;763;2478
431935;201501;76;238;62;209;17;66;22;65;39;131
431936;201501;399;1174;314;985;43;123;181;609;224;732
431937;201501;317;817;184;550;41;132;38;99;79;231
431940;201501;2684;7327;1783;5560;443;1498;494;1490;937;2988
431950;201501;1626;5067;1424;4718;321;1205;641;2022;962;3227
431960;201501;3142;9297;2816;8672;738;2479;974;2956;1712;5435
431970;201501;516;1403;267;850;39;143;74;215;113;358
431971;201501;118;327;89;278;16;51;34;93;50;144
431973;201501;489;1701;433;1585;51;195;275;1051;326;1246
431975;201501;91;199;18;66;4;19;4;14;8;33
431980;201501;1418;4138;1205;3711;295;1014;408;1164;703;2178
431990;201501;8270;22870;6316;19662;1191;4300;2428;7106;3619;11406
432000;201501;10476;29588;8289;25802;2573;8431;3097;9612;5670;18043
432010;201501;2302;6643;1922;5945;424;1461;936;2838;1360;4299
432020;201501;2367;5858;1883;5240;227;710;1343;3712;1570;4422
432023;201501;554;1598;382;1222;94;349;119;347;213;696
432026;201501;1298;3890;974;3218;177;610;533;1757;710;2367
432030;201501;411;1198;315;990;65;208;149;449;214;657
432032;201501;592;1557;401;1203;68;231;217;615;285;846
432035;201501;811;2536;713;2356;127;459;444;1438;571;1897
432040;201501;945;2265;472;1495;108;386;125;336;233;722
432045;201501;239;729;154;562;34;135;60;230;94;365
432050;201501;682;1909;588;1737;92;277;362;1102;454;1379
432055;201501;845;2578;706;2293;134;480;418;1318;552;1798
432057;201501;426;1086;329;916;35;107;225;593;260;700
432060;201501;468;1303;204;694;44;168;46;141;90;309
432065;201501;230;670;183;586;44;152;84;259;128;411
432067;201501;993;3095;712;2477;161;592;361;1258;522;1850
432070;201501;2431;6610;1674;5128;458;1594;517;1456;975;3050
432080;201501;3731;10821;3213;9898;967;3148;1261;3845;2228;6993
432085;201501;312;887;215;724;48;198;105;340;153;538
432090;201501;1482;4350;1198;3757;416;1403;418;1201;834;2604
432100;201501;1272;3708;688;2351;168;610;99;261;267;871
432110;201501;2757;8372;2108;7027;576;2152;316;917;892;3069
432120;201501;5166;15411;4403;14082;1610;5471;1436;4573;3046;10044
432130;201501;2503;7008;2019;6385;629;2194;917;2903;1546;5097
432132;201501;461;1312;239;806;28;107;87;274;115;381
432135;201501;724;2244;696;2193;95;337;518;1602;613;1939
432140;201501;2114;6657;1710;5884;412;1481;776;2764;1188;4245
432143;201501;1384;4135;1168;3782;267;894;642;2137;909;3031
432145;201501;1066;3270;678;2355;148;559;121;382;269;941
432146;201501;232;738;163;575;42;165;41;136;83;301
432147;201501;653;2069;499;1734;130;470;184;672;314;1142
432149;201501;369;1076;229;741;57;195;89;288;146;483
432150;201501;3748;10533;2775;8780;692;2442;875;2644;1567;5086
432160;201501;4271;13566;3736;12675;1182;4237;1513;5328;2695;9565
432162;201501;402;972;88;287;14;53;21;61;35;114
432163;201501;381;991;95;299;5;17;8;23;13;40
432166;201501;733;2160;594;1876;93;358;312;921;405;1279
432170;201501;958;3091;639;2376;126;483;128;453;254;936
432180;201501;2975;7862;2073;6336;599;1952;592;1787;1191;3739
432183;201501;444;1410;364;1248;166;592;74;249;240;841
432185;201501;924;2502;572;1838;114;416;253;800;367;1216
432190;201501;3355;9239;2347;7025;590;1849;671;1858;1261;3707
432195;201501;1218;3369;1036;3104;137;451;718;2127;855;2578
432200;201501;3361;10103;2706;8980;687;2478;1255;4258;1942;6736
432210;201501;441;1214;339;1058;72;267;175;504;247;771
432215;201501;890;2754;765;2557;135;431;483;1710;618;2141
432218;201501;295;793;221;653;40;126;98;263;138;389
432220;201501;4216;11132;3487;10015;384;1304;2323;6562;2707;7866
432225;201501;66;215;55;197;24;87;15;51;39;138
432230;201501;1094;2982;692;2108;180;611;232;606;412;1217
432232;201501;545;1582;432;1370;105;374;194;602;299;976
432234;201501;422;1168;289;862;64;197;104;294;168;491
432235;201501;74;219;43;149;11;50;5;14;16;64
432237;201501;481;1339;442;1279;25;102;354;999;379;1101
432240;201501;14265;46086;12173;43317;2183;9014;7349;26779;9532;35793
432250;201501;4948;17006;4537;16195;1721;6732;1440;5156;3161;11888
432252;201501;385;1137;296;976;67;242;158;517;225;759
432253;201501;1336;4279;949;3332;281;1030;258;931;539;1961
432254;201501;770;2072;244;791;49;171;38;102;87;273
432255;201501;233;598;131;432;34;118;41;132;75;250
432260;201501;7561;19019;5264;15242;1209;3638;2217;6622;3426;10260
432270;201501;2578;7706;2185;7046;599;1984;986;3280;1585;5264
432280;201501;1269;3520;677;2214;122;431;153;440;275;871
432285;201501;171;544;56;194;12;48;11;29;23;77
432290;201501;593;1783;393;1319;98;352;135;439;233;791
432300;201501;23141;69566;20626;65289;4377;15046;11581;36424;15958;51470
432310;201501;834;2498;678;2230;139;518;375;1208;514;1726
432320;201501;248;644;125;396;32;106;24;69;56;175
432330;201501;315;845;127;428;17;55;11;34;28;89
432335;201501;216;629;99;340;23;86;10;27;33;113
432340;201501;350;873;164;498;33;109;55;161;88;270
432345;201501;674;1864;617;1771;93;350;376;986;469;1336
432350;201501;436;1179;250;824;60;211;76;227;136;438
432360;201501;164;494;32;112;8;37;10;26;18;63
432370;201501;455;1286;361;1100;33;92;241;761;274;853
432375;201501;822;2088;646;1808;92;271;384;1092;476;1363
432377;201501;169;550;47;159;7;31;14;34;21;65
432380;201501;830;2807;736;2629;272;1104;287;952;559;2056
500020;201501;2175;6627;1637;5611;398;1592;594;1889;992;3481
500025;201501;1157;2795;749;2096;115;328;405;1119;520;1447
500060;201501;6659;19588;5334;17425;766;2552;3485;11856;4251;14408
500070;201501;4020;11854;3411;10814;738;2703;1610;5030;2348;7733
500080;201501;1638;4781;1208;4012;357;1325;420;1429;777;2754
500085;201501;2214;5843;1632;4973;205;689;972;2864;1177;3553
500090;201501;2391;6915;1814;5885;386;1328;872;2898;1258;4226
500100;201501;2462;7341;2220;6957;603;2212;1109;3323;1712;5535
500110;201501;8347;24578;6863;22352;1133;3986;3857;13329;4990;17315
500124;201501;1996;6392;1727;5953;310;1055;990;3728;1300;4783
500150;201501;1413;3544;1038;2943;208;704;482;1195;690;1899
500190;201501;4771;12418;3753;11108;647;2050;2272;6991;2919;9041
500200;201501;2424;6188;1912;5347;268;874;1135;3150;1403;4024
500210;201501;4782;14337;4071;13249;898;3101;2097;6962;2995;10063
500215;201501;1661;5108;1364;4545;257;956;561;1792;818;2748
500220;201501;2854;9034;2375;8190;547;2037;899;3179;1446;5216
500230;201501;2644;6788;2001;5837;545;1739;871;2567;1416;4306
500240;201501;4842;15031;3508;12365;605;2345;1380;5107;1985;7452
500260;201501;2622;6859;2001;5880;316;1027;995;2773;1311;3800
500270;201501;116795;301265;76703;233607;19684;65321;19361;58635;39045;123956
500280;201501;1352;3804;1134;3513;117;384;833;2637;950;3021
500290;201501;4067;9845;2491;7408;627;2154;755;2025;1382;4179
500295;201501;2530;7567;1715;5643;338;1252;440;1246;778;2498
500310;201501;776;2051;671;1898;152;475;324;884;476;1359
500315;201501;3123;9744;2640;9037;450;1600;1698;6053;2148;7653
500320;201501;15117;49127;12620;44603;3931;14866;4439;16690;8370;31556
500325;201501;4040;10462;2987;8827;673;2173;1461;4242;2134;6415
500330;201501;6218;16761;4765;14138;1020;3325;2374;6919;3394;10244
500345;201501;2160;5756;1698;5021;262;895;1012;2934;1274;3829
500348;201501;2345;6718;2057;6264;166;621;1565;4718;1731;5339
500350;201501;1232;3769;799;2781;134;510;247;877;381;1387
500370;201501;22795;69419;17597;59777;4068;15473;5829;19893;9897;35366
500375;201501;2882;7907;2134;6521;522;1728;837;2606;1359;4334
500380;201501;2863;8158;2391;7347;752;2411;858;2636;1610;5047
500390;201501;605;1295;387;995;34;112;278;675;312;787
500400;201501;1323;4043;1011;3304;243;878;297;888;540;1766
500410;201501;2247;6303;1795;5634;449;1571;841;2621;1290;4192
500430;201501;2420;7007;1939;6324;391;1448;913;3042;1304;4490
500440;201501;1385;3800;1058;3274;207;713;540;1637;747;2350
500450;201501;1972;6050;1529;5196;354;1365;318;956;672;2321
500460;201501;3510;10753;2875;9569;837;3117;761;2490;1598;5607
500470;201501;2990;8874;2159;7094;605;2167;343;1024;948;3191
500480;201501;1913;6202;1786;6031;164;550;1472;5097;1636;5647
500490;201501;1005;2772;797;2414;235;795;249;758;484;1553
500500;201501;3606;11262;2870;10146;1100;4397;866;3033;1966;7430
500510;201501;849;2208;541;1670;87;308;238;672;325;980
500515;201501;1845;4901;1519;4475;239;686;921;2972;1160;3658
500520;201501;2977;10211;2656;9759;484;1913;1713;6484;2197;8397
500525;201501;1193;3812;971;3390;199;738;493;1813;692;2551
500540;201501;5786;16262;3555;12000;1058;4144;584;1774;1642;5918
500560;201501;4596;15123;4185;14522;647;2456;3019;10515;3666;12971
500568;201501;3863;9877;2777;8322;570;1963;1364;3979;1934;5942
500570;201501;7280;19672;4985;15445;1391;4620;1425;4302;2816;8922
500580;201501;3622;10449;2908;9230;350;1216;1999;6356;2349;7572
500600;201501;3464;9378;2420;7466;575;1956;928;2846;1503;4802
500620;201501;8203;22957;6086;19241;1248;4416;2888;9190;4136;13606
500625;201501;766;2303;483;1669;107;403;150;495;257;898
500627;201501;476;1386;377;1207;77;250;117;400;194;650
500630;201501;5882;16223;4543;14192;1299;4515;1564;4795;2863;9310
500635;201501;2577;9974;2159;9311;327;1318;1354;6419;1681;7737
500640;201501;1653;4013;1289;3504;99;321;960;2582;1059;2903
500660;201501;17923;52207;14145;45984;4076;14975;5029;16244;9105;31219
500690;201501;2935;8395;2360;7674;859;2860;878;3127;1737;5987
500710;201501;3568;10599;3040;9727;630;2259;1549;4927;2179;7186
500720;201501;5843;15676;3831;12150;1070;3738;1092;3372;2162;7110
500730;201501;947;2653;698;2165;151;524;276;820;427;1344
500740;201501;3723;10452;3026;9162;508;1883;1346;4012;1854;5895
500750;201501;834;2375;758;2281;158;500;485;1508;643;2008
500755;201501;1222;3553;873;2839;190;699;307;893;497;1592
500769;201501;4902;13125;3104;9477;614;2117;788;2063;1402;4180
500770;201501;1773;5279;1350;4493;387;1425;423;1421;810;2846
500780;201501;1004;2964;839;2657;206;709;341;1033;547;1742
500790;201501;9006;25156;7614;22755;1402;4893;4182;12032;5584;16925
500793;201501;2274;6588;1834;5890;350;1278;865;2636;1215;3914
500795;201501;2465;7239;2119;6765;255;686;1604;5444;1859;6130
500797;201501;866;2347;641;1967;93;319;311;953;404;1272
500800;201501;2679;7409;2109;6626;821;2946;667;2110;1488;5056
500830;201501;16272;45786;11557;36597;2710;9550;3562;10713;6272;20263
500840;201501;1369;3840;987;3087;139;482;456;1380;595;1862
510010;201501;1194;3693;1041;3438;323;1091;470;1602;793;2693
510020;201501;3060;8855;2041;6842;495;1801;601;1928;1096;3729
510025;201501;7912;23224;6662;21060;1574;5619;2899;8682;4473;14301
510030;201501;1752;4883;1477;4438;382;1302;632;1756;1014;3058
510035;201501;784;2385;680;2215;112;363;428;1439;540;1802
510040;201501;1684;4619;1308;4069;239;847;716;2232;955;3079
510050;201501;1870;5509;1378;4583;366;1332;485;1584;851;2916
510060;201501;1425;4107;1084;3494;249;861;394;1244;643;2105
510080;201501;1152;3576;930;3166;290;1112;241;742;531;1854
510100;201501;678;1811;473;1412;63;209;207;584;270;793
510120;201501;313;655;183;492;20;56;115;307;135;363
510125;201501;3086;8157;2477;7089;458;1630;1125;2998;1583;4628
510130;201501;1878;5122;1563;4646;399;1259;641;1906;1040;3165
510140;201501;2991;9614;2408;8704;962;3855;586;1920;1548;5775
510160;201501;1356;4543;1257;4414;121;488;996;3500;1117;3988
510170;201501;5645;17087;4663;15370;932;3477;2253;7190;3185;10667
510180;201501;11626;30748;8348;25544;2368;7640;2862;9627;5230;17267
510185;201501;1350;3947;1110;3640;156;471;758;2737;914;3208
510190;201501;2115;6455;1493;5479;391;1592;596;2270;987;3862
510250;201501;13726;42419;11834;39740;3357;12190;5524;18999;8881;31189
510260;201501;2250;8953;1996;8425;633;2881;788;3636;1421;6517
510263;201501;4199;11285;3052;9420;763;2540;980;2915;1743;5455
510267;201501;5524;15960;4058;12913;951;3290;1257;3817;2208;7107
510268;201501;828;2417;713;2255;157;518;401;1290;558;1808
510269;201501;969;2944;754;2546;225;798;310;1065;535;1863
510270;201501;2631;8347;2344;7839;424;1499;1282;4401;1706;5900
510279;201501;1962;6160;1739;5761;530;1915;575;1747;1105;3662
510285;201501;1412;4203;1116;3683;284;1032;423;1334;707;2366
510300;201501;3173;9496;2705;8832;221;853;2120;6940;2341;7793
510305;201501;1486;4593;1182;4015;304;1131;359;1190;663;2321
510310;201501;857;2610;721;2361;242;856;233;735;475;1591
510320;201501;3752;10952;2925;9389;849;3143;613;1782;1462;4925
510325;201501;5308;16921;4588;15944;915;3291;3128;11150;4043;14441
510330;201501;2754;8832;2299;8046;587;2275;859;2998;1446;5273
510335;201501;4553;14191;3921;13373;617;2108;2761;9894;3378;12002
510336;201501;557;1695;437;1463;99;365;217;714;316;1079
510337;201501;2171;7157;1833;6515;740;2658;511;2006;1251;4664
510340;201501;65603;187624;50907;164863;18851;67154;11534;39089;30385;106243
510343;201501;1086;3205;962;3039;90;282;776;2525;866;2807
510345;201501;1652;4905;1371;4402;331;1157;493;1486;824;2643
510350;201501;3417;9448;2698;8471;665;2205;1324;4336;1989;6541
510360;201501;1779;4439;1185;3708;148;555;824;2508;972;3063
510370;201501;986;3466;882;3311;197;780;531;2030;728;2810
510380;201501;529;1636;386;1365;152;599;63;204;215;803
510385;201501;973;3600;740;3061;118;514;346;1535;464;2049
510390;201501;1117;3414;1026;3306;250;665;662;2356;912;3021
510395;201501;829;2097;651;1859;95;289;341;1094;436;1383
510410;201501;3791;12411;3453;11779;822;2991;1918;6593;2740;9584
510420;201501;2354;6109;1752;5104;230;825;945;2708;1175;3533
510450;201501;600;1640;449;1416;111;406;182;556;293;962
510452;201501;609;1999;441;1601;95;389;185;647;280;1036
510454;201501;818;2640;722;2480;116;419;469;1660;585;2079
510455;201501;969;2973;739;2521;172;681;244;793;416;1474
510460;201501;2175;5799;1723;5169;210;766;1126;3278;1336;4044
510480;201501;4451;11975;3255;9811;834;2654;830;2358;1664;5012
510490;201501;1424;4637;1262;4395;255;1046;780;2629;1035;3675
510500;201501;1521;4558;1070;3664;267;1071;450;1479;717;2550
510510;201501;2736;9605;2396;9016;784;3226;950;3537;1734;6763
510515;201501;6191;19165;4859;16242;1135;4227;1266;3989;2401;8216
510517;201501;1764;5229;1513;4829;484;1599;678;2241;1162;3840
510520;201501;2079;5048;1556;4370;79;269;1154;3342;1233;3611
510523;201501;1026;3083;895;2865;157;531;572;1853;729;2384
510525;201501;7701;19517;5101;15539;1106;3614;1952;5932;3058;9546
510530;201501;526;1502;448;1395;67;272;268;798;335;1070
510550;201501;2525;8420;2151;7737;606;2319;848;3096;1454;5415
510558;201501;1998;5769;1669;5290;408;1420;808;2599;1216;4019
510560;201501;1658;5315;1166;4463;355;1483;308;1213;663;2696
510562;201501;5074;15381;4197;13647;1292;4718;1376;4499;2668;9217
510590;201501;2888;7703;2344;7009;594;1859;1152;3525;1746;5384
510600;201501;1523;3953;1010;3112;191;658;426;1205;617;1863
510610;201501;2767;7937;2393;7429;186;671;1921;5987;2107;6658
510615;201501;2256;6990;1921;6465;577;2083;891;3044;1468;5127
510617;201501;580;1701;476;1518;53;173;358;1187;411;1360
510618;201501;1417;4119;1023;3364;220;871;458;1439;678;2310
510619;201501;805;2206;512;1675;89;332;112;332;201;664
510620;201501;1439;3624;818;2678;251;952;179;532;430;1484
510621;201501;981;3419;870;3188;240;971;306;1061;546;2032
510622;201501;3711;11229;2574;8831;679;2562;395;1114;1074;3676
510623;201501;3440;9832;2794;8719;796;2678;1156;3499;1952;6177
510624;201501;1325;3998;972;3323;218;852;346;1079;564;1931
510625;201501;2180;6353;1760;5645;490;1752;438;1336;928;3088
510626;201501;1336;3921;997;3445;324;1246;434;1527;758;2773
510627;201501;750;2120;499;1599;134;477;134;423;268;900
510628;201501;1603;3985;1172;3405;117;374;869;2526;986;2900
510629;201501;1816;5840;1505;5173;442;1685;512;1690;954;3375
510630;201501;2544;8579;2065;7678;616;2594;500;1862;1116;4456
510631;201501;389;1131;358;1084;55;167;251;763;306;930
510637;201501;2627;7602;2269;7022;549;1863;1148;3504;1697;5367
510642;201501;4636;15342;4036;14502;1188;4614;1974;7370;3162;11984
510645;201501;943;2144;611;1702;197;555;217;648;414;1203
510650;201501;5911;20248;5452;19689;1135;4174;3624;13746;4759;17920
510665;201501;1260;3438;858;2700;246;827;259;783;505;1610
510670;201501;386;894;218;653;34;131;91;252;125;383
510675;201501;6186;19818;5091;17679;1554;6145;1293;4228;2847;10373
510677;201501;2203;5825;1759;5249;221;675;1293;4015;1514;4690
510680;201501;758;2311;618;2050;128;470;249;765;377;1235
510682;201501;2283;7111;1778;6179;457;1783;494;1630;951;3413
510685;201501;941;2499;786;2297;77;263;583;1679;660;1942
510700;201501;4320;11283;2997;9400;648;2158;1638;5268;2286;7426
510704;201501;8366;22752;6957;20499;1445;4760;3779;10916;5224;15676
510706;201501;1844;5579;1352;4807;322;1190;689;2523;1011;3713
510710;201501;3449;9676;2537;7864;658;2181;685;1889;1343;4070
510715;201501;658;1673;425;1255;91;301;170;460;261;761
510718;201501;1876;5149;1466;4694;600;1975;566;1912;1166;3887
510719;201501;453;1034;282;809;36;143;124;324;160;467
510720;201501;1301;3061;983;2694;120;334;711;1990;831;2324
510724;201501;809;2459;679;2219;150;562;342;1039;492;1601
510726;201501;638;1709;502;1492;118;366;189;538;307;904
510729;201501;742;1906;494;1497;119;392;223;681;342;1073
510730;201501;2379;7243;2026;6615;498;1827;944;2967;1442;4794
510735;201501;1094;3711;894;3383;218;909;455;1719;673;2628
510740;201501;1125;2777;828;2341;207;582;454;1336;661;1918
510757;201501;647;2215;555;2031;167;647;225;835;392;1482
510760;201501;27889;74430;20333;61896;6045;19943;6426;19434;12471;39377
510770;201501;4335;11379;3788;10756;401;1085;2596;8295;2997;9380
510774;201501;436;1200;366;1093;79;279;173;530;252;809
510775;201501;783;2257;657;2056;227;773;230;711;457;1484
510776;201501;471;1325;390;1183;96;320;189;561;285;881
510777;201501;1642;4845;1225;4280;180;699;912;3204;1092;3903
510779;201501;688;2001;513;1697;84;301;227;763;311;1064
510780;201501;3716;11107;3150;10250;750;2546;1558;5322;2308;7868
510785;201501;1711;5105;1396;4558;452;1572;454;1507;906;3079
510787;201501;2020;6143;1647;5515;573;2045;472;1537;1045;3582
510788;201501;495;1334;379;1158;154;465;116;392;270;857
510790;201501;15568;45339;10701;36112;2666;10386;1258;4045;3924;14431
510792;201501;6893;21342;5062;17819;1181;4810;1136;3686;2317;8496
510794;201501;1174;3687;977;3369;372;1407;258;806;630;2213
510795;201501;8489;26029;6288;21770;1768;6755;1579;5537;3347;12292
510800;201501;1699;4719;1381;4297;363;1246;638;1885;1001;3131
510805;201501;1858;5260;1564;4844;135;425;1236;3880;1371;4305
510810;201501;687;1671;540;1477;145;422;268;702;413;1124
510820;201501;767;1831;532;1483;103;328;223;562;326;890
510830;201501;596;1993;519;1873;156;596;259;1004;415;1600
510835;201501;656;2001;494;1677;145;549;168;511;313;1060
510840;201501;49346;121035;38849;107874;8545;25052;20617;59204;29162;84256
510850;201501;1412;4087;1104;3595;394;1470;195;489;589;1959
510860;201501;2540;8304;1940;7036;672;2674;238;829;910;3503
510880;201501;686;2278;595;2123;168;647;280;1030;448;1677
510885;201501;605;1697;483;1533;81;301;223;701;304;1002
510890;201501;841;2716;701;2484;242;974;230;710;472;1684
510895;201501;1101;3456;940;3147;254;979;403;1281;657;2260
520005;201501;1219;3919;1120;3762;316;1106;547;1880;863;2986
520010;201501;1631;5541;1375;5028;535;2237;309;1030;844;3267
520013;201501;3711;10218;2790;8572;625;2031;1152;3534;1777;5565
520015;201501;491;1396;395;1257;96;329;163;534;259;863
520017;201501;1097;3363;941;3112;251;929;406;1281;657;2210
520020;201501;397;1060;310;935;71;225;151;463;222;688
520025;201501;24538;77747;23689;76774;2404;8273;19856;64671;22260;72944
520030;201501;4381;13971;3794;13062;930;3515;1809;6270;2739;9785
520050;201501;305;849;259;772;28;88;188;560;216;648
520055;201501;763;2289;646;2058;123;376;344;1133;467;1509
520060;201501;1397;4394;1218;4039;254;968;526;1680;780;2648
520080;201501;1700;5171;1472;4840;346;1117;821;2849;1167;3966
520082;201501;802;2456;736;2350;141;414;454;1545;595;1959
520085;201501;955;2942;816;2677;179;628;301;974;480;1602
520090;201501;940;2178;699;1872;147;340;381;1100;528;1440
520110;201501;40437;118804;31900;105997;11941;44832;7592;24922;19533;69754
520120;201501;254;661;151;482;38;138;35;115;73;253
520130;201501;3423;9851;3124;9415;524;1695;2013;6093;2537;7788
520140;201501;42369;137831;37424;128693;13142;49373;9505;32104;22647;81477
520145;201501;425;1127;331;990;73;230;146;421;219;651
520150;201501;656;1766;539;1630;139;451;290;871;429;1322
520160;201501;796;2290;667;2100;215;727;221;695;436;1422
520170;201501;3891;9230;3116;8357;323;936;2484;6772;2807;7708
520180;201501;1898;5691;1586;5197;377;1436;657;2096;1034;3532
520215;201501;1854;4849;1576;4427;229;686;1002;2846;1231;3532
520235;201501;747;1964;567;1702;140;470;262;751;402;1221
520250;201501;1251;3936;1047;3595;314;1168;472;1642;786;2810
520260;201501;783;2023;554;1601;82;254;256;717;338;971
520280;201501;511;1508;470;1450;224;745;129;440;353;1185
520310;201501;1119;2735;856;2367;211;568;408;1243;619;1811
520320;201501;1710;5424;1416;4853;170;625;893;3136;1063;3761
520330;201501;2713;8433;2097;7375;642;2520;398;1308;1040;3828
520340;201501;1809;4607;1396;4113;181;461;1056;3275;1237;3736
520350;201501;2792;8018;2322;7149;621;2165;1076;3160;1697;5325
520355;201501;1061;3599;975;3467;341;1331;400;1372;741;2703
520357;201501;792;2192;682;2021;49;163;509;1499;558;1662
520360;201501;623;1809;560;1703;115;362;285;887;400;1249
520380;201501;1263;3421;876;2701;168;577;397;1222;565;1799
520390;201501;984;2424;619;1933;151;570;266;762;417;1332
520393;201501;543;1408;462;1288;63;192;310;859;373;1051
520396;201501;726;2324;622;2125;73;286;434;1495;507;1781
520400;201501;1713;4880;1472;4556;230;787;991;3053;1221;3840
520410;201501;1498;3769;1121;3269;261;826;610;1769;871;2595
520420;201501;337;953;251;780;52;177;75;208;127;385
520425;201501;1137;3130;1013;2929;273;851;544;1548;817;2399
520430;201501;2043;5360;1348;4095;282;978;506;1416;788;2394
520440;201501;3579;9250;2508;7463;785;2571;669;1999;1454;4570
520450;201501;10109;28686;7406;23759;1949;6896;1112;3298;3061;10194
520455;201501;650;1953;531;1752;185;672;160;531;345;1203
520460;201501;851;2446;692;2176;139;507;339;1018;478;1525
520465;201501;771;2155;665;2028;156;539;346;1024;502;1563
520470;201501;1746;5652;1582;5405;318;1065;1074;3841;1392;4906
520480;201501;939;2720;746;2417;132;473;417;1332;549;1805
520485;201501;1204;3853;1040;3571;317;1205;526;1793;843;2998
520490;201501;3799;12103;3067;10936;1032;3907;1290;4683;2322;8590
520495;201501;1254;3522;1092;3315;98;313;919;2811;1017;3124
520500;201501;1460;4160;1305;3939;388;1230;636;1944;1024;3174
520505;201501;842;2375;724;2205;176;579;419;1286;595;1865
520510;201501;10355;28948;7148;23728;1988;7272;1934;6517;3922;13789
520520;201501;1011;2871;818;2587;262;880;329;1056;591;1936
520530;201501;2141;6981;1833;6457;426;1487;960;3630;1386;5117
520540;201501;2942;8385;2304;7236;612;2033;757;2411;1369;4444
520545;201501;1129;3424;947;3058;214;746;320;1006;534;1752
520547;201501;697;2223;608;2058;226;804;196;638;422;1442
520549;201501;9362;27112;7721;25110;2329;8007;3808;12567;6137;20574
520551;201501;3312;10119;3120;9889;787;2696;2003;6355;2790;9051
520552;201501;729;2329;693;2277;103;390;492;1598;595;1988
520570;201501;520;1517;376;1265;149;534;78;252;227;786
520580;201501;2828;7556;2050;6399;676;2360;731;2194;1407;4554
520590;201501;1444;4037;1169;3588;279;896;380;1115;659;2011
520620;201501;6920;22169;6331;21311;1297;4669;4007;13622;5304;18291
520630;201501;703;1897;537;1647;118;371;255;788;373;1159
520640;201501;2729;7723;2294;7035;677;2185;987;3115;1664;5300
520650;201501;791;2206;621;1879;164;552;288;859;452;1411
520660;201501;346;1047;283;949;93;329;94;318;187;647
520670;201501;847;2575;786;2483;49;138;692;2227;741;2365
520680;201501;604;1717;496;1573;129;429;239;767;368;1196
520690;201501;389;994;271;821;52;138;129;427;181;565
520710;201501;515;1322;341;994;11;33;195;566;206;599
520725;201501;1691;4313;1291;3730;291;916;725;2075;1016;2991
520735;201501;710;2051;538;1716;143;518;182;558;325;1076
520740;201501;1615;4687;1341;4318;283;1024;683;2162;966;3186
520750;201501;615;1679;496;1508;104;325;286;903;390;1228
520753;201501;1288;3691;1202;3560;155;422;889;2775;1044;3197
520760;201501;928;2514;802;2347;141;456;548;1627;689;2083
520780;201501;2000;4899;1652;4436;177;424;1228;3393;1405;3817
520790;201501;2620;7193;2238;6660;304;889;1624;4996;1928;5885
520800;201501;14989;44570;13296;42564;2549;7925;8746;29736;11295;37661
520810;201501;907;2468;800;2337;126;370;614;1856;740;2226
520815;201501;536;1749;410;1489;189;788;23;60;212;848
520830;201501;1504;4095;1293;3878;41;94;1186;3630;1227;3724
520840;201501;1462;4805;1233;4377;404;1590;267;960;671;2550
520850;201501;645;1941;519;1750;140;531;238;780;378;1311
520860;201501;6543;18662;4969;16454;1334;4760;2193;7481;3527;12241
520870;201501;109175;295998;74785;237648;20933;73987;19007;57778;39940;131765
520880;201501;6978;19962;5115;17084;1491;5646;796;2560;2287;8206
520890;201501;3907;11135;3269;10082;672;2208;1653;5120;2325;7328
520910;201501;3598;10715;2707;8965;847;3024;534;1699;1381;4723
520915;201501;837;2394;637;2025;131;448;278;861;409;1309
520920;201501;3345;9052;2373;7488;606;2069;739;2408;1345;4477
520929;201501;501;1416;424;1313;125;388;209;667;334;1055
520940;201501;1025;3007;875;2786;98;351;636;2010;734;2361
520945;201501;718;1754;591;1561;176;433;283;767;459;1200
520960;201501;752;2295;629;2075;100;338;354;1207;454;1545
520970;201501;3183;9420;2663;8518;616;2161;1025;3212;1641;5373
520980;201501;810;2327;755;2242;245;809;396;1131;641;1940
520990;201501;2878;9569;2738;9364;531;1878;1785;6304;2316;8182
520993;201501;1049;2811;859;2514;73;227;607;1788;680;2015
520995;201501;2529;6939;2300;6636;334;980;1668;4857;2002;5837
521000;201501;6915;21172;5963;19556;1456;5446;2606;8315;4062;13761
521010;201501;3774;11451;3117;10230;803;2836;1200;3992;2003;6828
521015;201501;664;1850;561;1687;128;364;311;976;439;1340
521020;201501;3890;11077;2802;8900;821;2835;490;1353;1311;4188
521030;201501;587;1552;513;1438;112;314;277;790;389;1104
521040;201501;5636;15553;4915;14492;1731;5195;2166;6816;3897;12011
521056;201501;874;2717;741;2500;239;856;316;1117;555;1973
521060;201501;1144;3211;1001;2992;273;769;435;1352;708;2121
521080;201501;1188;2861;736;2129;121;431;282;682;403;1113
521090;201501;2899;8110;2359;7398;770;2534;946;3121;1716;5655
521100;201501;1627;3933;1382;3663;240;620;949;2632;1189;3252
521120;201501;4381;12412;3727;11482;896;2935;1885;5907;2781;8842
521130;201501;1031;2853;793;2403;140;525;443;1296;583;1821
521140;201501;973;3115;845;2858;265;967;243;808;508;1775
521150;201501;12713;32860;8018;23834;2565;8296;2175;6316;4740;14612
521160;201501;825;2000;510;1440;103;319;226;603;329;922
521170;201501;1188;2899;950;2584;226;624;545;1478;771;2102
521180;201501;6495;21625;5925;20607;2166;8021;1836;6419;4002;14440
521190;201501;9058;26178;6405;21516;1861;6666;1846;6222;3707;12888
521200;201501;735;1934;642;1801;69;220;430;1181;499;1401
521205;201501;588;1739;465;1519;56;209;268;880;324;1089
521210;201501;891;2469;628;1972;205;752;219;601;424;1353
521220;201501;3643;10160;2915;9191;882;3063;1187;3682;2069;6745
521225;201501;359;898;285;811;31;85;204;608;235;693
521230;201501;1188;3727;1084;3521;359;1256;517;1629;876;2885
521250;201501;26514;86471;24292;83157;9609;35238;8734;30413;18343;65651
521260;201501;758;1847;610;1601;93;315;379;918;472;1233
521270;201501;1816;5673;1670;5456;159;418;1302;4474;1461;4892
521280;201501;1837;5693;1540;5149;467;1684;541;1779;1008;3463
521290;201501;516;1485;383;1269;110;428;143;457;253;885
521295;201501;1046;2824;932;2672;79;238;794;2304;873;2542
521300;201501;1664;4916;1525;4707;254;767;1022;3261;1276;4028
521305;201501;794;2212;662;2021;122;355;425;1360;547;1715
521308;201501;4651;13966;3748;12234;877;3016;1791;5820;2668;8836
521310;201501;7458;22419;5678;19087;1648;6017;1305;4079;2953;10096
521340;201501;246;723;222;689;32;118;143;426;175;544
521350;201501;1934;5297;1639;4861;220;664;1153;3509;1373;4173
521370;201501;872;2777;765;2579;241;873;251;806;492;1679
521375;201501;1295;3804;1096;3471;267;939;534;1605;801;2544
521377;201501;1010;2726;964;2676;72;140;849;2452;921;2592
521380;201501;4826;13631;3488;11142;705;2476;706;2278;1411;4754
521385;201501;512;1409;440;1316;105;339;244;717;349;1056
521390;201501;896;2439;702;2176;206;731;223;668;429;1399
521400;201501;2162;6032;1961;5786;270;880;1499;4425;1769;5305
521405;201501;1337;3829;1062;3336;322;1141;472;1470;794;2611
521410;201501;707;2198;648;2104;235;745;286;996;521;1741
521440;201501;1377;3871;1331;3813;81;213;1198;3479;1279;3692
521450;201501;4417;13870;3609;12381;1054;3954;944;3201;1998;7155
521460;201501;6443;19350;5673;18105;1386;4882;2895;9087;4281;13969
521470;201501;723;2062;545;1718;144;515;104;308;248;823
521480;201501;379;1148;299;989;76;257;108;354;184;611
521483;201501;2952;7694;2322;6634;653;1999;802;2203;1455;4202
521486;201501;1511;3922;1303;3614;132;398;994;2741;1126;3139
521487;201501;634;1638;458;1377;93;263;204;654;297;917
521490;201501;777;2302;648;2094;68;278;469;1502;537;1780
521500;201501;1323;4252;1064;3693;204;819;413;1308;617;2127
521520;201501;860;2092;673;1834;186;490;331;942;517;1432
521523;201501;11863;44108;11110;42845;4230;17510;2010;8488;6240;25998
521525;201501;1021;2678;910;2526;115;381;651;1762;766;2143
521530;201501;1609;4659;1029;3451;257;939;197;592;454;1531
521540;201501;964;2635;672;2135;166;630;208;610;374;1240
521550;201501;975;2490;861;2319;221;647;460;1198;681;1845
521560;201501;4225;13854;3632;12993;1402;5503;1152;4042;2554;9545
521565;201501;683;1754;585;1636;92;238;404;1170;496;1408
521570;201501;4380;12406;3095;9815;828;2836;984;3104;1812;5940
521580;201501;567;1322;394;1090;112;345;136;364;248;709
521590;201501;633;1839;513;1645;167;582;92;313;259;895
521600;201501;562;1477;393;1196;105;341;115;312;220;653
521630;201501;1437;3687;1076;3165;303;1073;222;520;525;1593
521640;201501;1884;4970;1513;4459;457;1517;629;1886;1086;3403
521645;201501;583;1710;467;1454;68;242;214;616;282;858
521680;201501;1439;4611;1223;4166;639;2333;198;629;837;2962
521690;201501;562;1664;505;1563;118;438;240;681;358;1119
521710;201501;2514;7824;2161;7102;489;1695;1001;3302;1490;4997
521720;201501;1854;5328;1591;4961;316;996;1048;3283;1364;4279
521730;201501;3755;12424;3386;11736;1368;5303;897;2835;2265;8138
521740;201501;3231;8928;2561;8047;847;2875;1212;3975;2059;6850
521760;201501;12022;40659;11027;39063;2315;9176;6174;22052;8489;31228
521770;201501;2566;7605;2106;6765;805;2782;624;1895;1429;4677
521800;201501;7586;22591;6569;20944;2097;7172;2623;8654;4720;15826
521805;201501;853;1980;633;1661;155;370;351;1001;506;1371
521810;201501;681;1930;565;1746;119;400;307;948;426;1348
521830;201501;5048;16764;4666;16195;839;3181;3121;10855;3960;14036
521839;201501;731;2062;567;1753;122;432;196;566;318;998
521850;201501;6374;17572;5205;15533;1219;3786;1918;5382;3137;9168
521860;201501;1743;5043;1425;4470;328;1140;495;1510;823;2650
521870;201501;482;1687;444;1591;137;535;134;445;271;980
521878;201501;711;2103;521;1700;122;455;212;657;334;1112
521880;201501;24174;62092;16096;49063;4458;14598;5078;15657;9536;30255
521890;201501;3528;10714;2861;9423;983;3515;713;2284;1696;5799
521900;201501;1408;3676;1090;3275;269;885;482;1367;751;2252
521910;201501;1028;2879;917;2748;183;572;573;1788;756;2360
521920;201501;344;1028;295;945;92;336;102;291;194;627
521925;201501;632;1908;554;1767;104;367;232;681;336;1048
521930;201501;3893;12569;3504;11860;1185;4297;974;3289;2159;7586
521935;201501;632;1830;568;1716;152;461;282;835;434;1296
521940;201501;996;2815;821;2526;240;784;332;1010;572;1794
521945;201501;627;2127;589;2078;110;361;409;1532;519;1893
521950;201501;571;1627;458;1451;103;360;212;684;315;1044
521960;201501;769;2276;635;2040;134;501;286;880;420;1381
521970;201501;2362;6773;2119;6457;308;968;1543;4812;1851;5780
521971;201501;1080;2919;817;2440;174;557;271;764;445;1321
521973;201501;846;2718;726;2492;182;664;250;835;432;1499
521975;201501;12391;34326;11638;33452;1720;5181;8669;24993;10389;30174
521980;201501;1866;5575;1687;5361;244;681;1322;4400;1566;5081
521990;201501;1035;3102;894;2886;127;473;584;1878;711;2351
522000;201501;1783;5456;1542;5126;231;910;1018;3365;1249;4275
522005;201501;392;987;274;798;74;210;97;282;171;492
522010;201501;3039;8931;2554;8144;949;3158;583;1846;1532;5004
522015;201501;865;2616;744;2431;188;645;387;1268;575;1913
522020;201501;4982;13270;4249;12309;917;2822;2614;7607;3531;10429
522026;201501;557;1529;414;1364;118;440;135;442;253;882
522028;201501;520;1548;431;1347;79;258;270;832;349;1090
522040;201501;2569;6469;1988;5737;473;1429;1078;3141;1551;4570
522045;201501;14618;47556;12360;43098;3950;15236;2699;9160;6649;24396
522050;201501;1061;3052;838;2664;248;866;310;917;558;1783
522060;201501;2780;8403;2190;7498;638;2413;1016;3394;1654;5807
522068;201501;1584;5089;1471;4964;122;318;1233;4402;1355;4720
522070;201501;789;2394;710;2271;76;307;506;1601;582;1908
522100;201501;633;1842;563;1739;196;686;266;769;462;1455
522108;201501;889;2744;772;2568;70;257;600;1991;670;2248
522119;201501;1342;4176;1161;3915;237;843;652;2280;889;3123
522130;201501;454;1333;404;1272;119;392;225;713;344;1105
522140;201501;17258;47683;14466;43312;4199;13640;5503;15951;9702;29591
522145;201501;792;2251;728;2154;360;1157;206;581;566;1738
522150;201501;923;2610;816;2432;250;770;334;984;584;1754
522155;201501;760;2221;681;2105;122;366;457;1465;579;1831
522157;201501;688;1984;590;1841;53;197;474;1472;527;1669
522160;201501;5914;16906;4345;14152;1543;5613;605;1838;2148;7451
522170;201501;3119;8728;2607;7935;812;2527;903;2870;1715;5397
522180;201501;342;1000;271;881;92;320;93;311;185;631
522185;201501;15747;46947;13598;44141;3161;10979;7687;25268;10848;36247
522190;201501;963;2421;751;2092;122;351;422;1207;544;1558
522200;201501;1571;5144;1392;4782;444;1667;417;1352;861;3019
522205;201501;1357;3974;1138;3623;305;1036;521;1653;826;2689
522220;201501;1400;3809;1127;3473;282;889;561;1910;843;2799
522230;201501;1153;3369;1006;3135;120;435;691;2162;811;2597
530010;201501;236098;748432;210875;703251;59915;221677;72637;238071;132552;459748
