ibge;anomes;cadunico_tot_fam;cadunico_tot_pes;cadunico_tot_fam_rpc_ate_meio_sm;cadunico_tot_pes_rpc_ate_meio_sm;cadunico_tot_fam_pob;cadunico_tot_pes_pob;cadunico_tot_fam_ext_pob;cadunico_tot_pes_ext_pob;cadunico_tot_fam_pob_e_ext_pob;cadunico_tot_pes_pob_e_ext_pob
110001;201612;3154;10499;2747;9774;669;2451;1299;4633;1968;7084
110002;201612;12481;35814;8970;29319;2840;9885;2594;8104;5434;17989
110003;201612;690;2168;558;1914;167;604;102;320;269;924
110004;201612;9020;28149;6800;23423;2127;7714;1155;4153;3282;11867
110005;201612;1689;5298;1375;4649;455;1592;530;1760;985;3352
110006;201612;1625;4983;993;3559;291;1070;96;294;387;1364
110007;201612;1343;3998;1118;3563;345;1166;415;1494;760;2660
110008;201612;2329;7840;2140;7563;367;1190;1530;5657;1897;6847
110009;201612;4445;13413;3201;11218;959;3542;858;3029;1817;6571
110010;201612;6892;21759;5842;20087;1766;6172;2505;9331;4271;15503
110011;201612;6711;20735;5446;18107;1969;6794;1535;4980;3504;11774
110012;201612;14500;41286;10395;33685;2844;9360;2564;8392;5408;17752
110013;201612;5245;16532;4232;14507;1796;6301;869;3129;2665;9430
110014;201612;3951;11382;3189;10055;922;2948;1467;4580;2389;7528
110015;201612;4722;14032;2929;10225;755;2743;434;1541;1189;4284
110018;201612;3777;10535;2564;8464;660;2416;825;2533;1485;4949
110020;201612;65206;175050;44340;143968;10351;35044;18593;61578;28944;96622
110025;201612;4062;11532;3120;9737;485;1631;1935;5885;2420;7516
110026;201612;608;1846;536;1734;145;451;271;918;416;1369
110028;201612;5878;17963;4341;14657;1297;4667;481;1630;1778;6297
110029;201612;1279;3583;945;3042;269;884;377;1207;646;2091
110030;201612;9683;26422;6726;21787;1940;6779;2189;6877;4129;13656
110032;201612;3551;11008;2815;9419;943;3146;696;2313;1639;5459
110033;201612;4850;15607;4087;14100;1415;4916;1251;4543;2666;9459
110034;201612;3303;8880;2528;7718;879;2808;1163;3447;2042;6255
110037;201612;1807;6205;1521;5546;425;1606;627;2277;1052;3883
110040;201612;3175;9880;2485;8492;742;2694;809;2643;1551;5337
110045;201612;4761;15320;3995;14175;1373;5245;1589;5508;2962;10753
110050;201612;1592;5099;1287;4470;491;1737;430;1509;921;3246
110060;201612;786;2588;583;2132;187;733;88;326;275;1059
110070;201612;1937;6430;1682;5828;576;2134;538;1762;1114;3896
110080;201612;4605;12245;3761;11227;626;1736;2678;8381;3304;10117
110090;201612;681;1973;471;1569;130;466;196;628;326;1094
110092;201612;1219;4043;1062;3786;205;769;632;2302;837;3071
110094;201612;3377;9920;2738;8915;952;3264;924;2970;1876;6234
110100;201612;2065;6468;1793;5952;499;1752;880;2889;1379;4641
110110;201612;1568;4958;1284;4479;513;1843;276;1009;789;2852
110120;201612;1674;5251;1208;4190;345;1248;228;777;573;2025
110130;201612;2329;6620;1557;5195;479;1698;354;1191;833;2889
110140;201612;2294;7436;1731;6223;448;1686;385;1282;833;2968
110143;201612;1197;3650;855;3022;301;1117;285;1004;586;2121
110145;201612;1013;2887;692;2251;188;661;279;875;467;1536
110146;201612;387;1213;328;1117;71;231;165;572;236;803
110147;201612;649;1931;468;1561;127;437;147;455;274;892
110148;201612;1094;3365;652;2287;120;439;51;168;171;607
110149;201612;3198;9481;2421;8177;866;2891;883;3156;1749;6047
110150;201612;2325;6683;1834;5924;615;2082;560;1842;1175;3924
110155;201612;806;2498;665;2156;161;568;284;873;445;1441
110160;201612;1782;5747;1407;4953;530;1852;379;1379;909;3231
110170;201612;2679;7554;1830;5911;450;1526;815;2562;1265;4088
110175;201612;1584;4834;1221;4282;228;834;638;2305;866;3139
110180;201612;1133;3350;920;3005;262;836;445;1484;707;2320
120001;201612;2707;9181;2406;8667;516;1926;1443;5297;1959;7223
120005;201612;1529;6422;1416;6187;167;795;1007;4542;1174;5337
120010;201612;4661;15702;4409;15301;561;1900;3382;11966;3943;13866
120013;201612;1966;7874;1850;7692;441;1829;1076;4739;1517;6568
120017;201612;1914;6907;1724;6531;499;1909;710;2983;1209;4892
120020;201612;14009;62038;13384;60675;1917;9051;9374;43697;11291;52748
120025;201612;2330;8156;2216;7965;411;1554;1381;5023;1792;6577
120030;201612;6528;25112;6276;24765;201;1100;5673;22296;5874;23396
120032;201612;1512;7332;1425;7089;145;907;1077;5307;1222;6214
120033;201612;3521;14147;3409;13935;202;941;2987;12231;3189;13172
120034;201612;2100;8875;1967;8576;142;893;1581;6715;1723;7608
120035;201612;3155;14023;3058;13819;220;1156;2578;11722;2798;12878
120038;201612;2503;9021;2330;8682;613;2337;1214;4629;1827;6966
120039;201612;1772;8416;1700;8262;173;1024;1305;6345;1478;7369
120040;201612;42893;153346;38481;144743;8724;35326;19632;74354;28356;109680
120042;201612;3009;12439;2792;11924;248;1235;2095;8982;2343;10217
120043;201612;920;4277;883;4207;79;397;710;3491;789;3888
120045;201612;4321;14582;4177;14403;405;1571;3592;12317;3997;13888
120050;201612;7842;32158;7337;31038;958;4365;5116;22158;6074;26523
120060;201612;7728;34132;7461;33568;701;3729;5870;26554;6571;30283
120070;201612;2652;9817;2514;9513;431;1611;1620;6294;2051;7905
120080;201612;3526;13318;3341;12962;650;2647;2249;8837;2899;11484
130002;201612;3140;12868;2917;12505;157;821;2556;10958;2713;11779
130006;201612;2091;8657;1757;7971;215;1097;1297;5884;1512;6981
130008;201612;2222;8677;2013;8261;117;569;1649;6738;1766;7307
130010;201612;3099;10170;2870;9900;156;537;2568;8908;2724;9445
130014;201612;3156;10269;2675;9439;514;1928;1647;5845;2161;7773
130020;201612;2747;10248;2588;9931;102;568;2217;8345;2319;8913
130030;201612;7887;29372;7523;28931;227;691;6997;27391;7224;28082
130040;201612;3781;11610;3290;10922;322;1137;2617;8781;2939;9918
130050;201612;6120;24914;5718;24349;344;1493;4885;21319;5229;22812
130060;201612;5822;26909;5500;26311;547;3180;4280;20334;4827;23514
130063;201612;3889;17059;3692;16794;251;1281;3245;14841;3496;16122
130068;201612;3196;13276;2799;12364;239;1232;2060;9114;2299;10346
130070;201612;7381;24155;6487;23063;473;1556;5407;19720;5880;21276
130080;201612;5565;24119;5120;23376;620;3306;3726;17020;4346;20326
130083;201612;2230;8660;2070;8382;258;1189;1501;6035;1759;7224
130090;201612;2745;9665;2594;9410;77;364;2322;8418;2399;8782
130100;201612;5885;21292;5695;21042;131;538;5410;20047;5541;20585
130110;201612;6658;21428;6271;20945;605;1857;5207;17806;5812;19663
130115;201612;4635;16134;4343;15621;145;587;3811;13691;3956;14278
130120;201612;14824;55846;13682;54246;1438;5919;10912;44102;12350;50021
130130;201612;4064;16244;3968;16059;196;989;3491;14081;3687;15070
130140;201612;6240;24453;6122;24315;256;1065;5667;22563;5923;23628
130150;201612;3415;13535;3333;13419;130;730;3002;11993;3132;12723
130160;201612;4212;17438;4004;17140;438;2229;3216;13692;3654;15921
130165;201612;2884;11820;2727;11531;166;883;2273;9607;2439;10490
130170;201612;9494;32891;8140;31183;956;3961;6263;24277;7219;28238
130180;201612;3477;11496;3405;11394;118;291;3184;10805;3302;11096
130185;201612;11964;37198;10456;35428;879;2511;8671;30794;9550;33305
130190;201612;16703;57641;14414;54358;2426;9249;9669;37552;12095;46801
130195;201612;1972;8329;1898;8218;109;461;1677;7397;1786;7858
130200;201612;2035;6961;1820;6610;376;1381;1168;4349;1544;5730
130210;201612;1316;5130;1180;4937;107;578;929;3826;1036;4404
130220;201612;1989;8165;1806;7779;200;975;1222;5245;1422;6220
130230;201612;3717;16992;3462;16545;354;1861;2638;12915;2992;14776
130240;201612;8871;32686;7855;31124;374;2039;6850;26912;7224;28951
130250;201612;19846;68580;18374;66553;2802;9925;13303;50157;16105;60082
130255;201612;4246;14604;3918;14061;208;820;3415;12287;3623;13107
130260;201612;244604;796590;212077;736375;64044;236207;86966;298146;151010;534353
130270;201612;7389;30501;6824;29559;905;3980;5051;22505;5956;26485
130280;201612;3338;13880;3208;13712;110;498;2979;12871;3089;13369
130290;201612;11187;39811;10509;38995;202;523;10056;37946;10258;38469
130300;201612;4523;17188;4222;16699;233;1151;3643;14356;3876;15507
130310;201612;5020;19173;4557;18490;355;1649;3743;15297;4098;16946
130320;201612;2958;10731;2655;10243;386;1568;1811;7123;2197;8691
130330;201612;3705;13431;3296;12855;152;758;2852;11066;3004;11824
130340;201612;18543;69646;16768;67241;2094;8356;13338;54812;15432;63168
130350;201612;3375;13805;3256;13605;238;1392;2722;11179;2960;12571
130353;201612;6115;18667;5197;17397;1083;3564;3311;11732;4394;15296
130356;201612;4591;16539;4202;15867;544;2036;3035;11783;3579;13819
130360;201612;3291;9490;2892;9057;90;228;2714;8639;2804;8867
130370;201612;5435;21276;4888;20463;175;974;4273;17910;4448;18884
130380;201612;7969;33025;7623;32467;482;2447;6526;27781;7008;30228
130390;201612;5235;23029;4892;22327;517;2792;3625;16432;4142;19224
130395;201612;2216;7716;1928;7113;222;882;1371;5007;1593;5889
130400;201612;2101;8032;1962;7816;117;588;1735;6876;1852;7464
130406;201612;10788;40815;9729;39236;2741;11420;5583;22769;8324;34189
130410;201612;3854;14632;3384;13724;1047;4561;1480;6136;2527;10697
130420;201612;10743;44804;10132;43789;1881;8332;7165;31753;9046;40085
130423;201612;3429;13086;3148;12643;230;1146;2660;10553;2890;11699
130426;201612;2407;10153;2309;9983;131;634;2020;8824;2151;9458
130430;201612;3545;12325;3355;12027;269;974;2793;10143;3062;11117
130440;201612;3561;12861;3317;12561;186;791;2930;11127;3116;11918
140002;201612;1701;5566;1521;5300;117;505;1164;3995;1281;4500
140005;201612;3568;9710;3431;9556;67;153;3309;9268;3376;9421
140010;201612;53626;154147;42086;135747;10424;35054;17334;58294;27758;93348
140015;201612;2928;9300;2698;9006;180;454;2356;8107;2536;8561
140017;201612;3148;10094;2778;9585;280;942;2097;7489;2377;8431
140020;201612;4464;15000;3925;14182;560;2218;2693;9708;3253;11926
140023;201612;2196;7283;1841;6692;216;850;1297;4760;1513;5610
140028;201612;2076;5743;1856;5416;202;684;1387;3872;1589;4556
140030;201612;3638;11388;3321;10922;667;1847;2171;7632;2838;9479
140040;201612;1773;8167;1707;8064;114;707;1504;6982;1618;7689
140045;201612;2507;9214;2229;8789;423;1646;1486;6146;1909;7792
140047;201612;5569;16985;4710;15507;1220;4036;2174;7642;3394;11678
140050;201612;1408;4422;1222;4144;223;770;751;2580;974;3350
140060;201612;1466;4415;1282;4115;211;718;844;2693;1055;3411
140070;201612;1653;8954;1576;8715;133;900;1238;6826;1371;7726
150010;201612;35936;105740;33256;101762;2200;7118;27302;83182;29502;90300
150013;201612;1720;4971;1512;4715;174;503;1136;3636;1310;4139
150020;201612;12445;41502;11914;40721;1536;4738;9418;33149;10954;37887
150030;201612;7424;31233;7138;30776;623;2571;5989;26402;6612;28973
150034;201612;4115;11399;3766;10887;158;496;3318;9562;3476;10058
150040;201612;12415;39746;10952;37963;1526;4585;8365;30763;9891;35348
150050;201612;5565;22032;5230;21405;230;1213;4552;18524;4782;19737
150060;201612;17664;54833;15524;51135;3480;11462;8755;29620;12235;41082
150070;201612;6060;24475;5403;23731;195;1029;4983;22007;5178;23036
150080;201612;75305;194070;60469;172413;14164;40083;29519;88190;43683;128273
150085;201612;5556;18731;5287;18385;393;1164;4589;16415;4982;17579
150090;201612;10305;39213;9617;38090;832;3446;7547;30294;8379;33740
150095;201612;5311;17164;4735;16267;342;1103;3821;13476;4163;14579
150100;201612;3201;11855;2936;11322;184;815;2331;8856;2515;9671
150110;201612;3616;17046;3582;16967;210;1068;3172;15130;3382;16198
150120;201612;6606;23791;6404;23437;455;1475;5338;20251;5793;21726
150125;201612;668;1967;571;1848;87;318;390;1237;477;1555
150130;201612;22090;66826;19875;63376;2404;7254;14654;47798;17058;55052
150140;201612;165420;455839;150235;433646;20719;57901;109868;321510;130587;379411
150145;201612;4463;14087;4000;13443;498;1726;3135;10629;3633;12355
150150;201612;12040;36036;10869;34177;1747;5660;7318;23227;9065;28887
150157;201612;3019;8990;2545;8274;341;1242;1740;5716;2081;6958
150160;201612;3057;9694;2822;9326;851;2833;1464;4966;2315;7799
150170;201612;21357;78569;19972;76101;2850;11121;14267;55174;17117;66295
150172;201612;2971;10097;2569;9393;326;1237;1860;6910;2186;8147
150175;201612;1835;5638;1697;5465;137;440;1380;4579;1517;5019
150178;201612;9757;30051;8276;28155;891;3293;6150;21321;7041;24614
150180;201612;18558;73691;17690;72406;1162;5326;15103;62119;16265;67445
150190;201612;6901;23877;6613;23463;197;823;6055;21558;6252;22381
150195;201612;5284;17186;4941;16620;150;540;4468;15105;4618;15645
150200;201612;5291;16678;5020;16355;99;344;4727;15495;4826;15839
150210;201612;24957;92754;24003;91333;1691;6442;20164;78556;21855;84998
150215;201612;7347;23043;6272;21208;1995;6946;2468;8480;4463;15426
150220;201612;11417;35417;10003;33034;2341;7762;5150;17374;7491;25136
150230;201612;11687;36243;9993;33725;1552;5336;6428;22078;7980;27414
150240;201612;34172;101431;28150;89855;9744;31620;6987;23069;16731;54689
150250;201612;3961;16573;3791;16298;778;3375;2487;11137;3265;14512
150260;201612;2016;7891;1877;7623;336;1321;1159;4844;1495;6165
150270;201612;8054;24762;6158;22179;1740;6379;3068;11375;4808;17754
150275;201612;5895;21255;5496;20577;633;2262;4088;15633;4721;17895
150276;201612;2133;6361;1868;5996;321;1073;1361;4412;1682;5485
150277;201612;4688;14435;3943;13442;1069;3724;2328;8111;3397;11835
150280;201612;5775;26007;5559;25498;815;3808;4032;18844;4847;22652
150285;201612;2997;11431;2733;10954;326;1388;1924;7829;2250;9217
150290;201612;10073;28365;9534;27756;602;1419;8319;24921;8921;26340
150293;201612;9081;24361;6321;20359;1994;6539;2183;7543;4177;14082
150295;201612;7550;21929;6074;20140;1479;4874;3355;12130;4834;17004
150300;201612;2009;6548;1843;6291;91;413;1540;5199;1631;5612
150304;201612;4048;12920;3433;11848;626;2153;2127;7564;2753;9717
150307;201612;6409;21368;5973;20679;383;1251;5074;17663;5457;18914
150309;201612;5944;20333;5137;18987;1338;4893;2669;10343;4007;15236
150310;201612;6360;27131;6034;26599;489;2413;4943;21867;5432;24280
150320;201612;9466;24257;8514;23057;911;2290;6783;18598;7694;20888
150330;201612;13959;46990;12903;45322;1957;6849;9253;33282;11210;40131
150340;201612;2550;7956;2299;7524;232;757;1755;5753;1987;6510
150345;201612;6580;21647;6082;20923;566;1932;4812;16851;5378;18783
150350;201612;8098;24260;7447;23393;1304;3365;5355;17764;6659;21129
150360;201612;20351;63091;17463;59156;3046;10101;11516;40527;14562;50628
150370;201612;9774;35035;8790;33572;1076;4006;6551;25846;7627;29852
150375;201612;2848;12630;2734;12458;274;1280;2250;10369;2524;11649
150380;201612;9623;27596;8370;25784;493;1467;7053;21939;7546;23406
150390;201612;7645;33186;7035;31948;1193;5163;4603;21781;5796;26944
150400;201612;5836;22631;5521;21957;452;1725;4422;17866;4874;19591
150405;201612;8010;24150;6986;22761;973;2470;5057;17805;6030;20275
150410;201612;1588;5975;1427;5618;207;889;879;3460;1086;4349
150420;201612;35136;116475;28027;104016;9473;37655;7675;30237;17148;67892
150430;201612;7369;24542;6913;23772;913;2898;5111;18122;6024;21020
150440;201612;5400;18402;5117;17985;528;1783;4124;14746;4652;16529
150442;201612;21494;61217;18160;55782;3498;10596;10788;34150;14286;44746
150445;201612;5349;18245;4864;17403;552;1944;3658;13356;4210;15300
150450;201612;4135;20183;3978;19879;526;2540;3013;15538;3539;18078
150460;201612;7037;25938;6448;25172;332;1552;5394;21757;5726;23309
150470;201612;17521;53711;16683;52609;1046;2843;14869;47689;15915;50532
150475;201612;3626;12505;3299;12015;282;1072;2648;9754;2930;10826
150480;201612;13857;47161;12496;44887;1320;4909;9671;35147;10991;40056
150490;201612;7183;27356;6962;26994;267;1173;6161;24047;6428;25220
150495;201612;4927;18075;4747;17823;149;624;4391;16523;4540;17147
150497;201612;2545;9365;2233;8708;750;3034;933;3723;1683;6757
150500;201612;3109;8541;2841;8133;301;803;2222;6355;2523;7158
150503;201612;3232;10023;2647;9190;879;3101;1356;4872;2235;7973
150506;201612;10611;36632;9538;35014;2281;8026;5744;22425;8025;30451
150510;201612;9681;37556;8608;35199;1383;5599;5607;23803;6990;29402
150520;201612;6630;26281;6494;26093;235;919;6065;24576;6300;25495
150530;201612;12236;42067;10838;39683;1186;3867;8319;31050;9505;34917
150540;201612;4573;13813;3965;12893;242;799;3295;10686;3537;11485
150543;201612;5727;17478;4899;16226;1069;3624;2908;9858;3977;13482
150548;201612;9011;29043;8339;28159;370;1116;7632;26069;8002;27185
150549;201612;2004;6487;1828;6268;52;196;1683;5812;1735;6008
150550;201612;19803;62788;16574;56808;5274;18235;5934;21135;11208;39370
150553;201612;22012;75063;17313;64964;6422;25389;4005;15376;10427;40765
150555;201612;1733;5074;1371;4444;91;301;1013;3264;1104;3565
150560;201612;1845;6059;1671;5688;286;963;989;3388;1275;4351
150563;201612;2509;8400;2286;7984;558;2077;1165;4029;1723;6106
150565;201612;3868;13302;3447;12583;140;663;2913;10617;3053;11280
150570;201612;5854;21071;5573;20522;541;2038;4314;15955;4855;17993
150580;201612;9717;40499;9381;40049;624;2713;8143;35362;8767;38075
150590;201612;5602;22468;5413;22205;151;749;5032;20622;5183;21371
150600;201612;7980;30527;7552;29868;278;1297;6807;27014;7085;28311
150610;201612;2353;7918;2127;7432;188;720;1589;5453;1777;6173
150611;201612;2706;9172;2500;8774;140;529;2099;7373;2239;7902
150613;201612;11788;34761;9111;30334;2857;9831;3640;12277;6497;22108
150616;201612;3072;9334;2223;7780;551;2100;653;2146;1204;4246
150618;201612;6326;21255;5506;19701;1434;5122;2880;10580;4314;15702
150619;201612;5051;17259;4558;16382;573;2136;3252;11687;3825;13823
150620;201612;6157;22056;5509;21157;686;2749;4213;16251;4899;19000
150630;201612;5750;17137;5405;16708;485;1526;4505;14136;4990;15662
150635;201612;3850;12499;3338;11411;894;3100;1355;4775;2249;7875
150640;201612;1963;5767;1844;5620;167;476;1587;4997;1754;5473
150650;201612;11388;34731;9907;31880;2831;9058;4128;13793;6959;22851
150655;201612;5012;16360;4631;15637;543;1889;3488;11818;4031;13707
150658;201612;4394;13170;3708;12185;796;2817;2274;7636;3070;10453
150660;201612;5554;17238;4945;16235;1165;3841;2630;8798;3795;12639
150670;201612;7383;19291;5923;17410;592;1826;4707;14023;5299;15849
150680;201612;57312;195769;47325;178214;14342;54825;18853;77086;33195;131911
150690;201612;1978;6101;1753;5733;196;631;1268;4172;1464;4803
150700;201612;6046;18936;5437;18058;932;3128;3633;12295;4565;15423
150710;201612;4258;14309;3742;13416;404;1501;2657;9619;3061;11120
150715;201612;4827;15106;4141;13973;410;1525;3115;10492;3525;12017
150720;201612;6344;25521;5949;24767;649;2989;4489;18840;5138;21829
150730;201612;10009;33729;9071;32115;1184;4346;6802;24448;7986;28794
150740;201612;3554;11336;3121;10500;665;2319;1668;5568;2333;7887
150745;201612;4769;15258;4232;14448;1194;4322;2334;7906;3528;12228
150746;201612;1338;4391;1255;4221;106;336;962;3280;1068;3616
150747;201612;5172;16063;4472;15144;414;1255;3362;12062;3776;13317
150750;201612;3413;10907;3020;10303;195;780;2446;8332;2641;9112
150760;201612;11126;35313;10185;33996;1581;5369;7151;24195;8732;29564
150770;201612;5868;22258;5583;21729;253;888;4970;20182;5223;21070
150775;201612;1024;3118;855;2809;160;617;475;1528;635;2145
150780;201612;3593;11522;3440;11325;134;528;3120;10233;3254;10761
150790;201612;4874;16030;4514;15589;348;1230;3640;13317;3988;14547
150795;201612;14930;47959;13153;44999;3117;10339;7505;26795;10622;37134
150796;201612;3079;8945;2720;8482;295;936;2114;6698;2409;7634
150797;201612;3654;12552;3289;11833;107;441;2789;9988;2896;10429
150800;201612;13494;43994;12249;42340;2585;8260;8086;29605;10671;37865
150803;201612;6626;23769;6161;22972;677;2684;4555;17083;5232;19767
150805;201612;2626;9433;2383;8983;361;1332;1642;6297;2003;7629
150808;201612;5406;17938;4147;15304;1575;6290;454;1647;2029;7937
150810;201612;18487;56560;14970;51804;2591;8686;9483;34602;12074;43288
150812;201612;5209;16318;4678;15303;581;2097;3266;10365;3847;12462
150815;201612;8298;27515;7368;26269;828;2919;5711;20849;6539;23768
150820;201612;11272;32635;9916;30971;897;2270;7925;25556;8822;27826
150830;201612;12430;47182;11602;45961;512;2675;9903;39879;10415;42554
150835;201612;2138;7476;1947;7093;442;1593;1040;3905;1482;5498
150840;201612;7208;21966;5730;19272;1279;4601;2737;9098;4016;13699
160005;201612;800;2717;754;2631;62;264;616;2102;678;2366
160010;201612;1319;4507;1315;4501;20;35;1284;4443;1304;4478
160015;201612;1731;6446;1681;6364;77;251;1542;5938;1619;6189
160020;201612;1835;6762;1691;6519;211;879;1256;4855;1467;5734
160021;201612;1030;4429;987;4350;103;602;730;3187;833;3789
160023;201612;967;4016;947;3975;99;396;789;3357;888;3753
160025;201612;1451;4394;1430;4370;47;115;1363;4193;1410;4308
160027;201612;8146;24284;7516;23543;1435;4404;5319;17196;6754;21600
160030;201612;49454;168101;42187;155568;10581;38650;21557;84597;32138;123247
160040;201612;4301;16789;4187;16617;168;975;3803;14861;3971;15836
160050;201612;3171;11880;2778;11245;1588;6344;622;2895;2210;9239
160053;201612;2985;11167;2894;11024;775;2876;1735;6871;2510;9747
160055;201612;565;2252;556;2238;25;123;500;1988;525;2111
160060;201612;15235;52397;14284;51126;1903;6447;10894;39931;12797;46378
160070;201612;2666;10497;2486;10169;188;900;2077;8473;2265;9373
160080;201612;2583;9659;2504;9543;56;294;2369;8965;2425;9259
170025;201612;495;1628;435;1531;122;440;224;781;346;1221
170030;201612;1135;3761;943;3389;225;830;406;1470;631;2300
170035;201612;1307;3772;1009;3181;163;556;534;1664;697;2220
170040;201612;1856;5770;1597;5412;181;696;868;3156;1049;3852
170070;201612;1567;4210;1161;3641;220;737;653;2028;873;2765
170100;201612;2259;6828;1928;6263;200;633;1452;4743;1652;5376
170105;201612;739;2321;553;1909;135;488;244;802;379;1290
170110;201612;879;2916;736;2626;171;657;308;1086;479;1743
170130;201612;1336;4248;1023;3604;272;1024;418;1503;690;2527
170190;201612;1532;4547;1080;3753;409;1326;204;853;613;2179
170200;201612;1562;4323;922;3035;271;959;175;522;446;1481
170210;201612;30250;85736;22587;72385;7358;25097;4509;14931;11867;40028
170215;201612;1200;3693;995;3356;106;393;694;2314;800;2707
170220;201612;5368;18389;4793;17166;1215;4417;2408;8775;3623;13192
170230;201612;1327;4238;1007;3561;213;811;435;1473;648;2284
170240;201612;2675;7969;2101;6993;217;841;1418;4638;1635;5479
170255;201612;3331;10536;2576;9083;832;2966;1009;3586;1841;6552
170270;201612;992;2454;644;1948;46;146;445;1315;491;1461
170290;201612;2697;7800;2336;7371;294;648;1823;6238;2117;6886
170300;201612;1830;5569;1434;4867;151;529;945;3208;1096;3737
170305;201612;694;2082;532;1752;98;350;280;899;378;1249
170307;201612;974;3480;809;3137;170;701;396;1567;566;2268
170310;201612;1480;4170;1074;3422;275;931;481;1500;756;2431
170320;201612;1095;3144;764;2564;155;540;350;1203;505;1743
170330;201612;787;2566;697;2395;49;195;541;1819;590;2014
170360;201612;459;1439;357;1247;67;253;178;581;245;834
170370;201612;1309;3714;929;3037;157;571;499;1587;656;2158
170380;201612;1650;5330;1281;4667;229;887;633;2317;862;3204
170382;201612;557;1748;442;1540;44;207;307;1032;351;1239
170384;201612;1566;6271;1404;5936;377;1682;660;2825;1037;4507
170386;201612;846;2529;701;2282;221;828;269;810;490;1638
170388;201612;576;1746;441;1499;96;352;166;531;262;883
170389;201612;882;2991;777;2790;64;245;586;2087;650;2332
170390;201612;1269;3605;1003;3238;88;287;772;2506;860;2793
170410;201612;532;1689;415;1457;25;113;271;928;296;1041
170460;201612;471;1282;291;945;56;211;114;346;170;557
170510;201612;768;2505;549;2050;91;374;282;987;373;1361
170550;201612;6521;18521;4356;14428;1521;5404;537;1722;2058;7126
170555;201612;1292;3720;1000;3243;194;666;511;1696;705;2362
170560;201612;1034;3362;777;2976;152;604;430;1693;582;2297
170600;201612;1239;3696;1055;3418;327;1014;574;1939;901;2953
170610;201612;1563;4794;1208;4144;147;552;769;2571;916;3123
170625;201612;396;1197;266;895;36;124;101;320;137;444
170650;201612;1197;3831;915;3267;238;878;320;1207;558;2085
170700;201612;3881;12104;3024;10537;663;2420;1337;4781;2000;7201
170710;201612;1726;5063;1308;4260;239;818;686;2185;925;3003
170720;201612;1809;4864;1519;4400;162;396;1204;3631;1366;4027
170730;201612;913;2750;694;2344;195;659;269;934;464;1593
170740;201612;2137;7637;1811;6979;275;1089;1142;4436;1417;5525
170755;201612;755;2365;542;1883;91;345;242;813;333;1158
170765;201612;1202;3302;847;2701;240;779;314;1043;554;1822
170770;201612;1637;5542;1462;5201;342;1197;819;2976;1161;4173
170820;201612;3558;11947;3104;11085;604;2182;1650;6074;2254;8256
170825;201612;694;2060;557;1786;79;254;317;992;396;1246
170830;201612;1403;4061;1155;3658;70;169;976;3168;1046;3337
170900;201612;2473;8782;2307;8506;209;823;1836;6838;2045;7661
170930;201612;3721;10933;3046;9810;734;2470;1512;4966;2246;7436
170950;201612;13442;39011;9074;30616;2729;10233;1260;4108;3989;14341
170980;201612;481;1406;335;1134;69;229;144;474;213;703
171050;201612;1484;4951;1289;4548;99;443;999;3460;1098;3903
171070;201612;1412;4384;1271;4171;295;952;743;2540;1038;3492
171090;201612;1074;2861;854;2527;70;178;624;1850;694;2028
171110;201612;575;1698;408;1374;129;478;155;449;284;927
171150;201612;1007;2755;609;1999;92;320;379;1234;471;1554
171180;201612;683;2051;417;1475;103;361;160;600;263;961
171190;201612;1452;5509;1258;5056;244;1008;623;2612;867;3620
171195;201612;831;2892;686;2611;89;384;447;1699;536;2083
171200;201612;618;1932;472;1646;157;582;142;467;299;1049
171215;201612;441;1301;320;1057;45;170;161;528;206;698
171240;201612;691;2520;623;2383;63;307;395;1533;458;1840
171245;201612;568;1914;444;1605;108;417;158;547;266;964
171250;201612;998;2916;751;2466;187;633;343;1100;530;1733
171270;201612;377;1536;345;1466;129;512;112;545;241;1057
171280;201612;856;2665;677;2324;166;592;300;1080;466;1672
171320;201612;3683;11109;2945;9754;900;2937;1166;3994;2066;6931
171330;201612;2684;7884;2112;6900;580;2021;947;3059;1527;5080
171360;201612;1426;4541;1253;4269;97;360;1003;3421;1100;3781
171370;201612;638;1824;533;1673;104;376;314;967;418;1343
171380;201612;1242;3975;976;3451;412;1472;189;756;601;2228
171395;201612;897;2685;624;2110;106;409;315;1009;421;1418
171420;201612;1861;5804;1328;4666;329;1182;494;1743;823;2925
171430;201612;1019;3134;814;2740;133;443;477;1582;610;2025
171488;201612;2453;7503;1995;6759;426;1419;1063;3727;1489;5146
171500;201612;835;2438;647;2114;79;253;445;1476;524;1729
171510;201612;835;2909;715;2669;59;251;529;1972;588;2223
171515;201612;481;1386;353;1141;48;154;197;622;245;776
171525;201612;598;1936;504;1755;55;216;322;1065;377;1281
171550;201612;329;1081;240;904;71;296;75;283;146;579
171570;201612;1241;3901;1053;3519;227;713;657;2272;884;2985
171575;201612;1875;5182;1280;4076;266;910;617;1928;883;2838
171610;201612;4996;15753;3858;13540;1037;3928;1162;4055;2199;7983
171620;201612;2706;7761;2257;7113;115;450;1871;5891;1986;6341
171630;201612;843;2573;696;2336;193;669;356;1205;549;1874
171650;201612;2111;6494;1472;5073;393;1391;473;1625;866;3016
171660;201612;2331;6502;1637;5172;255;847;920;2841;1175;3688
171665;201612;1450;4211;1090;3607;211;727;538;1853;749;2580
171670;201612;1816;5094;1413;4402;413;1367;524;1568;937;2935
171700;201612;1067;3383;845;2929;142;494;460;1605;602;2099
171720;201612;728;2159;602;1930;155;505;303;981;458;1486
171750;201612;1088;3432;794;2812;218;738;227;849;445;1587
171780;201612;1128;3064;796;2562;94;340;448;1402;542;1742
171790;201612;1347;4785;1129;4293;284;1063;586;2370;870;3433
171800;201612;697;2141;549;1891;69;240;350;1238;419;1478
171820;201612;9601;29009;7567;25396;1551;5452;3558;12051;5109;17503
171830;201612;1310;4899;1116;4423;358;1346;407;1744;765;3090
171840;201612;700;1978;582;1794;39;133;440;1320;479;1453
171845;201612;660;1829;497;1541;71;248;264;812;335;1060
171850;201612;867;3121;746;2845;82;356;486;1858;568;2214
171855;201612;1106;3512;974;3252;56;214;748;2449;804;2663
171865;201612;421;1423;353;1291;66;239;174;627;240;866
171870;201612;684;2076;518;1741;139;485;192;698;331;1183
171875;201612;1193;3831;975;3435;86;355;671;2319;757;2674
171880;201612;802;2961;767;2901;88;310;617;2397;705;2707
171884;201612;882;2420;605;1970;159;558;149;554;308;1112
171886;201612;1311;4201;952;3432;282;1098;192;684;474;1782
171888;201612;723;2172;498;1694;65;229;287;948;352;1177
171889;201612;482;1498;403;1359;83;279;204;728;287;1007
171890;201612;1196;3543;937;3130;174;569;512;1713;686;2282
171900;201612;490;1771;359;1439;108;456;134;523;242;979
172000;201612;582;1865;466;1617;69;253;257;855;326;1108
172010;201612;1169;4044;1051;3809;121;525;756;2689;877;3214
172015;201612;329;1286;255;1123;54;211;126;577;180;788
172020;201612;2263;7514;2053;7141;309;1156;1378;4788;1687;5944
172025;201612;702;2037;482;1636;67;240;260;904;327;1144
172030;201612;1110;3534;948;3234;45;195;762;2561;807;2756
172049;201612;1295;3315;892;2606;427;1331;321;873;748;2204
172065;201612;1337;3486;1080;3192;77;218;959;2871;1036;3089
172080;201612;2291;7236;1894;6469;180;735;1282;4298;1462;5033
172085;201612;468;1323;305;970;57;164;103;328;160;492
172090;201612;3795;10329;3061;9222;98;308;2695;8179;2793;8487
172093;201612;554;1689;408;1403;92;354;188;624;280;978
172097;201612;619;1840;459;1552;100;342;166;570;266;912
172100;201612;34768;99421;24122;79954;6750;24437;6270;20784;13020;45221
172110;201612;1608;6116;1386;5710;171;815;969;4027;1140;4842
172120;201612;4905;15370;3869;13731;777;2709;2218;8094;2995;10803
172125;201612;236;747;187;649;38;148;84;287;122;435
172130;201612;517;1445;373;1181;34;132;243;738;277;870
172208;201612;2102;6141;1773;5587;244;756;1114;3533;1358;4289
172210;201612;2502;7454;2103;6836;421;1481;1266;4065;1687;5546
210005;201612;20930;64781;16952;58069;6343;22616;5038;17404;11381;40020
210010;201612;1727;6484;1550;6151;91;417;1281;5134;1372;5551
210015;201612;3388;10639;2951;9927;188;475;2516;8747;2704;9222
210020;201612;6898;16656;6463;16104;212;477;5958;14825;6170;15302
210030;201612;5230;17513;4875;17000;391;1584;3989;13800;4380;15384
210040;201612;1958;5832;1829;5672;70;179;1674;5278;1744;5457
210043;201612;6706;18530;5607;17120;697;1906;4002;13005;4699;14911
210047;201612;6306;23213;5684;22196;470;2123;4460;17356;4930;19479
210050;201612;2195;8174;1774;7252;671;2788;587;2597;1258;5385
210055;201612;1706;5942;1522;5626;123;476;1186;4374;1309;4850
210060;201612;6917;27162;6327;25961;953;4023;4183;17564;5136;21587
210070;201612;7123;20794;6567;20084;74;242;6104;18785;6178;19027
210080;201612;3625;12672;3531;12554;17;77;3403;12153;3420;12230
210083;201612;4505;15610;3996;15002;112;523;3758;14119;3870;14642
210087;201612;2963;8663;2668;8249;311;906;2077;6575;2388;7481
210090;201612;10015;31991;9449;31050;328;1190;8437;27724;8765;28914
210095;201612;5868;20841;5566;20412;277;1116;4793;17700;5070;18816
210100;201612;7020;21203;6349;20227;278;1110;5401;16982;5679;18092
210110;201612;2749;9537;2613;9337;92;410;2349;8345;2441;8755
210120;201612;25513;71351;21726;66638;2996;7768;15400;50283;18396;58051
210125;201612;3592;11225;3455;11077;172;375;3128;10316;3300;10691
210130;201612;4127;12158;3740;11575;251;813;3096;9540;3347;10353
210135;201612;1595;4745;1364;4399;74;231;1128;3653;1202;3884
210140;201612;16486;52260;13701;48097;2843;10559;7797;27731;10640;38290
210150;201612;4540;11195;3993;10463;81;212;3706;9665;3787;9877
210160;201612;17005;53636;15837;51767;2426;7166;11653;39563;14079;46729
210170;201612;13534;47876;12999;47124;640;2497;11607;42282;12247;44779
210173;201612;2043;8053;1887;7781;66;387;1740;7095;1806;7482
210177;201612;3033;9224;2855;9000;103;309;2641;8419;2744;8728
210180;201612;1455;4412;1360;4259;43;180;1176;3627;1219;3807
210190;201612;4724;14964;4242;14003;157;682;3437;11055;3594;11737
210193;201612;1304;4132;1169;3905;69;251;973;3265;1042;3516
210197;201612;2034;6853;1854;6629;240;820;1393;5186;1633;6006
210200;201612;7927;26723;7283;25761;871;2860;5651;20629;6522;23489
210203;201612;6691;20794;6254;20210;368;1030;5478;18031;5846;19061
210207;201612;2973;9879;2752;9452;295;892;2052;7290;2347;8182
210210;201612;8103;27584;7527;26732;67;331;7029;25096;7096;25427
210215;201612;1090;4598;1029;4488;84;429;811;3576;895;4005
210220;201612;5894;23123;5583;22585;294;1439;4772;19316;5066;20755
210230;201612;5084;16384;4710;15786;241;778;4152;14007;4393;14785
210232;201612;12588;40217;10237;37072;1681;6159;6552;25310;8233;31469
210235;201612;3681;11347;3209;10718;165;637;2739;9146;2904;9783
210237;201612;2260;8683;2190;8585;25;122;2097;8267;2122;8389
210240;201612;2944;9184;2704;8811;143;456;2297;7490;2440;7946
210250;201612;5198;16794;4852;16317;122;631;4433;14719;4555;15350
210255;201612;2527;8115;2253;7580;243;879;1702;5676;1945;6555
210260;201612;5000;16436;4589;15758;445;1458;3562;12454;4007;13912
210270;201612;5172;14764;4503;13746;116;582;3976;11914;4092;12496
210275;201612;3450;8470;3257;8244;152;272;3022;7831;3174;8103
210280;201612;5518;16602;4516;15055;252;1152;3446;11077;3698;12229
210290;201612;5496;18281;5029;17679;258;922;4344;15421;4602;16343
210300;201612;36415;101001;29369;91713;3317;10015;21130;68711;24447;78726
210310;201612;2876;8050;2584;7629;79;153;2296;6870;2375;7023
210312;201612;2278;7035;2110;6793;63;308;1889;6012;1952;6320
210315;201612;2748;8623;2380;8138;121;429;2088;7228;2209;7657
210317;201612;4027;12642;3849;12417;135;492;3554;11490;3689;11982
210320;201612;18972;62459;17311;60363;834;3119;14993;52962;15827;56081
210325;201612;3646;11107;3186;10374;184;669;2599;8488;2783;9157
210330;201612;32840;84246;26027;76438;5382;14342;15546;51332;20928;65674
210340;201612;11505;34471;10247;32664;2325;7529;6376;21509;8701;29038
210350;201612;9625;29395;8462;27649;472;1613;6970;22884;7442;24497
210355;201612;3831;14101;3403;13364;171;808;2902;11456;3073;12264
210360;201612;14967;45684;13332;43193;957;3512;10702;34337;11659;37849
210370;201612;9247;22184;7638;20425;331;604;6731;18733;7062;19337
210375;201612;3083;9281;2491;8444;833;2862;1066;3727;1899;6589
210380;201612;5752;15970;5128;15102;455;1161;4196;12641;4651;13802
210390;201612;2868;10153;2569;9642;158;783;2126;7887;2284;8670
210400;201612;4840;15190;4627;14947;93;253;4443;14479;4536;14732
210405;201612;7466;20934;5825;18426;1927;6081;2106;7290;4033;13371
210407;201612;1956;7025;1641;6411;210;832;1166;4558;1376;5390
210408;201612;2387;9267;2203;8995;160;780;1818;7546;1978;8326
210409;201612;3619;13168;3406;12822;200;977;2846;10642;3046;11619
210410;201612;3659;11854;3464;11559;361;1075;2768;9590;3129;10665
210420;201612;3997;13218;3580;12438;230;798;2934;10296;3164;11094
210430;201612;2079;6460;1997;6359;87;281;1761;5610;1848;5891
210440;201612;3865;12017;3690;11776;185;513;3345;10793;3530;11306
210450;201612;2667;8409;2309;7826;126;419;1870;6297;1996;6716
210455;201612;3542;10454;3225;10041;472;1425;2380;7696;2852;9121
210460;201612;3468;11334;3145;10801;159;661;2610;8911;2769;9572
210462;201612;1333;4863;1207;4619;66;336;983;3713;1049;4049
210465;201612;2524;8232;2295;7885;179;507;1962;6901;2141;7408
210467;201612;6033;20126;5640;19655;334;1123;4894;17312;5228;18435
210470;201612;2035;5528;1431;4590;89;263;1110;3577;1199;3840
210480;201612;14536;46288;12451;43551;2095;6969;8694;32290;10789;39259
210490;201612;3639;9907;3063;9055;87;289;2699;7921;2786;8210
210500;201612;6036;25357;5769;24787;550;2499;4574;19811;5124;22310
210510;201612;6424;21809;6006;21260;317;929;5152;18798;5469;19727
210515;201612;3590;11341;3424;11154;53;145;3272;10793;3325;10938
210520;201612;2566;7773;2306;7390;180;543;1908;6210;2088;6753
210530;201612;46900;129730;29956;102522;7007;26797;12169;42579;19176;69376
210535;201612;3176;10946;2976;10642;116;401;2646;9573;2762;9974
210540;201612;12631;41775;10984;39314;1985;6924;6935;26074;8920;32998
210542;201612;5656;16214;5096;15584;271;645;4474;14027;4745;14672
210545;201612;2281;7292;2145;7052;41;231;1932;6245;1973;6476
210547;201612;3653;13087;3336;12487;349;1192;2479;9549;2828;10741
210550;201612;5854;17339;5286;16708;283;668;4766;15497;5049;16165
210560;201612;3909;12283;3466;11489;144;558;2974;9780;3118;10338
210565;201612;1441;5224;1202;4807;73;378;940;3790;1013;4168
210570;201612;11917;33759;10896;32559;655;1496;9548;29275;10203;30771
210580;201612;3110;9107;2783;8671;264;569;2183;7344;2447;7913
210590;201612;3898;12514;3594;12095;242;868;3081;10393;3323;11261
210592;201612;2498;7808;2363;7566;33;156;2105;6685;2138;6841
210594;201612;2615;7494;1984;6463;113;279;1514;5102;1627;5381
210596;201612;2549;9508;2387;9187;218;908;1812;7019;2030;7927
210598;201612;1771;5546;1646;5385;81;300;1440;4691;1521;4991
210600;201612;3132;8981;2603;8210;139;477;2094;6550;2233;7027
210610;201612;2477;8061;2305;7831;114;500;2015;6728;2129;7228
210620;201612;1981;6419;1792;6169;53;138;1646;5769;1699;5907
210630;201612;3292;11746;2985;11194;270;1231;2262;8332;2532;9563
210632;201612;4452;15412;4046;14761;460;1767;3083;11265;3543;13032
210635;201612;1862;6533;1745;6339;87;319;1532;5630;1619;5949
210637;201612;2588;8914;2348;8547;138;566;1902;6957;2040;7523
210640;201612;4456;16859;4363;16753;3;16;4293;16563;4296;16579
210650;201612;6830;20657;6588;20331;170;514;6263;19386;6433;19900
210660;201612;8245;24187;7344;22762;284;957;6625;20342;6909;21299
210663;201612;2617;8023;2474;7827;157;494;2111;6758;2268;7252
210667;201612;1863;6395;1734;6183;73;321;1507;5372;1580;5693
210670;201612;4522;16480;4264;16043;201;920;3603;13567;3804;14487
210675;201612;5068;14019;4540;13307;473;1216;3663;10998;4136;12214
210680;201612;3873;10533;3346;9866;173;407;2904;8683;3077;9090
210690;201612;7506;25249;7149;24832;271;872;6277;22522;6548;23394
210700;201612;2624;7732;2373;7425;485;1221;1562;5578;2047;6799
210710;201612;4701;15684;4378;15149;209;917;3705;12710;3914;13627
210720;201612;2568;9212;2396;8960;113;551;2144;7938;2257;8489
210725;201612;1035;4015;908;3724;123;485;595;2505;718;2990
210730;201612;1173;3520;994;3240;92;263;776;2556;868;2819
210735;201612;4083;13899;3649;13138;440;1661;2735;9995;3175;11656
210740;201612;4932;14633;4600;14256;203;873;4100;12394;4303;13267
210745;201612;4050;11896;3767;11518;224;590;3234;9982;3458;10572
210750;201612;18764;51669;16438;48814;2183;6394;11972;36207;14155;42601
210760;201612;5853;16799;5335;16226;32;94;5200;15871;5232;15965
210770;201612;5870;16032;4970;14899;91;393;4559;13571;4650;13964
210780;201612;7690;25968;6970;24630;811;2758;5026;18226;5837;20984
210790;201612;4584;14265;4078;13604;334;831;3240;11376;3574;12207
210800;201612;4758;13268;4232;12598;112;361;3824;11399;3936;11760
210805;201612;3744;15252;3576;14942;168;911;3082;12857;3250;13768
210810;201612;5301;16093;4869;15518;299;574;4268;14144;4567;14718
210820;201612;7445;21638;6451;19925;942;2759;4457;14020;5399;16779
210825;201612;5652;19529;5363;19117;607;2022;4231;15553;4838;17575
210830;201612;8311;23976;7789;23302;855;2111;6186;19329;7041;21440
210840;201612;3541;9698;3106;9015;91;274;2694;7736;2785;8010
210845;201612;5883;17431;5674;17203;75;157;5493;16832;5568;16989
210850;201612;6234;21805;5488;20510;515;2228;4085;15174;4600;17402
210860;201612;17793;51960;15568;48604;1245;3792;12375;39113;13620;42905
210870;201612;5569;18690;5032;17949;537;1844;3908;14191;4445;16035
210880;201612;4263;13795;4024;13461;280;1066;3340;11115;3620;12181
210890;201612;4821;14516;4392;13984;319;850;3731;12368;4050;13218
210900;201612;4761;14207;3734;12466;1625;5638;830;2986;2455;8624
210905;201612;1786;5649;1548;5265;114;303;1238;4346;1352;4649
210910;201612;8162;25929;7080;23978;956;3357;4805;16255;5761;19612
210920;201612;2740;10183;2584;9904;149;783;2116;8019;2265;8802
210923;201612;1475;4957;1329;4711;123;475;915;3297;1038;3772
210927;201612;4714;15199;4431;14873;86;277;4202;14220;4288;14497
210930;201612;2489;9017;2290;8689;107;601;1952;7238;2059;7839
210940;201612;3019;11100;2873;10824;168;789;2473;9141;2641;9930
210945;201612;5683;17483;5443;17181;264;455;4949;15914;5213;16369
210950;201612;5175;15858;4279;14375;437;1428;3125;10676;3562;12104
210955;201612;1819;5901;1577;5520;139;479;1145;4083;1284;4562
210960;201612;9000;28579;8055;27175;2044;6499;4500;16338;6544;22837
210970;201612;1319;4596;1152;4301;138;549;816;3003;954;3552
210975;201612;1735;5828;1617;5580;97;366;1280;4388;1377;4754
210980;201612;10071;23467;9601;22960;599;1097;8601;21100;9200;22197
210990;201612;15933;49580;12732;44581;3320;12055;5668;20582;8988;32637
211000;201612;15452;48637;13516;46292;804;3200;11355;39303;12159;42503
211003;201612;4708;17567;4227;16853;269;1335;3302;13384;3571;14719
211010;201612;6459;23879;6077;23359;69;368;5772;22288;5841;22656
211020;201612;7318;23782;6933;23123;515;1989;5709;18827;6224;20816
211023;201612;2154;7310;2054;7137;176;677;1684;5828;1860;6505
211027;201612;2736;10473;2662;10335;263;1084;2148;8361;2411;9445
211030;201612;3757;11531;3501;11257;612;1416;2632;9236;3244;10652
211040;201612;4436;16463;4198;16070;156;912;3671;13946;3827;14858
211050;201612;10023;25536;9483;24931;177;430;9032;23767;9209;24197
211060;201612;6102;21333;5864;20972;436;1634;5023;18076;5459;19710
211065;201612;1942;6191;1736;5871;56;195;1585;5371;1641;5566
211070;201612;7839;26882;7108;25621;323;1295;6014;21782;6337;23077
211080;201612;1260;3847;1089;3562;71;327;860;2673;931;3000
211085;201612;1940;6428;1755;6096;227;813;1259;4414;1486;5227
211090;201612;3390;9738;3128;9352;82;361;2765;8097;2847;8458
211100;201612;6460;17142;6286;16938;30;107;6169;16605;6199;16712
211102;201612;2843;10996;2676;10749;233;992;2236;9104;2469;10096
211105;201612;2460;8161;2096;7520;200;790;1531;5415;1731;6205
211107;201612;4459;14219;3965;13512;232;807;3251;11333;3483;12140
211110;201612;6148;18209;4827;16104;863;2771;3076;10634;3939;13405
211120;201612;34242;96455;31002;92429;5150;14701;21950;67418;27100;82119
211125;201612;2050;6472;1785;6035;97;368;1482;4990;1579;5358
211130;201612;160075;428666;138270;394114;24443;70954;71442;214456;95885;285410
211140;201612;5154;17193;4728;16491;161;640;4080;14203;4241;14843
211150;201612;9649;27675;8505;26171;342;1195;7298;22409;7640;23604
211153;201612;2693;8391;2407;7983;669;2311;1416;4747;2085;7058
211157;201612;1135;3649;961;3364;69;329;677;2390;746;2719
211160;201612;4098;13258;3370;11948;214;1016;2360;8081;2574;9097
211163;201612;1659;5463;1543;5287;29;99;1407;4902;1436;5001
211167;201612;1483;4932;1414;4826;39;185;1338;4539;1377;4724
211170;201612;5981;15979;5719;15632;88;252;5369;14604;5457;14856
211172;201612;2437;7085;2175;6698;96;420;1894;5693;1990;6113
211174;201612;2663;7904;2429;7593;53;291;2248;6916;2301;7207
211176;201612;4132;13039;3506;12165;308;1244;2659;9247;2967;10491
211178;201612;4098;10421;3713;9934;46;133;3542;9410;3588;9543
211180;201612;4168;14437;3889;14006;250;968;3297;11945;3547;12913
211190;201612;2810;9283;2570;8898;60;300;2214;7608;2274;7908
211195;201612;1431;4316;1185;3981;59;175;1004;3455;1063;3630
211200;201612;2128;6984;1826;6533;346;1162;1099;4143;1445;5305
211210;201612;6637;20457;6213;19837;365;1186;5345;17076;5710;18262
211220;201612;32245;93326;27663;86950;4907;15586;18502;58977;23409;74563
211223;201612;4927;15354;4421;14490;541;1698;3255;10822;3796;12520
211227;201612;1598;5629;1440;5365;81;374;1195;4442;1276;4816
211230;201612;7784;25268;6948;23814;732;2551;5244;18119;5976;20670
211240;201612;7789;26995;7345;26364;225;1123;6653;23552;6878;24675
211245;201612;5477;16270;5443;16233;87;134;5326;16033;5413;16167
211250;201612;13087;41773;12223;40679;1061;3121;10138;34816;11199;37937
211260;201612;8302;25914;7794;25206;404;1427;6987;22567;7391;23994
211270;201612;10161;34716;8963;33111;446;2079;7259;27034;7705;29113
211280;201612;13017;38810;11567;36719;968;2516;9406;30837;10374;33353
211285;201612;1737;6378;1477;5792;255;1080;720;2904;975;3984
211290;201612;7006;22931;6639;22411;345;1121;5782;19762;6127;20883
211300;201612;8014;24024;7419;23158;150;422;6917;21638;7067;22060
211400;201612;11721;36537;9938;33869;2669;9179;4802;17831;7471;27010
220005;201612;1818;5183;1591;4806;65;243;1276;3711;1341;3954
220010;201612;1394;4075;1205;3755;32;129;995;3018;1027;3147
220020;201612;3243;10261;3001;9818;529;1714;1887;6204;2416;7918
220025;201612;2271;5563;1977;5106;31;94;1693;4274;1724;4368
220027;201612;1340;3596;1159;3335;52;145;944;2694;996;2839
220030;201612;3168;8549;3084;8411;149;472;2723;7301;2872;7773
220040;201612;7479;23081;6734;21662;1343;4226;4213;13622;5556;17848
220045;201612;1375;4532;1192;4129;48;229;927;3114;975;3343
220050;201612;4392;13282;3701;12035;185;772;2972;9525;3157;10297
220060;201612;2073;5069;1809;4718;51;105;1646;4291;1697;4396
220070;201612;2352;6851;2088;6385;154;433;1655;5036;1809;5469
220080;201612;668;2040;611;1942;37;160;520;1588;557;1748
220090;201612;1788;4501;1437;4001;41;146;1268;3455;1309;3601
220095;201612;719;1923;669;1852;14;53;619;1688;633;1741
220100;201612;1284;3878;1031;3395;60;251;832;2667;892;2918
220105;201612;2198;6952;1905;6341;131;428;1460;4879;1591;5307
220110;201612;3295;9580;3125;9279;83;319;2780;8108;2863;8427
220115;201612;2562;8475;2445;8278;129;514;2168;7261;2297;7775
220117;201612;1205;3242;982;2873;39;109;830;2403;869;2512
220120;201612;11808;34653;10882;33419;124;589;10295;31403;10419;31992
220130;201612;852;2877;748;2703;35;206;640;2241;675;2447
220140;201612;1656;4408;1406;4083;161;378;1132;3362;1293;3740
220150;201612;6888;20841;6400;20082;143;622;5674;17481;5817;18103
220155;201612;1065;3258;835;2799;30;103;580;1909;610;2012
220157;201612;1061;2666;884;2363;19;66;759;1964;778;2030
220160;201612;2456;7527;2180;6993;67;317;1790;5605;1857;5922
220170;201612;1357;4045;1133;3660;33;152;948;2999;981;3151
220173;201612;1994;6042;1601;5241;38;203;1330;4207;1368;4410
220177;201612;1723;5192;1683;5131;34;146;1607;4866;1641;5012
220180;201612;1102;3004;892;2590;13;46;662;1831;675;1877
220190;201612;4507;14418;4071;13780;510;1769;3060;10326;3570;12095
220191;201612;1373;4584;1278;4403;124;471;964;3248;1088;3719
220192;201612;1750;5000;1388;4335;67;223;1073;3326;1140;3549
220194;201612;1733;5189;1495;4787;95;337;1165;3644;1260;3981
220196;201612;1955;5669;1738;5257;113;415;1434;4250;1547;4665
220198;201612;1333;3772;1002;3324;13;41;936;3144;949;3185
220200;201612;4409;14432;4038;13906;311;1083;3341;11547;3652;12630
220202;201612;2122;6346;1807;5744;30;154;1586;4918;1616;5072
220205;201612;2709;7178;2395;6719;47;177;2119;5840;2166;6017
220207;201612;857;2641;707;2348;66;255;496;1608;562;1863
220208;201612;1789;5675;1475;5097;246;869;888;3073;1134;3942
220209;201612;1558;4658;1314;4213;35;145;1097;3458;1132;3603
220210;201612;1614;4331;1366;3900;30;126;1126;3099;1156;3225
220211;201612;1523;4316;1416;4143;35;164;1274;3635;1309;3799
220213;201612;1655;4700;1470;4319;26;103;1230;3497;1256;3600
220217;201612;1985;6293;1893;6170;39;146;1764;5798;1803;5944
220220;201612;10195;28278;8833;26018;585;1526;6737;20104;7322;21630
220225;201612;1102;3152;877;2809;31;121;727;2291;758;2412
220230;201612;5326;14401;4745;13501;210;575;4153;11805;4363;12380
220240;201612;2796;8659;2518;8097;95;376;2106;6692;2201;7068
220245;201612;1503;4003;1216;3585;17;58;1096;3268;1113;3326
220250;201612;3014;8850;2678;8327;74;296;2340;7253;2414;7549
220253;201612;1534;4611;1261;4090;240;802;813;2607;1053;3409
220255;201612;1712;4769;1428;4256;41;172;1164;3282;1205;3454
220260;201612;4428;14320;3839;13146;281;975;2905;9949;3186;10924
220265;201612;1290;4463;1157;4209;107;432;778;2833;885;3265
220270;201612;6746;21823;6321;20961;408;1655;5187;16670;5595;18325
220271;201612;1448;4061;1260;3744;60;161;1054;3173;1114;3334
220272;201612;1757;5257;1559;4878;38;154;1247;3801;1285;3955
220273;201612;1183;3430;1013;3115;76;225;752;2300;828;2525
220275;201612;2062;5220;1640;4684;30;123;1471;4109;1501;4232
220277;201612;2189;6026;1840;5405;56;185;1524;4366;1580;4551
220280;201612;1466;4045;1255;3643;75;256;1005;2828;1080;3084
220285;201612;1643;4289;1342;3877;24;94;1219;3516;1243;3610
220290;201612;5982;19782;4981;18185;552;2142;3450;12580;4002;14722
220300;201612;1790;5986;1570;5615;70;397;1269;4369;1339;4766
220310;201612;2382;7974;2131;7643;76;373;1805;6443;1881;6816
220320;201612;2805;8692;2372;7860;223;832;1714;5611;1937;6443
220323;201612;1466;5141;1271;4837;136;544;986;3752;1122;4296
220325;201612;1165;3685;948;3235;66;266;709;2367;775;2633
220327;201612;1299;4154;1163;3902;38;203;966;3127;1004;3330
220330;201612;3563;9538;3134;8944;101;276;2829;8108;2930;8384
220335;201612;1779;5487;1591;5255;22;60;1509;5026;1531;5086
220340;201612;1807;4954;1478;4401;95;297;1106;3200;1201;3497
220342;201612;1104;3643;1036;3525;56;257;848;2850;904;3107
220345;201612;2860;7150;2477;6567;47;92;2307;6118;2354;6210
220350;201612;3733;9907;3046;8725;158;517;2373;6639;2531;7156
220360;201612;1236;3415;1033;3088;72;222;823;2414;895;2636
220370;201612;9089;26003;8123;24629;273;989;7273;21828;7546;22817
220375;201612;1458;4575;1353;4436;11;31;1316;4347;1327;4378
220380;201612;1347;3630;1108;3269;41;150;932;2661;973;2811
220385;201612;847;2164;662;1845;15;55;546;1489;561;1544
220390;201612;8845;27057;7517;24545;1997;6533;3028;10093;5025;16626
220400;201612;1489;3741;1091;3066;95;177;837;2336;932;2513
220410;201612;1146;3354;949;3020;54;176;751;2354;805;2530
220415;201612;815;2255;689;2043;36;113;513;1475;549;1588
220420;201612;2122;6098;1686;5200;124;320;1247;3851;1371;4171
220430;201612;2429;6807;2366;6724;96;302;2133;6004;2229;6306
220435;201612;1626;4793;1440;4445;37;150;1171;3553;1208;3703
220440;201612;2306;7683;2135;7391;171;578;1697;5795;1868;6373
220450;201612;1896;5901;1579;5426;364;1328;900;3088;1264;4416
220455;201612;1291;4097;1200;3932;47;174;1067;3468;1114;3642
220460;201612;870;2405;782;2288;44;119;660;1913;704;2032
220465;201612;2301;7601;2063;7192;287;1038;1466;5127;1753;6165
220470;201612;3634;10712;3257;10077;127;375;2647;8056;2774;8431
220480;201612;2412;6834;2043;6197;137;346;1544;4666;1681;5012
220490;201612;2229;6263;2017;5973;38;138;1806;5284;1844;5422
220500;201612;3062;8306;2552;7372;79;357;2059;5691;2138;6048
220510;201612;2713;7866;2116;6754;76;268;1620;5121;1696;5389
220515;201612;1799;4396;1582;4094;117;272;1340;3476;1457;3748
220520;201612;5006;13653;4544;12998;110;333;4107;11730;4217;12063
220525;201612;1207;3441;1126;3312;25;97;968;2800;993;2897
220527;201612;1358;4117;1167;3719;113;363;843;2734;956;3097
220530;201612;1269;3562;1093;3286;47;184;959;2806;1006;2990
220535;201612;845;2542;798;2474;79;251;594;1831;673;2082
220540;201612;3453;10992;3266;10692;105;493;2884;9282;2989;9775
220545;201612;1372;4526;1275;4329;113;434;995;3325;1108;3759
220550;201612;9025;28575;8040;26740;711;2415;6024;19841;6735;22256
220551;201612;1441;4493;1250;4145;60;256;1003;3216;1063;3472
220552;201612;1580;4859;1339;4373;55;283;1060;3304;1115;3587
220553;201612;1607;4615;1284;4102;44;171;1036;3317;1080;3488
220554;201612;765;2238;663;2066;55;134;522;1644;577;1778
220555;201612;2091;6707;1899;6390;44;218;1662;5475;1706;5693
220556;201612;1348;4183;1185;3837;44;198;915;2819;959;3017
220557;201612;1547;4963;1367;4599;113;380;981;3283;1094;3663
220558;201612;1062;3241;930;3020;40;192;744;2328;784;2520
220559;201612;1544;4377;1340;4019;26;85;1155;3444;1181;3529
220560;201612;1568;3938;1253;3459;38;105;1085;2943;1123;3048
220570;201612;7084;22900;6568;21927;957;3215;4515;15251;5472;18466
220580;201612;6457;20000;6238;19615;239;770;5634;17568;5873;18338
220585;201612;2037;6842;1811;6392;105;438;1459;5045;1564;5483
220590;201612;1265;3748;1097;3489;124;403;778;2501;902;2904
220595;201612;2324;6784;2144;6526;29;141;1978;5928;2007;6069
220600;201612;1271;3096;1010;2731;121;196;784;2240;905;2436
220605;201612;1845;5482;1548;4923;54;199;1258;3913;1312;4112
220610;201612;2720;8123;2547;7846;44;181;2322;7091;2366;7272
220620;201612;7485;24873;7152;24386;259;1250;6374;21435;6633;22685
220630;201612;386;1196;299;1022;49;178;159;540;208;718
220635;201612;1652;5585;1431;5093;71;312;1098;3821;1169;4133
220640;201612;2559;7473;2217;6948;90;333;1868;5757;1958;6090
220650;201612;2103;6179;1798;5584;96;312;1362;4193;1458;4505
220660;201612;2826;8388;2508;7945;102;486;2192;6732;2294;7218
220665;201612;1190;3971;1062;3741;23;129;915;3169;938;3298
220667;201612;1653;5457;1478;5116;82;285;1224;4220;1306;4505
220669;201612;1773;5747;1683;5584;185;775;1233;3983;1418;4758
220670;201612;1888;5622;1650;5301;100;272;1374;4478;1474;4750
220672;201612;2375;6941;2185;6695;133;444;1892;5791;2025;6235
220675;201612;1241;3557;1136;3359;69;166;902;2669;971;2835
220680;201612;2375;7335;2232;7118;134;424;1921;6142;2055;6566
220690;201612;1699;4669;1429;4204;125;322;1086;3273;1211;3595
220695;201612;949;2691;836;2473;36;103;671;1961;707;2064
220700;201612;8131;23179;6920;21179;569;1816;5164;15616;5733;17432
220710;201612;817;2423;621;2017;41;105;467;1511;508;1616
220720;201612;2024;5234;1864;4978;53;150;1639;4335;1692;4485
220730;201612;1341;3850;1116;3482;30;127;936;2860;966;2987
220735;201612;1006;2522;779;2121;31;83;638;1705;669;1788
220740;201612;1380;4248;1168;3950;52;189;989;3373;1041;3562
220750;201612;3932;10941;3528;10285;279;724;2897;8513;3176;9237
220755;201612;1171;3282;1013;3000;37;137;809;2319;846;2456
220760;201612;2749;9020;2466;8622;121;564;2101;7235;2222;7799
220770;201612;21183;70270;18243;64218;6409;23351;5303;19229;11712;42580
220775;201612;1222;3279;1163;3210;13;54;1138;3127;1151;3181
220777;201612;1534;4195;1230;3676;76;177;961;2866;1037;3043
220779;201612;1340;3478;1221;3290;36;120;1082;2866;1118;2986
220780;201612;5485;15096;4806;13963;449;1331;3750;10826;4199;12157
220785;201612;1283;3262;1204;3137;39;92;1105;2864;1144;2956
220790;201612;10126;30417;9108;28711;596;2165;7415;23010;8011;25175
220793;201612;800;2270;700;2104;31;106;586;1745;617;1851
220795;201612;1450;4056;1332;3882;57;186;1206;3483;1263;3669
220800;201612;15682;42552;13349;38494;2871;8466;7743;21423;10614;29889
220810;201612;3152;9108;2696;8283;95;382;2207;6626;2302;7008
220820;201612;5357;14480;4678;13414;397;940;3817;10963;4214;11903
220830;201612;7181;20338;6529;19225;485;1438;5259;15415;5744;16853
220840;201612;13305;41952;11386;37818;2393;7926;5939;19919;8332;27845
220850;201612;2873;9631;2683;9378;73;343;2488;8671;2561;9014
220855;201612;581;1781;494;1600;24;101;378;1200;402;1301
220860;201612;925;2490;804;2295;35;122;678;1892;713;2014
220865;201612;2602;7107;2014;6061;57;259;1654;4782;1711;5041
220870;201612;2204;7339;1937;6945;47;238;1755;6226;1802;6464
220880;201612;4556;12355;4201;11911;47;141;3985;11304;4032;11445
220885;201612;1256;4481;1078;4142;72;353;837;3152;909;3505
220887;201612;1347;3338;1172;3089;9;42;1095;2843;1104;2885
220890;201612;1605;5482;1343;4888;111;389;995;3657;1106;4046
220900;201612;1837;5016;1625;4682;39;110;1441;4124;1480;4234
220910;201612;1479;4486;1276;4162;42;125;1131;3734;1173;3859
220915;201612;981;2775;805;2423;21;86;641;1855;662;1941
220920;201612;1315;4729;1172;4501;77;422;879;3265;956;3687
220930;201612;1447;4575;1303;4346;36;172;1104;3641;1140;3813
220935;201612;1069;3191;851;2695;53;169;581;1769;634;1938
220937;201612;1460;3982;1189;3494;40;143;958;2758;998;2901
220940;201612;1255;3990;1132;3712;56;256;844;2669;900;2925
220945;201612;407;1512;356;1396;32;140;241;937;273;1077
220950;201612;1287;3175;852;2419;17;71;696;1884;713;1955
220955;201612;1433;4110;1219;3709;71;187;966;2944;1037;3131
220960;201612;897;2308;683;1945;21;67;533;1491;554;1558
220965;201612;1618;4769;1496;4564;33;188;1313;3871;1346;4059
220970;201612;1918;5226;1456;4415;83;281;1145;3418;1228;3699
220975;201612;712;2256;639;2155;29;177;571;1841;600;2018
220980;201612;1227;3643;1060;3346;54;179;829;2608;883;2787
220985;201612;1160;3433;1067;3276;63;231;817;2414;880;2645
220987;201612;1433;4582;1269;4289;71;325;1012;3313;1083;3638
220990;201612;1734;5056;1461;4547;38;191;1153;3467;1191;3658
220995;201612;1241;3650;915;3113;85;297;654;2255;739;2552
220997;201612;2278;6883;2151;6680;39;185;2021;6199;2060;6384
221000;201612;4109;12428;3795;11848;239;926;3034;9268;3273;10194
221005;201612;1393;4350;1248;4055;440;1296;567;1965;1007;3261
221010;201612;1171;3009;987;2749;27;75;873;2400;900;2475
221020;201612;1658;5197;1499;4874;42;189;1113;3525;1155;3714
221030;201612;1430;4253;1246;3921;41;178;1013;3096;1054;3274
221035;201612;1472;4001;1348;3833;61;139;1235;3576;1296;3715
221037;201612;594;1762;505;1594;14;64;364;1082;378;1146
221038;201612;579;1644;439;1393;31;100;285;897;316;997
221039;201612;923;2540;799;2340;27;105;661;1866;688;1971
221040;201612;4438;13769;4045;13058;199;637;3214;10385;3413;11022
221050;201612;3454;10362;3170;9947;104;368;2802;8722;2906;9090
221060;201612;7899;23313;6632;21069;402;1377;5142;16137;5544;17514
221062;201612;1278;4423;1104;4040;64;287;871;3140;935;3427
221063;201612;1064;3441;931;3187;139;466;614;2111;753;2577
221065;201612;2766;7354;2386;6699;87;219;2037;5644;2124;5863
221070;201612;3635;11620;3072;10466;178;699;2339;7909;2517;8608
221080;201612;3422;8616;2664;7474;81;263;2257;6239;2338;6502
221090;201612;1355;3735;1160;3385;35;146;989;2808;1024;2954
221093;201612;1536;4564;1410;4272;201;628;857;2513;1058;3141
221095;201612;957;2571;812;2320;11;33;702;1970;713;2003
221097;201612;796;2211;612;1854;26;96;457;1332;483;1428
221100;201612;103765;303349;92291;282283;18551;58283;52529;157173;71080;215456
221110;201612;10220;31887;9378;30774;328;1456;8045;25968;8373;27424
221120;201612;3983;12748;3749;12306;580;1980;2609;8524;3189;10504
221130;201612;4411;12614;3452;10564;1148;3373;1336;4181;2484;7554
221135;201612;1495;4474;1352;4254;72;254;1150;3568;1222;3822
221140;201612;1309;3232;1144;2971;34;65;1011;2595;1045;2660
221150;201612;1199;3041;911;2514;29;115;725;1911;754;2026
221160;201612;744;1959;680;1861;24;59;562;1523;586;1582
221170;201612;1132;3396;1001;3156;52;140;801;2522;853;2662
230010;201612;3330;9012;2594;7678;217;709;1956;5636;2173;6345
230015;201612;2896;9867;2638;9285;312;1219;1751;6051;2063;7270
230020;201612;13390;43527;12877;42623;589;2277;11019;36130;11608;38407
230030;201612;11783;33443;10316;31061;419;1471;8605;25535;9024;27006
230040;201612;4243;11831;3568;10592;273;970;2629;7631;2902;8601
230050;201612;2658;8891;1844;6619;498;1720;497;1849;995;3569
230060;201612;2254;6368;1857;5625;71;287;1461;4307;1532;4594
230070;201612;4180;12436;3497;11068;306;1046;2449;7880;2755;8926
230075;201612;8904;30910;8120;29271;741;3105;6121;21645;6862;24750
230080;201612;2373;6129;1878;5334;60;234;1591;4420;1651;4654
230090;201612;3902;11021;3380;10080;312;1052;2449;7200;2761;8252
230100;201612;16564;48919;14972;45846;2504;8130;8908;27211;11412;35341
230110;201612;12389;39167;10964;35986;2140;7099;5789;18728;7929;25827
230120;201612;7781;21572;6583;19629;787;2116;4439;13853;5226;15969
230125;201612;2949;8487;2392;7439;155;527;1773;5430;1928;5957
230130;201612;5691;18498;4669;16167;739;2564;2838;9697;3577;12261
230140;201612;3471;10962;2829;9679;196;752;2012;6836;2208;7588
230150;201612;1626;5031;1376;4460;285;962;723;2330;1008;3292
230160;201612;6204;18011;5469;16868;264;1048;4462;13553;4726;14601
230170;201612;6126;19065;5198;17175;268;1030;3825;12360;4093;13390
230180;201612;1650;4855;1404;4327;52;243;1066;3118;1118;3361
230185;201612;3743;12253;3259;11299;529;1865;2068;7264;2597;9129
230190;201612;12086;38360;10183;34180;2175;7451;4849;16139;7024;23590
230195;201612;5300;16046;4573;14674;522;1696;3329;10524;3851;12220
230200;201612;4934;14113;4347;12911;310;968;3346;9728;3656;10696
230205;201612;4029;13171;3620;12353;233;1002;2587;8641;2820;9643
230210;201612;8719;24874;7456;22679;1140;3495;4786;14615;5926;18110
230220;201612;13139;36903;11555;33989;860;2814;8684;25016;9544;27830
230230;201612;7260;22861;6532;21386;660;2139;4681;15281;5341;17420
230240;201612;13232;36617;11248;33112;483;1513;9025;26138;9508;27651
230250;201612;9558;29324;9303;28747;558;2027;7237;21794;7795;23821
230260;201612;14288;46882;12590;43113;1941;6901;7238;24851;9179;31752
230270;201612;7479;21709;5948;18719;881;2834;3751;11834;4632;14668
230280;201612;19516;57080;16751;51973;1320;4372;12740;38760;14060;43132
230290;201612;4717;14203;3954;12586;492;1435;2685;8579;3177;10014
230300;201612;4286;12728;4037;12356;201;772;3328;9972;3529;10744
230310;201612;4819;14301;4005;12768;167;661;2933;9099;3100;9760
230320;201612;7152;21722;6325;20154;371;1509;4834;15010;5205;16519
230330;201612;4788;13858;3886;12018;315;1009;2741;8325;3056;9334
230340;201612;3363;11157;2960;10238;306;1154;1976;6699;2282;7853
230350;201612;17906;53792;15621;49323;1705;6013;9555;30253;11260;36266
230360;201612;3200;8971;2358;7320;176;598;1593;4845;1769;5443
230365;201612;2995;7872;2555;7087;90;338;2155;5873;2245;6211
230370;201612;54156;169802;46988;156471;12583;43234;19962;68494;32545;111728
230380;201612;6443;18741;5127;16062;208;730;3829;11789;4037;12519
230390;201612;3319;10590;2912;9809;171;774;2167;7099;2338;7873
230393;201612;3046;9934;2523;8805;144;711;1869;6229;2013;6940
230395;201612;5678;16298;4906;14864;762;2272;2958;9126;3720;11398
230400;201612;5431;16274;4776;15096;233;1025;3818;11708;4051;12733
230410;201612;14385;45187;11950;39843;1670;5699;7220;24011;8890;29710
230420;201612;23699;74905;20492;68062;4123;14209;9879;32399;14002;46608
230423;201612;4114;13406;3701;12511;205;860;2912;9668;3117;10528
230425;201612;5375;17762;4775;16369;680;2356;3063;10511;3743;12867
230426;201612;2551;7138;1955;5933;60;265;1494;4394;1554;4659
230427;201612;1880;5519;1329;4253;132;400;805;2485;937;2885
230428;201612;8610;26350;7850;24779;1440;4849;4091;12560;5531;17409
230430;201612;4407;13781;3899;12722;252;981;2897;9181;3149;10162
230435;201612;5076;15619;4375;14253;651;2332;2509;7998;3160;10330
230440;201612;358642;1031156;307751;936321;68489;213894;147584;445665;216073;659559
230445;201612;4367;11904;3610;10549;270;782;2608;7558;2878;8340
230450;201612;3565;10995;3028;9978;273;1152;2154;6870;2427;8022
230460;201612;1853;6084;1559;5500;137;575;1077;3725;1214;4300
230465;201612;3924;11648;3169;10156;244;844;2150;6709;2394;7553
230470;201612;10890;39057;9849;36769;1227;5011;6743;24920;7970;29931
230480;201612;1426;4429;1165;3871;128;514;812;2613;940;3127
230490;201612;2247;6787;1862;5973;269;876;943;2914;1212;3790
230495;201612;5531;18121;4825;16609;814;3016;2599;8816;3413;11832
230500;201612;8663;30573;8098;29303;529;2357;6114;21839;6643;24196
230510;201612;1499;5247;1050;4036;270;1064;329;1261;599;2325
230520;201612;4198;13023;3830;12229;379;1309;2644;8274;3023;9583
230523;201612;14686;46897;11833;40049;2828;9963;2993;10301;5821;20264
230526;201612;4032;11905;3392;10726;171;753;2665;8177;2836;8930
230530;201612;5328;16952;4703;16055;1065;3817;2846;9891;3911;13708
230533;201612;4050;11134;3401;9862;372;975;2450;7190;2822;8165
230535;201612;5424;15907;4614;14348;540;1615;2932;9369;3472;10984
230540;201612;17195;49734;15195;46384;474;1961;12895;38614;13369;40575
230550;201612;19158;56180;16216;50249;2879;9561;8592;25813;11471;35374
230560;201612;6767;19266;5609;17042;179;723;4401;13058;4580;13781
230565;201612;3442;9413;2695;7983;87;324;2055;6001;2142;6325
230570;201612;3529;9605;3045;8871;100;335;2532;7296;2632;7631
230580;201612;9796;29192;8872;27747;713;2353;7251;22511;7964;24864
230590;201612;8943;27193;7308;23892;630;2194;5113;16252;5743;18446
230600;201612;3798;10339;2666;7986;262;750;1682;5112;1944;5862
230610;201612;6134;19085;5453;17833;698;2200;3839;12628;4537;14828
230620;201612;2139;6037;1586;4793;184;573;921;2668;1105;3241
230625;201612;7695;24620;6573;21961;2037;7161;1737;5796;3774;12957
230630;201612;10547;33127;9398;30828;2642;8165;4141;14543;6783;22708
230640;201612;26180;83139;23492;78813;2228;8391;17904;59325;20132;67716
230650;201612;4771;14488;4212;13340;313;1150;3109;9563;3422;10713
230655;201612;9272;34244;8805;33304;707;3021;6863;25881;7570;28902
230660;201612;6060;18738;5041;16663;266;1303;3961;12672;4227;13975
230670;201612;5927;15727;4562;13222;154;499;3658;10212;3812;10711
230680;201612;2570;7576;2163;6716;302;920;1320;4085;1622;5005
230690;201612;6429;20462;5846;19098;804;2765;3577;11357;4381;14122
230700;201612;9520;26262;8114;23488;510;1734;5974;16571;6484;18305
230710;201612;7399;23783;6198;21355;711;2474;4319;14858;5030;17332
230720;201612;1784;5646;1469;4896;203;692;885;2916;1088;3608
230725;201612;3648;12329;3000;10632;739;2679;910;3191;1649;5870
230730;201612;53097;162261;43045;143317;12630;46033;8326;28881;20956;74914
230740;201612;6194;18172;5387;16727;209;812;4274;12984;4483;13796
230750;201612;8045;23171;6735;20778;322;1162;5259;15755;5581;16917
230760;201612;11026;32263;9766;29604;1094;3636;6714;19564;7808;23200
230763;201612;4265;12818;3644;11519;176;695;2796;8465;2972;9160
230765;201612;38068;118322;32152;105899;8433;28886;9410;31794;17843;60680
230770;201612;24744;67873;21482;62612;2930;8732;13833;40038;16763;48770
230780;201612;5693;21850;5361;21039;1238;4892;2677;10896;3915;15788
230790;201612;2785;8728;2537;8274;195;723;1961;6362;2156;7085
230800;201612;7439;25858;6569;23826;1328;5108;3178;11218;4506;16326
230810;201612;11876;38032;10954;36326;774;2810;8331;27229;9105;30039
230820;201612;3216;11028;2713;9837;365;1525;1548;5421;1913;6946
230830;201612;7343;22057;6324;20035;327;1279;4888;15178;5215;16457
230835;201612;3789;10060;3026;8763;200;574;2361;6769;2561;7343
230837;201612;3106;10430;2585;9259;218;886;1883;6518;2101;7404
230840;201612;8860;28710;8084;27275;643;2432;6219;20922;6862;23354
230850;201612;9336;28970;8408;27224;1122;3473;5582;18300;6704;21773
230860;201612;4979;13922;4321;12871;227;750;3527;10377;3754;11127
230870;201612;17847;46641;15114;42151;565;1707;11999;33047;12564;34754
230880;201612;1921;6438;1798;6169;99;470;1328;4405;1427;4875
230890;201612;3980;14229;3573;13301;351;1586;2408;8663;2759;10249
230900;201612;2731;9136;2210;7888;521;1716;975;3618;1496;5334
230910;201612;3046;8851;2444;7719;161;731;1868;5677;2029;6408
230920;201612;4634;13184;4302;12742;159;557;3748;11147;3907;11704
230930;201612;6732;20224;5766;18232;523;1731;3941;12352;4464;14083
230940;201612;7505;21495;6600;19848;267;956;5377;15983;5644;16939
230945;201612;6165;18367;5289;16849;359;1275;3712;11912;4071;13187
230950;201612;6356;16948;5744;16123;181;465;5034;14388;5215;14853
230960;201612;13988;42979;12098;38947;2391;7741;5610;18127;8001;25868
230970;201612;13214;39513;11029;35247;2265;7715;5051;15740;7316;23455
230980;201612;2874;8836;2402;7930;656;2114;1171;4029;1827;6143
230990;201612;1786;5207;1425;4475;121;481;939;2825;1060;3306
231000;201612;2531;6973;2020;5884;101;361;1410;3984;1511;4345
231010;201612;3036;8340;2420;7227;256;787;1629;4747;1885;5534
231020;201612;7764;25910;7052;24205;1241;4157;4176;14556;5417;18713
231025;201612;7654;23381;6882;21892;1044;3395;4410;14163;5454;17558
231030;201612;7177;23062;5773;19943;1102;3881;3084;10652;4186;14533
231040;201612;3146;9753;2723;8864;119;521;2059;6473;2178;6994
231050;201612;11647;32777;9671;29057;682;2136;7296;21715;7978;23851
231060;201612;2349;7608;2134;7182;107;554;1654;5393;1761;5947
231070;201612;8355;26223;7268;23920;1351;4516;3853;12787;5204;17303
231080;201612;3961;12152;3509;11288;132;718;2758;8443;2890;9161
231085;201612;4797;14747;4517;14283;594;1935;3177;10209;3771;12144
231090;201612;4117;11442;3149;9425;165;542;2282;6652;2447;7194
231095;201612;2000;6492;1716;5853;179;685;1173;3972;1352;4657
231100;201612;3159;9704;2557;8473;230;795;1824;5987;2054;6782
231110;201612;3432;11255;3355;11086;511;1714;2134;6985;2645;8699
231120;201612;1891;6342;1734;5984;257;925;1087;3716;1344;4641
231123;201612;2000;5500;1689;4903;119;326;1268;3630;1387;3956
231126;201612;6088;17365;4815;14799;221;774;3552;10628;3773;11402
231130;201612;18808;56791;16473;52690;2872;9530;10000;32788;12872;42318
231135;201612;4005;11886;3313;10533;230;769;2428;7608;2658;8377
231140;201612;16989;52155;14143;46409;1055;4523;9728;30595;10783;35118
231150;201612;5505;15959;4615;14196;797;2483;2237;6951;3034;9434
231160;201612;5804;18969;5237;17769;848;2869;3052;10369;3900;13238
231170;201612;4171;13328;3582;12012;305;1083;2514;8261;2819;9344
231180;201612;14230;41689;11932;36702;2511;7738;6024;18258;8535;25996
231190;201612;4512;12660;3670;11260;231;864;2744;8125;2975;8989
231195;201612;4456;14882;3808;13446;356;1554;2637;9042;2993;10596
231200;201612;7787;26071;6585;23391;326;1685;4869;16624;5195;18309
231210;201612;4780;15183;4179;14123;241;1168;3220;10536;3461;11704
231220;201612;11615;32931;9864;29521;584;1960;7327;21354;7911;23314
231230;201612;9094;29941;8134;28382;680;2801;6071;21070;6751;23871
231240;201612;11460;35711;10099;32755;2074;6797;5199;16788;7273;23585
231250;201612;1901;5364;1176;3569;385;1128;313;922;698;2050
231260;201612;3258;9860;2883;9154;521;1619;1716;5558;2237;7177
231270;201612;7074;19162;6064;17474;219;892;4797;13507;5016;14399
231280;201612;1713;5595;1570;5291;168;585;1045;3535;1213;4120
231290;201612;34001;112678;29503;101980;5985;21934;12483;42070;18468;64004
231300;201612;4219;12262;3366;10474;263;887;2305;6978;2568;7865
231310;201612;7282;20534;5702;17127;807;2417;3398;9988;4205;12405
231320;201612;6961;20906;5447;17671;238;959;4131;13132;4369;14091
231325;201612;2692;7794;2249;7044;535;1762;1108;3418;1643;5180
231330;201612;10994;34877;9146;30865;1901;6318;4823;16423;6724;22741
231335;201612;5376;15117;4542;13522;122;493;3780;11011;3902;11504
231340;201612;17522;57178;15757;54084;1273;4345;11963;41567;13236;45912
231350;201612;14398;41848;13340;40291;659;1894;11757;35841;12416;37735
231355;201612;4527;14260;3995;13271;260;1004;2925;9560;3185;10564
231360;201612;7500;23823;6538;22018;1155;3920;4037;13860;5192;17780
231370;201612;2388;6638;1802;5590;57;183;1388;4244;1445;4427
231375;201612;4121;13874;3750;13109;199;935;2963;10108;3162;11043
231380;201612;5408;16274;5089;15835;247;760;4263;13492;4510;14252
231390;201612;3428;10584;3086;9930;261;907;2155;6808;2416;7715
231395;201612;3785;12337;3305;11336;616;2041;1850;6399;2466;8440
231400;201612;8825;27053;7938;25163;451;1743;6047;18752;6498;20495
231410;201612;14637;48487;13131;45970;1094;4022;9939;34799;11033;38821
240010;201612;2364;6979;1844;5852;267;937;1048;3196;1315;4133
240020;201612;10047;31377;8640;28450;1625;5599;4657;15232;6282;20831
240030;201612;2496;6978;2392;6817;216;582;1976;5626;2192;6208
240040;201612;847;2464;668;2094;16;83;488;1447;504;1530
240050;201612;3351;9056;2746;7934;80;263;2263;6404;2343;6667
240060;201612;1391;3965;1196;3578;55;203;956;2736;1011;2939
240070;201612;2359;7071;2158;6655;290;919;1464;4424;1754;5343
240080;201612;2990;7935;2489;7153;146;441;1917;5435;2063;5876
240090;201612;2239;5983;1781;5119;40;154;1442;4046;1482;4200
240100;201612;7714;22127;6635;19777;593;1858;4669;13486;5262;15344
240110;201612;4647;14452;3939;12914;622;2173;2166;6893;2788;9066
240120;201612;2652;9122;2444;8639;323;1322;1536;5274;1859;6596
240130;201612;2677;7101;2305;6470;69;230;1972;5444;2041;5674
240140;201612;2132;6421;1740;5654;227;828;1069;3334;1296;4162
240145;201612;5486;17277;4786;15938;1222;4163;2509;8497;3731;12660
240150;201612;941;2870;761;2473;59;242;552;1711;611;1953
240160;201612;1411;4438;1165;3969;116;465;784;2653;900;3118
240165;201612;879;2736;711;2337;156;466;375;1263;531;1729
240170;201612;2208;6696;1849;5980;428;1438;915;2910;1343;4348
240180;201612;2634;8252;2245;7415;377;1289;1331;4420;1708;5709
240185;201612;1331;4456;1225;4269;69;286;986;3420;1055;3706
240190;201612;955;3018;818;2755;31;147;644;2143;675;2290
240200;201612;12151;32837;9840;28854;2310;6934;3880;11563;6190;18497
240210;201612;2819;7850;2489;7258;115;423;2038;5760;2153;6183
240220;201612;7261;24197;6524;22977;662;2760;4660;16228;5322;18988
240230;201612;5687;14969;4769;13476;139;435;4086;11477;4225;11912
240240;201612;1771;5340;996;3347;200;715;177;512;377;1227
240250;201612;2588;7592;2429;7370;95;294;2145;6503;2240;6797
240260;201612;11803;39463;11016;38026;2092;7261;6698;23284;8790;30545
240270;201612;2216;7056;2002;6665;176;642;1504;5016;1680;5658
240280;201612;1536;4310;1359;4044;56;193;1117;3293;1173;3486
240290;201612;1167;3706;1005;3366;44;234;684;2130;728;2364
240300;201612;2270;6190;1562;4669;198;639;783;2246;981;2885
240310;201612;9274;26209;7899;23685;1297;4001;4280;12843;5577;16844
240320;201612;1946;5720;1445;4630;48;189;1113;3390;1161;3579
240325;201612;31685;88544;24056;75001;7507;24253;5789;18768;13296;43021
240330;201612;1466;4442;1202;3871;57;222;786;2425;843;2647
240340;201612;1995;5138;1597;4466;135;394;1203;3295;1338;3689
240350;201612;2021;5563;1836;5321;73;269;1631;4654;1704;4923
240360;201612;6491;20116;5700;18793;1532;5046;2680;9218;4212;14264
240370;201612;2005;5538;1543;4630;182;512;992;2965;1174;3477
240375;201612;825;2228;697;1978;44;172;510;1336;554;1508
240380;201612;2360;7043;1699;5495;253;817;877;2799;1130;3616
240390;201612;903;2501;728;2135;34;104;549;1551;583;1655
240400;201612;1326;3558;1002;2909;63;209;714;1995;777;2204
240410;201612;443;1460;390;1348;74;303;222;727;296;1030
240420;201612;4627;17631;4169;16493;734;3317;2228;8626;2962;11943
240430;201612;3260;9178;2911;8513;104;433;2324;6501;2428;6934
240440;201612;2421;6235;2116;5761;381;1089;1271;3405;1652;4494
240450;201612;3914;11550;3174;10040;362;1346;1854;5536;2216;6882
240460;201612;2835;8668;2636;8386;189;764;2103;6486;2292;7250
240470;201612;3555;11113;2663;9101;825;2676;1067;3747;1892;6423
240480;201612;514;1388;345;1031;28;90;186;536;214;626
240485;201612;1877;6008;1594;5384;217;787;1021;3432;1238;4219
240490;201612;1725;4326;1371;3736;27;96;1210;3254;1237;3350
240500;201612;2123;6049;1892;5688;103;354;1528;4531;1631;4885
240510;201612;1664;4928;1580;4787;162;441;1273;3904;1435;4345
240520;201612;1193;3436;1043;3163;69;253;831;2426;900;2679
240530;201612;1903;6209;1723;5884;301;1024;1151;3933;1452;4957
240540;201612;1750;5201;1635;5004;90;314;1381;4160;1471;4474
240550;201612;763;2176;628;1926;41;120;464;1411;505;1531
240560;201612;3177;9084;2896;8640;349;911;2208;6708;2557;7619
240570;201612;2943;8169;2008;5965;480;1446;725;1929;1205;3375
240580;201612;7579;23278;6947;22097;572;2109;5503;17177;6075;19286
240590;201612;741;2074;630;1864;21;77;491;1413;512;1490
240600;201612;1610;4703;1179;3740;115;417;681;2053;796;2470
240610;201612;4510;12937;3757;11385;357;1139;2500;7343;2857;8482
240615;201612;954;2816;753;2393;141;461;427;1312;568;1773
240620;201612;1788;5402;1569;5010;136;438;1209;3838;1345;4276
240630;201612;2041;6137;1806;5710;152;419;1265;4070;1417;4489
240640;201612;900;2552;739;2279;43;189;552;1631;595;1820
240650;201612;3909;11489;3385;10588;176;601;2696;8308;2872;8909
240660;201612;2312;7375;2147;7107;166;615;1674;5464;1840;6079
240670;201612;2528;7562;2019;6427;238;791;1196;3685;1434;4476
240680;201612;1480;4324;1126;3630;91;313;772;2406;863;2719
240690;201612;912;2481;762;2212;33;127;621;1728;654;1855
240700;201612;2472;7338;2018;6462;61;259;1627;5076;1688;5335
240710;201612;17331;46550;14566;41709;3079;8527;7683;22386;10762;30913
240720;201612;5098;14476;4483;13272;1422;4239;1875;5397;3297;9636
240725;201612;997;3028;785;2525;65;215;496;1539;561;1754
240730;201612;2003;6063;1703;5469;106;344;1294;4121;1400;4465
240740;201612;1884;5464;1624;4946;122;461;1151;3344;1273;3805
240750;201612;2114;7849;1914;7434;452;1886;901;3514;1353;5400
240760;201612;1325;3578;1045;3158;95;278;773;2427;868;2705
240770;201612;3031;8625;2685;8105;108;454;2249;6621;2357;7075
240780;201612;5892;16226;4564;13966;662;2013;2726;8416;3388;10429
240790;201612;888;2678;707;2313;31;126;513;1677;544;1803
240800;201612;33041;94518;28071;85394;6634;20463;11652;35540;18286;56003
240810;201612;82053;235302;73011;218427;20134;59654;31984;97343;52118;156997
240820;201612;5623;17764;4837;16370;1211;4288;2043;7165;3254;11453
240830;201612;8575;26448;7857;25308;310;1427;6661;20943;6971;22370
240840;201612;1094;3028;889;2638;88;253;577;1657;665;1910
240850;201612;1268;3694;865;2745;116;378;463;1438;579;1816
240860;201612;1250;3555;967;2995;26;109;768;2263;794;2372
240870;201612;1129;3050;872;2559;182;512;473;1328;655;1840
240880;201612;1164;3865;1083;3709;65;310;896;2972;961;3282
240890;201612;4769;13493;3804;11518;815;2453;1606;4768;2421;7221
240895;201612;2595;8916;2348;8444;237;917;1715;6186;1952;7103
240910;201612;2910;8614;2505;7807;128;490;2008;6135;2136;6625
240920;201612;747;2410;631;2130;121;435;319;1062;440;1497
240930;201612;3379;8659;2879;7979;93;267;2425;6734;2518;7001
240933;201612;1485;4023;1236;3576;49;196;1046;2889;1095;3085
240940;201612;6266;16628;4914;14230;696;1958;3081;8832;3777;10790
240950;201612;929;3016;836;2820;50;224;614;1996;664;2220
240960;201612;777;2428;658;2165;58;199;479;1569;537;1768
240970;201612;1790;4992;1489;4468;70;283;1174;3371;1244;3654
240980;201612;2731;9136;2490;8653;427;1548;1515;5194;1942;6742
240990;201612;2575;7694;2389;7282;396;1302;1551;4632;1947;5934
241000;201612;1024;2844;841;2490;38;140;604;1746;642;1886
241010;201612;2741;9285;2536;8861;339;1422;1736;5776;2075;7198
241020;201612;1974;5474;1455;4374;214;586;896;2655;1110;3241
241025;201612;1638;4945;1341;4361;68;291;1007;3175;1075;3466
241030;201612;2364;7783;2018;7031;208;815;1385;4755;1593;5570
241040;201612;2124;7289;1901;6829;118;504;1433;5128;1551;5632
241050;201612;1257;3708;1042;3297;54;203;782;2420;836;2623
241060;201612;825;2391;731;2217;52;171;528;1558;580;1729
241070;201612;702;2037;623;1884;57;211;463;1306;520;1517
241080;201612;1125;3307;879;2807;28;132;659;2031;687;2163
241090;201612;2119;6289;1713;5535;93;399;1286;4063;1379;4462
241100;201612;1150;3399;937;2894;71;232;675;2048;746;2280
241105;201612;1159;3487;961;3109;244;771;429;1450;673;2221
241110;201612;793;2461;630;2074;41;155;437;1378;478;1533
241120;201612;7060;21573;6252;20037;1669;5118;3047;10369;4716;15487
241140;201612;3376;9084;2819;7932;256;671;2047;5639;2303;6310
241142;201612;714;2114;512;1654;108;391;231;701;339;1092
241150;201612;5322;15562;4604;14244;567;1777;3078;9456;3645;11233
241160;201612;933;2769;813;2542;141;430;476;1468;617;1898
241170;201612;1129;3272;1032;3089;104;322;804;2358;908;2680
241180;201612;933;2622;700;2111;83;262;386;1113;469;1375
241190;201612;1154;3182;887;2610;40;150;608;1708;648;1858
241200;201612;18484;52996;15584;48141;3938;12409;6674;20973;10612;33382
241210;201612;1402;3951;1079;3249;140;491;650;1862;790;2353
241220;201612;7818;25387;7015;23788;2136;7254;2958;10339;5094;17593
241230;201612;2988;8628;2692;8111;154;520;2210;6489;2364;7009
241240;201612;1243;3633;778;2526;83;297;355;1148;438;1445
241250;201612;6053;18431;4906;16127;185;981;3756;11852;3941;12833
241255;201612;1661;6274;1451;5737;304;1352;747;2894;1051;4246
241260;201612;5061;13634;3876;11610;163;708;2941;8503;3104;9211
241270;201612;1827;5575;1528;4925;90;387;1130;3522;1220;3909
241280;201612;1791;5215;1592;4815;145;430;1162;3476;1307;3906
241290;201612;2893;8081;2391;7143;174;560;1783;5190;1957;5750
241300;201612;1452;4129;1189;3610;46;158;839;2495;885;2653
241310;201612;1629;4767;1458;4446;82;309;1175;3521;1257;3830
241320;201612;899;3106;790;2861;94;394;507;1800;601;2194
241330;201612;1378;4292;1297;4181;80;335;1111;3507;1191;3842
241335;201612;2744;8283;2450;7707;132;470;2017;6224;2149;6694
241340;201612;1739;5380;1414;4593;318;1104;628;1941;946;3045
241350;201612;1871;5913;1643;5451;118;519;1232;3923;1350;4442
241355;201612;1412;3912;1095;3318;48;171;873;2597;921;2768
241360;201612;2071;5570;1622;4650;59;175;1238;3432;1297;3607
241370;201612;1350;4016;1046;3378;104;368;666;2072;770;2440
241380;201612;610;1744;490;1497;75;234;292;863;367;1097
241390;201612;2699;8739;2467;8312;240;867;1869;6266;2109;7133
241400;201612;3679;10528;3271;9892;352;1120;2443;7383;2795;8503
241410;201612;2415;7329;2107;6831;348;1195;1332;4281;1680;5476
241415;201612;1638;4888;1441;4550;132;437;1092;3367;1224;3804
241420;201612;2196;7596;1875;6990;583;2304;431;1586;1014;3890
241430;201612;565;1672;418;1340;44;154;240;721;284;875
241440;201612;6060;21797;5689;21117;765;3180;4147;15314;4912;18494
241445;201612;962;2781;910;2718;56;126;765;2410;821;2536
241450;201612;2884;7785;2460;7125;298;877;1672;4761;1970;5638
241460;201612;3320;9616;2850;8615;250;819;2087;6122;2337;6941
241470;201612;1372;3786;1095;3388;93;326;829;2536;922;2862
241475;201612;1232;3681;953;3092;35;197;726;2199;761;2396
241480;201612;2623;8729;2327;8150;966;3469;497;1939;1463;5408
241490;201612;698;1825;541;1567;26;72;364;991;390;1063
241500;201612;720;2260;597;2079;10;43;517;1781;527;1824
250010;201612;2714;8423;2221;7316;70;314;1708;5462;1778;5776
250020;201612;1546;4444;1152;3649;48;184;835;2547;883;2731
250030;201612;6747;19517;6160;18584;388;1217;5060;15018;5448;16235
250040;201612;3905;13225;3542;12395;522;1825;2248;7886;2770;9711
250050;201612;3251;10162;2939;9603;517;1704;1778;5621;2295;7325
250053;201612;1212;3640;1084;3428;138;415;736;2358;874;2773
250057;201612;615;2615;593;2588;5;6;568;2533;573;2539
250060;201612;5032;14829;4605;14139;506;1621;3465;10537;3971;12158
250070;201612;3818;11768;3456;11025;93;469;2706;8247;2799;8716
250073;201612;761;2244;640;2018;16;61;515;1561;531;1622
250077;201612;2079;6073;1637;5275;118;403;1148;3649;1266;4052
250080;201612;4058;11855;3803;11362;285;852;2976;8745;3261;9597
250090;201612;2534;7236;2311;6835;289;602;1719;5214;2008;5816
250100;201612;3760;12190;3490;11662;240;909;2753;8959;2993;9868
250110;201612;4813;14325;4477;13773;366;1322;3598;10786;3964;12108
250115;201612;474;1517;415;1393;23;124;317;995;340;1119
250120;201612;1824;5701;1550;5146;84;322;1220;4003;1304;4325
250130;201612;5224;16302;4597;15045;181;795;3772;12100;3953;12895
250135;201612;1001;3063;926;2913;31;126;752;2328;783;2454
250140;201612;2036;6695;1914;6474;153;655;1467;4847;1620;5502
250150;201612;4941;16459;4414;15388;204;946;3418;11586;3622;12532
250153;201612;1404;3827;1168;3452;34;153;1011;2910;1045;3063
250157;201612;1691;5470;1504;5071;234;757;984;3367;1218;4124
250160;201612;3236;9485;3022;9105;77;293;2783;8328;2860;8621
250170;201612;1531;4546;1374;4282;103;369;1058;3256;1161;3625
250180;201612;15405;44469;13954;41969;1729;5302;9812;28880;11541;34182
250190;201612;4077;11727;3600;10856;514;1513;2359;7025;2873;8538
250200;201612;1918;5651;1550;5042;67;256;1285;4102;1352;4358
250205;201612;819;2832;743;2652;27;141;561;1969;588;2110
250210;201612;1424;4679;1299;4449;98;461;989;3229;1087;3690
250215;201612;1318;4244;1223;4085;177;579;721;2397;898;2976
250220;201612;731;2217;607;2014;30;126;469;1547;499;1673
250230;201612;1479;3761;1152;3164;46;163;930;2414;976;2577
250240;201612;2236;7362;2104;7100;92;357;1723;5763;1815;6120
250250;201612;4288;12810;3800;12056;170;599;3152;9893;3322;10492
250260;201612;1645;4980;1387;4526;65;212;1101;3577;1166;3789
250270;201612;1263;3913;1097;3692;89;287;838;2902;927;3189
250280;201612;3519;10335;3020;9477;270;855;2263;7066;2533;7921
250290;201612;1759;4781;1421;4271;19;70;1255;3729;1274;3799
250300;201612;5122;15286;4870;14940;392;1590;4155;12346;4547;13936
250310;201612;1083;3332;959;3102;115;378;686;2172;801;2550
250320;201612;7835;22945;7263;22002;844;2760;5284;15628;6128;18388
250330;201612;2331;7282;1971;6701;147;510;1488;5021;1635;5531
250340;201612;1064;3144;938;2902;30;116;797;2415;827;2531
250350;201612;3951;11085;3513;10508;104;392;3122;9219;3226;9611
250355;201612;1896;5961;1728;5717;35;199;1534;4982;1569;5181
250360;201612;1750;5193;1600;4916;45;136;1372;4189;1417;4325
250370;201612;11232;32221;9956;30697;624;1997;8579;26369;9203;28366
250375;201612;1044;3168;922;2970;46;166;774;2482;820;2648
250380;201612;1613;4613;1515;4456;71;278;1273;3609;1344;3887
250390;201612;1722;4777;1361;4131;218;605;854;2600;1072;3205
250400;201612;71919;189969;53474;158836;15549;47151;18334;55040;33883;102191
250403;201612;1536;5004;1389;4770;220;932;912;2983;1132;3915
250407;201612;1173;3271;984;2952;77;190;721;2136;798;2326
250410;201612;517;1675;471;1581;19;95;379;1231;398;1326
250415;201612;1866;5583;1627;5124;99;328;1261;3916;1360;4244
250420;201612;1236;3590;1100;3374;18;63;997;3037;1015;3100
250430;201612;6019;16156;5315;14978;326;962;4355;11972;4681;12934
250435;201612;1292;3980;1122;3646;84;328;826;2627;910;2955
250440;201612;4414;12544;3921;11799;110;408;3371;9972;3481;10380
250450;201612;1855;5300;1603;4931;50;190;1353;4078;1403;4268
250460;201612;6333;18939;5865;18275;447;1468;4815;15111;5262;16579
250470;201612;1502;4090;1248;3707;110;377;885;2521;995;2898
250480;201612;3663;11050;3299;10465;89;393;2843;8922;2932;9315
250485;201612;592;1498;492;1344;24;78;417;1110;441;1188
250490;201612;3789;11647;3613;11362;717;2119;2473;7882;3190;10001
250500;201612;1733;5242;1512;4835;128;400;1179;3784;1307;4184
250510;201612;4801;13456;4233;12566;130;397;3769;11148;3899;11545
250520;201612;1735;5215;1575;4935;212;735;987;3003;1199;3738
250523;201612;1665;5009;1604;4916;128;462;1327;3993;1455;4455
250527;201612;1374;4122;1306;4038;21;112;1220;3699;1241;3811
250530;201612;573;1783;503;1686;27;108;439;1459;466;1567
250535;201612;1298;4043;1183;3797;36;174;968;3008;1004;3182
250540;201612;2304;6524;2123;6295;40;177;1857;5369;1897;5546
250550;201612;856;2868;782;2741;38;205;646;2188;684;2393
250560;201612;1611;5044;1498;4840;78;310;1234;3879;1312;4189
250570;201612;2550;8031;2192;7296;103;455;1740;5594;1843;6049
250580;201612;1070;2876;925;2647;55;196;773;2146;828;2342
250590;201612;814;2528;734;2397;45;173;614;1942;659;2115
250600;201612;6971;20479;6452;19610;650;1829;5028;15337;5678;17166
250610;201612;2974;8644;2718;8208;205;629;2131;6382;2336;7011
250620;201612;653;1934;572;1760;76;251;374;1115;450;1366
250625;201612;2400;7603;2306;7438;43;110;2191;7072;2234;7182
250630;201612;9382;28892;8279;26496;1784;5719;4353;13780;6137;19499
250640;201612;3324;10261;3106;9926;180;741;2586;8035;2766;8776
250650;201612;846;2327;718;2132;36;137;537;1492;573;1629
250660;201612;1729;4632;1590;4421;29;76;1494;4167;1523;4243
250670;201612;2309;7754;2180;7510;88;453;1860;6230;1948;6683
250680;201612;4663;13090;4357;12674;179;598;3838;11005;4017;11603
250690;201612;5932;15378;5625;14994;354;889;5028;13398;5382;14287
250700;201612;4438;13178;4004;12454;712;2193;2545;7888;3257;10081
250710;201612;4346;13433;3793;12577;456;1535;2633;8810;3089;10345
250720;201612;2655;7630;2412;7219;65;282;2128;6237;2193;6519
250730;201612;3355;10207;3069;9754;197;712;2441;7542;2638;8254
250740;201612;1876;5376;1588;4913;164;588;1194;3543;1358;4131
250750;201612;94351;264596;83536;246687;10951;33902;55883;160884;66834;194786
250760;201612;2224;6237;1927;5760;143;500;1546;4511;1689;5011
250770;201612;3857;12690;3552;12205;408;1587;2540;8557;2948;10144
250780;201612;1705;5011;1428;4444;162;580;957;2868;1119;3448
250790;201612;2310;7525;2147;7210;499;1598;1215;4228;1714;5826
250800;201612;2601;7252;2240;6610;93;243;1874;5442;1967;5685
250810;201612;1236;3610;1050;3294;49;196;836;2563;885;2759
250820;201612;1835;5724;1750;5613;92;395;1546;4882;1638;5277
250830;201612;5510;17686;4971;16510;470;1756;3480;11279;3950;13035
250840;201612;881;2875;718;2508;42;173;497;1728;539;1901
250850;201612;1940;5926;1717;5534;67;336;1388;4325;1455;4661
250855;201612;1074;3138;906;2834;44;187;691;2081;735;2268
250860;201612;3189;10262;2625;9156;609;2211;1006;3516;1615;5727
250870;201612;1056;3063;883;2695;21;75;722;2154;743;2229
250880;201612;1490;3994;1223;3606;116;347;940;2788;1056;3135
250890;201612;9103;27128;8506;26165;1099;3785;5995;17868;7094;21653
250900;201612;2685;8675;2308;7873;184;585;1765;6007;1949;6592
250905;201612;1979;6268;1882;6121;209;743;1484;4764;1693;5507
250910;201612;4795;13823;4400;13185;196;709;3744;11038;3940;11747
250915;201612;1365;4151;1338;4111;85;175;1186;3767;1271;3942
250920;201612;3128;8890;2883;8469;280;700;2141;6277;2421;6977
250930;201612;1904;5798;1780;5572;115;466;1380;4182;1495;4648
250933;201612;1103;3624;993;3370;68;262;689;2290;757;2552
250937;201612;631;1955;554;1802;37;142;421;1334;458;1476
250939;201612;1499;4527;1358;4265;155;501;966;2988;1121;3489
250940;201612;3688;10845;3369;10280;86;349;2970;8981;3056;9330
250950;201612;1305;3927;1116;3649;44;180;918;2979;962;3159
250960;201612;1021;3318;957;3204;50;189;777;2559;827;2748
250970;201612;8255;22896;6998;20734;585;1812;5185;15057;5770;16869
250980;201612;2502;7299;2187;6666;74;307;1716;4988;1790;5295
250990;201612;1905;6441;1659;5866;215;892;1078;3650;1293;4542
251000;201612;2028;5962;1740;5452;38;181;1505;4622;1543;4803
251010;201612;2665;7876;2376;7376;84;297;2056;6328;2140;6625
251020;201612;1637;4587;1479;4374;68;195;1340;3964;1408;4159
251030;201612;981;2810;873;2594;45;154;637;1818;682;1972
251040;201612;1718;5393;1509;4996;61;293;1201;3803;1262;4096
251050;201612;1027;2997;821;2569;116;359;509;1555;625;1914
251060;201612;1011;2294;732;1919;23;83;591;1508;614;1591
251065;201612;447;1336;377;1216;24;84;261;793;285;877
251070;201612;606;1682;531;1564;17;63;448;1272;465;1335
251080;201612;18311;51217;15802;46911;4628;14149;6544;19865;11172;34014
251090;201612;2804;8609;2410;7812;143;540;1852;5839;1995;6379
251100;201612;923;2909;815;2696;61;237;569;1807;630;2044
251110;201612;1788;5257;1537;4722;108;297;1099;3350;1207;3647
251120;201612;6117;20403;5690;19566;578;2315;4225;14162;4803;16477
251130;201612;3773;9734;3476;9400;163;433;3246;8828;3409;9261
251140;201612;4157;12590;3852;12065;112;480;3258;10080;3370;10560
251150;201612;2560;8038;2328;7656;177;731;1762;5621;1939;6352
251160;201612;1787;5805;1748;5752;48;196;1607;5262;1655;5458
251170;201612;1368;4156;1285;4045;68;289;1102;3384;1170;3673
251180;201612;2419;7386;2148;6896;320;1030;1346;4286;1666;5316
251190;201612;4351;11958;4091;11584;108;330;3741;10424;3849;10754
251200;201612;3850;12430;3619;12119;86;363;3288;10961;3374;11324
251203;201612;983;3276;925;3150;37;175;717;2364;754;2539
251207;201612;992;3118;831;2780;40;190;602;1923;642;2113
251210;201612;7681;21603;6457;19895;623;1896;4969;15533;5592;17429
251220;201612;1139;3010;922;2683;80;221;712;2084;792;2305
251230;201612;4421;13110;4044;12616;205;769;3573;10981;3778;11750
251240;201612;3177;9549;2841;9050;351;1137;2125;6693;2476;7830
251250;201612;10164;29754;9272;28314;685;2458;7158;21219;7843;23677
251260;201612;452;1447;414;1387;22;92;316;1038;338;1130
251270;201612;4157;13487;3735;12884;119;583;3241;11056;3360;11639
251272;201612;1318;3779;1254;3682;80;262;1119;3254;1199;3516
251274;201612;884;2722;775;2522;77;320;512;1585;589;1905
251275;201612;1189;3472;1088;3289;48;214;849;2432;897;2646
251276;201612;1180;3611;1103;3465;59;254;854;2597;913;2851
251278;201612;570;1781;477;1587;42;168;328;1077;370;1245
251280;201612;2264;6711;2034;6267;87;345;1625;4804;1712;5149
251290;201612;5403;14756;4981;14168;533;1841;3842;10496;4375;12337
251300;201612;730;2424;679;2340;20;90;566;1922;586;2012
251310;201612;2834;8525;2591;8153;112;514;2093;6337;2205;6851
251315;201612;1597;5433;1499;5249;143;505;1095;3822;1238;4327
251320;201612;1831;5024;1306;4098;43;157;945;2930;988;3087
251330;201612;1711;4568;1425;4160;64;282;1249;3527;1313;3809
251335;201612;1009;3353;908;3175;64;285;660;2238;724;2523
251340;201612;3263;9493;2885;8873;156;599;2270;6805;2426;7404
251350;201612;1174;3745;1085;3571;76;269;841;2690;917;2959
251360;201612;1785;5571;1498;5140;45;175;1296;4473;1341;4648
251365;201612;688;2084;560;1787;14;57;432;1341;446;1398
251370;201612;22360;68229;21221;66429;2037;6935;16475;50457;18512;57392
251380;201612;1292;4003;1109;3674;20;115;952;3035;972;3150
251385;201612;735;1969;595;1729;52;140;414;1164;466;1304
251390;201612;5508;18686;4744;17028;1548;5581;1769;6408;3317;11989
251392;201612;1011;3003;862;2730;50;191;645;1977;695;2168
251394;201612;564;1797;469;1606;42;150;325;1089;367;1239
251396;201612;790;2242;660;2014;81;231;417;1258;498;1489
251398;201612;860;2519;748;2287;28;115;541;1581;569;1696
251400;201612;1106;3148;923;2851;63;234;687;2026;750;2260
251410;201612;1498;3853;1241;3416;32;128;1061;2804;1093;2932
251420;201612;1936;5528;1653;5149;169;556;1198;3676;1367;4232
251430;201612;1552;5285;1397;5011;55;290;1191;4157;1246;4447
251440;201612;1152;3451;935;3004;34;154;736;2330;770;2484
251445;201612;1476;4512;1377;4358;103;418;1075;3260;1178;3678
251450;201612;4508;14240;4087;13583;95;455;3438;11278;3533;11733
251455;201612;1053;3369;918;3075;69;262;652;2153;721;2415
251460;201612;801;2499;729;2368;62;196;581;1888;643;2084
251465;201612;425;1358;357;1201;14;78;276;887;290;965
251470;201612;1078;3182;872;2735;70;247;569;1722;639;1969
251480;201612;879;2513;763;2310;29;134;588;1691;617;1825
251490;201612;1728;5135;1501;4735;133;494;1049;3206;1182;3700
251500;201612;1702;5414;1595;5208;93;386;1303;4120;1396;4506
251510;201612;2501;8169;2204;7551;375;1355;1307;4417;1682;5772
251520;201612;906;2496;777;2246;102;300;509;1431;611;1731
251530;201612;11929;32935;11008;31508;239;1060;9657;26887;9896;27947
251540;201612;2786;8863;2525;8342;141;575;2026;6548;2167;7123
251550;201612;3300;8750;2710;7839;73;251;2275;6488;2348;6739
251560;201612;645;2023;564;1862;77;294;352;1101;429;1395
251570;201612;945;2810;730;2337;31;122;532;1648;563;1770
251580;201612;1812;5136;1631;4869;331;811;1049;3299;1380;4110
251590;201612;1442;4418;1346;4260;47;163;1099;3445;1146;3608
251593;201612;948;2909;854;2760;130;434;526;1643;656;2077
251597;201612;1890;5763;1813;5653;39;170;1601;4896;1640;5066
251600;201612;6338;18527;5816;17651;353;1061;4736;14257;5089;15318
251610;201612;3221;9592;2842;8859;274;801;2108;6640;2382;7441
251615;201612;1117;3186;856;2703;78;221;584;1821;662;2042
251620;201612;15135;40160;13107;37683;509;1416;11213;33126;11722;34542
251630;201612;4478;11595;3705;10381;297;875;2790;7603;3087;8478
251640;201612;2151;6548;1909;6045;80;345;1600;4936;1680;5281
251650;201612;3866;11155;3474;10570;201;622;2908;8749;3109;9371
251660;201612;3415;10897;3057;10212;86;428;2567;8296;2653;8724
251670;201612;4351;12842;3844;12197;23;90;3636;11648;3659;11738
251675;201612;673;2100;613;2009;118;417;378;1191;496;1608
251680;201612;2679;7697;2123;6796;88;359;1649;5183;1737;5542
251690;201612;3236;9626;2820;8752;121;399;2152;6482;2273;6881
251700;201612;1884;6072;1735;5848;84;410;1431;4664;1515;5074
251710;201612;867;2280;525;1546;96;318;247;663;343;981
251720;201612;1386;4216;1138;3719;46;232;868;2689;914;2921
251740;201612;737;2088;563;1771;53;177;363;1121;416;1298
260005;201612;23897;58764;19884;52399;4257;10676;11030;29195;15287;39871
260010;201612;9651;26326;7823;23563;1095;3316;4703;14499;5798;17815
260020;201612;6108;16675;5041;15009;187;708;4176;12362;4363;13070
260030;201612;6079;17361;5220;15864;350;1181;4129;12401;4479;13582
260040;201612;9495;23401;7658;21075;739;1876;5782;16415;6521;18291
260050;201612;11083;34164;10236;33005;461;1750;8953;28952;9414;30702
260060;201612;3762;10590;3246;9631;327;928;2365;7111;2692;8039
260070;201612;9590;27404;8549;25612;1060;3486;5895;17150;6955;20636
260080;201612;5891;15283;5151;14186;691;1677;3709;10267;4400;11944
260090;201612;5084;13902;4645;13230;602;1682;3401;9703;4003;11385
260100;201612;3303;9095;2767;8294;132;541;2324;6835;2456;7376
260105;201612;5012;13802;4671;13213;154;616;4075;11210;4229;11826
260110;201612;20601;57466;18728;55091;720;2214;16704;49053;17424;51267
260120;201612;12608;37344;10819;34092;2409;7665;5676;18269;8085;25934
260130;201612;3091;8646;2840;8218;331;993;2101;5973;2432;6966
260140;201612;12313;30638;10528;28388;700;2150;8530;22865;9230;25015
260150;201612;3137;8601;2783;8103;212;701;2217;6375;2429;7076
260160;201612;5410;16931;4583;15736;228;1033;3751;12785;3979;13818
260170;201612;15791;43986;14773;42393;820;2648;12586;35615;13406;38263
260180;201612;3162;9564;2848;9083;178;583;2410;7659;2588;8242
260190;201612;15932;36735;14133;34287;378;981;12437;29679;12815;30660
260200;201612;10768;27442;9868;26219;351;1121;8829;23307;9180;24428
260210;201612;11389;34150;10010;31833;540;1869;8249;26166;8789;28035
260220;201612;9216;26066;8771;25406;357;1300;7754;22006;8111;23306
260230;201612;9519;26848;8585;25417;418;1414;7018;20609;7436;22023
260240;201612;2860;8432;2445;7809;274;957;1804;5744;2078;6701
260250;201612;2230;6135;1933;5678;122;370;1567;4536;1689;4906
260260;201612;11954;33837;10601;31713;1196;3737;7910;23581;9106;27318
260270;201612;3583;10321;3208;9696;219;927;2458;7067;2677;7994
260280;201612;12742;40915;11483;38877;672;2321;9634;32737;10306;35058
260290;201612;31512;93078;28952;88160;5278;16381;17649;53085;22927;69466
260300;201612;8576;26137;7306;23985;381;1588;5780;18814;6161;20402
260310;201612;4379;12867;3897;12067;977;2734;2259;7399;3236;10133
260320;201612;7304;22965;6545;21566;355;1356;5338;17422;5693;18778
260330;201612;2520;8083;2292;7603;89;367;1834;5911;1923;6278
260340;201612;1856;5388;1698;5127;37;129;1544;4626;1581;4755
260345;201612;21625;66399;19335;61594;5644;19019;6863;20741;12507;39760
260350;201612;4767;12736;4340;12094;149;534;3823;10465;3972;10999
260360;201612;2350;6698;1983;6028;117;473;1439;4211;1556;4684
260370;201612;5503;17060;4714;15525;351;1417;3462;11190;3813;12607
260380;201612;4775;15593;4247;14679;236;993;3199;10910;3435;11903
260390;201612;4188;13227;3498;11752;269;957;2521;8305;2790;9262
260392;201612;3465;11038;3109;10543;200;935;2580;8490;2780;9425
260400;201612;13571;37798;12527;35965;1471;4568;8859;24791;10330;29359
260410;201612;59077;167582;48908;149897;13743;43904;18122;56207;31865;100111
260415;201612;3621;11314;3020;9982;193;850;2080;6517;2273;7367
260420;201612;11919;27104;10408;25343;179;591;9583;23025;9762;23616
260430;201612;2836;9130;2408;8233;229;822;1614;5494;1843;6316
260440;201612;3198;9576;2746;8635;338;1154;1809;5487;2147;6641
260450;201612;4904;14114;4670;13767;172;540;4208;12440;4380;12980
260460;201612;5436;17228;4778;15825;857;3024;2607;8409;3464;11433
260470;201612;4489;13267;3972;12561;166;503;3482;11193;3648;11696
260480;201612;4043;11451;3392;10408;515;1659;2215;6802;2730;8461
260490;201612;4821;12569;4143;11362;188;585;3444;9201;3632;9786
260500;201612;5727;16336;4934;14947;776;2313;3162;9603;3938;11916
260510;201612;8670;22946;7985;21951;310;991;7080;19242;7390;20233
260515;201612;4670;13918;3405;11250;250;871;2201;7230;2451;8101
260520;201612;16011;41061;14895;39360;1559;4116;11562;30180;13121;34296
260530;201612;9295;28655;8069;26643;330;1356;6855;22456;7185;23812
260540;201612;5927;14692;5337;14010;791;1449;4085;11454;4876;12903
260545;201612;62;221;35;142;8;33;8;29;16;62
260550;201612;2612;8450;2079;7203;375;1378;933;3182;1308;4560
260560;201612;6071;16136;5319;14983;141;595;4697;12931;4838;13526
260570;201612;6737;21811;6058;20641;505;1950;4562;15374;5067;17324
260580;201612;3618;10024;3284;9418;97;346;2858;8018;2955;8364
260590;201612;6026;15087;5601;14561;285;747;4899;12723;5184;13470
260600;201612;28216;81137;24273;74126;1833;6522;18063;54138;19896;60660
260610;201612;5987;18172;5591;17423;519;1798;4112;12470;4631;14268
260620;201612;14998;45170;14029;43276;2181;7428;8903;26515;11084;33943
260630;201612;2173;6387;1890;5922;90;395;1565;4768;1655;5163
260640;201612;16672;45732;15309;43638;2161;6381;10313;29182;12474;35563
260650;201612;5372;16652;4641;15337;269;1024;3742;12339;4011;13363
260660;201612;7567;20998;6649;19707;450;1299;5509;16284;5959;17583
260670;201612;2262;6062;1822;5378;115;327;1328;3906;1443;4233
260680;201612;21012;59688;18304;54348;3521;10393;9298;27388;12819;37781
260690;201612;3649;9799;2894;8483;208;591;2250;6522;2458;7113
260700;201612;5755;17069;5584;16877;29;47;5484;16730;5513;16777
260710;201612;1308;3804;1220;3677;82;274;909;2777;991;3051
260720;201612;17355;54440;15791;51208;3186;10514;8737;28055;11923;38569
260730;201612;6587;21734;6073;20791;761;2724;4455;15071;5216;17795
260740;201612;1193;3589;1035;3281;69;258;833;2606;902;2864
260750;201612;6851;20358;5924;19115;261;820;5268;17213;5529;18033
260760;201612;4698;12575;4303;11988;186;604;3713;10282;3899;10886
260765;201612;7503;25118;6990;24184;916;3997;4746;15621;5662;19618
260770;201612;3712;9947;3243;9127;112;352;2637;7300;2749;7652
260775;201612;4812;14157;4421;13443;408;1488;3196;9357;3604;10845
260780;201612;3513;11314;3174;10594;667;2342;1572;5031;2239;7373
260790;201612;107280;269355;95671;249907;20045;52171;54075;139467;74120;191638
260795;201612;3010;8833;2592;8136;220;724;1883;5906;2103;6630
260800;201612;4849;12881;4472;12326;141;519;3973;10598;4114;11117
260805;201612;3682;10949;3021;9749;322;1185;2110;6627;2432;7812
260810;201612;6597;18295;6250;17770;366;1023;5302;14971;5668;15994
260820;201612;3936;11101;3318;10009;718;2165;1723;5118;2441;7283
260825;201612;2832;9009;2463;8349;165;630;1851;6238;2016;6868
260830;201612;3555;11462;3124;10550;471;1546;2033;6940;2504;8486
260840;201612;4163;11865;3641;11040;223;741;2963;8862;3186;9603
260845;201612;3922;11413;3704;10986;415;1265;2797;8304;3212;9569
260850;201612;4631;15166;3972;13583;740;2699;1877;6280;2617;8979
260860;201612;3593;10820;3010;9604;155;543;2328;7304;2483;7847
260870;201612;4092;11022;3529;10195;270;787;2843;8117;3113;8904
260875;201612;6179;17462;5285;15849;826;2422;3401;10247;4227;12669
260880;201612;9606;28645;8483;26675;540;1746;6822;21482;7362;23228
260890;201612;12621;36042;11396;33876;612;2076;8901;25977;9513;28053
260900;201612;5533;16983;4616;15082;333;1359;3065;9708;3398;11067
260910;201612;3031;8981;2596;8194;149;528;2007;6240;2156;6768
260915;201612;4534;15024;4193;14494;81;417;3845;13189;3926;13606
260920;201612;3129;9564;2849;9142;143;537;2333;7538;2476;8075
260930;201612;3817;12398;3288;11400;324;1137;2347;8128;2671;9265
260940;201612;13593;35821;12024;32987;1445;4293;8239;21892;9684;26185
260950;201612;6175;18918;5223;16822;785;2799;2709;8187;3494;10986
260960;201612;53338;146005;46679;134178;9401;27709;24500;69015;33901;96724
260970;201612;4803;14360;4322;13654;244;868;3391;10635;3635;11503
260980;201612;3906;12705;3605;12283;108;457;3219;10918;3327;11375
260990;201612;17092;51878;15223;49025;990;3633;12244;39133;13234;42766
261000;201612;15322;41423;12054;36026;2116;6534;6498;19770;8614;26304
261010;201612;2429;6741;2200;6458;113;252;1963;5882;2076;6134
261020;201612;6309;18101;5398;16408;537;1644;3994;11890;4531;13534
261030;201612;3672;11297;3154;10367;168;663;2526;8119;2694;8782
261040;201612;4992;15949;4114;14004;325;1243;2951;9784;3276;11027
261050;201612;7713;22447;7011;21069;915;2690;4624;13883;5539;16573
261060;201612;12120;34990;10943;32765;914;3124;8173;23754;9087;26878
261070;201612;51949;125625;44319;113653;5525;14153;30521;77299;36046;91452
261080;201612;5569;15909;5236;15381;316;814;4528;13499;4844;14313
261090;201612;16177;43981;14562;41540;1151;3171;11686;33420;12837;36591
261100;201612;8134;25258;6968;23063;1279;4255;4020;13504;5299;17759
261110;201612;59267;175280;50505;160459;13352;44455;21508;68901;34860;113356
261120;201612;3784;9886;3222;9148;72;261;2910;8220;2982;8481
261130;201612;6980;17785;6343;16952;144;465;5723;15102;5867;15567
261140;201612;3130;8694;2768;8076;364;1190;1754;4944;2118;6134
261150;201612;5253;14795;4752;13974;258;934;4045;11746;4303;12680
261153;201612;2029;6036;1684;5446;77;328;1234;3919;1311;4247
261160;201612;188618;493756;167152;457752;45986;127980;70622;194218;116608;322198
261170;201612;5542;14977;4968;14069;347;1000;3961;11177;4308;12177
261180;201612;9528;26263;8507;24599;1022;3119;5735;16235;6757;19354
261190;201612;4979;15339;4568;14765;415;1725;3291;10253;3706;11978
261200;201612;3506;8733;3077;8173;334;876;2408;6403;2742;7279
261210;201612;1833;4885;1679;4671;125;334;1448;4033;1573;4367
261220;201612;13268;40695;10672;35002;1571;5522;6011;19359;7582;24881
261230;201612;4525;14037;4042;13333;121;510;3470;11467;3591;11977
261240;201612;4713;13670;4245;12817;531;1448;3044;9296;3575;10744
261245;201612;3429;10484;2879;9437;128;567;2282;7206;2410;7773
261247;201612;3095;9488;2557;8425;275;929;1778;5927;2053;6856
261250;201612;18459;49070;16804;46619;3354;8872;10642;30516;13996;39388
261255;201612;3931;12199;3391;11163;200;852;2723;8651;2923;9503
261260;201612;12209;34118;10595;31921;526;1713;8946;26955;9472;28668
261270;201612;3624;10772;3177;9952;297;1032;2275;6914;2572;7946
261280;201612;2500;7519;2235;7045;91;359;1858;5708;1949;6067
261290;201612;2882;8198;2537;7679;147;536;2014;6029;2161;6565
261300;201612;10647;33712;8902;30301;1161;4463;5660;18696;6821;23159
261310;201612;6937;21320;6347;20154;1607;5139;3316;10503;4923;15642
261320;201612;5705;17462;5097;16288;182;704;4140;12974;4322;13678
261330;201612;5506;15281;5109;14709;297;1060;4346;12187;4643;13247
261340;201612;3751;12493;3452;11941;309;1334;2437;8234;2746;9568
261350;201612;7906;25610;7278;24434;200;1090;6062;19639;6262;20729
261360;201612;8054;21038;6944;19358;592;1685;5465;14894;6057;16579
261370;201612;18758;55329;17140;52363;3681;11507;9222;28094;12903;39601
261380;201612;4031;13628;3645;12737;545;2092;2285;7848;2830;9940
261390;201612;16008;48307;13925;44417;1969;6551;8520;27087;10489;33638
261400;201612;4541;15533;3920;14131;238;1033;2847;10072;3085;11105
261410;201612;8756;23925;7659;22126;614;1882;6065;17351;6679;19233
261420;201612;7212;24039;6788;23389;1430;5526;4068;13660;5498;19186
261430;201612;3363;10307;2851;9467;203;670;2237;7482;2440;8152
261440;201612;1523;4804;1336;4462;38;221;1051;3393;1089;3614
261450;201612;13809;39122;13079;38057;249;1056;11825;33916;12074;34972
261460;201612;6947;20326;6478;19640;359;1076;5614;17065;5973;18141
261470;201612;3971;10841;3568;10234;67;231;3110;8943;3177;9174
261480;201612;3745;13153;3341;12370;260;1047;2480;8965;2740;10012
261485;201612;4854;14813;4185;13559;564;2049;2620;8256;3184;10305
261500;201612;5288;14900;4615;13888;519;1450;3290;10151;3809;11601
261510;201612;1830;5865;1614;5470;107;396;1211;4102;1318;4498
261520;201612;2671;8599;2377;8004;130;507;1624;5626;1754;6133
261530;201612;11021;35422;9516;32168;2138;7713;4003;13312;6141;21025
261540;201612;6719;21723;6115;20546;1656;5482;3141;10831;4797;16313
261550;201612;3405;9475;3096;8973;266;896;2355;6627;2621;7523
261560;201612;7075;23071;6278;21875;732;2914;4557;15778;5289;18692
261570;201612;3333;9918;2779;8907;402;1324;1730;5485;2132;6809
261580;201612;5985;17943;5340;16843;275;1162;4529;14011;4804;15173
261590;201612;2378;6703;1977;6020;153;469;1461;4448;1614;4917
261600;201612;5139;13928;4278;12577;296;896;3303;9684;3599;10580
261610;201612;2405;6721;2062;6216;137;479;1656;4959;1793;5438
261618;201612;2422;6712;2145;6309;152;484;1641;4685;1793;5169
261620;201612;3883;12073;3568;11506;792;2472;2141;7111;2933;9583
261630;201612;7389;21557;5934;18618;714;2535;3514;10641;4228;13176
261640;201612;34222;84085;31806;81050;2085;4640;25932;68849;28017;73489
261650;201612;3726;10928;3329;10316;240;887;2534;7825;2774;8712
270010;201612;4220;15631;3795;14715;265;1297;2876;10951;3141;12248
270020;201612;3784;10571;3472;10086;309;1009;2769;7822;3078;8831
270030;201612;36312;108078;32723;101608;7301;22699;18057;56198;25358;78897
270040;201612;10423;31495;9444;30082;1584;5160;6124;19675;7708;24835
270050;201612;4405;11954;3929;11342;327;997;3253;9370;3580;10367
270060;201612;1860;5384;1689;5138;274;836;1124;3468;1398;4304
270070;201612;4304;13124;3871;12475;183;839;3286;10271;3469;11110
270080;201612;1260;3924;1047;3471;132;460;696;2239;828;2699
270090;201612;2046;6359;1831;5899;71;335;1480;4552;1551;4887
270100;201612;5566;16835;5125;16041;567;2034;3785;11540;4352;13574
270110;201612;2923;8234;2573;7812;330;995;1819;5749;2149;6744
270120;201612;3004;8384;2618;7860;101;392;2346;6954;2447;7346
270130;201612;5077;15194;4609;14627;611;2054;3440;11049;4051;13103
270135;201612;1761;4685;1554;4405;183;387;1287;3806;1470;4193
270140;201612;10301;24246;8502;21774;1028;3168;6517;15748;7545;18916
270150;201612;2623;8450;2544;8352;44;147;2461;8094;2505;8241
270160;201612;4866;16150;4441;15532;142;697;3863;13295;4005;13992
270170;201612;3626;11593;3268;11029;511;1986;2057;6695;2568;8681
270180;201612;2240;7282;2034;6960;69;363;1722;5726;1791;6089
270190;201612;1724;5601;1614;5436;75;291;1381;4660;1456;4951
270200;201612;2512;8284;2320;7987;189;818;1729;5753;1918;6571
270210;201612;4622;13558;4288;13068;235;961;3662;10912;3897;11873
270220;201612;1236;4041;1101;3771;214;808;623;2052;837;2860
270230;201612;10559;32621;8861;29607;1006;4026;5506;17584;6512;21610
270235;201612;6073;19584;5630;18832;317;1314;4627;15294;4944;16608
270240;201612;9044;27528;7455;25251;1844;6419;3572;12301;5416;18720
270250;201612;3105;8211;2782;7776;449;1189;2048;5796;2497;6985
270255;201612;4710;14334;3680;12333;233;940;2648;8610;2881;9550
270260;201612;5687;18198;5461;17853;334;1465;4645;14750;4979;16215
270270;201612;1143;3213;1020;3010;224;657;586;1699;810;2356
270280;201612;3438;9641;2876;8738;337;873;2069;6323;2406;7196
270290;201612;7695;26475;7090;25332;425;2053;5677;19741;6102;21794
270300;201612;3619;11351;3176;10754;327;1202;2355;7886;2682;9088
270310;201612;7323;21881;6317;20269;229;1192;5304;16421;5533;17613
270320;201612;5704;17561;5293;16828;868;2883;3529;11060;4397;13943
270330;201612;4126;14072;3816;13625;387;1459;2948;10596;3335;12055
270340;201612;1634;4978;1422;4671;189;608;1037;3367;1226;3975
270350;201612;1823;4904;1639;4669;145;449;1226;3466;1371;3915
270360;201612;2002;6106;1896;5979;164;485;1603;5152;1767;5637
270370;201612;1445;4739;1287;4439;93;394;942;3206;1035;3600
270375;201612;2851;7745;2493;7246;73;240;2237;6477;2310;6717
270380;201612;5698;17306;5175;16509;744;2122;3799;12532;4543;14654
270390;201612;1236;3400;1040;3078;53;181;809;2312;862;2493
270400;201612;6231;18524;5460;17271;305;1163;4080;12467;4385;13630
270410;201612;4700;14679;4183;13644;401;1386;2981;9546;3382;10932
270420;201612;5874;18404;5538;17890;233;1034;4541;14275;4774;15309
270430;201612;131036;374004;110412;340359;32415;103806;37028;117416;69443;221222
270440;201612;4516;13511;4031;12761;142;615;3369;10519;3511;11134
270450;201612;6213;18858;5836;18314;326;1274;4815;14782;5141;16056
270460;201612;3305;8702;2956;8242;98;346;2609;7104;2707;7450
270470;201612;9961;31608;8955;29863;1005;3801;6096;20131;7101;23932
270480;201612;2742;8357;2362;7638;312;1102;1581;4923;1893;6025
270490;201612;957;2992;857;2829;41;173;674;2183;715;2356
270500;201612;4783;16003;4431;15516;277;1179;3654;12669;3931;13848
270510;201612;5904;17177;5186;16097;605;2333;3884;11522;4489;13855
270520;201612;3446;10899;3055;10177;1012;3668;917;3144;1929;6812
270530;201612;1272;3967;1158;3770;102;341;833;2741;935;3082
270540;201612;1993;6533;1800;6224;93;498;1511;5021;1604;5519
270550;201612;6614;19568;5865;18533;727;2388;4215;13476;4942;15864
270560;201612;3092;9134;2813;8681;254;876;2108;6381;2362;7257
270570;201612;3707;11883;3313;11162;717;2118;2134;7436;2851;9554
270580;201612;2031;6145;1899;5965;125;395;1583;5027;1708;5422
270590;201612;1341;4393;1293;4317;7;31;1271;4246;1278;4277
270600;201612;2810;9182;2524;8659;136;648;2065;6898;2201;7546
270610;201612;3200;9787;2921;9341;143;524;2486;7833;2629;8357
270620;201612;1369;4500;1269;4315;82;318;1020;3378;1102;3696
270630;201612;15546;45562;13913;42771;1800;5613;9627;29957;11427;35570
270640;201612;5640;17169;4960;16031;287;1211;3980;12503;4267;13714
270642;201612;2276;7967;2098;7689;184;903;1608;5683;1792;6586
270644;201612;2733;7933;2327;7336;264;834;1730;5513;1994;6347
270650;201612;3620;11187;3376;10815;390;1835;2443;7234;2833;9069
270660;201612;2105;5429;1567;4601;150;384;1128;3330;1278;3714
270670;201612;16380;41393;13831;38335;1781;4729;10218;28893;11999;33622
270680;201612;4220;12175;3982;11887;96;281;3744;11215;3840;11496
270690;201612;9009;24677;7814;23201;2645;7343;3814;12227;6459;19570
270700;201612;575;1822;501;1684;63;271;336;1060;399;1331
270710;201612;5849;18441;5469;17896;370;1562;4525;14460;4895;16022
270720;201612;3343;11131;3009;10511;116;699;2531;8571;2647;9270
270730;201612;6311;17866;5889;17389;554;1662;4893;14611;5447;16273
270740;201612;2273;6486;2124;6254;179;605;1723;4983;1902;5588
270750;201612;5179;15624;4687;14787;636;2098;3334;10479;3970;12577
270760;201612;3399;10037;2995;9337;106;432;2460;7534;2566;7966
270770;201612;18415;48206;14979;43828;3119;8850;8601;26409;11720;35259
270780;201612;1760;5602;1645;5396;177;657;1224;3961;1401;4618
270790;201612;1558;4917;1414;4683;308;1095;800;2597;1108;3692
270800;201612;11045;32273;10109;30894;545;2197;8631;25723;9176;27920
270810;201612;3140;9586;2407;8155;288;1017;1515;5172;1803;6189
270820;201612;1739;5561;1508;5141;253;912;935;3167;1188;4079
270830;201612;5531;14537;4884;13709;349;930;4041;11670;4390;12600
270840;201612;7721;24588;7046;23612;304;1608;6099;19754;6403;21362
270850;201612;7273;22164;6852;21546;788;3141;5029;14842;5817;17983
270860;201612;10617;29565;8767;27081;1106;3799;5872;17670;6978;21469
270870;201612;2103;6376;1735;5591;224;773;1148;3628;1372;4401
270880;201612;8127;25665;7442;24561;432;1733;6054;19664;6486;21397
270890;201612;2402;7256;2197;6855;207;777;1635;4928;1842;5705
270895;201612;2852;10246;2711;10003;118;623;2358;8536;2476;9159
270900;201612;1769;4851;1470;4397;98;303;1115;3244;1213;3547
270910;201612;3483;11234;3131;10559;249;1005;2364;7754;2613;8759
270915;201612;9257;30510;8068;28245;1194;4722;4898;16610;6092;21332
270920;201612;6143;19143;5825;18650;250;1257;5108;15821;5358;17078
270930;201612;16049;43120;13369;39634;3177;8949;7595;23428;10772;32377
270940;201612;5455;17819;5021;17239;411;1770;3687;12267;4098;14037
280010;201612;629;1830;535;1650;49;204;362;1017;411;1221
280020;201612;4736;13388;3949;11973;676;2163;2496;7363;3172;9526
280030;201612;72042;186318;58239;164238;18119;52036;20320;58711;38439;110747
280040;201612;3064;9219;2681;8590;215;776;1998;6271;2213;7047
280050;201612;3625;11458;3260;10789;979;3382;1400;4638;2379;8020
280060;201612;4873;14939;3999;13335;839;2919;1956;6630;2795;9549
280067;201612;6882;19279;5846;17491;969;2850;3476;10467;4445;13317
280070;201612;1912;6159;1818;5999;199;683;1410;4631;1609;5314
280100;201612;3686;11285;3231;10450;469;1656;2154;6898;2623;8554
280110;201612;1370;4077;1228;3835;50;198;1045;3189;1095;3387
280120;201612;7640;23816;6864;22475;1064;3163;4705;15913;5769;19076
280130;201612;7383;20158;6615;18983;876;2679;4673;13311;5549;15990
280140;201612;5665;14964;5135;14147;375;1092;4138;11377;4513;12469
280150;201612;3360;9875;3061;9342;233;790;2375;7075;2608;7865
280160;201612;1313;3848;1099;3468;156;514;710;2175;866;2689
280170;201612;4716;13876;4200;13034;417;1274;3217;10067;3634;11341
280190;201612;1164;3034;978;2732;74;233;777;2095;851;2328
280200;201612;1149;3402;1001;3150;98;361;725;2192;823;2553
280210;201612;14025;40165;11980;36962;2820;9017;6228;19208;9048;28225
280220;201612;1591;4788;1447;4537;66;271;1210;3724;1276;3995
280230;201612;3090;9283;2751;8698;306;995;1879;5952;2185;6947
280240;201612;3379;9627;3024;9029;164;537;2471;7289;2635;7826
280250;201612;825;2162;640;1857;117;369;340;928;457;1297
280260;201612;2063;5404;1916;5213;49;158;1779;4830;1828;4988
280270;201612;2075;6466;1875;6123;104;386;1543;4943;1647;5329
280280;201612;4066;13225;3546;12256;857;2434;2007;7615;2864;10049
280290;201612;17296;51191;15090;47427;2704;8845;8792;27665;11496;36510
280300;201612;9638;28581;8860;27556;692;2374;6889;22153;7581;24527
280310;201612;1347;3744;1127;3341;44;183;858;2452;902;2635
280320;201612;8500;26472;7553;24741;1260;4401;4233;13566;5493;17967
280330;201612;4349;12377;3884;11545;418;1447;2863;8101;3281;9548
280340;201612;3750;10288;3482;9893;266;817;2849;8170;3115;8987
280350;201612;22055;60317;18853;55259;2770;8431;12363;36057;15133;44488
280360;201612;5522;17164;4938;16051;929;3231;2767;8780;3696;12011
280370;201612;1817;5028;1497;4457;172;426;1049;3163;1221;3589
280380;201612;1020;3119;909;2933;89;328;626;1934;715;2262
280390;201612;3053;8896;2509;7823;548;1687;1465;4589;2013;6276
280400;201612;4061;11327;3561;10512;1073;3074;1664;5098;2737;8172
280410;201612;2095;6632;1716;5817;274;989;960;3119;1234;4108
280420;201612;4145;11820;3751;11188;185;570;3218;9562;3403;10132
280430;201612;2202;5632;1942;5243;89;327;1528;3992;1617;4319
280440;201612;4605;13230;4113;12533;329;1019;3295;9903;3624;10922
280445;201612;2422;6607;2160;6118;66;212;1769;4874;1835;5086
280450;201612;9003;23557;8200;22436;586;1326;6905;19389;7491;20715
280460;201612;6668;17202;5960;16124;738;1968;4397;11982;5135;13950
280470;201612;1811;5377;1562;4906;136;407;1156;3641;1292;4048
280480;201612;32044;90039;29123;85305;4622;14389;19140;54829;23762;69218
280490;201612;3792;11260;3272;10360;180;695;2464;7596;2644;8291
280500;201612;902;2409;791;2248;47;128;649;1831;696;1959
280510;201612;2495;7298;2175;6803;176;604;1589;4908;1765;5512
280520;201612;1743;4674;1575;4448;136;361;1312;3712;1448;4073
280530;201612;2439;6467;2201;6156;125;368;1865;5206;1990;5574
280540;201612;9274;25215;8428;23910;258;920;7401;20501;7659;21421
280550;201612;6819;17430;5484;15311;532;1402;3876;10807;4408;12209
280560;201612;7412;21678;6931;20926;313;1088;5899;17500;6212;18588
280570;201612;6259;16872;5221;15339;537;1647;3594;10406;4131;12053
280580;201612;5341;16438;4477;14787;787;2473;2653;8983;3440;11456
280590;201612;2588;7157;2192;6582;366;1186;1332;3951;1698;5137
280600;201612;3413;10327;3097;9801;253;864;2381;7427;2634;8291
280610;201612;2378;6607;2116;6185;177;600;1561;4414;1738;5014
280620;201612;5238;14992;4464;13616;621;1686;3009;9597;3630;11283
280630;201612;3586;11603;3289;11097;283;962;2575;8820;2858;9782
280640;201612;2139;6409;2024;6278;73;228;1885;5860;1958;6088
280650;201612;1068;3302;951;3095;91;327;681;2167;772;2494
280660;201612;2652;7301;2491;7090;296;797;2024;5794;2320;6591
280670;201612;16302;41992;14578;39392;1969;5599;10065;26800;12034;32399
280680;201612;2800;7433;2361;6687;195;550;1824;5067;2019;5617
280690;201612;914;2581;797;2410;106;346;559;1655;665;2001
280700;201612;979;2961;871;2747;70;221;623;1936;693;2157
280710;201612;12108;30896;10778;29211;637;1359;9330;25972;9967;27331
280720;201612;2293;6029;2048;5711;229;646;1441;4177;1670;4823
280730;201612;900;2677;819;2546;70;278;651;1948;721;2226
280740;201612;13180;34901;10795;30786;1474;4024;7041;20210;8515;24234
280750;201612;3430;10320;3061;9639;302;987;2183;6875;2485;7862
280760;201612;5617;16833;4991;15792;933;3107;2860;9200;3793;12307
290010;201612;2764;6290;2005;5069;40;159;1646;3949;1686;4108
290020;201612;4266;14067;4108;13826;360;942;3401;11675;3761;12617
290030;201612;3173;9505;2925;9131;451;1372;2145;6717;2596;8089
290035;201612;4419;11280;3801;10371;187;646;2952;8221;3139;8867
290040;201612;4148;10815;3422;9949;201;712;2679;7688;2880;8400
290050;201612;2381;7726;2037;7062;142;574;1488;5055;1630;5629
290060;201612;1257;3219;1021;2887;117;406;770;2068;887;2474
290070;201612;32635;80833;26975;72770;5347;14094;14286;39875;19633;53969
290080;201612;5881;17427;4853;15878;711;2394;3266;10812;3977;13206
290090;201612;1978;4387;1579;3929;107;254;1384;3468;1491;3722
290100;201612;8926;25644;7779;23704;1114;3355;4892;15241;6006;18596
290110;201612;4732;13857;4375;13183;767;2312;2716;8068;3483;10380
290115;201612;4535;13684;4030;12995;209;622;3386;11140;3595;11762
290120;201612;6692;17319;5424;15732;252;874;4389;12491;4641;13365
290130;201612;4594;11899;3657;10638;147;542;2959;8345;3106;8887
290135;201612;4526;11067;3655;9617;336;934;2681;6776;3017;7710
290140;201612;4320;12850;3624;11890;204;810;3011;9834;3215;10644
290150;201612;2159;6414;2013;6142;234;750;1527;4567;1761;5317
290160;201612;3394;8449;3173;8137;311;652;2579;6680;2890;7332
290170;201612;2599;8372;2409;8091;134;577;2069;6812;2203;7389
290180;201612;2863;8260;2391;7481;126;463;1872;5787;1998;6250
290190;201612;3731;12247;3506;11863;183;750;2739;9136;2922;9886
290195;201612;2150;5758;1729;5061;52;236;1469;4186;1521;4422
290200;201612;3801;11688;3264;10791;223;770;2605;8538;2828;9308
290205;201612;3274;9227;2813;8420;201;743;2142;6195;2343;6938
290210;201612;14469;40919;12794;38565;1972;5392;8855;28117;10827;33509
290220;201612;2285;6692;2110;6387;113;476;1734;5074;1847;5550
290225;201612;2877;7014;2532;6599;117;341;2293;5922;2410;6263
290230;201612;2230;7092;2075;6881;99;395;1749;5767;1848;6162
290240;201612;3508;9559;3096;8865;209;665;2472;6907;2681;7572
290250;201612;3756;11618;3476;11228;114;312;3013;10163;3127;10475
290260;201612;5131;14219;4162;12701;356;1143;3167;9616;3523;10759
290265;201612;3395;10411;2878;9390;143;607;2253;7220;2396;7827
290270;201612;11850;42562;11162;41297;1222;4931;8235;30319;9457;35250
290280;201612;5416;17167;4808;16028;507;1757;3558;11776;4065;13533
290290;201612;9634;29759;8318;27429;1158;3754;5645;18799;6803;22553
290300;201612;4490;12642;3127;9957;202;663;2219;7141;2421;7804
290310;201612;1430;4246;1189;3826;176;599;707;2243;883;2842
290320;201612;28270;78707;23249;71805;5233;16987;11657;36670;16890;53657
290323;201612;3696;10170;3292;9627;131;385;2768;8026;2899;8411
290327;201612;4397;13100;3658;11668;491;1588;2350;7479;2841;9067
290330;201612;1823;4389;1663;4207;90;240;1487;3788;1577;4028
290340;201612;5082;15210;4589;14561;1262;4042;2595;8291;3857;12333
290350;201612;4163;12880;3570;11859;315;1040;2590;8691;2905;9731
290360;201612;4533;13517;3850;12513;134;518;3229;10532;3363;11050
290370;201612;4671;12672;3873;11506;287;816;3145;9400;3432;10216
290380;201612;5472;15827;4716;14605;267;880;3722;11693;3989;12573
290390;201612;14796;44095;12807;40911;1864;6004;8153;26572;10017;32576
290395;201612;2560;8307;2264;7719;97;475;1752;5902;1849;6377
290400;201612;3649;10465;2937;9256;224;712;2141;6623;2365;7335
290405;201612;4656;14496;3761;12681;467;1527;2374;8141;2841;9668
290410;201612;5783;16976;4598;14915;334;1316;3314;10362;3648;11678
290420;201612;3199;9123;2570;8122;232;739;1951;6152;2183;6891
290430;201612;3117;9555;2653;8659;464;1527;1600;5279;2064;6806
290440;201612;2964;7683;2281;6660;118;382;1766;5181;1884;5563
290450;201612;3166;9168;2604;8234;170;689;1966;6024;2136;6713
290460;201612;12304;35368;10576;32099;3344;10203;3500;10584;6844;20787
290470;201612;4072;11442;3045;9727;633;2197;1448;4700;2081;6897
290475;201612;5580;17538;4770;15899;176;878;3855;12415;4031;13293
290480;201612;2359;6419;2211;6200;209;592;1587;4705;1796;5297
290485;201612;4683;14771;4043;13765;215;1076;3305;11004;3520;12080
290490;201612;8204;21138;7612;20295;554;1634;6320;16511;6874;18145
290500;201612;3962;12384;3104;10520;497;1759;1631;5435;2128;7194
290510;201612;3139;8945;2748;8367;134;465;2295;6910;2429;7375
290515;201612;3506;9782;2866;8899;205;619;2357;7426;2562;8045
290520;201612;11164;34267;8598;28847;829;2911;5351;17645;6180;20556
290530;201612;4952;14685;4285;13549;288;876;3436;10848;3724;11724
290540;201612;3644;10554;3337;10012;226;697;2665;7917;2891;8614
290550;201612;4416;11479;3886;10824;71;244;3634;10075;3705;10319
290560;201612;6270;17817;5370;16415;1230;3614;3170;9866;4400;13480
290570;201612;41526;111757;37221;105324;4021;11014;27060;76296;31081;87310
290580;201612;6878;22914;6333;21954;626;2343;4807;16727;5433;19070
290590;201612;7157;22638;6095;20658;216;903;5044;16980;5260;17883
290600;201612;17407;51622;15813;49187;1849;5492;11888;37788;13737;43280
290610;201612;2405;8054;1895;6956;110;516;1371;4871;1481;5387
290620;201612;6055;18368;5449;17302;297;968;4533;14251;4830;15219
290630;201612;8158;20781;6967;19336;493;1410;5884;16319;6377;17729
290640;201612;2593;7423;2063;6507;114;430;1615;4976;1729;5406
290650;201612;10613;30500;9874;29329;2301;6687;5733;17509;8034;24196
290660;201612;3555;9769;2957;8822;100;330;2256;6943;2356;7273
290670;201612;6884;20730;5929;19031;599;1976;4221;13567;4820;15543
290680;201612;9905;29646;8625;27708;345;1559;7093;22181;7438;23740
290682;201612;4627;12968;3982;11982;164;634;3379;9974;3543;10608
290685;201612;3631;8567;2326;6647;278;806;1483;4318;1761;5124
290687;201612;6999;20253;5435;17516;1259;4026;2565;8595;3824;12621
290689;201612;3045;8758;2656;8140;259;856;1941;6093;2200;6949
290690;201612;5404;15129;4588;13927;701;2083;2985;9075;3686;11158
290700;201612;2366;7127;2168;6804;133;423;1739;5468;1872;5891
290710;201612;7590;23784;6927;22687;512;1574;5617;18546;6129;20120
290720;201612;18221;52813;16636;50604;1256;3463;13705;42561;14961;46024
290730;201612;6950;18962;6117;17738;601;1653;4485;13003;5086;14656
290740;201612;899;2617;685;2234;47;174;518;1654;565;1828
290750;201612;10302;28125;8535;24702;1332;4127;5034;14018;6366;18145
290755;201612;2282;6477;1736;5419;111;377;1240;3799;1351;4176
290760;201612;4048;12239;3165;10470;475;1374;1843;6335;2318;7709
290770;201612;2506;8632;2302;8310;89;428;1891;6785;1980;7213
290780;201612;8902;22207;7538;20131;789;1598;5724;15879;6513;17477
290790;201612;4372;12804;3971;12224;208;594;3434;10597;3642;11191
290800;201612;6883;14610;5302;12800;368;702;4269;10702;4637;11404
290810;201612;5335;15972;4343;14263;154;562;3328;10896;3482;11458
290820;201612;5262;14749;4673;13867;380;1264;3553;10519;3933;11783
290830;201612;4340;11241;3891;10552;164;534;3022;7989;3186;8523
290840;201612;16885;48013;14579;44261;2210;6421;9256;29161;11466;35582
290850;201612;5961;16957;5562;16384;805;2099;4053;12361;4858;14460
290860;201612;5080;16837;4635;16230;416;1479;3670;13098;4086;14577
290870;201612;4675;13545;3669;11796;191;752;2631;8332;2822;9084
290880;201612;1398;3733;1080;3204;106;296;756;2274;862;2570
290890;201612;6996;17711;5925;16483;482;1118;4964;14119;5446;15237
290900;201612;2267;6462;1683;5339;216;708;966;3035;1182;3743
290910;201612;4689;12266;3738;10787;70;280;3233;9122;3303;9402
290920;201612;4853;13042;4419;12420;201;572;3807;10642;4008;11214
290930;201612;8087;23819;6785;21667;241;1128;5492;17083;5733;18211
290940;201612;3519;10935;2937;9946;90;329;2370;8074;2460;8403
290950;201612;1535;4201;1295;3795;126;362;898;2654;1024;3016
290960;201612;5585;15624;5000;14830;124;441;4293;12738;4417;13179
290970;201612;3657;11119;3077;10117;228;748;2166;7135;2394;7883
290980;201612;10260;28926;8249;24978;2408;7329;2347;7096;4755;14425
290990;201612;8787;25992;7396;23519;649;2281;5544;17212;6193;19493
291000;201612;3066;8843;2702;8377;138;483;2362;7251;2500;7734
291005;201612;14374;36599;12408;33880;1210;3315;9295;25598;10505;28913
291010;201612;3202;9782;2443;8129;214;716;1630;5432;1844;6148
291020;201612;1189;3173;912;2642;81;230;551;1499;632;1729
291030;201612;2298;6133;1565;4627;126;397;1004;2845;1130;3242
291040;201612;5549;16294;4736;14966;261;1091;3760;11693;4021;12784
291050;201612;7558;24145;6730;22531;1658;5860;3509;11492;5167;17352
291060;201612;5900;21415;5434;20542;867;3611;3432;12692;4299;16303
291070;201612;15714;44710;13396;41027;728;2617;10624;32060;11352;34677
291072;201612;22858;66571;17369;55104;4273;14362;5993;18921;10266;33283
291075;201612;4890;13735;4222;12611;256;673;3261;9798;3517;10471
291077;201612;1377;3952;1097;3433;70;237;783;2424;853;2661
291080;201612;75026;232489;63163;206990;23203;75991;10273;33514;33476;109505
291085;201612;5563;14600;4679;13316;342;1018;3839;10919;4181;11937
291090;201612;1678;3771;1440;3465;90;155;1264;3082;1354;3237
291100;201612;2551;6442;1980;5746;103;389;1547;4347;1650;4736
291110;201612;5132;17542;4535;16535;572;2305;3234;11486;3806;13791
291120;201612;7058;18908;6333;17729;682;1911;4641;12949;5323;14860
291125;201612;1784;3605;1368;3148;63;197;1156;2608;1219;2805
291130;201612;2790;8719;2249;7626;79;374;1742;5736;1821;6110
291140;201612;4134;12176;3352;10602;535;1513;2064;6627;2599;8140
291150;201612;1996;4983;1785;4706;67;222;1494;3819;1561;4041
291160;201612;4899;15589;4257;14360;717;2560;2419;7983;3136;10543
291165;201612;2475;6883;1870;5719;34;150;1378;4084;1412;4234
291170;201612;20421;54075;16746;47910;1618;4936;10741;30454;12359;35390
291180;201612;5925;15573;4764;13606;453;1202;3441;9923;3894;11125
291185;201612;3480;9525;3041;8775;138;401;2526;7197;2664;7598
291190;201612;7225;19193;6158;17582;339;1265;5178;14402;5517;15667
291200;201612;2851;8423;2121;6904;124;410;1421;4659;1545;5069
291210;201612;6591;16021;5460;14509;209;694;4338;11343;4547;12037
291220;201612;4198;12781;3758;12010;497;1833;2501;7721;2998;9554
291230;201612;3908;9762;3501;9298;77;152;3322;8897;3399;9049
291240;201612;4363;11739;3738;10576;113;346;3147;8727;3260;9073
291250;201612;3334;10275;2600;8804;244;807;1752;5983;1996;6790
291260;201612;1036;2969;929;2824;44;215;791;2298;835;2513
291270;201612;4599;14426;3975;13210;1302;4400;1889;6286;3191;10686
291280;201612;2093;6076;1639;5246;318;1101;830;2565;1148;3666
291290;201612;5498;15286;4572;13921;705;2085;2835;8791;3540;10876
291300;201612;4107;11723;3031;9734;162;580;2256;7107;2418;7687
291310;201612;5316;14970;4514;13450;252;768;3549;10496;3801;11264
291320;201612;5872;18166;4570;15496;1204;4003;1995;6965;3199;10968
291330;201612;1556;4652;1331;4240;84;298;964;2998;1048;3296
291340;201612;3784;10424;3081;9318;157;381;2513;7609;2670;7990
291345;201612;3277;10345;3012;9977;204;631;2472;8348;2676;8979
291350;201612;5606;16389;4803;14955;257;862;3776;11829;4033;12691
291360;201612;31939;85790;26563;77603;6887;19860;13453;40201;20340;60061
291370;201612;8101;22977;7524;22138;725;2060;5630;16659;6355;18719
291380;201612;3629;10764;3086;9845;157;588;2399;7624;2556;8212
291390;201612;10207;27000;9217;25640;943;2648;7226;20003;8169;22651
291400;201612;14080;38062;12013;34802;2307;6019;7427;22694;9734;28713
291410;201612;2981;8018;2236;6691;98;441;1700;4859;1798;5300
291420;201612;1990;5349;1662;4903;62;236;1411;4105;1473;4341
291430;201612;3204;9121;2753;8430;162;654;2210;6514;2372;7168
291440;201612;6254;18914;5340;17236;542;1774;3987;12924;4529;14698
291450;201612;8295;23584;7048;21760;272;795;5782;18539;6054;19334
291460;201612;12974;38820;11440;36262;1501;5079;7423;23577;8924;28656
291465;201612;7784;22099;6680;20688;358;1518;5513;16639;5871;18157
291470;201612;15277;40507;13172;37800;805;2239;10135;29784;10940;32023
291480;201612;34728;86175;26785;74192;4931;13848;14556;40193;19487;54041
291490;201612;4158;13161;3797;12594;629;2073;2488;8331;3117;10404
291500;201612;4197;11886;3440;10637;160;624;2835;8616;2995;9240
291510;201612;3679;10841;3277;10252;63;251;2878;9035;2941;9286
291520;201612;3731;10062;3060;9054;636;1864;1805;5353;2441;7217
291530;201612;2056;5532;1557;4747;348;1054;822;2662;1170;3716
291535;201612;3550;10876;3232;10317;199;647;2530;8109;2729;8756
291540;201612;1982;4787;1667;4450;120;225;1467;3998;1587;4223
291550;201612;5032;13102;4231;11882;731;1861;2583;7391;3314;9252
291560;201612;17926;42212;12058;34748;779;2270;8959;26373;9738;28643
291570;201612;2170;5615;1908;5269;182;363;1573;4537;1755;4900
291580;201612;5206;15647;4492;14533;403;1611;3312;10514;3715;12125
291590;201612;1718;5345;1515;4987;155;544;1140;3763;1295;4307
291600;201612;5101;13949;3711;11525;939;3067;1616;4836;2555;7903
291610;201612;4728;14891;4548;14671;120;419;4203;13621;4323;14040
291620;201612;2996;6944;2110;5924;121;380;1704;4792;1825;5172
291630;201612;3018;7306;2443;6584;282;701;1851;5084;2133;5785
291640;201612;15831;43210;11728;36260;3114;9812;3080;10046;6194;19858
291650;201612;8134;23527;7418;22580;662;1639;6051;18875;6713;20514
291660;201612;2157;5572;1601;4660;140;472;1036;2796;1176;3268
291670;201612;1822;5010;1613;4704;94;257;1294;3830;1388;4087
291680;201612;3759;10841;3178;9782;486;1619;2011;6095;2497;7714
291685;201612;4780;11958;3838;10652;575;1460;2536;7296;3111;8756
291690;201612;3653;9820;2779;8251;201;568;1973;5747;2174;6315
291700;201612;8864;27356;7773;25315;832;2593;5741;18892;6573;21485
291710;201612;5096;13190;3952;11547;264;788;2913;8388;3177;9176
291720;201612;4552;14455;3670;12526;324;1213;2637;8729;2961;9942
291730;201612;6062;17584;5400;16627;480;1532;4229;13099;4709;14631
291733;201612;2721;7656;2113;6717;205;681;1409;4497;1614;5178
291735;201612;2921;7981;2442;7242;100;341;2044;5984;2144;6325
291740;201612;3672;10370;3028;9409;182;614;2480;7656;2662;8270
291750;201612;20858;53777;15925;45602;3635;10367;7745;22803;11380;33170
291760;201612;10382;32953;8699;29767;3563;13326;1830;6188;5393;19514
291770;201612;7394;21205;5985;18503;868;2702;3782;11436;4650;14138
291780;201612;4369;13033;3998;12384;156;526;3446;10593;3602;11119
291790;201612;2648;7917;2472;7625;77;290;2120;6420;2197;6710
291800;201612;29387;78728;25058;72383;3694;10478;16073;47357;19767;57835
291810;201612;10523;27979;8713;25585;490;1479;7105;20765;7595;22244
291820;201612;3704;10823;3231;10056;194;663;2482;7707;2676;8370
291830;201612;4054;10727;3665;10112;280;779;2946;8157;3226;8936
291835;201612;6121;19144;4771;16370;1554;5454;2119;7403;3673;12857
291840;201612;46644;130525;39862;121801;6108;18123;26788;84339;32896;102462
291845;201612;2532;7337;2350;7080;137;372;2046;6255;2183;6627
291850;201612;4385;12658;3536;11204;331;897;2581;8473;2912;9370
291855;201612;1816;4314;1525;3909;108;380;1216;2986;1324;3366
291860;201612;2152;5970;1519;4624;381;1273;736;2031;1117;3304
291870;201612;1359;3648;906;2770;67;251;587;1688;654;1939
291875;201612;2766;8554;2424;7980;88;342;1771;5677;1859;6019
291880;201612;4918;15677;4378;14488;513;1696;3082;10161;3595;11857
291890;201612;1261;3175;972;2775;216;519;613;1819;829;2338
291900;201612;1237;3279;936;2743;53;184;721;2069;774;2253
291905;201612;2603;7080;1834;5552;80;254;1371;4017;1451;4271
291910;201612;2714;7237;2263;6656;108;415;1917;5560;2025;5975
291915;201612;6856;20938;5628;18621;702;2432;3942;13048;4644;15480
291920;201612;24049;71621;21762;67958;2873;9688;14161;43549;17034;53237
291930;201612;2523;7436;2166;6784;183;670;1555;4706;1738;5376
291940;201612;3262;9128;2296;7331;310;1002;1348;4203;1658;5205
291950;201612;8453;27743;7357;25480;1380;4740;4052;14403;5432;19143
291955;201612;10968;30752;9774;29030;2471;7285;4937;15463;7408;22748
291960;201612;3030;8851;2435;7900;200;650;1821;6079;2021;6729
291970;201612;3827;11629;3449;10925;294;1061;2370;7461;2664;8522
291980;201612;11346;32353;8718;28356;950;3097;5981;19713;6931;22810
291990;201612;2063;6213;1907;6008;61;221;1689;5354;1750;5575
291992;201612;2854;8526;2754;8339;385;1082;2063;6310;2448;7392
291995;201612;2057;5808;1711;5291;66;250;1434;4339;1500;4589
292000;201612;2325;6487;2019;5994;164;537;1474;4405;1638;4942
292010;201612;5945;14922;4827;13258;492;1231;3547;9987;4039;11218
292020;201612;3964;13416;3670;12872;465;1755;2718;9419;3183;11174
292030;201612;1794;5806;1596;5407;312;1079;796;2599;1108;3678
292040;201612;4313;11455;3607;10642;190;401;3115;9552;3305;9953
292045;201612;3297;10030;2924;9500;132;387;2614;8523;2746;8910
292050;201612;6274;18892;4995;16147;559;1933;3172;10081;3731;12014
292060;201612;12522;30889;11350;29307;843;1905;9415;24214;10258;26119
292070;201612;4836;14535;4392;13950;523;1516;3450;11118;3973;12634
292080;201612;3389;8797;2733;7924;180;603;2315;6671;2495;7274
292090;201612;3945;10010;3237;9122;251;834;2634;7383;2885;8217
292100;201612;10356;27978;8652;25267;1982;5887;4239;12702;6221;18589
292105;201612;2948;9020;2611;8425;84;392;2137;6819;2221;7211
292110;201612;6251;16687;4593;13842;1445;4212;1909;5889;3354;10101
292120;201612;7048;19675;5678;17031;1058;3072;3204;9792;4262;12864
292130;201612;2742;7638;2300;6947;428;1143;1359;4331;1787;5474
292140;201612;4696;12416;3803;10992;595;1569;2607;7692;3202;9261
292145;201612;2259;6965;1954;6413;227;710;1375;4616;1602;5326
292150;201612;12459;37431;11442;35706;360;1420;9742;30045;10102;31465
292160;201612;2258;6700;2047;6404;76;315;1825;5612;1901;5927
292170;201612;8415;23895;6793;20929;836;2695;4402;13455;5238;16150
292180;201612;2975;8466;2202;7067;485;1439;1098;3637;1583;5076
292190;201612;3139;8972;2528;7870;488;1592;1317;4103;1805;5695
292200;201612;6635;19852;5403;17589;1530;5138;2018;6670;3548;11808
292205;201612;3716;11182;3262;10431;150;634;2726;8460;2876;9094
292210;201612;6266;16248;5238;14827;203;714;4537;12693;4740;13407
292220;201612;1780;4870;1566;4511;392;1068;823;2378;1215;3446
292225;201612;3144;9734;2821;9195;144;637;2333;7450;2477;8087
292230;201612;6742;18728;6203;17804;220;926;5084;14021;5304;14947
292240;201612;4797;14386;4029;12719;372;1177;2827;8813;3199;9990
292250;201612;4983;15068;4503;14154;937;2978;2408;7632;3345;10610
292260;201612;3158;9061;2870;8638;184;499;2422;7380;2606;7879
292265;201612;3157;9430;2639;8491;100;463;2075;6462;2175;6925
292270;201612;3944;9979;3264;9163;198;549;2727;7720;2925;8269
292273;201612;2393;5732;1979;5178;126;264;1600;4311;1726;4575
292275;201612;1644;5032;1457;4748;164;393;1142;3952;1306;4345
292280;201612;2201;5984;1878;5562;152;363;1476;4587;1628;4950
292285;201612;2365;6377;1920;5693;91;311;1536;4485;1627;4796
292290;201612;6012;19107;5295;17907;343;1411;4127;13844;4470;15255
292300;201612;8115;23958;6832;22217;1983;6621;3359;11122;5342;17743
292303;201612;2816;8457;2509;7991;70;271;2183;6858;2253;7129
292305;201612;2781;7514;2587;7208;52;212;2354;6460;2406;6672
292310;201612;5900;17189;5367;16346;143;554;4460;13376;4603;13930
292320;201612;6682;18289;5482;16162;404;1216;4216;12292;4620;13508
292330;201612;2182;5708;1966;5379;138;421;1617;4346;1755;4767
292335;201612;4951;13030;4380;12191;349;901;3579;10057;3928;10958
292340;201612;6375;17487;5226;15498;295;863;4032;11842;4327;12705
292350;201612;2258;6546;1899;6005;102;399;1564;4909;1666;5308
292360;201612;5244;13393;4719;12466;293;696;3796;10284;4089;10980
292370;201612;8465;23299;7216;21493;542;1302;5852;17648;6394;18950
292380;201612;7026;20782;6311;19518;682;1882;4745;14847;5427;16729
292390;201612;3554;7830;2829;6995;525;677;2139;5900;2664;6577
292400;201612;20148;61752;18077;58034;2924;9303;11685;37462;14609;46765
292405;201612;4389;10890;3517;9675;181;421;2856;7902;3037;8323
292410;201612;1992;5248;1770;4948;147;367;1460;4118;1607;4485
292420;201612;3682;11822;3428;11396;206;921;2760;9006;2966;9927
292430;201612;5397;15741;3881;13385;333;1229;2572;8866;2905;10095
292440;201612;8368;27526;7733;26547;142;639;7082;24398;7224;25037
292450;201612;3858;11573;3093;10187;283;933;2201;7259;2484;8192
292460;201612;4409;13317;3761;12122;388;1322;2685;8568;3073;9890
292465;201612;2277;6780;1840;6018;153;542;1231;4053;1384;4595
292467;201612;1783;5698;1682;5530;321;1061;1090;3669;1411;4730
292470;201612;2833;7464;2271;6488;108;288;1800;5149;1908;5437
292480;201612;6241;16031;5147;14531;126;421;4643;12919;4769;13340
292490;201612;2350;6325;1872;5596;127;393;1424;4231;1551;4624
292500;201612;6344;18805;5339;16897;627;2023;3548;11270;4175;13293
292510;201612;12389;35558;10189;31896;899;3122;7494;23327;8393;26449
292520;201612;5483;15231;4586;13786;951;2867;2622;7941;3573;10808
292525;201612;5198;13535;4422;12602;118;382;3858;10989;3976;11371
292530;201612;26328;74977;22357;68737;5736;17676;10614;33438;16350;51114
292540;201612;2916;7673;2533;7178;312;836;1936;5559;2248;6395
292550;201612;6595;19943;5450;18316;590;2144;4101;13889;4691;16033
292560;201612;3950;11035;3425;10168;181;706;2668;7743;2849;8449
292570;201612;4154;11435;3687;10855;85;253;3439;10207;3524;10460
292575;201612;6293;20408;5992;19885;377;1253;5069;16903;5446;18156
292580;201612;6517;19322;6000;18520;265;917;5176;15848;5441;16765
292590;201612;7452;20990;6894;20135;341;1063;5905;16954;6246;18017
292593;201612;2855;7431;2391;6650;311;803;1699;4698;2010;5501
292595;201612;5695;15595;4955;14537;278;884;4006;11644;4284;12528
292600;201612;10622;29999;9265;27992;868;2138;7079;22012;7947;24150
292610;201612;4568;12532;3662;10973;228;662;2388;7394;2616;8056
292620;201612;6143;18221;5384;17311;102;318;5037;16339;5139;16657
292630;201612;8792;22376;7091;19554;1047;2596;4630;13072;5677;15668
292640;201612;7546;24321;6830;23008;323;1276;5286;17746;5609;19022
292650;201612;4371;11907;4043;11458;264;737;3416;9616;3680;10353
292660;201612;10792;31855;9680;30143;1092;3363;7177;22568;8269;25931
292665;201612;2206;7004;2044;6780;27;82;1883;6307;1910;6389
292670;201612;3529;9900;2660;8222;352;1085;1611;4974;1963;6059
292680;201612;3677;10667;3159;9664;361;1018;2248;6828;2609;7846
292690;201612;2687;7340;1905;6013;153;456;1308;4227;1461;4683
292700;201612;9451;27527;7986;25263;1258;3556;4945;16549;6203;20105
292710;201612;2116;6972;1974;6772;66;252;1740;5982;1806;6234
292720;201612;9137;23023;7842;21501;257;828;6748;18641;7005;19469
292730;201612;3600;10642;3402;10311;188;593;2779;8356;2967;8949
292740;201612;323068;856462;293559;806049;55574;157835;174039;469026;229613;626861
292750;201612;6412;17271;5347;15607;233;766;4341;12612;4574;13378
292760;201612;3859;11900;3399;11013;357;1196;2411;7740;2768;8936
292770;201612;5836;16932;4955;15539;896;2916;2950;9451;3846;12367
292780;201612;1793;4118;1347;3518;146;289;965;2576;1111;2865
292790;201612;3394;8043;3244;7885;49;78;3148;7713;3197;7791
292800;201612;9134;26451;8234;24830;514;1594;6572;19680;7086;21274
292805;201612;2882;8067;2456;7401;228;701;1856;5595;2084;6296
292810;201612;9342;27227;7272;23952;813;2647;4978;16623;5791;19270
292820;201612;7350;20720;5334;17602;389;1525;4124;13376;4513;14901
292830;201612;1609;4781;1443;4511;50;218;1256;3848;1306;4066
292840;201612;8039;23738;7592;23053;282;998;6735;20117;7017;21115
292850;201612;3066;8132;2349;6919;272;804;1500;4323;1772;5127
292860;201612;15052;38154;13478;35941;879;2322;10881;28861;11760;31183
292870;201612;18342;49920;15465;44966;1751;5567;9335;26337;11086;31904
292880;201612;11747;33274;10295;30984;638;2392;7727;22340;8365;24732
292890;201612;5265;17311;4599;16034;565;2049;3128;10883;3693;12932
292895;201612;2732;6591;2009;5416;221;588;1397;3753;1618;4341
292900;201612;2682;8102;2509;7792;129;573;1955;5789;2084;6362
292905;201612;4035;11754;3065;10089;352;1072;2046;6834;2398;7906
292910;201612;4888;14288;4260;13081;612;1861;2534;7793;3146;9654
292920;201612;9287;26738;8716;25847;413;1537;7377;21229;7790;22766
292925;201612;4973;14954;4476;14145;305;962;3570;11263;3875;12225
292930;201612;6389;20129;5745;18828;366;1582;4112;12968;4478;14550
292935;201612;1892;5678;1580;5301;68;309;1367;4632;1435;4941
292937;201612;2978;7710;2552;7152;133;374;2136;5992;2269;6366
292940;201612;3033;8397;2453;7496;198;628;1792;5562;1990;6190
292950;201612;8081;23197;7268;21701;410;1408;5578;16274;5988;17682
292960;201612;5122;12965;4306;11802;213;629;3340;9024;3553;9653
292970;201612;4180;12294;3614;11482;126;608;3020;9460;3146;10068
292975;201612;3604;9258;3298;8842;352;802;2743;7466;3095;8268
292980;201612;3060;8094;2400;7032;180;590;1817;5183;1997;5773
292990;201612;11535;32569;9644;29465;411;1361;7918;23950;8329;25311
293000;201612;2803;7104;2453;6601;40;139;1921;5429;1961;5568
293010;201612;17294;47505;14053;41793;2307;6794;8347;24715;10654;31509
293015;201612;7315;24751;6163;22334;656;2708;4119;14733;4775;17441
293020;201612;8690;28881;8248;28163;228;1056;7305;24671;7533;25727
293030;201612;5483;15580;4111;13247;518;1531;2683;8993;3201;10524
293040;201612;3709;11849;3481;11403;193;620;3028;9927;3221;10547
293050;201612;20392;55663;17321;51195;3612;10658;8757;26895;12369;37553
293060;201612;3498;9403;2821;8219;215;673;2080;5961;2295;6634
293070;201612;23840;63116;18331;54695;4299;12560;8265;25809;12564;38369
293075;201612;3168;10744;2890;10250;181;833;2290;8056;2471;8889
293076;201612;3636;9887;3155;9179;146;395;2595;7666;2741;8061
293077;201612;4936;15051;4183;13877;800;2711;2502;8466;3302;11177
293080;201612;4482;14027;3954;13095;152;753;3304;10678;3456;11431
293090;201612;3082;9815;2508;8819;196;703;1802;6387;1998;7090
293100;201612;5720;16534;4597;14456;591;1829;3202;10130;3793;11959
293105;201612;3894;12681;3363;11620;445;1522;2208;7708;2653;9230
293110;201612;1990;5546;1682;5060;71;228;1354;4053;1425;4281
293120;201612;3654;11797;3426;11411;238;748;2809;9419;3047;10167
293130;201612;3645;10717;3268;10213;120;462;2898;9003;3018;9465
293135;201612;30582;76588;21737;62968;5492;17116;7482;21483;12974;38599
293140;201612;1942;5331;1797;5097;108;399;1482;4030;1590;4429
293150;201612;5333;17420;4399;15500;647;2279;2750;9784;3397;12063
293160;201612;3654;9274;3191;8673;434;857;2432;7069;2866;7926
293170;201612;3325;9617;2941;8962;241;825;2115;6396;2356;7221
293180;201612;5015;14082;4036;12403;149;609;3192;9492;3341;10101
293190;201612;13497;39972;12014;37540;476;2088;10182;31077;10658;33165
293200;201612;7232;19620;6087;17982;183;656;4824;14264;5007;14920
293210;201612;5062;14235;4304;12886;293;910;3266;9658;3559;10568
293220;201612;4936;14451;3905;12425;1073;3319;1378;4559;2451;7878
293230;201612;3601;10818;3123;10005;435;1572;2089;6565;2524;8137
293240;201612;4228;11705;3316;10062;121;350;2554;7747;2675;8097
293245;201612;4155;11588;3644;10815;178;542;3030;8912;3208;9454
293250;201612;5411;14724;4772;13659;458;1344;3446;9718;3904;11062
293260;201612;4374;12819;3593;11559;221;726;2596;8283;2817;9009
293270;201612;5453;14325;4799;13534;281;718;4190;11926;4471;12644
293280;201612;5197;14181;4263;12779;285;709;3318;10112;3603;10821
293290;201612;13834;45525;12391;42595;3205;11069;5237;18638;8442;29707
293300;201612;6617;15644;5506;14213;388;948;4123;10761;4511;11709
293305;201612;4769;11769;3909;10533;117;362;3313;8845;3430;9207
293310;201612;2322;6097;1815;5179;181;505;1242;3500;1423;4005
293315;201612;4155;10428;3448;9316;310;686;2672;7337;2982;8023
293317;201612;2354;6648;2038;6024;184;563;1472;4291;1656;4854
293320;201612;7376;24065;7079;23625;1134;3701;5035;17139;6169;20840
293325;201612;1691;4823;1366;4260;201;677;886;2709;1087;3386
293330;201612;47116;152805;41373;141284;9433;33383;18689;63831;28122;97214
293340;201612;2484;7168;1936;6150;245;804;1144;3632;1389;4436
293345;201612;3193;9416;2760;8813;235;566;2153;7199;2388;7765
293350;201612;6301;18701;5914;18217;162;340;5460;17258;5622;17598
293360;201612;12936;38374;11636;36657;646;2326;10213;31977;10859;34303
310010;201612;750;2071;594;1793;108;382;268;740;376;1122
310020;201612;2474;7770;1922;6613;467;1735;246;784;713;2519
310030;201612;2115;6574;1716;5863;365;1370;967;3201;1332;4571
310040;201612;952;2545;760;2251;60;221;591;1672;651;1893
310050;201612;1732;5918;1582;5582;311;1244;696;2314;1007;3558
310060;201612;3247;9756;2755;9061;232;936;2186;7058;2418;7994
310070;201612;353;968;250;776;13;59;164;463;177;522
310080;201612;707;2081;546;1776;82;325;199;594;281;919
310090;201612;4555;13304;3747;11810;487;1648;2441;7618;2928;9266
310100;201612;3494;10352;2826;9207;156;613;2225;7148;2381;7761
310110;201612;4700;13166;3773;11430;599;2029;2021;5803;2620;7832
310120;201612;627;1856;445;1483;118;473;159;412;277;885
310130;201612;365;1106;305;988;77;302;157;439;234;741
310140;201612;163;546;135;500;40;176;38;109;78;285
310150;201612;4464;13534;3552;11594;884;3057;1117;3461;2001;6518
310160;201612;6465;20536;4958;17266;1563;5749;585;1933;2148;7682
310163;201612;1047;3338;838;2883;295;1070;183;571;478;1641
310170;201612;8797;24383;7628;22581;920;2846;5379;15948;6299;18794
310180;201612;1691;4760;1365;4228;209;723;798;2347;1007;3070
310190;201612;2874;9344;2388;8351;645;2431;414;1405;1059;3836
310200;201612;1631;5318;1319;4601;272;1038;484;1643;756;2681
310205;201612;1102;3115;797;2610;147;475;408;1369;555;1844
310210;201612;2752;7672;2274;6924;190;558;1678;5050;1868;5608
310220;201612;1002;2984;855;2735;134;484;527;1617;661;2101
310230;201612;2411;7295;1919;6157;232;890;1166;3484;1398;4374
310240;201612;882;3190;773;2945;108;458;453;1706;561;2164
310250;201612;789;2564;737;2462;120;500;453;1387;573;1887
310260;201612;2932;9245;1989;7123;490;1960;299;875;789;2835
310270;201612;2577;7078;2007;6193;162;645;1580;4729;1742;5374
310280;201612;2242;5764;1680;4820;446;1311;811;2224;1257;3535
310285;201612;1972;7013;1791;6682;215;897;1234;4695;1449;5592
310290;201612;1083;3230;984;3040;233;808;517;1438;750;2246
310300;201612;1613;5385;1490;5123;348;1360;707;2269;1055;3629
310310;201612;299;824;207;644;33;89;109;355;142;444
310320;201612;393;1215;306;1045;37;179;157;491;194;670
310330;201612;517;1276;309;866;35;103;129;317;164;420
310340;201612;7972;23581;6253;20383;1456;4674;2699;9158;4155;13832
310350;201612;13222;34375;8423;25873;2260;7423;2045;5967;4305;13390
310360;201612;437;1234;387;1157;16;57;304;873;320;930
310370;201612;1334;4442;1145;4048;358;1277;450;1595;808;2872
310375;201612;1181;3216;700;2295;117;388;246;805;363;1193
310380;201612;355;911;187;593;55;176;61;176;116;352
310390;201612;437;1520;355;1322;82;320;74;235;156;555
310400;201612;9442;25831;6518;20574;1570;5257;1926;5856;3496;11113
310410;201612;675;2212;454;1787;94;394;95;364;189;758
310420;201612;4316;12168;2663;8482;568;1948;427;1133;995;3081
310430;201612;1246;3952;812;2986;194;754;125;415;319;1169
310440;201612;501;1477;361;1187;65;236;147;470;212;706
310445;201612;1190;3854;944;3354;114;422;618;2158;732;2580
310450;201612;4358;12071;3345;10446;328;1015;2366;7419;2694;8434
310460;201612;1465;4295;1129;3728;307;1064;305;1051;612;2115
310470;201612;3996;8934;3366;8161;249;549;2901;7126;3150;7675
310480;201612;1228;3528;876;2804;192;602;371;1134;563;1736
310490;201612;2856;9116;2277;7855;584;2310;885;2807;1469;5117
310500;201612;1261;4214;1066;3767;247;936;407;1400;654;2336
310510;201612;1855;5830;1324;4574;332;1223;216;736;548;1959
310520;201612;1403;3570;1011;2934;75;203;717;2061;792;2264
310530;201612;917;2690;409;1409;59;232;50;131;109;363
310540;201612;2934;9294;2489;8398;687;2396;1017;3315;1704;5711
310550;201612;1110;3104;866;2680;128;492;536;1549;664;2041
310560;201612;13942;42086;11066;36088;3008;10671;3336;9916;6344;20587
310570;201612;1156;3389;952;3010;138;546;640;1922;778;2468
310590;201612;4137;11985;3260;10249;494;1640;1691;5166;2185;6806
310600;201612;1353;4406;1119;3847;228;853;480;1536;708;2389
310610;201612;390;1314;327;1165;79;342;109;324;188;666
310620;201612;137283;414591;110798;359372;26345;93517;38918;112974;65263;206491
310630;201612;4139;12266;3604;11275;296;1016;2746;8457;3042;9473
310640;201612;1209;3686;918;3114;269;1017;239;746;508;1763
310650;201612;2642;8135;1962;6844;317;1118;1071;3717;1388;4835
310660;201612;1301;3927;1146;3714;110;377;838;2681;948;3058
310665;201612;1277;3762;1126;3533;72;237;923;2965;995;3202
310670;201612;38641;117004;32607;103673;7965;26427;12400;37856;20365;64283
310680;201612;658;1831;557;1664;69;233;399;1153;468;1386
310690;201612;1264;4041;1001;3558;188;802;434;1420;622;2222
310700;201612;511;1263;384;1088;56;184;239;645;295;829
310710;201612;5876;19003;4112;15584;811;3553;399;1321;1210;4874
310720;201612;796;2320;697;2156;54;194;522;1589;576;1783
310730;201612;8909;27382;7682;25079;1322;4576;4369;13999;5691;18575
310740;201612;4794;15054;3420;11953;784;2849;734;2412;1518;5261
310750;201612;1445;3593;989;2912;200;616;418;1112;618;1728
310760;201612;558;1670;427;1410;62;215;180;596;242;811
310770;201612;926;2870;676;2423;125;502;303;1016;428;1518
310780;201612;3802;10251;3022;8861;408;1199;1991;5725;2399;6924
310790;201612;1891;6056;1631;5507;439;1500;687;2403;1126;3903
310800;201612;2537;8050;1786;6404;520;2115;112;352;632;2467
310810;201612;1082;3031;910;2690;145;494;520;1429;665;1923
310820;201612;1267;3625;822;2703;199;693;197;617;396;1310
310825;201612;2727;9366;2127;8250;120;657;1606;6129;1726;6786
310830;201612;1336;4264;1018;3613;273;1011;336;1151;609;2162
310840;201612;2128;6263;1412;4828;283;974;367;1154;650;2128
310850;201612;1507;4392;1268;4062;121;467;938;2936;1059;3403
310855;201612;2803;8689;2356;7954;354;1284;1572;5252;1926;6536
310860;201612;7024;21486;5665;18794;731;2453;3384;11325;4115;13778
310870;201612;1066;2825;820;2417;133;409;494;1454;627;1863
310880;201612;977;3049;761;2593;130;481;417;1402;547;1883
310890;201612;2450;7286;1728;5955;431;1610;353;1037;784;2647
310900;201612;4057;12596;2969;10209;663;2515;1086;3397;1749;5912
310910;201612;1885;5279;1053;3514;161;600;135;344;296;944
310920;201612;1810;5235;1357;4459;308;1091;612;1950;920;3041
310925;201612;919;2948;800;2727;271;977;333;1084;604;2061
310930;201612;5936;16518;4517;14233;646;2169;2794;8897;3440;11066
310940;201612;5900;16325;4754;14450;679;2163;2971;8828;3650;10991
310945;201612;1090;3212;958;2982;131;453;573;1710;704;2163
310950;201612;2065;6374;1382;4839;312;1282;489;1582;801;2864
310960;201612;380;1211;306;1064;82;308;126;447;208;755
310970;201612;1165;3797;810;2978;197;785;137;431;334;1216
310980;201612;366;885;214;620;30;105;119;307;149;412
310990;201612;1114;3554;845;2910;202;766;284;873;486;1639
311000;201612;3396;11310;2949;10346;1054;3841;817;2694;1871;6535
311010;201612;702;2333;629;2156;222;817;242;813;464;1630
311020;201612;919;2696;672;2204;102;375;354;1075;456;1450
311030;201612;1623;4356;1037;3237;272;965;319;865;591;1830
311040;201612;433;1445;343;1219;81;291;73;241;154;532
311050;201612;2210;6687;1815;5983;451;1633;769;2470;1220;4103
311060;201612;2395;6964;1601;5198;279;1019;582;1710;861;2729
311070;201612;1347;4526;1090;3968;227;923;474;1655;701;2578
311080;201612;783;2411;626;2078;144;524;218;662;362;1186
311090;201612;1762;6257;1389;5483;419;1826;450;1640;869;3466
311100;201612;1904;6371;1402;5218;446;1786;161;570;607;2356
311110;201612;3252;7817;2228;6284;396;1170;1086;3045;1482;4215
311115;201612;1189;3467;989;3143;81;334;688;2127;769;2461
311120;201612;7217;20197;5101;16077;1116;3820;1535;4362;2651;8182
311130;201612;1988;6037;1542;5243;257;1044;670;2111;927;3155
311140;201612;1313;3398;933;2822;70;246;612;1837;682;2083
311150;201612;1546;5425;1383;5094;231;914;815;2986;1046;3900
311160;201612;3734;12413;2897;10741;1027;4131;619;2231;1646;6362
311170;201612;767;2288;578;1909;97;327;265;903;362;1230
311180;201612;997;2911;740;2390;227;766;191;585;418;1351
311190;201612;1067;3032;739;2353;188;663;175;494;363;1157
311200;201612;1780;5389;1306;4363;357;1277;215;640;572;1917
311205;201612;969;3191;788;2785;119;493;378;1310;497;1803
311210;201612;992;3087;892;2947;147;485;627;2117;774;2602
311220;201612;789;2469;622;2083;138;498;233;740;371;1238
311230;201612;8141;25717;5849;20573;1313;4856;1880;6742;3193;11598
311240;201612;939;2841;708;2447;182;691;246;806;428;1497
311250;201612;742;2372;630;2164;207;734;169;519;376;1253
311260;201612;2071;5546;1484;4484;360;1182;555;1616;915;2798
311265;201612;1184;3305;916;2836;161;533;510;1572;671;2105
311270;201612;3261;10280;2828;9615;231;1142;2032;6566;2263;7708
311280;201612;1116;3150;618;2020;128;477;151;469;279;946
311290;201612;1937;6357;1740;5862;341;1136;1024;3451;1365;4587
311300;201612;4254;13857;3689;12772;322;1419;2750;9263;3072;10682
311310;201612;589;1920;452;1616;109;379;123;383;232;762
311320;201612;3378;11211;2900;10060;526;2027;1136;3638;1662;5665
311330;201612;4215;12611;3476;11164;888;3032;1509;4754;2397;7786
311340;201612;11187;34631;9131;30364;2792;9760;2136;6892;4928;16652
311350;201612;2240;6197;1610;4914;224;797;779;2114;1003;2911
311360;201612;899;2681;761;2470;359;1187;100;348;459;1535
311370;201612;3612;10812;2851;9309;640;2431;1104;3180;1744;5611
311380;201612;415;1374;326;1158;90;340;99;349;189;689
311390;201612;1712;6098;1488;5709;589;2560;364;1228;953;3788
311400;201612;1405;4311;1051;3573;177;695;436;1310;613;2005
311410;201612;1674;5748;1497;5481;393;1585;727;2648;1120;4233
311420;201612;1791;5780;1084;3961;192;757;100;250;292;1007
311430;201612;3497;10455;2262;7637;458;1633;340;1114;798;2747
311440;201612;2332;7471;1597;5937;507;2123;264;947;771;3070
311450;201612;1807;6285;1421;5333;394;1629;252;838;646;2467
311455;201612;963;2593;706;2114;194;594;260;700;454;1294
311460;201612;581;1872;396;1462;70;309;97;327;167;636
311470;201612;454;1510;341;1247;87;361;55;162;142;523
311480;201612;785;2039;708;1917;164;434;443;1200;607;1634
311490;201612;208;759;177;664;56;235;57;180;113;415
311500;201612;425;1232;324;1042;73;278;142;438;215;716
311510;201612;2679;8154;1883;6582;611;2443;379;1234;990;3677
311520;201612;582;1877;524;1738;180;653;202;629;382;1282
311530;201612;10296;26424;6897;20554;1878;6273;1602;4524;3480;10797
311535;201612;749;2157;425;1480;121;468;61;185;182;653
311540;201612;595;2035;534;1910;168;594;232;807;400;1401
311545;201612;2090;6235;1807;5854;143;524;1328;4204;1471;4728
311547;201612;1437;4017;1167;3550;60;182;836;2510;896;2692
311550;201612;2809;8732;2136;7264;383;1419;801;2628;1184;4047
311560;201612;259;676;210;598;30;94;121;312;151;406
311570;201612;1911;4929;1446;4260;77;230;1170;3545;1247;3775
311580;201612;2392;4707;1664;3823;427;878;908;2259;1335;3137
311590;201612;481;1456;390;1297;96;365;173;559;269;924
311600;201612;1223;3632;1001;3315;352;1187;439;1468;791;2655
311610;201612;2723;9486;2349;8696;788;2817;874;3401;1662;6218
311615;201612;3122;9559;2499;8484;225;909;1790;5958;2015;6867
311620;201612;411;1227;350;1121;42;156;233;732;275;888
311630;201612;1306;3794;1038;3290;195;608;646;2013;841;2621
311640;201612;757;2409;587;2106;125;469;265;942;390;1411
311650;201612;2148;6030;1768;5374;203;684;1098;3305;1301;3989
311660;201612;2640;8352;1787;6413;362;1323;240;727;602;2050
311670;201612;1559;4411;1172;3743;379;1293;343;1041;722;2334
311680;201612;2009;6304;1636;5580;351;1240;884;3001;1235;4241
311690;201612;509;1272;425;1165;26;73;363;1006;389;1079
311700;201612;2267;5804;1699;4990;86;277;1356;3892;1442;4169
311710;201612;1560;4801;1082;3796;405;1573;247;820;652;2393
311720;201612;386;1283;320;1129;105;375;86;282;191;657
311730;201612;5788;14353;2946;9199;964;3347;457;1077;1421;4424
311740;201612;781;2378;748;2334;131;409;568;1783;699;2192
311750;201612;3978;12691;3267;11378;546;2104;1774;5936;2320;8040
311760;201612;648;2143;528;1818;110;414;133;368;243;782
311770;201612;2055;6570;1628;5640;377;1406;487;1590;864;2996
311780;201612;1190;4063;905;3367;230;948;198;639;428;1587
311783;201612;1997;6310;1600;5502;59;293;1250;4176;1309;4469
311787;201612;587;1981;406;1444;74;290;113;341;187;631
311790;201612;1541;4503;1098;3628;256;967;365;1144;621;2111
311800;201612;4861;16039;3659;12819;799;3045;444;1377;1243;4422
311810;201612;1021;3333;845;2960;73;336;532;1802;605;2138
311820;201612;556;1705;452;1450;105;384;246;710;351;1094
311830;201612;7864;25567;5714;20205;1657;6276;565;1813;2222;8089
311840;201612;2717;8210;2420;7697;576;2010;1328;4104;1904;6114
311850;201612;275;855;231;765;40;141;129;416;169;557
311860;201612;47796;138146;38918;121598;7050;23563;20979;62975;28029;86538
311870;201612;2083;6062;1418;4644;264;973;449;1316;713;2289
311880;201612;6592;18532;5649;17170;664;1849;4041;12637;4705;14486
311890;201612;1374;4030;1072;3415;255;860;473;1466;728;2326
311900;201612;673;2037;540;1784;78;291;322;1044;400;1335
311910;201612;3929;11437;3149;10177;719;2422;1393;4431;2112;6853
311920;201612;1862;6003;1561;5414;180;690;949;3240;1129;3930
311930;201612;3219;8969;2548;7808;1107;3403;530;1613;1637;5016
311940;201612;12359;36480;9039;29281;1978;6754;2724;8174;4702;14928
311950;201612;2163;6313;1688;5521;140;556;1212;3852;1352;4408
311960;201612;374;1147;320;1021;57;226;156;418;213;644
311970;201612;367;1224;260;967;50;214;63;214;113;428
311980;201612;543;1554;340;1151;53;195;119;410;172;605
311990;201612;428;1213;324;1035;105;361;122;363;227;724
311995;201612;1137;3466;576;2024;34;134;48;108;82;242
312000;201612;593;1760;519;1642;50;163;341;1092;391;1255
312010;201612;860;2803;669;2335;92;353;288;957;380;1310
312015;201612;1333;4255;1173;3937;134;514;771;2521;905;3035
312020;201612;1048;3343;911;3094;203;706;404;1345;607;2051
312030;201612;1785;5053;1576;4780;85;342;1370;4057;1455;4399
312040;201612;718;2562;544;2086;120;504;124;442;244;946
312050;201612;1146;4052;928;3473;233;970;152;486;385;1456
312060;201612;711;2194;614;2008;199;693;253;777;452;1470
312070;201612;978;2962;605;2126;132;503;231;778;363;1281
312080;201612;2609;7036;1957;5953;247;903;1151;3214;1398;4117
312083;201612;897;2464;754;2257;64;203;583;1725;647;1928
312087;201612;2093;6249;1843;5845;172;581;1426;4560;1598;5141
312090;201612;8412;25518;6646;22141;1905;6483;2477;8059;4382;14542
312100;201612;1420;4529;1012;3756;223;908;418;1449;641;2357
312110;201612;965;3373;791;2953;222;929;154;494;376;1423
312120;201612;646;2065;513;1778;115;465;199;601;314;1066
312125;201612;1065;3393;932;3145;210;665;536;1908;746;2573
312130;201612;826;2330;589;1813;77;271;237;673;314;944
312140;201612;788;2504;638;2127;162;584;184;538;346;1122
312150;201612;442;1307;376;1158;29;118;242;684;271;802
312160;201612;7154;23622;6007;20990;1429;5394;2291;7620;3720;13014
312170;201612;864;2474;689;2157;66;217;433;1319;499;1536
312180;201612;1327;4046;1080;3505;215;768;458;1373;673;2141
312190;201612;573;1830;399;1448;131;518;62;223;193;741
312200;201612;4678;13269;3802;11765;714;2187;2174;6760;2888;8947
312210;201612;1072;2807;780;2345;156;548;442;1232;598;1780
312220;201612;1877;6339;1712;6130;169;515;1400;5196;1569;5711
312230;201612;10809;32942;7665;26351;2488;9269;862;2724;3350;11993
312235;201612;1528;4541;1337;4253;143;519;964;3019;1107;3538
312240;201612;851;2846;651;2392;151;607;156;547;307;1154
312245;201612;2113;6244;1859;5878;80;297;1542;4826;1622;5123
312247;201612;756;2225;555;1859;169;580;205;703;374;1283
312250;201612;1118;3057;784;2458;129;458;311;903;440;1361
312260;201612;870;2733;691;2397;120;446;407;1357;527;1803
312270;201612;642;1889;475;1528;52;218;265;762;317;980
312280;201612;396;1299;337;1163;122;433;40;130;162;563
312290;201612;735;2432;633;2218;141;561;208;702;349;1263
312300;201612;792;2603;568;2017;143;549;50;121;193;670
312310;201612;774;2850;698;2657;178;750;292;1060;470;1810
312320;201612;1883;5324;1335;4217;384;1300;270;742;654;2042
312330;201612;974;2821;778;2521;138;515;546;1723;684;2238
312340;201612;288;785;227;675;39;135;122;328;161;463
312350;201612;273;683;236;639;19;68;198;510;217;578
312352;201612;1569;4882;1381;4580;246;866;914;3095;1160;3961
312360;201612;2850;9055;2250;7729;498;1824;675;2260;1173;4084
312370;201612;1636;5021;1377;4543;391;1445;530;1601;921;3046
312380;201612;1845;5009;1613;4678;56;166;1389;4091;1445;4257
312385;201612;1288;3698;1073;3338;79;309;784;2355;863;2664
312390;201612;2048;6465;1470;5214;375;1382;318;1011;693;2393
312400;201612;2935;9316;2280;7899;907;3211;447;1586;1354;4797
312410;201612;9651;31049;8211;28041;1750;6296;3676;12233;5426;18529
312420;201612;3745;11440;3432;10889;635;1996;2182;6997;2817;8993
312430;201612;7920;22832;6473;20109;961;2973;4064;12613;5025;15586
312440;201612;762;2382;601;2062;235;879;183;648;418;1527
312450;201612;1140;3712;848;3084;274;1046;265;977;539;2023
312460;201612;331;994;280;918;54;205;154;491;208;696
312470;201612;589;1595;350;1112;77;284;109;308;186;592
312480;201612;1089;2826;790;2463;141;517;461;1340;602;1857
312490;201612;1882;4918;1405;4142;178;581;837;2349;1015;2930
312500;201612;666;1953;546;1749;98;342;222;674;320;1016
312510;201612;3538;10235;2660;8314;390;1355;1387;4055;1777;5410
312520;201612;224;710;169;609;61;223;56;207;117;430
312530;201612;561;1625;474;1491;46;184;331;1008;377;1192
312540;201612;1360;4269;981;3440;242;909;405;1407;647;2316
312550;201612;688;2034;562;1746;92;285;289;839;381;1124
312560;201612;2064;5348;1655;4786;71;273;1372;3879;1443;4152
312570;201612;2164;6365;1747;5622;489;1637;607;1962;1096;3599
312580;201612;500;1625;398;1381;48;182;164;551;212;733
312590;201612;1616;5220;1322;4560;358;1323;492;1585;850;2908
312595;201612;1772;5987;1602;5575;341;1188;857;3000;1198;4188
312600;201612;756;2402;552;1989;89;404;264;878;353;1282
312610;201612;6319;17547;4177;13302;990;3339;835;2473;1825;5812
312620;201612;2144;6160;1606;5351;99;373;1225;4155;1324;4528
312630;201612;293;938;230;807;67;258;71;233;138;491
312640;201612;511;1640;390;1372;80;284;117;381;197;665
312650;201612;2096;5976;1435;4592;175;654;849;2579;1024;3233
312660;201612;1357;3568;1058;3097;107;362;734;2080;841;2442
312670;201612;5269;15534;4286;14020;1213;4286;1457;4631;2670;8917
312675;201612;1247;3932;1023;3444;123;475;699;2297;822;2772
312680;201612;1384;4187;1172;3883;156;623;748;2367;904;2990
312690;201612;2094;5506;1634;4781;245;768;1078;3034;1323;3802
312695;201612;807;2792;748;2689;147;488;481;1793;628;2281
312700;201612;1676;5095;1251;4161;156;569;721;2307;877;2876
312705;201612;1255;3534;971;2991;78;264;691;2052;769;2316
312707;201612;1423;4575;1068;3819;128;560;583;1974;711;2534
312710;201612;6257;15607;3686;11270;1136;3744;695;2053;1831;5797
312720;201612;749;2485;604;2160;119;472;247;800;366;1272
312730;201612;1798;4336;1228;3596;151;497;754;2166;905;2663
312733;201612;1532;4101;1070;3211;53;173;716;2066;769;2239
312735;201612;778;2094;674;1937;172;530;342;917;514;1447
312737;201612;799;1997;544;1603;168;484;181;538;349;1022
312738;201612;473;1468;310;1102;74;299;111;357;185;656
312740;201612;297;753;179;602;54;182;39;123;93;305
312750;201612;1191;4173;1084;3985;202;861;543;1903;745;2764
312760;201612;1783;5687;1263;4506;300;1114;340;1181;640;2295
312770;201612;40016;107599;27321;84522;6915;22445;7601;22185;14516;44630
312780;201612;2594;8807;2241;8132;375;1480;1243;4497;1618;5977
312790;201612;315;793;165;516;21;76;65;170;86;246
312800;201612;4764;15300;3590;12716;1091;4125;730;2541;1821;6666
312810;201612;1972;6008;1263;4465;308;1170;244;745;552;1915
312820;201612;1885;5298;1516;4581;66;234;1096;3188;1162;3422
312825;201612;1282;3435;1100;3179;75;235;862;2481;937;2716
312830;201612;2499;7601;1567;5611;431;1615;262;883;693;2498
312840;201612;1199;3782;893;3134;130;513;314;976;444;1489
312850;201612;675;2081;482;1655;93;363;154;496;247;859
312860;201612;1159;3382;774;2606;214;792;235;709;449;1501
312870;201612;5469;16754;3488;12284;648;2437;805;2640;1453;5077
312880;201612;1243;3634;1055;3325;92;328;712;2273;804;2601
312890;201612;1716;5136;961;3361;208;765;346;1207;554;1972
312900;201612;1195;3451;1000;3158;108;365;691;2198;799;2563
312910;201612;1603;3159;854;2127;146;380;408;928;554;1308
312920;201612;825;2621;665;2282;147;591;268;835;415;1426
312930;201612;2058;5876;1682;5214;465;1407;684;2117;1149;3524
312940;201612;847;2739;695;2425;183;710;197;620;380;1330
312950;201612;2826;7918;2009;6551;733;2517;383;1240;1116;3757
312960;201612;1863;5311;1580;4889;151;431;1238;3900;1389;4331
312965;201612;1766;5520;1446;4870;147;537;911;3042;1058;3579
312970;201612;925;3056;721;2667;183;738;197;712;380;1450
312980;201612;16899;55447;15013;51072;4201;15341;5831;18724;10032;34065
312990;201612;446;1289;285;988;84;333;88;288;172;621
313000;201612;471;1543;363;1313;78;370;140;422;218;792
313005;201612;2555;8047;2223;7396;363;1174;1358;4528;1721;5702
313010;201612;3559;11300;2911;10055;762;2820;1286;4270;2048;7090
313020;201612;890;2952;579;2126;100;403;75;227;175;630
313030;201612;1377;3645;942;2954;214;757;414;1259;628;2016
313040;201612;726;2384;622;2134;73;318;311;980;384;1298
313050;201612;1717;5335;1209;4455;266;1076;295;971;561;2047
313055;201612;1546;4807;1411;4594;60;211;1205;3921;1265;4132
313060;201612;747;2369;547;1883;152;539;60;185;212;724
313065;201612;1838;5917;1523;5343;225;842;1029;3612;1254;4454
313070;201612;955;2757;731;2328;164;561;323;985;487;1546
313080;201612;420;1277;286;980;63;258;90;251;153;509
313090;201612;5052;14514;4237;13107;1197;3949;1883;5740;3080;9689
313100;201612;1090;3264;965;3049;73;231;779;2474;852;2705
313110;201612;1645;4669;1152;3637;163;581;526;1524;689;2105
313115;201612;2258;7442;2047;6965;447;1677;952;3000;1399;4677
313120;201612;3348;8868;2790;8068;651;2105;1557;4345;2208;6450
313130;201612;24744;73548;19928;63321;4074;14025;8571;25382;12645;39407
313140;201612;497;1297;381;1111;20;65;287;812;307;877
313150;201612;1296;4065;1018;3492;453;1647;166;562;619;2209
313160;201612;887;2692;717;2326;133;482;352;1065;485;1547
313170;201612;9523;31360;6545;23821;1362;5151;1756;6005;3118;11156
313180;201612;2202;5972;1662;5123;347;1172;722;2084;1069;3256
313190;201612;3696;12190;2692;9630;584;2199;675;2213;1259;4412
313200;201612;1112;3538;957;3234;76;288;700;2315;776;2603
313210;201612;3954;12148;3226;10899;736;2575;1459;4739;2195;7314
313220;201612;1532;4495;1013;3365;229;851;228;613;457;1464
313230;201612;2214;7693;2038;7416;286;1114;1433;5143;1719;6257
313240;201612;7938;23639;5725;19266;1067;4021;2313;7263;3380;11284
313250;201612;6287;19839;5036;17362;669;2377;2766;9374;3435;11751
313260;201612;608;1796;388;1304;63;237;110;344;173;581
313270;201612;5225;15566;4175;13551;754;2600;2238;7121;2992;9721
313280;201612;360;1171;242;903;52;208;57;194;109;402
313290;201612;766;2727;605;2386;225;990;82;279;307;1269
313300;201612;1706;5549;1289;4526;374;1395;150;432;524;1827
313310;201612;919;3146;749;2745;174;708;142;428;316;1136
313320;201612;2249;6379;1557;5195;333;1225;606;1953;939;3178
313330;201612;3950;11938;3190;10525;307;1288;2014;6334;2321;7622
313340;201612;1628;4027;1204;3349;229;640;666;1859;895;2499
313350;201612;2418;7524;1764;5959;387;1399;400;1215;787;2614
313360;201612;1243;3506;873;2844;196;770;469;1377;665;2147
313370;201612;1123;3750;990;3383;141;554;528;1696;669;2250
313375;201612;2060;5475;1334;4235;265;974;462;1352;727;2326
313380;201612;4522;13817;3576;11724;987;3466;1186;3565;2173;7031
313390;201612;856;2901;791;2779;77;306;539;1858;616;2164
313400;201612;3555;9610;3050;8974;338;935;2465;7387;2803;8322
313410;201612;1128;3204;917;2851;204;696;525;1572;729;2268
313420;201612;16261;39134;8757;25736;1858;5955;1352;3892;3210;9847
313430;201612;957;2999;684;2381;121;491;248;772;369;1263
313440;201612;6098;13741;3871;10794;190;503;2722;7617;2912;8120
313450;201612;575;1712;428;1386;88;312;138;405;226;717
313460;201612;1997;6683;1673;6038;420;1742;627;2022;1047;3764
313470;201612;2981;8139;2514;7367;372;1103;1679;4835;2051;5938
313480;201612;783;2294;571;1849;83;300;219;647;302;947
313490;201612;1457;4106;735;2875;223;947;57;202;280;1149
313500;201612;401;1317;292;1013;51;191;90;298;141;489
313505;201612;8742;25395;8127;24679;222;474;7635;23532;7857;24006
313507;201612;1339;3641;1119;3305;88;278;761;2242;849;2520
313510;201612;14262;41353;12005;37142;1701;5496;6546;19823;8247;25319
313520;201612;13796;42185;11153;37140;1188;4363;7233;23769;8421;28132
313530;201612;550;1636;425;1383;45;170;153;449;198;619
313535;201612;2480;7201;2150;6551;178;545;1576;4713;1754;5258
313540;201612;949;2953;658;2166;182;638;172;526;354;1164
313545;201612;1209;4405;1059;4083;170;718;607;2225;777;2943
313550;201612;1771;5602;1504;5056;338;1147;743;2459;1081;3606
313560;201612;2143;4883;1704;4360;179;440;1306;3383;1485;3823
313570;201612;845;2892;708;2616;207;838;251;881;458;1719
313580;201612;5563;15912;4184;13655;776;2666;2217;7312;2993;9978
313590;201612;909;2619;681;2258;315;1119;114;347;429;1466
313600;201612;3664;10960;3148;10068;309;1118;2310;7278;2619;8396
313610;201612;930;2685;779;2381;179;555;425;1292;604;1847
313620;201612;5042;15222;4140;13462;1077;3638;1544;4913;2621;8551
313630;201612;7707;21249;5510;17944;821;2936;2963;9981;3784;12917
313640;201612;756;2199;526;1807;176;627;134;472;310;1099
313650;201612;1768;5860;1548;5462;227;934;996;3398;1223;4332
313652;201612;883;3071;799;2903;134;547;458;1587;592;2134
313655;201612;904;2858;735;2563;104;397;421;1454;525;1851
313657;201612;1333;3857;1055;3407;83;355;785;2374;868;2729
313660;201612;788;2575;659;2294;143;578;323;1026;466;1604
313665;201612;3700;11725;3002;10170;601;2233;1475;4755;2076;6988
313670;201612;42427;122660;28891;94738;6636;23233;9229;28841;15865;52074
313680;201612;1029;3005;857;2692;106;410;550;1649;656;2059
313690;201612;824;2941;684;2608;153;595;260;1011;413;1606
313695;201612;1305;4208;1104;3798;109;440;770;2624;879;3064
313700;201612;3418;11605;2946;10960;441;1654;2114;8033;2555;9687
313710;201612;1255;3368;915;2795;163;527;490;1463;653;1990
313720;201612;5190;16183;3710;12693;714;2647;1332;4131;2046;6778
313730;201612;1263;3296;900;2765;114;395;539;1610;653;2005
313740;201612;1811;6562;1436;5528;372;1577;73;222;445;1799
313750;201612;1956;5925;1544;5013;418;1431;430;1241;848;2672
313753;201612;1791;5055;1338;4217;215;759;663;2022;878;2781
313760;201612;4067;12870;3137;10832;829;3038;894;2868;1723;5906
313770;201612;3217;10109;2657;9222;849;3101;1096;3751;1945;6852
313780;201612;3939;10820;2637;8448;429;1522;986;3028;1415;4550
313790;201612;443;1509;413;1450;78;274;245;871;323;1145
313800;201612;1138;3028;955;2726;86;274;691;1990;777;2264
313810;201612;1523;4340;1300;3980;151;487;919;2839;1070;3326
313820;201612;11810;31619;8933;26491;1515;5103;3880;10602;5395;15705
313830;201612;367;1195;313;1096;76;310;129;431;205;741
313835;201612;853;2815;766;2657;99;416;428;1397;527;1813
313840;201612;7097;20298;5146;16724;1276;4411;1172;3623;2448;8034
313850;201612;1066;2879;886;2533;164;573;477;1207;641;1780
313860;201612;2700;8086;1866;6165;397;1369;565;1728;962;3097
313862;201612;1227;3083;834;2415;89;258;508;1534;597;1792
313865;201612;2218;6697;1947;6255;142;540;1470;4625;1612;5165
313867;201612;1090;3704;912;3277;290;1073;286;1047;576;2120
313868;201612;1622;5337;1328;4697;105;485;950;3226;1055;3711
313870;201612;730;2286;623;2053;183;650;164;466;347;1116
313880;201612;1265;3911;1005;3369;243;877;350;1018;593;1895
313890;201612;1825;4859;1424;4266;300;879;808;2584;1108;3463
313900;201612;3699;13168;3118;11768;954;3878;775;2865;1729;6743
313910;201612;666;2212;510;1866;175;683;61;208;236;891
313920;201612;3115;10361;2612;9362;554;2002;1364;5056;1918;7058
313925;201612;1753;4787;1285;3864;169;476;792;2380;961;2856
313930;201612;6490;23519;5304;21283;682;2444;3408;14665;4090;17109
313940;201612;8308;26884;6195;23040;1850;7545;1580;6058;3430;13603
313950;201612;3960;11033;2813;9032;885;3201;906;2650;1791;5851
313960;201612;5286;13586;3496;10718;919;3020;1010;2860;1929;5880
313970;201612;1341;3992;1145;3650;123;455;693;2261;816;2716
313980;201612;1193;3690;859;3047;181;722;350;1176;531;1898
313990;201612;1567;5837;1277;5028;413;1765;256;846;669;2611
314000;201612;7989;24821;6883;22414;992;3812;4110;12673;5102;16485
314010;201612;1153;3161;915;2802;61;213;652;1935;713;2148
314015;201612;1492;4809;1163;4197;241;971;528;1791;769;2762
314020;201612;490;1451;283;969;65;248;54;162;119;410
314030;201612;758;2466;552;1959;90;333;235;805;325;1138
314040;201612;730;2121;559;1767;196;638;174;536;370;1174
314050;201612;1537;4711;1144;3856;233;890;483;1493;716;2383
314053;201612;1552;4830;1322;4476;204;707;827;2930;1031;3637
314055;201612;2099;6240;1799;5765;63;251;1473;4715;1536;4966
314060;201612;1163;3522;897;3034;50;221;604;1978;654;2199
314070;201612;4015;12398;2979;10184;828;2914;733;2330;1561;5244
314080;201612;1761;5475;1089;3828;195;730;245;731;440;1461
314085;201612;1928;6428;1622;5901;441;1715;571;2055;1012;3770
314090;201612;3081;10618;2582;9535;694;2854;771;2866;1465;5720
314100;201612;3266;8144;2833;7575;144;288;2459;6811;2603;7099
314110;201612;3694;11655;3078;10224;639;2269;1314;3966;1953;6235
314120;201612;996;2380;443;1424;92;320;107;336;199;656
314130;201612;686;1963;299;1056;46;174;60;189;106;363
314140;201612;4740;14522;3654;12198;776;2710;1647;5403;2423;8113
314150;201612;1493;4103;1131;3433;150;485;639;1884;789;2369
314160;201612;2507;6486;1789;5289;229;720;1008;3068;1237;3788
314170;201612;1018;3011;802;2535;84;279;485;1455;569;1734
314180;201612;4930;15419;4206;14133;1258;4390;1662;5635;2920;10025
314190;201612;658;1841;468;1505;115;441;172;474;287;915
314200;201612;2822;8664;2427;7904;252;964;1695;5325;1947;6289
314210;201612;1955;5556;1674;5043;235;744;1008;2949;1243;3693
314220;201612;1443;4444;989;3474;309;1170;201;609;510;1779
314225;201612;1314;3757;1153;3510;89;304;864;2631;953;2935
314230;201612;638;2024;582;1918;95;370;329;1053;424;1423
314240;201612;1065;3206;824;2761;194;681;388;1334;582;2015
314250;201612;526;1565;374;1221;87;291;103;291;190;582
314260;201612;947;3379;799;2989;169;707;236;823;405;1530
314270;201612;2743;8840;2200;7816;209;832;1475;5204;1684;6036
314280;201612;2958;7993;1884;5876;440;1551;666;1846;1106;3397
314290;201612;4635;12725;3817;11287;826;2462;2058;6006;2884;8468
314300;201612;1442;4742;1120;3959;343;1239;295;996;638;2235
314310;201612;5500;15699;4176;13203;1077;3584;1627;4804;2704;8388
314315;201612;774;3017;690;2838;69;323;483;1961;552;2284
314320;201612;2841;7987;1956;6648;458;1636;938;3262;1396;4898
314330;201612;52231;155532;41389;135695;12473;42766;10766;34121;23239;76887
314340;201612;2739;7367;1310;4416;284;1047;114;254;398;1301
314345;201612;1184;3979;1051;3729;211;785;652;2258;863;3043
314350;201612;1133;3247;789;2590;217;741;111;306;328;1047
314360;201612;634;2039;377;1393;81;339;89;330;170;669
314370;201612;530;1714;482;1633;85;334;338;1098;423;1432
314380;201612;1225;3720;795;2790;219;842;109;376;328;1218
314390;201612;12173;34836;8237;27031;2016;6941;1883;5568;3899;12509
314400;201612;4293;12629;3471;11319;1199;4076;991;3325;2190;7401
314410;201612;2537;7735;1791;6178;506;1890;534;1849;1040;3739
314420;201612;729;2031;548;1736;23;125;401;1208;424;1333
314430;201612;5875;17487;4708;15108;1324;4553;1499;4663;2823;9216
314435;201612;1307;4125;1124;3798;87;378;779;2579;866;2957
314437;201612;970;2583;752;2216;26;88;586;1712;612;1800
314440;201612;535;1638;425;1443;149;559;104;290;253;849
314450;201612;1474;4362;1205;3875;234;893;608;1777;842;2670
314460;201612;3620;12124;2708;9958;635;2518;473;1598;1108;4116
314465;201612;2207;6835;1995;6418;84;363;1596;4985;1680;5348
314467;201612;971;2748;795;2430;44;138;610;1870;654;2008
314470;201612;2033;6366;1669;5557;432;1611;599;1806;1031;3417
314480;201612;5509;18173;3462;12605;614;2361;467;1462;1081;3823
314490;201612;793;2374;594;1945;126;461;300;902;426;1363
314500;201612;1762;4992;1171;3800;254;889;386;1182;640;2071
314505;201612;1769;5015;1586;4750;180;596;1111;3329;1291;3925
314510;201612;1865;4988;1166;3948;376;1366;276;909;652;2275
314520;201612;2643;9280;1786;7139;352;1559;180;635;532;2194
314530;201612;5678;19751;5209;18786;1024;3459;3075;11528;4099;14987
314535;201612;2683;7381;2161;6588;239;793;1536;4624;1775;5417
314537;201612;1081;3339;857;2913;99;401;534;1753;633;2154
314540;201612;350;1054;251;823;51;170;90;282;141;452
314545;201612;1389;4184;1207;3914;66;217;975;3226;1041;3443
314550;201612;594;1618;406;1319;80;337;166;460;246;797
314560;201612;4112;13979;3237;11761;566;2273;1058;3550;1624;5823
314570;201612;299;871;213;684;54;194;93;277;147;471
314580;201612;498;1646;343;1280;87;371;33;110;120;481
314585;201612;815;2629;552;2023;129;526;144;485;273;1011
314587;201612;1928;5786;1578;5155;334;1045;773;2577;1107;3622
314590;201612;2783;9386;1916;7038;397;1617;386;1294;783;2911
314600;201612;1551;5010;984;3691;217;867;129;388;346;1255
314610;201612;6606;22148;5690;19903;1226;4742;2411;7779;3637;12521
314620;201612;1551;4583;1343;4259;104;355;1033;3223;1137;3578
314625;201612;1459;4831;1281;4497;152;734;863;2817;1015;3551
314630;201612;4652;13773;3886;12434;255;1051;2870;8936;3125;9987
314640;201612;549;1473;385;1169;104;332;112;283;216;615
314650;201612;1015;2792;658;2130;78;286;267;757;345;1043
314655;201612;1528;4535;1067;3581;292;951;403;1346;695;2297
314660;201612;300;801;197;592;22;62;96;279;118;341
314670;201612;1604;4251;1042;3175;148;468;624;1820;772;2288
314675;201612;1781;5265;1512;4764;125;452;1102;3409;1227;3861
314690;201612;2062;6681;1598;5706;480;1856;310;1042;790;2898
314700;201612;8825;28977;5681;21524;1559;6439;744;2677;2303;9116
314710;201612;7887;23569;4894;16708;888;3320;742;2231;1630;5551
314720;201612;2268;7405;1670;5969;411;1589;403;1432;814;3021
314730;201612;2012;6061;1535;5164;412;1531;555;1704;967;3235
314740;201612;2675;8397;2203;7416;333;1279;1121;3592;1454;4871
314750;201612;319;993;233;792;47;164;94;305;141;469
314760;201612;1673;5428;1126;4038;229;930;202;551;431;1481
314770;201612;1047;3239;500;1723;63;241;106;294;169;535
314780;201612;291;769;209;648;50;188;91;252;141;440
314790;201612;9393;28639;6551;22772;2851;10628;447;1132;3298;11760
314795;201612;1561;4532;1341;4162;77;314;1004;2977;1081;3291
314800;201612;10861;31057;6410;21330;1688;5861;614;1851;2302;7712
314810;201612;10013;28942;7221;23606;2182;7588;1432;4628;3614;12216
314820;201612;832;2350;570;1845;134;474;230;710;364;1184
314830;201612;1513;5009;1296;4591;362;1417;559;1952;921;3369
314840;201612;887;3136;716;2867;128;638;426;1597;554;2235
314850;201612;1912;5368;1474;4564;164;646;1042;3076;1206;3722
314860;201612;3200;10443;2715;9440;472;1872;1545;5190;2017;7062
314870;201612;5343;16471;4461;15122;440;1837;3238;10704;3678;12541
314875;201612;1710;5518;1602;5351;169;576;1331;4465;1500;5041
314880;201612;893;2322;696;2038;43;94;532;1641;575;1735
314890;201612;528;1631;371;1246;64;246;141;419;205;665
314900;201612;531;1554;416;1354;88;296;171;532;259;828
314910;201612;1569;5058;1225;4443;355;1438;418;1408;773;2846
314915;201612;2409;7613;2024;6870;145;595;1445;4754;1590;5349
314920;201612;518;1425;341;1132;19;71;195;606;214;677
314930;201612;4387;14629;3612;12716;956;3562;986;3229;1942;6791
314940;201612;386;1108;337;1017;42;132;214;605;256;737
314950;201612;322;917;211;725;43;157;66;212;109;369
314960;201612;725;2213;540;1811;133;481;164;494;297;975
314970;201612;550;1877;449;1659;106;429;123;460;229;889
314980;201612;1328;4086;1034;3540;287;1097;61;173;348;1270
314990;201612;2389;7434;1651;5689;451;1767;320;897;771;2664
314995;201612;1577;4762;1327;4339;126;514;902;2861;1028;3375
315000;201612;1045;2965;805;2532;82;288;523;1626;605;1914
315010;201612;408;1249;300;1008;63;269;108;307;171;576
315015;201612;1988;6128;1776;5867;216;747;1326;4545;1542;5292
315020;201612;811;2486;552;1888;90;323;232;744;322;1067
315030;201612;580;1764;437;1479;123;426;92;288;215;714
315040;201612;881;2655;796;2479;160;531;463;1394;623;1925
315050;201612;1249;3590;938;3059;144;536;487;1544;631;2080
315053;201612;1013;3014;840;2658;134;525;434;1343;568;1868
315057;201612;1602;5493;1380;5021;329;1154;690;2538;1019;3692
315060;201612;683;2190;429;1591;84;328;58;208;142;536
315070;201612;721;2124;556;1815;156;534;218;647;374;1181
315080;201612;2767;9045;2305;7986;595;2212;986;3334;1581;5546
315090;201612;752;2599;565;2135;141;588;135;459;276;1047
315100;201612;1129;3759;751;2802;170;715;200;674;370;1389
315110;201612;1230;3675;961;3131;207;721;389;1233;596;1954
315120;201612;13524;31757;8659;24866;1427;4107;4260;12798;5687;16905
315130;201612;1239;4083;1052;3663;271;1034;334;1080;605;2114
315140;201612;2652;8250;2068;6986;430;1660;800;2425;1230;4085
315150;201612;4255;11457;2920;9035;537;1786;1222;3711;1759;5497
315160;201612;1188;3486;891;2875;198;656;342;1063;540;1719
315170;201612;1446;4531;1045;3635;231;850;209;741;440;1591
315180;201612;16661;46383;7976;27018;1466;5429;1444;4380;2910;9809
315190;201612;1920;4995;1568;4426;365;1082;919;2536;1284;3618
315200;201612;3543;11868;2762;10059;915;3593;482;1678;1397;5271
315210;201612;7566;22096;5550;17568;1021;3468;2150;6377;3171;9845
315213;201612;1095;3302;961;3062;37;127;800;2518;837;2645
315217;201612;2359;8046;1876;7088;204;946;1169;4255;1373;5201
315220;201612;9516;27229;7499;23538;2735;8608;2122;6718;4857;15326
315230;201612;2805;7528;2453;7098;146;219;2159;6572;2305;6791
315240;201612;2967;8989;2419;8050;750;2628;1013;3246;1763;5874
315250;201612;9970;29840;7187;24118;1740;6223;2329;7585;4069;13808
315260;201612;932;2878;550;1961;102;362;74;226;176;588
315270;201612;645;2071;451;1646;88;362;102;339;190;701
315280;201612;2776;7873;1526;5053;327;1119;231;700;558;1819
315290;201612;1201;3323;761;2534;255;905;151;508;406;1413
315300;201612;504;1310;319;1053;124;413;130;439;254;852
315310;201612;1239;3885;946;3274;151;603;577;1899;728;2502
315320;201612;719;2154;554;1903;85;353;260;866;345;1219
315330;201612;729;2631;396;1670;96;432;54;212;150;644
315340;201612;3401;9580;2519;8036;543;1794;931;2854;1474;4648
315350;201612;1775;4869;1284;4093;175;614;832;2640;1007;3254
315360;201612;1611;5347;1245;4448;248;962;408;1355;656;2317
315370;201612;445;1392;372;1233;79;270;159;521;238;791
315380;201612;189;632;134;493;33;148;42;121;75;269
315390;201612;1171;3807;785;2866;176;698;173;575;349;1273
315400;201612;4155;12435;3190;10444;637;2208;1454;4623;2091;6831
315410;201612;2062;5271;1666;4688;168;551;1207;3352;1375;3903
315415;201612;1024;3262;850;2974;334;1225;253;875;587;2100
315420;201612;1073;3459;766;2769;183;673;105;332;288;1005
315430;201612;3501;9521;2442;7644;731;2459;538;1553;1269;4012
315440;201612;938;2807;779;2505;178;674;336;936;514;1610
315445;201612;2012;5517;1495;4657;240;760;935;2906;1175;3666
315450;201612;2372;7321;2047;6763;355;1098;1229;4147;1584;5245
315460;201612;30031;97324;25509;87196;9223;32936;4394;14094;13617;47030
315470;201612;446;1338;342;1121;37;153;181;556;218;709
315480;201612;1655;5008;1031;3544;238;854;204;709;442;1563
315490;201612;3045;8069;2086;6555;381;1331;763;2219;1144;3550
315500;201612;475;1388;271;890;39;144;121;336;160;480
315510;201612;1340;3780;1126;3425;88;302;858;2541;946;2843
315520;201612;1023;3037;794;2612;123;440;483;1527;606;1967
315530;201612;616;2048;470;1661;157;603;137;427;294;1030
315540;201612;1012;3162;786;2703;160;661;278;910;438;1571
315550;201612;1696;4760;1201;3907;276;981;385;1203;661;2184
315560;201612;6259;20713;5531;19549;598;2323;3648;12930;4246;15253
315570;201612;1808;5785;1572;5243;324;1166;732;2322;1056;3488
315580;201612;2131;6196;1622;5224;430;1532;466;1372;896;2904
315590;201612;800;2373;679;2157;98;356;359;1103;457;1459
315600;201612;2333;8288;1813;7159;374;1466;909;3719;1283;5185
315610;201612;951;2682;731;2218;127;485;315;795;442;1280
315620;201612;296;1049;269;990;75;263;149;579;224;842
315630;201612;808;2554;592;2069;142;490;110;367;252;857
315640;201612;435;1263;338;1080;58;220;149;429;207;649
315645;201612;787;2316;607;1937;238;792;153;453;391;1245
315650;201612;1767;4848;1347;4215;86;355;991;3032;1077;3387
315660;201612;2525;6470;1962;5496;266;709;1313;3646;1579;4355
315670;201612;10217;33139;8728;29998;2290;8324;3364;11122;5654;19446
315680;201612;2922;9652;2150;7942;693;2695;543;1975;1236;4670
315690;201612;3192;8931;1961;6559;510;1811;367;1280;877;3091
315700;201612;7054;21593;5564;18455;1023;3613;2607;8227;3630;11840
315710;201612;1808;5072;1324;4243;93;405;868;2644;961;3049
315720;201612;3685;11577;3013;10191;311;1301;1893;5963;2204;7264
315725;201612;1506;4632;1322;4346;205;697;941;3131;1146;3828
315727;201612;571;1714;428;1414;103;391;150;441;253;832
315730;201612;725;2284;650;2089;93;349;338;1029;431;1378
315733;201612;985;2905;808;2551;252;846;267;778;519;1624
315737;201612;1173;3593;895;3044;60;267;596;2005;656;2272
315740;201612;979;2956;782;2531;149;568;397;1161;546;1729
315750;201612;1115;3368;967;3079;52;214;730;2294;782;2508
315760;201612;1031;2686;990;2634;14;45;927;2446;941;2491
315765;201612;1525;4598;1335;4340;46;188;1153;3768;1199;3956
315770;201612;1355;4304;1105;3793;298;1095;257;884;555;1979
315780;201612;20864;67462;17878;60519;3867;13962;6767;21860;10634;35822
315790;201612;3567;11719;3020;10565;864;3017;1491;5317;2355;8334
315800;201612;1234;4800;893;3733;209;918;153;596;362;1514
315810;201612;1306;3492;1090;3144;182;547;691;1911;873;2458
315820;201612;2277;7683;1929;6982;642;2357;729;2761;1371;5118
315830;201612;1109;3607;854;3038;91;401;294;922;385;1323
315840;201612;802;2080;462;1414;79;265;139;387;218;652
315850;201612;917;3233;875;3142;214;853;494;1655;708;2508
315860;201612;499;1662;339;1290;76;336;73;241;149;577
315870;201612;437;1266;349;1116;46;159;204;612;250;771
315880;201612;1164;3001;889;2627;197;686;324;894;521;1580
315890;201612;1448;4936;1259;4542;491;1886;423;1466;914;3352
315895;201612;5123;15978;4085;13518;805;2802;1490;4640;2295;7442
315900;201612;753;2171;709;2094;52;235;578;1583;630;1818
315910;201612;470;1571;430;1496;118;458;254;835;372;1293
315920;201612;1594;4337;788;2573;160;566;158;435;318;1001
315930;201612;1031;2761;689;2124;189;600;177;518;366;1118
315935;201612;881;2936;747;2623;201;780;187;630;388;1410
315940;201612;598;1901;489;1663;95;352;230;766;325;1118
315950;201612;1168;3515;1007;3202;232;721;590;1900;822;2621
315960;201612;3595;11221;2162;8127;727;3101;94;180;821;3281
315970;201612;646;1829;478;1578;43;124;338;1144;381;1268
315980;201612;3678;9035;2177;6420;656;2121;491;1230;1147;3351
315990;201612;3836;10868;2965;9221;549;1911;1417;4245;1966;6156
316000;201612;561;1642;438;1439;116;460;149;452;265;912
316010;201612;619;1976;471;1668;53;226;238;751;291;977
316020;201612;925;3016;812;2796;105;432;554;1797;659;2229
316030;201612;3101;9019;2164;7231;208;773;1329;4436;1537;5209
316040;201612;2948;9336;2021;7207;333;1326;460;1398;793;2724
316045;201612;1925;5998;1733;5629;246;783;1208;3942;1454;4725
316050;201612;353;1110;261;929;55;228;129;420;184;648
316060;201612;689;2043;521;1750;59;280;320;976;379;1256
316070;201612;5975;18396;4868;15889;1064;3783;2017;6201;3081;9984
316080;201612;707;2532;580;2197;121;494;64;238;185;732
316090;201612;514;1585;339;1184;56;226;116;369;172;595
316095;201612;1418;4472;1180;4030;189;625;709;2425;898;3050
316100;201612;2548;8334;1725;6261;443;1736;393;1291;836;3027
316105;201612;922;2604;658;2123;168;566;244;795;412;1361
316110;201612;11804;39504;10275;36665;1613;5766;6432;23508;8045;29274
316120;201612;1098;3483;778;2665;199;708;189;539;388;1247
316130;201612;1478;3382;773;2235;130;421;328;854;458;1275
316140;201612;913;2637;693;2280;100;324;434;1439;534;1763
316150;201612;1460;3930;1221;3485;186;599;719;1969;905;2568
316160;201612;1151;3381;849;2766;162;562;404;1236;566;1798
316165;201612;926;2457;721;2144;139;472;392;1141;531;1613
316170;201612;1255;3504;860;2779;140;480;372;1102;512;1582
316180;201612;1397;4316;877;3088;198;777;160;468;358;1245
316190;201612;2835;8673;1286;4544;256;851;246;774;502;1625
316200;201612;3672;11622;2572;9231;568;2274;631;2102;1199;4376
316210;201612;4427;14191;3475;12072;1143;4140;480;1685;1623;5825
316220;201612;777;2387;486;1737;94;368;48;179;142;547
316225;201612;1161;3206;928;2791;152;528;568;1612;720;2140
316230;201612;419;1194;323;1015;37;128;162;543;199;671
316240;201612;6374;19470;5585;18331;639;2023;4024;13326;4663;15349
316245;201612;3208;10997;2860;10353;204;1049;2170;7532;2374;8581
316250;201612;10113;28930;7100;22653;1908;6451;1575;4671;3483;11122
316255;201612;2525;7488;2155;6985;290;1035;1478;4817;1768;5852
316257;201612;1254;3394;885;2693;195;630;281;811;476;1441
316260;201612;1777;4904;1286;4093;244;809;596;1951;840;2760
316265;201612;1330;3731;919;2895;92;329;562;1739;654;2068
316270;201612;3494;11779;3110;10817;831;3124;1161;3813;1992;6937
316280;201612;3051;9822;2676;9010;439;1604;1444;4664;1883;6268
316290;201612;3263;10009;2486;8334;456;1715;970;3142;1426;4857
316292;201612;3470;10677;2972;9800;442;1630;1902;6012;2344;7642
316294;201612;806;2534;539;1956;116;491;46;156;162;647
316295;201612;1786;5808;1621;5462;151;637;1174;3802;1325;4439
316300;201612;986;3072;808;2739;63;237;509;1742;572;1979
316310;201612;694;1993;420;1457;84;323;133;423;217;746
316320;201612;584;1853;445;1569;78;317;99;301;177;618
316330;201612;941;2854;703;2297;81;284;455;1414;536;1698
316340;201612;890;2821;684;2375;134;529;345;1125;479;1654
316350;201612;1244;3958;1082;3640;166;579;655;2190;821;2769
316360;201612;720;1918;566;1681;106;306;347;1034;453;1340
316370;201612;4346;13679;3378;11569;998;3714;525;1632;1523;5346
316380;201612;1572;4087;1185;3518;60;203;910;2669;970;2872
316390;201612;861;2443;679;2114;158;520;301;945;459;1465
316400;201612;1248;3805;897;3100;196;742;328;1059;524;1801
316410;201612;998;3277;914;3142;146;495;635;2172;781;2667
316420;201612;1924;6045;1650;5642;144;586;1174;3908;1318;4494
316430;201612;903;2743;591;2044;132;484;135;421;267;905
316440;201612;654;2134;506;1869;180;772;82;293;262;1065
316443;201612;627;1836;467;1515;129;462;160;475;289;937
316447;201612;1557;4546;1392;4323;103;351;1164;3610;1267;3961
316450;201612;2118;7040;1725;6191;204;811;1197;4240;1401;5051
316460;201612;736;2257;659;2112;201;657;289;911;490;1568
316470;201612;7056;22271;5232;18306;1394;5446;1307;4231;2701;9677
316480;201612;177;590;143;510;36;132;36;118;72;250
316490;201612;309;936;238;767;44;131;80;229;124;360
316500;201612;1158;4008;678;2574;132;540;40;134;172;674
316510;201612;720;2627;615;2391;215;889;151;570;366;1459
316520;201612;993;2965;786;2583;128;461;300;885;428;1346
316530;201612;831;2658;649;2268;145;604;264;775;409;1379
316540;201612;725;2316;611;2075;79;327;217;675;296;1002
316550;201612;1173;3882;1080;3695;187;720;663;2246;850;2966
316553;201612;1888;6500;1391;5232;403;1614;263;923;666;2537
316555;201612;2823;9518;2458;9005;199;809;1842;6857;2041;7666
316556;201612;626;1582;440;1247;43;131;301;811;344;942
316557;201612;763;2719;694;2579;266;1053;169;564;435;1617
316560;201612;276;996;223;872;51;228;53;191;104;419
316570;201612;1164;3729;968;3289;140;478;466;1597;606;2075
316580;201612;294;799;176;551;45;147;43;125;88;272
316590;201612;1423;3853;953;2993;224;740;454;1308;678;2048
316600;201612;1016;3315;879;3000;251;913;340;1134;591;2047
316610;201612;559;2018;473;1828;80;383;280;1022;360;1405
316620;201612;2158;6438;1754;5682;219;831;1099;3482;1318;4313
316630;201612;1394;4582;1134;3998;490;1759;261;952;751;2711
316640;201612;163;511;131;429;33;137;54;145;87;282
316650;201612;882;3150;759;2942;87;338;521;2066;608;2404
316660;201612;192;495;81;251;7;27;15;37;22;64
316670;201612;1922;5275;1433;4361;574;1867;380;1025;954;2892
316680;201612;1895;5121;1443;4413;130;411;1057;3195;1187;3606
316690;201612;1130;3824;963;3430;260;1030;262;904;522;1934
316695;201612;1051;3270;893;2941;93;326;584;1895;677;2221
316700;201612;357;1047;316;970;27;116;220;622;247;738
316710;201612;2661;9871;2185;8743;870;3621;443;1910;1313;5531
316720;201612;15651;49923;11949;41326;3066;10912;3332;11029;6398;21941
316730;201612;331;1026;285;920;75;264;111;329;186;593
316740;201612;644;2136;569;2003;60;273;398;1373;458;1646
316750;201612;390;1299;305;1090;52;217;109;359;161;576
316760;201612;3431;11246;2849;10327;1436;5431;872;3153;2308;8584
316770;201612;1344;3648;1122;3303;65;255;960;2774;1025;3029
316780;201612;566;1884;451;1634;127;515;55;150;182;665
316790;201612;736;2165;554;1804;141;472;169;541;310;1013
316800;201612;5029;16191;4171;14352;821;3031;2114;6840;2935;9871
316805;201612;778;1963;735;1908;50;123;641;1720;691;1843
316810;201612;590;1775;450;1476;114;414;174;494;288;908
316820;201612;389;1001;193;641;31;119;28;81;59;200
316830;201612;539;1847;499;1753;149;573;212;709;361;1282
316840;201612;2684;8179;2264;7323;479;1778;1022;3110;1501;4888
316850;201612;2022;5752;1588;4986;253;900;883;2676;1136;3576
316860;201612;17361;54093;14020;47439;3177;12009;5495;17535;8672;29544
316870;201612;5980;19110;4462;15478;1291;4773;805;2636;2096;7409
316880;201612;836;2517;679;2223;209;763;183;583;392;1346
316890;201612;1203;2878;849;2354;222;719;475;1193;697;1912
316900;201612;2452;7191;1769;5705;411;1436;523;1482;934;2918
316905;201612;446;1460;368;1280;125;449;120;414;245;863
316910;201612;848;2607;567;2011;143;556;78;240;221;796
316920;201612;1524;4130;1026;3336;276;985;364;1124;640;2109
316930;201612;7638;25664;5562;20793;1223;4857;757;2626;1980;7483
316935;201612;4301;13052;2882;9860;811;2898;620;2049;1431;4947
316940;201612;6531;20982;4793;16835;1093;3919;1049;3418;2142;7337
316950;201612;1555;4175;1244;3710;91;311;951;2762;1042;3073
316960;201612;4543;11518;3483;9938;646;1968;1915;5335;2561;7303
316970;201612;3102;9796;2775;9102;666;2423;1108;3301;1774;5724
316980;201612;913;2756;602;2115;174;678;86;279;260;957
316990;201612;9540;29685;7030;23826;2044;7280;544;1666;2588;8946
317000;201612;2727;9200;2613;9069;257;825;2003;7689;2260;8514
317005;201612;2561;7820;2167;7104;458;1536;1127;3679;1585;5215
317010;201612;26568;65521;14402;45286;3778;12867;2819;9209;6597;22076
317020;201612;63397;170261;32817;105952;6716;23095;6641;19314;13357;42409
317030;201612;649;1933;522;1716;49;211;328;1045;377;1256
317040;201612;9799;28014;7305;23312;1903;6352;2732;8639;4635;14991
317043;201612;683;1827;548;1609;114;322;296;853;410;1175
317047;201612;1075;2867;761;2305;73;234;454;1346;527;1580
317050;201612;1432;4776;1005;3699;209;797;328;1090;537;1887
317052;201612;2198;7148;1998;6785;156;623;1456;4820;1612;5443
317057;201612;1579;4388;1154;3589;93;373;736;2177;829;2550
317060;201612;417;1166;230;750;56;211;56;147;112;358
317065;201612;1218;3787;1048;3458;78;329;765;2459;843;2788
317070;201612;8830;27158;5362;18979;1179;4567;670;2212;1849;6779
317075;201612;1023;3075;735;2402;169;567;166;520;335;1087
317080;201612;6004;16067;4738;13760;1474;4323;1360;3798;2834;8121
317090;201612;4626;15177;4237;14504;513;1651;2973;10335;3486;11986
317100;201612;2894;7747;1945;6060;666;2156;547;1623;1213;3779
317103;201612;1751;6106;1482;5511;211;1014;779;2703;990;3717
317107;201612;1303;3968;1109;3548;121;468;718;2121;839;2589
317110;201612;695;1710;357;1139;53;206;135;441;188;647
317115;201612;1103;3409;904;2983;86;278;635;2102;721;2380
317120;201612;9773;32470;7623;27128;1676;6455;3119;10600;4795;17055
317130;201612;7017;20557;5353;17304;1254;4328;1987;6254;3241;10582
317140;201612;534;1699;465;1561;69;252;291;970;360;1222
317150;201612;969;2663;821;2471;60;217;658;1937;718;2154
317160;201612;3393;8862;2410;7390;162;537;1741;5224;1903;5761
317170;201612;1907;5066;1338;4028;213;706;478;1236;691;1942
317180;201612;1740;5834;1332;4886;345;1331;331;1162;676;2493
317190;201612;1355;3766;1000;3212;96;305;666;2112;762;2417
317200;201612;4298;13273;3397;11289;853;3053;969;3009;1822;6062
317210;201612;897;2731;774;2541;105;441;505;1595;610;2036
317220;201612;276;938;258;908;62;242;122;416;184;658
320010;201612;4727;14731;3864;12876;871;2985;1885;6131;2756;9116
320013;201612;1853;5611;1215;4166;243;857;486;1673;729;2530
320016;201612;2966;8248;2449;7440;251;712;1848;5610;2099;6322
320020;201612;3697;11386;2856;9620;848;2970;855;2863;1703;5833
320030;201612;1648;5205;1159;4064;379;1386;320;1051;699;2437
320035;201612;1744;5162;1461;4678;524;1810;479;1422;1003;3232
320040;201612;3067;9847;2400;8367;541;1972;868;2961;1409;4933
320050;201612;1553;4218;1295;3712;302;924;574;1561;876;2485
320060;201612;10929;34367;7576;26335;1796;6620;1523;4911;3319;11531
320070;201612;1341;4230;997;3436;213;786;275;883;488;1669
320080;201612;5432;15505;3799;12085;883;2859;1173;3735;2056;6594
320090;201612;7650;22172;5653;17924;1544;5087;1982;5947;3526;11034
320100;201612;2492;7856;1919;6616;613;2116;544;1878;1157;3994
320110;201612;1183;3516;949;3038;246;760;247;812;493;1572
320115;201612;1765;6232;1562;5831;846;3276;321;1242;1167;4518
320120;201612;15150;45073;10857;36378;2733;9758;2930;9603;5663;19361
320130;201612;34848;110692;30199;100822;6014;22209;14426;46040;20440;68249
320140;201612;3277;10278;2139;7610;617;2373;327;1104;944;3477
320150;201612;13835;39397;9548;30289;2826;9357;1007;2869;3833;12226
320160;201612;4846;14987;3864;12859;1060;3786;1270;3899;2330;7685
320170;201612;1583;5059;1228;4239;291;1049;485;1636;776;2685
320180;201612;735;2489;613;2237;235;891;123;455;358;1346
320190;201612;3426;11702;2483;9206;660;2535;415;1512;1075;4047
320200;201612;942;2899;739;2514;218;817;206;714;424;1531
320210;201612;4502;12659;3539;10625;750;2444;1636;4519;2386;6963
320220;201612;2040;6345;1652;5590;459;1673;636;2168;1095;3841
320225;201612;1276;4295;929;3422;359;1406;101;353;460;1759
320230;201612;4031;12832;3226;11303;1017;3777;1178;4107;2195;7884
320240;201612;12194;35458;9101;29532;2382;8142;2658;8494;5040;16636
320245;201612;3028;10296;2668;9383;894;3302;553;1854;1447;5156
320250;201612;1830;5537;1175;3980;309;1160;202;588;511;1748
320255;201612;1649;5608;1407;5152;613;2364;435;1638;1048;4002
320260;201612;1010;3041;702;2331;182;650;188;539;370;1189
320265;201612;2386;7610;1973;6814;677;2415;698;2439;1375;4854
320270;201612;2651;7714;1820;6029;443;1572;765;2525;1208;4097
320280;201612;6194;19040;5020;16453;1216;4290;1309;3932;2525;8222
320290;201612;1388;4477;882;3161;282;1049;123;447;405;1496
320300;201612;4067;13537;3437;12039;1071;3952;626;2132;1697;6084
320305;201612;4393;14004;3582;12119;914;3298;1370;4426;2284;7724
320310;201612;1813;5437;1434;4582;357;1169;524;1636;881;2805
320313;201612;2084;5922;1245;3987;334;1152;197;554;531;1706
320316;201612;1650;4936;1259;4080;386;1309;356;1124;742;2433
320320;201612;19210;57337;14041;47138;3888;13928;4418;14306;8306;28234
320330;201612;2874;8462;2262;7327;735;2371;815;2784;1550;5155
320332;201612;5064;16245;4237;14615;1406;5101;1455;4893;2861;9994
320334;201612;1967;6124;1225;4440;318;1257;256;862;574;2119
320335;201612;2196;6453;1212;4064;309;1125;123;326;432;1451
320340;201612;5447;14740;4480;13038;1056;3267;1909;5617;2965;8884
320350;201612;4879;12931;3396;10042;696;2054;1545;4498;2241;6552
320360;201612;1613;4307;1120;3310;185;577;461;1280;646;1857
320370;201612;2751;9078;2124;7537;601;2180;593;2058;1194;4238
320380;201612;2097;6211;1786;5599;402;1351;926;2786;1328;4137
320390;201612;6824;20462;5300;17040;1551;5290;1473;4467;3024;9757
320400;201612;3369;10398;2793;9243;661;2386;1227;3876;1888;6262
320405;201612;4184;12147;3511;10878;752;2445;1867;5613;2619;8058
320410;201612;5193;14204;3707;11888;901;3030;1603;5172;2504;8202
320420;201612;2324;6937;1729;5785;535;1962;432;1376;967;3338
320425;201612;1954;5095;1459;4200;179;533;929;2614;1108;3147
320430;201612;2486;6918;2016;5910;405;1234;1077;3011;1482;4245
320435;201612;2689;8603;2085;7324;1001;3658;458;1653;1459;5311
320440;201612;1010;3299;834;2834;197;746;289;914;486;1660
320450;201612;1874;5850;1451;4936;402;1469;570;1847;972;3316
320455;201612;4015;13055;2718;9770;799;3049;581;1966;1380;5015
320460;201612;2565;8128;1754;6163;440;1663;372;1186;812;2849
320465;201612;1547;4728;1102;3716;174;637;551;1822;725;2459
320470;201612;4073;12092;2601;8750;795;2882;463;1433;1258;4315
320480;201612;1666;5218;1361;4540;356;1278;526;1666;882;2944
320490;201612;15066;45786;12018;39792;3395;12260;3625;11659;7020;23919
320495;201612;1290;3705;729;2494;232;823;76;273;308;1096
320500;201612;46487;138209;38838;123492;8622;29038;18698;57489;27320;86527
320501;201612;4597;13872;3397;11716;1107;4236;811;2535;1918;6771
320503;201612;1862;6255;1393;5193;562;2270;359;1143;921;3413
320506;201612;4040;12363;2511;8558;725;2574;49;127;774;2701
320510;201612;8220;25318;6797;22427;1475;5249;3359;10720;4834;15969
320515;201612;1816;5263;1387;4275;417;1331;276;818;693;2149
320517;201612;2078;6648;1580;5564;524;1989;351;1192;875;3181
320520;201612;35452;105704;27463;89985;6873;24392;9590;30442;16463;54834
320530;201612;26843;80219;21263;68986;3950;14587;10672;32088;14622;46675
330010;201612;19673;59562;17080;54307;3886;13043;8801;27391;12687;40434
330015;201612;1471;4117;1200;3584;197;691;581;1657;778;2348
330020;201612;17039;49698;15117;46223;2820;9455;8829;25951;11649;35406
330022;201612;1823;5360;1482;4747;277;1000;809;2495;1086;3495
330023;201612;3066;9406;2548;8451;732;2579;717;2252;1449;4831
330025;201612;4401;11846;3279;9842;802;2540;1622;4792;2424;7332
330030;201612;7960;26222;6715;23553;1383;5224;3186;10561;4569;15785
330040;201612;11161;33452;9812;30602;2109;7002;5291;15814;7400;22816
330045;201612;72786;197144;60927;178686;8146;25217;40958;117185;49104;142402
330050;201612;2321;7015;1827;6020;520;1827;612;1843;1132;3670
330060;201612;5508;15713;4509;14037;1132;3853;2185;6508;3317;10361
330070;201612;19179;57855;16641;53221;3639;12359;7996;25264;11635;37623
330080;201612;7686;21631;6906;20281;671;2005;4874;14203;5545;16208
330090;201612;2553;6793;2185;6166;360;1111;1229;3330;1589;4441
330093;201612;1892;5632;1503;4888;303;983;680;2324;983;3307
330095;201612;964;3253;799;2863;175;708;280;925;455;1633
330100;201612;56918;176244;50139;164037;7864;28486;29028;93121;36892;121607
330110;201612;2177;6837;1835;6161;484;1703;597;1947;1081;3650
330115;201612;1712;4918;1432;4434;271;929;790;2331;1061;3260
330120;201612;2596;7083;2241;6510;388;1276;1337;3736;1725;5012
330130;201612;3250;10498;2803;9641;681;2487;1313;4364;1994;6851
330140;201612;2981;9186;2627;8566;554;1995;1415;4494;1969;6489
330150;201612;1986;5928;1489;4878;393;1339;364;1181;757;2520
330160;201612;1133;3545;961;3223;256;967;432;1338;688;2305
330170;201612;97105;290701;85572;269722;18545;60168;45391;140600;63936;200768
330180;201612;1995;5802;1601;5026;112;447;1046;3089;1158;3536
330185;201612;8076;24756;6751;22012;1366;4804;3611;11346;4977;16150
330187;201612;3707;10559;3057;9398;497;1638;1919;5732;2416;7370
330190;201612;24635;69551;22629;66204;3760;11455;15689;45464;19449;56919
330200;201612;13576;42383;11742;39003;3174;10758;5530;18461;8704;29219
330205;201612;1983;5490;1639;4846;248;779;1007;2871;1255;3650
330210;201612;3047;8452;2292;6892;696;2117;635;1858;1331;3975
330220;201612;9871;29847;7924;25453;2041;6908;1855;5405;3896;12313
330225;201612;3633;11246;3004;9951;358;1459;1774;5526;2132;6985
330227;201612;16399;47190;14385;43976;3173;9827;8214;25355;11387;35182
330230;201612;1189;3563;1037;3282;180;671;589;1749;769;2420
330240;201612;16968;51604;13696;44963;4360;15208;3877;11953;8237;27161
330245;201612;1180;3577;805;2795;219;798;137;430;356;1228
330250;201612;34022;99689;29749;91810;9016;27736;11120;35302;20136;63038
330260;201612;4027;12487;3293;10873;613;2175;1417;4403;2030;6578
330270;201612;19156;43415;11829;32929;2890;8819;4300;11674;7190;20493
330280;201612;2162;6386;1713;5449;296;1028;848;2508;1144;3536
330285;201612;17842;50744;15613;47039;2716;8729;9506;28000;12222;36729
330290;201612;3140;9110;2688;8299;457;1552;1497;4424;1954;5976
330300;201612;3158;10224;2757;9395;439;1677;1614;5222;2053;6899
330310;201612;2112;5963;1725;5252;248;755;1060;3190;1308;3945
330320;201612;12759;38222;11755;36491;1612;5444;8582;26133;10194;31577
330330;201612;26960;73640;22695;66382;3954;12670;13677;38222;17631;50892
330340;201612;13727;39574;9974;32226;2427;8168;3252;10112;5679;18280
330350;201612;83707;243310;73403;226790;11018;35730;49170;150143;60188;185873
330360;201612;5818;17064;5410;16359;495;1677;4150;12266;4645;13943
330370;201612;3432;12083;2953;10924;1041;3951;843;3085;1884;7036
330380;201612;4862;15683;3918;13601;899;3421;1321;4304;2220;7725
330385;201612;3764;12972;3305;11955;1026;3897;1214;4383;2240;8280
330390;201612;21581;70146;18137;62643;4538;16692;7373;24633;11911;41325
330395;201612;2986;8700;2602;8013;241;889;1777;5279;2018;6168
330400;201612;2533;7862;2235;7259;259;1062;1417;4205;1676;5267
330410;201612;2614;7997;2015;6753;412;1493;939;2990;1351;4483
330411;201612;2215;6872;1850;6044;234;869;1113;3433;1347;4302
330412;201612;1325;4451;1054;3825;216;868;488;1637;704;2505
330414;201612;22743;64092;19372;58857;4122;12133;11050;33855;15172;45988
330415;201612;3191;9867;2570;8602;683;2295;953;3158;1636;5453
330420;201612;9493;26723;5763;19390;1292;4561;1269;4050;2561;8611
330430;201612;6948;20586;5867;18386;1300;4306;2584;7773;3884;12079
330440;201612;1505;5020;1265;4472;406;1574;319;998;725;2572
330450;201612;1302;4291;1126;3956;245;1025;585;1953;830;2978
330452;201612;13179;38336;9995;31883;2556;8643;3908;11837;6464;20480
330455;201612;479693;1309563;369942;1118409;82514;259992;187768;551393;270282;811385
330460;201612;1132;3644;949;3271;201;758;418;1392;619;2150
330470;201612;4200;12532;3594;11377;821;2783;1684;5117;2505;7900
330475;201612;7528;23193;6422;21113;2012;7087;2240;7022;4252;14109
330480;201612;5425;15845;4698;14621;855;2793;2709;8113;3564;10906
330490;201612;105752;276494;90920;252428;10025;28975;64645;176687;74670;205662
330500;201612;5075;15539;4795;14994;652;2230;3317;10179;3969;12409
330510;201612;35621;108544;30659;99697;10255;33249;12133;39897;22388;73146
330513;201612;1309;3953;1184;3719;381;1193;465;1477;846;2670
330515;201612;2924;8978;2445;7990;759;2442;648;2092;1407;4534
330520;201612;10569;31994;9036;28910;1884;6302;4076;12651;5960;18953
330530;201612;1383;4071;1142;3551;297;1012;491;1431;788;2443
330540;201612;2841;8340;2192;7046;588;1957;754;2295;1342;4252
330550;201612;7562;25250;6351;22620;2788;10199;828;2959;3616;13158
330555;201612;9625;28461;8360;26399;1696;5413;4961;15823;6657;21236
330560;201612;4138;12398;3536;11161;600;2058;1877;5575;2477;7633
330570;201612;3057;9038;2459;7901;650;2162;1151;3614;1801;5776
330575;201612;5021;14252;4350;12954;612;2072;2893;8176;3505;10248
330580;201612;12870;40286;10311;34697;2825;9840;3869;12801;6694;22641
330590;201612;1478;4547;1360;4330;239;779;899;2869;1138;3648
330600;201612;10682;31118;8164;26415;1387;4922;4025;12576;5412;17498
330610;201612;8459;26375;7381;24234;1240;4537;4217;13302;5457;17839
330615;201612;1551;5480;1422;5230;651;2538;334;1241;985;3779
330620;201612;3332;11559;2819;10360;947;3694;565;1998;1512;5692
330630;201612;22276;64263;17238;54748;2741;9767;9863;29691;12604;39458
350010;201612;1696;4960;1014;3478;263;926;108;326;371;1252
350020;201612;435;1180;274;851;41;139;150;430;191;569
350030;201612;4335;13523;3129;10931;1006;3709;700;2341;1706;6050
350040;201612;434;1460;295;1124;61;243;84;304;145;547
350050;201612;837;2555;629;2119;144;551;202;559;346;1110
350055;201612;611;1781;496;1583;92;309;286;885;378;1194
350060;201612;114;352;89;309;22;83;42;147;64;230
350070;201612;3708;10889;2102;7272;436;1572;461;1402;897;2974
350075;201612;512;1708;369;1371;136;501;62;213;198;714
350080;201612;620;1795;348;1152;63;220;128;390;191;610
350090;201612;585;1539;350;1058;102;278;114;351;216;629
350100;201612;1832;5675;1199;4274;243;965;366;1196;609;2161
350110;201612;446;1349;301;1003;29;117;176;566;205;683
350115;201612;1192;3561;1000;3139;189;655;528;1486;717;2141
350120;201612;614;1624;254;831;59;201;52;154;111;355
350130;201612;3192;9448;2622;8198;354;1241;1510;4424;1864;5665
350140;201612;568;1853;448;1611;56;232;247;861;303;1093
350150;201612;427;1408;356;1248;125;456;66;234;191;690
350160;201612;7869;22742;4958;16651;1077;3973;2136;6479;3213;10452
350170;201612;1448;4904;1129;4049;300;1134;238;789;538;1923
350180;201612;1003;2786;571;1796;98;320;278;834;376;1154
350190;201612;2996;9231;2254;7527;506;1921;954;2694;1460;4615
350200;201612;364;1121;312;1018;24;80;214;687;238;767
350210;201612;4584;12154;3099;9504;850;2687;1283;3825;2133;6512
350220;201612;2323;7351;1899;6334;398;1567;870;2625;1268;4192
350230;201612;692;2208;585;1975;131;470;248;819;379;1289
350240;201612;507;1546;379;1237;45;151;216;676;261;827
350250;201612;1926;6928;1717;6481;628;2499;473;1757;1101;4256
350260;201612;950;2507;585;1797;103;321;257;741;360;1062
350270;201612;4845;14700;3845;12403;719;2448;1692;5134;2411;7582
350275;201612;1834;5985;1611;5558;481;1738;565;1872;1046;3610
350280;201612;21117;51095;11728;34295;2607;7867;3109;8768;5716;16635
350290;201612;2123;6685;1540;5356;332;1241;492;1584;824;2825
350300;201612;529;1502;368;1144;88;268;185;555;273;823
350310;201612;852;2815;680;2377;95;389;286;930;381;1319
350315;201612;484;1533;327;1151;52;218;78;236;130;454
350320;201612;10059;31380;8395;27895;2405;8278;1265;4299;3670;12577
350330;201612;13981;38596;8496;25830;1943;5622;2946;8402;4889;14024
350335;201612;368;1143;311;1022;23;65;234;772;257;837
350340;201612;1030;3021;657;2241;124;463;213;708;337;1171
350350;201612;669;2084;535;1822;99;368;187;606;286;974
350360;201612;818;2768;653;2365;158;550;270;994;428;1544
350370;201612;519;1535;336;1105;74;250;72;217;146;467
350380;201612;4024;11663;2556;8751;643;2375;678;2064;1321;4439
350390;201612;8946;27226;7337;23882;2248;7429;2581;8105;4829;15534
350395;201612;357;979;157;541;20;74;45;135;65;209
350400;201612;7701;21947;5727;18049;1368;4653;2122;6241;3490;10894
350410;201612;8011;26342;5766;21233;1589;6270;1085;3661;2674;9931
350420;201612;519;1620;363;1319;82;342;23;80;105;422
350430;201612;663;2070;540;1838;82;328;319;1029;401;1357
350440;201612;1220;3813;983;3212;236;757;440;1425;676;2182
350450;201612;7198;22225;5384;18210;1258;4498;1378;4314;2636;8812
350460;201612;1344;3609;746;2389;141;513;284;817;425;1330
350470;201612;225;606;177;519;26;99;110;294;136;393
350480;201612;735;2189;470;1630;76;290;95;290;171;580
350490;201612;1788;5354;1415;4622;338;1157;464;1372;802;2529
350500;201612;533;1601;439;1411;74;282;233;707;307;989
350510;201612;1027;3104;698;2350;111;417;309;967;420;1384
350520;201612;1465;5372;1074;4293;224;963;266;1003;490;1966
350530;201612;2226;6478;1677;5280;504;1600;494;1459;998;3059
350535;201612;1203;3899;1092;3680;176;727;682;2153;858;2880
350540;201612;1698;4751;1213;3847;322;1031;428;1359;750;2390
350550;201612;10055;26489;6324;19864;1241;4322;2342;6812;3583;11134
350560;201612;3197;10449;2638;9036;362;1243;1453;4897;1815;6140
350570;201612;17109;55421;14383;49406;4585;16622;5045;16281;9630;32903
350580;201612;1619;5148;924;3304;182;674;96;268;278;942
350590;201612;3735;11480;2760;9396;731;2753;1064;3232;1795;5985
350600;201612;40899;100311;24552;70052;4274;12868;10899;28645;15173;41513
350610;201612;6464;19234;4877;15992;1066;3705;2024;6324;3090;10029
350620;201612;377;1080;274;903;43;162;115;341;158;503
350630;201612;1565;4492;1077;3513;174;665;462;1333;636;1998
350635;201612;6508;18861;4778;15587;1106;3911;1990;6150;3096;10061
350640;201612;776;2400;470;1601;80;287;102;317;182;604
350650;201612;7571;22617;4185;14308;971;3564;851;2591;1822;6155
350660;201612;4724;13598;3549;11344;731;2445;1782;5495;2513;7940
350670;201612;1441;4486;1276;4133;282;922;670;2117;952;3039
350680;201612;984;2917;700;2329;162;583;278;901;440;1484
350690;201612;803;2633;583;2106;121;463;201;665;322;1128
350700;201612;4133;12033;2571;9008;708;2627;805;2493;1513;5120
350710;201612;2680;8260;2228;7317;352;1270;1269;4016;1621;5286
350715;201612;736;2248;639;2042;155;520;290;851;445;1371
350720;201612;128;367;108;330;32;93;31;96;63;189
350730;201612;392;1416;351;1307;70;285;147;529;217;814
350740;201612;1698;5169;1084;3655;207;772;287;850;494;1622
350745;201612;493;1527;278;951;41;143;132;413;173;556
350750;201612;8750;26665;6696;22193;1532;5499;1762;5260;3294;10759
350760;201612;12680;36680;9446;30349;2483;8483;2426;6866;4909;15349
350770;201612;638;1807;403;1309;40;128;244;770;284;898
350775;201612;577;1519;452;1314;57;205;232;636;289;841
350780;201612;1777;5405;1248;4282;433;1579;166;555;599;2134
350790;201612;1784;5502;1192;4205;255;929;209;637;464;1566
350800;201612;2892;9549;2622;8975;493;1879;1357;4432;1850;6311
350810;201612;1918;5418;1593;4925;432;1392;704;2228;1136;3620
350820;201612;559;1533;367;1135;61;213;165;477;226;690
350830;201612;819;2518;479;1691;71;271;131;400;202;671
350840;201612;2341;8185;1818;6883;587;2275;382;1398;969;3673
350850;201612;5639;18693;4506;15989;1433;5300;957;3280;2390;8580
350860;201612;3051;9307;2792;8849;147;621;2205;6820;2352;7441
350870;201612;2601;8233;2004;7104;449;1753;1074;3754;1523;5507
350880;201612;1229;4050;918;3275;210;776;229;792;439;1568
350890;201612;640;1796;341;1109;45;158;101;273;146;431
350900;201612;4374;13687;2830;10070;834;3147;293;957;1127;4104
350910;201612;814;2387;683;2108;195;658;305;873;500;1531
350920;201612;10496;29514;8976;26631;885;2931;6523;18457;7408;21388
350925;201612;4314;13430;3254;11151;786;2837;1114;3277;1900;6114
350930;201612;1384;3832;929;2876;119;394;536;1562;655;1956
350940;201612;1718;5649;1507;5195;273;1057;850;2779;1123;3836
350945;201612;901;2796;697;2366;125;492;354;1096;479;1588
350950;201612;71657;213663;54812;175288;11596;39878;25045;74427;36641;114305
350960;201612;4672;15302;3809;13349;768;3010;1939;6338;2707;9348
350970;201612;3966;13551;3069;11299;986;3817;502;1571;1488;5388
350980;201612;576;1874;498;1719;212;788;137;447;349;1235
350990;201612;1705;5652;1290;4785;357;1407;353;1235;710;2642
350995;201612;736;2479;674;2334;83;385;445;1421;528;1806
351000;201612;2761;8168;2110;6838;405;1371;844;2522;1249;3893
351010;201612;313;910;170;567;38;135;64;206;102;341
351015;201612;720;2460;599;2218;122;485;287;1042;409;1527
351020;201612;7629;23715;6389;21488;1645;5675;2948;9831;4593;15506
351030;201612;1821;6283;1473;5371;356;1416;479;1621;835;3037
351040;201612;3366;9971;2942;9149;377;1294;2049;6120;2426;7414
351050;201612;14911;41242;9578;31360;2481;8567;2852;9068;5333;17635
351060;201612;36019;103042;27934;87686;5367;18316;14040;42298;19407;60614
351070;201612;1365;3817;807;2719;188;686;80;219;268;905
351080;201612;2507;7304;1879;6391;464;1697;845;2684;1309;4381
351090;201612;336;1150;235;911;53;220;37;138;90;358
351100;201612;2331;6953;1455;4780;375;1267;391;1272;766;2539
351110;201612;7072;18110;3655;12044;832;2986;898;2754;1730;5740
351120;201612;641;1877;459;1464;75;267;211;576;286;843
351130;201612;958;2669;461;1596;82;295;90;274;172;569
351140;201612;1619;5428;1257;4587;404;1540;241;809;645;2349
351150;201612;1386;4792;876;3392;175;683;89;281;264;964
351160;201612;1131;3936;936;3432;241;910;287;938;528;1848
351170;201612;1281;4031;1004;3367;159;569;510;1587;669;2156
351190;201612;789;2502;561;1903;90;305;175;564;265;869
351200;201612;1799;5272;1405;4439;207;719;586;1699;793;2418
351210;201612;1116;3178;711;2313;117;404;281;821;398;1225
351220;201612;2833;9498;2489;8693;422;1596;1347;4534;1769;6130
351230;201612;1701;5253;1338;4509;270;1041;662;2073;932;3114
351240;201612;1067;3257;743;2519;200;665;236;743;436;1408
351250;201612;899;2641;501;1671;88;294;181;563;269;857
351260;201612;880;2571;709;2201;209;630;230;688;439;1318
351270;201612;299;995;251;887;62;229;87;255;149;484
351280;201612;5019;14217;3426;10890;644;2203;1394;4155;2038;6358
351290;201612;932;2637;611;1957;134;440;260;792;394;1232
351300;201612;12137;38533;8387;30125;1999;7761;2658;9204;4657;16965
351310;201612;2838;8580;2187;7249;409;1505;1020;3102;1429;4607
351320;201612;821;2730;623;2184;120;466;226;712;346;1178
351330;201612;253;700;178;564;58;169;33;96;91;265
351340;201612;5432;17974;4357;15655;1301;4806;1509;5293;2810;10099
351350;201612;7110;22674;5912;19988;1629;5697;2090;6676;3719;12373
351360;201612;3818;11807;3333;10770;831;2955;992;2817;1823;5772
351370;201612;2163;6677;1581;5309;346;1272;648;1940;994;3212
351380;201612;36372;104507;31088;93909;6246;19889;14096;41238;20342;61127
351385;201612;256;760;165;556;25;90;64;184;89;274
351390;201612;1121;3534;899;3046;224;902;379;1105;603;2007
351400;201612;909;2970;828;2777;235;841;388;1266;623;2107
351410;201612;2309;6982;1900;6104;309;980;1116;3514;1425;4494
351420;201612;285;779;171;546;34;97;47;153;81;250
351430;201612;738;2337;684;2240;115;405;476;1541;591;1946
351440;201612;2998;8993;1979;6557;402;1341;266;803;668;2144
351450;201612;1491;4209;1063;3407;314;1037;334;1096;648;2133
351460;201612;633;1891;528;1683;272;855;128;403;400;1258
351470;201612;971;2884;798;2522;145;520;389;1134;534;1654
351480;201612;2652;8536;2335;7931;356;1526;1312;4151;1668;5677
351490;201612;1684;5530;1421;4901;139;590;852;2730;991;3320
351492;201612;257;820;193;647;10;38;112;359;122;397
351495;201612;194;623;136;466;29;118;61;192;90;310
351500;201612;28347;78362;19683;61460;4937;16345;7792;22790;12729;39135
351510;201612;8762;26416;6751;22160;1607;5550;3208;10226;4815;15776
351512;201612;477;1382;327;1020;55;162;150;465;205;627
351515;201612;2248;6802;1421;4875;339;1261;358;1060;697;2321
351518;201612;2083;6298;1334;4795;323;1282;476;1515;799;2797
351519;201612;759;2239;487;1609;81;293;123;293;204;586
351520;201612;629;1698;272;964;49;186;66;215;115;401
351530;201612;355;1094;192;645;24;70;49;136;73;206
351535;201612;2265;5816;1652;4784;124;439;1129;3087;1253;3526
351540;201612;1681;4980;1234;4028;419;1453;167;482;586;1935
351550;201612;4761;13996;3112;10138;571;2019;1341;4101;1912;6120
351560;201612;399;1287;317;1091;74;289;43;131;117;420
351565;201612;161;546;139;489;28;95;54;180;82;275
351570;201612;12737;37826;10098;32131;2047;7037;5639;17079;7686;24116
351580;201612;307;846;161;518;48;135;37;130;85;265
351590;201612;439;1113;242;710;20;65;129;352;149;417
351600;201612;1756;4839;1362;4075;158;545;839;2360;997;2905
351610;201612;663;1783;448;1380;48;155;222;606;270;761
351620;201612;17655;55479;12857;44909;2571;9885;3774;11598;6345;21483
351630;201612;21010;64013;18155;58721;4100;13797;10065;31554;14165;45351
351640;201612;13004;38174;10198;32813;1712;5953;6045;18757;7757;24710
351650;201612;417;1255;175;620;31;122;32;91;63;213
351660;201612;765;2405;492;1681;109;387;91;260;200;647
351670;201612;3807;11960;2853;9556;531;1965;1316;4047;1847;6012
351680;201612;556;1720;288;1003;64;217;53;181;117;398
351685;201612;398;1264;328;1114;89;269;137;472;226;741
351690;201612;1034;3069;700;2294;119;395;293;877;412;1272
351700;201612;1024;3015;840;2615;215;629;314;978;529;1607
351710;201612;520;1720;407;1423;59;209;170;570;229;779
351720;201612;1482;4461;930;3109;182;642;294;919;476;1561
351730;201612;1042;2931;762;2450;157;556;326;1003;483;1559
351740;201612;3921;10674;2878;8494;586;1804;1149;3166;1735;4970
351750;201612;1083;3429;603;2224;119;456;174;645;293;1101
351760;201612;3287;10145;2395;8064;660;2392;688;2075;1348;4467
351770;201612;2107;6614;1694;5753;509;1768;662;2147;1171;3915
351780;201612;1409;3914;663;2139;121;430;158;462;279;892
351790;201612;1067;3008;863;2647;191;538;458;1424;649;1962
351800;201612;477;1062;224;608;40;106;77;209;117;315
351810;201612;964;2765;788;2434;98;280;537;1617;635;1897
351820;201612;2436;7662;1570;5616;297;1114;150;506;447;1620
351830;201612;4065;12430;2905;9813;490;1842;1465;4628;1955;6470
351840;201612;6518;21920;5427;19449;1326;5005;1976;6746;3302;11751
351850;201612;2016;5342;1286;4017;176;681;678;1880;854;2561
351860;201612;3075;9737;2518;8477;611;2162;1078;3496;1689;5658
351870;201612;26173;77274;20792;66791;6594;21788;7496;23716;14090;45504
351880;201612;111017;341119;87717;290693;26070;90533;23106;71400;49176;161933
351885;201612;608;2075;528;1874;153;544;205;695;358;1239
351890;201612;588;1822;428;1462;105;376;68;207;173;583
351900;201612;1151;3513;892;3035;240;831;262;869;502;1700
351905;201612;451;1391;334;1138;42;147;180;563;222;710
351907;201612;18237;52903;14352;45121;1208;4606;9898;29742;11106;34348
351910;201612;996;3051;739;2440;172;597;302;937;474;1534
351920;201612;943;2534;723;2167;90;304;408;1181;498;1485
351925;201612;957;2884;737;2393;126;460;314;919;440;1379
351930;201612;2583;8187;2435;7887;623;2213;1551;4780;2174;6993
351940;201612;927;2796;723;2367;123;424;342;1107;465;1531
351950;201612;1476;4004;955;2973;117;390;489;1485;606;1875
351960;201612;4333;12467;3012;9817;702;2492;1285;4027;1987;6519
351970;201612;5304;18751;4528;17019;1203;4819;1661;5950;2864;10769
351980;201612;859;2517;565;1839;121;431;196;545;317;976
351990;201612;1418;3943;975;3021;194;709;226;557;420;1266
352000;201612;2194;7152;1884;6411;347;1261;919;2895;1266;4156
352010;201612;1527;5100;1235;4393;277;1020;207;735;484;1755
352020;201612;1353;4212;1111;3699;276;964;432;1360;708;2324
352030;201612;4677;13629;3708;12059;877;2979;1889;6067;2766;9046
352040;201612;1918;6119;1326;4707;272;1038;211;666;483;1704
352042;201612;3425;9353;1940;6067;392;1304;858;2596;1250;3900
352044;201612;1734;5215;952;3462;164;609;201;644;365;1253
352050;201612;10751;32353;6614;22707;1564;5809;1212;3614;2776;9423
352060;201612;677;2049;511;1672;103;379;201;577;304;956
352070;201612;770;1935;572;1583;125;373;199;538;324;911
352080;201612;415;1197;234;770;48;169;79;229;127;398
352090;201612;1258;4275;925;3381;158;612;242;804;400;1416
352100;201612;2806;8475;2072;6988;561;2005;835;2600;1396;4605
352110;201612;500;1718;406;1495;104;386;145;503;249;889
352115;201612;467;1474;383;1303;48;150;237;802;285;952
352120;201612;883;2785;670;2347;107;422;339;1064;446;1486
352130;201612;1741;5198;1033;3477;259;883;199;626;458;1509
352140;201612;1674;4760;888;2991;139;480;333;1056;472;1536
352150;201612;752;2233;550;1810;146;498;267;843;413;1341
352160;201612;959;2628;684;2090;143;476;222;584;365;1060
352170;201612;2636;7914;2221;6931;454;1506;1112;3224;1566;4730
352180;201612;2937;8369;2317;7025;598;1895;797;2276;1395;4171
352190;201612;1123;3354;838;2708;134;507;294;772;428;1279
352200;201612;364;1256;254;987;36;154;93;334;129;488
352210;201612;15785;42666;12354;37189;2133;6793;7549;22529;9682;29322
352215;201612;526;1614;460;1495;62;221;277;864;339;1085
352220;201612;11713;36786;8957;30806;3017;10895;1948;6567;4965;17462
352230;201612;11854;39627;9540;34598;2676;10362;3078;10425;5754;20787
352240;201612;11737;33539;8526;27433;2466;8694;2538;7165;5004;15859
352250;201612;21784;69048;18137;61165;5637;19948;5710;18837;11347;38785
352260;201612;5128;14517;3031;9827;654;2314;1129;3270;1783;5584
352265;201612;851;2668;706;2394;76;312;466;1498;542;1810
352270;201612;1534;5279;1165;4359;296;1159;309;1128;605;2287
352280;201612;2162;6424;1632;5349;413;1481;636;1907;1049;3388
352290;201612;1078;3398;867;2881;178;685;374;1106;552;1791
352300;201612;945;2721;639;2049;128;471;296;846;424;1317
352310;201612;43723;127383;32937;106864;9545;31424;14666;46953;24211;78377
352320;201612;5244;15996;4205;13690;1093;3699;1377;3988;2470;7687
352330;201612;1925;6118;1571;5535;498;1863;429;1449;927;3312
352340;201612;4846;15205;3391;12168;953;3601;691;2241;1644;5842
352350;201612;1570;5253;1323;4654;228;910;492;1593;720;2503
352360;201612;942;2880;830;2661;149;564;551;1657;700;2221
352370;201612;796;2711;684;2428;90;357;384;1287;474;1644
352380;201612;855;2747;681;2374;206;769;147;474;353;1243
352390;201612;18850;49315;11344;34668;2013;6915;5602;15700;7615;22615
352400;201612;3370;9636;2111;7016;636;2152;492;1498;1128;3650
352410;201612;2627;7952;2150;7048;496;1677;926;2899;1422;4576
352420;201612;810;2239;593;1801;132;402;253;725;385;1127
352430;201612;5899;17589;4669;15342;1631;5676;1352;4289;2983;9965
352440;201612;15223;46039;11663;38464;2758;9595;4505;14177;7263;23772
352450;201612;594;1818;345;1226;76;300;105;346;181;646
352460;201612;2324;7371;1786;6226;484;1801;487;1519;971;3320
352470;201612;3583;9998;2371;7552;334;1159;1117;3259;1451;4418
352480;201612;3887;10392;2664;8004;561;1860;1078;2829;1639;4689
352490;201612;625;2198;468;1772;83;331;125;465;208;796
352500;201612;7796;21775;6219;19078;3075;9631;1144;2819;4219;12450
352510;201612;2669;8359;2036;7074;597;2168;522;1756;1119;3924
352520;201612;1882;6600;1570;5793;433;1640;576;2080;1009;3720
352530;201612;8141;25664;5430;18895;1394;5115;693;1887;2087;7002
352540;201612;514;1601;327;1136;57;199;100;337;157;536
352550;201612;846;2758;535;2002;135;544;115;371;250;915
352560;201612;597;1788;369;1224;57;182;88;248;145;430
352570;201612;1775;5700;1190;4362;286;1146;169;497;455;1643
352580;201612;808;2418;566;1873;119;402;189;556;308;958
352585;201612;256;811;190;654;37;140;67;220;104;360
352590;201612;11865;36099;9081;30222;3146;10983;3201;9647;6347;20630
352600;201612;1699;5197;1291;4242;301;1041;525;1611;826;2652
352610;201612;3180;9759;2320;8031;597;2259;678;2139;1275;4398
352620;201612;5006;15159;4278;13836;1094;3607;1887;5928;2981;9535
352630;201612;587;1833;507;1636;117;435;213;610;330;1045
352640;201612;2373;7221;1925;6287;200;708;1264;4026;1464;4734
352650;201612;740;2248;482;1604;90;311;141;417;231;728
352660;201612;888;3138;699;2679;151;620;188;700;339;1320
352670;201612;10668;31549;5574;19693;1281;4884;387;1228;1668;6112
352680;201612;2801;9216;2007;7317;442;1792;717;2332;1159;4124
352690;201612;29889;81646;19799;60532;2765;9177;10658;30698;13423;39875
352700;201612;559;1681;457;1503;141;503;172;527;313;1030
352710;201612;5217;15011;3536;11420;936;3244;1158;3444;2094;6688
352720;201612;7492;23915;6333;21075;2176;7303;1709;5475;3885;12778
352725;201612;412;1144;189;624;31;123;80;234;111;357
352730;201612;2114;6916;1811;6086;388;1387;725;2150;1113;3537
352740;201612;2061;5449;1484;4456;210;722;882;2491;1092;3213
352750;201612;457;1308;217;736;24;92;52;159;76;251
352760;201612;1165;3930;856;3089;285;1037;178;599;463;1636
352770;201612;742;2291;576;1909;123;438;219;679;342;1117
352780;201612;605;2034;438;1603;87;331;144;506;231;837
352790;201612;624;1777;408;1349;78;260;110;349;188;609
352800;201612;1016;3590;680;2623;153;628;193;661;346;1289
352810;201612;973;2532;555;1683;115;348;189;531;304;879
352820;201612;608;1625;395;1264;77;262;86;262;163;524
352830;201612;484;1398;247;799;38;130;38;102;76;232
352840;201612;3748;12461;3195;11199;900;3282;1267;4241;2167;7523
352850;201612;9339;26589;6538;21694;1775;6199;2274;7235;4049;13434
352860;201612;765;2598;665;2358;140;526;244;803;384;1329
352870;201612;872;2188;529;1450;69;242;292;695;361;937
352880;201612;2127;5785;1385;4209;240;746;587;1629;827;2375
352885;201612;221;721;194;660;20;63;129;425;149;488
352890;201612;640;1672;405;1173;61;209;168;418;229;627
352900;201612;18454;53257;12278;40040;2582;9096;4620;13926;7202;23022
352910;201612;366;1052;187;631;21;75;43;127;64;202
352920;201612;2285;6750;1591;5211;297;1075;733;2202;1030;3277
352930;201612;5361;16607;3975;13377;845;3000;1271;3963;2116;6963
352940;201612;20898;66476;16086;54954;5093;18687;1532;4426;6625;23113
352950;201612;336;960;183;649;43;171;26;77;69;248
352960;201612;581;1740;302;1053;49;181;96;282;145;463
352965;201612;361;1034;203;655;42;139;35;96;77;235
352970;201612;3052;7574;2359;6480;227;655;1688;4583;1915;5238
352980;201612;1054;3329;867;3004;185;647;488;1728;673;2375
352990;201612;3954;12221;3308;10978;879;3231;1388;4228;2267;7459
353000;201612;429;1217;200;670;25;85;39;121;64;206
353010;201612;2869;7862;1907;5915;466;1590;527;1396;993;2986
353020;201612;3883;10536;1972;6211;368;1185;660;1830;1028;3015
353030;201612;3344;9806;2429;7950;687;2338;424;1309;1111;3647
353040;201612;455;1292;348;1064;71;238;112;308;183;546
353050;201612;4517;14999;3490;12614;996;3720;1229;4195;2225;7915
353060;201612;39348;114078;32591;101684;3666;13502;23053;67886;26719;81388
353070;201612;9746;29863;6396;22271;1600;5863;1680;5690;3280;11553
353080;201612;4607;14351;2923;10453;695;2675;736;2389;1431;5064
353090;201612;507;1720;439;1537;40;170;276;892;316;1062
353100;201612;276;772;103;349;18;59;19;51;37;110
353110;201612;6973;21345;5881;19437;1143;4081;3580;11684;4723;15765
353120;201612;642;1908;381;1287;71;257;105;298;176;555
353130;201612;2201;6331;1622;5311;501;1745;510;1585;1011;3330
353140;201612;2119;5851;1569;4683;330;1057;777;2178;1107;3235
353150;201612;1533;4586;1151;3835;324;1064;313;1017;637;2081
353160;201612;624;1736;358;1158;69;242;86;227;155;469
353170;201612;419;1277;347;1164;87;377;173;499;260;876
353180;201612;8439;23547;6419;19861;1079;3534;3770;11394;4849;14928
353190;201612;3484;10397;2657;8472;443;1539;1398;4118;1841;5657
353200;201612;1026;3409;699;2510;196;749;168;547;364;1296
353205;201612;335;1115;293;1011;73;255;126;427;199;682
353210;201612;1006;2496;610;1756;34;123;395;1072;429;1195
353215;201612;393;1218;291;970;51;198;93;257;144;455
353220;201612;585;1802;427;1444;113;385;86;273;199;658
353230;201612;707;2305;607;2093;151;555;167;536;318;1091
353240;201612;1980;6265;1637;5530;295;1132;912;2914;1207;4046
353250;201612;1019;2741;699;2086;96;308;347;977;443;1285
353260;201612;821;2280;533;1698;89;317;176;525;265;842
353270;201612;576;1687;460;1442;88;266;196;585;284;851
353280;201612;573;1869;406;1434;110;414;86;273;196;687
353282;201612;1741;5460;1525;4991;219;784;921;2881;1140;3665
353284;201612;351;926;175;545;30;94;45;129;75;223
353286;201612;117;354;81;278;20;66;14;46;34;112
353290;201612;774;2365;589;1975;81;333;343;1037;424;1370
353300;201612;1336;4140;1029;3396;228;845;370;1072;598;1917
353310;201612;188;543;141;465;47;160;42;135;89;295
353320;201612;555;1577;432;1326;64;192;230;680;294;872
353325;201612;606;1967;435;1546;58;202;138;473;196;675
353330;201612;559;1563;355;1091;55;196;180;508;235;704
353340;201612;2692;7827;1655;5721;548;1962;405;1368;953;3330
353350;201612;3055;9187;2149;7119;631;2177;527;1602;1158;3779
353360;201612;438;1437;384;1314;42;162;253;849;295;1011
353370;201612;573;1909;465;1646;52;217;266;888;318;1105
353380;201612;309;1026;229;838;37;149;73;256;110;405
353390;201612;5600;15384;3694;11624;788;2535;1282;3810;2070;6345
353400;201612;441;1344;322;1066;74;254;68;183;142;437
353410;201612;590;1735;454;1448;99;358;230;672;329;1030
353420;201612;565;1595;324;1001;101;308;69;198;170;506
353430;201612;2044;6809;1383;5092;366;1393;237;817;603;2210
353440;201612;53578;168175;39629;135245;11036;38408;13822;45282;24858;83690
353450;201612;381;1115;265;840;53;182;101;294;154;476
353460;201612;3086;8810;2200;6997;328;1160;1060;3320;1388;4480
353470;201612;7066;21119;4812;16314;1095;4021;1192;3635;2287;7656
353475;201612;1393;3978;926;2859;148;503;329;900;477;1403
353480;201612;1297;4009;1125;3650;153;508;763;2420;916;2928
353490;201612;857;2532;604;1941;144;454;210;649;354;1103
353500;201612;971;2585;770;2239;219;642;382;1089;601;1731
353510;201612;886;2811;601;2062;143;504;99;293;242;797
353520;201612;1057;2976;738;2386;108;388;348;1053;456;1441
353530;201612;2380;6905;1916;5953;282;983;1065;3130;1347;4113
353540;201612;1830;5587;1500;4967;386;1322;637;2023;1023;3345
353550;201612;5876;16389;4484;13754;521;1817;2788;7995;3309;9812
353560;201612;1987;6541;1544;5637;458;1794;365;1189;823;2983
353570;201612;482;1436;320;1050;78;252;136;414;214;666
353580;201612;2286;6647;1909;5936;312;1056;1190;3609;1502;4665
353590;201612;643;1900;414;1365;100;353;142;442;242;795
353600;201612;1660;4604;1343;3955;195;621;693;1908;888;2529
353610;201612;587;1983;400;1534;83;354;69;228;152;582
353620;201612;2178;6872;1670;5742;407;1442;439;1374;846;2816
353625;201612;397;1124;227;773;45;158;84;290;129;448
353630;201612;1337;4680;955;3615;155;622;124;384;279;1006
353640;201612;1277;3771;876;2857;100;338;428;1359;528;1697
353650;201612;8186;23819;5522;17859;1056;3507;2204;6731;3260;10238
353657;201612;283;894;224;765;38;147;83;265;121;412
353660;201612;996;2625;648;1895;256;770;51;85;307;855
353670;201612;3252;10417;2644;9062;853;3203;892;2756;1745;5959
353680;201612;652;2043;514;1782;144;564;188;602;332;1166
353690;201612;486;1307;217;723;38;133;39;93;77;226
353700;201612;1897;5734;1558;5020;211;728;842;2554;1053;3282
353710;201612;3190;7619;1321;4328;350;1087;267;843;617;1930
353715;201612;501;1433;302;987;28;102;90;269;118;371
353720;201612;1883;5781;1509;5116;311;1232;769;2400;1080;3632
353730;201612;4087;12320;2945;9642;580;2085;1056;3091;1636;5176
353740;201612;1588;4747;1104;3688;309;1089;272;863;581;1952
353750;201612;810;2718;553;2074;116;459;113;417;229;876
353760;201612;9848;26449;7704;23191;1081;3761;5058;14636;6139;18397
353770;201612;644;1993;287;1033;44;163;18;35;62;198
353780;201612;3825;13216;3175;11709;946;3646;753;2680;1699;6326
353790;201612;2072;7034;1564;5891;445;1876;365;1276;810;3152
353800;201612;15404;46746;11504;38963;3113;11171;4334;14065;7447;25236
353810;201612;956;3063;683;2413;127;500;232;773;359;1273
353820;201612;1347;4474;1108;3855;221;882;551;1751;772;2633
353830;201612;610;1638;458;1375;78;247;252;715;330;962
353850;201612;1623;5017;1335;4386;345;1169;495;1569;840;2738
353860;201612;2435;7933;1849;6559;536;1982;462;1547;998;3529
353870;201612;26923;77858;17233;56916;3330;11901;6348;18589;9678;30490
353880;201612;2576;8189;2056;7123;280;1102;1148;3864;1428;4966
353890;201612;2302;5650;1482;4207;244;745;809;2151;1053;2896
353900;201612;785;2441;541;1908;113;424;154;520;267;944
353910;201612;1182;3973;1043;3689;251;902;554;1965;805;2867
353920;201612;2268;6590;1395;4655;315;1125;251;698;566;1823
353930;201612;4308;12934;2760;9737;690;2603;464;1560;1154;4163
353940;201612;1058;3405;722;2558;141;512;224;733;365;1245
353950;201612;2952;9308;2431;8113;534;1866;1127;3483;1661;5349
353960;201612;528;1656;358;1231;76;269;82;254;158;523
353970;201612;557;1590;418;1334;47;160;267;838;314;998
353980;201612;12923;38174;10336;32866;2291;7522;5032;15404;7323;22926
353990;201612;379;1174;322;1037;37;146;191;580;228;726
354000;201612;2073;5717;1131;3688;232;799;118;344;350;1143
354010;201612;356;1072;285;935;55;180;161;523;216;703
354020;201612;3973;12452;3170;10545;834;2949;930;2784;1764;5733
354025;201612;789;2250;532;1737;106;347;178;572;284;919
354030;201612;447;1210;263;841;39;142;111;329;150;471
354040;201612;716;1932;443;1353;45;135;268;766;313;901
354050;201612;876;2775;644;2267;161;596;122;406;283;1002
354060;201612;4609;14239;2908;10166;791;2825;698;2215;1489;5040
354070;201612;2616;8727;2039;7251;518;1961;375;1215;893;3176
354075;201612;1813;6591;1580;5990;463;1825;634;2325;1097;4150
354080;201612;1312;3998;833;2881;159;562;266;851;425;1413
354085;201612;301;748;261;681;11;46;215;535;226;581
354090;201612;1288;3803;1171;3571;136;466;793;2364;929;2830
354100;201612;13600;45481;10609;38933;2846;11039;4293;15160;7139;26199
354105;201612;891;2606;751;2370;119;403;505;1558;624;1961
354110;201612;685;1859;500;1578;168;569;89;228;257;797
354120;201612;1799;4988;1240;3823;220;731;537;1534;757;2265
354130;201612;5899;16871;3905;12700;1417;4769;256;649;1673;5418
354140;201612;25447;63949;14223;42491;3325;10298;4231;11475;7556;21773
354150;201612;3636;9796;2567;7714;447;1437;1251;3588;1698;5025
354160;201612;3076;9967;2295;8044;591;2128;786;2678;1377;4806
354165;201612;480;1595;386;1388;96;383;140;492;236;875
354170;201612;1264;3954;909;3083;175;633;384;1203;559;1836
354180;201612;449;1389;355;1156;54;197;152;420;206;617
354190;201612;1382;4315;1058;3594;265;963;329;1054;594;2017
354200;201612;911;2554;651;2013;91;296;317;889;408;1185
354210;201612;593;1872;461;1589;66;276;240;746;306;1022
354220;201612;2735;7876;2140;6679;439;1403;1037;3110;1476;4513
354230;201612;582;1902;477;1640;84;323;231;732;315;1055
354240;201612;1164;3813;778;2855;153;591;169;580;322;1171
354250;201612;630;1777;391;1334;122;431;102;361;224;792
354260;201612;7569;22375;5774;18913;1650;5597;1774;5800;3424;11397
354270;201612;1076;3580;827;2961;170;650;279;972;449;1622
354280;201612;686;2010;591;1826;111;413;361;1021;472;1434
354290;201612;867;3046;724;2661;165;630;279;1017;444;1647
354300;201612;3632;11735;3251;10932;957;3262;1450;4727;2407;7989
354310;201612;802;2443;613;2044;135;458;302;985;437;1443
354320;201612;693;2070;520;1698;125;466;175;499;300;965
354323;201612;457;1255;307;940;61;192;106;282;167;474
354325;201612;1193;3879;853;3033;164;613;298;964;462;1577
354330;201612;6077;17944;4500;14593;1037;3636;2018;5974;3055;9610
354340;201612;22645;68571;17459;58656;4928;17517;6413;20475;11341;37992
354350;201612;1039;3058;884;2717;203;692;472;1329;675;2021
354360;201612;425;1352;214;823;24;91;9;38;33;129
354370;201612;1074;3593;862;3093;96;408;486;1665;582;2073
354380;201612;781;2356;537;1834;159;620;91;246;250;866
354390;201612;12706;36317;7630;25755;1599;5628;1447;4643;3046;10271
354400;201612;1461;5080;1098;4106;232;914;337;1236;569;2150
354410;201612;5086;15538;3904;13042;1042;3679;1462;4619;2504;8298
354420;201612;1131;3373;777;2529;181;631;311;970;492;1601
354425;201612;2056;5910;1625;5016;505;1613;413;1251;918;2864
354430;201612;1283;4139;1081;3672;233;876;460;1476;693;2352
354440;201612;495;1489;318;1074;40;143;124;380;164;523
354450;201612;388;1113;195;655;31;114;36;109;67;223
354460;201612;946;2632;591;1893;140;482;235;727;375;1209
354470;201612;567;1519;403;1172;38;134;217;561;255;695
354480;201612;704;1923;522;1582;65;198;332;958;397;1156
354490;201612;702;2344;528;1896;60;240;249;842;309;1082
354500;201612;1980;6363;1664;5768;596;2252;351;1167;947;3419
354510;201612;796;2184;690;1972;98;236;442;1263;540;1499
354515;201612;245;804;176;639;35;130;63;225;98;355
354520;201612;7599;24494;3940;13773;786;3061;1664;5291;2450;8352
354530;201612;2978;10144;2505;9038;691;2642;999;3459;1690;6101
354540;201612;1128;3410;894;2963;295;1041;154;481;449;1522
354550;201612;442;1297;350;1113;74;255;170;501;244;756
354560;201612;1656;4608;867;2766;157;492;392;1149;549;1641
354570;201612;1030;2883;398;1303;65;233;63;185;128;418
354580;201612;10264;28547;6470;20995;1201;4149;2523;7527;3724;11676
354600;201612;1509;4871;1223;4284;235;949;636;2094;871;3043
354610;201612;356;1015;178;583;16;52;67;197;83;249
354620;201612;360;1157;262;954;50;222;123;419;173;641
354625;201612;277;860;158;570;22;81;42;122;64;203
354630;201612;2021;6653;1674;5857;668;2466;203;633;871;3099
354640;201612;3058;10026;2121;7676;440;1768;430;1301;870;3069
354650;201612;778;2279;643;1991;66;224;442;1359;508;1583
354660;201612;2252;6223;1523;4890;151;556;1015;3140;1166;3696
354670;201612;1086;3343;764;2554;177;645;180;520;357;1165
354680;201612;4066;13178;3552;12063;967;3378;1595;5291;2562;8669
354690;201612;731;2352;425;1551;80;307;116;397;196;704
354700;201612;1122;3141;702;2161;152;560;292;765;444;1325
354710;201612;498;1481;327;1086;34;135;158;461;192;596
354720;201612;248;671;119;389;39;126;17;48;56;174
354730;201612;8278;25705;5768;20457;1192;4492;2595;8780;3787;13272
354740;201612;231;703;105;388;15;64;16;60;31;124
354750;201612;2139;6709;1588;5455;400;1517;571;1796;971;3313
354760;201612;1762;5562;1309;4538;422;1532;164;556;586;2088
354765;201612;296;837;113;389;16;56;18;54;34;110
354770;201612;2168;6012;1519;4800;552;1778;424;1291;976;3069
354780;201612;52976;146030;41677;121382;6683;21346;22875;62107;29558;83453
354790;201612;763;2527;662;2295;101;359;336;1131;437;1490
354800;201612;2220;6372;1800;5688;422;1455;860;2575;1282;4030
354805;201612;949;2823;612;2040;62;218;178;508;240;726
354810;201612;553;1779;296;1131;48;197;48;161;96;358
354820;201612;910;3081;692;2565;135;539;152;492;287;1031
354830;201612;428;1158;303;909;92;274;111;302;203;576
354840;201612;645;1867;457;1463;99;299;201;644;300;943
354850;201612;16488;49624;11352;38704;2293;8618;5232;16206;7525;24824
354860;201612;1279;4006;1043;3557;240;911;366;1111;606;2022
354870;201612;44174;127201;36824;111446;7862;25306;16923;49174;24785;74480
354880;201612;4175;11511;2022;6569;313;1186;691;1855;1004;3041
354890;201612;14702;42431;11567;36288;2503;8246;5201;15493;7704;23739
354900;201612;414;1279;276;941;57;218;57;173;114;391
354910;201612;5970;17699;2963;10843;533;2110;137;430;670;2540
354920;201612;352;1040;201;715;34;136;51;165;85;301
354925;201612;197;620;99;365;18;70;20;62;38;132
354930;201612;293;729;144;461;21;68;62;191;83;259
354940;201612;1621;5815;1224;4709;415;1674;112;376;527;2050
354950;201612;1388;4375;1104;3828;136;591;613;1984;749;2575
354960;201612;712;2200;596;1983;114;419;271;842;385;1261
354970;201612;3723;12117;3089;10689;539;2124;1662;5418;2201;7542
354980;201612;26207;68889;15955;49661;2896;10067;6674;18686;9570;28753
354990;201612;53630;153334;39122;123523;6685;22377;19737;59416;26422;81793
354995;201612;1718;5160;1358;4519;344;1170;664;2137;1008;3307
355000;201612;1279;4107;1054;3618;272;1056;197;541;469;1597
355010;201612;3283;10070;2325;7733;724;2499;467;1558;1191;4057
355020;201612;2779;9113;1988;7348;712;2845;464;1590;1176;4435
355030;201612;1103749;2960274;854228;2450132;190890;583974;381034;1023992;571924;1607966
355040;201612;2469;7496;2103;6811;411;1393;1277;3998;1688;5391
355050;201612;1063;3196;769;2548;242;789;125;402;367;1191
355060;201612;4114;13480;3109;11215;624;2506;1061;3435;1685;5941
355070;201612;6277;19187;5281;17318;1053;3880;2667;8099;3720;11979
355080;201612;813;2757;517;2023;72;311;29;103;101;414
355090;201612;1017;3460;806;2957;162;606;296;1058;458;1664
355100;201612;16215;49504;12823;43276;3387;12272;6274;20335;9661;32607
355110;201612;1082;3497;857;3030;255;971;147;451;402;1422
355120;201612;588;1826;429;1482;86;341;163;523;249;864
355130;201612;601;1507;234;692;32;98;81;216;113;314
355140;201612;1054;3488;960;3297;191;727;559;1929;750;2656
355150;201612;3361;9730;2619;8376;529;1737;1253;3924;1782;5661
355160;201612;1648;5146;1263;4397;377;1388;322;1067;699;2455
355170;201612;7653;21747;5602;18052;1957;6561;1577;5114;3534;11675
355180;201612;2671;8253;2033;6957;517;2058;628;1860;1145;3918
355190;201612;1309;4078;1059;3549;350;1304;285;1007;635;2311
355200;201612;740;2592;635;2328;260;1023;138;451;398;1474
355210;201612;2650;8212;2262;7321;287;1103;1447;4428;1734;5531
355220;201612;35233;105031;26662;86632;8780;29771;6662;19389;15442;49160
355230;201612;1371;3687;662;2102;141;434;160;448;301;882
355240;201612;23516;66847;14814;48007;3419;11438;4974;15489;8393;26927
355250;201612;27319;84462;21371;72109;6129;21805;7372;23881;13501;45686
355255;201612;849;2325;451;1462;91;299;124;392;215;691
355260;201612;1116;3325;898;2895;187;682;381;1105;568;1787
355270;201612;1543;4701;1261;4028;193;650;688;2033;881;2683
355280;201612;25859;73913;19263;60144;3636;12170;8371;24709;12007;36879
355290;201612;843;2675;608;2070;128;419;172;544;300;963
355300;201612;1242;3955;922;3232;209;734;295;986;504;1720
355310;201612;984;2913;711;2393;115;415;398;1318;513;1733
355320;201612;539;1646;433;1399;77;302;180;496;257;798
355330;201612;1794;5454;1226;4228;262;970;562;1815;824;2785
355340;201612;2632;6668;2230;5987;406;1057;1329;3513;1735;4570
355350;201612;1263;4188;934;3405;227;868;249;868;476;1736
355360;201612;1125;3610;952;3203;199;669;577;1990;776;2659
355365;201612;325;958;181;655;49;170;33;117;82;287
355370;201612;6596;16905;4777;14252;1439;4506;1867;5724;3306;10230
355380;201612;3027;8948;2151;6946;484;1618;504;1395;988;3013
355385;201612;982;3142;822;2790;270;978;223;672;493;1650
355390;201612;820;2388;561;1806;135;480;203;546;338;1026
355395;201612;1848;5625;1212;4070;199;640;551;1746;750;2386
355400;201612;8556;28059;7007;24593;2162;8025;1821;5963;3983;13988
355410;201612;17140;54165;12313;43680;3716;14104;2244;7710;5960;21814
355420;201612;678;2412;584;2202;176;735;154;571;330;1306
355430;201612;3288;9099;2588;7805;543;1730;1278;3703;1821;5433
355440;201612;862;2616;557;1885;100;339;151;462;251;801
355450;201612;3636;10338;1861;6203;370;1268;576;1755;946;3023
355460;201612;540;1449;332;1057;67;250;113;288;180;538
355465;201612;323;1037;234;827;50;175;58;190;108;365
355470;201612;720;2165;536;1809;144;495;194;621;338;1116
355475;201612;146;458;137;437;33;115;76;225;109;340
355480;201612;2881;9845;2534;9109;581;2228;1223;4251;1804;6479
355490;201612;950;2715;551;1829;84;274;182;565;266;839
355495;201612;722;2413;575;2076;118;464;149;493;267;957
355500;201612;6710;19671;3831;12864;740;2602;729;2219;1469;4821
355510;201612;1832;4891;884;2891;133;503;246;695;379;1198
355520;201612;410;959;183;500;22;68;88;213;110;281
355530;201612;427;1029;149;487;24;84;39;107;63;191
355535;201612;601;1810;444;1481;161;560;90;238;251;798
355540;201612;7681;23908;7074;22788;1752;5957;3702;11463;5454;17420
355550;201612;714;2195;538;1811;93;342;237;768;330;1110
355560;201612;1112;3367;564;2006;110;429;30;72;140;501
355570;201612;181;575;95;348;15;58;9;36;24;94
355580;201612;1193;3308;724;2331;113;402;307;948;420;1350
355590;201612;208;556;153;452;22;72;89;248;111;320
355600;201612;1100;3318;841;2741;258;892;282;870;540;1762
355610;201612;1557;4266;1058;3263;192;627;484;1428;676;2055
355620;201612;4096;12727;3086;10302;493;1857;1474;4469;1967;6326
355630;201612;2634;7700;1629;5552;386;1346;450;1530;836;2876
355635;201612;880;2821;724;2539;76;287;523;1843;599;2130
355640;201612;2613;8293;1718;6284;361;1429;288;1010;649;2439
355645;201612;3546;11514;2907;10374;468;1857;1730;6003;2198;7860
355650;201612;7179;21297;6009;18922;1208;4291;3574;10369;4782;14660
355660;201612;1170;3715;847;2967;135;562;404;1292;539;1854
355670;201612;2684;8335;1794;6079;355;1328;808;2382;1163;3710
355680;201612;1517;5031;991;3623;245;966;128;445;373;1411
355690;201612;466;1457;306;1119;125;467;17;45;142;512
355695;201612;239;778;109;400;9;39;8;19;17;58
355700;201612;5174;16651;4129;14150;1047;3613;1573;5217;2620;8830
355710;201612;9119;22561;4804;14218;1115;3408;1275;3492;2390;6900
355715;201612;305;903;182;615;52;190;34;101;86;291
355720;201612;1420;4678;1078;3821;264;984;354;1083;618;2067
355730;201612;801;2604;639;2201;203;700;159;531;362;1231
410010;201612;1304;4056;1021;3362;216;757;176;564;392;1321
410020;201612;1141;3664;920;3144;277;942;321;1089;598;2031
410030;201612;1090;3686;823;3016;223;823;138;501;361;1324
410040;201612;9342;30204;7522;26373;1708;6534;2353;7974;4061;14508
410045;201612;1013;2803;642;2046;145;488;152;423;297;911
410050;201612;2572;7015;1437;4660;429;1430;104;272;533;1702
410060;201612;2111;6428;1707;5553;402;1320;721;2320;1123;3640
410070;201612;1653;4633;1164;3615;336;1119;302;888;638;2007
410080;201612;1374;3852;983;3058;172;594;420;1216;592;1810
410090;201612;935;2884;819;2628;168;591;353;1132;521;1723
410100;201612;2574;7877;1645;5537;369;1350;173;499;542;1849
410105;201612;343;1076;187;675;34;142;31;87;65;229
410110;201612;2794;8102;2027;6483;338;1159;671;2054;1009;3213
410115;201612;510;1377;353;1068;65;211;121;322;186;533
410120;201612;2363;8134;2106;7566;823;3112;528;1849;1351;4961
410130;201612;1071;3301;936;2971;397;1337;217;593;614;1930
410140;201612;17064;43883;9764;29919;2093;6771;2330;6539;4423;13310
410150;201612;14724;37850;6698;20595;1468;4683;1085;3005;2553;7688
410160;201612;2829;8688;2395;7811;652;2300;828;2687;1480;4987
410165;201612;682;1985;509;1568;86;279;237;664;323;943
410170;201612;2201;6278;1473;4595;450;1509;200;571;650;2080
410180;201612;10952;34327;8851;29210;1871;6590;4028;12286;5899;18876
410185;201612;513;1430;346;1084;82;257;63;168;145;425
410190;201612;1958;5760;1401;4458;267;900;237;689;504;1589
410200;201612;3615;9980;2181;6967;511;1778;316;927;827;2705
410210;201612;2549;7464;1645;5341;261;966;375;972;636;1938
410220;201612;641;1729;408;1277;74;262;138;412;212;674
410230;201612;1399;4333;1129;3722;242;910;473;1475;715;2385
410240;201612;4141;12443;3431;10924;1101;3864;440;1255;1541;5119
410250;201612;2631;7183;1615;5056;384;1244;313;923;697;2167
410260;201612;1523;4360;1127;3614;235;811;479;1506;714;2317
410270;201612;554;1541;385;1163;40;131;204;595;244;726
410275;201612;775;2361;482;1630;77;270;207;692;284;962
410280;201612;2077;6026;1352;4411;321;1145;370;1076;691;2221
410290;201612;3290;9848;2546;8309;677;2190;917;2981;1594;5171
410300;201612;690;1942;538;1604;101;338;238;620;339;958
410302;201612;426;1175;235;785;29;106;125;412;154;518
410304;201612;1193;3768;1043;3417;281;957;369;1245;650;2202
410305;201612;1790;4877;1367;4083;358;1123;620;1807;978;2930
410310;201612;2195;6961;1812;6178;388;1431;643;2148;1031;3579
410315;201612;659;1848;359;1222;57;204;110;339;167;543
410320;201612;1174;3583;647;2282;102;404;72;221;174;625
410322;201612;533;1564;271;932;38;123;72;241;110;364
410330;201612;1291;3603;955;2893;221;686;232;692;453;1378
410335;201612;881;2610;702;2225;119;428;288;801;407;1229
410337;201612;777;2054;512;1524;71;243;185;500;256;743
410340;201612;536;1524;319;942;43;144;149;381;192;525
410345;201612;1801;5212;1117;3624;297;996;259;794;556;1790
410347;201612;711;1913;419;1318;63;225;144;401;207;626
410350;201612;1045;3111;690;2341;141;521;152;439;293;960
410360;201612;3761;10065;2691;8013;358;1199;1454;4125;1812;5324
410370;201612;11412;33303;7363;23241;1324;4541;2245;6055;3569;10596
410380;201612;1292;3711;1103;3309;124;446;543;1575;667;2021
410390;201612;2287;6878;1669;5437;523;1721;340;1019;863;2740
410395;201612;847;2795;730;2533;202;747;292;992;494;1739
410400;201612;4216;12987;3119;10435;642;2268;1147;3590;1789;5858
410405;201612;807;2308;618;1925;154;540;209;604;363;1144
410410;201612;1188;3662;1123;3556;285;1122;550;1597;835;2719
410420;201612;6438;20776;4755;16615;1168;4341;607;1796;1775;6137
410425;201612;2638;8311;1716;6104;311;1146;222;672;533;1818
410430;201612;13438;36117;8717;26733;1703;5583;2489;7056;4192;12639
410440;201612;2513;8041;2122;7216;567;2060;828;2722;1395;4782
410442;201612;2545;8421;2133;7434;667;2368;583;1988;1250;4356
410445;201612;2274;7358;1805;6379;522;1985;546;1934;1068;3919
410450;201612;1871;5307;1276;3952;316;970;106;230;422;1200
410460;201612;1628;4761;1159;3766;368;1203;211;637;579;1840
410465;201612;2159;6969;1686;5841;403;1426;581;1875;984;3301
410470;201612;1709;5450;1201;4217;287;1133;218;712;505;1845
410480;201612;29836;83061;14859;49648;2557;8700;1216;3239;3773;11939
410490;201612;10844;32918;7457;25260;1763;6452;1991;6052;3754;12504
410500;201612;1474;4607;1068;3619;390;1440;131;349;521;1789
410510;201612;2421;6343;1443;4236;294;827;498;1373;792;2200
410520;201612;2941;10144;2692;9561;785;2901;1149;4076;1934;6977
410530;201612;1459;4012;811;2502;157;495;175;461;332;956
410540;201612;2841;8410;1846;6163;362;1238;615;1988;977;3226
410550;201612;5915;17063;3631;11799;729;2552;506;1446;1235;3998
410560;201612;1231;3620;857;2764;235;828;237;653;472;1481
410570;201612;2531;7899;2091;7041;569;2086;582;2097;1151;4183
410580;201612;21229;62884;15908;51513;3758;13144;5122;15072;8880;28216
410590;201612;1380;4245;740;2461;133;445;172;482;305;927
410600;201612;1786;5189;1328;4221;342;1089;424;1340;766;2429
410610;201612;736;2059;521;1611;53;164;209;618;262;782
410620;201612;1677;5597;1112;4125;250;989;111;369;361;1358
410630;201612;2368;7030;1418;4739;309;1097;132;327;441;1424
410640;201612;4458;12170;2899;9031;775;2713;418;1125;1193;3838
410645;201612;1116;3824;1013;3632;458;1716;199;751;657;2467
410650;201612;2031;6289;1507;5055;515;1805;210;637;725;2442
410655;201612;832;2319;539;1704;83;311;193;536;276;847
410657;201612;754;2095;480;1488;124;413;145;379;269;792
410660;201612;2881;8086;1362;4540;291;995;148;459;439;1454
410670;201612;880;2429;540;1684;114;358;181;525;295;883
410680;201612;2818;9082;2075;7168;651;2180;444;1637;1095;3817
410685;201612;618;1788;498;1558;75;265;278;825;353;1090
410690;201612;110626;315793;69830;224706;14140;49000;17981;49566;32121;98566
410700;201612;2038;6075;1786;5523;487;1562;739;2140;1226;3702
410710;201612;893;2576;531;1738;124;405;121;332;245;737
410712;201612;774;2349;649;2096;266;929;151;463;417;1392
410715;201612;872;2797;580;2054;112;421;147;485;259;906
410720;201612;3162;9340;2007;6691;413;1450;356;1017;769;2467
410725;201612;1050;2940;635;2058;112;345;94;275;206;620
410730;201612;477;1375;344;1112;98;336;74;244;172;580
410740;201612;887;2606;575;1933;100;393;248;788;348;1181
410750;201612;1763;5138;1325;4160;270;905;418;1214;688;2119
410752;201612;307;824;133;429;31;108;34;90;65;198
410753;201612;355;1050;185;632;26;93;39;113;65;206
410754;201612;1110;3183;903;2808;66;191;582;1942;648;2133
410755;201612;800;1960;562;1549;70;222;334;853;404;1075
410760;201612;2478;7326;1966;6328;569;1962;534;1613;1103;3575
410765;201612;14259;42903;9658;32971;1573;5840;848;2652;2421;8492
410770;201612;871;2431;536;1711;135;455;79;244;214;699
410773;201612;1315;3698;1146;3426;162;577;827;2394;989;2971
410775;201612;1341;3845;1148;3499;340;1108;304;911;644;2019
410780;201612;530;1447;319;979;91;274;84;292;175;566
410785;201612;770;2398;583;1946;210;740;130;418;340;1158
410790;201612;438;1432;341;1157;93;322;23;59;116;381
410800;201612;2709;6712;1882;5194;285;877;690;1734;975;2611
410810;201612;321;988;246;817;47;181;90;289;137;470
410820;201612;762;2286;506;1656;111;389;66;216;177;605
410830;201612;28623;80725;21113;66251;6255;21120;6574;19266;12829;40386
410832;201612;978;2803;775;2370;97;360;445;1242;542;1602
410840;201612;6503;18768;3581;12129;855;2986;280;715;1135;3701
410845;201612;1170;3450;926;2915;195;648;370;1117;565;1765
410850;201612;2589;7748;2160;6911;516;1802;781;2482;1297;4284
410855;201612;567;1562;374;1131;57;179;144;394;201;573
410860;201612;3720;10589;2675;8292;552;1792;832;2403;1384;4195
410865;201612;1436;4744;1328;4539;354;1290;695;2395;1049;3685
410870;201612;1231;3650;1082;3393;128;428;747;2336;875;2764
410880;201612;3581;11286;2612;9081;491;1777;384;1331;875;3108
410890;201612;876;2845;607;2188;163;635;68;228;231;863
410895;201612;1015;3504;860;3112;322;1256;177;587;499;1843
410900;201612;893;2461;541;1711;82;283;164;458;246;741
410910;201612;381;995;249;735;24;84;137;383;161;467
410920;201612;783;2179;585;1806;159;550;193;584;352;1134
410930;201612;1509;4504;1151;3735;357;1290;281;834;638;2124
410940;201612;20373;64404;15612;54426;4891;18027;2905;9878;7796;27905
410950;201612;1759;5625;1591;5312;135;480;1227;4048;1362;4528
410960;201612;7369;20188;4185;13876;1266;4492;874;2664;2140;7156
410965;201612;1031;3024;752;2424;207;680;254;756;461;1436
410970;201612;3979;11785;2862;9433;798;2949;437;1318;1235;4267
410975;201612;1555;4354;1111;3449;215;752;395;1132;610;1884
410980;201612;6078;16951;3531;11533;639;2310;1051;3182;1690;5492
410990;201612;953;2765;506;1742;181;670;62;149;243;819
411000;201612;474;1407;279;948;53;191;57;151;110;342
411005;201612;470;1388;257;857;41;153;41;120;82;273
411007;201612;2261;7046;1841;6081;490;1702;506;1615;996;3317
411010;201612;3885;13084;3255;11466;902;3324;348;1177;1250;4501
411020;201612;2385;7318;1989;6557;607;2133;555;1717;1162;3850
411030;201612;619;1667;396;1188;65;220;121;313;186;533
411040;201612;739;2126;282;948;56;194;53;167;109;361
411050;201612;1884;6443;1571;5655;461;1805;220;671;681;2476
411060;201612;1507;4501;972;3254;197;738;132;405;329;1143
411065;201612;324;966;247;814;44;138;97;317;141;455
411070;201612;5883;17302;4281;13800;1138;3974;1103;3183;2241;7157
411080;201612;2057;6106;1703;5354;413;1403;480;1477;893;2880
411090;201612;765;1945;472;1421;53;183;81;216;134;399
411095;201612;1352;3800;840;2629;102;368;217;576;319;944
411100;201612;1139;3336;720;2351;161;599;116;340;277;939
411110;201612;543;1586;228;788;22;92;17;48;39;140
411120;201612;1548;4659;1039;3434;288;1089;253;695;541;1784
411125;201612;3925;12781;3480;11759;914;3210;1222;4086;2136;7296
411130;201612;655;1941;445;1456;100;334;119;412;219;746
411140;201612;2124;7170;1712;6109;416;1537;675;2420;1091;3957
411150;201612;3784;10595;2481;7774;544;1817;262;664;806;2481
411155;201612;914;2505;568;1780;70;231;257;758;327;989
411160;201612;261;741;181;567;31;101;51;150;82;251
411170;201612;721;2246;547;1829;125;448;173;548;298;996
411180;201612;5416;15932;4021;13045;867;3013;1340;4230;2207;7243
411190;201612;1343;3862;1011;3128;250;847;204;539;454;1386
411200;201612;4267;12506;3160;10408;842;2929;862;2674;1704;5603
411210;201612;1833;5188;1259;4012;311;1074;160;437;471;1511
411220;201612;916;2621;718;2200;177;606;287;786;464;1392
411230;201612;1214;3364;716;2334;133;458;249;772;382;1230
411240;201612;1452;3476;721;2124;121;370;286;764;407;1134
411250;201612;1881;5552;1438;4645;406;1431;375;1176;781;2607
411260;201612;318;825;189;581;22;69;85;240;107;309
411270;201612;1697;5255;1384;4566;227;823;658;2027;885;2850
411275;201612;1286;3744;932;2928;224;715;199;557;423;1272
411280;201612;1455;4180;855;2809;153;528;186;568;339;1096
411290;201612;690;2025;484;1570;125;421;134;417;259;838
411295;201612;922;2531;777;2227;123;387;318;902;441;1289
411300;201612;1170;2963;672;1945;64;181;273;713;337;894
411310;201612;801;2193;548;1690;41;142;197;578;238;720
411320;201612;4993;14391;3237;10687;911;3035;551;1641;1462;4676
411325;201612;1477;4650;1255;4138;276;951;578;1923;854;2874
411330;201612;2884;8940;2217;7465;728;2650;484;1646;1212;4296
411340;201612;736;2252;469;1591;40;159;195;620;235;779
411342;201612;689;1911;524;1569;158;485;164;454;322;939
411345;201612;842;2613;739;2399;174;637;332;1044;506;1681
411350;201612;2676;7931;1749;5875;496;1803;154;465;650;2268
411360;201612;564;1406;329;972;46;160;143;363;189;523
411370;201612;43938;122797;32181;99017;4708;16355;15060;42338;19768;58693
411373;201612;1422;4304;1122;3701;237;878;318;1024;555;1902
411375;201612;1101;3001;723;2211;146;467;214;598;360;1065
411380;201612;1024;2846;557;1711;124;380;158;430;282;810
411390;201612;1719;5052;1199;3777;259;860;279;787;538;1647
411400;201612;2073;5795;1470;4487;315;1042;442;1248;757;2290
411410;201612;1938;5875;1304;4290;291;1029;298;827;589;1856
411420;201612;3850;10768;2246;7215;355;1235;366;913;721;2148
411430;201612;3221;9473;2541;8239;584;2058;1237;3861;1821;5919
411435;201612;429;1388;336;1135;69;238;127;393;196;631
411440;201612;2678;8527;2196;7393;646;2243;449;1584;1095;3827
411450;201612;2307;6989;2006;6358;427;1375;918;3012;1345;4387
411460;201612;3313;9610;1461;5188;220;872;79;252;299;1124
411470;201612;781;2325;474;1581;77;280;88;251;165;531
411480;201612;4295;12883;2856;9709;681;2505;402;1211;1083;3716
411490;201612;1343;4091;1039;3442;192;654;251;779;443;1433
411500;201612;1803;4775;1177;3600;220;737;372;1104;592;1841
411510;201612;1954;5780;1416;4576;397;1400;244;709;641;2109
411520;201612;24618;66848;12997;41159;2317;7741;3100;8714;5417;16455
411530;201612;906;2547;583;1900;134;483;140;413;274;896
411535;201612;480;1444;185;668;19;91;12;28;31;119
411540;201612;2929;7880;1929;5743;437;1413;585;1541;1022;2954
411545;201612;973;3147;838;2866;125;449;523;1819;648;2268
411550;201612;722;1943;513;1545;161;506;84;236;245;742
411560;201612;2165;6352;1238;4094;186;653;104;279;290;932
411570;201612;6912;18084;4413;13679;1050;3588;945;2846;1995;6434
411573;201612;809;2372;739;2249;105;319;470;1440;575;1759
411575;201612;1548;4782;1220;4049;314;1072;387;1265;701;2337
411580;201612;3760;10636;2053;6848;242;928;257;681;499;1609
411585;201612;763;2412;339;1204;69;235;52;165;121;400
411590;201612;347;1050;279;907;37;132;132;397;169;529
411600;201612;305;844;195;654;46;176;69;232;115;408
411605;201612;1630;4453;975;2998;150;525;377;1092;527;1617
411610;201612;2120;5953;1553;4782;343;1135;597;1743;940;2878
411620;201612;2721;8370;2370;7759;537;1901;1203;3855;1740;5756
411630;201612;501;1346;314;1039;64;245;45;113;109;358
411640;201612;434;1344;305;1011;41;125;103;313;144;438
411650;201612;203;646;131;480;28;109;18;58;46;167
411660;201612;896;2367;602;1796;82;265;293;829;375;1094
411670;201612;1033;2929;739;2224;150;469;249;725;399;1194
411680;201612;1466;4311;1200;3779;240;832;580;1806;820;2638
411690;201612;3236;9416;2283;7460;628;2044;526;1788;1154;3832
411695;201612;679;2199;484;1718;106;395;158;567;264;962
411700;201612;1610;4623;1000;3290;209;737;134;394;343;1131
411705;201612;1774;6153;1516;5600;363;1323;732;2839;1095;4162
411710;201612;1580;4621;1124;3605;323;1078;172;549;495;1627
411720;201612;866;2429;595;1843;103;350;169;458;272;808
411721;201612;734;2163;535;1714;131;421;63;188;194;609
411722;201612;632;1911;359;1240;72;265;78;224;150;489
411725;201612;1360;4331;734;2678;167;633;135;478;302;1111
411727;201612;1673;4931;1088;3555;297;970;184;574;481;1544
411729;201612;621;1605;387;1145;119;356;80;185;199;541
411730;201612;5241;15023;4144;12789;1452;4494;958;2893;2410;7387
411740;201612;624;1763;320;1064;57;202;66;192;123;394
411745;201612;886;2519;651;1990;134;418;202;588;336;1006
411750;201612;4854;14357;3398;10956;614;2047;1211;3668;1825;5715
411760;201612;7436;21682;5862;18626;1896;6294;1250;3975;3146;10269
411770;201612;3287;10654;2460;8617;708;2606;381;1254;1089;3860
411780;201612;2839;8653;2497;8025;664;2256;1224;4020;1888;6276
411790;201612;3296;9238;1924;6193;485;1649;408;1228;893;2877
411800;201612;1095;3156;628;2037;99;353;89;236;188;589
411810;201612;1628;4606;1261;3836;266;874;499;1394;765;2268
411820;201612;12461;40351;9957;34599;3540;12553;2169;7564;5709;20117
411830;201612;534;1365;302;924;99;323;14;49;113;372
411840;201612;9974;28258;6466;20771;1520;5171;1242;3894;2762;9065
411845;201612;485;1491;250;850;46;166;23;67;69;233
411850;201612;7122;21034;5382;17236;1408;4807;1418;4290;2826;9097
411860;201612;842;2556;618;2031;119;407;206;618;325;1025
411870;201612;814;2619;498;1736;103;414;99;301;202;715
411880;201612;2159;6261;1528;5026;415;1494;289;858;704;2352
411885;201612;913;2539;689;2090;123;462;248;659;371;1121
411890;201612;1055;3222;599;2053;112;422;34;85;146;507
411900;201612;918;2852;542;1873;127;426;58;192;185;618
411910;201612;1156;3700;786;2757;214;795;190;582;404;1377
411915;201612;16784;45160;9020;28795;1752;5911;2106;5892;3858;11803
411920;201612;851;2852;682;2406;170;684;78;212;248;896
411925;201612;584;1663;359;1193;81;272;79;243;160;515
411930;201612;5636;18597;4705;16566;2248;8402;370;1221;2618;9623
411940;201612;3080;10218;2464;8719;677;2469;471;1524;1148;3993
411950;201612;12277;38255;9893;33273;2243;7986;4316;14012;6559;21998
411960;201612;5240;15351;4497;13832;1034;3409;1740;5051;2774;8460
411965;201612;532;1480;338;1116;59;225;89;291;148;516
411970;201612;745;2047;610;1830;179;544;235;799;414;1343
411980;201612;1573;4613;1250;3901;312;990;358;1106;670;2096
411990;201612;31041;96138;22102;75992;5659;20969;6105;19519;11764;40488
411995;201612;2412;7224;1900;6201;568;2062;481;1412;1049;3474
412000;201612;2210;5401;1557;4237;229;749;827;1978;1056;2727
412010;201612;664;2250;492;1832;64;259;122;403;186;662
412015;201612;627;1870;479;1543;100;306;215;708;315;1014
412020;201612;328;1002;202;675;41;135;52;154;93;289
412030;201612;712;2160;439;1524;82;321;118;361;200;682
412033;201612;848;2412;492;1559;71;228;142;427;213;655
412035;201612;953;2609;541;1789;117;400;178;552;295;952
412040;201612;578;1754;373;1263;67;225;60;205;127;430
412050;201612;1724;4905;1151;3659;219;745;260;808;479;1553
412060;201612;6878;23171;5850;20826;1863;7062;1502;5202;3365;12264
412065;201612;777;2357;547;1834;125;455;156;473;281;928
412070;201612;1284;3410;869;2518;139;427;348;952;487;1379
412080;201612;1427;4380;702;2583;86;331;23;61;109;392
412085;201612;430;1245;102;361;15;56;11;28;26;84
412090;201612;4487;13503;4026;12599;1038;3190;1944;6279;2982;9469
412100;201612;1813;5516;1361;4566;411;1490;267;874;678;2364
412110;201612;1058;2955;625;1988;145;475;117;387;262;862
412120;201612;1608;5466;1262;4560;343;1353;344;1059;687;2412
412125;201612;611;1998;531;1819;119;423;178;576;297;999
412130;201612;536;1621;352;1153;98;335;56;170;154;505
412135;201612;488;1366;266;844;58;184;89;262;147;446
412140;201612;1458;4347;1062;3439;233;800;187;541;420;1341
412150;201612;2905;8301;2393;7203;355;1149;1381;3987;1736;5136
412160;201612;1182;3755;628;2283;157;618;65;199;222;817
412170;201612;4469;13507;3444;11349;902;3206;1288;3916;2190;7122
412175;201612;1444;4667;1185;4081;239;880;572;1943;811;2823
412180;201612;1633;4928;1104;3814;247;946;376;1160;623;2106
412190;201612;3268;9107;2190;6984;434;1458;746;2435;1180;3893
412200;201612;2033;6411;1352;4619;277;996;400;1360;677;2356
412210;201612;642;1738;317;1023;55;194;46;106;101;300
412215;201612;3505;10631;3056;9747;827;2603;1524;5040;2351;7643
412217;201612;1064;3015;903;2692;84;315;646;1789;730;2104
412220;201612;5595;17860;4959;16508;1490;4915;1951;6641;3441;11556
412230;201612;2801;9118;2186;7735;443;1710;613;1953;1056;3663
412240;201612;8559;21818;4415;13672;836;2838;935;2550;1771;5388
412250;201612;1833;5345;1402;4382;352;1111;162;423;514;1534
412260;201612;1251;3467;728;2242;115;410;290;774;405;1184
412265;201612;936;2848;788;2561;200;677;288;935;488;1612
412270;201612;819;2547;502;1747;80;303;179;571;259;874
412280;201612;624;1918;427;1470;144;540;24;47;168;587
412290;201612;987;2764;675;2156;132;451;210;601;342;1052
412300;201612;1611;4893;1315;4261;349;1179;293;868;642;2047
412310;201612;930;2740;727;2360;111;438;326;1044;437;1482
412320;201612;821;2210;532;1642;100;375;190;542;290;917
412330;201612;1437;4124;956;3059;148;511;425;1341;573;1852
412340;201612;889;2782;508;1764;69;255;98;296;167;551
412350;201612;2120;6555;1413;4839;253;857;50;120;303;977
412360;201612;292;849;144;470;16;67;56;157;72;224
412370;201612;854;2512;574;1950;112;403;90;298;202;701
412380;201612;1469;4581;1076;3602;276;949;217;709;493;1658
412382;201612;647;1789;398;1241;70;233;94;240;164;473
412385;201612;2251;6938;1881;6069;704;2316;449;1456;1153;3772
412390;201612;2046;5802;1798;5359;429;1352;722;2206;1151;3558
412395;201612;745;2125;536;1705;85;303;269;805;354;1108
412400;201612;817;2563;636;2106;163;568;158;525;321;1093
412402;201612;1784;5197;1267;4073;300;1041;268;760;568;1801
412405;201612;3337;9696;1651;5626;275;1031;77;216;352;1247
412410;201612;4811;14286;3533;11668;989;3629;720;2172;1709;5801
412420;201612;368;1095;221;718;36;115;69;189;105;304
412430;201612;540;1509;341;1080;63;221;99;290;162;511
412440;201612;2971;9051;2116;7257;520;1903;509;1710;1029;3613
412450;201612;253;833;160;559;25;82;17;46;42;128
412460;201612;689;2191;520;1768;138;482;90;306;228;788
412470;201612;1823;6170;1431;5114;467;1769;266;985;733;2754
412480;201612;1101;3287;669;2164;101;336;91;222;192;558
412490;201612;855;2522;666;2105;132;423;237;685;369;1108
412500;201612;1834;5273;1369;4267;257;885;325;851;582;1736
412510;201612;2140;6935;1609;5572;494;1851;295;911;789;2762
412520;201612;1389;3968;917;2898;282;902;115;318;397;1220
412530;201612;548;1614;357;1133;79;260;69;215;148;475
412535;201612;739;2143;431;1376;76;264;103;298;179;562
412540;201612;1193;3380;777;2473;122;460;243;742;365;1202
412545;201612;686;1978;474;1465;83;282;153;413;236;695
412550;201612;29548;87955;18299;61240;4260;14875;4113;12591;8373;27466
412555;201612;245;719;147;475;27;86;34;92;61;178
412560;201612;5192;15828;3634;12135;732;2816;962;3007;1694;5823
412570;201612;4057;11768;2381;7985;533;1941;338;1116;871;3057
412575;201612;833;2556;598;1954;125;421;193;591;318;1012
412580;201612;1213;3364;790;2456;140;449;298;836;438;1285
412590;201612;443;1295;249;847;53;185;50;158;103;343
412600;201612;1389;4230;932;3126;203;724;255;790;458;1514
412610;201612;723;2169;418;1375;99;329;121;367;220;696
412620;201612;1177;3683;857;2978;222;867;143;417;365;1284
412625;201612;8063;23394;5321;17386;1030;3551;520;1512;1550;5063
412627;201612;939;2893;610;2095;207;753;96;316;303;1069
412630;201612;3091;9691;2209;7584;467;1566;610;1982;1077;3548
412635;201612;455;1322;272;883;68;212;18;41;86;253
412640;201612;861;2590;469;1612;77;271;53;169;130;440
412650;201612;1550;4660;1219;3943;232;868;379;1093;611;1961
412660;201612;2495;7082;1780;5564;393;1375;388;1026;781;2401
412665;201612;630;1633;316;995;85;272;72;209;157;481
412667;201612;1622;4597;1161;3596;324;992;278;837;602;1829
412670;201612;501;1531;378;1264;97;359;62;193;159;552
412680;201612;1322;3935;721;2501;115;427;181;539;296;966
412690;201612;716;2137;513;1687;139;493;103;326;242;819
412700;201612;1787;5371;1444;4802;458;1699;352;1076;810;2775
412710;201612;6127;19425;4731;16162;1067;3982;1180;3607;2247;7589
412720;201612;1328;4076;816;2728;132;459;159;431;291;890
412730;201612;2012;6031;1053;3659;226;841;100;305;326;1146
412740;201612;1423;4514;909;3265;186;711;119;452;305;1163
412750;201612;3984;12005;3414;10945;448;1647;2106;6564;2554;8211
412760;201612;2359;7397;2138;6959;274;1020;1386;4361;1660;5381
412770;201612;10195;28137;4752;15683;733;2559;914;2570;1647;5129
412780;201612;1235;3733;982;3208;213;739;385;1172;598;1911
412785;201612;2152;6006;1544;4778;421;1310;654;2049;1075;3359
412788;201612;1408;4436;1127;3816;299;1119;295;842;594;1961
412790;201612;1042;3116;672;2229;135;481;128;335;263;816
412795;201612;945;2590;622;1901;117;362;232;686;349;1048
412796;201612;2604;7924;2231;7100;540;1834;867;2571;1407;4405
412800;201612;3006;8516;2076;6424;333;1127;758;2170;1091;3297
412810;201612;11006;29890;5527;17561;780;2749;1445;3697;2225;6446
412820;201612;7052;20584;4710;15576;1137;3842;1180;3867;2317;7709
412830;201612;354;1090;223;764;42;154;53;173;95;327
412840;201612;1753;4956;1270;3904;232;759;297;883;529;1642
412850;201612;2721;7948;2000;6525;414;1492;603;1762;1017;3254
412853;201612;1721;4921;1427;4266;138;443;780;2178;918;2621
412855;201612;1349;3922;905;2838;194;659;188;467;382;1126
412860;201612;1136;3247;839;2639;231;784;282;808;513;1592
412862;201612;741;1918;427;1305;68;213;124;384;192;597
412863;201612;1134;3803;1089;3714;149;552;775;2590;924;3142
412865;201612;690;2053;470;1569;117;402;140;477;257;879
412870;201612;876;2527;626;2035;251;882;77;224;328;1106
412880;201612;771;2303;531;1759;99;359;40;97;139;456
420005;201612;521;1554;275;960;50;193;90;296;140;489
420010;201612;3140;8725;2422;7627;336;1078;1630;5143;1966;6221
420020;201612;676;2191;330;1242;34;152;41;141;75;293
420030;201612;443;1149;199;682;46;191;21;61;67;252
420040;201612;659;2112;346;1340;66;286;21;62;87;348
420050;201612;702;2003;432;1413;101;332;168;534;269;866
420055;201612;185;566;86;315;19;73;14;46;33;119
420060;201612;223;721;135;486;18;75;27;77;45;152
420070;201612;1251;3993;889;3079;182;698;327;1127;509;1825
420075;201612;162;433;64;203;10;32;10;19;20;51
420080;201612;569;1786;442;1517;137;487;106;363;243;850
420090;201612;396;1348;262;990;66;261;43;169;109;430
420100;201612;1132;3590;1028;3428;237;806;565;1890;802;2696
420110;201612;284;965;249;867;62;224;74;257;136;481
420120;201612;265;910;205;763;63;262;48;152;111;414
420125;201612;291;1053;258;978;71;288;109;405;180;693
420127;201612;442;1272;138;519;32;134;13;38;45;172
420130;201612;1801;6047;1318;4935;353;1447;242;792;595;2239
420140;201612;4079;12131;2695;9169;599;2235;399;1133;998;3368
420150;201612;641;1783;364;1224;53;195;164;524;217;719
420160;201612;257;708;142;478;26;88;37;119;63;207
420165;201612;210;653;108;377;22;82;20;64;42;146
420170;201612;201;617;111;424;33;140;10;35;43;175
420180;201612;365;1091;179;643;26;96;45;151;71;247
420190;201612;356;1102;145;560;31;122;10;32;41;154
420195;201612;1290;3822;962;3161;254;886;204;615;458;1501
420200;201612;2339;7202;1274;4683;263;1079;221;740;484;1819
420205;201612;1031;3289;799;2825;184;706;415;1443;599;2149
420207;201612;1428;4191;901;3059;261;970;178;550;439;1520
420208;201612;577;1550;288;1031;95;358;65;246;160;604
420209;201612;277;851;159;555;26;102;75;251;101;353
420210;201612;1771;5256;1059;3969;289;1245;371;1259;660;2504
420213;201612;760;2676;690;2509;193;739;322;1168;515;1907
420215;201612;307;984;186;667;54;203;11;45;65;248
420220;201612;164;568;129;494;36;146;45;160;81;306
420230;201612;4048;11908;2832;9546;559;2183;1054;3306;1613;5489
420240;201612;10457;29024;6267;20725;963;3709;2827;8269;3790;11978
420243;201612;589;1757;444;1460;91;316;147;469;238;785
420245;201612;1228;3610;766;2618;110;434;299;894;409;1328
420250;201612;485;1557;409;1391;101;416;178;551;279;967
420253;201612;473;1246;346;1060;42;123;209;665;251;788
420257;201612;282;773;155;516;38;125;65;218;103;343
420260;201612;1114;3566;864;3056;183;726;337;1161;520;1887
420270;201612;647;1910;185;645;31;113;55;166;86;279
420280;201612;2052;5558;1160;3857;253;925;366;1126;619;2051
420285;201612;146;425;58;218;9;36;3;7;12;43
420287;201612;492;1434;385;1248;133;462;112;354;245;816
420290;201612;5648;16984;3505;11762;695;2441;1064;3240;1759;5681
420300;201612;6457;19282;3593;12702;828;3141;641;1997;1469;5138
420310;201612;778;2077;611;1749;83;270;432;1191;515;1461
420315;201612;919;2891;665;2342;225;833;190;649;415;1482
420320;201612;4331;13363;3347;11426;1068;3952;1019;3328;2087;7280
420325;201612;188;624;161;559;24;93;61;195;85;288
420330;201612;913;3115;624;2371;126;523;175;604;301;1127
420340;201612;1378;4225;906;3073;156;591;75;211;231;802
420350;201612;1440;4234;976;3266;274;976;347;1079;621;2055
420360;201612;2878;8689;1565;5662;311;1250;132;408;443;1658
420370;201612;1716;4948;1308;4191;181;606;876;2750;1057;3356
420380;201612;5080;15155;3076;10561;748;2714;767;2472;1515;5186
420390;201612;1189;3364;603;2056;120;455;123;315;243;770
420395;201612;1267;3895;750;2643;99;386;83;237;182;623
420400;201612;1157;3422;726;2493;168;632;151;453;319;1085
420410;201612;688;1849;453;1428;89;312;260;778;349;1090
420415;201612;456;1406;299;1021;88;306;80;266;168;572
420417;201612;687;2188;519;1749;105;366;226;740;331;1106
420419;201612;304;995;188;713;66;268;9;34;75;302
420420;201612;10082;30639;7546;25309;2767;9788;1449;4371;4216;14159
420425;201612;1156;3094;687;2151;86;335;324;927;410;1262
420430;201612;3234;9855;1902;6572;418;1557;591;1953;1009;3510
420435;201612;267;787;157;541;36;139;69;220;105;359
420440;201612;764;2375;398;1375;169;635;72;211;241;846
420445;201612;374;1072;217;693;46;147;69;211;115;358
420450;201612;749;2289;466;1619;88;341;117;358;205;699
420455;201612;1879;5502;1478;4735;242;941;699;2043;941;2984
420460;201612;8453;24610;5979;19897;1366;5134;2295;6982;3661;12116
420470;201612;1025;2687;534;1717;104;357;165;479;269;836
420475;201612;98;284;45;162;15;46;5;15;20;61
420480;201612;4754;13686;3123;10347;764;2672;629;2012;1393;4684
420490;201612;629;1647;307;1066;78;293;63;229;141;522
420500;201612;1420;4510;996;3608;324;1272;305;1056;629;2328
420510;201612;119;443;85;353;20;92;45;182;65;274
420515;201612;74;226;57;198;10;40;14;50;24;90
420517;201612;825;2526;694;2261;132;478;381;1177;513;1655
420519;201612;462;1203;266;829;49;144;67;192;116;336
420520;201612;640;1653;304;1018;59;195;65;174;124;369
420530;201612;1147;3621;745;2684;178;735;186;552;364;1287
420535;201612;262;754;102;362;24;70;11;51;35;121
420540;201612;21819;60825;13556;42515;3211;10810;3698;9575;6909;20385
420543;201612;353;925;264;771;22;80;174;523;196;603
420545;201612;1523;4748;1129;3842;244;909;343;1080;587;1989
420550;201612;3865;12081;2551;9262;693;2874;438;1443;1131;4317
420555;201612;351;1056;245;825;46;175;91;279;137;454
420560;201612;473;1391;346;1149;66;230;168;530;234;760
420570;201612;2093;6600;1456;5076;388;1507;459;1442;847;2949
420580;201612;1528;4581;1125;3848;274;1048;456;1495;730;2543
420590;201612;3182;9485;1799;6145;381;1396;298;820;679;2216
420600;201612;898;2918;793;2687;137;477;446;1553;583;2030
420610;201612;478;1451;247;896;57;227;56;194;113;421
420620;201612;536;1653;446;1450;117;394;119;382;236;776
420630;201612;943;2895;632;2132;154;558;227;689;381;1247
420640;201612;762;2268;321;1190;89;365;24;77;113;442
420650;201612;2394;6971;1333;4629;243;863;346;1071;589;1934
420660;201612;457;1342;287;958;69;250;77;246;146;496
420665;201612;659;1839;403;1335;54;187;143;420;197;607
420670;201612;1621;4770;1015;3443;206;804;259;762;465;1566
420675;201612;179;588;123;439;24;93;26;89;50;182
420680;201612;437;1041;228;706;31;103;89;264;120;367
420690;201612;822;2840;538;2014;87;325;94;282;181;607
420700;201612;3032;8939;2114;6949;432;1520;746;2257;1178;3777
420710;201612;601;1986;423;1563;107;448;139;473;246;921
420720;201612;1610;4625;1217;4017;359;1236;516;1676;875;2912
420730;201612;3028;9057;2369;7793;523;1880;1000;3135;1523;5015
420740;201612;793;2439;589;1991;200;728;174;537;374;1265
420750;201612;2045;6554;1386;4943;215;847;468;1470;683;2317
420757;201612;94;219;35;128;6;25;15;56;21;81
420760;201612;371;1168;163;555;39;143;21;59;60;202
420765;201612;526;1662;239;909;55;223;50;177;105;400
420768;201612;1170;3989;905;3417;397;1483;270;1084;667;2567
420770;201612;534;1604;284;1059;67;286;53;187;120;473
420775;201612;623;1871;304;1057;69;252;45;140;114;392
420780;201612;1413;4260;729;2530;141;493;119;392;260;885
420785;201612;260;787;179;583;26;91;51;141;77;232
420790;201612;1208;4107;890;3334;276;1129;296;1025;572;2154
420800;201612;867;2418;386;1288;92;324;122;391;214;715
420810;201612;1939;6550;1447;5416;448;1866;283;938;731;2804
420820;201612;8292;24665;5360;19159;1327;5224;1397;4746;2724;9970
420830;201612;2692;8374;2071;7093;583;2140;675;2236;1258;4376
420840;201612;982;2856;403;1476;87;344;74;236;161;580
420845;201612;1377;4065;827;2976;225;926;177;586;402;1512
420850;201612;1474;4659;810;3093;173;726;53;173;226;899
420860;201612;370;1043;196;691;53;207;36;126;89;333
420870;201612;1038;2930;767;2451;271;971;196;542;467;1513
420880;201612;973;3290;681;2471;138;553;119;367;257;920
420890;201612;9033;24249;4085;13685;694;2494;1017;2910;1711;5404
420895;201612;203;583;100;331;31;104;15;43;46;147
420900;201612;1741;4893;993;3358;201;751;269;806;470;1557
420910;201612;23844;69987;14779;50790;2755;10413;4766;14819;7521;25232
420915;201612;532;2093;367;1590;74;336;156;607;230;943
420917;201612;472;1443;183;609;36;138;69;201;105;339
420920;201612;168;488;66;234;11;48;11;38;22;86
420930;201612;17697;50315;12475;40532;2721;9548;4952;15094;7673;24642
420940;201612;2695;8028;1844;6205;448;1622;124;348;572;1970
420945;201612;196;592;116;404;26;108;30;88;56;196
420950;201612;558;1544;247;911;30;143;54;183;84;326
420960;201612;899;2550;638;2046;133;465;271;792;404;1257
420970;201612;2398;7569;1838;6436;599;2241;403;1345;1002;3586
420980;201612;435;1281;319;1092;119;439;101;377;220;816
420985;201612;476;1347;202;726;43;188;51;166;94;354
420990;201612;764;2142;376;1312;60;224;57;167;117;391
421000;201612;529;1815;309;1214;62;259;53;164;115;423
421003;201612;670;1792;200;687;21;68;22;55;43;123
421005;201612;138;418;99;350;20;76;48;176;68;252
421010;201612;4914;13937;3153;10553;760;2767;647;1892;1407;4659
421020;201612;432;1324;297;1055;32;136;175;607;207;743
421030;201612;713;2544;601;2248;178;746;83;281;261;1027
421040;201612;876;2216;500;1577;84;299;257;772;341;1071
421050;201612;1517;4335;770;2630;156;565;155;444;311;1009
421055;201612;196;550;88;281;21;70;18;37;39;107
421060;201612;523;1718;322;1170;74;303;94;328;168;631
421070;201612;650;2062;368;1345;84;326;54;187;138;513
421080;201612;677;2955;594;2825;80;258;448;2352;528;2610
421085;201612;494;1376;225;800;46;185;64;196;110;381
421090;201612;389;1077;160;535;22;83;44;133;66;216
421100;201612;948;2542;427;1392;116;389;36;110;152;499
421105;201612;1433;4295;1085;3651;249;888;332;1135;581;2023
421110;201612;935;3318;825;3047;297;1141;156;516;453;1657
421120;201612;1258;4041;729;2644;106;444;189;581;295;1025
421125;201612;402;1106;274;874;87;303;72;194;159;497
421130;201612;3026;10025;2510;8955;829;3148;811;2892;1640;6040
421140;201612;313;906;220;701;48;148;79;229;127;377
421145;201612;537;1677;293;1013;43;149;92;309;135;458
421150;201612;613;1756;420;1417;83;312;168;529;251;841
421160;201612;1139;3140;501;1667;101;373;173;530;274;903
421165;201612;222;754;171;618;28;93;81;306;109;399
421170;201612;1271;3613;954;3069;175;603;555;1743;730;2346
421175;201612;1166;3314;730;2444;151;607;278;802;429;1409
421180;201612;528;1455;240;819;53;209;36;103;89;312
421185;201612;400;1101;262;829;52;158;114;380;166;538
421187;201612;324;979;208;700;35;120;83;252;118;372
421189;201612;400;1235;292;990;54;199;77;235;131;434
421190;201612;11158;31612;5935;20698;1275;4809;925;2871;2200;7680
421200;201612;895;2927;708;2488;166;597;208;679;374;1276
421205;201612;206;621;139;477;35;145;37;105;72;250
421210;201612;1375;4147;918;3068;252;850;229;757;481;1607
421220;201612;1699;5786;1417;5091;406;1597;206;600;612;2197
421223;201612;505;1583;340;1222;85;328;118;431;203;759
421225;201612;1084;3448;863;2949;191;721;344;1162;535;1883
421227;201612;762;2415;655;2228;138;521;364;1190;502;1711
421230;201612;443;1421;358;1248;92;347;150;501;242;848
421240;201612;393;1235;170;638;21;93;29;86;50;179
421250;201612;1545;4460;906;3246;263;974;177;624;440;1598
421260;201612;351;989;69;253;17;56;14;50;31;106
421265;201612;786;2351;674;2157;111;399;409;1265;520;1664
421270;201612;729;1997;332;1125;67;229;77;275;144;504
421280;201612;1521;4807;1126;4054;314;1277;442;1490;756;2767
421290;201612;948;2627;492;1612;92;316;95;272;187;588
421300;201612;288;862;202;669;54;218;81;235;135;453
421310;201612;203;627;142;473;23;81;50;166;73;247
421315;201612;318;961;159;578;29;107;21;73;50;180
421320;201612;604;1831;322;1108;61;215;56;137;117;352
421330;201612;561;1803;398;1454;117;461;81;301;198;762
421335;201612;466;1580;364;1349;77;330;73;270;150;600
421340;201612;1704;4803;1277;4078;178;705;713;2187;891;2892
421350;201612;1020;3303;827;2890;131;541;457;1503;588;2044
421360;201612;2750;7884;1531;5364;387;1481;426;1314;813;2795
421370;201612;529;1785;386;1452;114;471;108;378;222;849
421380;201612;877;2506;705;2154;107;363;368;1066;475;1429
421390;201612;176;493;64;220;25;95;21;59;46;154
421400;201612;273;915;186;744;46;199;62;217;108;416
421410;201612;302;860;165;565;20;74;73;246;93;320
421415;201612;363;1172;136;507;31;118;24;81;55;199
421420;201612;752;2251;526;1738;89;317;211;633;300;950
421430;201612;198;643;146;528;30;119;35;128;65;247
421440;201612;824;2327;516;1761;113;422;222;740;335;1162
421450;201612;423;1294;211;788;33;131;25;98;58;229
421460;201612;576;1597;269;990;54;210;64;237;118;447
421470;201612;380;1250;276;1006;74;301;72;241;146;542
421480;201612;2982;8397;1753;6063;612;2436;217;518;829;2954
421490;201612;270;808;104;404;21;94;19;63;40;157
421500;201612;1997;6825;1539;5749;483;1988;175;616;658;2604
421505;201612;346;1132;296;1017;69;239;124;420;193;659
421507;201612;528;1582;306;1074;72;265;81;287;153;552
421510;201612;171;551;128;459;19;86;61;170;80;256
421520;201612;777;2110;446;1373;57;207;198;521;255;728
421530;201612;305;960;151;588;29;134;28;90;57;224
421535;201612;646;1874;321;1155;45;182;139;453;184;635
421540;201612;323;862;230;694;51;162;81;211;132;373
421545;201612;783;2454;510;1891;132;534;145;501;277;1035
421550;201612;1992;6227;1589;5487;483;1858;495;1555;978;3413
421555;201612;314;907;91;324;16;67;15;43;31;110
421560;201612;185;583;73;266;17;64;14;49;31;113
421565;201612;751;2187;657;2066;221;768;279;878;500;1646
421567;201612;582;2118;488;1889;246;967;102;391;348;1358
421568;201612;504;1524;304;1036;66;236;91;299;157;535
421569;201612;231;692;90;331;13;48;15;56;28;104
421570;201612;1335;3992;672;2349;177;639;100;325;277;964
421575;201612;346;1188;291;1024;55;198;148;514;203;712
421580;201612;2905;9158;2010;7068;491;1927;543;1653;1034;3580
421590;201612;213;644;160;535;23;82;85;272;108;354
421600;201612;492;1538;345;1178;84;303;75;219;159;522
421605;201612;587;1806;396;1419;71;277;119;397;190;674
421610;201612;1350;3680;855;2693;146;509;337;972;483;1481
421620;201612;4343;13063;2652;9400;761;2822;690;2382;1451;5204
421625;201612;373;1029;131;446;32;100;14;48;46;148
421630;201612;2874;8522;1378;4837;338;1258;208;665;546;1923
421635;201612;217;654;95;316;13;53;27;69;40;122
421640;201612;1043;3041;690;2326;150;504;238;786;388;1290
421650;201612;2099;6670;1387;4917;345;1383;178;510;523;1893
421660;201612;7208;23401;5639;19935;1241;4783;1802;5773;3043;10556
421670;201612;1031;3070;636;2140;167;626;189;581;356;1207
421680;201612;1122;3583;877;3035;293;1056;174;568;467;1624
421690;201612;1420;4633;943;3432;218;863;91;269;309;1132
421700;201612;462;1501;219;849;46;191;59;201;105;392
421710;201612;209;695;92;337;18;69;26;84;44;153
421715;201612;220;586;105;344;27;96;35;97;62;193
421720;201612;1873;5510;1033;3688;282;1089;143;406;425;1495
421725;201612;131;399;94;316;25;89;20;57;45;146
421730;201612;566;1611;237;795;37;132;67;199;104;331
421740;201612;677;2188;414;1509;97;400;72;230;169;630
421750;201612;974;2556;542;1681;99;328;202;559;301;887
421755;201612;303;874;153;494;34;123;47;143;81;266
421760;201612;892;2698;370;1363;70;259;69;228;139;487
421770;201612;2792;8319;1919;6490;506;1758;626;2164;1132;3922
421775;201612;461;1343;290;997;46;177;105;334;151;511
421780;201612;977;3354;693;2624;171;733;191;631;362;1364
421790;201612;760;2024;423;1481;173;647;88;251;261;898
421795;201612;344;1002;196;628;35;125;56;168;91;293
421800;201612;2607;7792;1822;6154;435;1605;673;2099;1108;3704
421810;201612;572;1752;378;1333;105;407;55;169;160;576
421820;201612;976;2835;516;1787;78;270;78;219;156;489
421825;201612;1428;4492;1328;4281;164;614;972;3051;1136;3665
421830;201612;2443;8272;2045;7373;536;2113;650;2153;1186;4266
421835;201612;161;476;116;408;19;84;76;256;95;340
421840;201612;281;877;180;641;39;162;65;201;104;363
421850;201612;418;1346;217;802;33;141;48;162;81;303
421860;201612;297;910;172;627;33;137;41;117;74;254
421870;201612;3631;10283;2272;7345;721;2499;487;1477;1208;3976
421875;201612;389;1153;150;569;30;128;14;48;44;176
421880;201612;806;2458;546;1864;117;444;115;360;232;804
421885;201612;288;905;215;756;74;270;60;198;134;468
421890;201612;809;2772;666;2467;234;1005;196;639;430;1644
421895;201612;369;1168;320;1081;62;231;184;618;246;849
421900;201612;934;2576;534;1725;136;456;147;436;283;892
421910;201612;475;1491;299;1081;66;279;54;145;120;424
421915;201612;492;1477;271;926;52;169;50;169;102;338
421917;201612;584;1658;378;1315;133;518;102;334;235;852
421920;201612;675;1939;430;1581;225;845;98;376;323;1221
421930;201612;2970;7751;1447;4935;351;1278;200;588;551;1866
421935;201612;627;2030;438;1591;89;378;153;495;242;873
421940;201612;222;755;118;448;12;53;26;80;38;133
421950;201612;3422;9287;1395;4840;341;1267;170;547;511;1814
421960;201612;179;525;120;411;28;106;23;75;51;181
421970;201612;2294;6235;1203;3872;353;1153;323;939;676;2092
421985;201612;448;1146;215;663;32;116;72;224;104;340
422000;201612;1254;3754;980;3190;272;964;372;1186;644;2150
430003;201612;591;1882;479;1656;129;499;141;459;270;958
430005;201612;323;951;216;729;45;165;90;285;135;450
430010;201612;1990;5472;1484;4544;390;1260;631;1910;1021;3170
430020;201612;644;1601;514;1402;80;248;318;819;398;1067
430030;201612;1034;2667;688;2016;228;700;120;309;348;1009
430040;201612;10585;28140;6808;20592;1746;5751;764;2083;2510;7834
430045;201612;680;1840;474;1411;90;274;196;569;286;843
430047;201612;283;663;110;335;16;46;41;123;57;169
430050;201612;1019;2787;516;1662;113;361;129;394;242;755
430055;201612;296;778;140;431;14;52;65;185;79;237
430057;201612;69;170;33;96;3;6;6;9;9;15
430060;201612;16371;51643;13448;46064;3924;14259;5069;17270;8993;31529
430063;201612;962;2830;710;2267;188;601;336;1083;524;1684
430064;201612;1201;3599;926;3052;272;906;251;826;523;1732
430066;201612;170;394;110;292;10;33;62;158;72;191
430070;201612;634;1690;136;462;21;78;15;39;36;117
430080;201612;700;1978;388;1334;95;353;111;330;206;683
430085;201612;938;2402;515;1593;95;324;150;473;245;797
430087;201612;779;2471;675;2256;129;469;333;1039;462;1508
430090;201612;620;1636;211;697;33;123;50;161;83;284
430100;201612;838;2187;394;1245;93;309;105;269;198;578
430105;201612;1002;2865;618;2116;146;550;210;689;356;1239
430107;201612;216;709;144;506;31;118;37;115;68;233
430110;201612;1843;5217;1414;4485;332;1095;656;1941;988;3036
430120;201612;1588;4812;1086;3683;248;844;431;1479;679;2323
430130;201612;3581;9387;2801;8020;844;2462;920;2633;1764;5095
430140;201612;1145;3504;707;2471;204;724;205;712;409;1436
430150;201612;712;1903;407;1278;101;337;102;325;203;662
430155;201612;311;862;153;507;27;95;40;121;67;216
430160;201612;16350;46888;13322;41287;3503;11432;5057;15649;8560;27081
430163;201612;1911;5536;1454;4697;214;767;806;2538;1020;3305
430165;201612;457;1110;99;328;13;42;14;33;27;75
430170;201612;917;2609;305;1128;48;184;34;100;82;284
430175;201612;866;2717;691;2283;212;660;263;944;475;1604
430180;201612;768;2147;606;1833;143;478;300;849;443;1327
430185;201612;499;1327;269;840;51;158;94;250;145;408
430187;201612;645;1917;465;1498;117;408;157;474;274;882
430190;201612;1581;4718;1310;4136;276;930;662;2020;938;2950
430192;201612;179;547;65;210;6;18;13;37;19;55
430195;201612;381;1159;70;243;9;33;2;7;11;40
430200;201612;1332;4246;1083;3669;329;1178;272;876;601;2054
430205;201612;550;1576;404;1277;47;164;281;878;328;1042
430210;201612;5777;15345;3190;9611;483;1622;1030;2484;1513;4106
430215;201612;352;973;223;684;40;124;92;262;132;386
430220;201612;639;1655;196;700;38;149;35;108;73;257
430222;201612;259;807;201;665;27;103;97;304;124;407
430223;201612;354;994;275;844;69;200;123;391;192;591
430225;201612;34;83;15;41;4;12;5;12;9;24
430230;201612;1575;4730;1492;4614;263;710;1155;3714;1418;4424
430235;201612;262;842;197;677;44;162;63;198;107;360
430237;201612;521;1337;353;1031;37;128;222;607;259;735
430240;201612;996;2531;620;1893;70;256;338;962;408;1218
430245;201612;789;2460;581;1999;173;606;230;821;403;1427
430250;201612;1064;3108;897;2785;316;1026;96;278;412;1304
430258;201612;163;462;116;374;10;33;50;169;60;202
430260;201612;671;1923;477;1515;66;209;266;868;332;1077
430265;201612;270;836;200;692;41;135;30;105;71;240
430270;201612;2817;7798;2334;6938;345;1152;1401;3956;1746;5108
430280;201612;4613;12264;3504;10212;846;2528;1544;4477;2390;7005
430290;201612;2406;6280;2175;5913;129;379;1893;5100;2022;5479
430300;201612;8801;25758;6909;21890;1661;5611;3136;9882;4797;15493
430310;201612;6500;19296;4641;15492;1106;3988;1793;5529;2899;9517
430320;201612;819;2388;481;1618;102;312;218;749;320;1061
430330;201612;659;1754;481;1388;130;358;201;542;331;900
430340;201612;697;1722;328;1068;66;218;169;536;235;754
430350;201612;5827;17602;4652;14952;1968;6309;1216;3807;3184;10116
430355;201612;381;958;119;373;23;83;16;48;39;131
430360;201612;968;2567;709;2049;158;484;273;727;431;1211
430367;201612;232;637;141;446;35;134;49;139;84;273
430370;201612;522;1432;291;944;71;243;63;184;134;427
430380;201612;706;1865;349;1157;127;466;83;260;210;726
430390;201612;3758;10423;2090;6810;375;1301;267;806;642;2107
430400;201612;1315;3175;926;2486;311;833;337;851;648;1684
430410;201612;582;1552;390;1193;71;226;202;602;273;828
430420;201612;3413;9855;2549;7870;749;2384;824;2452;1573;4836
430430;201612;662;1819;367;1211;113;387;87;285;200;672
430435;201612;1991;5383;1358;4158;378;1189;413;1278;791;2467
430440;201612;3989;12405;2893;9794;632;2208;1212;4128;1844;6336
430450;201612;6884;19248;5287;15991;1821;5647;1306;3982;3127;9629
430460;201612;27394;81131;19799;66477;5504;19966;5696;18250;11200;38216
430461;201612;509;1345;137;437;22;70;38;116;60;186
430462;201612;282;799;165;579;33;127;30;108;63;235
430463;201612;3917;12441;3243;11087;719;2636;1533;5204;2252;7840
430465;201612;568;1593;485;1435;137;437;255;721;392;1158
430466;201612;3464;9318;2895;8363;673;2073;1491;4096;2164;6169
430467;201612;459;1356;354;1124;74;250;141;415;215;665
430468;201612;1343;3757;1072;3290;257;804;445;1299;702;2103
430469;201612;485;1317;53;187;8;25;8;18;16;43
430470;201612;7587;20203;4846;15201;1455;4713;842;2584;2297;7297
430471;201612;484;1609;419;1443;130;459;99;342;229;801
430480;201612;989;2617;445;1463;74;251;100;293;174;544
430485;201612;146;415;65;209;15;52;12;29;27;81
430490;201612;291;846;180;605;34;121;79;266;113;387
430495;201612;366;1094;218;759;48;179;63;197;111;376
430500;201612;1117;3087;878;2667;215;726;414;1193;629;1919
430510;201612;21357;61346;15599;49484;4971;16830;4322;12571;9293;29401
430511;201612;380;1180;144;506;23;87;15;35;38;122
430512;201612;1031;2665;828;2284;229;674;235;661;464;1335
430513;201612;787;2041;407;1205;104;331;154;415;258;746
430515;201612;455;1312;301;979;49;147;140;478;189;625
430517;201612;1138;3576;889;3031;178;623;437;1496;615;2119
430520;201612;1459;4024;815;2578;178;620;194;523;372;1143
430530;201612;1084;2893;439;1417;72;260;117;322;189;582
430535;201612;2414;7150;1669;5603;367;1299;648;2073;1015;3372
430537;201612;463;1506;380;1308;38;126;266;911;304;1037
430540;201612;703;1562;454;1211;85;235;267;703;352;938
430543;201612;459;1174;394;1091;68;206;280;774;348;980
430544;201612;648;2057;516;1737;129;473;234;745;363;1218
430545;201612;1267;4105;1083;3858;379;1425;438;1520;817;2945
430550;201612;606;1718;319;1037;77;275;54;145;131;420
430558;201612;81;242;47;150;12;45;12;24;24;69
430560;201612;388;932;143;460;14;54;57;164;71;218
430570;201612;1070;2754;628;1841;140;471;262;643;402;1114
430580;201612;1189;2975;704;2156;117;395;348;1051;465;1446
430583;201612;169;456;37;118;4;10;5;18;9;28
430585;201612;302;765;165;473;29;104;73;182;102;286
430587;201612;156;491;113;371;30;98;26;93;56;191
430590;201612;1210;3292;1074;3042;107;350;838;2301;945;2651
430593;201612;23;85;19;71;5;20;8;28;13;48
430595;201612;291;832;71;245;8;37;9;20;17;57
430597;201612;330;963;197;629;23;78;61;158;84;236
430600;201612;1937;5185;895;2759;177;550;269;764;446;1314
430605;201612;1246;3717;910;3005;170;637;381;1221;551;1858
430607;201612;757;1795;525;1428;71;198;320;892;391;1090
430610;201612;7282;19563;5187;15931;1580;5158;1100;3290;2680;8448
430613;201612;274;667;93;280;14;37;20;50;34;87
430620;201612;673;1883;528;1592;136;414;213;616;349;1030
430630;201612;382;1179;157;526;26;85;26;75;52;160
430632;201612;641;1798;287;911;52;173;92;257;144;430
430635;201612;579;1656;425;1326;111;379;204;602;315;981
430637;201612;479;1354;405;1196;69;233;227;617;296;850
430640;201612;1566;4173;567;1897;86;269;45;119;131;388
430642;201612;458;1190;266;820;47;139;117;364;164;503
430645;201612;279;639;89;256;18;51;26;77;44;128
430650;201612;1759;5670;1446;4995;321;1125;755;2632;1076;3757
430655;201612;157;403;131;351;31;107;63;133;94;240
430660;201612;5293;14819;4034;12462;1037;3400;1668;5019;2705;8419
430670;201612;434;1261;392;1170;38;114;304;928;342;1042
430673;201612;716;1679;282;859;66;203;85;249;151;452
430675;201612;247;738;64;229;7;35;18;53;25;88
430676;201612;3526;10377;2691;8698;674;2316;845;2723;1519;5039
430680;201612;1086;3089;577;1945;125;419;122;357;247;776
430690;201612;3935;11312;2969;9263;1001;3173;613;1890;1614;5063
430692;201612;252;830;188;709;17;82;123;441;140;523
430693;201612;1173;3218;645;2080;144;507;135;393;279;900
430695;201612;560;1523;338;1040;65;213;131;370;196;583
430697;201612;443;1252;298;969;78;271;107;344;185;615
430700;201612;9206;23653;3906;13039;747;2775;268;787;1015;3562
430705;201612;264;806;199;649;64;222;53;151;117;373
430710;201612;1667;4228;1185;3356;246;765;482;1351;728;2116
430720;201612;768;1922;467;1433;121;381;143;425;264;806
430730;201612;1580;4105;935;2945;203;666;387;1225;590;1891
430740;201612;577;1597;279;927;62;215;58;197;120;412
430745;201612;487;1391;196;635;28;91;34;117;62;208
430750;201612;1449;4008;1072;3305;198;662;553;1660;751;2322
430755;201612;465;1243;260;791;28;95;129;354;157;449
430760;201612;2750;6780;1746;5246;413;1383;650;1997;1063;3380
430770;201612;6103;17581;4613;14640;864;2920;2488;7649;3352;10569
430780;201612;2436;6453;1334;4265;264;882;410;1281;674;2163
430781;201612;422;1241;277;915;63;209;76;252;139;461
430783;201612;542;1307;295;857;60;194;134;350;194;544
430786;201612;74;250;44;169;8;32;9;27;17;59
430790;201612;4387;12016;2770;8602;657;2184;1063;3031;1720;5215
430800;201612;866;2416;533;1645;116;382;185;542;301;924
430805;201612;548;1522;314;1005;33;89;165;526;198;615
430807;201612;449;1268;272;858;56;199;79;235;135;434
430810;201612;706;1918;210;736;50;192;36;117;86;309
430820;201612;1354;3901;691;2391;152;532;128;422;280;954
430825;201612;307;835;106;325;24;60;19;39;43;99
430830;201612;1596;4946;1436;4693;246;874;888;2829;1134;3703
430840;201612;961;2883;810;2580;226;717;350;1127;576;1844
430843;201612;79;200;34;105;5;16;13;37;18;53
430845;201612;261;772;200;632;92;306;15;34;107;340
430850;201612;2334;6863;1865;5899;538;1843;683;2056;1221;3899
430860;201612;1016;2658;447;1452;102;387;155;448;257;835
430865;201612;592;1564;524;1454;184;515;222;599;406;1114
430870;201612;728;2012;321;1066;77;261;63;172;140;433
430880;201612;1139;3183;737;2347;193;633;204;669;397;1302
430885;201612;241;566;127;395;14;47;91;286;105;333
430890;201612;1638;4431;832;2606;104;353;164;425;268;778
430900;201612;2646;6951;1909;5603;424;1380;809;2206;1233;3586
430905;201612;1061;2999;612;2022;150;502;132;390;282;892
430910;201612;1576;4591;972;3213;210;771;333;947;543;1718
430912;201612;455;1290;322;1029;53;178;194;606;247;784
430915;201612;577;1789;386;1415;137;524;79;321;216;845
430920;201612;17058;50923;14374;45599;2704;9392;8153;24771;10857;34163
430925;201612;134;303;47;142;9;25;16;53;25;78
430930;201612;9443;26221;5720;18917;1674;5751;1164;4021;2838;9772
430940;201612;1217;3704;617;2177;172;624;72;203;244;827
430950;201612;884;2395;548;1681;134;428;195;537;329;965
430955;201612;163;475;60;206;11;46;13;39;24;85
430957;201612;232;774;187;678;39;133;85;310;124;443
430960;201612;1343;3556;1006;2936;246;802;461;1318;707;2120
430965;201612;1529;4217;1236;3672;95;333;927;2646;1022;2979
430970;201612;401;1091;215;686;51;159;71;206;122;365
430975;201612;555;1811;400;1411;103;383;139;500;242;883
430980;201612;355;913;205;658;48;147;70;217;118;364
430990;201612;556;1757;337;1171;61;225;101;334;162;559
430995;201612;600;1704;416;1302;122;381;146;436;268;817
431000;201612;1506;3811;602;1878;99;324;42;109;141;433
431010;201612;2635;7309;1319;4548;225;840;157;445;382;1285
431020;201612;10031;24519;5982;17100;1620;4788;1561;4208;3181;8996
431030;201612;320;914;125;452;27;97;15;50;42;147
431033;201612;2387;6980;1975;6265;569;1879;778;2496;1347;4375
431036;201612;217;561;83;277;13;43;16;40;29;83
431040;201612;903;2549;679;2127;132;491;326;931;458;1422
431041;201612;494;1290;405;1152;122;360;164;465;286;825
431043;201612;470;1290;239;835;104;371;47;149;151;520
431046;201612;103;294;68;214;5;19;20;61;25;80
431050;201612;1581;4055;1084;3149;300;871;478;1381;778;2252
431053;201612;579;1829;435;1496;141;517;87;291;228;808
431055;201612;664;1761;598;1648;78;207;435;1193;513;1400
431057;201612;360;1050;208;702;43;161;54;163;97;324
431060;201612;5293;15822;4422;14167;1505;4983;1150;3743;2655;8726
431065;201612;531;1510;345;1116;59;218;107;303;166;521
431070;201612;610;1791;303;1011;78;256;52;140;130;396
431075;201612;234;736;165;572;30;119;56;200;86;319
431080;201612;680;2060;425;1447;93;320;111;351;204;671
431085;201612;754;2076;560;1639;105;301;310;891;415;1192
431087;201612;525;1511;448;1343;46;133;313;944;359;1077
431090;201612;471;1171;173;553;45;144;34;97;79;241
431100;201612;3207;8884;2443;7486;645;2114;776;2245;1421;4359
431110;201612;1451;3813;992;2842;233;696;324;851;557;1547
431112;201612;535;1730;470;1583;106;360;229;733;335;1093
431113;201612;452;1331;343;1093;100;327;93;316;193;643
431115;201612;1340;3820;1124;3422;209;645;608;1832;817;2477
431120;201612;2623;7959;1866;6316;625;2363;512;1519;1137;3882
431123;201612;431;1248;262;893;70;228;122;426;192;654
431125;201612;1314;3941;863;2922;283;961;156;597;439;1558
431127;201612;253;684;43;139;8;22;10;26;18;48
431130;201612;3341;9599;2132;7067;477;1619;620;2054;1097;3673
431140;201612;4857;11860;2335;7197;360;1187;717;1946;1077;3133
431142;201612;456;1317;374;1163;59;183;223;700;282;883
431150;201612;1004;3019;725;2401;173;621;251;825;424;1446
431160;201612;812;2337;653;2034;120;340;301;1035;421;1375
431162;201612;523;1296;173;588;26;87;19;48;45;135
431164;201612;174;479;44;158;11;41;3;12;14;53
431170;201612;654;1796;427;1357;127;415;116;348;243;763
431171;201612;729;2149;603;1880;168;539;233;698;401;1237
431173;201612;443;1275;327;1058;129;446;60;179;189;625
431175;201612;964;2690;744;2264;211;666;189;541;400;1207
431177;201612;751;2411;535;1952;166;660;176;612;342;1272
431179;201612;364;787;81;238;16;48;14;31;30;79
431180;201612;2169;6072;1315;4297;293;1005;241;729;534;1734
431190;201612;579;1603;265;874;41;143;53;145;94;288
431198;201612;333;1102;281;996;96;352;77;291;173;643
431200;201612;403;1138;91;318;9;30;4;10;13;40
431205;201612;258;770;97;356;26;87;29;116;55;203
431210;201612;699;1858;568;1657;169;486;284;847;453;1333
431213;201612;229;688;166;557;25;97;83;273;108;370
431215;201612;230;716;122;441;25;89;10;31;35;120
431217;201612;162;489;102;352;29;96;39;134;68;230
431220;201612;827;2257;414;1330;37;129;181;529;218;658
431225;201612;1281;3569;889;2790;219;665;303;966;522;1631
431230;201612;775;2298;546;1785;95;333;233;734;328;1067
431235;201612;113;313;27;84;6;19;3;5;9;24
431237;201612;465;1375;357;1179;66;260;186;586;252;846
431238;201612;27;95;21;78;6;27;5;17;11;44
431240;201612;3363;9893;2701;8617;773;2638;1058;3243;1831;5881
431242;201612;380;1127;304;972;95;298;99;332;194;630
431244;201612;352;829;179;507;25;82;78;192;103;274
431245;201612;1214;3143;739;2198;118;357;347;1007;465;1364
431247;201612;199;557;122;394;30;97;28;83;58;180
431250;201612;1324;4347;1128;4006;311;1168;398;1394;709;2562
431260;201612;341;962;151;534;17;73;39;115;56;188
431261;201612;248;825;196;698;36;153;85;276;121;429
431262;201612;413;1131;170;564;18;66;93;314;111;380
431265;201612;1365;3402;587;1774;116;353;177;437;293;790
431267;201612;275;790;154;470;24;89;93;258;117;347
431270;201612;2742;6761;1510;4593;396;1292;442;1334;838;2626
431275;201612;225;679;113;415;35;131;12;43;47;174
431280;201612;312;857;94;309;10;37;16;36;26;73
431290;201612;314;967;205;700;40;154;29;69;69;223
431295;201612;74;208;24;78;0;0;7;18;7;18
431300;201612;388;972;43;166;1;4;1;3;2;7
431301;201612;271;835;75;260;13;47;11;26;24;73
431303;201612;726;1930;378;1172;51;177;135;386;186;563
431306;201612;2135;5545;1159;3626;146;530;358;925;504;1455
431308;201612;36;125;32;110;18;66;7;22;25;88
431310;201612;715;2115;390;1332;75;266;116;401;191;667
431320;201612;726;2016;336;1142;68;242;59;182;127;424
431330;201612;2662;6633;1171;3747;332;1150;93;246;425;1396
431333;201612;407;1097;139;430;23;70;29;73;52;143
431335;201612;39;120;23;84;7;31;2;2;9;33
431337;201612;2386;7156;1568;5413;361;1312;225;753;586;2065
431339;201612;521;1417;353;1068;78;235;172;511;250;746
431340;201612;22564;60053;14887;45655;3518;11403;3468;10142;6986;21545
431342;201612;531;1299;382;1055;120;383;206;507;326;890
431344;201612;352;982;236;754;5;12;190;602;195;614
431346;201612;298;752;92;288;19;64;11;34;30;98
431349;201612;728;2020;380;1160;70;216;139;389;209;605
431350;201612;3910;11374;2894;9306;694;2443;901;2672;1595;5115
431360;201612;617;1574;359;1098;100;301;89;275;189;576
431365;201612;1344;3933;1086;3453;192;652;620;1966;812;2618
431370;201612;4686;13136;3451;10851;934;3089;1143;3653;2077;6742
431380;201612;872;2715;767;2476;115;412;440;1390;555;1802
431390;201612;2839;7502;1492;4772;305;1079;411;1140;716;2219
431395;201612;1196;3567;937;3056;231;767;392;1288;623;2055
431400;201612;374;1160;144;486;34;118;31;98;65;216
431402;201612;1064;2607;640;1825;131;393;327;870;458;1263
431403;201612;185;551;145;473;46;170;49;138;95;308
431405;201612;3931;10946;2996;9398;590;2026;1557;4672;2147;6698
431406;201612;629;1930;464;1582;120;435;247;815;367;1250
431407;201612;510;1454;319;1057;72;236;104;315;176;551
431410;201612;13675;39110;8351;27924;2437;8890;1281;3950;3718;12840
431413;201612;207;510;68;228;5;19;13;38;18;57
431415;201612;693;1963;457;1490;100;366;130;359;230;725
431417;201612;513;1309;426;1170;50;149;281;755;331;904
431420;201612;1273;3465;1060;3107;240;737;445;1360;685;2097
431430;201612;560;1461;302;933;55;179;113;304;168;483
431440;201612;21207;58165;15783;48726;4811;15459;4454;14459;9265;29918
431442;201612;115;338;56;185;10;32;3;7;13;39
431445;201612;522;1477;176;576;24;77;45;136;69;213
431446;201612;380;1160;258;858;73;248;67;202;140;450
431447;201612;551;1580;393;1238;83;239;175;562;258;801
431449;201612;737;2010;531;1616;49;137;304;925;353;1062
431450;201612;2057;4989;1747;4473;183;553;1324;3239;1507;3792
431454;201612;62;216;53;193;10;37;22;86;32;123
431455;201612;686;1738;323;923;84;238;101;265;185;503
431460;201612;3023;8344;2383;7021;656;1955;752;2292;1408;4247
431470;201612;1728;5007;1164;3736;260;815;410;1336;670;2151
431475;201612;201;594;29;115;4;22;1;1;5;23
431477;201612;699;1830;411;1215;51;149;209;577;260;726
431478;201612;258;654;74;210;11;32;10;20;21;52
431480;201612;3047;8330;2166;6679;466;1525;988;2912;1454;4437
431490;201612;105814;285430;88193;256775;10719;36028;61149;172129;71868;208157
431500;201612;554;1529;420;1257;80;220;237;714;317;934
431505;201612;489;1181;307;885;24;71;193;553;217;624
431507;201612;361;869;186;522;39;112;92;246;131;358
431510;201612;1749;4951;1257;3905;297;961;373;1076;670;2037
431513;201612;309;822;140;432;17;51;72;221;89;272
431514;201612;96;272;41;142;3;12;9;28;12;40
431515;201612;559;1563;360;1118;98;350;136;367;234;717
431517;201612;73;247;51;185;9;35;12;39;21;74
431520;201612;514;1290;195;631;42;159;27;77;69;236
431530;201612;4016;9506;2633;7510;882;2626;590;1676;1472;4302
431531;201612;227;662;154;502;20;61;57;170;77;231
431532;201612;503;1379;369;1070;83;242;131;366;214;608
431535;201612;292;748;118;360;24;77;39;101;63;178
431540;201612;1998;6579;1726;6101;146;579;1164;4172;1310;4751
431545;201612;341;950;45;161;2;7;14;54;16;61
431550;201612;2112;6184;1741;5435;386;1274;723;2125;1109;3399
431555;201612;669;1649;438;1243;65;185;264;744;329;929
431560;201612;19933;57973;12594;43108;3258;12130;2539;8940;5797;21070
431570;201612;5714;14456;4285;12398;1299;3777;1666;4933;2965;8710
431575;201612;377;1004;257;773;45;148;49;123;94;271
431580;201612;543;1516;263;874;54;188;72;221;126;409
431590;201612;911;2423;488;1533;135;433;138;432;273;865
431595;201612;404;1150;284;874;35;106;158;471;193;577
431600;201612;1906;5226;1260;4013;287;1017;291;890;578;1907
431610;201612;1380;3914;922;2951;142;444;400;1295;542;1739
431620;201612;448;1282;202;631;45;140;85;243;130;383
431630;201612;1311;3560;731;2272;219;688;189;555;408;1243
431640;201612;6158;17056;5433;15935;1071;3291;3275;9633;4346;12924
431642;201612;509;1343;355;1053;47;143;152;427;199;570
431643;201612;321;833;129;372;21;61;41;93;62;154
431645;201612;1631;4616;1310;4003;234;771;771;2308;1005;3079
431647;201612;136;409;78;259;13;43;15;43;28;86
431650;201612;312;952;207;699;25;91;66;195;91;286
431660;201612;945;2692;522;1752;109;391;99;273;208;664
431670;201612;1214;3157;842;2468;153;511;390;1036;543;1547
431673;201612;230;626;92;306;23;75;9;24;32;99
431675;201612;695;1754;122;406;12;42;34;102;46;144
431680;201612;8841;24341;6310;19246;1846;5881;1617;4874;3463;10755
431690;201612;21667;60567;16054;50272;4489;14568;5038;15983;9527;30551
431695;201612;140;418;90;293;19;63;25;58;44;121
431697;201612;430;1218;369;1103;101;312;172;520;273;832
431700;201612;1468;4158;1207;3631;197;599;674;1974;871;2573
431710;201612;11580;33651;9179;29468;3136;10527;2289;7906;5425;18433
431720;201612;6635;18370;4482;13785;1024;3279;1274;3745;2298;7024
431725;201612;30;85;17;57;4;13;5;15;9;28
431730;201612;3563;10384;2682;8701;773;2713;718;2419;1491;5132
431740;201612;4868;13320;3500;10670;1156;3806;540;1435;1696;5241
431750;201612;8205;23362;6723;20686;1822;5872;2692;8268;4514;14140
431755;201612;328;890;59;197;13;42;13;39;26;81
431760;201612;3983;11059;2990;9178;497;1668;1542;4470;2039;6138
431770;201612;1872;5010;1521;4436;280;823;891;2549;1171;3372
431775;201612;183;504;92;299;19;59;7;16;26;75
431780;201612;2101;5727;1440;4368;357;1118;346;966;703;2084
431790;201612;1110;3289;791;2540;144;508;280;849;424;1357
431795;201612;374;1002;199;606;39;124;52;154;91;278
431800;201612;8153;23841;6013;19473;1930;6677;738;2261;2668;8938
431805;201612;327;808;83;293;12;45;18;66;30;111
431810;201612;3057;8306;2206;6535;452;1424;944;2663;1396;4087
431820;201612;2437;7510;2000;6611;412;1477;885;2781;1297;4258
431830;201612;10590;25576;7765;21126;2148;6219;3033;8180;5181;14399
431840;201612;2472;7436;2054;6633;486;1675;998;3212;1484;4887
431842;201612;763;1930;246;766;31;102;55;137;86;239
431843;201612;345;997;259;814;37;132;126;378;163;510
431844;201612;281;776;66;230;16;60;11;28;27;88
431845;201612;492;1433;332;1056;27;82;211;680;238;762
431846;201612;304;918;254;838;23;89;185;603;208;692
431848;201612;230;618;111;361;9;37;19;48;28;85
431849;201612;469;1138;73;215;11;29;12;24;23;53
431850;201612;4481;13112;3615;11205;903;2916;1146;3446;2049;6362
431860;201612;746;1957;489;1448;84;283;250;676;334;959
431861;201612;97;292;39;149;7;25;10;29;17;54
431862;201612;471;1540;364;1324;79;321;145;507;224;828
431870;201612;17150;50083;13069;41947;3178;10831;4675;14649;7853;25480
431880;201612;3998;11754;2963;9513;786;2702;1022;3075;1808;5777
431890;201612;4729;12818;3100;9670;941;3094;583;1878;1524;4972
431900;201612;1089;2970;634;2004;166;585;259;744;425;1329
431910;201612;936;2256;381;1123;67;195;108;288;175;483
431912;201612;447;1315;356;1131;102;306;156;512;258;818
431915;201612;1188;3230;867;2643;228;725;316;957;544;1682
431920;201612;1213;3428;1023;3098;114;349;725;2165;839;2514
431930;201612;1080;3029;733;2380;210;646;330;1097;540;1743
431935;201612;60;197;46;168;9;32;12;38;21;70
431936;201612;330;988;211;691;53;194;68;212;121;406
431937;201612;276;735;141;438;34;110;23;61;57;171
431940;201612;2377;6455;1387;4358;335;1106;378;1132;713;2238
431950;201612;1511;4566;1291;4145;244;875;651;2001;895;2876
431960;201612;2654;7528;2097;6319;603;1857;621;1812;1224;3669
431970;201612;406;1154;174;596;40;138;38;116;78;254
431971;201612;86;266;50;181;7;25;6;22;13;47
431973;201612;436;1527;377;1399;48;175;247;929;295;1104
431975;201612;106;244;22;80;2;8;4;13;6;21
431980;201612;1295;3802;969;3085;230;746;298;905;528;1651
431990;201612;6661;18328;4412;14356;860;3003;1296;4098;2156;7101
432000;201612;9695;26868;7349;22509;2396;7416;2453;7428;4849;14844
432010;201612;2058;5725;1545;4723;303;991;734;2127;1037;3118
432020;201612;2240;5329;1544;4284;312;941;859;2261;1171;3202
432023;201612;483;1328;279;878;46;153;119;310;165;463
432026;201612;1118;3409;799;2696;124;408;420;1404;544;1812
432030;201612;368;1041;255;786;55;165;119;348;174;513
432032;201612;528;1398;345;1034;58;194;151;405;209;599
432035;201612;796;2370;685;2150;255;861;160;499;415;1360
432040;201612;945;2206;382;1229;67;233;155;476;222;709
432045;201612;250;692;121;416;27;93;34;126;61;219
432050;201612;579;1605;478;1412;81;247;270;813;351;1060
432055;201612;906;2503;582;1855;138;468;254;781;392;1249
432057;201612;394;964;266;733;43;104;141;369;184;473
432060;201612;461;1219;149;511;29;119;44;124;73;243
432065;201612;218;620;156;508;48;170;56;163;104;333
432067;201612;872;2646;634;2112;133;419;279;941;412;1360
432070;201612;2300;6343;1310;4220;283;947;275;821;558;1768
432080;201612;3712;10345;2927;8866;935;3021;995;2930;1930;5951
432085;201612;314;872;202;679;52;182;88;283;140;465
432090;201612;1431;4045;1065;3300;313;1024;417;1239;730;2263
432100;201612;1298;3729;504;1774;86;328;28;69;114;397
432110;201612;2419;7311;1604;5488;382;1480;123;363;505;1843
432120;201612;4228;12412;3299;10598;1250;4160;779;2443;2029;6603
432130;201612;2687;7327;2053;6419;706;2344;773;2379;1479;4723
432132;201612;304;870;130;450;20;72;38;122;58;194
432135;201612;713;2086;560;1768;99;312;351;1085;450;1397
432140;201612;1735;5584;1303;4700;297;1101;507;1930;804;3031
432143;201612;1315;3819;1058;3359;183;622;521;1669;704;2291
432145;201612;1303;3954;689;2438;116;450;112;363;228;813
432146;201612;174;553;105;375;28;99;20;77;48;176
432147;201612;596;1924;440;1566;122;457;81;293;203;750
432149;201612;362;993;218;654;42;123;85;250;127;373
432150;201612;3516;9840;2434;7702;557;1916;726;2168;1283;4084
432160;201612;4181;13190;3503;11822;1086;3824;1136;3825;2222;7649
432162;201612;375;906;45;138;9;35;7;19;16;54
432163;201612;280;774;49;162;3;10;1;2;4;12
432166;201612;599;1763;441;1397;69;249;184;523;253;772
432170;201612;1165;3541;735;2568;180;653;156;509;336;1162
432180;201612;2405;6586;1347;4251;307;997;246;657;553;1654
432183;201612;373;1174;279;959;93;348;45;142;138;490
432185;201612;872;2293;552;1677;79;249;296;878;375;1127
432190;201612;2947;7992;1710;5219;374;1192;502;1405;876;2597
432195;201612;1044;2787;687;2143;155;464;261;804;416;1268
432200;201612;2744;8371;2175;7269;527;1899;913;2980;1440;4879
432210;201612;383;1065;254;821;55;203;92;269;147;472
432215;201612;790;2426;663;2204;154;468;354;1241;508;1709
432218;201612;261;665;146;421;30;77;48;120;78;197
432220;201612;4037;10537;3057;8821;415;1348;1788;4923;2203;6271
432225;201612;103;315;75;256;28;103;19;62;47;165
432230;201612;976;2651;520;1609;111;347;125;320;236;667
432232;201612;461;1326;366;1126;67;229;161;463;228;692
432234;201612;363;974;191;587;36;114;43;118;79;232
432235;201612;110;317;35;123;5;16;1;1;6;17
432237;201612;437;1175;370;1049;23;71;261;715;284;786
432240;201612;13234;41207;10802;37476;1789;6948;6457;22763;8246;29711
432250;201612;4525;15381;3900;14018;1168;4401;1262;4571;2430;8972
432252;201612;443;1142;287;893;47;160;165;515;212;675
432253;201612;1265;3995;632;2248;136;532;37;112;173;644
432254;201612;873;2337;183;596;35;114;20;49;55;163
432255;201612;202;512;100;326;17;59;31;87;48;146
432260;201612;7400;18296;4878;14020;1163;3338;2003;6013;3166;9351
432270;201612;2449;7271;1953;6279;590;1977;459;1449;1049;3426
432280;201612;1363;3672;637;2034;87;284;174;493;261;777
432285;201612;194;608;19;62;3;8;2;2;5;10
432290;201612;467;1391;276;931;79;252;67;219;146;471
432300;201612;23015;67672;19323;60823;3515;11966;11002;33696;14517;45662
432310;201612;780;2264;587;1915;144;497;276;877;420;1374
432320;201612;205;524;81;257;18;58;14;35;32;93
432330;201612;313;825;101;336;12;42;14;38;26;80
432335;201612;153;446;52;189;11;41;10;26;21;67
432340;201612;343;824;152;463;28;100;45;123;73;223
432345;201612;634;1739;566;1614;75;267;363;953;438;1220
432350;201612;383;1035;179;586;29;87;54;165;83;252
432360;201612;198;611;36;137;5;20;7;20;12;40
432370;201612;402;1097;267;808;35;103;160;486;195;589
432375;201612;691;1760;496;1430;52;154;302;840;354;994
432377;201612;237;801;32;123;5;16;9;34;14;50
432380;201612;964;3002;694;2415;196;752;282;932;478;1684
500020;201612;2293;6570;1652;5404;330;1238;731;2273;1061;3511
500025;201612;1405;3246;781;2144;72;188;468;1250;540;1438
500060;201612;6818;20353;5171;17340;762;2474;3193;11151;3955;13625
500070;201612;4253;12111;3122;9990;715;2476;1174;3743;1889;6219
500080;201612;1354;3971;938;3150;248;901;327;1057;575;1958
500085;201612;2090;5241;1361;4109;117;358;884;2622;1001;2980
500090;201612;2241;6399;1493;4958;302;1047;619;2130;921;3177
500100;201612;2854;8012;2097;6598;450;1532;848;2497;1298;4029
500110;201612;7820;23105;5849;19802;1077;3868;2612;9303;3689;13171
500124;201612;2055;6561;1714;5955;420;1394;832;3222;1252;4616
500150;201612;1329;3377;802;2405;164;554;297;745;461;1299
500190;201612;4840;12252;3496;10289;765;2323;1794;5367;2559;7690
500200;201612;2368;5919;1655;4601;394;1126;635;1617;1029;2743
500210;201612;4566;13627;3621;11981;884;3032;1559;5182;2443;8214
500215;201612;1420;4294;958;3295;168;610;355;1187;523;1797
500220;201612;2942;9060;2261;7788;470;1700;1020;3492;1490;5192
500230;201612;2861;7228;1886;5586;354;1113;935;2775;1289;3888
500240;201612;4344;13569;2862;10339;489;1958;821;3076;1310;5034
500260;201612;2683;6658;1707;5063;261;819;888;2535;1149;3354
500270;201612;116657;301087;66326;206601;15665;51345;15304;45910;30969;97255
500280;201612;1349;3426;1022;2941;81;243;788;2276;869;2519
500290;201612;4350;9629;2162;6308;444;1341;787;2246;1231;3587
500295;201612;2472;7029;1268;4181;186;664;343;954;529;1618
500310;201612;744;1955;576;1686;114;377;295;809;409;1186
500315;201612;3089;9618;2446;8469;352;1252;1491;5333;1843;6585
500320;201612;17130;54360;12388;44826;3714;14454;3075;11500;6789;25954
500325;201612;4274;10593;2761;8169;499;1571;1552;4578;2051;6149
500330;201612;6798;17522;4166;12485;872;2795;1788;5207;2660;8002
500345;201612;2076;5340;1514;4458;379;1182;661;1914;1040;3096
500348;201612;2176;6331;1829;5753;163;623;1231;3765;1394;4388
500350;201612;1256;3683;606;2083;63;222;216;746;279;968
500370;201612;21463;64205;14835;51253;3326;12695;4504;15400;7830;28095
500375;201612;2771;7632;1893;5869;370;1205;550;1664;920;2869
500380;201612;3341;9016;2316;7106;537;1693;939;2855;1476;4548
500390;201612;542;1224;286;794;46;151;150;384;196;535
500400;201612;1275;3852;865;2845;200;679;204;624;404;1303
500410;201612;2147;6137;1660;5358;358;1179;876;2901;1234;4080
500430;201612;2665;7260;1795;5900;395;1436;683;2299;1078;3735
500440;201612;1386;3665;848;2667;160;520;356;1118;516;1638
500450;201612;1307;3841;783;2705;157;577;120;327;277;904
500460;201612;3943;11371;2465;8327;644;2393;466;1493;1110;3886
500470;201612;2908;8378;1809;5925;496;1732;301;906;797;2638
500480;201612;2233;6679;2025;6415;174;466;1590;5402;1764;5868
500490;201612;928;2528;619;1966;182;650;103;340;285;990
500500;201612;3790;11369;2723;9615;1012;4014;794;2772;1806;6786
500510;201612;823;2111;474;1444;53;169;216;609;269;778
500515;201612;1887;4922;1457;4301;186;543;911;2873;1097;3416
500520;201612;3119;10666;2613;9601;387;1642;1578;5657;1965;7299
500525;201612;1170;3632;887;3075;148;575;413;1467;561;2042
500540;201612;6218;16696;3160;10651;861;3303;345;968;1206;4271
500560;201612;4718;15202;4157;14251;489;1835;2966;10179;3455;12014
500568;201612;4178;10175;2455;7354;641;2260;639;1603;1280;3863
500570;201612;7293;19056;4099;12795;1109;3657;674;2017;1783;5674
500580;201612;3635;10067;2793;8619;260;822;1982;6148;2242;6970
500600;201612;3892;10217;2240;7049;568;1909;546;1648;1114;3557
500620;201612;7466;21286;5107;16465;1034;3446;2168;7008;3202;10454
500625;201612;717;2064;356;1207;68;247;126;415;194;662
500627;201612;680;1820;394;1264;91;282;85;271;176;553
500630;201612;5512;14895;3516;11231;915;3052;1055;3274;1970;6326
500635;201612;2664;9775;2128;8903;262;1076;1490;6646;1752;7722
500640;201612;1611;3870;1187;3228;68;209;887;2359;955;2568
500660;201612;18970;53879;13794;44917;4198;15145;3631;11492;7829;26637
500690;201612;2386;7099;1868;6307;912;3213;379;1368;1291;4581
500710;201612;3314;9695;2545;8257;610;2179;910;2887;1520;5066
500720;201612;6061;15920;3360;10906;851;2965;625;1898;1476;4863
500730;201612;985;2710;601;1918;156;525;190;576;346;1101
500740;201612;4331;11597;2945;8951;336;1155;1563;4682;1899;5837
500750;201612;959;2622;737;2211;128;412;366;1030;494;1442
500755;201612;1157;3350;702;2342;139;481;125;313;264;794
500769;201612;5328;13908;2517;7928;438;1471;528;1400;966;2871
500770;201612;1629;4703;1000;3396;218;777;261;870;479;1647
500780;201612;1133;3231;786;2529;217;691;193;605;410;1296
500790;201612;9418;25336;7380;21802;1471;4869;3909;11062;5380;15931
500793;201612;2150;6105;1456;4748;439;1471;250;718;689;2189
500795;201612;2335;6849;1931;6257;270;722;1310;4594;1580;5316
500797;201612;804;2176;505;1622;94;333;179;545;273;878
500800;201612;2879;7554;2012;6212;777;2639;366;1173;1143;3812
500830;201612;19153;50156;12113;36556;2406;7797;4388;12433;6794;20230
500840;201612;1336;3637;757;2406;80;267;303;894;383;1161
510010;201612;1216;3561;941;3069;234;739;489;1643;723;2382
510020;201612;3401;9445;1793;6021;387;1336;344;1042;731;2378
510025;201612;7079;20365;4563;15088;1006;3486;1162;3522;2168;7008
510030;201612;1565;4222;1202;3623;259;824;606;1760;865;2584
510035;201612;864;2399;565;1916;151;520;274;939;425;1459
510040;201612;1728;4575;1239;3767;161;516;726;2171;887;2687
510050;201612;1794;5205;1219;4021;324;1169;343;1080;667;2249
510060;201612;1506;4256;1050;3327;170;560;459;1406;629;1966
510080;201612;1022;3263;762;2685;208;775;111;328;319;1103
510100;201612;643;1680;407;1191;48;160;206;540;254;700
510120;201612;305;646;191;501;10;35;132;336;142;371
510125;201612;2968;7714;2060;6020;365;1241;819;2153;1184;3394
510130;201612;1636;4572;1239;3798;349;1124;364;1076;713;2200
510140;201612;2757;8641;2019;7406;865;3522;398;1214;1263;4736
510160;201612;1227;4139;1085;3891;209;800;644;2288;853;3088
510170;201612;4996;14946;3774;12674;739;2619;1701;5493;2440;8112
510180;201612;12095;31218;7589;23597;2232;7182;1972;6892;4204;14074
510185;201612;1406;4110;1063;3629;193;621;641;2437;834;3058
510190;201612;2402;6440;1564;5137;267;903;889;2978;1156;3881
510250;201612;13635;40505;11255;36628;3299;11363;4492;14902;7791;26265
510260;201612;2163;8842;1684;7820;302;1325;907;4859;1209;6184
510263;201612;3780;10239;2462;7859;602;2046;476;1409;1078;3455
510267;201612;5341;15588;3307;11002;735;2564;691;2230;1426;4794
510268;201612;860;2446;702;2204;127;440;412;1269;539;1709
510269;201612;1002;3065;649;2289;230;829;133;465;363;1294
510270;201612;2697;8744;2055;7298;475;1658;728;2572;1203;4230
510279;201612;1701;5190;1251;4134;310;1101;398;1189;708;2290
510285;201612;1158;3349;814;2710;243;865;260;816;503;1681
510300;201612;3295;9498;2619;8465;181;633;1985;6465;2166;7098
510305;201612;1409;4396;993;3537;250;938;301;1086;551;2024
510310;201612;747;2209;581;1899;202;684;169;531;371;1215
510320;201612;3660;10334;2445;7931;574;2071;787;2324;1361;4395
510325;201612;4927;15351;4012;14077;1086;3953;2322;8382;3408;12335
510330;201612;2629;8429;1970;7158;490;1818;724;2777;1214;4595
510335;201612;4765;14191;3673;12702;488;1673;2459;8904;2947;10577
510336;201612;577;1753;404;1398;82;290;178;615;260;905
510337;201612;1883;6108;1373;5038;559;2148;210;780;769;2928
510340;201612;74223;195679;46156;147936;15649;54631;7654;24480;23303;79111
510343;201612;1077;3083;768;2461;109;370;404;1261;513;1631
510345;201612;1536;4569;1126;3747;287;1009;383;1217;670;2226
510350;201612;3084;8275;2186;6903;563;1869;922;2979;1485;4848
510360;201612;1766;4229;1046;3304;88;365;751;2309;839;2674
510370;201612;1368;4358;1040;3790;242;950;533;1988;775;2938
510380;201612;509;1469;272;963;78;292;22;77;100;369
510385;201612;928;3518;614;2757;75;361;312;1498;387;1859
510390;201612;1034;3315;856;2931;224;707;420;1535;644;2242
510395;201612;737;1798;503;1435;62;195;223;703;285;898
510410;201612;3725;11921;3051;10564;775;2739;1381;4902;2156;7641
510420;201612;2370;5883;1615;4582;288;859;774;2143;1062;3002
510450;201612;706;1837;421;1331;93;327;107;311;200;638
510452;201612;630;2015;448;1576;75;255;244;852;319;1107
510454;201612;860;2662;682;2308;101;364;415;1416;516;1780
510455;201612;912;2813;620;2126;115;441;227;721;342;1162
510460;201612;2293;5929;1592;4827;190;671;931;2691;1121;3362
510480;201612;4247;10919;2744;8063;526;1602;990;2702;1516;4304
510490;201612;1548;4804;1264;4332;292;1105;646;2108;938;3213
510500;201612;1441;4246;917;3161;196;784;423;1373;619;2157
510510;201612;2649;9065;2080;7866;625;2488;504;1950;1129;4438
510515;201612;6133;17658;3749;12439;781;2746;843;2508;1624;5254
510517;201612;1528;4554;1140;3752;327;1116;234;738;561;1854
510520;201612;2084;4623;1277;3556;31;78;919;2712;950;2790
510523;201612;946;2747;818;2522;118;354;543;1728;661;2082
510525;201612;5275;15931;3951;13051;793;2703;1487;4623;2280;7326
510530;201612;480;1379;390;1231;34;155;273;804;307;959
510550;201612;2748;8865;2017;7365;539;2085;634;2316;1173;4401
510558;201612;1851;5289;1482;4692;159;546;962;3129;1121;3675
510560;201612;1583;4751;908;3502;259;1054;189;752;448;1806
510562;201612;5242;15140;3500;11501;1023;3559;882;2984;1905;6543
510590;201612;3154;7965;2341;6891;456;1268;1410;4336;1866;5604
510600;201612;1593;4014;927;2816;193;577;339;995;532;1572
510610;201612;2877;8117;2213;7045;203;719;1423;4427;1626;5146
510615;201612;1987;6006;1624;5381;517;1766;634;2132;1151;3898
510617;201612;639;1868;513;1651;35;100;407;1361;442;1461
510618;201612;1415;4069;948;3102;210;806;466;1402;676;2208
510619;201612;717;2009;366;1249;41;167;42;115;83;282
510620;201612;1376;3405;654;2158;188;690;102;268;290;958
510621;201612;829;2793;707;2530;183;744;190;632;373;1376
510622;201612;3886;11555;2522;8505;695;2461;374;1149;1069;3610
510623;201612;3365;9166;2319;7271;578;1992;781;2231;1359;4223
510624;201612;1734;4772;774;2695;148;569;132;395;280;964
510625;201612;1938;5437;1346;4391;390;1384;207;639;597;2023
510626;201612;1582;4158;930;3142;289;1099;171;548;460;1647
510627;201612;688;1969;427;1398;125;435;98;315;223;750
510628;201612;1534;3755;998;2975;197;585;576;1726;773;2311
510629;201612;1700;5497;1282;4519;394;1497;352;1229;746;2726
510630;201612;2467;8165;1525;6010;351;1515;250;985;601;2500
510631;201612;374;1052;305;928;10;25;252;767;262;792
510637;201612;2648;7663;2116;6719;823;2781;569;1716;1392;4497
510642;201612;4696;15391;3857;14045;1234;4944;1507;5605;2741;10549
510645;201612;959;2133;551;1560;192;530;152;447;344;977
510650;201612;6257;20008;5435;18939;1503;5434;3113;11160;4616;16594
510665;201612;1717;4467;944;2954;167;530;405;1292;572;1822
510670;201612;368;815;193;558;19;66;105;303;124;369
510675;201612;6174;19087;4498;15585;1321;4904;850;2864;2171;7768
510677;201612;1864;5038;1439;4449;190;585;1023;3307;1213;3892
510680;201612;699;2088;463;1577;100;348;81;244;181;592
510682;201612;1980;6315;1428;5179;410;1632;253;861;663;2493
510685;201612;924;2472;678;2046;87;290;389;1112;476;1402
510700;201612;4162;10759;2647;8482;636;2032;1214;4013;1850;6045
510704;201612;9768;25465;6559;19472;1293;4187;2696;7441;3989;11628
510706;201612;1845;5478;1195;4454;221;838;633;2495;854;3333
510710;201612;3147;8615;1993;6158;463;1443;572;1594;1035;3037
510715;201612;699;1691;439;1214;70;202;170;494;240;696
510718;201612;2314;5667;1382;4465;629;2038;282;1101;911;3139
510719;201612;383;871;212;624;23;77;114;319;137;396
510720;201612;1090;2688;710;2109;200;637;224;587;424;1224
510724;201612;697;2066;474;1600;102;384;168;517;270;901
510726;201612;705;1625;417;1173;63;179;244;653;307;832
510729;201612;716;1791;342;1060;81;276;110;325;191;601
510730;201612;2800;7875;1813;5930;549;1871;432;1351;981;3222
510735;201612;980;3144;726;2739;131;557;380;1420;511;1977
510740;201612;1108;2672;695;2005;143;391;351;1074;494;1465
510757;201612;725;2365;578;2068;255;927;143;487;398;1414
510760;201612;31618;79086;18210;55603;5482;17801;3432;9519;8914;27320
510770;201612;4348;10669;3412;9493;336;864;2239;6893;2575;7757
510774;201612;347;975;262;780;47;160;127;400;174;560
510775;201612;643;1941;487;1615;142;530;118;342;260;872
510776;201612;536;1478;383;1148;95;309;146;432;241;741
510777;201612;1569;4543;1135;3905;148;528;893;3092;1041;3620
510779;201612;600;1788;444;1484;62;187;229;800;291;987
510780;201612;3669;10681;2800;9260;728;2459;1097;3901;1825;6360
510785;201612;1699;4869;1084;3685;306;1067;165;591;471;1658
510787;201612;2274;6802;1666;5631;735;2584;236;752;971;3336
510788;201612;569;1464;374;1158;128;393;119;427;247;820
510790;201612;15016;43259;8816;30616;1902;7307;927;3159;2829;10466
510792;201612;8243;23501;4844;16643;1009;3770;807;2556;1816;6326
510794;201612;1165;3592;836;2921;250;941;231;749;481;1690
510795;201612;7876;23254;5243;18011;1430;5321;957;3451;2387;8772
510800;201612;1527;4255;1113;3542;237;779;467;1386;704;2165
510805;201612;2003;5501;1376;4369;303;1058;568;1655;871;2713
510810;201612;662;1589;483;1325;138;367;225;601;363;968
510820;201612;715;1640;415;1163;78;264;164;396;242;660
510830;201612;666;1979;521;1741;113;375;265;941;378;1316
510835;201612;617;1794;426;1416;80;284;185;578;265;862
510840;201612;43402;109615;33086;94855;8286;24405;14993;44018;23279;68423
510850;201612;1520;4141;816;2749;216;753;128;386;344;1139
510860;201612;2678;8124;1753;6293;585;2311;118;381;703;2692
510880;201612;572;1910;470;1716;153;587;170;625;323;1212
510885;201612;622;1730;474;1508;92;321;196;600;288;921
510890;201612;779;2428;611;2168;134;515;327;1168;461;1683
510895;201612;1116;3331;846;2784;187;682;306;915;493;1597
520005;201612;1492;4676;1273;4345;418;1411;546;1964;964;3375
520010;201612;1662;5522;1249;4581;459;1850;198;615;657;2465
520013;201612;3067;8626;2085;6638;517;1679;625;2011;1142;3690
520015;201612;468;1338;355;1143;81;284;121;406;202;690
520017;201612;1042;3051;824;2665;206;743;331;975;537;1718
520020;201612;425;1105;320;939;64;196;145;410;209;606
520025;201612;29927;87850;26603;83480;3617;11906;19570;61212;23187;73118
520030;201612;4640;14158;3614;12271;650;2405;1850;6202;2500;8607
520050;201612;436;1093;237;708;21;49;160;500;181;549
520055;201612;787;2373;636;2056;130;408;313;1013;443;1421
520060;201612;1303;4041;1045;3505;257;970;331;1035;588;2005
520080;201612;1847;5232;1451;4673;278;838;773;2664;1051;3502
520082;201612;1063;2809;896;2526;181;439;549;1621;730;2060
520085;201612;708;2111;593;1895;152;464;196;621;348;1085
520090;201612;943;2163;641;1756;150;354;326;989;476;1343
520110;201612;39984;114813;28720;95947;10545;38942;3230;9948;13775;48890
520120;201612;176;455;90;301;17;61;24;76;41;137
520130;201612;3396;9451;2924;8706;748;2364;1452;4354;2200;6718
520140;201612;33362;107280;26194;92447;9492;35722;3154;10751;12646;46473
520145;201612;329;915;217;690;43;150;54;169;97;319
520150;201612;429;1138;346;1037;55;188;205;588;260;776
520160;201612;860;2276;655;1947;172;501;212;638;384;1139
520170;201612;4360;9872;3284;8573;229;646;2711;7068;2940;7714
520180;201612;2111;6133;1665;5379;276;1039;867;2727;1143;3766
520215;201612;1965;5005;1515;4240;189;535;970;2735;1159;3270
520235;201612;663;1691;457;1360;93;311;170;471;263;782
520250;201612;1516;4223;964;3226;270;976;179;584;449;1560
520260;201612;794;1993;451;1334;93;281;163;453;256;734
520280;201612;542;1589;456;1430;142;461;170;581;312;1042
520310;201612;1193;2835;749;2094;222;669;223;675;445;1344
520320;201612;1948;5938;1497;5032;151;509;970;3330;1121;3839
520330;201612;2463;7621;1738;6253;493;1913;242;824;735;2737
520340;201612;1883;4709;1351;3913;242;614;833;2576;1075;3190
520350;201612;3230;8643;2258;6766;687;2172;784;2220;1471;4392
520355;201612;1052;3376;892;3102;240;890;425;1443;665;2333
520357;201612;822;2195;635;1877;56;172;446;1310;502;1482
520360;201612;707;2009;551;1725;161;519;201;644;362;1163
520380;201612;1286;3446;771;2386;112;367;360;1044;472;1411
520390;201612;957;2309;532;1690;173;610;147;400;320;1010
520393;201612;536;1266;385;1036;55;148;216;562;271;710
520396;201612;669;2139;534;1866;64;258;339;1149;403;1407
520400;201612;1604;4609;1336;4179;251;837;789;2417;1040;3254
520410;201612;1446;3407;975;2716;202;621;524;1407;726;2028
520420;201612;315;897;204;638;29;89;92;268;121;357
520425;201612;1210;3320;886;2675;263;798;357;1102;620;1900
520430;201612;1813;4793;957;3094;207;638;126;366;333;1004
520440;201612;3599;9217;2177;6536;641;2082;411;1200;1052;3282
520450;201612;10548;28662;6112;20138;1498;5200;305;938;1803;6138
520455;201612;685;2021;505;1683;178;611;164;553;342;1164
520460;201612;867;2425;694;2133;110;382;386;1137;496;1519
520465;201612;815;2156;692;1962;56;196;527;1417;583;1613
520470;201612;1679;5431;1490;5119;344;1235;920;3244;1264;4479
520480;201612;888;2592;536;1848;91;316;113;344;204;660
520485;201612;1294;4049;1092;3700;216;793;669;2271;885;3064
520490;201612;3984;12176;3008;10534;827;2883;1404;5021;2231;7904
520495;201612;1401;3578;1101;3152;98;287;855;2501;953;2788
520500;201612;1238;3450;975;3023;254;865;373;1118;627;1983
520505;201612;685;1940;564;1737;125;383;284;874;409;1257
520510;201612;8594;23467;5507;18184;1322;4737;1642;5346;2964;10083
520520;201612;1037;2863;793;2485;258;827;227;739;485;1566
520530;201612;1974;6426;1511;5551;560;2084;337;1352;897;3436
520540;201612;2747;7622;1778;5690;488;1595;275;888;763;2483
520545;201612;955;2858;723;2393;138;493;228;717;366;1210
520547;201612;593;1853;493;1674;158;534;154;513;312;1047
520549;201612;9669;28396;7739;25425;2212;7526;3414;11320;5626;18846
520551;201612;3646;11008;3231;10347;794;2810;1908;5939;2702;8749
520552;201612;735;2164;651;2052;91;295;455;1458;546;1753
520570;201612;587;1603;385;1231;130;440;134;400;264;840
520580;201612;3064;7341;2032;5856;494;1575;1020;2859;1514;4434
520590;201612;1407;3988;972;3157;234;760;177;576;411;1336
520620;201612;7983;22981;6640;21114;1690;5422;3501;11277;5191;16699
520630;201612;933;2382;597;1812;105;340;275;791;380;1131
520640;201612;2705;7288;2082;6171;529;1552;792;2409;1321;3961
520650;201612;847;2216;584;1719;98;313;318;910;416;1223
520660;201612;303;843;222;727;89;309;74;250;163;559
520670;201612;965;2809;834;2609;56;177;661;2045;717;2222
520680;201612;783;2041;562;1661;140;407;228;678;368;1085
520690;201612;295;762;200;603;51;134;92;284;143;418
520710;201612;546;1424;320;968;6;17;208;619;214;636
520725;201612;1542;3933;1084;3131;148;455;703;1985;851;2440
520735;201612;802;2155;519;1606;105;359;187;561;292;920
520740;201612;1711;4470;1310;3907;207;661;761;2219;968;2880
520750;201612;600;1618;460;1391;94;264;215;699;309;963
520753;201612;1483;3921;1280;3622;177;491;854;2564;1031;3055
520760;201612;791;2078;657;1891;66;168;482;1466;548;1634
520780;201612;1823;4439;1314;3656;153;416;847;2290;1000;2706
520790;201612;2871;7205;2049;5903;198;495;1513;4562;1711;5057
520800;201612;16666;45487;13686;41713;3023;8664;8087;26375;11110;35039
520810;201612;1107;2662;812;2298;74;207;640;1898;714;2105
520815;201612;594;1853;389;1392;165;646;18;61;183;707
520830;201612;1630;4086;1263;3651;50;127;1057;3036;1107;3163
520840;201612;1543;4994;1267;4487;538;1995;248;938;786;2933
520850;201612;586;1761;402;1431;97;376;106;378;203;754
520860;201612;6273;18549;4528;15382;1137;4087;1480;5096;2617;9183
520870;201612;87387;237854;59853;189818;19271;64842;12780;38405;32051;103247
520880;201612;6414;18377;4598;15490;1844;6889;357;1099;2201;7988
520890;201612;3746;10355;2800;8651;586;1997;1321;3973;1907;5970
520910;201612;3527;10026;2314;7599;886;3080;414;1263;1300;4343
520915;201612;640;1869;458;1494;113;384;213;675;326;1059
520920;201612;3437;9084;2296;7206;441;1452;909;2929;1350;4381
520929;201612;601;1584;429;1290;96;270;224;715;320;985
520940;201612;1106;3103;847;2698;92;302;619;1946;711;2248
520945;201612;650;1537;488;1246;120;278;251;627;371;905
520960;201612;997;2898;740;2384;56;175;368;1206;424;1381
520970;201612;2490;7682;2055;6790;570;2004;462;1475;1032;3479
520980;201612;739;2112;599;1882;198;647;284;893;482;1540
520990;201612;2961;9351;2700;8974;325;1105;1893;6523;2218;7628
520993;201612;922;2320;717;2017;42;116;538;1535;580;1651
520995;201612;2211;5945;1874;5476;416;1145;1092;3267;1508;4412
521000;201612;6958;21019;5186;17299;1993;7031;851;2650;2844;9681
521010;201612;3927;11249;2860;9149;669;2086;1210;3863;1879;5949
521015;201612;679;1828;564;1635;129;350;325;952;454;1302
521020;201612;2866;8189;1744;5729;519;1787;169;512;688;2299
521030;201612;643;1596;454;1268;99;273;174;495;273;768
521040;201612;6059;16208;4756;14031;1717;5201;1376;4205;3093;9406
521056;201612;825;2453;635;2108;228;800;149;535;377;1335
521060;201612;1035;2680;759;2227;292;828;240;767;532;1595
521080;201612;1070;2567;559;1671;51;177;247;655;298;832
521090;201612;2848;7579;2087;6439;695;2210;635;1984;1330;4194
521100;201612;1901;4441;1339;3624;239;607;835;2319;1074;2926
521120;201612;4622;11793;3425;10204;982;3064;1172;3810;2154;6874
521130;201612;984;2632;653;1968;93;343;369;1065;462;1408
521140;201612;968;2907;729;2396;175;593;250;836;425;1429
521150;201612;11400;28594;6661;20026;2761;8516;1318;4001;4079;12517
521160;201612;858;2005;505;1394;109;304;217;594;326;898
521170;201612;1116;2742;791;2218;153;456;461;1259;614;1715
521180;201612;6001;19135;5167;17525;1351;4796;1716;5842;3067;10638
521190;201612;8682;24759;5252;17995;1366;5045;1027;3426;2393;8471
521200;201612;735;1993;542;1636;67;226;307;904;374;1130
521205;201612;604;1681;450;1399;49;165;276;843;325;1008
521210;201612;880;2425;485;1546;124;459;87;225;211;684
521220;201612;4171;10361;2829;8396;621;1959;1346;4004;1967;5963
521225;201612;379;937;305;848;35;90;222;649;257;739
521230;201612;1215;3762;1032;3383;335;1158;444;1413;779;2571
521250;201612;30034;90908;24110;81235;10910;38085;5358;18566;16268;56651
521260;201612;646;1555;513;1363;89;265;293;740;382;1005
521270;201612;1786;5096;1578;4783;136;343;1202;3776;1338;4119
521280;201612;1832;5546;1435;4736;423;1463;421;1358;844;2821
521290;201612;431;1190;313;1012;79;291;145;437;224;728
521295;201612;1176;2788;931;2437;146;358;647;1770;793;2128
521300;201612;1836;5175;1514;4630;167;495;1010;3087;1177;3582
521305;201612;718;2039;558;1758;106;316;295;960;401;1276
521308;201612;4219;12434;3176;10283;743;2392;1394;4526;2137;6918
521310;201612;7995;23128;5150;17249;1300;4639;1083;3381;2383;8020
521340;201612;335;857;312;828;16;33;276;732;292;765
521350;201612;1966;5339;1501;4554;230;669;959;2946;1189;3615
521370;201612;906;2625;593;2020;214;761;62;208;276;969
521375;201612;1316;3694;1011;3206;264;912;450;1373;714;2285
521377;201612;1072;2710;943;2553;57;105;809;2233;866;2338
521380;201612;5611;15734;3281;11017;506;1700;1050;3523;1556;5223
521385;201612;524;1362;435;1250;139;411;177;539;316;950
521390;201612;808;2198;592;1878;177;621;169;510;346;1131
521400;201612;1934;5476;1710;5180;306;1039;1165;3503;1471;4542
521405;201612;1380;3841;1028;3180;313;1024;396;1227;709;2251
521410;201612;718;2142;648;2023;197;555;287;978;484;1533
521440;201612;1338;3856;975;3059;189;628;287;755;476;1383
521450;201612;3587;11678;2703;9731;844;3166;514;1765;1358;4931
521460;201612;6596;18783;5156;16097;1428;4730;2010;6030;3438;10760
521470;201612;659;1888;439;1415;107;329;71;225;178;554
521480;201612;346;1040;214;721;50;183;68;216;118;399
521483;201612;2719;7047;1884;5520;505;1490;508;1443;1013;2933
521486;201612;1633;4112;1269;3553;99;252;952;2677;1051;2929
521487;201612;486;1316;341;1051;105;367;62;170;167;537
521490;201612;791;2242;590;1877;32;144;407;1227;439;1371
521500;201612;1307;4103;859;3056;173;704;154;473;327;1177
521520;201612;859;1986;613;1639;131;368;307;857;438;1225
521523;201612;13515;47346;12139;44683;4222;16549;1740;7094;5962;23643
521525;201612;1063;2707;832;2330;111;344;514;1376;625;1720
521530;201612;1647;4682;940;3161;229;784;138;449;367;1233
521540;201612;872;2340;558;1775;131;467;205;624;336;1091
521550;201612;1572;3968;913;2592;192;565;411;1144;603;1709
521560;201612;3536;11469;2781;10298;1136;4387;955;3674;2091;8061
521565;201612;590;1522;486;1379;88;214;301;867;389;1081
521570;201612;4612;12625;2597;8444;546;1871;395;1267;941;3138
521580;201612;532;1238;266;811;66;197;44;126;110;323
521590;201612;588;1621;445;1369;129;427;154;442;283;869
521600;201612;412;1178;260;853;61;189;57;175;118;364
521630;201612;1263;3108;813;2419;196;678;199;506;395;1184
521640;201612;2105;5243;1524;4387;395;1113;659;1949;1054;3062
521645;201612;537;1595;372;1226;74;246;127;389;201;635
521680;201612;1248;4013;972;3425;413;1503;95;321;508;1824
521690;201612;538;1555;462;1421;115;401;216;615;331;1016
521710;201612;2674;7784;1974;6426;406;1337;541;1753;947;3090
521720;201612;1897;5354;1330;4192;265;847;693;2089;958;2936
521730;201612;3568;11577;2871;10057;1029;3940;490;1435;1519;5375
521740;201612;3557;9800;2612;8281;560;1897;1269;4136;1829;6033
521760;201612;14420;44568;11492;39310;3357;12279;3891;13330;7248;25609
521770;201612;2488;7152;1860;5868;696;2364;471;1357;1167;3721
521800;201612;6650;19990;5432;17796;1711;5805;1791;6139;3502;11944
521805;201612;915;2031;618;1585;159;371;293;824;452;1195
521810;201612;751;1859;515;1507;92;287;231;707;323;994
521830;201612;5078;15814;4394;14716;662;2423;2835;9334;3497;11757
521839;201612;688;1875;460;1417;100;308;184;528;284;836
521850;201612;6337;17052;4255;13174;1082;3548;843;2396;1925;5944
521860;201612;1844;4866;1308;3993;309;1043;388;1157;697;2200
521870;201612;481;1585;372;1341;104;383;119;408;223;791
521878;201612;778;2198;509;1626;76;269;205;609;281;878
521880;201612;21231;54818;13420;41428;3730;11983;3987;12548;7717;24531
521890;201612;3164;9336;2122;7089;592;2072;351;1114;943;3186
521900;201612;1420;3679;904;2829;227;743;290;845;517;1588
521910;201612;884;2367;753;2196;107;326;437;1341;544;1667
521920;201612;280;886;221;763;81;301;44;148;125;449
521925;201612;671;2022;491;1632;93;329;141;425;234;754
521930;201612;3370;10743;2709;9355;986;3504;461;1598;1447;5102
521935;201612;603;1676;475;1424;124;366;218;621;342;987
521940;201612;929;2515;745;2236;140;444;424;1249;564;1693
521945;201612;651;1985;521;1737;99;337;256;901;355;1238
521950;201612;651;1646;514;1440;53;156;366;1021;419;1177
521960;201612;645;1919;478;1568;101;363;218;682;319;1045
521970;201612;2676;6862;2129;6170;149;388;1777;5317;1926;5705
521971;201612;996;2648;630;1943;118;358;159;473;277;831
521973;201612;943;2876;757;2528;150;504;372;1240;522;1744
521975;201612;12436;34011;10835;31755;2199;6750;6928;19953;9127;26703
521980;201612;2052;5518;1711;5082;261;674;1277;3939;1538;4613
521990;201612;1137;3178;869;2721;109;364;572;1819;681;2183
522000;201612;2267;6132;1559;5170;190;661;856;2954;1046;3615
522005;201612;381;915;246;703;82;212;86;254;168;466
522010;201612;3193;9043;2517;7818;907;2816;559;1737;1466;4553
522015;201612;888;2596;692;2239;168;529;314;1021;482;1550
522020;201612;4998;12799;3532;10331;918;2743;1625;4672;2543;7415
522026;201612;648;1784;451;1519;99;354;152;546;251;900
522028;201612;542;1518;418;1232;53;146;247;730;300;876
522040;201612;2285;5499;1760;4837;327;889;1190;3324;1517;4213
522045;201612;14613;47164;11110;39434;3009;11480;1843;6282;4852;17762
522050;201612;1114;3174;719;2332;165;551;183;520;348;1071
522060;201612;2270;6833;1803;6037;447;1589;897;2961;1344;4550
522068;201612;1685;5114;1433;4756;176;533;1058;3649;1234;4182
522070;201612;656;1950;575;1810;74;279;368;1120;442;1399
522100;201612;469;1386;389;1248;138;486;141;430;279;916
522108;201612;824;2561;661;2266;56;240;494;1635;550;1875
522119;201612;1362;4066;1076;3567;246;837;467;1570;713;2407
522130;201612;340;938;270;846;79;252;138;436;217;688
522140;201612;15926;45855;12203;38558;3572;11858;2325;6917;5897;18775
522145;201612;748;2067;611;1856;206;620;274;896;480;1516
522150;201612;950;2482;724;2097;204;574;271;816;475;1390
522155;201612;830;2331;698;2112;147;401;388;1238;535;1639
522157;201612;648;1762;528;1579;35;125;396;1166;431;1291
522160;201612;5982;16718;3814;12453;1038;3587;352;1182;1390;4769
522170;201612;2240;6548;1633;5326;548;1875;308;986;856;2861
522180;201612;323;922;227;748;65;232;54;191;119;423
522185;201612;15806;43592;11916;38193;3678;12270;5233;16985;8911;29255
522190;201612;865;2120;630;1770;116;338;289;836;405;1174
522200;201612;1644;5295;1187;4163;276;993;252;843;528;1836
522205;201612;1268;3522;972;3025;163;540;519;1568;682;2108
522220;201612;1364;3523;1045;3114;199;577;607;1903;806;2480
522230;201612;1224;3348;988;2962;109;388;616;1811;725;2199
530010;201612;184168;569696;155537;516510;42041;152546;62347;197683;104388;350229
110001;201611;3390;11126;2908;10303;705;2595;1355;4819;2060;7414
110002;201611;13476;38705;9834;32009;3081;10745;2912;9124;5993;19869
110003;201611;772;2437;640;2184;187;675;147;472;334;1147
110004;201611;10198;31560;7757;26429;2382;8606;1380;4839;3762;13445
110005;201611;1862;5843;1538;5195;517;1788;596;2002;1113;3790
110006;201611;1970;5843;1172;4163;337;1248;133;409;470;1657
110007;201611;1418;4191;1194;3759;368;1222;446;1579;814;2801
110008;201611;2406;8097;2221;7832;387;1261;1584;5852;1971;7113
110009;201611;4705;14107;3457;11944;1016;3716;1003;3451;2019;7167
110010;201611;7531;22883;6362;21127;1876;6300;2868;10260;4744;16560
110011;201611;7529;23078;6146;20267;2145;7361;1776;5707;3921;13068
110012;201611;15960;45321;11588;37296;3232;10642;2932;9484;6164;20126
110013;201611;5519;17264;4463;15191;1862;6503;962;3416;2824;9919
110014;201611;4145;11899;3375;10563;942;3003;1580;4904;2522;7907
110015;201611;5158;15436;3320;11588;884;3237;555;1961;1439;5198
110018;201611;4184;11662;2884;9516;733;2690;952;2951;1685;5641
110020;201611;68486;183326;47037;151780;10933;36886;20004;65919;30937;102805
110025;201611;4346;12283;3371;10433;534;1768;2068;6258;2602;8026
110026;201611;643;1950;575;1842;147;451;306;1023;453;1474
110028;201611;6863;20512;5048;16751;1438;5137;685;2229;2123;7366
110029;201611;1416;3998;1061;3396;304;1003;415;1320;719;2323
110030;201611;10641;28687;7474;23845;2143;7384;2505;7871;4648;15255
110032;201611;3970;12208;3181;10534;1048;3506;804;2624;1852;6130
110033;201611;5211;16490;4432;14990;1511;5149;1409;4998;2920;10147
110034;201611;3446;9164;2652;7991;878;2761;1292;3782;2170;6543
110037;201611;1995;6682;1626;5890;439;1654;668;2417;1107;4071
110040;201611;3422;10569;2731;9192;804;2881;913;2960;1717;5841
110045;201611;5017;16044;4234;14906;1432;5465;1729;5943;3161;11408
110050;201611;1683;5321;1348;4658;507;1786;462;1618;969;3404
110060;201611;857;2770;640;2300;211;820;123;431;334;1251
110070;201611;1993;6572;1734;5970;570;2118;606;1966;1176;4084
110080;201611;4608;12292;3775;11294;619;1718;2706;8483;3325;10201
110090;201611;730;2168;555;1839;140;498;234;744;374;1242
110092;201611;1308;4301;1161;4072;218;812;711;2530;929;3342
110094;201611;3619;10638;2963;9612;1008;3453;1044;3332;2052;6785
110100;201611;2174;6786;1905;6280;530;1848;939;3074;1469;4922
110110;201611;1642;5152;1356;4676;550;1945;303;1096;853;3041
110120;201611;1783;5531;1292;4422;353;1262;254;844;607;2106
110130;201611;2487;7055;1716;5635;535;1865;406;1321;941;3186
110140;201611;2404;7735;1856;6561;483;1801;455;1457;938;3258
110143;201611;1255;3841;906;3202;313;1154;305;1084;618;2238
110145;201611;1030;2936;769;2462;206;718;341;1059;547;1777
110146;201611;439;1343;363;1225;70;231;187;640;257;871
110147;201611;735;2148;542;1760;138;469;180;541;318;1010
110148;201611;1231;3720;753;2562;143;508;69;203;212;711
110149;201611;3352;9909;2577;8607;903;2989;985;3458;1888;6447
110150;201611;2441;7025;1955;6279;615;2086;635;2076;1250;4162
110155;201611;872;2669;721;2309;181;626;307;938;488;1564
110160;201611;1927;6203;1551;5413;562;1969;470;1659;1032;3628
110170;201611;2876;8003;1968;6283;475;1594;905;2826;1380;4420
110175;201611;1625;4934;1255;4381;227;822;666;2410;893;3232
110180;201611;1267;3681;1029;3302;281;877;506;1664;787;2541
120001;201611;2809;9486;2511;8993;523;1944;1492;5466;2015;7410
120005;201611;1575;6555;1453;6306;170;811;1033;4622;1203;5433
120010;201611;4813;16143;4549;15726;569;1922;3486;12322;4055;14244
120013;201611;2005;7989;1883;7795;446;1838;1102;4846;1548;6684
120017;201611;1985;7128;1794;6749;522;1998;743;3082;1265;5080
120020;201611;14406;63309;13725;61844;2010;9365;9481;44116;11491;53481
120025;201611;2422;8434;2305;8239;438;1648;1442;5218;1880;6866
120030;201611;6567;25210;6331;24889;215;1107;5728;22476;5943;23583
120032;201611;1517;7349;1428;7101;145;906;1075;5304;1220;6210
120033;201611;3600;14325;3489;14115;220;993;3051;12383;3271;13376
120034;201611;2119;8880;1994;8607;148;921;1608;6752;1756;7673
120035;201611;3168;14072;3072;13864;223;1166;2574;11714;2797;12880
120038;201611;2649;9470;2468;9122;660;2510;1265;4782;1925;7292
120039;201611;1802;8526;1725;8362;166;975;1320;6426;1486;7401
120040;201611;45252;160481;40527;151226;9304;37414;20447;76965;29751;114379
120042;201611;3038;12582;2827;12082;254;1261;2120;9095;2374;10356
120043;201611;937;4303;897;4228;80;399;724;3516;804;3915
120045;201611;4448;14981;4311;14814;451;1712;3664;12565;4115;14277
120050;201611;8171;33148;7648;31996;1005;4507;5264;22660;6269;27167
120060;201611;7773;34229;7517;33696;699;3654;5931;26808;6630;30462
120070;201611;2723;10065;2590;9768;452;1696;1654;6411;2106;8107
120080;201611;3614;13524;3413;13157;638;2574;2323;9080;2961;11654
130002;201611;3146;12882;2918;12512;163;852;2544;10905;2707;11757
130006;201611;2085;8663;1757;7994;220;1126;1287;5857;1507;6983
130008;201611;2249;8754;2036;8335;128;614;1659;6774;1787;7388
130010;201611;3180;10280;2889;9934;158;540;2581;8930;2739;9470
130014;201611;3258;10529;2755;9674;513;1912;1706;6039;2219;7951
130020;201611;2768;10275;2618;9977;100;556;2247;8391;2347;8947
130030;201611;7889;29349;7512;28898;249;740;6962;27315;7211;28055
130040;201611;3807;11651;3308;10950;322;1137;2631;8803;2953;9940
130050;201611;6199;25084;5747;24435;355;1536;4898;21362;5253;22898
130060;201611;5897;27088;5552;26458;551;3171;4323;20511;4874;23682
130063;201611;3866;17004;3671;16744;261;1322;3216;14762;3477;16084
130068;201611;3238;13403;2838;12493;247;1261;2076;9153;2323;10414
130070;201611;7423;24028;6494;22900;497;1613;5361;19401;5858;21014
130080;201611;5548;24050;5115;23334;643;3422;3701;16918;4344;20340
130083;201611;2232;8681;2064;8394;264;1215;1484;5999;1748;7214
130090;201611;2751;9688;2605;9445;86;401;2335;8458;2421;8859
130100;201611;5893;21339;5696;21076;136;550;5403;20058;5539;20608
130110;201611;6914;21924;6427;21323;638;1935;5286;18032;5924;19967
130115;201611;4670;16201;4352;15657;151;601;3818;13731;3969;14332
130120;201611;14996;56295;13837;54688;1437;5883;11078;44647;12515;50530
130130;201611;4061;16244;3963;16057;202;1020;3475;14027;3677;15047
130140;201611;6316;24660;6199;24527;259;1068;5777;22912;6036;23980
130150;201611;3459;13626;3355;13487;131;729;3026;12082;3157;12811
130160;201611;4259;17555;4048;17257;445;2220;3256;13841;3701;16061
130165;201611;2905;11898;2743;11608;181;950;2273;9620;2454;10570
130170;201611;9601;33205;8218;31457;944;3862;6355;24679;7299;28541
130180;201611;3494;11503;3414;11388;118;294;3189;10786;3307;11080
130185;201611;11997;37362;10503;35611;862;2435;8741;31078;9603;33513
130190;201611;17179;58656;14645;55066;2475;9398;9774;37956;12249;47354
130195;201611;1997;8365;1912;8239;108;459;1690;7415;1798;7874
130200;201611;2068;7041;1841;6673;382;1406;1177;4371;1559;5777
130210;201611;1310;5122;1174;4932;114;609;919;3807;1033;4416
130220;201611;2068;8333;1855;7907;223;1058;1221;5200;1444;6258
130230;201611;3747;17074;3476;16597;355;1864;2660;12998;3015;14862
130240;201611;8963;32910;7954;31380;370;2002;6946;27267;7316;29269
130250;201611;20308;69768;18796;67701;2831;9900;13680;51321;16511;61221
130255;201611;4359;14811;3983;14191;205;801;3471;12436;3676;13237
130260;201611;253489;821263;219500;759301;65003;239029;91738;314700;156741;553729
130270;201611;7571;30888;6918;29814;912;3987;5105;22669;6017;26656
130280;201611;3368;13892;3230;13717;104;464;3007;12918;3111;13382
130290;201611;11573;40543;10873;39694;210;527;10368;38547;10578;39074
130300;201611;4565;17343;4271;16878;243;1169;3697;14590;3940;15759
130310;201611;5057;19268;4584;18582;359;1666;3755;15350;4114;17016
130320;201611;3036;10884;2705;10361;389;1580;1842;7215;2231;8795
130330;201611;3714;13452;3313;12891;160;781;2864;11096;3024;11877
130340;201611;18597;69855;16853;67493;2195;8699;13279;54628;15474;63327
130350;201611;3377;13823;3266;13641;240;1378;2735;11249;2975;12627
130353;201611;6226;18925;5287;17660;1087;3557;3377;11966;4464;15523
130356;201611;4628;16637;4232;15961;534;2007;3073;11925;3607;13932
130360;201611;3325;9518;2906;9066;93;231;2714;8632;2807;8863
130370;201611;5741;21591;4892;20435;177;969;4279;17910;4456;18879
130380;201611;8056;33266;7681;32654;489;2479;6554;27866;7043;30345
130390;201611;5288;23121;4910;22368;521;2802;3634;16469;4155;19271
130395;201611;2236;7787;1945;7183;233;926;1367;4996;1600;5922
130400;201611;2188;8160;2029;7915;125;609;1785;6932;1910;7541
130406;201611;10945;41153;9801;39421;2684;11137;5711;23296;8395;34433
130410;201611;3940;14869;3456;13947;1064;4626;1507;6236;2571;10862
130420;201611;10825;45052;10195;44024;1933;8507;7166;31801;9099;40308
130423;201611;3444;13145;3155;12708;242;1190;2655;10603;2897;11793
130426;201611;2407;10159;2304;9984;140;666;2007;8797;2147;9463
130430;201611;3564;12378;3374;12083;278;1002;2804;10177;3082;11179
130440;201611;3606;12982;3355;12676;195;836;2959;11194;3154;12030
140002;201611;1699;5578;1535;5335;118;508;1171;4001;1289;4509
140005;201611;3537;9647;3401;9493;65;149;3282;9219;3347;9368
140010;201611;55329;158947;43587;140294;10781;36257;18016;60434;28797;96691
140015;201611;2988;9420;2765;9140;193;481;2399;8196;2592;8677
140017;201611;3182;10154;2814;9651;278;924;2133;7571;2411;8495
140020;201611;4513;15109;3976;14306;558;2180;2738;9861;3296;12041
140023;201611;2214;7319;1857;6735;209;831;1327;4852;1536;5683
140028;201611;2110;5804;1896;5486;210;698;1423;3939;1633;4637
140030;201611;3807;11752;3466;11264;679;1817;2286;7988;2965;9805
140040;201611;1783;8196;1716;8093;119;730;1503;6978;1622;7708
140045;201611;2509;9211;2234;8789;416;1587;1499;6223;1915;7810
140047;201611;5615;17046;4758;15595;1236;4068;2213;7743;3449;11811
140050;201611;1417;4433;1237;4170;236;811;762;2603;998;3414
140060;201611;1476;4438;1286;4138;220;754;839;2692;1059;3446
140070;201611;1646;8921;1572;8693;129;876;1238;6827;1367;7703
150010;201611;36874;108266;34092;104216;2290;7402;27805;84838;30095;92240
150013;201611;1771;5090;1558;4830;183;532;1172;3733;1355;4265
150020;201611;12677;42112;12119;41299;1528;4703;9593;33683;11121;38386
150030;201611;7438;31287;7167;30868;645;2579;6008;26548;6653;29127
150034;201611;4303;11829;3979;11381;169;505;3562;10218;3731;10723
150040;201611;13203;41255;11269;38871;1569;4683;8474;31125;10043;35808
150050;201611;5721;22428;5370;21782;266;1354;4614;18645;4880;19999
150060;201611;18478;56969;16259;53208;3625;11847;9266;31237;12891;43084
150070;201611;6191;24844;5493;24061;219;1114;5032;22197;5251;23311
150080;201611;77434;199030;62492;177508;13962;39025;31657;94180;45619;133205
150085;201611;5723;19135;5410;18733;442;1315;4640;16542;5082;17857
150090;201611;10461;39631;9763;38501;863;3550;7636;30572;8499;34122
150095;201611;5449;17530;4845;16593;366;1193;3886;13683;4252;14876
150100;201611;3306;12196;3033;11657;190;852;2404;9094;2594;9946
150110;201611;3664;17204;3639;17157;210;1019;3241;15430;3451;16449
150120;201611;6695;24176;6498;23834;483;1561;5395;20509;5878;22070
150125;201611;731;2122;621;1986;100;362;412;1296;512;1658
150130;201611;22685;68360;20446;64916;2480;7496;14996;48728;17476;56224
150140;201611;169382;466467;154025;444529;20130;56221;114038;334196;134168;390417
150145;201611;4661;14560;4159;13875;534;1880;3214;10796;3748;12676
150150;201611;12470;37230;11200;35211;1846;6018;7428;23574;9274;29592
150157;201611;3198;9483;2689;8723;367;1338;1833;6008;2200;7346
150160;201611;3162;9925;2921;9554;867;2874;1529;5102;2396;7976
150170;201611;21974;80349;20502;77797;2949;11404;14619;56361;17568;67765
150172;201611;3120;10508;2697;9783;360;1350;1919;7092;2279;8442
150175;201611;1925;5818;1773;5637;157;489;1436;4718;1593;5207
150178;201611;10347;31575;8781;29598;944;3410;6539;22506;7483;25916
150180;201611;18909;74831;18000;73518;1222;5583;15280;62784;16502;68367
150190;201611;7094;24277;6772;23807;229;877;6151;21798;6380;22675
150195;201611;5436;17537;5057;16912;172;595;4538;15277;4710;15872
150200;201611;5364;16846;5083;16514;106;359;4777;15628;4883;15987
150210;201611;25464;94114;24423;92599;1793;6802;20398;79258;22191;86060
150215;201611;7539;23603;6436;21724;2024;7057;2553;8750;4577;15807
150220;201611;12071;37204;10583;34727;2505;8268;5352;17970;7857;26238
150230;201611;12065;37229;10274;34588;1563;5401;6660;22799;8223;28200
150240;201611;36019;106390;29908;94870;10156;32988;7735;25255;17891;58243
150250;201611;4057;16861;3878;16574;795;3410;2536;11322;3331;14732
150260;201611;2076;8138;1939;7871;356;1423;1196;4978;1552;6401
150270;201611;8650;26201;6596;23451;1818;6616;3344;12249;5162;18865
150275;201611;6025;21615;5613;20918;664;2368;4146;15814;4810;18182
150276;201611;2235;6613;1958;6236;342;1142;1424;4571;1766;5713
150277;201611;4960;15056;4158;13989;1036;3583;2545;8753;3581;12336
150280;201611;6017;26687;5781;26134;878;4058;4139;19096;5017;23154
150285;201611;3016;11471;2754;11002;335;1429;1940;7864;2275;9293
150290;201611;10243;28801;9679;28159;635;1501;8389;25150;9024;26651
150293;201611;9750;26108;6884;21972;2134;7001;2368;8139;4502;15140
150295;201611;7765;22405;6206;20520;1523;5004;3413;12307;4936;17311
150300;201611;2039;6623;1876;6375;99;445;1564;5253;1663;5698
150304;201611;4248;13350;3587;12230;649;2217;2218;7790;2867;10007
150307;201611;6750;22068;6191;21221;407;1304;5216;18019;5623;19323
150309;201611;6212;21131;5396;19778;1351;4905;2854;10999;4205;15904
150310;201611;6443;27328;6132;26819;502;2428;5012;22069;5514;24497
150320;201611;9654;24604;8709;23440;893;2199;6985;19095;7878;21294
150330;201611;14275;47910;13163;46148;1988;6973;9410;33816;11398;40789
150340;201611;2577;8038;2329;7621;244;797;1753;5759;1997;6556
150345;201611;6842;22328;6321;21578;614;2076;4956;17220;5570;19296
150350;201611;8273;24705;7584;23781;1327;3457;5423;17940;6750;21397
150360;201611;21705;66412;18512;62109;3208;10559;12135;42415;15343;52974
150370;201611;10134;36268;9172;34853;1168;4310;6814;26817;7982;31127
150375;201611;2929;12833;2813;12660;287;1323;2307;10512;2594;11835
150380;201611;10124;28811;8748;26839;533;1618;7316;22679;7849;24297
150390;201611;8015;34409;7373;33132;1293;5545;4727;22204;6020;27749
150400;201611;5996;23159;5661;22445;470;1785;4488;18140;4958;19925
150405;201611;8410;25043;7319;23595;1076;2727;5228;18291;6304;21018
150410;201611;1625;6106;1468;5760;209;904;901;3526;1110;4430
150420;201611;37423;123614;30113;110919;9911;39288;8726;33780;18637;73068
150430;201611;7481;24897;7031;24153;950;3023;5155;18276;6105;21299
150440;201611;5551;18819;5251;18370;560;1880;4167;14863;4727;16743
150442;201611;22371;63491;18970;58018;3612;10925;11299;35589;14911;46514
150445;201611;5449;18567;4957;17720;579;2025;3706;13544;4285;15569
150450;201611;4268;20613;4080;20269;529;2559;3098;15890;3627;18449
150460;201611;7162;26281;6540;25463;304;1473;5518;22164;5822;23637
150470;201611;17875;54593;17011;53486;851;2254;15427;49265;16278;51519
150475;201611;3560;12284;3241;11810;279;1058;2610;9625;2889;10683
150480;201611;14218;48014;12840;45745;1353;4959;9953;35932;11306;40891
150490;201611;7200;27379;6974;27011;266;1167;6161;24019;6427;25186
150495;201611;5025;18333;4836;18073;170;682;4449;16707;4619;17389
150497;201611;2757;9964;2415;9256;810;3218;1006;3939;1816;7157
150500;201611;3203;8776;2929;8367;287;793;2299;6550;2586;7343
150503;201611;3703;11274;3024;10323;1018;3564;1491;5286;2509;8850
150506;201611;11212;38454;10065;36753;2390;8344;6083;23720;8473;32064
150510;201611;9946;38329;8831;35917;1424;5737;5697;24125;7121;29862
150520;201611;6754;26602;6597;26385;253;963;6124;24762;6377;25725
150530;201611;12568;42838;11080;40358;1217;3988;8471;31524;9688;35512
150540;201611;4777;14350;4162;13420;266;874;3431;11044;3697;11918
150543;201611;5914;18051;5074;16778;1111;3744;3010;10205;4121;13949
150548;201611;9395;29854;8642;28882;413;1208;7853;26646;8266;27854
150549;201611;2087;6677;1890;6434;64;221;1722;5930;1786;6151
150550;201611;20606;64775;17240;58678;5385;18520;6341;22437;11726;40957
150553;201611;23377;79823;18556;69468;6820;27022;4297;16389;11117;43411
150555;201611;1779;5209;1422;4593;103;341;1040;3343;1143;3684
150560;201611;1981;6426;1803;6038;305;1003;1063;3574;1368;4577
150563;201611;2713;8947;2471;8508;610;2247;1267;4327;1877;6574
150565;201611;3957;13493;3527;12767;151;697;2968;10741;3119;11438
150570;201611;5965;21384;5684;20839;560;2092;4372;16154;4932;18246
150580;201611;9854;40882;9520;40441;633;2750;8277;35780;8910;38530
150590;201611;5732;22714;5491;22397;164;764;5070;20729;5234;21493
150600;201611;8138;30971;7707;30311;322;1422;6896;27313;7218;28735
150610;201611;2483;8281;2225;7736;208;773;1593;5465;1801;6238
150611;201611;2799;9447;2576;9016;148;550;2137;7511;2285;8061
150613;201611;12780;37688;10048;33306;3183;10989;4055;13680;7238;24669
150616;201611;3200;9664;2336;8100;592;2230;714;2344;1306;4574
150618;201611;6571;22016;5749;20468;1509;5406;2974;10849;4483;16255
150619;201611;5253;17792;4738;16890;564;2149;3380;12021;3944;14170
150620;201611;6483;22922;5806;21997;740;2878;4377;16901;5117;19779
150630;201611;5978;17677;5602;17215;511;1601;4633;14474;5144;16075
150635;201611;4069;13099;3523;11958;930;3230;1444;5034;2374;8264
150640;201611;1959;5752;1839;5603;171;492;1574;4957;1745;5449
150650;201611;12454;37279;10703;34053;3007;9564;4396;14557;7403;24121
150655;201611;5236;16978;4835;16227;586;2029;3578;12076;4164;14105
150658;201611;4574;13622;3871;12612;820;2898;2386;7936;3206;10834
150660;201611;5692;17554;5043;16512;1207;3954;2640;8845;3847;12799
150670;201611;7620;19814;6093;17859;640;1987;4801;14261;5441;16248
150680;201611;60228;204741;50061;186943;15046;57500;19861;80052;34907;137552
150690;201611;2076;6305;1829;5904;224;686;1284;4204;1508;4890
150700;201611;6240;19432;5593;18499;936;3105;3737;12653;4673;15758
150710;201611;4306;14420;3792;13537;429;1571;2682;9689;3111;11260
150715;201611;5050;15650;4294;14433;441;1621;3210;10812;3651;12433
150720;201611;6623;26274;6180;25440;697;3114;4570;19133;5267;22247
150730;201611;10350;34666;9378;33011;1229;4461;7029;25194;8258;29655
150740;201611;3745;11846;3283;10956;705;2433;1710;5694;2415;8127
150745;201611;5182;16310;4591;15435;1250;4466;2565;8565;3815;13031
150746;201611;1403;4519;1307;4334;121;383;986;3313;1107;3696
150747;201611;5381;16505;4644;15546;429;1271;3507;12496;3936;13767
150750;201611;3426;10957;3044;10375;197;788;2471;8409;2668;9197
150760;201611;11536;36434;10565;35087;1699;5726;7379;24909;9078;30635
150770;201611;6041;22704;5717;22122;287;980;5021;20340;5308;21320
150775;201611;1147;3434;960;3096;179;682;508;1595;687;2277
150780;201611;3639;11605;3491;11423;130;484;3178;10394;3308;10878
150790;201611;5031;16353;4635;15870;378;1308;3705;13470;4083;14778
150795;201611;15261;48629;13450;45679;3148;10372;7763;27516;10911;37888
150796;201611;3154;9113;2803;8666;316;1000;2164;6803;2480;7803
150797;201611;3785;12889;3386;12124;119;489;2850;10173;2969;10662
150800;201611;14184;45950;12856;44212;2746;8799;8457;30793;11203;39592
150803;201611;6770;24115;6291;23304;695;2716;4651;17375;5346;20091
150805;201611;2705;9664;2456;9213;370;1361;1695;6474;2065;7835
150808;201611;5925;19419;4555;16611;1719;6789;545;1931;2264;8720
150810;201611;19510;59088;15750;54130;2651;8844;10113;36634;12764;45478
150812;201611;5345;16651;4822;15670;575;2119;3400;10702;3975;12821
150815;201611;8674;28402;7655;27065;850;2921;5972;21673;6822;24594
150820;201611;11665;33355;10190;31579;909;2246;8163;26144;9072;28390
150830;201611;13038;48655;12048;47192;589;2886;10072;40348;10661;43234
150835;201611;2297;7998;2082;7570;471;1714;1085;4058;1556;5772
150840;201611;7354;22322;5852;19602;1305;4683;2826;9354;4131;14037
160005;201611;822;2784;773;2689;67;275;627;2139;694;2414
160010;201611;1316;4394;1312;4389;43;86;1258;4279;1301;4365
160015;201611;1743;6473;1693;6391;74;244;1557;5975;1631;6219
160020;201611;1930;6885;1758;6613;228;897;1284;4898;1512;5795
160021;201611;1055;4478;1006;4393;111;621;734;3189;845;3810
160023;201611;1000;4113;979;4071;99;398;815;3435;914;3833
160025;201611;1430;4360;1412;4341;22;78;1376;4225;1398;4303
160027;201611;8338;24634;7632;23818;1525;4671;5301;17097;6826;21768
160030;201611;50160;170499;42896;157958;10708;39126;21990;86192;32698;125318
160040;201611;4314;16832;4200;16664;170;986;3827;14956;3997;15942
160050;201611;3203;11954;2805;11317;1576;6266;656;3030;2232;9296
160053;201611;3021;11279;2932;11141;780;2882;1762;6962;2542;9844
160055;201611;573;2266;563;2252;29;130;496;1977;525;2107
160060;201611;15897;53854;14720;52364;2015;6782;11130;40635;13145;47417
160070;201611;2668;10480;2488;10152;189;908;2083;8477;2272;9385
160080;201611;2601;9725;2531;9624;62;311;2391;9042;2453;9353
170025;201611;526;1696;460;1598;126;446;234;817;360;1263
170030;201611;1188;3903;1003;3557;242;874;431;1542;673;2416
170035;201611;1457;4136;1108;3447;185;632;562;1722;747;2354
170040;201611;1911;5932;1631;5556;207;786;885;3257;1092;4043
170070;201611;1683;4475;1267;3901;241;794;714;2166;955;2960
170100;201611;2425;7144;2024;6491;222;685;1527;4945;1749;5630
170105;201611;776;2398;574;1969;126;470;260;854;386;1324
170110;201611;963;3126;801;2811;178;672;342;1188;520;1860
170130;201611;1371;4315;1072;3718;274;1013;451;1596;725;2609
170190;201611;1550;4559;1097;3771;413;1341;210;863;623;2204
170200;201611;1627;4484;960;3151;281;976;189;571;470;1547
170210;201611;31724;89498;23814;75818;7660;26068;4862;15931;12522;41999
170215;201611;1229;3744;1015;3391;107;401;704;2328;811;2729
170220;201611;5652;19182;5058;17945;1256;4576;2556;9182;3812;13758
170230;201611;1397;4430;1066;3745;231;887;450;1511;681;2398
170240;201611;2768;8149;2167;7153;233;903;1457;4721;1690;5624
170255;201611;3460;10829;2674;9343;871;3072;1054;3736;1925;6808
170270;201611;1043;2542;677;2018;59;179;455;1334;514;1513
170290;201611;2809;8030;2436;7587;312;673;1903;6443;2215;7116
170300;201611;1963;5887;1528;5133;170;598;984;3323;1154;3921
170305;201611;753;2240;572;1885;103;371;297;961;400;1332
170307;201611;1061;3680;862;3283;186;756;405;1592;591;2348
170310;201611;1614;4433;1140;3590;299;995;493;1541;792;2536
170320;201611;1147;3276;809;2690;179;624;349;1190;528;1814
170330;201611;817;2620;728;2467;59;223;583;1948;642;2171
170360;201611;481;1497;378;1302;77;285;184;597;261;882
170370;201611;1346;3803;954;3113;162;590;510;1616;672;2206
170380;201611;1748;5553;1346;4851;230;898;668;2415;898;3313
170382;201611;582;1879;465;1670;59;237;307;1110;366;1347
170384;201611;1591;6369;1428;6033;364;1619;699;3004;1063;4623
170386;201611;926;2732;760;2456;232;861;282;842;514;1703
170388;201611;639;1903;492;1636;103;383;180;562;283;945
170389;201611;933;3114;828;2924;64;250;628;2200;692;2450
170390;201611;1306;3702;1048;3351;96;316;799;2572;895;2888
170410;201611;548;1720;433;1494;30;125;279;947;309;1072
170460;201611;497;1347;308;997;60;222;116;354;176;576
170510;201611;778;2537;575;2118;92;381;293;1015;385;1396
170550;201611;6877;19369;4607;15130;1565;5558;587;1853;2152;7411
170555;201611;1353;3837;1038;3330;203;688;515;1694;718;2382
170560;201611;1081;3452;812;3063;164;661;458;1789;622;2450
170600;201611;1329;3885;1138;3601;344;1038;623;2055;967;3093
170610;201611;1720;5121;1292;4372;151;561;798;2643;949;3204
170625;201611;428;1280;298;1000;42;140;108;341;150;481
170650;201611;1238;3928;949;3359;240;873;334;1252;574;2125
170700;201611;4232;12921;3253;11199;713;2607;1397;4923;2110;7530
170710;201611;1782;5187;1353;4373;242;830;731;2326;973;3156
170720;201611;1911;5094;1571;4526;186;449;1208;3657;1394;4106
170730;201611;997;2924;749;2482;203;686;292;983;495;1669
170740;201611;2175;7717;1838;7045;278;1078;1157;4491;1435;5569
170755;201611;791;2454;576;1977;99;386;250;816;349;1202
170765;201611;1316;3570;925;2906;249;800;342;1126;591;1926
170770;201611;1693;5675;1503;5321;343;1200;852;3086;1195;4286
170820;201611;3592;11611;3113;10717;646;2340;1553;5391;2199;7731
170825;201611;742;2180;590;1887;87;289;317;989;404;1278
170830;201611;1423;4124;1198;3768;79;184;1034;3349;1113;3533
170900;201611;2525;8921;2354;8638;223;872;1865;6906;2088;7778
170930;201611;3887;11406;3178;10224;782;2637;1541;5048;2323;7685
170950;201611;13967;40299;9508;31825;2862;10686;1374;4435;4236;15121
170980;201611;507;1463;349;1175;68;228;147;483;215;711
171050;201611;1513;5002;1310;4586;105;451;1009;3475;1114;3926
171070;201611;1466;4547;1314;4318;319;1023;738;2532;1057;3555
171090;201611;1090;2906;866;2567;67;175;643;1915;710;2090
171110;201611;605;1763;427;1424;132;488;163;471;295;959
171150;201611;1062;2870;637;2074;97;340;386;1243;483;1583
171180;201611;705;2099;435;1515;113;395;162;598;275;993
171190;201611;1619;6004;1394;5493;276;1131;649;2682;925;3813
171195;201611;877;3017;719;2719;96;407;453;1717;549;2124
171200;201611;688;2143;527;1828;167;623;155;501;322;1124
171215;201611;467;1363;337;1106;50;182;163;537;213;719
171240;201611;701;2544;633;2408;63;302;398;1544;461;1846
171245;201611;625;2068;477;1697;106;415;163;557;269;972
171250;201611;1044;3022;790;2570;186;639;379;1188;565;1827
171270;201611;403;1633;371;1564;139;544;121;590;260;1134
171280;201611;882;2715;702;2375;174;604;309;1095;483;1699
171320;201611;3848;11546;3094;10171;925;3004;1225;4159;2150;7163
171330;201611;2837;8203;2217;7185;606;2090;996;3198;1602;5288
171360;201611;1464;4670;1289;4393;110;400;1006;3440;1116;3840
171370;201611;669;1902;562;1750;115;411;318;968;433;1379
171380;201611;1292;4090;1019;3556;416;1486;222;835;638;2321
171395;201611;893;2684;634;2142;106;419;314;1010;420;1429
171420;201611;2050;6225;1460;5008;357;1265;536;1825;893;3090
171430;201611;1089;3290;863;2868;155;524;484;1580;639;2104
171488;201611;2529;7655;2082;6965;462;1538;1122;3897;1584;5435
171500;201611;866;2512;673;2185;83;266;460;1515;543;1781
171510;201611;888;3065;762;2820;67;279;544;2027;611;2306
171515;201611;513;1469;378;1214;55;168;213;676;268;844
171525;201611;652;2055;535;1838;62;232;324;1069;386;1301
171550;201611;336;1106;245;919;75;317;68;255;143;572
171570;201611;1256;3946;1068;3564;224;711;670;2311;894;3022
171575;201611;1947;5378;1356;4273;287;968;642;1988;929;2956
171610;201611;5421;17078;4254;14843;1141;4326;1316;4548;2457;8874
171620;201611;2727;7833;2278;7191;119;463;1879;5924;1998;6387
171630;201611;923;2787;749;2506;215;749;356;1198;571;1947
171650;201611;2247;6897;1601;5474;428;1525;531;1792;959;3317
171660;201611;2428;6730;1732;5412;269;881;957;2952;1226;3833
171665;201611;1491;4319;1124;3709;211;723;574;1975;785;2698
171670;201611;1936;5398;1526;4705;430;1432;595;1748;1025;3180
171700;201611;1119;3520;900;3082;148;522;508;1733;656;2255
171720;201611;747;2205;613;1970;172;561;291;953;463;1514
171750;201611;1163;3617;853;2970;234;788;240;885;474;1673
171780;201611;1164;3134;821;2621;102;366;447;1386;549;1752
171790;201611;1401;4936;1177;4438;308;1150;600;2409;908;3559
171800;201611;711;2191;575;1959;70;240;371;1290;441;1530
171820;201611;10477;30938;8291;27270;1698;5871;4041;13415;5739;19286
171830;201611;1384;5105;1176;4610;372;1399;423;1781;795;3180
171840;201611;763;2097;624;1889;47;151;468;1385;515;1536
171845;201611;713;1946;536;1640;76;259;290;888;366;1147
171850;201611;925;3263;785;2960;92;392;493;1868;585;2260
171855;201611;1129;3582;1004;3332;62;239;769;2508;831;2747
171865;201611;455;1506;376;1358;70;247;182;654;252;901
171870;201611;736;2182;551;1816;144;494;203;714;347;1208
171875;201611;1276;4051;1028;3619;93;385;699;2426;792;2811
171880;201611;829;3033;796;2982;89;327;630;2427;719;2754
171884;201611;888;2436;608;1981;163;575;145;538;308;1113
171886;201611;1414;4539;1053;3771;312;1200;212;762;524;1962
171888;201611;742;2188;511;1702;63;209;292;962;355;1171
171889;201611;506;1566;430;1437;89;290;217;773;306;1063
171890;201611;1212;3624;963;3239;171;568;524;1767;695;2335
171900;201611;491;1769;361;1441;107;450;139;542;246;992
172000;201611;586;1880;476;1646;74;265;264;891;338;1156
172010;201611;1195;4111;1080;3888;118;516;786;2784;904;3300
172015;201611;339;1314;262;1144;59;227;126;580;185;807
172020;201611;2320;7667;2104;7287;307;1141;1424;4951;1731;6092
172025;201611;707;2045;485;1641;68;244;257;890;325;1134
172030;201611;1162;3666;981;3340;52;221;773;2600;825;2821
172049;201611;1331;3400;935;2712;449;1394;329;885;778;2279
172065;201611;1369;3559;1107;3260;81;215;976;2930;1057;3145
172080;201611;2435;7595;2001;6767;199;788;1323;4400;1522;5188
172085;201611;517;1425;340;1059;61;174;106;340;167;514
172090;201611;3865;10509;3115;9375;111;351;2704;8188;2815;8539
172093;201611;606;1805;442;1491;96;369;193;637;289;1006
172097;201611;649;1911;485;1616;105;351;171;578;276;929
172100;201611;35832;103042;25324;83934;7112;25878;6652;21868;13764;47746
172110;201611;1648;6186;1422;5785;171;801;996;4111;1167;4912
172120;201611;5180;15917;4119;14326;790;2740;2497;8900;3287;11640
172125;201611;247;766;195;668;39;154;88;295;127;449
172130;201611;558;1526;406;1259;39;147;257;773;296;920
172208;201611;2183;6338;1849;5787;257;797;1144;3593;1401;4390
172210;201611;2594;7701;2189;7085;437;1542;1317;4194;1754;5736
210005;201611;22176;68241;17975;61243;6483;23172;5602;19222;12085;42394
210010;201611;1787;6632;1600;6291;98;431;1311;5232;1409;5663
210015;201611;3445;10764;2996;10040;195;481;2551;8853;2746;9334
210020;201611;7225;17250;6696;16597;204;492;6140;15168;6344;15660
210030;201611;5546;18280;5147;17703;429;1698;4138;14180;4567;15878
210040;201611;1929;5309;1769;5113;78;201;1584;4636;1662;4837
210043;201611;6937;19080;5792;17608;715;1951;4109;13300;4824;15251
210047;201611;6686;24338;5970;23159;526;2323;4593;17825;5119;20148
210050;201611;2331;8514;1871;7565;693;2849;638;2770;1331;5619
210055;201611;1779;6106;1580;5777;128;490;1222;4470;1350;4960
210060;201611;7308;28181;6657;26896;991;4151;4340;17989;5331;22140
210070;201611;7335;21302;6727;20541;94;302;6223;19140;6317;19442
210080;201611;3766;12942;3658;12801;27;117;3499;12304;3526;12421
210083;201611;4549;15737;4059;15162;118;512;3810;14285;3928;14797
210087;201611;3008;8757;2700;8335;295;857;2123;6712;2418;7569
210090;201611;10264;32694;9647;31699;354;1292;8535;28093;8889;29385
210095;201611;6069;21468;5758;21022;305;1204;4913;18102;5218;19306
210100;201611;7435;21944;6653;20864;302;1185;5630;17415;5932;18600
210110;201611;2868;9912;2733;9723;113;503;2435;8629;2548;9132
210120;201611;26826;74325;22707;69246;2977;7633;16330;53161;19307;60794
210125;201611;3664;11415;3520;11259;184;401;3165;10436;3349;10837
210130;201611;4244;12475;3862;11907;259;837;3204;9841;3463;10678
210135;201611;1676;4922;1414;4534;91;294;1137;3670;1228;3964
210140;201611;17483;55008;14567;50717;2906;10630;8500;30170;11406;40800
210150;201611;4721;11508;4149;10768;88;233;3858;9970;3946;10203
210160;201611;17894;55843;16581;53813;2172;6375;12556;42290;14728;48665
210170;201611;14270;49872;13710;49097;762;2844;12078;43638;12840;46482
210173;201611;2080;8199;1924;7925;78;434;1745;7125;1823;7559
210177;201611;3150;9556;2953;9310;127;382;2689;8578;2816;8960
210180;201611;1515;4565;1398;4381;56;210;1189;3695;1245;3905
210190;201611;4929;15488;4399;14469;184;790;3504;11249;3688;12039
210193;201611;1400;4355;1248;4101;75;267;1025;3409;1100;3676
210197;201611;2089;6964;1908;6740;245;825;1439;5278;1684;6103
210200;201611;8414;28111;7718;27078;1003;3270;5802;21182;6805;24452
210203;201611;6932;21399;6452;20762;402;1118;5618;18460;6020;19578
210207;201611;3064;9785;2807;9305;300;914;2071;7036;2371;7950
210210;201611;8478;28528;7912;27753;70;306;7360;26141;7430;26447
210215;201611;1162;4796;1096;4684;89;458;865;3726;954;4184
210220;201611;6207;24002;5842;23387;327;1575;4922;19803;5249;21378
210230;201611;5386;17162;4955;16472;266;860;4289;14379;4555;15239
210232;201611;13228;41987;10732;38642;1723;6359;6857;26317;8580;32676
210235;201611;3731;11494;3262;10875;178;672;2776;9270;2954;9942
210237;201611;2360;8938;2284;8829;31;144;2179;8474;2210;8618
210240;201611;3057;9512;2807;9131;157;496;2347;7654;2504;8150
210250;201611;5308;16980;4944;16493;125;626;4510;14895;4635;15521
210255;201611;2677;8506;2374;7938;273;965;1755;5852;2028;6817
210260;201611;5234;16923;4740;16144;479;1564;3662;12730;4141;14294
210270;201611;5452;15225;4685;14110;121;557;4128;12272;4249;12829
210275;201611;3682;8820;3433;8534;162;301;3172;8068;3334;8369
210280;201611;5734;17084;4739;15596;268;1171;3641;11617;3909;12788
210290;201611;5851;19046;5308;18344;296;1040;4545;15892;4841;16932
210300;201611;38748;106342;30969;96141;3253;9952;22240;71898;25493;81850
210310;201611;2959;8248;2657;7820;87;186;2358;7032;2445;7218
210312;201611;2297;7125;2130;6886;59;290;1907;6108;1966;6398
210315;201611;2774;8707;2417;8240;128;441;2117;7319;2245;7760
210317;201611;4241;13079;4024;12810;145;522;3708;11841;3853;12363
210320;201611;19755;63692;17946;61412;880;3225;15476;53654;16356;56879
210325;201611;3742;11358;3258;10605;210;751;2622;8587;2832;9338
210330;201611;35980;88740;27501;79261;5416;14020;16497;53991;21913;68011
210340;201611;12031;35573;10663;33634;2362;7482;6633;22252;8995;29734
210350;201611;10156;30659;8868;28762;556;1849;7210;23553;7766;25402
210355;201611;3988;14426;3554;13712;188;829;3019;11785;3207;12614
210360;201611;16306;48675;14370;45780;1115;3890;11241;35702;12356;39592
210370;201611;9405;22545;7775;20774;300;567;6894;19112;7194;19679
210375;201611;3253;9672;2615;8785;847;2891;1166;4044;2013;6935
210380;201611;6214;17015;5450;15939;483;1230;4417;13233;4900;14463
210390;201611;2942;10337;2637;9820;166;813;2179;8042;2345;8855
210400;201611;4972;15649;4739;15381;102;274;4525;14841;4627;15115
210405;201611;8415;22823;6476;19948;2118;6600;2294;7822;4412;14422
210407;201611;2045;7246;1710;6610;213;824;1206;4693;1419;5517
210408;201611;2459;9456;2270;9193;149;700;1903;7890;2052;8590
210409;201611;3771;13546;3513;13140;210;1015;2901;10818;3111;11833
210410;201611;3722;12137;3549;11896;374;1113;2864;10010;3238;11123
210420;201611;4162;13567;3713;12745;245;842;3010;10459;3255;11301
210430;201611;2165;6688;2075;6576;104;329;1811;5753;1915;6082
210440;201611;4025;12450;3832;12182;199;566;3446;11088;3645;11654
210450;201611;2833;8817;2451;8192;148;497;1946;6466;2094;6963
210455;201611;3958;11489;3505;10818;530;1583;2498;8039;3028;9622
210460;201611;3679;11889;3351;11353;173;703;2781;9393;2954;10096
210462;201611;1463;5244;1331;4986;81;379;1065;3968;1146;4347
210465;201611;2638;8501;2386;8132;185;533;2028;7080;2213;7613
210467;201611;6297;20701;5833;20139;375;1217;4980;17546;5355;18763
210470;201611;2086;5639;1475;4699;92;263;1140;3667;1232;3930
210480;201611;15201;47844;12898;44813;2247;7490;8794;32567;11041;40057
210490;201611;3728;10123;3132;9246;99;314;2724;7989;2823;8303
210500;201611;6469;26522;6127;25817;629;2760;4708;20187;5337;22947
210510;201611;6598;22261;6167;21704;336;1004;5252;19061;5588;20065
210515;201611;3762;11718;3575;11504;71;189;3380;11036;3451;11225
210520;201611;2682;8060;2396;7642;192;583;1968;6380;2160;6963
210530;201611;46494;130665;30832;105397;7334;27980;12672;44226;20006;72206
210535;201611;3314;11287;3111;10979;119;417;2760;9860;2879;10277
210540;201611;13578;43980;11669;41169;2208;7661;7061;26389;9269;34050
210542;201611;5983;17003;5378;16331;314;725;4671;14612;4985;15337
210545;201611;2368;7570;2227;7328;47;256;1978;6408;2025;6664
210547;201611;3753;13344;3435;12751;348;1182;2581;9850;2929;11032
210550;201611;6150;17939;5532;17260;293;664;5007;16106;5300;16770
210560;201611;4105;12714;3608;11845;169;633;3059;9992;3228;10625
210565;201611;1511;5373;1259;4937;71;370;981;3870;1052;4240
210570;201611;12586;35224;11312;33734;714;1626;9810;30124;10524;31750
210580;201611;3260;9472;2882;8976;286;639;2241;7549;2527;8188
210590;201611;4105;12926;3768;12470;265;914;3206;10665;3471;11579
210592;201611;2544;7908;2420;7693;41;184;2141;6770;2182;6954
210594;201611;2722;7694;2065;6642;116;278;1592;5313;1708;5591
210596;201611;2762;10148;2575;9782;252;1011;1915;7374;2167;8385
210598;201611;1894;5800;1727;5590;91;339;1502;4834;1593;5173
210600;201611;3304;9360;2757;8576;155;503;2204;6822;2359;7325
210610;201611;2562;8283;2369;8025;127;557;2051;6832;2178;7389
210620;201611;2004;6481;1813;6225;54;133;1669;5850;1723;5983
210630;201611;3720;12927;3277;12149;317;1398;2309;8521;2626;9919
210632;201611;4633;15882;4211;15204;475;1801;3197;11583;3672;13384
210635;201611;1914;6647;1792;6453;90;314;1575;5753;1665;6067
210637;201611;2702;9210;2451;8834;147;569;1981;7208;2128;7777
210640;201611;4620;16981;4513;16854;4;16;4425;16628;4429;16644
210650;201611;6958;20979;6721;20673;178;524;6379;19720;6557;20244
210660;201611;8514;24708;7535;23192;297;967;6798;20785;7095;21752
210663;201611;2793;8337;2609;8107;162;515;2226;7014;2388;7529
210667;201611;1887;6457;1750;6237;78;338;1508;5382;1586;5720
210670;201611;4629;16852;4359;16396;221;987;3649;13778;3870;14765
210675;201611;5225;14322;4682;13605;478;1235;3778;11266;4256;12501
210680;201611;4132;11154;3571;10445;191;463;3072;9106;3263;9569
210690;201611;7584;25486;7229;25080;289;922;6358;22797;6647;23719
210700;201611;2693;7863;2427;7538;492;1240;1593;5650;2085;6890
210710;201611;4967;16095;4603;15510;224;941;3900;13011;4124;13952
210720;201611;2630;9432;2459;9180;129;607;2183;8080;2312;8687
210725;201611;1112;4190;945;3833;132;508;600;2530;732;3038
210730;201611;1175;3552;1003;3281;87;246;788;2612;875;2858
210735;201611;4238;14358;3783;13567;500;1863;2755;10076;3255;11939
210740;201611;5022;14839;4670;14455;203;878;4199;12706;4402;13584
210745;201611;4119;12050;3829;11662;243;643;3264;10051;3507;10694
210750;201611;21036;56078;17978;52429;2284;6556;13165;39215;15449;45771
210760;201611;5988;17109;5477;16550;37;116;5336;16178;5373;16294
210770;201611;6089;16513;5131;15327;116;451;4682;13926;4798;14377
210780;201611;8223;27294;7374;25759;869;2961;5209;18713;6078;21674
210790;201611;4759;14657;4202;13948;321;798;3356;11739;3677;12537
210800;201611;4898;13615;4335;12910;124;401;3901;11632;4025;12033
210805;201611;3854;15577;3681;15266;179;936;3163;13136;3342;14072
210810;201611;5522;16603;5038;15967;335;649;4358;14429;4693;15078
210820;201611;7963;22774;6912;21034;1030;2993;4723;14686;5753;17679
210825;201611;5769;19783;5460;19352;603;2012;4326;15813;4929;17825
210830;201611;8514;24690;7985;24013;869;2156;6368;20002;7237;22158
210840;201611;3707;10021;3233;9281;112;308;2754;7867;2866;8175
210845;201611;5945;17672;5728;17435;80;175;5532;17029;5612;17204
210850;201611;6414;22388;5651;21060;563;2421;4121;15321;4684;17742
210860;201611;18310;53310;16072;49983;1307;4006;12719;40038;14026;44044
210870;201611;5859;19481;5269;18699;566;1955;4036;14622;4602;16577
210880;201611;4352;14055;4114;13728;303;1123;3429;11423;3732;12546
210890;201611;5198;15265;4654;14605;355;978;3887;12702;4242;13680
210900;201611;5084;15040;4014;13233;1660;5732;958;3360;2618;9092
210905;201611;1869;5809;1627;5425;123;314;1295;4468;1418;4782
210910;201611;8784;27610;7670;25667;1107;3833;5116;17187;6223;21020
210920;201611;2896;10515;2732;10229;156;779;2248;8345;2404;9124
210923;201611;1541;5154;1392;4899;138;526;939;3389;1077;3915
210927;201611;4952;15611;4635;15253;84;248;4407;14627;4491;14875
210930;201611;2579;9251;2379;8920;114;632;2016;7396;2130;8028
210940;201611;3073;11294;2929;11022;191;867;2489;9232;2680;10099
210945;201611;5938;17995;5688;17700;298;464;5180;16511;5478;16975
210950;201611;5355;16351;4443;14869;451;1497;3246;11033;3697;12530
210955;201611;1933;6143;1665;5727;161;557;1185;4157;1346;4714
210960;201611;9428;29662;8476;28264;2135;6745;4745;17047;6880;23792
210970;201611;1398;4827;1208;4503;150;591;842;3132;992;3723
210975;201611;1812;6013;1688;5772;108;400;1337;4545;1445;4945
210980;201611;10376;24034;9892;23514;637;1186;8836;21529;9473;22715
210990;201611;16902;51368;13266;45948;3336;12035;6187;22086;9523;34121
211000;201611;15962;50095;13907;47561;813;3284;11628;40150;12441;43434
211003;201611;5031;18368;4472;17550;309;1414;3415;13803;3724;15217
211010;201611;6616;24313;6237;23811;80;399;5934;22792;6014;23191
211020;201611;7543;24210;7168;23573;555;2038;5890;19225;6445;21263
211023;201611;2238;7525;2128;7337;184;696;1724;5936;1908;6632
211027;201611;2889;10989;2795;10834;285;1155;2228;8705;2513;9860
211030;201611;3926;11887;3639;11581;644;1461;2711;9448;3355;10909
211040;201611;4539;16724;4291;16327;159;910;3755;14224;3914;15134
211050;201611;10447;26548;9914;25956;233;548;9381;24619;9614;25167
211060;201611;6283;21877;6033;21492;458;1712;5137;18449;5595;20161
211065;201611;2021;6390;1799;6062;66;226;1638;5546;1704;5772
211070;201611;8315;28153;7537;26821;409;1525;6278;22572;6687;24097
211080;201611;1379;4096;1146;3733;73;344;886;2752;959;3096
211085;201611;2006;6662;1801;6309;241;877;1285;4566;1526;5443
211090;201611;3583;10296;3292;9874;113;456;2856;8410;2969;8866
211100;201611;6743;17533;6542;17301;39;135;6383;16871;6422;17006
211102;201611;2990;11365;2797;11075;246;1018;2323;9345;2569;10363
211105;201611;2698;8639;2271;7942;214;819;1670;5777;1884;6596
211107;201611;4648;14590;4128;13866;240;810;3403;11699;3643;12509
211110;201611;6531;19128;5113;16928;917;2925;3207;11073;4124;13998
211120;201611;36618;101266;32557;96243;5397;15267;22758;69632;28155;84899
211125;201611;2102;6622;1833;6185;110;423;1517;5107;1627;5530
211130;201611;163486;437146;141538;403265;25030;72445;74864;224020;99894;296465
211140;201611;5432;17964;4968;17206;184;718;4247;14714;4431;15432
211150;201611;10056;28699;8906;27208;397;1349;7598;23228;7995;24577
211153;201611;2899;8828;2575;8374;672;2249;1587;5238;2259;7487
211157;201611;1225;3901;1024;3582;81;372;694;2449;775;2821
211160;201611;4229;13641;3475;12307;237;1104;2432;8335;2669;9439
211163;201611;1726;5627;1601;5440;37;125;1457;5038;1494;5163
211167;201611;1536;5081;1459;4961;40;184;1365;4632;1405;4816
211170;201611;6394;16806;6091;16439;97;292;5686;15282;5783;15574
211172;201611;2526;7301;2235;6877;99;420;1930;5829;2029;6249
211174;201611;2874;8295;2563;7893;60;305;2344;7114;2404;7419
211176;201611;4412;13608;3704;12643;338;1307;2771;9523;3109;10830
211178;201611;4144;10538;3763;10060;54;144;3586;9534;3640;9678
211180;201611;4355;14958;4056;14493;277;1070;3379;12179;3656;13249
211190;201611;2897;9492;2644;9098;65;311;2289;7835;2354;8146
211195;201611;1499;4459;1231;4105;62;182;1039;3546;1101;3728
211200;201611;2184;7128;1872;6668;355;1200;1128;4244;1483;5444
211210;201611;6893;21087;6441;20429;403;1286;5479;17426;5882;18712
211220;201611;35658;100594;29720;92647;5423;17158;19178;61085;24601;78243
211223;201611;5330;16326;4763;15376;592;1815;3462;11394;4054;13209
211227;201611;1663;5795;1504;5536;92;388;1250;4629;1342;5017
211230;201611;8450;27100;7512;25474;814;2823;5517;18940;6331;21763
211240;201611;8177;27901;7670;27218;264;1196;6879;24190;7143;25386
211245;201611;5624;16596;5572;16541;108;182;5411;16255;5519;16437
211250;201611;13512;42952;12572;41781;1166;3332;10319;35628;11485;38960
211260;201611;8657;26760;8142;26040;445;1523;7268;23252;7713;24775
211270;201611;10496;35589;9236;33919;476;2187;7439;27587;7915;29774
211280;201611;13201;39226;11761;37171;1005;2573;9588;31343;10593;33916
211285;201611;1826;6624;1549;6001;266;1116;768;3084;1034;4200
211290;201611;7300;23733;6925;23202;399;1234;5994;20405;6393;21639
211300;201611;8417;24950;7699;23923;196;549;7077;22099;7273;22648
211400;201611;12075;37154;10293;34527;2734;9291;4942;18177;7676;27468
220005;201611;1866;5280;1630;4896;69;247;1305;3783;1374;4030
220010;201611;1443;4179;1239;3845;41;147;1007;3056;1048;3203
220020;201611;3373;10603;3128;10168;566;1830;1965;6399;2531;8229
220025;201611;2315;5645;2020;5188;32;95;1726;4335;1758;4430
220027;201611;1401;3745;1210;3475;62;179;982;2807;1044;2986
220030;201611;3302;8922;3212;8776;164;534;2818;7572;2982;8106
220040;201611;7932;24321;7151;22859;1441;4547;4394;14098;5835;18645
220045;201611;1435;4698;1263;4351;62;289;970;3243;1032;3532
220050;201611;4543;13610;3836;12349;188;771;3100;9832;3288;10603
220060;201611;2128;5180;1862;4828;50;100;1690;4383;1740;4483
220070;201611;2486;7179;2201;6696;158;455;1730;5248;1888;5703
220080;201611;730;2164;665;2057;47;199;555;1648;602;1847
220090;201611;1853;4656;1495;4147;49;175;1301;3523;1350;3698
220095;201611;735;1969;683;1892;13;51;634;1732;647;1783
220100;201611;1367;4090;1087;3562;73;298;847;2708;920;3006
220105;201611;2289;7178;1990;6577;143;449;1494;4966;1637;5415
220110;201611;3460;9947;3213;9529;98;376;2820;8225;2918;8601
220115;201611;2626;8666;2500;8458;141;549;2206;7403;2347;7952
220117;201611;1322;3477;1061;3066;53;169;881;2508;934;2677
220120;201611;12451;35897;11354;34456;157;688;10643;32146;10800;32834
220130;201611;866;2914;761;2737;35;205;657;2292;692;2497
220140;201611;1715;4505;1477;4201;169;384;1201;3505;1370;3889
220150;201611;7149;21517;6637;20739;165;681;5865;18061;6030;18742
220155;201611;1132;3428;872;2917;34;121;581;1916;615;2037
220157;201611;1085;2710;907;2407;22;72;779;2008;801;2080
220160;201611;2654;7982;2308;7328;86;381;1848;5752;1934;6133
220170;201611;1406;4182;1183;3804;37;168;974;3082;1011;3250
220173;201611;2093;6245;1660;5370;45;226;1369;4291;1414;4517
220177;201611;1781;5309;1734;5237;42;163;1642;4938;1684;5101
220180;201611;1136;3083;929;2681;20;67;679;1876;699;1943
220190;201611;4746;15094;4269;14412;518;1786;3250;10976;3768;12762
220191;201611;1440;4738;1329;4538;135;496;985;3293;1120;3789
220192;201611;1824;5155;1426;4435;69;224;1092;3385;1161;3609
220194;201611;1764;5259;1531;4861;95;338;1201;3727;1296;4065
220196;201611;2064;5942;1844;5533;133;466;1488;4391;1621;4857
220198;201611;1357;3828;1021;3375;13;44;957;3201;970;3245
220200;201611;4622;15057;4227;14486;353;1213;3412;11794;3765;13007
220202;201611;2188;6516;1856;5892;34;166;1622;5021;1656;5187
220205;201611;2805;7358;2469;6874;54;201;2174;5952;2228;6153
220207;201611;915;2755;744;2432;78;285;514;1650;592;1935
220208;201611;1862;5917;1543;5326;258;928;925;3176;1183;4104
220209;201611;1580;4720;1336;4277;35;150;1117;3523;1152;3673
220210;201611;1685;4493;1417;4038;30;127;1154;3172;1184;3299
220211;201611;1620;4497;1489;4298;47;193;1318;3725;1365;3918
220213;201611;1773;4993;1576;4599;33;125;1292;3649;1325;3774
220217;201611;2037;6399;1934;6265;42;150;1794;5874;1836;6024
220220;201611;10964;30065;9495;27670;709;1768;7090;21086;7799;22854
220225;201611;1108;3167;885;2826;29;111;733;2303;762;2414
220230;201611;5483;14751;4836;13768;215;592;4211;11984;4426;12576
220240;201611;2949;9031;2657;8460;116;441;2185;6898;2301;7339
220245;201611;1537;4076;1251;3667;17;55;1131;3362;1148;3417
220250;201611;3195;9131;2855;8608;81;308;2502;7497;2583;7805
220253;201611;1623;4837;1333;4287;234;801;865;2743;1099;3544
220255;201611;1779;4902;1497;4395;40;148;1226;3430;1266;3578
220260;201611;4707;14956;4029;13650;304;1034;3010;10231;3314;11265
220265;201611;1351;4627;1204;4357;114;454;793;2888;907;3342
220270;201611;6945;22432;6526;21605;422;1718;5349;17201;5771;18919
220271;201611;1498;4154;1307;3839;68;183;1086;3235;1154;3418
220272;201611;1823;5402;1611;5006;46;186;1279;3870;1325;4056
220273;201611;1238;3563;1058;3237;84;256;782;2378;866;2634
220275;201611;2146;5370;1711;4820;31;134;1533;4214;1564;4348
220277;201611;2269;6224;1913;5600;68;214;1568;4499;1636;4713
220280;201611;1587;4243;1353;3813;86;290;1075;2941;1161;3231
220285;201611;1678;4366;1372;3948;25;97;1250;3603;1275;3700
220290;201611;6171;20337;5180;18782;555;2155;3633;13198;4188;15353
220300;201611;1885;6218;1649;5835;73;393;1325;4550;1398;4943
220310;201611;2522;8316;2242;7957;86;381;1903;6755;1989;7136
220320;201611;3030;9210;2533;8268;253;926;1790;5790;2043;6716
220323;201611;1519;5288;1313;4972;142;573;1007;3827;1149;4400
220325;201611;1185;3751;961;3288;70;290;709;2372;779;2662
220327;201611;1329;4236;1186;3970;39;208;979;3168;1018;3376
220330;201611;3738;9946;3304;9347;114;295;2974;8473;3088;8768
220335;201611;1846;5633;1647;5388;26;73;1551;5127;1577;5200
220340;201611;1874;5108;1533;4545;101;323;1135;3277;1236;3600
220342;201611;1155;3768;1078;3642;64;284;871;2913;935;3197
220345;201611;2917;7361;2523;6757;50;107;2334;6246;2384;6353
220350;201611;3988;10422;3246;9169;184;573;2503;6924;2687;7497
220360;201611;1312;3563;1097;3220;79;244;859;2470;938;2714
220370;201611;9436;26754;8382;25290;299;1045;7486;22429;7785;23474
220375;201611;1510;4708;1398;4562;16;45;1349;4441;1365;4486
220380;201611;1424;3804;1157;3411;40;146;940;2679;980;2825
220385;201611;859;2185;671;1859;17;60;548;1484;565;1544
220390;201611;9648;29097;8138;26283;2116;6921;3205;10539;5321;17460
220400;201611;1524;3821;1123;3143;96;180;865;2403;961;2583
220410;201611;1241;3584;1036;3247;65;223;799;2460;864;2683
220415;201611;880;2379;739;2151;45;132;544;1544;589;1676
220420;201611;2193;6249;1767;5377;119;311;1317;4008;1436;4319
220430;201611;2622;7300;2543;7191;116;361;2257;6324;2373;6685
220435;201611;1672;4907;1480;4555;36;143;1202;3644;1238;3787
220440;201611;2400;7881;2202;7564;173;583;1754;5957;1927;6540
220450;201611;2097;6457;1735;5922;415;1513;960;3277;1375;4790
220455;201611;1377;4256;1258;4047;52;183;1103;3537;1155;3720
220460;201611;904;2477;817;2362;47;128;693;1982;740;2110
220465;201611;2408;7877;2147;7444;316;1137;1504;5249;1820;6386
220470;201611;3888;11345;3460;10632;149;432;2739;8304;2888;8736
220480;201611;2528;7132;2135;6473;139;359;1624;4906;1763;5265
220490;201611;2306;6466;2088;6169;48;171;1859;5430;1907;5601
220500;201611;3241;8680;2665;7652;87;383;2123;5855;2210;6238
220510;201611;2822;8094;2181;6920;82;287;1656;5211;1738;5498
220515;201611;1907;4613;1652;4264;127;294;1369;3540;1496;3834
220520;201611;5255;14178;4723;13438;114;333;4265;12155;4379;12488
220525;201611;1289;3635;1203;3500;37;137;1021;2923;1058;3060
220527;201611;1402;4233;1211;3835;115;365;882;2844;997;3209
220530;201611;1287;3638;1113;3366;46;184;977;2875;1023;3059
220535;201611;876;2627;826;2556;82;258;611;1876;693;2134
220540;201611;3557;11289;3368;10992;110;507;2954;9501;3064;10008
220545;201611;1419;4675;1319;4474;130;498;1004;3347;1134;3845
220550;201611;9336;29450;8319;27581;754;2588;6148;20226;6902;22814
220551;201611;1485;4637;1295;4290;67;290;1017;3255;1084;3545
220552;201611;1665;5050;1392;4509;58;292;1096;3399;1154;3691
220553;201611;1639;4708;1314;4194;49;183;1058;3396;1107;3579
220554;201611;826;2369;713;2186;66;167;546;1696;612;1863
220555;201611;2234;6956;2025;6638;51;251;1769;5674;1820;5925
220556;201611;1445;4412;1255;4030;54;230;943;2886;997;3116
220557;201611;1610;5142;1423;4769;119;409;1005;3356;1124;3765
220558;201611;1096;3334;959;3104;48;231;758;2360;806;2591
220559;201611;1609;4508;1391;4131;27;89;1202;3556;1229;3645
220560;201611;1687;4182;1364;3699;42;114;1173;3117;1215;3231
220570;201611;7451;23762;6874;22704;1047;3442;4656;15615;5703;19057
220580;201611;6687;20638;6471;20285;266;848;5832;18211;6098;19059
220585;201611;2125;7138;1910;6724;117;471;1548;5377;1665;5848
220590;201611;1361;4003;1179;3725;143;478;823;2632;966;3110
220595;201611;2435;7038;2239;6767;32;150;2058;6134;2090;6284
220600;201611;1320;3169;1044;2790;139;225;796;2259;935;2484
220605;201611;1953;5680;1625;5082;61;216;1306;3998;1367;4214
220610;201611;2775;8325;2610;8075;53;219;2376;7290;2429;7509
220620;201611;7751;25604;7392;25085;283;1349;6536;21889;6819;23238
220630;201611;397;1223;308;1047;52;189;162;549;214;738
220635;201611;1719;5802;1481;5270;73;333;1109;3843;1182;4176
220640;201611;2676;7763;2341;7256;105;384;1949;5948;2054;6332
220650;201611;2219;6420;1893;5795;111;371;1433;4330;1544;4701
220660;201611;2853;8493;2537;8057;107;515;2216;6825;2323;7340
220665;201611;1205;4007;1081;3785;23;131;937;3229;960;3360
220667;201611;1715;5628;1546;5311;85;312;1269;4326;1354;4638
220669;201611;1871;6033;1758;5828;216;901;1246;4024;1462;4925
220670;201611;2006;5866;1747;5524;119;312;1446;4666;1565;4978
220672;201611;2534;7283;2332;7026;165;521;1982;5993;2147;6514
220675;201611;1292;3680;1186;3483;75;177;933;2755;1008;2932
220680;201611;2472;7562;2311;7326;146;461;1966;6266;2112;6727
220690;201611;1742;4769;1460;4296;117;313;1111;3333;1228;3646
220695;201611;971;2736;865;2541;34;92;691;2011;725;2103
220700;201611;8700;24427;7355;22268;578;1838;5483;16441;6061;18279
220710;201611;829;2446;634;2047;43;110;478;1538;521;1648
220720;201611;2131;5441;1958;5176;58;163;1722;4513;1780;4676
220730;201611;1401;3948;1154;3548;28;118;974;2941;1002;3059
220735;201611;1036;2607;801;2189;34;96;649;1742;683;1838
220740;201611;1417;4352;1200;4047;62;220;1005;3424;1067;3644
220750;201611;4053;11235;3647;10586;282;744;2986;8755;3268;9499
220755;201611;1212;3384;1053;3110;47;163;830;2387;877;2550
220760;201611;2829;9264;2535;8850;132;596;2136;7360;2268;7956
220770;201611;22496;73989;19381;67688;6762;24578;5560;20043;12322;44621
220775;201611;1237;3297;1178;3228;16;55;1149;3142;1165;3197
220777;201611;1628;4389;1309;3852;92;206;1014;2996;1106;3202
220779;201611;1419;3626;1308;3456;43;142;1157;3003;1200;3145
220780;201611;5940;15828;5128;14565;481;1366;4017;11386;4498;12752
220785;201611;1322;3346;1242;3219;42;101;1139;2934;1181;3035
220790;201611;10363;31081;9345;29391;645;2318;7573;23485;8218;25803
220793;201611;831;2345;726;2173;32;112;602;1785;634;1897
220795;201611;1477;4159;1358;3983;62;205;1217;3536;1279;3741
220800;201611;16544;44569;14081;40332;2691;8021;8528;23514;11219;31535
220810;201611;3392;9638;2861;8694;114;443;2280;6766;2394;7209
220820;201611;5562;14834;4875;13789;344;821;4086;11538;4430;12359
220830;201611;7691;21422;6995;20256;562;1635;5538;16016;6100;17651
220840;201611;14228;44493;12188;40212;2614;8658;6140;20530;8754;29188
220850;201611;2953;9894;2748;9618;90;397;2501;8765;2591;9162
220855;201611;620;1885;525;1700;26;108;389;1235;415;1343
220860;201611;961;2560;833;2355;40;133;695;1932;735;2065
220865;201611;2661;7231;2065;6171;61;277;1679;4829;1740;5106
220870;201611;2310;7570;2015;7162;56;272;1825;6439;1881;6711
220880;201611;4793;12875;4395;12389;73;215;4121;11644;4194;11859
220885;201611;1297;4610;1114;4260;78;359;853;3217;931;3576
220887;201611;1384;3410;1194;3139;12;48;1107;2871;1119;2919
220890;201611;1670;5661;1398;5054;117;409;1035;3799;1152;4208
220900;201611;1952;5326;1691;4882;44;122;1480;4254;1524;4376
220910;201611;1562;4682;1339;4333;49;133;1174;3866;1223;3999
220915;201611;1040;2898;848;2522;24;99;671;1912;695;2011
220920;201611;1371;4883;1221;4655;85;452;928;3419;1013;3871
220930;201611;1479;4681;1341;4464;44;208;1121;3686;1165;3894
220935;201611;1098;3282;876;2778;57;190;590;1796;647;1986
220937;201611;1531;4149;1247;3643;50;178;983;2804;1033;2982
220940;201611;1359;4261;1219;3954;69;296;866;2726;935;3022
220945;201611;436;1612;382;1492;34;150;264;1005;298;1155
220950;201611;1339;3276;878;2488;20;81;709;1920;729;2001
220955;201611;1496;4241;1261;3811;73;189;987;2985;1060;3174
220960;201611;937;2398;714;2021;24;71;546;1519;570;1590
220965;201611;1675;4938;1561;4747;44;221;1351;3982;1395;4203
220970;201611;2190;5729;1546;4641;103;332;1151;3435;1254;3767
220975;201611;713;2265;644;2169;28;166;579;1874;607;2040
220980;201611;1322;3909;1127;3562;65;222;850;2689;915;2911
220985;201611;1227;3595;1128;3435;76;274;863;2542;939;2816
220987;201611;1499;4737;1324;4424;73;330;1038;3372;1111;3702
220990;201611;1839;5270;1534;4717;44;214;1188;3532;1232;3746
220995;201611;1278;3720;930;3147;85;296;655;2257;740;2553
220997;201611;2333;6995;2198;6781;45;204;2061;6283;2106;6487
221000;201611;4271;12909;3925;12281;269;1050;3090;9461;3359;10511
221005;201611;1478;4548;1318;4237;473;1384;587;2019;1060;3403
221010;201611;1226;3126;1018;2841;37;111;886;2437;923;2548
221020;201611;1783;5520;1609;5176;57;246;1175;3693;1232;3939
221030;201611;1531;4466;1318;4090;50;208;1063;3216;1113;3424
221035;201611;1494;4055;1370;3888;62;142;1256;3626;1318;3768
221037;201611;631;1863;536;1688;15;62;380;1127;395;1189
221038;201611;601;1699;462;1452;33;115;295;921;328;1036
221039;201611;965;2650;840;2455;28;115;696;1960;724;2075
221040;201611;4619;14220;4212;13505;222;713;3322;10682;3544;11395
221050;201611;3569;10647;3269;10212;117;412;2855;8857;2972;9269
221060;201611;8318;24172;6981;21878;453;1498;5400;16785;5853;18283
221062;201611;1302;4510;1132;4140;65;291;904;3259;969;3550
221063;201611;1104;3550;972;3300;152;499;629;2166;781;2665
221065;201611;2836;7546;2455;6895;90;240;2083;5763;2173;6003
221070;201611;3787;11914;3189;10723;184;711;2432;8133;2616;8844
221080;201611;3544;8912;2776;7762;106;338;2332;6424;2438;6762
221090;201611;1467;3952;1197;3507;35;151;1010;2876;1045;3027
221093;201611;1655;4871;1524;4575;223;694;903;2638;1126;3332
221095;201611;976;2604;829;2355;15;38;712;1988;727;2026
221097;201611;826;2277;639;1919;27;96;474;1370;501;1466
221100;201611;114254;331769;101622;309137;20473;64508;57425;171075;77898;235583
221110;201611;10497;32666;9629;31518;374;1584;8171;26385;8545;27969
221120;201611;4188;13342;3921;12841;640;2180;2676;8763;3316;10943
221130;201611;4791;13615;3785;11492;1219;3566;1478;4560;2697;8126
221135;201611;1558;4638;1402;4403;93;332;1170;3629;1263;3961
221140;201611;1374;3329;1195;3057;41;90;1051;2660;1092;2750
221150;201611;1246;3135;952;2597;30;119;761;1997;791;2116
221160;201611;831;2172;756;2057;31;79;585;1587;616;1666
221170;201611;1183;3535;1053;3299;56;152;837;2626;893;2778
230010;201611;3411;9160;2660;7819;211;698;2037;5856;2248;6554
230015;201611;2960;10030;2684;9418;329;1289;1762;6075;2091;7364
230020;201611;13868;44828;13304;43840;657;2489;11243;36809;11900;39298
230030;201611;12213;34548;10737;32148;476;1616;8830;26122;9306;27738
230040;201611;4570;12466;3738;10989;284;988;2719;7831;3003;8819
230050;201611;2673;8932;1878;6728;499;1733;518;1924;1017;3657
230060;201611;2312;6518;1898;5754;76;309;1472;4342;1548;4651
230070;201611;4392;12311;3589;10827;323;1076;2436;7407;2759;8483
230075;201611;9031;31327;8242;29692;698;3043;6244;22020;6942;25063
230080;201611;2501;6384;1950;5523;69;255;1628;4507;1697;4762
230090;201611;4011;11315;3436;10288;328;1114;2467;7287;2795;8401
230100;201611;17152;50269;15432;47039;2596;8454;9118;27768;11714;36222
230110;201611;13291;41676;11723;38216;2279;7509;6071;19572;8350;27081
230120;201611;8035;22094;6740;20044;804;2165;4525;14106;5329;16271
230125;201611;3129;8853;2466;7629;161;554;1818;5553;1979;6107
230130;201611;5817;18807;4736;16375;675;2378;2948;10031;3623;12409
230140;201611;3600;11257;2913;9914;218;840;2037;6880;2255;7720
230150;201611;1750;5363;1461;4729;304;1028;752;2409;1056;3437
230160;201611;6427;18581;5625;17335;283;1100;4548;13826;4831;14926
230170;201611;6460;19856;5408;17764;311;1168;3948;12763;4259;13931
230180;201611;1744;5064;1476;4504;62;267;1099;3187;1161;3454
230185;201611;3967;12816;3450;11804;575;2012;2134;7414;2709;9426
230190;201611;12954;40799;10910;36386;2298;7971;5108;16850;7406;24821
230195;201611;5437;16311;4637;14855;433;1451;3466;10924;3899;12375
230200;201611;5227;14857;4601;13591;360;1114;3473;10066;3833;11180
230205;201611;4213;13579;3725;12655;239;1014;2639;8817;2878;9831
230210;201611;9171;25796;7735;23379;1239;3742;4849;14795;6088;18537
230220;201611;13579;37981;11927;34977;940;3028;8844;25458;9784;28486
230230;201611;7572;23729;6743;22042;710;2306;4737;15476;5447;17782
230240;201611;14016;38487;11828;34660;538;1693;9281;26736;9819;28429
230250;201611;9923;30247;9645;29652;585;2111;7443;22330;8028;24441
230260;201611;14560;47662;12874;43965;2007;7109;7356;25262;9363;32371
230270;201611;7686;22165;6133;19158;860;2782;3904;12224;4764;15006
230280;201611;20230;58680;17288;53351;1414;4609;12936;39256;14350;43865
230290;201611;4877;14587;4043;12843;524;1548;2713;8646;3237;10194
230300;201611;4498;13277;4225;12874;247;916;3417;10216;3664;11132
230310;201611;4959;14676;4099;13056;184;731;2952;9161;3136;9892
230320;201611;7371;22322;6527;20744;411;1620;4932;15323;5343;16943
230330;201611;4876;14053;3969;12214;321;1012;2796;8469;3117;9481
230340;201611;3492;11557;3065;10594;324;1226;2015;6817;2339;8043
230350;201611;18629;55468;16158;50747;1785;6266;9826;31056;11611;37322
230360;201611;3285;9197;2468;7598;182;623;1670;5031;1852;5654
230365;201611;3106;8132;2618;7272;96;350;2171;5921;2267;6271
230370;201611;56375;176461;48987;162921;13145;45260;20693;70955;33838;116215
230380;201611;6689;19237;5300;16464;222;744;3915;12001;4137;12745
230390;201611;3542;11078;3041;10166;196;860;2202;7185;2398;8045
230393;201611;3237;10419;2654;9170;152;745;1931;6382;2083;7127
230395;201611;5863;16752;5035;15218;782;2339;2998;9240;3780;11579
230400;201611;5665;16678;4861;15316;238;1042;3851;11792;4089;12834
230410;201611;14849;46426;12300;40891;1733;5911;7362;24413;9095;30324
230420;201611;24928;78541;21629;71589;4418;15256;10169;33350;14587;48606
230423;201611;4315;13937;3859;12984;234;944;2959;9828;3193;10772
230425;201611;5645;18499;4990;17001;704;2431;3144;10744;3848;13175
230426;201611;2706;7460;2027;6133;65;285;1524;4468;1589;4753
230427;201611;1901;5570;1338;4287;135;407;804;2479;939;2886
230428;201611;8936;27367;8200;25855;1470;4969;4370;13456;5840;18425
230430;201611;4651;14438;4121;13363;280;1070;2969;9356;3249;10426
230435;201611;5143;15879;4438;14505;665;2409;2509;8044;3174;10453
230440;201611;373986;1075687;322395;980559;72024;226100;153034;462517;225058;688617
230445;201611;4662;12440;3780;10974;300;857;2680;7750;2980;8607
230450;201611;3746;11501;3151;10384;297;1239;2184;6996;2481;8235
230460;201611;2004;6441;1674;5804;151;613;1138;3880;1289;4493
230465;201611;4020;11852;3232;10306;238;839;2180;6761;2418;7600
230470;201611;11179;39933;10104;37592;1257;5134;6883;25367;8140;30501
230480;201611;1496;4592;1209;3998;136;531;825;2654;961;3185
230490;201611;2353;7082;1951;6237;279;922;978;3006;1257;3928
230495;201611;5913;18987;5069;17322;833;3107;2656;8991;3489;12098
230500;201611;9165;31955;8563;30689;583;2549;6408;22737;6991;25286
230510;201611;1519;5304;1068;4085;278;1089;333;1267;611;2356
230520;201611;4915;14715;4288;13497;436;1507;2801;8651;3237;10158
230523;201611;15342;48706;12392;41687;2904;10256;3149;10747;6053;21003
230526;201611;4167;12230;3473;10954;185;796;2698;8298;2883;9094
230530;201611;5523;17423;4832;16434;1072;3839;2924;10133;3996;13972
230533;201611;4124;11296;3459;10005;387;1011;2473;7254;2860;8265
230535;201611;5631;16370;4755;14711;566;1693;3017;9594;3583;11287
230540;201611;17773;51185;15666;47678;517;2092;13191;39465;13708;41557
230550;201611;20029;58397;16980;52317;3013;9967;8936;26738;11949;36705
230560;201611;6966;19754;5780;17503;184;736;4504;13344;4688;14080
230565;201611;3550;9655;2768;8172;96;355;2084;6068;2180;6423
230570;201611;3728;9977;3189;9188;106;367;2655;7547;2761;7914
230580;201611;10209;30200;9258;28747;711;2370;7613;23480;8324;25850
230590;201611;9239;27944;7544;24561;623;2250;5244;16564;5867;18814
230600;201611;3792;10321;2668;7982;233;669;1718;5197;1951;5866
230610;201611;6335;19666;5609;18365;714;2281;3909;12877;4623;15158
230620;201611;2204;6172;1636;4924;195;617;935;2703;1130;3320
230625;201611;8084;25725;6927;23029;2072;7281;1860;6167;3932;13448
230630;201611;11065;34551;9791;32011;2690;8245;4308;15105;6998;23350
230640;201611;26916;85301;24151;80835;2385;8803;18071;59917;20456;68720
230650;201611;4913;14822;4312;13604;326;1201;3161;9692;3487;10893
230655;201611;9465;34824;8963;33827;741;3136;6943;26202;7684;29338
230660;201611;6229;19092;5175;16952;292;1348;4038;12856;4330;14204
230670;201611;6145;16133;4677;13498;150;473;3740;10435;3890;10908
230680;201611;2653;7758;2215;6860;316;965;1341;4135;1657;5100
230690;201611;6485;20610;5919;19299;797;2748;3634;11521;4431;14269
230700;201611;9878;27106;8365;24191;556;1914;6074;16855;6630;18769
230710;201611;7660;24416;6402;21895;747;2567;4401;15063;5148;17630
230720;201611;1884;5881;1534;5085;210;717;917;3007;1127;3724
230725;201611;3770;12633;3125;10960;753;2707;995;3437;1748;6144
230730;201611;58127;173389;46188;151936;13250;48029;9377;31737;22627;79766
230740;201611;6257;18330;5473;16923;207;823;4370;13234;4577;14057
230750;201611;8613;24426;7071;21689;355;1249;5438;16259;5793;17508
230760;201611;11264;32847;10000;30187;1089;3634;6909;20084;7998;23718
230763;201611;4380;13083;3731;11740;181;721;2846;8572;3027;9293
230765;201611;40276;124960;34186;112307;8983;30941;9926;33373;18909;64314
230770;201611;25435;69280;22102;63993;3008;8968;14217;40875;17225;49843
230780;201611;5981;22719;5617;21852;1297;5107;2751;11154;4048;16261
230790;201611;2871;8950;2603;8468;208;758;1986;6442;2194;7200
230800;201611;7697;26643;6769;24509;1387;5350;3208;11325;4595;16675
230810;201611;12435;39485;11436;37668;861;3064;8626;28096;9487;31160
230820;201611;3368;11431;2813;10144;392;1609;1564;5491;1956;7100
230830;201611;7676;22829;6569;20665;356;1347;4993;15423;5349;16770
230835;201611;4109;10568;3190;9101;214;596;2455;6981;2669;7577
230837;201611;3276;10811;2674;9495;229;923;1909;6576;2138;7499
230840;201611;9277;29695;8354;28047;688;2571;6304;21201;6992;23772
230850;201611;9698;29923;8776;28213;1150;3606;5841;18982;6991;22588
230860;201611;5224;14533;4512;13384;236;783;3657;10737;3893;11520
230870;201611;18976;49087;15759;43935;672;2009;12296;33963;12968;35972
230880;201611;2024;6735;1886;6441;116;529;1342;4455;1458;4984
230890;201611;4033;14373;3613;13421;368;1666;2403;8629;2771;10295
230900;201611;2935;9670;2336;8288;531;1756;1016;3740;1547;5496
230910;201611;3184;9168;2528;7941;170;740;1896;5759;2066;6499
230920;201611;4801;13572;4425;13085;175;611;3828;11382;4003;11993
230930;201611;7162;21252;6063;19058;546;1815;4125;12861;4671;14676
230940;201611;8003;22352;6840;20399;292;1001;5563;16476;5855;17477
230945;201611;6142;18326;5279;16833;367;1294;3680;11830;4047;13124
230950;201611;6590;17449;5905;16535;198;512;5128;14640;5326;15152
230960;201611;14503;44273;12506;40081;2458;7996;5749;18483;8207;26479
230970;201611;14186;42289;11863;37832;2401;8237;5331;16550;7732;24787
230980;201611;2991;9163;2508;8233;684;2184;1205;4140;1889;6324
230990;201611;1801;5249;1437;4517;122;488;944;2844;1066;3332
231000;201611;2766;7456;2120;6137;110;388;1438;4033;1548;4421
231010;201611;3155;8547;2481;7361;262;805;1652;4789;1914;5594
231020;201611;7960;26417;7245;24748;1261;4232;4259;14781;5520;19013
231025;201611;8064;24311;7134;22599;1082;3488;4503;14463;5585;17951
231030;201611;7661;24334;6131;21004;1137;4030;3236;11088;4373;15118
231040;201611;3155;9788;2733;8898;119;525;2065;6495;2184;7020
231050;201611;12183;33975;10003;29939;717;2270;7418;21990;8135;24260
231060;201611;2490;7947;2238;7461;126;630;1685;5434;1811;6064
231070;201611;8714;27180;7584;24802;1425;4744;3957;13080;5382;17824
231080;201611;3945;12161;3504;11326;135;731;2760;8525;2895;9256
231085;201611;4985;15259;4684;14770;613;1971;3294;10619;3907;12590
231090;201611;4263;11724;3218;9580;165;539;2316;6741;2481;7280
231095;201611;2243;7135;1884;6367;205;786;1231;4130;1436;4916
231100;201611;3258;9949;2608;8633;224;781;1869;6140;2093;6921
231110;201611;3574;11673;3488;11496;433;1474;2287;7494;2720;8968
231120;201611;2031;6761;1858;6368;277;983;1142;3909;1419;4892
231123;201611;2092;5655;1737;5007;124;327;1309;3734;1433;4061
231126;201611;6412;17952;5028;15333;236;852;3704;11017;3940;11869
231130;201611;19655;58857;17135;54495;3052;9977;10222;33530;13274;43507
231135;201611;4207;12426;3446;10983;252;858;2461;7753;2713;8611
231140;201611;17509;53612;14639;47883;1109;4748;9908;31089;11017;35837
231150;201611;5868;16772;4852;14832;815;2533;2359;7279;3174;9812
231160;201611;5897;19247;5311;18023;880;2991;3067;10432;3947;13423
231170;201611;4350;13791;3744;12459;311;1132;2602;8480;2913;9612
231180;201611;14699;42918;12362;37883;2595;8034;6249;18844;8844;26878
231190;201611;4619;12897;3749;11462;241;883;2798;8272;3039;9155
231195;201611;4725;15464;3935;13811;384;1662;2681;9154;3065;10816
231200;201611;7931;26460;6696;23741;340;1729;4888;16722;5228;18451
231210;201611;5062;15599;4272;14353;260;1221;3271;10728;3531;11949
231220;201611;12044;34019;10233;30541;594;2028;7510;21827;8104;23855
231230;201611;9381;30735;8342;29065;723;2950;6161;21400;6884;24350
231240;201611;12449;38297;10866;34982;2216;7242;5461;17581;7677;24823
231250;201611;1941;5497;1222;3715;379;1149;313;900;692;2049
231260;201611;3520;10407;3070;9621;566;1739;1799;5754;2365;7493
231270;201611;7406;19919;6321;18141;253;1017;4926;13799;5179;14816
231280;201611;1770;5733;1619;5418;171;593;1078;3632;1249;4225
231290;201611;34455;114195;29950;103530;6024;22286;12647;42622;18671;64908
231300;201611;4556;13023;3531;10937;261;909;2395;7203;2656;8112
231310;201611;7598;21381;5952;17870;837;2509;3472;10196;4309;12705
231320;201611;7164;21358;5635;18152;259;1018;4215;13318;4474;14336
231325;201611;2777;8006;2322;7228;501;1708;1202;3640;1703;5348
231330;201611;12240;38061;9999;33371;2046;6738;5172;17446;7218;24184
231335;201611;5606;15518;4701;13817;144;560;3875;11128;4019;11688
231340;201611;18231;58913;16379;55769;1314;4414;12486;43235;13800;47649
231350;201611;14613;42613;13567;41090;749;2124;11848;36333;12597;38457
231355;201611;4672;14548;4139;13575;267;1028;3044;9804;3311;10832
231360;201611;7806;24579;6789;22708;1201;4045;4137;14156;5338;18201
231370;201611;2468;6765;1845;5681;61;190;1413;4307;1474;4497
231375;201611;4280;14314;3890;13540;212;965;3035;10357;3247;11322
231380;201611;5644;16823;5253;16292;286;859;4306;13645;4592;14504
231390;201611;3526;10795;3170;10139;261;904;2226;6996;2487;7900
231395;201611;3937;12728;3451;11750;637;2106;1930;6640;2567;8746
231400;201611;9178;27964;8260;26026;493;1882;6170;19078;6663;20960
231410;201611;14676;48787;13194;46310;1122;4138;9978;35065;11100;39203
240010;201611;2488;7339;1946;6177;284;1013;1073;3278;1357;4291
240020;201611;10891;33612;9331;30443;1820;6200;4833;15749;6653;21949
240030;201611;2564;7173;2461;7016;200;551;2045;5814;2245;6365
240040;201611;847;2477;673;2115;17;87;492;1462;509;1549
240050;201611;3509;9428;2885;8286;94;317;2348;6601;2442;6918
240060;201611;1443;4066;1241;3671;54;201;991;2797;1045;2998
240070;201611;2593;7666;2371;7213;316;992;1604;4793;1920;5785
240080;201611;3083;8192;2575;7417;155;467;1971;5595;2126;6062
240090;201611;2319;6156;1840;5257;43;163;1469;4097;1512;4260
240100;201611;7951;22775;6862;20427;596;1919;4856;13993;5452;15912
240110;201611;4900;15163;4188;13633;663;2357;2293;7195;2956;9552
240120;201611;2738;9316;2523;8825;344;1358;1581;5417;1925;6775
240130;201611;2840;7490;2415;6777;85;280;2018;5562;2103;5842
240140;201611;2263;6740;1857;5959;251;919;1102;3401;1353;4320
240145;201611;5876;18264;5108;16815;1311;4444;2600;8744;3911;13188
240150;201611;1002;3026;804;2592;66;268;551;1689;617;1957
240160;201611;1466;4584;1217;4113;124;506;807;2707;931;3213
240165;201611;911;2824;744;2440;149;458;409;1376;558;1834
240170;201611;2359;7070;1995;6354;450;1495;978;3086;1428;4581
240180;201611;2746;8573;2343;7724;402;1383;1369;4551;1771;5934
240185;201611;1421;4675;1311;4488;81;312;1040;3563;1121;3875
240190;201611;973;3063;838;2803;33;155;657;2173;690;2328
240200;201611;13553;35416;10778;30974;2534;7473;4343;12667;6877;20140
240210;201611;2985;8173;2616;7569;136;490;2122;5958;2258;6448
240220;201611;7499;24692;6761;23490;651;2723;4895;16762;5546;19485
240230;201611;5762;15141;4849;13665;140;430;4154;11651;4294;12081
240240;201611;1816;5455;1047;3484;216;776;182;516;398;1292
240250;201611;2723;7915;2550;7673;104;323;2225;6693;2329;7016
240260;201611;12582;41760;11709;40203;2053;7252;7162;24737;9215;31989
240270;201611;2284;7244;2058;6836;186;675;1535;5119;1721;5794
240280;201611;1611;4494;1415;4193;69;222;1140;3360;1209;3582
240290;201611;1284;3991;1093;3596;50;258;721;2215;771;2473
240300;201611;2298;6256;1591;4741;206;659;788;2261;994;2920
240310;201611;9687;27260;8294;24768;1354;4264;4490;13402;5844;17666
240320;201611;2077;6058;1527;4871;53;211;1147;3483;1200;3694
240325;201611;35148;96461;26559;81738;8060;25937;6582;20911;14642;46848
240330;201611;1530;4616;1251;4007;62;239;801;2461;863;2700
240340;201611;2098;5368;1698;4701;154;450;1259;3412;1413;3862
240350;201611;2090;5795;1899;5543;88;318;1656;4760;1744;5078
240360;201611;7363;22170;6408;20604;1616;5267;3088;10299;4704;15566
240370;201611;2067;5669;1601;4765;175;483;1040;3095;1215;3578
240375;201611;866;2309;727;2049;52;189;523;1368;575;1557
240380;201611;2457;7268;1774;5685;262;842;915;2894;1177;3736
240390;201611;946;2604;755;2221;36;117;557;1577;593;1694
240400;201611;1363;3652;1040;3007;63;211;739;2058;802;2269
240410;201611;490;1603;430;1475;76;325;245;792;321;1117
240420;201611;4790;18103;4343;17019;784;3462;2305;8912;3089;12374
240430;201611;3344;9378;2978;8692;119;496;2368;6616;2487;7112
240440;201611;2541;6568;2226;6075;418;1203;1308;3506;1726;4709
240450;201611;3899;11522;3180;10048;353;1326;1880;5585;2233;6911
240460;201611;2908;8935;2720;8667;198;802;2162;6706;2360;7508
240470;201611;3581;11181;2698;9192;831;2686;1098;3848;1929;6534
240480;201611;525;1410;357;1057;26;84;193;549;219;633
240485;201611;2009;6330;1709;5693;235;837;1060;3535;1295;4372
240490;201611;1758;4401;1402;3808;32;115;1225;3277;1257;3392
240500;201611;2180;6189;1943;5819;111;381;1556;4613;1667;4994
240510;201611;1827;5350;1690;5120;173;501;1327;4043;1500;4544
240520;201611;1262;3620;1101;3337;86;313;854;2498;940;2811
240530;201611;2009;6467;1803;6106;316;1078;1182;4017;1498;5095
240540;201611;1793;5301;1672;5096;97;320;1403;4234;1500;4554
240550;201611;800;2271;665;2025;48;144;486;1461;534;1605
240560;201611;3319;9430;3026;8979;357;927;2291;6920;2648;7847
240570;201611;3119;8602;2125;6288;487;1467;758;2009;1245;3476
240580;201611;7855;24044;7168;22788;653;2366;5585;17444;6238;19810
240590;201611;786;2178;666;1953;27;96;508;1452;535;1548
240600;201611;1633;4772;1206;3820;118;432;699;2104;817;2536
240610;201611;4708;13435;3924;11838;390;1261;2576;7517;2966;8778
240615;201611;1054;3046;811;2555;156;501;443;1346;599;1847
240620;201611;1841;5569;1617;5169;155;495;1219;3890;1374;4385
240630;201611;2105;6289;1865;5854;164;436;1290;4141;1454;4577
240640;201611;939;2631;771;2347;46;198;566;1653;612;1851
240650;201611;4000;11709;3454;10797;187;630;2738;8455;2925;9085
240660;201611;2429;7654;2248;7366;183;663;1739;5642;1922;6305
240670;201611;2665;7907;2105;6675;250;816;1214;3751;1464;4567
240680;201611;1530;4439;1158;3713;90;309;800;2493;890;2802
240690;201611;971;2623;813;2347;47;172;653;1812;700;1984
240700;201611;2643;7810;2144;6860;66;282;1679;5237;1745;5519
240710;201611;18966;49226;15732;43937;3327;9019;8262;23497;11589;32516
240720;201611;5288;14981;4652;13750;1429;4310;1996;5691;3425;10001
240725;201611;1096;3280;835;2685;68;233;505;1562;573;1795
240730;201611;2162;6478;1823;5814;118;382;1352;4284;1470;4666
240740;201611;2028;5864;1749;5325;143;540;1236;3605;1379;4145
240750;201611;2208;8139;2001;7708;464;1944;938;3635;1402;5579
240760;201611;1361;3651;1087;3240;108;291;798;2489;906;2780
240770;201611;3195;9075;2810;8507;137;566;2323;6854;2460;7420
240780;201611;6199;16962;4792;14573;694;2104;2808;8624;3502;10728
240790;201611;915;2755;728;2380;34;134;518;1694;552;1828
240800;201611;36026;102389;30668;92691;7235;22328;12490;37916;19725;60244
240810;201611;87872;251004;78503;233766;21626;64317;33848;102453;55474;166770
240820;201611;6427;19605;5465;17953;1316;4578;2304;7823;3620;12401
240830;201611;8824;27066;8083;25887;334;1491;6830;21455;7164;22946
240840;201611;1235;3371;997;2936;109;315;617;1756;726;2071
240850;201611;1331;3857;914;2879;125;409;479;1478;604;1887
240860;201611;1340;3761;1034;3173;41;146;805;2369;846;2515
240870;201611;1204;3232;932;2718;179;501;507;1414;686;1915
240880;201611;1196;3949;1110;3786;74;351;897;2959;971;3310
240890;201611;5097;14319;4093;12315;859;2607;1714;5031;2573;7638
240895;201611;2725;9261;2462;8761;263;993;1757;6288;2020;7281
240910;201611;2984;8810;2574;8009;141;531;2020;6180;2161;6711
240920;201611;785;2512;660;2218;127;451;325;1081;452;1532
240930;201611;3562;9048;3040;8359;119;330;2527;6982;2646;7312
240933;201611;1491;4044;1243;3599;47;192;1044;2888;1091;3080
240940;201611;6706;17607;5169;14909;727;2045;3186;9087;3913;11132
240950;201611;983;3177;889;2991;56;243;645;2091;701;2334
240960;201611;806;2490;680;2218;59;205;490;1594;549;1799
240970;201611;1924;5298;1592;4720;85;323;1215;3463;1300;3786
240980;201611;3009;9847;2717;9269;492;1742;1599;5422;2091;7164
240990;201611;2834;8357;2594;7838;434;1414;1629;4827;2063;6241
241000;201611;1067;2947;870;2574;46;169;612;1767;658;1936
241010;201611;2823;9505;2594;9036;346;1450;1755;5833;2101;7283
241020;201611;2083;5724;1538;4583;225;620;946;2771;1171;3391
241025;201611;1659;5006;1365;4425;70;300;1021;3210;1091;3510
241030;201611;2435;7947;2082;7190;211;833;1439;4875;1650;5708
241040;201611;2236;7565;1989;7077;137;577;1454;5176;1591;5753
241050;201611;1296;3799;1087;3403;57;220;824;2525;881;2745
241060;201611;885;2521;779;2329;62;194;555;1631;617;1825
241070;201611;787;2263;694;2086;65;239;498;1404;563;1643
241080;201611;1175;3436;927;2936;31;141;684;2097;715;2238
241090;201611;2139;6334;1740;5605;93;414;1317;4138;1410;4552
241100;201611;1200;3529;987;3023;80;262;689;2074;769;2336
241105;201611;1226;3646;1025;3269;255;797;464;1546;719;2343
241110;201611;862;2652;672;2215;46;178;443;1392;489;1570
241120;201611;7381;22344;6486;20705;1676;5110;3201;10854;4877;15964
241140;201611;3506;9448;2930;8252;274;728;2085;5753;2359;6481
241142;201611;736;2166;524;1686;110;398;232;706;342;1104
241150;201611;5520;16074;4789;14745;578;1820;3207;9819;3785;11639
241160;201611;980;2869;858;2651;144;432;506;1542;650;1974
241170;201611;1178;3410;1076;3220;99;308;842;2484;941;2792
241180;201611;962;2666;720;2147;86;269;393;1124;479;1393
241190;201611;1211;3321;934;2738;43;163;632;1761;675;1924
241200;201611;19863;56638;16802;51569;4179;13217;7154;22341;11333;35558
241210;201611;1480;4134;1126;3377;146;510;660;1893;806;2403
241220;201611;8211;26514;7372;24863;2192;7482;3162;10929;5354;18411
241230;201611;3046;8782;2749;8276;157;535;2243;6604;2400;7139
241240;201611;1244;3628;785;2534;84;293;358;1151;442;1444
241250;201611;6115;18628;4976;16353;195;1032;3821;12083;4016;13115
241255;201611;1749;6565;1539;6025;336;1444;763;2953;1099;4397
241260;201611;5239;14044;4030;12013;187;785;3021;8708;3208;9493
241270;201611;1927;5818;1614;5151;109;442;1156;3578;1265;4020
241280;201611;1880;5414;1665;4986;157;457;1190;3554;1347;4011
241290;201611;3080;8484;2518;7453;194;620;1825;5284;2019;5904
241300;201611;1484;4200;1216;3677;51;165;850;2530;901;2695
241310;201611;1691;4922;1514;4593;94;339;1200;3590;1294;3929
241320;201611;924;3182;813;2936;97;415;523;1847;620;2262
241330;201611;1445;4470;1351;4339;94;382;1134;3573;1228;3955
241335;201611;2809;8423;2505;7832;139;488;2053;6300;2192;6788
241340;201611;1859;5700;1516;4895;338;1159;663;2042;1001;3201
241350;201611;1950;6112;1721;5658;131;575;1278;4030;1409;4605
241355;201611;1455;3998;1132;3407;49;174;908;2687;957;2861
241360;201611;2137;5733;1678;4801;69;206;1261;3478;1330;3684
241370;201611;1371;4069;1064;3421;106;368;670;2080;776;2448
241380;201611;669;1893;543;1635;75;232;321;937;396;1169
241390;201611;2806;9062;2564;8619;256;955;1927;6433;2183;7388
241400;201611;3720;10657;3315;10026;357;1136;2472;7485;2829;8621
241410;201611;2524;7642;2214;7145;363;1257;1392;4447;1755;5704
241415;201611;1679;4995;1485;4667;124;422;1128;3462;1252;3884
241420;201611;2313;7935;1972;7301;602;2374;450;1634;1052;4008
241430;201611;586;1730;438;1390;45;158;243;723;288;881
241440;201611;6444;22810;5931;21897;826;3381;4220;15571;5046;18952
241445;201611;1008;2903;954;2837;70;164;783;2467;853;2631
241450;201611;3014;8153;2594;7532;317;973;1754;5023;2071;5996
241460;201611;3480;9998;2959;8908;259;855;2124;6208;2383;7063
241470;201611;1435;3917;1144;3504;103;353;853;2590;956;2943
241475;201611;1276;3790;990;3193;39;214;752;2269;791;2483
241480;201611;2817;9255;2510;8662;1020;3622;541;2051;1561;5673
241490;201611;695;1829;542;1575;26;72;368;1007;394;1079
241500;201611;744;2313;619;2129;16;65;532;1814;548;1879
250010;201611;2828;8702;2313;7567;83;359;1752;5573;1835;5932
250020;201611;1697;4777;1226;3852;58;229;849;2565;907;2794
250030;201611;7065;20280;6406;19259;415;1308;5211;15464;5626;16772
250040;201611;4165;13912;3750;12974;553;1928;2318;8055;2871;9983
250050;201611;3461;10764;3131;10184;534;1768;1852;5835;2386;7603
250053;201611;1267;3772;1137;3565;141;435;766;2431;907;2866
250057;201611;629;2645;608;2619;9;15;577;2558;586;2573
250060;201611;5250;15458;4804;14736;490;1590;3622;10980;4112;12570
250070;201611;4075;12403;3641;11570;123;594;2814;8546;2937;9140
250073;201611;809;2362;675;2117;22;79;526;1583;548;1662
250077;201611;2199;6340;1732;5514;127;425;1193;3786;1320;4211
250080;201611;4225;12234;3962;11749;311;928;3087;9019;3398;9947
250090;201611;2592;7363;2375;6982;253;541;1803;5384;2056;5925
250100;201611;3910;12610;3629;12074;273;1024;2820;9166;3093;10190
250110;201611;5151;15200;4787;14623;410;1465;3779;11292;4189;12757
250115;201611;539;1709;460;1536;24;131;328;1026;352;1157
250120;201611;1990;6066;1652;5392;97;367;1266;4080;1363;4447
250130;201611;5383;16618;4753;15410;196;867;3915;12421;4111;13288
250135;201611;1087;3247;976;3040;36;131;778;2399;814;2530
250140;201611;2080;6800;1943;6555;162;668;1488;4939;1650;5607
250150;201611;5161;17050;4570;15883;232;1039;3465;11783;3697;12822
250153;201611;1483;3989;1227;3597;40;173;1052;3009;1092;3182
250157;201611;1735;5595;1545;5206;210;713;1041;3532;1251;4245
250160;201611;3322;9719;3109;9358;99;360;2839;8509;2938;8869
250170;201611;1637;4740;1452;4436;124;431;1113;3368;1237;3799
250180;201611;16237;46957;14788;44492;1831;5782;10254;30140;12085;35922
250190;201611;4295;12192;3774;11271;556;1625;2412;7132;2968;8757
250200;201611;2042;5928;1645;5294;77;278;1358;4320;1435;4598
250205;201611;889;3027;797;2819;38;183;579;2017;617;2200
250210;201611;1488;4831;1352;4593;106;478;1020;3324;1126;3802
250215;201611;1370;4423;1275;4266;171;583;754;2504;925;3087
250220;201611;759;2277;633;2079;29;119;502;1643;531;1762
250230;201611;1558;3910;1207;3288;47;164;977;2521;1024;2685
250240;201611;2342;7683;2193;7397;107;404;1759;5910;1866;6314
250250;201611;4399;13101;3897;12332;179;630;3223;10098;3402;10728
250260;201611;1728;5201;1454;4732;79;259;1142;3706;1221;3965
250270;201611;1328;4095;1159;3871;95;305;877;3025;972;3330
250280;201611;3660;10651;3133;9766;302;951;2342;7284;2644;8235
250290;201611;1925;5109;1554;4587;28;105;1391;4089;1419;4194
250300;201611;5639;16378;5264;15886;476;1816;4346;12778;4822;14594
250310;201611;1174;3546;1016;3262;107;364;732;2304;839;2668
250320;201611;8326;24492;7694;23415;895;2975;5436;16097;6331;19072
250330;201611;2457;7561;2059;6937;154;537;1543;5153;1697;5690
250340;201611;1108;3246;969;2987;33;125;818;2476;851;2601
250350;201611;4208;11602;3726;10976;128;460;3227;9493;3355;9953
250355;201611;1961;6181;1781;5916;53;265;1551;5063;1604;5328
250360;201611;1865;5435;1681;5117;52;146;1423;4326;1475;4472
250370;201611;11887;33811;10533;32201;727;2260;9053;27724;9780;29984
250375;201611;1084;3253;959;3048;49;174;794;2510;843;2684
250380;201611;1704;4824;1593;4656;80;303;1344;3817;1424;4120
250390;201611;1889;5155;1460;4390;201;562;914;2750;1115;3312
250400;201611;74545;196760;55999;165683;15662;47638;19975;59577;35637;107215
250403;201611;1551;5040;1406;4816;218;919;925;3038;1143;3957
250407;201611;1222;3388;1019;3048;84;215;736;2176;820;2391
250410;201611;549;1780;501;1684;23;112;392;1279;415;1391
250415;201611;1880;5600;1643;5140;104;331;1267;3914;1371;4245
250420;201611;1300;3784;1163;3567;29;111;1037;3152;1066;3263
250430;201611;6098;16396;5416;15259;316;970;4488;12336;4804;13306
250435;201611;1385;4189;1201;3835;100;371;853;2686;953;3057
250440;201611;4540;12896;4064;12187;122;425;3497;10362;3619;10787
250450;201611;1982;5564;1716;5186;58;214;1448;4298;1506;4512
250460;201611;6611;19648;6102;18918;488;1575;4926;15441;5414;17016
250470;201611;1610;4298;1316;3861;119;411;916;2571;1035;2982
250480;201611;3799;11397;3430;10833;79;336;3008;9470;3087;9806
250485;201611;677;1693;538;1470;27;89;433;1143;460;1232
250490;201611;3883;11928;3726;11686;738;2195;2593;8255;3331;10450
250500;201611;1803;5401;1561;4962;142;436;1190;3807;1332;4243
250510;201611;5018;13944;4356;12932;152;469;3828;11353;3980;11822
250520;201611;1796;5368;1634;5094;232;784;1008;3069;1240;3853
250523;201611;1719;5149;1651;5050;138;492;1359;4098;1497;4590
250527;201611;1433;4270;1353;4166;23;118;1246;3767;1269;3885
250530;201611;632;1902;536;1774;32;119;464;1527;496;1646
250535;201611;1335;4161;1221;3921;41;199;981;3052;1022;3251
250540;201611;2439;6799;2231;6538;50;213;1937;5529;1987;5742
250550;201611;919;3018;825;2859;45;228;657;2205;702;2433
250560;201611;1681;5242;1569;5039;84;346;1303;4067;1387;4413
250570;201611;2666;8317;2290;7565;112;480;1787;5715;1899;6195
250580;201611;1141;3032;964;2745;64;229;782;2153;846;2382
250590;201611;867;2662;783;2529;56;217;648;2033;704;2250
250600;201611;7424;21508;6822;20541;720;2013;5202;15783;5922;17796
250610;201611;3183;9142;2890;8657;233;713;2215;6589;2448;7302
250620;201611;708;2058;610;1854;78;256;392;1157;470;1413
250625;201611;2454;7838;2372;7714;50;126;2261;7402;2311;7528
250630;201611;9609;29592;8535;27288;1866;6004;4427;14016;6293;20020
250640;201611;3471;10604;3245;10276;186;775;2707;8346;2893;9121
250650;201611;869;2382;732;2169;38;142;540;1492;578;1634
250660;201611;1840;4843;1660;4590;32;92;1555;4312;1587;4404
250670;201611;2430;8091;2289;7831;114;534;1909;6379;2023;6913
250680;201611;4965;13848;4654;13441;194;632;4155;11959;4349;12591
250690;201611;6141;15876;5812;15468;388;988;5177;13789;5565;14777
250700;201611;4762;14075;4285;13302;739;2327;2722;8371;3461;10698
250710;201611;4497;13807;3927;12937;475;1597;2724;9061;3199;10658
250720;201611;2714;7824;2488;7453;71;304;2217;6551;2288;6855
250730;201611;3535;10632;3227;10162;236;817;2495;7676;2731;8493
250740;201611;1944;5570;1636;5074;160;577;1228;3662;1388;4239
250750;201611;102082;285513;90438;266633;12290;38466;59448;171117;71738;209583
250760;201611;2303;6434;1993;5941;153;538;1592;4654;1745;5192
250770;201611;3958;13005;3652;12530;438;1715;2592;8744;3030;10459
250780;201611;1853;5363;1537;4745;171;618;1002;2977;1173;3595
250790;201611;2415;7791;2231;7451;507;1628;1263;4373;1770;6001
250800;201611;2729;7554;2330;6868;97;268;1930;5604;2027;5872
250810;201611;1310;3786;1102;3438;58;236;874;2668;932;2904
250820;201611;1876;5831;1786;5715;97;403;1575;4972;1672;5375
250830;201611;5660;18115;5102;16918;485;1802;3558;11552;4043;13354
250840;201611;916;2969;746;2589;52;210;501;1736;553;1946
250850;201611;2029;6164;1796;5763;79;366;1439;4498;1518;4864
250855;201611;1099;3207;937;2928;48;204;718;2157;766;2361
250860;201611;3231;10378;2673;9292;635;2308;1004;3486;1639;5794
250870;201611;1062;3076;898;2728;24;83;727;2159;751;2242
250880;201611;1516;4078;1253;3700;125;386;959;2832;1084;3218
250890;201611;9512;28151;8803;27053;1151;4003;6169;18386;7320;22389
250900;201611;2847;9122;2429;8249;208;675;1813;6160;2021;6835
250905;201611;2064;6474;1950;6305;222;788;1515;4853;1737;5641
250910;201611;5017;14406;4612;13756;225;771;3847;11313;4072;12084
250915;201611;1462;4425;1425;4371;96;208;1248;3957;1344;4165
250920;201611;3315;9326;3045;8875;311;806;2223;6486;2534;7292
250930;201611;2059;6223;1909;5963;147;576;1431;4344;1578;4920
250933;201611;1144;3731;1034;3483;80;297;699;2310;779;2607
250937;201611;687;2111;599;1932;44;167;443;1389;487;1556
250939;201611;1573;4730;1427;4456;162;528;994;3063;1156;3591
250940;201611;3847;11296;3508;10701;109;411;3049;9253;3158;9664
250950;201611;1299;3915;1111;3638;44;180;907;2946;951;3126
250960;201611;1096;3507;1026;3390;63;235;825;2687;888;2922
250970;201611;8582;23568;7263;21351;626;1892;5376;15549;6002;17441
250980;201611;2610;7576;2279;6929;84;344;1777;5165;1861;5509
250990;201611;1989;6669;1736;6084;234;951;1109;3730;1343;4681
251000;201611;2153;6298;1841;5757;47;216;1550;4758;1597;4974
251010;201611;2804;8180;2469;7617;95;326;2103;6460;2198;6786
251020;201611;1687;4726;1527;4513;75;221;1377;4069;1452;4290
251030;201611;1088;3052;955;2796;61;201;674;1905;735;2106
251040;201611;1813;5648;1586;5236;77;361;1220;3861;1297;4222
251050;201611;1097;3164;868;2695;127;393;520;1583;647;1976
251060;201611;1050;2377;760;1990;34;110;606;1552;640;1662
251065;201611;474;1419;405;1303;26;91;273;823;299;914
251070;201611;650;1811;573;1696;32;113;462;1314;494;1427
251080;201611;19567;54340;16911;49812;4777;14538;7153;21526;11930;36064
251090;201611;3010;9181;2573;8311;185;689;1898;5973;2083;6662
251100;201611;997;3114;870;2871;81;307;571;1805;652;2112
251110;201611;1940;5622;1650;5043;131;367;1144;3473;1275;3840
251120;201611;6239;20830;5831;20043;584;2342;4380;14746;4964;17088
251130;201611;4002;10150;3639;9744;73;181;3497;9431;3570;9612
251140;201611;4273;12873;3953;12336;112;481;3323;10271;3435;10752
251150;201611;2680;8355;2426;7947;188;783;1808;5756;1996;6539
251160;201611;1884;6022;1819;5937;53;213;1682;5477;1735;5690
251170;201611;1437;4332;1352;4220;76;307;1159;3541;1235;3848
251180;201611;2572;7701;2275;7194;355;1119;1407;4428;1762;5547
251190;201611;4480;12245;4202;11854;133;394;3830;10681;3963;11075
251200;201611;3842;12413;3621;12118;81;348;3319;11063;3400;11411
251203;201611;1040;3437;973;3294;42;186;739;2437;781;2623
251207;201611;1130;3437;908;2988;45;212;634;1994;679;2206
251210;201611;8039;22469;6726;20674;669;2023;5135;16063;5804;18086
251220;201611;1197;3134;955;2768;85;241;728;2121;813;2362
251230;201611;4657;13652;4224;13098;227;828;3727;11421;3954;12249
251240;201611;3350;10022;3012;9518;369;1206;2256;7040;2625;8246
251250;201611;10557;30771;9565;29168;746;2627;7300;21674;8046;24301
251260;201611;491;1550;444;1477;24;102;329;1071;353;1173
251270;201611;4283;13740;3853;13144;123;591;3364;11371;3487;11962
251272;201611;1391;3960;1313;3846;88;284;1146;3327;1234;3611
251274;201611;914;2807;800;2598;77;308;530;1656;607;1964
251275;201611;1269;3648;1162;3463;59;260;905;2558;964;2818
251276;201611;1232;3739;1143;3574;67;274;871;2643;938;2917
251278;201611;604;1871;513;1682;55;204;342;1114;397;1318
251280;201611;2354;6974;2131;6564;101;402;1692;5008;1793;5410
251290;201611;5726;15485;5269;14863;578;1966;4039;10978;4617;12944
251300;201611;789;2603;724;2494;34;148;578;1958;612;2106
251310;201611;2998;8890;2703;8443;121;528;2159;6520;2280;7048
251315;201611;1646;5576;1549;5398;142;502;1128;3925;1270;4427
251320;201611;1914;5232;1385;4304;54;190;999;3075;1053;3265
251330;201611;1811;4777;1495;4332;70;310;1295;3628;1365;3938
251335;201611;1042;3443;938;3257;73;327;678;2285;751;2612
251340;201611;3473;9841;3007;9097;187;710;2305;6757;2492;7467
251350;201611;1291;4062;1182;3853;94;336;885;2808;979;3144
251360;201611;1840;5713;1552;5286;50;198;1346;4606;1396;4804
251365;201611;805;2360;606;1919;17;68;443;1372;460;1440
251370;201611;23036;70623;21906;68826;2121;7412;16935;51979;19056;59391
251380;201611;1365;4200;1158;3835;29;160;982;3125;1011;3285
251385;201611;797;2115;647;1863;62;177;437;1212;499;1389
251390;201611;5893;19847;5078;18132;1574;5673;2004;7230;3578;12903
251392;201611;1064;3141;897;2833;55;195;652;2010;707;2205
251394;201611;620;1933;498;1697;48;173;339;1133;387;1306
251396;201611;839;2354;700;2115;85;249;449;1337;534;1586
251398;201611;992;2828;833;2518;34;133;571;1662;605;1795
251400;201611;1180;3293;979;2979;74;269;718;2100;792;2369
251410;201611;1524;3928;1267;3501;41;164;1072;2852;1113;3016
251420;201611;2015;5692;1721;5311;182;598;1229;3731;1411;4329
251430;201611;1651;5577;1476;5279;65;333;1240;4319;1305;4652
251440;201611;1255;3693;998;3179;46;187;759;2386;805;2573
251445;201611;1528;4655;1424;4495;108;432;1113;3378;1221;3810
251450;201611;4655;14650;4239;14012;105;487;3566;11667;3671;12154
251455;201611;1094;3478;947;3169;69;258;663;2208;732;2466
251460;201611;817;2537;743;2404;68;218;589;1910;657;2128
251465;201611;455;1434;381;1268;16;86;287;915;303;1001
251470;201611;1193;3461;948;2956;84;299;595;1793;679;2092
251480;201611;951;2667;818;2436;34;157;626;1763;660;1920
251490;201611;1801;5331;1565;4930;144;534;1085;3323;1229;3857
251500;201611;1731;5489;1621;5279;99;411;1320;4174;1419;4585
251510;201611;2620;8499;2318;7876;400;1424;1333;4494;1733;5918
251520;201611;959;2610;816;2346;111;308;521;1471;632;1779
251530;201611;12231;33710;11331;32351;265;1127;9950;27744;10215;28871
251540;201611;2929;9245;2640;8672;167;671;2084;6724;2251;7395
251550;201611;3554;9218;2909;8272;86;293;2461;6916;2547;7209
251560;201611;713;2217;645;2086;88;319;387;1186;475;1505
251570;201611;1019;2993;775;2479;41;168;554;1705;595;1873
251580;201611;1931;5382;1742;5107;346;847;1131;3468;1477;4315
251590;201611;1498;4610;1410;4473;50;178;1165;3669;1215;3847
251593;201611;1010;3105;916;2958;143;475;547;1712;690;2187
251597;201611;1950;5912;1868;5800;46;185;1662;5100;1708;5285
251600;201611;6601;19218;6048;18313;361;1089;4868;14651;5229;15740
251610;201611;3357;9932;2935;9149;285;855;2167;6809;2452;7664
251615;201611;1161;3292;888;2793;84;249;603;1866;687;2115
251620;201611;15770;41975;13570;39274;597;1686;11418;33997;12015;35683
251630;201611;4711;12022;3852;10722;314;909;2901;7867;3215;8776
251640;201611;2583;7460;2128;6638;101;413;1655;5063;1756;5476
251650;201611;4020;11476;3598;10874;216;662;3062;9211;3278;9873
251660;201611;3578;11367;3206;10670;111;534;2665;8595;2776;9129
251670;201611;4546;13339;3914;12519;45;151;3623;11743;3668;11894
251675;201611;742;2297;672;2192;122;437;406;1272;528;1709
251680;201611;2789;7914;2223;7001;90;356;1727;5356;1817;5712
251690;201611;3316;9896;2908;9040;140;476;2194;6617;2334;7093
251700;201611;1960;6296;1809;6072;91;447;1485;4835;1576;5282
251710;201611;905;2355;552;1607;103;336;255;669;358;1005
251720;201611;1435;4360;1184;3878;52;256;904;2825;956;3081
251740;201611;784;2193;588;1840;53;176;372;1153;425;1329
260005;201611;26572;63697;21611;56248;4645;11595;11727;30752;16372;42347
260010;201611;10245;27356;8125;24314;1143;3448;4883;14963;6026;18411
260020;201611;6223;16915;5119;15200;207;751;4202;12449;4409;13200
260030;201611;6279;17803;5400;16324;368;1200;4263;12787;4631;13987
260040;201611;10006;24165;8016;21705;747;1890;6115;17098;6862;18988
260050;201611;11552;35082;10595;33826;523;1880;9172;29454;9695;31334
260060;201611;3948;10961;3402;9965;340;960;2447;7285;2787;8245
260070;201611;9979;28441;8923;26652;1158;3759;6036;17623;7194;21382
260080;201611;6019;15569;5221;14390;683;1702;3733;10319;4416;12021
260090;201611;5265;14294;4801;13592;631;1726;3505;9985;4136;11711
260100;201611;3441;9342;2885;8523;144;574;2424;7076;2568;7650
260105;201611;5073;13974;4737;13398;171;649;4124;11374;4295;12023
260110;201611;21465;59485;19483;56991;809;2478;17288;50559;18097;53037
260120;201611;12551;37274;10822;34120;2444;7807;5674;18267;8118;26074
260130;201611;3304;9117;3023;8646;388;1131;2173;6171;2561;7302
260140;201611;13287;32590;11179;29911;802;2341;8853;23664;9655;26005
260150;201611;3280;8944;2887;8406;210;723;2281;6570;2491;7293
260160;201611;5626;17378;4764;16160;259;1129;3919;13228;4178;14357
260170;201611;16842;46729;15782;45100;974;3097;13191;37216;14165;40313
260180;201611;3341;9979;2986;9453;179;576;2514;7975;2693;8551
260190;201611;16574;38057;14726;35573;437;1125;12892;30700;13329;31825
260200;201611;11479;29080;10400;27587;459;1409;9042;23883;9501;25292
260210;201611;12014;35522;10429;32981;570;1995;8502;26917;9072;28912
260220;201611;9636;27368;9189;26727;415;1544;8112;23160;8527;24704
260230;201611;9874;27661;8898;26191;448;1519;7246;21216;7694;22735
260240;201611;3011;8801;2562;8119;295;1014;1844;5839;2139;6853
260250;201611;2348;6345;2029;5872;123;364;1662;4754;1785;5118
260260;201611;12522;35021;11188;32961;1245;3910;8330;24642;9575;28552
260270;201611;3713;10634;3338;10020;241;987;2534;7248;2775;8235
260280;201611;13128;41780;11737;39565;688;2383;9796;33197;10484;35580
260290;201611;33067;97652;30442;92673;5464;17062;18563;55790;24027;72852
260300;201611;8819;26631;7492;24448;380;1575;5957;19351;6337;20926
260310;201611;4731;13709;4202;12851;1078;2988;2361;7668;3439;10656
260320;201611;7378;23219;6621;21846;373;1417;5386;17660;5759;19077
260330;201611;2686;8507;2427;7985;106;425;1905;6119;2011;6544
260340;201611;1905;5490;1732;5213;43;136;1562;4681;1605;4817
260345;201611;23312;71586;20906;66594;5874;20038;7581;22871;13455;42909
260350;201611;4946;13178;4497;12505;177;601;3890;10659;4067;11260
260360;201611;2419;6856;2070;6229;137;506;1500;4402;1637;4908
260370;201611;5773;17726;4942;16135;384;1506;3552;11446;3936;12952
260380;201611;4916;15959;4373;15042;250;1016;3296;11234;3546;12250
260390;201611;4353;13705;3648;12212;290;1037;2599;8546;2889;9583
260392;201611;3520;11133;3149;10622;209;958;2608;8539;2817;9497
260400;201611;14118;39309;13031;37410;1567;4893;9086;25448;10653;30341
260410;201611;62676;176724;52278;158953;14690;46647;19459;60048;34149;106695
260415;201611;3897;12010;3198;10532;227;966;2141;6718;2368;7684
260420;201611;12445;27962;10832;26120;224;716;9899;23565;10123;24281
260430;201611;2935;9372;2472;8423;239;851;1649;5594;1888;6445
260440;201611;3378;10042;2887;9024;357;1209;1862;5647;2219;6856
260450;201611;5086;14678;4823;14286;194;614;4279;12713;4473;13327
260460;201611;5688;17898;5019;16492;903;3157;2748;8794;3651;11951
260470;201611;4612;13618;4079;12901;178;528;3571;11521;3749;12049
260480;201611;4195;11801;3532;10762;535;1714;2312;7089;2847;8803
260490;201611;5115;13282;4353;11960;239;713;3528;9469;3767;10182
260500;201611;6003;17019;5175;15586;807;2413;3319;10029;4126;12442
260510;201611;8986;23622;8186;22505;348;1102;7217;19649;7565;20751
260515;201611;4837;14376;3545;11657;264;921;2249;7358;2513;8279
260520;201611;16588;42380;15482;40722;1631;4236;12047;31446;13678;35682
260530;201611;9927;29813;8607;27712;377;1456;7272;23326;7649;24782
260540;201611;6249;15225;5607;14486;879;1582;4251;11800;5130;13382
260545;201611;71;254;40;159;8;33;11;38;19;71
260550;201611;2809;8991;2237;7684;406;1482;993;3372;1399;4854
260560;201611;6317;16604;5530;15414;151;597;4877;13322;5028;13919
260570;201611;7015;22511;6282;21263;553;2112;4650;15607;5203;17719
260580;201611;3780;10398;3422;9761;116;388;2936;8208;3052;8596
260590;201611;6276;15548;5815;14979;316;795;5051;13040;5367;13835
260600;201611;28815;82820;24929;75979;1992;6953;18272;54864;20264;61817
260610;201611;6663;19779;6196;18948;689;2227;4429;13298;5118;15525
260620;201611;15936;47705;14882;45725;2345;7940;9369;27907;11714;35847
260630;201611;2278;6626;1971;6120;102;418;1609;4867;1711;5285
260640;201611;17504;47582;16083;45466;2292;6759;10798;30361;13090;37120
260650;201611;5492;17004;4761;15694;285;1080;3798;12527;4083;13607
260660;201611;7887;21577;6887;20190;421;1231;5736;16738;6157;17969
260670;201611;2424;6401;1930;5666;128;395;1387;4059;1515;4454
260680;201611;22092;61906;19294;56515;3693;10866;9806;28476;13499;39342
260690;201611;3698;9905;2926;8563;207;582;2271;6586;2478;7168
260700;201611;5881;17362;5704;17165;34;55;5597;17006;5631;17061
260710;201611;1370;3970;1271;3833;93;307;932;2863;1025;3170
260720;201611;18412;57381;16759;54039;3472;11431;9059;28997;12531;40428
260730;201611;6867;22500;6298;21493;805;2876;4555;15399;5360;18275
260740;201611;1329;3902;1137;3538;91;318;852;2639;943;2957
260750;201611;6990;20765;6054;19505;288;906;5321;17377;5609;18283
260760;201611;4826;12863;4422;12278;211;685;3771;10425;3982;11110
260765;201611;7893;26321;7361;25363;1005;4303;4920;16214;5925;20517
260770;201611;3894;10318;3410;9490;128;405;2767;7575;2895;7980
260775;201611;5058;14786;4636;14038;437;1585;3300;9651;3737;11236
260780;201611;3697;11798;3353;11080;695;2442;1684;5340;2379;7782
260790;201611;113887;285056;101842;265291;21363;55811;57249;147474;78612;203285
260795;201611;3122;9114;2694;8417;232;762;1932;6046;2164;6808
260800;201611;5003;13228;4599;12645;147;553;4104;10946;4251;11499
260805;201611;3878;11365;3176;10117;361;1297;2181;6784;2542;8081
260810;201611;6973;19091;6603;18571;381;1104;5628;15731;6009;16835
260820;201611;4164;11614;3515;10499;766;2281;1836;5420;2602;7701
260825;201611;2940;9287;2562;8629;170;651;1931;6483;2101;7134
260830;201611;3762;11956;3291;10990;515;1660;2090;7101;2605;8761
260840;201611;4300;12150;3738;11281;239;816;3043;9060;3282;9876
260845;201611;4262;12235;3959;11658;452;1351;2897;8573;3349;9924
260850;201611;5006;16226;4270;14513;806;2928;1972;6570;2778;9498
260860;201611;3618;10909;3037;9712;158;554;2343;7373;2501;7927
260870;201611;4352;11486;3684;10540;312;888;2928;8322;3240;9210
260875;201611;6579;18170;5644;16545;843;2402;3685;10854;4528;13256
260880;201611;9930;29559;8801;27587;581;1882;7015;22073;7596;23955
260890;201611;13383;37922;12115;35730;733;2396;9397;27365;10130;29761
260900;201611;5936;18037;4916;15959;391;1550;3160;9987;3551;11537
260910;201611;3118;9204;2676;8424;163;571;2045;6346;2208;6917
260915;201611;4628;15288;4299;14802;88;444;3943;13482;4031;13926
260920;201611;3248;9832;2940;9375;155;568;2382;7670;2537;8238
260930;201611;3941;12647;3364;11590;348;1229;2371;8140;2719;9369
260940;201611;14218;37331;12485;34247;1535;4609;8426;22393;9961;27002
260950;201611;6447;19652;5488;17577;817;2934;2833;8512;3650;11446
260960;201611;57400;156983;50501;144908;10239;30307;26097;73635;36336;103942
260970;201611;5080;15009;4530;14237;282;1015;3560;11163;3842;12178
260980;201611;4058;13002;3746;12566;121;498;3332;11124;3453;11622
260990;201611;17761;53500;15778;50541;1064;3815;12552;40070;13616;43885
261000;201611;16226;43532;12728;37837;2242;6931;6744;20459;8986;27390
261010;201611;2569;6998;2327;6701;132;291;2053;6054;2185;6345
261020;201611;6373;18272;5454;16577;552;1680;4026;12004;4578;13684
261030;201611;3720;11469;3226;10585;186;726;2574;8281;2760;9007
261040;201611;5178;16478;4282;14544;361;1386;3018;10029;3379;11415
261050;201611;7964;23016;7251;21631;934;2771;4809;14325;5743;17096
261060;201611;12480;36018;11280;33796;949;3230;8371;24435;9320;27665
261070;201611;54604;131351;46459;118867;6081;15587;31396;79622;37477;95209
261080;201611;5827;16523;5419;15885;341;890;4622;13771;4963;14661
261090;201611;16778;45332;15033;42727;1204;3323;11980;34190;13184;37513
261100;201611;8324;25734;7145;23531;1300;4367;4128;13732;5428;18099
261110;201611;62896;183966;53532;168475;13710;45358;23556;74782;37266;120140
261120;201611;3848;10041;3268;9277;73;257;2948;8346;3021;8603
261130;201611;7201;18208;6528;17372;158;490;5931;15660;6089;16150
261140;201611;3297;9058;2896;8396;383;1242;1835;5169;2218;6411
261150;201611;5462;15384;4943;14544;303;1099;4125;11991;4428;13090
261153;201611;2185;6286;1753;5594;80;320;1283;4048;1363;4368
261160;201611;201912;524875;179273;488022;47766;132572;77492;212351;125258;344923
261170;201611;5818;15697;5201;14740;397;1162;4094;11588;4491;12750
261180;201611;9762;26815;8767;25215;1026;3145;5963;16833;6989;19978
261190;201611;5256;15989;4805;15375;459;1871;3456;10670;3915;12541
261200;201611;3641;9028;3234;8518;359;934;2543;6743;2902;7677
261210;201611;1916;5057;1748;4827;143;387;1494;4134;1637;4521
261220;201611;13514;41346;10868;35571;1583;5573;6047;19434;7630;25007
261230;201611;4675;14388;4180;13683;132;542;3599;11814;3731;12356
261240;201611;5038;14467;4527;13558;581;1592;3181;9662;3762;11254
261245;201611;3619;10953;3006;9800;149;656;2341;7374;2490;8030
261247;201611;3307;9992;2698;8809;271;954;1865;6153;2136;7107
261250;201611;19687;51790;18013;49343;3439;9052;11786;33182;15225;42234
261255;201611;4089;12539;3513;11451;218;943;2784;8755;3002;9698
261260;201611;12619;34802;10969;32585;529;1698;9333;27728;9862;29426
261270;201611;3725;10958;3260;10134;303;1058;2318;7001;2621;8059
261280;201611;2625;7833;2330;7328;117;441;1909;5869;2026;6310
261290;201611;2987;8428;2623;7894;153;562;2097;6259;2250;6821
261300;201611;10743;34028;8988;30607;1188;4540;5649;18711;6837;23251
261310;201611;7378;22496;6761;21294;1702;5427;3504;11008;5206;16435
261320;201611;5917;18024;5296;16837;209;770;4263;13347;4472;14117
261330;201611;5806;16032;5397;15457;344;1174;4527;12682;4871;13856
261340;201611;4009;13183;3696;12615;356;1483;2545;8530;2901;10013
261350;201611;8186;26503;7502;25243;238;1232;6153;20033;6391;21265
261360;201611;8281;21561;7121;19801;626;1788;5551;15102;6177;16890
261370;201611;20059;58455;18143;55132;3802;11854;9898;30014;13700;41868
261380;201611;4212;14132;3802;13211;567;2166;2376;8148;2943;10314
261390;201611;16638;49954;14460;45983;2056;6814;8763;27845;10819;34659
261400;201611;4741;16078;4090;14644;285;1223;2932;10344;3217;11567
261410;201611;8987;24488;7881;22705;678;2053;6140;17576;6818;19629
261420;201611;7596;25136;7149;24470;1537;5900;4223;14115;5760;20015
261430;201611;3507;10643;2965;9775;237;763;2285;7647;2522;8410
261440;201611;1597;4955;1391;4589;46;239;1090;3486;1136;3725
261450;201611;14435;40568;13651;39466;315;1193;12344;35331;12659;36524
261460;201611;7324;21148;6758;20359;419;1203;5784;17611;6203;18814
261470;201611;4144;11164;3671;10495;82;263;3187;9147;3269;9410
261480;201611;3807;13352;3395;12554;265;1067;2508;9073;2773;10140
261485;201611;5075;15406;4409;14162;618;2217;2717;8524;3335;10741
261500;201611;5694;15767;4939;14664;559;1542;3528;10769;4087;12311
261510;201611;1896;6027;1670;5624;115;419;1239;4172;1354;4591
261520;201611;2707;8675;2419;8109;132;520;1667;5755;1799;6275
261530;201611;11546;36798;9905;33314;2161;7811;4125;13677;6286;21488
261540;201611;7095;22779;6493;21624;1709;5593;3429;11749;5138;17342
261550;201611;3526;9788;3213;9285;280;923;2439;6877;2719;7800
261560;201611;7193;23386;6399;22220;779;3038;4637;16064;5416;19102
261570;201611;3466;10271;2892;9238;414;1358;1804;5702;2218;7060
261580;201611;6156;18352;5440;17154;303;1261;4582;14210;4885;15471
261590;201611;2489;6943;2075;6254;173;519;1530;4627;1703;5146
261600;201611;5313;14269;4425;12921;303;912;3427;10012;3730;10924
261610;201611;2434;6803;2081;6292;135;498;1667;4982;1802;5480
261618;201611;2550;7003;2254;6582;164;498;1717;4901;1881;5399
261620;201611;4160;12781;3811;12165;796;2496;2321;7585;3117;10081
261630;201611;7734;22384;6216;19359;742;2607;3666;11052;4408;13659
261640;201611;34285;84485;31906;81513;2094;4685;26061;69391;28155;74076
261650;201611;3815;11207;3421;10604;261;958;2603;8060;2864;9018
270010;201611;4574;16681;4062;15626;311;1473;2929;11141;3240;12614
270020;201611;3970;11057;3622;10520;327;1050;2866;8127;3193;9177
270030;201611;36253;108169;32864;102087;7428;23106;18106;56440;25534;79546
270040;201611;10715;32149;9699;30720;1629;5254;6314;20226;7943;25480
270050;201611;4544;12295;4049;11666;347;1042;3305;9524;3652;10566
270060;201611;1923;5571;1749;5330;285;882;1170;3624;1455;4506
270070;201611;4454;13431;3994;12756;182;818;3411;10593;3593;11411
270080;201611;1300;4039;1083;3578;144;501;699;2244;843;2745
270090;201611;2097;6432;1874;5968;71;341;1527;4637;1598;4978
270100;201611;5806;17495;5358;16698;602;2162;3928;11952;4530;14114
270110;201611;3265;8833;2827;8315;362;1060;1910;5972;2272;7032
270120;201611;3183;8791;2722;8166;105;402;2399;7127;2504;7529
270130;201611;5211;15559;4727;14972;613;2034;3521;11329;4134;13363
270135;201611;1805;4777;1599;4499;186;391;1329;3898;1515;4289
270140;201611;10648;25002;8750;22430;998;3189;6708;16185;7706;19374
270150;201611;2726;8702;2626;8576;49;162;2524;8273;2573;8435
270160;201611;5115;16652;4594;15934;169;763;3965;13594;4134;14357
270170;201611;3834;12124;3434;11515;537;2066;2106;6865;2643;8931
270180;201611;2310;7462;2084;7118;80;418;1736;5768;1816;6186
270190;201611;1818;5898;1704;5729;92;356;1437;4846;1529;5202
270200;201611;2622;8610;2410;8295;204;878;1796;6008;2000;6886
270210;201611;4738;13911;4393;13406;255;1022;3720;11120;3975;12142
270220;201611;1350;4372;1205;4090;240;892;666;2184;906;3076
270230;201611;11104;34252;9331;31155;1105;4423;5751;18420;6856;22843
270235;201611;6524;20666;5984;19763;349;1464;4881;15925;5230;17389
270240;201611;9674;28850;7846;26325;1931;6663;3707;12700;5638;19363
270250;201611;3264;8467;2917;8014;459;1211;2172;6009;2631;7220
270255;201611;4992;14888;3785;12627;230;940;2727;8842;2957;9782
270260;201611;5948;18861;5693;18472;383;1629;4776;15104;5159;16733
270270;201611;1190;3352;1062;3147;228;684;605;1763;833;2447
270280;201611;3551;9908;2999;9034;343;864;2149;6548;2492;7412
270290;201611;8247;28120;7543;26836;526;2426;5872;20418;6398;22844
270300;201611;3686;11559;3241;10957;328;1194;2426;8142;2754;9336
270310;201611;7704;22772;6575;20989;247;1256;5486;16953;5733;18209
270320;201611;5966;18420;5552;17685;883;3020;3706;11620;4589;14640
270330;201611;4320;14535;3988;14061;405;1522;3082;10928;3487;12450
270340;201611;1757;5250;1517;4915;186;598;1112;3572;1298;4170
270350;201611;1952;5132;1728;4849;164;476;1262;3564;1426;4040
270360;201611;2035;6191;1935;6074;154;442;1657;5307;1811;5749
270370;201611;1536;4991;1363;4673;103;424;989;3349;1092;3773
270375;201611;2953;8023;2595;7532;85;293;2319;6692;2404;6985
270380;201611;5891;17703;5339;16874;747;2125;3929;12828;4676;14953
270390;201611;1273;3463;1085;3157;54;192;851;2384;905;2576
270400;201611;6462;19033;5618;17698;345;1292;4168;12738;4513;14030
270410;201611;4888;15137;4352;14078;412;1437;3081;9784;3493;11221
270420;201611;5976;18719;5626;18193;242;1087;4603;14494;4845;15581
270430;201611;140868;399881;120112;366331;34554;109978;42406;131984;76960;241962
270440;201611;4742;14003;4215;13198;164;663;3507;10874;3671;11537
270450;201611;6379;19371;6012;18858;341;1322;4926;15170;5267;16492
270460;201611;3484;9064;3067;8509;110;376;2694;7319;2804;7695
270470;201611;10439;32738;9352;30881;1045;3870;6333;20788;7378;24658
270480;201611;2864;8739;2482;8024;297;1099;1673;5191;1970;6290
270490;201611;989;3091;886;2924;45;181;697;2272;742;2453
270500;201611;4894;16376;4549;15910;290;1232;3758;13041;4048;14273
270510;201611;6115;17758;5360;16633;601;2359;4026;11927;4627;14286
270520;201611;3517;11091;3131;10390;1013;3656;960;3276;1973;6932
270530;201611;1401;4285;1267;4061;118;390;878;2859;996;3249
270540;201611;2100;6805;1873;6447;102;530;1545;5125;1647;5655
270550;201611;7274;20825;6200;19378;776;2518;4316;13744;5092;16262
270560;201611;3134;9252;2861;8817;264;930;2138;6448;2402;7378
270570;201611;3771;12044;3381;11338;617;1883;2285;7804;2902;9687
270580;201611;2080;6255;1938;6060;133;414;1598;5064;1731;5478
270590;201611;1396;4534;1323;4417;9;41;1286;4298;1295;4339
270600;201611;2881;9390;2580;8852;142;674;2083;6966;2225;7640
270610;201611;3296;10018;2992;9544;158;571;2516;7916;2674;8487
270620;201611;1430;4703;1322;4516;95;373;1040;3452;1135;3825
270630;201611;16589;47839;14852;44938;1993;5992;10251;31482;12244;37474
270640;201611;5787;17502;5081;16348;316;1294;4048;12681;4364;13975
270642;201611;2320;8135;2134;7853;212;1012;1603;5720;1815;6732
270644;201611;2771;8009;2368;7429;268;820;1765;5620;2033;6440
270650;201611;3740;11484;3493;11117;413;1881;2510;7433;2923;9314
270660;201611;2149;5501;1587;4639;141;375;1154;3365;1295;3740
270670;201611;17038;42862;14319;39585;1859;4977;10432;29452;12291;34429
270680;201611;4389;12582;4136;12275;117;328;3857;11507;3974;11835
270690;201611;9266;25381;8064;23914;2657;7363;4053;12949;6710;20312
270700;201611;642;1989;556;1837;80;332;361;1122;441;1454
270710;201611;6012;18928;5600;18341;407;1669;4597;14711;5004;16380
270720;201611;3436;11380;3070;10711;127;725;2551;8652;2678;9377
270730;201611;6497;18414;6050;17910;577;1728;4983;14944;5560;16672
270740;201611;2343;6619;2182;6375;196;640;1737;5007;1933;5647
270750;201611;5258;15851;4762;15017;648;2156;3373;10598;4021;12754
270760;201611;3444;10171;3041;9481;124;491;2473;7599;2597;8090
270770;201611;19364;49997;15527;45154;3242;9238;8786;26815;12028;36053
270780;201611;1850;5856;1724;5631;187;704;1275;4100;1462;4804
270790;201611;1620;5062;1464;4812;322;1140;801;2590;1123;3730
270800;201611;11613;33487;10548;31966;631;2370;8879;26368;9510;28738
270810;201611;3364;10083;2543;8528;299;1057;1565;5312;1864;6369
270820;201611;1826;5818;1591;5404;260;945;980;3313;1240;4258
270830;201611;5864;15312;5131;14384;400;1055;4121;11957;4521;13012
270840;201611;8007;25229;7269;24190;325;1662;6252;20151;6577;21813
270850;201611;7542;22869;7107;22248;854;3351;5150;15166;6004;18517
270860;201611;11100;30840;9193;28285;1165;4014;6122;18370;7287;22384
270870;201611;2170;6518;1782;5705;221;773;1182;3709;1403;4482
270880;201611;8304;26097;7566;24933;439;1774;6171;20023;6610;21797
270890;201611;2495;7536;2284;7126;230;881;1680;5063;1910;5944
270895;201611;2936;10552;2769;10272;130;666;2399;8766;2529;9432
270900;201611;1952;5191;1553;4606;110;330;1127;3271;1237;3601
270910;201611;3577;11551;3226;10889;257;1055;2442;8021;2699;9076
270915;201611;9650;31586;8422;29284;1261;4970;5001;16905;6262;21875
270920;201611;6198;19339;5889;18866;260;1287;5175;16062;5435;17349
270930;201611;17628;46113;14202;41716;3280;9220;7855;24116;11135;33336
270940;201611;5627;18378;5152;17751;467;2057;3662;12155;4129;14212
280010;201611;665;1919;561;1728;47;200;374;1063;421;1263
280020;201611;4946;13940;4081;12398;694;2253;2543;7504;3237;9757
280030;201611;77135;197993;62456;174818;18788;53822;22166;63539;40954;117361
280040;201611;3164;9492;2756;8846;227;807;2056;6500;2283;7307
280050;201611;3827;11959;3442;11267;1048;3586;1451;4786;2499;8372
280060;201611;5121;15723;4251;14130;879;3070;2073;7005;2952;10075
280067;201611;7371;20309;6123;18257;983;2894;3629;10911;4612;13805
280070;201611;2013;6429;1897;6245;216;736;1445;4764;1661;5500
280100;201611;3903;11825;3402;10922;494;1730;2221;7099;2715;8829
280110;201611;1437;4221;1285;3977;53;213;1090;3308;1143;3521
280120;201611;7906;24506;7116;23162;1091;3226;4869;16413;5960;19639
280130;201611;7750;21084;6925;19837;931;2848;4815;13739;5746;16587
280140;201611;5908;15335;5282;14404;393;1136;4259;11623;4652;12759
280150;201611;3558;10455;3231;9873;262;914;2426;7201;2688;8115
280160;201611;1385;3996;1160;3617;170;562;746;2271;916;2833
280170;201611;4909;14233;4332;13318;444;1317;3276;10212;3720;11529
280190;201611;1219;3168;1016;2844;80;258;794;2141;874;2399
280200;201611;1206;3526;1061;3288;106;395;771;2297;877;2692
280210;201611;14259;40832;12191;37614;2786;8924;6432;19881;9218;28805
280220;201611;1637;4914;1495;4676;70;277;1253;3854;1323;4131
280230;201611;3546;10359;3095;9601;368;1196;2031;6326;2399;7522
280240;201611;3523;9956;3135;9320;184;579;2526;7435;2710;8014
280250;201611;844;2191;653;1878;116;361;351;951;467;1312
280260;201611;2161;5586;1992;5370;62;189;1826;4929;1888;5118
280270;201611;2276;6986;1993;6519;113;424;1574;5042;1687;5466
280280;201611;4202;13474;3655;12483;874;2447;2049;7725;2923;10172
280290;201611;17930;53009;15700;49274;2696;8886;9277;29148;11973;38034
280300;201611;9838;29002;9052;27980;721;2436;7064;22591;7785;25027
280310;201611;1415;3894;1186;3480;51;208;882;2507;933;2715
280320;201611;8865;27470;7867;25689;1332;4638;4332;13920;5664;18558
280330;201611;4550;12814;4049;11945;443;1507;2963;8360;3406;9867
280340;201611;3916;10671;3628;10259;291;866;2937;8415;3228;9281
280350;201611;23015;62604;19730;57443;2924;8775;12766;37078;15690;45853
280360;201611;5961;18387;5320;17235;1007;3535;2919;9222;3926;12757
280370;201611;1930;5310;1601;4730;184;485;1114;3309;1298;3794
280380;201611;1054;3197;934;2997;92;341;642;1978;734;2319
280390;201611;3237;9332;2655;8210;543;1681;1564;4862;2107;6543
280400;201611;4244;11697;3722;10865;1123;3161;1750;5339;2873;8500
280410;201611;2246;7048;1836;6192;287;1038;1008;3257;1295;4295
280420;201611;4240;12072;3838;11430;201;621;3269;9710;3470;10331
280430;201611;2301;5809;2029;5410;106;363;1584;4086;1690;4449
280440;201611;4798;13731;4283;13008;347;1098;3415;10212;3762;11310
280445;201611;2557;6953;2286;6456;76;256;1843;5081;1919;5337
280450;201611;9377;24385;8537;23247;618;1387;7173;20098;7791;21485
280460;201611;7064;18108;6269;16906;783;2100;4555;12409;5338;14509
280470;201611;1861;5527;1620;5074;144;439;1193;3752;1337;4191
280480;201611;33460;94049;30462;89289;4852;15313;19796;56741;24648;72054
280490;201611;3944;11621;3396;10672;207;783;2531;7767;2738;8550
280500;201611;945;2478;831;2316;46;119;688;1903;734;2022
280510;201611;2722;7724;2283;7091;194;664;1660;5130;1854;5794
280520;201611;1845;4880;1645;4618;142;365;1361;3866;1503;4231
280530;201611;2520;6666;2271;6345;136;403;1898;5295;2034;5698
280540;201611;9578;25794;8682;24457;264;973;7615;20937;7879;21910
280550;201611;7150;18169;5778;15996;572;1529;4061;11213;4633;12742
280560;201611;7731;22435;7198;21610;356;1208;6032;17830;6388;19038
280570;201611;6609;17616;5532;16051;581;1762;3789;10859;4370;12621
280580;201611;5645;17046;4663;15259;802;2510;2768;9317;3570;11827
280590;201611;2639;7291;2239;6728;350;1167;1380;4070;1730;5237
280600;201611;3726;11227;3386;10664;290;1003;2534;7859;2824;8862
280610;201611;2521;6939;2244;6500;188;639;1625;4561;1813;5200
280620;201611;5399;15477;4608;14076;626;1740;3091;9849;3717;11589
280630;201611;3683;11831;3377;11335;303;1009;2656;9088;2959;10097
280640;201611;2241;6628;2114;6481;80;234;1964;6062;2044;6296
280650;201611;1136;3467;1006;3249;94;340;721;2298;815;2638
280660;201611;2798;7609;2618;7369;312;832;2124;6015;2436;6847
280670;201611;17120;43647;15321;41003;2076;5846;10592;27961;12668;33807
280680;201611;2891;7667;2447;6928;195;556;1894;5278;2089;5834
280690;201611;966;2715;831;2512;109;358;580;1721;689;2079
280700;201611;1076;3148;926;2884;74;231;652;2008;726;2239
280710;201611;12412;31624;11035;29893;677;1467;9492;26394;10169;27861
280720;201611;2402;6259;2151;5938;250;677;1490;4295;1740;4972
280730;201611;924;2741;841;2608;76;295;664;1995;740;2290
280740;201611;13626;35883;11147;31698;1546;4166;7215;20751;8761;24917
280750;201611;3545;10580;3162;9881;303;972;2258;7082;2561;8054
280760;201611;5825;17315;5137;16213;931;3084;2950;9508;3881;12592
290010;201611;3040;6767;2139;5338;40;155;1731;4098;1771;4253
290020;201611;4466;14511;4307;14275;400;1025;3554;12082;3954;13107
290030;201611;3262;9795;3019;9432;469;1445;2179;6843;2648;8288
290035;201611;4724;11823;3990;10798;212;680;3075;8553;3287;9233
290040;201611;4282;11101;3524;10193;217;754;2742;7853;2959;8607
290050;201611;2491;8007;2135;7338;154;623;1548;5240;1702;5863
290060;201611;1332;3373;1075;3033;131;447;812;2187;943;2634
290070;201611;34944;85140;28635;76421;5759;15092;14700;40942;20459;56034
290080;201611;6197;18118;5080;16488;726;2408;3447;11359;4173;13767
290090;201611;2195;4710;1685;4146;119;269;1456;3644;1575;3913
290100;201611;9720;27419;8280;25043;1178;3546;5077;15735;6255;19281
290110;201611;4974;14485;4598;13792;777;2391;2856;8399;3633;10790
290115;201611;4902;14514;4297;13702;250;742;3502;11451;3752;12193
290120;201611;6927;17763;5602;16136;251;843;4600;13076;4851;13919
290130;201611;4702;12071;3762;10820;154;550;3044;8490;3198;9040
290135;201611;4764;11598;3834;10072;342;979;2773;6978;3115;7957
290140;201611;4409;13120;3697;12151;221;852;3044;9997;3265;10849
290150;201611;2254;6622;2100;6341;251;807;1590;4706;1841;5513
290160;201611;3542;8794;3319;8490;361;748;2671;6945;3032;7693
290170;201611;2799;8870;2498;8411;143;626;2102;6949;2245;7575
290180;201611;2989;8589;2523;7836;160;577;1937;5939;2097;6516
290190;201611;3862;12624;3612;12211;201;838;2791;9293;2992;10131
290195;201611;2227;5930;1795;5221;62;269;1512;4284;1574;4553
290200;201611;4010;12190;3410;11197;237;813;2693;8809;2930;9622
290205;201611;3347;9436;2881;8636;215;804;2187;6360;2402;7164
290210;201611;15059;42028;13306;39598;2173;5771;9047;28562;11220;34333
290220;201611;2344;6825;2158;6512;119;490;1749;5114;1868;5604
290225;201611;3047;7275;2676;6841;125;345;2428;6180;2553;6525
290230;201611;2301;7296;2141;7079;120;478;1769;5818;1889;6296
290240;201611;3650;9815;3197;9070;230;702;2519;7011;2749;7713
290250;201611;4025;12312;3618;11722;137;388;3051;10324;3188;10712
290260;201611;5274;14550;4288;13014;378;1218;3247;9835;3625;11053
290265;201611;3507;10705;2982;9679;156;666;2306;7336;2462;8002
290270;201611;12281;43763;11494;42380;1313;5247;8355;30772;9668;36019
290280;201611;5475;17389;4875;16270;513;1761;3587;11934;4100;13695
290290;201611;10102;30877;8667;28370;1222;3970;5782;19149;7004;23119
290300;201611;4755;13156;3282;10313;220;693;2266;7254;2486;7947
290310;201611;1464;4324;1221;3905;184;623;717;2269;901;2892
290320;201611;29460;82057;24326;75010;5484;17824;12204;38390;17688;56214
290323;201611;3964;10593;3403;9887;154;434;2824;8174;2978;8608
290327;201611;4526;13480;3779;12037;513;1660;2436;7741;2949;9401
290330;201611;1878;4524;1713;4338;100;267;1519;3871;1619;4138
290340;201611;5183;15462;4687;14813;1306;4178;2632;8389;3938;12567
290350;201611;4515;13635;3777;12425;340;1109;2684;8985;3024;10094
290360;201611;4662;13775;3943;12738;148;562;3287;10675;3435;11237
290370;201611;4902;13165;4076;11997;327;919;3285;9764;3612;10683
290380;201611;5679;16187;4849;14884;278;909;3828;11918;4106;12827
290390;201611;15225;45316;13264;42235;2009;6451;8356;27248;10365;33699
290395;201611;2648;8527;2325;7899;113;520;1775;6004;1888;6524
290400;201611;3710;10648;2999;9457;236;754;2170;6737;2406;7491
290405;201611;4805;14821;3879;13001;509;1654;2394;8195;2903;9849
290410;201611;6094;17622;4778;15412;361;1413;3426;10662;3787;12075
290420;201611;3335;9495;2694;8494;223;722;2066;6509;2289;7231
290430;201611;3206;9792;2739;8896;478;1581;1659;5443;2137;7024
290440;201611;3068;7925;2362;6878;132;432;1830;5352;1962;5784
290450;201611;3382;9622;2757;8611;220;805;1995;6114;2215;6919
290460;201611;13069;37447;11269;34080;3499;10661;3841;11572;7340;22233
290470;201611;4469;12145;3270;10274;680;2320;1536;4935;2216;7255
290475;201611;5760;18023;4906;16319;210;984;3889;12540;4099;13524
290480;201611;2548;6755;2352;6489;232;648;1690;4943;1922;5591
290485;201611;4871;15216;4172;14133;238;1161;3370;11188;3608;12349
290490;201611;8409;21599;7811;20764;582;1691;6464;16902;7046;18593
290500;201611;4231;13109;3312;11166;524;1861;1718;5736;2242;7597
290510;201611;3433;9500;2914;8744;154;519;2375;7080;2529;7599
290515;201611;3597;10020;2946;9118;216;646;2388;7528;2604;8174
290520;201611;11851;35819;8977;29935;883;3115;5446;17906;6329;21021
290530;201611;5246;15266;4464;13979;306;919;3520;11045;3826;11964
290540;201611;4005;11316;3631;10686;272;812;2857;8348;3129;9160
290550;201611;4723;11946;4041;11121;93;262;3714;10223;3807;10485
290560;201611;6615;18528;5617;17018;1298;3770;3234;10043;4532;13813
290570;201611;43958;118331;39196;111269;4194;11759;28290;80036;32484;91795
290580;201611;6878;22993;6345;22067;636;2371;4804;16803;5440;19174
290590;201611;7440;23305;6262;21146;238;985;5119;17181;5357;18166
290600;201611;18084;53373;16400;50855;1966;5861;12167;38642;14133;44503
290610;201611;2536;8394;1979;7210;123;566;1403;4964;1526;5530
290620;201611;6557;19465;5827;18248;347;1116;4757;14778;5104;15894
290630;201611;8505;21514;7267;20034;544;1521;6094;16858;6638;18379
290640;201611;2759;7800;2146;6765;123;456;1653;5106;1776;5562
290650;201611;11398;32440;10520;31081;2389;6927;6088;18527;8477;25454
290660;201611;3767;10200;3102;9172;113;354;2339;7167;2452;7521
290670;201611;7046;21123;6056;19374;646;2121;4268;13705;4914;15826
290680;201611;10581;30815;9164;28776;416;1668;7487;22989;7903;24657
290682;201611;4699;13162;4047;12170;169;662;3421;10092;3590;10754
290685;201611;3829;8937;2421;6890;284;832;1520;4416;1804;5248
290687;201611;7651;21340;5754;18266;1311;4150;2693;8960;4004;13110
290689;201611;3244;9201;2777;8459;245;806;2065;6474;2310;7280
290690;201611;5649;15620;4792;14383;736;2168;3142;9464;3878;11632
290700;201611;2435;7336;2235;7007;146;465;1764;5547;1910;6012
290710;201611;7869;24387;7200;23293;515;1582;5872;19144;6387;20726
290720;201611;19133;54643;17237;52055;1375;3725;14085;43558;15460;47283
290730;201611;7399;19794;6451;18446;714;1839;4626;13384;5340;15223
290740;201611;971;2805;739;2378;64;223;532;1693;596;1916
290750;201611;10540;28786;8750;25344;1361;4252;5113;14214;6474;18466
290755;201611;2384;6692;1799;5590;122;410;1253;3827;1375;4237
290760;201611;4313;12817;3341;10943;496;1451;1952;6622;2448;8073
290770;201611;2583;8847;2370;8523;92;435;1938;6946;2030;7381
290780;201611;9221;22890;7777;20745;823;1683;5866;16294;6689;17977
290790;201611;4498;13128;4092;12544;224;655;3501;10768;3725;11423
290800;201611;7337;15306;5552;13296;452;858;4387;10985;4839;11843
290810;201611;5518;16361;4448;14567;168;604;3391;11103;3559;11707
290820;201611;5744;15732;4993;14676;451;1424;3750;11115;4201;12539
290830;201611;4446;11544;3977;10818;192;635;3027;8001;3219;8636
290840;201611;18008;50413;15498;46443;2362;6779;9777;30524;12139;37303
290850;201611;6254;17845;5877;17322;874;2279;4310;13253;5184;15532
290860;201611;5218;17154;4755;16530;444;1532;3729;13278;4173;14810
290870;201611;4838;13921;3772;12098;213;823;2685;8514;2898;9337
290880;201611;1491;3932;1137;3341;100;277;787;2348;887;2625
290890;201611;7356;18415;6222;17121;529;1229;5169;14540;5698;15769
290900;201611;2493;7029;1809;5771;237;777;985;3119;1222;3896
290910;201611;4885;12685;3880;11149;88;333;3317;9349;3405;9682
290920;201611;5036;13422;4564;12754;220;608;3903;10866;4123;11474
290930;201611;8377;24581;7032;22354;290;1299;5607;17391;5897;18690
290940;201611;3593;11114;3014;10147;103;356;2447;8330;2550;8686
290950;201611;1589;4310;1348;3912;131;370;935;2736;1066;3106
290960;201611;5909;16370;5261;15487;167;571;4399;13007;4566;13578
290970;201611;3822;11572;3207;10524;253;829;2206;7283;2459;8112
290980;201611;10850;30433;8697;26261;2499;7619;2414;7291;4913;14910
290990;201611;9236;26987;7753;24391;712;2424;5736;17644;6448;20068
291000;201611;3108;8937;2738;8475;132;452;2418;7450;2550;7902
291005;201611;14828;37805;12802;35000;1310;3630;9424;25986;10734;29616
291010;201611;3338;10154;2535;8415;225;749;1663;5549;1888;6298
291020;201611;1382;3571;1006;2877;96;262;572;1541;668;1803
291030;201611;2303;6138;1573;4656;135;427;1000;2844;1135;3271
291040;201611;5719;16706;4884;15362;286;1157;3849;11933;4135;13090
291050;201611;8094;25677;7171;23894;1747;6213;3673;11966;5420;18179
291060;201611;6081;21991;5605;21124;895;3736;3511;12989;4406;16725
291070;201611;16631;46616;14082;42669;848;2899;10988;32965;11836;35864
291072;201611;23922;69217;18220;57509;4515;15150;6247;19706;10762;34856
291075;201611;5267;14632;4546;13446;291;768;3458;10297;3749;11065
291077;201611;1502;4216;1169;3629;81;263;795;2441;876;2704
291080;201611;80933;248982;68492;223003;24542;80349;12556;40513;37098;120862
291085;201611;5808;15045;4870;13728;369;1083;3965;11187;4334;12270
291090;201611;1699;3852;1467;3553;78;154;1293;3148;1371;3302
291100;201611;2625;6624;2061;5947;103;376;1624;4585;1727;4961
291110;201611;5243;17985;4624;16953;561;2297;3309;11839;3870;14136
291120;201611;7415;19730;6667;18527;755;2099;4817;13399;5572;15498
291125;201611;1994;3872;1496;3336;89;227;1211;2700;1300;2927
291130;201611;2913;8981;2344;7885;91;404;1775;5819;1866;6223
291140;201611;4248;12442;3457;10876;524;1480;2139;6827;2663;8307
291150;201611;2015;5080;1818;4822;80;262;1501;3861;1581;4123
291160;201611;5314;16465;4535;15076;796;2770;2512;8235;3308;11005
291165;201611;2594;7147;1909;5841;35;154;1415;4194;1450;4348
291170;201611;22418;57365;18106;50595;1718;5188;11783;32529;13501;37717
291180;201611;6319;16304;4952;14110;422;1181;3597;10312;4019;11493
291185;201611;3754;10051;3262;9254;165;485;2688;7534;2853;8019
291190;201611;7472;19756;6369;18130;396;1418;5268;14676;5664;16094
291200;201611;2949;8663;2236;7227;138;434;1488;4853;1626;5287
291210;201611;7007;16646;5697;14972;245;773;4461;11626;4706;12399
291220;201611;4296;13040;3839;12238;503;1822;2552;7900;3055;9722
291230;201611;4048;10075;3621;9586;91;171;3389;9102;3480;9273
291240;201611;4705;12547;3948;11150;126;389;3247;8996;3373;9385
291250;201611;3605;10861;2739;9183;263;862;1795;6099;2058;6961
291260;201611;1103;3155;991;3007;53;246;835;2427;888;2673
291270;201611;4565;14369;3986;13218;1305;4401;1898;6315;3203;10716
291280;201611;2130;6169;1672;5344;324;1126;843;2595;1167;3721
291290;201611;5727;15763;4770;14382;729;2136;2991;9158;3720;11294
291300;201611;4439;12402;3240;10262;195;682;2376;7406;2571;8088
291310;201611;5481;15312;4624;13710;269;811;3617;10654;3886;11465
291320;201611;6228;19117;4870;16350;1242;4119;2098;7220;3340;11339
291330;201611;1622;4831;1392;4415;98;348;994;3086;1092;3434
291340;201611;4005;10854;3185;9616;147;396;2583;7792;2730;8188
291345;201611;3424;10670;3133;10290;212;644;2591;8715;2803;9359
291350;201611;5834;16849;4972;15341;267;886;3887;12083;4154;12969
291360;201611;34843;92703;29043;83962;7341;21096;14947;44298;22288;65394
291370;201611;8442;23683;7795;22775;697;1988;5874;17329;6571;19317
291380;201611;3775;11099;3173;10106;173;631;2443;7793;2616;8424
291390;201611;10516;27658;9465;26263;1036;2852;7315;20291;8351;23143
291400;201611;14113;38199;12080;34999;2295;6044;7542;23027;9837;29071
291410;201611;3382;8731;2371;7041;120;518;1735;4913;1855;5431
291420;201611;2124;5609;1759;5120;77;270;1487;4281;1564;4551
291430;201611;3325;9441;2838;8711;174;692;2240;6627;2414;7319
291440;201611;6835;20093;5556;17830;578;1894;4043;13071;4621;14965
291450;201611;8433;23943;7163;22089;279;795;5836;18732;6115;19527
291460;201611;13531;40291;11903;37612;1587;5364;7616;24141;9203;29505
291465;201611;8170;22919;6984;21443;411;1673;5733;17230;6144;18903
291470;201611;16424;42825;14008;39776;932;2513;10611;31015;11543;33528
291480;201611;36870;91291;28631;78987;5039;14207;15640;42951;20679;57158
291490;201611;4316;13564;3942;12979;629;2055;2630;8774;3259;10829
291500;201611;4426;12338;3572;10972;189;721;2885;8706;3074;9427
291510;201611;3764;11046;3342;10434;70;270;2942;9241;3012;9511
291520;201611;3922;10486;3210;9434;603;1782;1951;5728;2554;7510
291530;201611;2218;5908;1674;5072;400;1207;837;2701;1237;3908
291535;201611;3817;11434;3389;10731;223;719;2617;8353;2840;9072
291540;201611;2145;5018;1765;4619;127;228;1552;4188;1679;4416
291550;201611;5214;13483;4370;12234;768;1955;2628;7521;3396;9476
291560;201611;19006;44131;12704;36311;856;2462;9454;27718;10310;30180
291570;201611;2235;5760;1965;5406;182;358;1630;4687;1812;5045
291580;201611;5603;16571;4799;15327;453;1770;3475;10924;3928;12694
291590;201611;1791;5537;1581;5176;163;569;1175;3872;1338;4441
291600;201611;5233;14257;3807;11794;971;3147;1629;4887;2600;8034
291610;201611;4967;15483;4755;15223;137;461;4369;14099;4506;14560
291620;201611;3149;7211;2209;6142;136;411;1750;4893;1886;5304
291630;201611;3224;7630;2594;6866;258;644;1994;5383;2252;6027
291640;201611;17143;46086;12808;39040;3337;10485;3621;11458;6958;21943
291650;201611;8479;24233;7691;23222;655;1589;6296;19506;6951;21095
291660;201611;2230;5746;1683;4846;144;494;1095;2932;1239;3426
291670;201611;1912;5246;1685;4915;107;298;1340;3977;1447;4275
291680;201611;4119;11724;3463;10567;572;1861;2076;6307;2648;8168
291685;201611;4847;12080;3896;10780;577;1483;2589;7413;3166;8896
291690;201611;3940;10426;2938;8685;218;623;2056;6002;2274;6625
291700;201611;9296;28399;8108;26216;887;2765;5915;19389;6802;22154
291710;201611;5376;13785;4168;12084;298;889;3060;8778;3358;9667
291720;201611;4644;14728;3750;12777;329;1221;2667;8821;2996;10042
291730;201611;6298;18169;5582;17141;510;1619;4329;13431;4839;15050
291733;201611;2787;7782;2150;6817;211;703;1426;4541;1637;5244
291735;201611;3023;8189;2468;7344;106;361;2065;6092;2171;6453
291740;201611;3862;10875;3185;9865;206;694;2561;7896;2767;8590
291750;201611;22851;57890;17057;48553;3774;10820;8236;24072;12010;34892
291760;201611;11120;34854;9407;31690;3822;14184;2142;7084;5964;21268
291770;201611;7816;22272;6312;19419;900;2823;3896;11748;4796;14571
291780;201611;4558;13517;4183;12865;188;588;3546;10873;3734;11461
291790;201611;2661;7965;2495;7699;83;293;2136;6501;2219;6794
291800;201611;31145;83209;26483;76417;4015;11447;16630;49068;20645;60515
291810;201611;10983;28969;9007;26412;485;1507;7318;21401;7803;22908
291820;201611;3835;11136;3322;10322;193;663;2528;7854;2721;8517
291830;201611;4265;11120;3836;10465;319;884;3025;8290;3344;9174
291835;201611;6461;19787;4919;16789;1530;5390;2166;7527;3696;12917
291840;201611;49141;135902;41982;126862;6342;18630;28484;88653;34826;107283
291845;201611;2639;7533;2438;7265;142;354;2165;6608;2307;6962
291850;201611;4636;13118;3726;11614;369;981;2699;8764;3068;9745
291855;201611;1857;4427;1568;4036;126;426;1222;3023;1348;3449
291860;201611;2199;6091;1567;4747;345;1163;799;2210;1144;3373
291870;201611;1432;3805;948;2881;72;271;611;1759;683;2030
291875;201611;2884;8902;2531;8306;103;398;1811;5801;1914;6199
291880;201611;5005;15857;4453;14675;523;1718;3133;10320;3656;12038
291890;201611;1342;3359;1033;2930;211;519;669;1959;880;2478
291900;201611;1298;3399;998;2882;57;194;756;2138;813;2332
291905;201611;2741;7332;1941;5790;93;297;1431;4116;1524;4413
291910;201611;2817;7457;2316;6829;110;401;1971;5760;2081;6161
291915;201611;7179;21618;5816;19094;649;2245;4117;13538;4766;15783
291920;201611;26222;76520;23541;72411;3228;10586;15114;46208;18342;56794
291930;201611;2666;7732;2272;7036;188;673;1620;4861;1808;5534
291940;201611;3449;9578;2412;7663;319;1052;1399;4331;1718;5383
291950;201611;9019;29320;7827;26942;1456;5014;4237;14983;5693;19997
291955;201611;11420;32111;10229;30408;2522;7490;5287;16530;7809;24020
291960;201611;3212;9207;2553;8180;227;721;1864;6180;2091;6901
291970;201611;4005;12022;3606;11307;335;1164;2430;7627;2765;8791
291980;201611;12204;34033;9127;29437;1013;3267;6098;20027;7111;23294
291990;201611;2226;6635;2020;6366;79;270;1732;5559;1811;5829
291992;201611;2969;8867;2874;8688;417;1193;2135;6515;2552;7708
291995;201611;2129;5985;1789;5479;78;303;1487;4455;1565;4758
292000;201611;2480;6823;2120;6259;190;620;1512;4500;1702;5120
292010;201611;6610;16117;5039;13827;514;1287;3638;10277;4152;11564
292020;201611;4149;13884;3812;13269;500;1870;2775;9556;3275;11426
292030;201611;1982;6175;1704;5690;318;1073;837;2721;1155;3794
292040;201611;4539;11869;3769;11000;206;408;3237;9894;3443;10302
292045;201611;3266;9932;2898;9410;129;386;2602;8468;2731;8854
292050;201611;6495;19428;5181;16644;552;1906;3276;10371;3828;12277
292060;201611;13046;31927;11814;30285;891;2025;9777;24969;10668;26994
292070;201611;4918;14758;4473;14162;536;1535;3506;11296;4042;12831
292080;201611;3640;9206;2900;8241;207;637;2413;6861;2620;7498
292090;201611;4099;10334;3374;9445;271;908;2732;7620;3003;8528
292100;201611;11574;30501;9494;27382;2203;6496;4586;13627;6789;20123
292105;201611;3119;9360;2722;8692;101;427;2210;7008;2311;7435
292110;201611;6615;17426;4870;14505;1510;4408;2010;6117;3520;10525
292120;201611;7611;21031;6150;18239;1143;3302;3401;10298;4544;13600
292130;201611;2936;7987;2444;7248;417;1111;1493;4633;1910;5744
292140;201611;5111;13191;4089;11639;655;1687;2735;7974;3390;9661
292145;201611;2423;7306;2081;6705;233;714;1450;4818;1683;5532
292150;201611;12915;38463;11753;36544;383;1442;9859;30439;10242;31881
292160;201611;2525;7145;2130;6611;88;353;1862;5696;1950;6049
292170;201611;8943;25077;7115;21809;885;2858;4504;13775;5389;16633
292180;201611;3077;8740;2297;7339;479;1432;1192;3944;1671;5376
292190;201611;3350;9360;2688;8233;507;1650;1448;4415;1955;6065
292200;201611;6953;20904;5678;18542;1624;5533;2049;6745;3673;12278
292205;201611;3934;11636;3424;10811;169;687;2802;8626;2971;9313
292210;201611;6628;17038;5448;15427;246;816;4626;13010;4872;13826
292220;201611;1885;5088;1642;4693;413;1112;846;2433;1259;3545
292225;201611;3283;10039;2918;9446;170;713;2384;7609;2554;8322
292230;201611;6974;19301;6391;18317;247;1007;5199;14350;5446;15357
292240;201611;4834;14442;4075;12797;390;1218;2846;8845;3236;10063
292250;201611;5261;15905;4757;14943;1007;3206;2458;7802;3465;11008
292260;201611;3259;9355;2965;8930;190;532;2472;7521;2662;8053
292265;201611;3251;9658;2713;8694;114;509;2091;6494;2205;7003
292270;201611;4206;10396;3367;9406;196;552;2809;7913;3005;8465
292273;201611;2839;6382;2100;5438;154;324;1620;4365;1774;4689
292275;201611;1682;4709;1473;4397;180;442;1101;3458;1281;3900
292280;201611;2283;6148;1942;5721;181;440;1489;4644;1670;5084
292285;201611;2535;6709;2013;5921;95;336;1600;4654;1695;4990
292290;201611;7072;20852;5788;19041;362;1461;4448;14653;4810;16114
292300;201611;8578;25107;7230;23314;2069;6914;3556;11698;5625;18612
292303;201611;2961;8778;2603;8248;81;310;2236;7009;2317;7319
292305;201611;2935;7868;2729;7553;57;226;2482;6774;2539;7000
292310;201611;5997;17433;5430;16554;157;582;4479;13491;4636;14073
292320;201611;6899;18817;5640;16606;429;1278;4297;12539;4726;13817
292330;201611;2286;5906;2036;5548;156;469;1644;4425;1800;4894
292335;201611;5268;13645;4584;12663;381;981;3704;10354;4085;11335
292340;201611;6590;18035;5402;16004;332;988;4105;12068;4437;13056
292350;201611;2369;6808;1991;6249;119;455;1618;5051;1737;5506
292360;201611;5371;13689;4849;12765;283;651;3921;10642;4204;11293
292370;201611;8745;24109;7503;22340;630;1536;5999;18164;6629;19700
292380;201611;7391;21475;6576;20093;722;1977;4937;15287;5659;17264
292390;201611;3667;8002;2897;7116;514;668;2207;6013;2721;6681
292400;201611;21195;64269;19077;60538;3008;9502;12416;39404;15424;48906
292405;201611;4642;11306;3651;9954;207;473;2934;8056;3141;8529
292410;201611;2037;5335;1818;5046;147;364;1509;4230;1656;4594
292420;201611;3806;12093;3538;11664;233;985;2833;9209;3066;10194
292430;201611;5608;16210;4023;13803;351;1284;2633;9029;2984;10313
292440;201611;8666;28133;7920;27013;162;677;7206;24734;7368;25411
292450;201611;4081;12068;3224;10547;312;1027;2238;7357;2550;8384
292460;201611;4996;14697;4139;13163;479;1586;2755;8730;3234;10316
292465;201611;2469;7249;1982;6396;182;628;1284;4194;1466;4822
292467;201611;1915;6009;1796;5818;335;1109;1142;3802;1477;4911
292470;201611;2995;7822;2374;6750;119;329;1859;5290;1978;5619
292480;201611;6484;16565;5301;14945;132;451;4792;13384;4924;13835
292490;201611;2448;6564;1944;5784;142;445;1449;4288;1591;4733
292500;201611;6668;19487;5535;17417;668;2134;3629;11496;4297;13630
292510;201611;12926;36637;10595;32850;898;3118;7794;24100;8692;27218
292520;201611;5813;16181;4854;14639;1026;3115;2685;8149;3711;11264
292525;201611;5481;14038;4608;12995;139;428;3955;11188;4094;11616
292530;201611;27855;78309;23601;71911;6015;18496;11326;35417;17341;53913
292540;201611;3041;8004;2628;7472;319;891;1989;5711;2308;6602
292550;201611;6813;20526;5655;18891;644;2293;4195;14201;4839;16494
292560;201611;4150;11389;3521;10413;196;751;2723;7867;2919;8618
292570;201611;4340;11872;3859;11282;106;305;3532;10471;3638;10776
292575;201611;6574;21184;6263;20644;409;1321;5248;17479;5657;18800
292580;201611;6822;20041;6260;19190;299;994;5348;16326;5647;17320
292590;201611;7699;21745;7102;20821;379;1147;6042;17481;6421;18628
292593;201611;3100;7886;2503;6916;338;875;1738;4774;2076;5649
292595;201611;5961;16188;5140;15059;298;926;4093;11944;4391;12870
292600;201611;10949;30599;9535;28565;910;2182;7305;22588;8215;24770
292610;201611;4793;13044;3775;11325;262;758;2417;7538;2679;8296
292620;201611;6358;18649;5503;17633;116;374;5114;16541;5230;16915
292630;201611;9488;23704;7581;20625;1000;2515;5001;13956;6001;16471
292640;201611;7878;25068;7084;23692;380;1411;5427;18224;5807;19635
292650;201611;4774;12587;4416;12111;363;887;3668;10097;4031;10984
292660;201611;11071;32543;9951;30830;1099;3393;7377;23098;8476;26491
292665;201611;2379;7373;2218;7152;36;94;2038;6646;2074;6740
292670;201611;3816;10544;2828;8693;348;1087;1694;5219;2042;6306
292680;201611;3775;10916;3244;9920;372;1063;2309;7010;2681;8073
292690;201611;2929;7810;2039;6352;170;481;1369;4397;1539;4878
292700;201611;9624;27990;8174;25753;1280;3599;5081;16958;6361;20557
292710;201611;2178;7106;2027;6895;71;265;1779;6071;1850;6336
292720;201611;9515;23807;8072;22133;282;887;6928;19220;7210;20107
292730;201611;3720;10922;3501;10555;218;653;2813;8479;3031;9132
292740;201611;342796;905388;311098;852740;58226;166203;184614;497536;242840;663739
292750;201611;6716;17768;5544;15996;271;849;4472;12889;4743;13738
292760;201611;4128;12547;3589;11534;394;1329;2464;7886;2858;9215
292770;201611;6202;17847;5275;16411;960;3130;3135;9946;4095;13076
292780;201611;1927;4355;1418;3685;153;317;1001;2652;1154;2969
292790;201611;3460;8212;3307;8051;59;96;3192;7849;3251;7945
292800;201611;9486;27301;8506;25577;553;1717;6717;20088;7270;21805
292805;201611;2993;8374;2559;7703;253;780;1922;5792;2175;6572
292810;201611;9723;28180;7564;24819;884;2868;5133;17112;6017;19980
292820;201611;7618;21183;5456;17899;385;1474;4213;13632;4598;15106
292830;201611;1760;5128;1553;4804;61;256;1336;4067;1397;4323
292840;201611;8323;24334;7725;23464;305;1078;6847;20531;7152;21609
292850;201611;3159;8340;2432;7119;281;809;1541;4428;1822;5237
292860;201611;15763;39594;14116;37315;1045;2759;11229;29550;12274;32309
292870;201611;19549;52942;16422;47640;1908;6081;9737;27478;11645;33559
292880;201611;12940;35905;11116;33088;818;2849;8061;23263;8879;26112
292890;201611;5637;18391;4908;17013;613;2206;3263;11333;3876;13539
292895;201611;2911;6923;2126;5684;247;643;1459;3890;1706;4533
292900;201611;2837;8536;2648;8213;143;619;2023;6014;2166;6633
292905;201611;4135;11984;3140;10287;351;1076;2094;6943;2445;8019
292910;201611;5108;14864;4446;13611;622;1907;2626;8039;3248;9946
292920;201611;9556;27380;8936;26429;432;1563;7557;21762;7989;23325
292925;201611;5263;15571;4659;14638;322;1022;3649;11470;3971;12492
292930;201611;6624;20829;5957;19502;409;1742;4229;13359;4638;15101
292935;201611;2062;5938;1682;5487;86;319;1426;4762;1512;5081
292937;201611;3329;8304;2722;7524;169;455;2216;6161;2385;6616
292940;201611;3370;8953;2589;7831;225;693;1837;5701;2062;6394
292950;201611;8372;24043;7548;22542;451;1583;5711;16654;6162;18237
292960;201611;5397;13626;4530;12393;257;748;3450;9309;3707;10057
292970;201611;4403;12807;3768;11909;147;685;3101;9672;3248;10357
292975;201611;3690;9469;3367;9031;372;873;2786;7597;3158;8470
292980;201611;3371;8629;2546;7394;195;635;1887;5369;2082;6004
292990;201611;12217;33928;10178;30663;438;1394;8349;24940;8787;26334
293000;201611;2922;7364;2563;6868;47;152;2028;5712;2075;5864
293010;201611;18289;50047;14887;44116;2437;7220;8683;25616;11120;32836
293015;201611;7715;25816;6486;23283;718;2917;4236;15041;4954;17958
293020;201611;9277;30165;8603;29149;269;1186;7497;25216;7766;26402
293030;201611;5742;16045;4232;13525;488;1438;2778;9287;3266;10725
293040;201611;3855;12227;3626;11786;209;654;3164;10323;3373;10977
293050;201611;21230;57236;17971;52624;3453;10011;9464;28955;12917;38966
293060;201611;3689;9779;2953;8518;224;698;2171;6164;2395;6862
293070;201611;25053;66431;19461;57913;4602;13539;8722;27138;13324;40677
293075;201611;3316;11052;2996;10527;188;839;2370;8296;2558;9135
293076;201611;3794;10294;3324;9623;166;431;2753;8142;2919;8573
293077;201611;5129;15568;4360;14375;838;2829;2601;8760;3439;11589
293080;201611;4683;14536;4120;13567;166;811;3398;10928;3564;11739
293090;201611;3365;10476;2674;9344;220;789;1890;6708;2110;7497
293100;201611;5961;17169;4765;14988;577;1815;3305;10486;3882;12301
293105;201611;4080;13169;3478;11979;472;1636;2253;7855;2725;9491
293110;201611;2086;5775;1767;5276;83;258;1418;4226;1501;4484
293120;201611;3856;12335;3608;11923;264;827;2888;9658;3152;10485
293130;201611;4115;11337;3421;10525;131;478;2990;9235;3121;9713
293135;201611;31206;78195;22226;64460;5424;16968;7809;22491;13233;39459
293140;201611;2016;5537;1868;5296;121;442;1528;4169;1649;4611
293150;201611;5565;18023;4583;16022;673;2389;2837;10070;3510;12459
293160;201611;3714;9384;3232;8767;446;876;2451;7121;2897;7997
293170;201611;3468;9952;3058;9272;273;914;2185;6636;2458;7550
293180;201611;5437;14909;4224;12917;150;612;3331;9902;3481;10514
293190;201611;13943;41265;12451;38862;512;2222;10480;31935;10992;34157
293200;201611;7355;19906;6179;18244;187;659;4905;14536;5092;15195
293210;201611;5193;14563;4414;13188;306;971;3349;9907;3655;10878
293220;201611;5089;14818;4062;12833;1083;3341;1459;4765;2542;8106
293230;201611;3847;11429;3350;10600;462;1655;2263;7036;2725;8691
293240;201611;4447;12098;3428;10318;131;377;2591;7812;2722;8189
293245;201611;4392;12163;3829;11302;218;641;3082;9101;3300;9742
293250;201611;5742;15418;5013;14259;511;1456;3546;10028;4057;11484
293260;201611;4656;13485;3789;12140;241;785;2743;8779;2984;9564
293270;201611;5828;14965;5141;14156;329;814;4462;12417;4791;13231
293280;201611;5483;14719;4462;13211;312;779;3451;10407;3763;11186
293290;201611;14730;48197;13251;45218;3401;11766;5632;19804;9033;31570
293300;201611;7082;16461;5794;14858;420;1004;4353;11335;4773;12339
293305;201611;4916;12088;4011;10797;132;411;3365;8973;3497;9384
293310;201611;2545;6557;1959;5518;208;578;1297;3609;1505;4187
293315;201611;4407;10951;3637;9744;355;784;2737;7488;3092;8272
293317;201611;2525;7075;2165;6378;190;575;1550;4517;1740;5092
293320;201611;7844;25252;7508;24769;1156;3768;5357;18020;6513;21788
293325;201611;1868;5238;1489;4601;207;703;960;2919;1167;3622
293330;201611;51451;163844;44855;151238;10025;35291;20239;68570;30264;103861
293340;201611;2690;7574;2050;6421;260;836;1188;3732;1448;4568
293345;201611;3401;9939;2893;9217;258;639;2213;7401;2471;8040
293350;201611;6647;19302;6211;18772;205;427;5670;17651;5875;18078
293360;201611;13528;39595;12062;37674;678;2366;10524;32770;11202;35136
310010;201611;932;2499;685;2084;116;417;296;819;412;1236
310020;201611;2912;9008;2257;7649;516;1900;296;923;812;2823
310030;201611;2379;7250;1890;6371;393;1449;1012;3338;1405;4787
310040;201611;998;2632;795;2329;68;241;609;1718;677;1959
310050;201611;1881;6324;1680;5874;323;1282;726;2429;1049;3711
310060;201611;3327;10004;2839;9328;256;1021;2253;7286;2509;8307
310070;201611;358;984;254;791;14;63;168;476;182;539
310080;201611;751;2207;583;1892;97;383;215;645;312;1028
310090;201611;4688;13638;3855;12113;482;1626;2501;7797;2983;9423
310100;201611;3541;10496;2877;9370;163;644;2259;7268;2422;7912
310110;201611;4940;13757;3971;11961;654;2194;2095;5997;2749;8191
310120;201611;644;1909;459;1531;121;488;165;429;286;917
310130;201611;404;1222;342;1106;90;349;166;466;256;815
310140;201611;220;719;173;638;52;230;51;154;103;384
310150;201611;4832;14509;3880;12533;945;3283;1234;3789;2179;7072
310160;201611;6536;20727;5036;17480;1586;5819;615;2023;2201;7842
310163;201611;1069;3393;858;2942;302;1089;198;623;500;1712
310170;201611;9268;25494;8007;23586;999;3090;5533;16386;6532;19476
310180;201611;1776;4934;1439;4398;233;783;826;2416;1059;3199
310190;201611;2865;9331;2379;8339;646;2467;415;1408;1061;3875
310200;201611;1834;5912;1493;5169;304;1151;497;1680;801;2831
310205;201611;1144;3230;833;2713;149;472;426;1427;575;1899
310210;201611;2814;7853;2328;7096;194;572;1734;5244;1928;5816
310220;201611;1063;3137;912;2887;144;517;564;1718;708;2235
310230;201611;2605;7824;2078;6640;276;1032;1183;3531;1459;4563
310240;201611;926;3296;803;3023;114;474;457;1715;571;2189
310250;201611;820;2648;769;2549;128;527;471;1431;599;1958
310260;201611;3223;10088;2239;7893;556;2198;363;1061;919;3259
310270;201611;2626;7199;2036;6295;167;660;1590;4777;1757;5437
310280;201611;2384;6137;1803;5161;414;1278;870;2365;1284;3643
310285;201611;2072;7219;1866;6870;214;897;1335;5001;1549;5898
310290;201611;1149;3444;1050;3261;257;901;542;1518;799;2419
310300;201611;1729;5724;1592;5443;387;1506;752;2416;1139;3922
310310;201611;371;1007;253;780;38;107;120;385;158;492
310320;201611;402;1253;312;1071;41;198;158;496;199;694
310330;201611;528;1307;318;893;35;105;133;326;168;431
310340;201611;8479;24776;6594;21324;1536;4908;2852;9633;4388;14541
310350;201611;14285;37298;9355;28612;2464;8125;2292;6664;4756;14789
310360;201611;456;1305;406;1229;21;80;307;886;328;966
310370;201611;1421;4716;1226;4317;381;1352;484;1722;865;3074
310375;201611;1241;3354;750;2422;121;405;282;895;403;1300
310380;201611;384;994;211;669;67;220;67;190;134;410
310390;201611;463;1593;373;1381;80;314;79;252;159;566
310400;201611;10565;28729;7304;22874;1747;5859;2005;6097;3752;11956
310410;201611;756;2459;502;1981;102;429;100;387;202;816
310420;201611;5685;15747;3293;10516;646;2207;484;1303;1130;3510
310430;201611;1353;4287;899;3277;213;837;146;496;359;1333
310440;201611;573;1625;405;1301;69;249;157;496;226;745
310445;201611;1259;4055;995;3525;111;419;654;2284;765;2703
310450;201611;4656;12770;3562;11049;354;1122;2467;7702;2821;8824
310460;201611;1621;4732;1250;4115;339;1195;322;1124;661;2319
310470;201611;4121;9150;3445;8325;252;553;2953;7239;3205;7792
310480;201611;1260;3612;908;2893;200;621;385;1177;585;1798
310490;201611;3045;9608;2410;8255;618;2449;929;2945;1547;5394
310500;201611;1343;4460;1139;3995;270;1026;432;1461;702;2487
310510;201611;2079;6477;1500;5132;374;1361;232;780;606;2141
310520;201611;1446;3665;1042;3013;77;206;729;2087;806;2293
310530;201611;993;2937;456;1580;58;228;59;158;117;386
310540;201611;3173;10053;2714;9141;722;2525;1108;3638;1830;6163
310550;201611;1233;3400;947;2915;158;595;547;1566;705;2161
310560;201611;15853;47409;12584;40761;3376;11940;3643;10798;7019;22738
310570;201611;1194;3477;978;3081;143;563;650;1951;793;2514
310590;201611;4399;12636;3421;10713;522;1737;1695;5159;2217;6896
310600;201611;1441;4659;1207;4109;260;972;504;1604;764;2576
310610;201611;470;1553;396;1383;92;397;121;353;213;750
310620;201611;147950;445765;119910;388186;28212;100458;42355;123637;70567;224095
310630;201611;4330;12861;3788;11850;337;1175;2808;8635;3145;9810
310640;201611;1299;3921;990;3327;287;1083;254;771;541;1854
310650;201611;2694;8282;2011;6997;333;1180;1100;3811;1433;4991
310660;201611;1361;4056;1181;3812;114;390;856;2723;970;3113
310665;201611;1299;3794;1135;3552;77;249;927;2968;1004;3217
310670;201611;41912;126759;35546;112865;8752;29122;13300;40604;22052;69726
310680;201611;693;1929;594;1771;79;268;415;1198;494;1466
310690;201611;1441;4535;1118;3939;208;864;440;1437;648;2301
310700;201611;546;1325;412;1146;62;208;265;707;327;915
310710;201611;6402;20401;4487;16801;872;3790;537;1771;1409;5561
310720;201611;825;2402;722;2233;62;221;529;1607;591;1828
310730;201611;9485;28896;8131;26429;1380;4788;4609;14760;5989;19548
310740;201611;5190;16238;3731;13004;887;3250;812;2651;1699;5901
310750;201611;1494;3693;1023;2994;203;617;435;1162;638;1779
310760;201611;609;1809;472;1543;78;274;194;625;272;899
310770;201611;934;2906;693;2474;134;536;312;1042;446;1578
310780;201611;3894;10463;3097;9041;427;1252;2038;5844;2465;7096
310790;201611;1990;6324;1724;5780;472;1619;725;2519;1197;4138
310800;201611;2871;8948;2031;7176;580;2328;140;438;720;2766
310810;201611;1175;3271;1000;2929;169;556;557;1521;726;2077
310820;201611;1327;3764;860;2802;209;726;207;641;416;1367
310825;201611;2612;8694;2005;7590;121;661;1462;5409;1583;6070
310830;201611;1379;4409;1053;3740;285;1075;349;1191;634;2266
310840;201611;2241;6603;1530;5201;322;1145;403;1246;725;2391
310850;201611;1558;4504;1297;4144;126;479;958;3010;1084;3489
310855;201611;3032;9266;2526;8443;390;1410;1651;5494;2041;6904
310860;201611;7509;22666;6020;19786;759;2551;3515;11685;4274;14236
310870;201611;1085;2871;839;2464;137;415;500;1471;637;1886
310880;201611;1081;3318;819;2777;138;512;425;1419;563;1931
310890;201611;2678;7966;1907;6549;464;1747;389;1159;853;2906
310900;201611;4251;13179;3127;10713;692;2632;1147;3585;1839;6217
310910;201611;1943;5444;1105;3690;180;670;144;381;324;1051
310920;201611;1911;5477;1435;4678;320;1143;642;2024;962;3167
310925;201611;966;3054;835;2815;279;1011;339;1095;618;2106
310930;201611;6287;17379;4784;15007;711;2383;2906;9230;3617;11613
310940;201611;6281;17179;5026;15175;727;2297;3071;9092;3798;11389
310945;201611;1178;3405;1005;3122;140;482;600;1792;740;2274
310950;201611;2173;6714;1471;5146;336;1376;513;1663;849;3039
310960;201611;409;1290;329;1134;86;321;132;467;218;788
310970;201611;1466;4762;987;3622;217;873;144;453;361;1326
310980;201611;443;1068;258;747;35;117;132;339;167;456
310990;201611;1204;3809;913;3128;205;775;295;893;500;1668
311000;201611;3603;11975;3118;10952;1064;3953;880;2874;1944;6827
311010;201611;743;2442;660;2261;228;835;260;881;488;1716
311020;201611;988;2827;710;2312;108;397;368;1119;476;1516
311030;201611;1711;4614;1092;3431;287;1018;331;913;618;1931
311040;201611;463;1539;376;1323;89;314;84;277;173;591
311050;201611;2342;7036;1916;6298;469;1686;815;2641;1284;4327
311060;201611;2583;7485;1741;5630;312;1125;598;1760;910;2885
311070;201611;1440;4827;1186;4287;258;1040;487;1703;745;2743
311080;201611;823;2514;671;2201;153;552;245;739;398;1291
311090;201611;1745;6217;1385;5481;431;1861;438;1614;869;3475
311100;201611;2105;6948;1568;5740;503;1995;195;673;698;2668
311110;201611;3570;8471;2434;6790;439;1287;1174;3254;1613;4541
311115;201611;1253;3581;1026;3229;93;374;698;2147;791;2521
311120;201611;8020;22222;5697;17804;1243;4280;1625;4592;2868;8872
311130;201611;2123;6378;1633;5532;288;1158;695;2199;983;3357
311140;201611;1385;3608;1004;3035;84;292;653;1956;737;2248
311150;201611;1774;6070;1586;5717;248;972;984;3517;1232;4489
311160;201611;4032;13286;3126;11515;1081;4340;684;2460;1765;6800
311170;201611;818;2418;610;2001;103;347;263;897;366;1244
311180;201611;1168;3367;870;2771;260;861;213;652;473;1513
311190;201611;1123;3142;777;2440;196;678;186;530;382;1208
311200;201611;2008;6032;1484;4917;402;1438;247;725;649;2163
311205;201611;1021;3324;830;2907;124;509;390;1344;514;1853
311210;201611;1035;3214;934;3073;150;492;661;2227;811;2719
311220;201611;878;2710;684;2278;150;538;239;756;389;1294
311230;201611;8437;26451;6077;21224;1333;4889;1959;7000;3292;11889
311240;201611;1060;3170;800;2717;204;761;268;880;472;1641
311250;201611;810;2581;688;2365;217;786;192;595;409;1381
311260;201611;2446;6432;1697;5101;401;1304;600;1748;1001;3052
311265;201611;1262;3489;970;2994;171;571;532;1640;703;2211
311270;201611;3451;10753;2964;10018;262;1262;2089;6737;2351;7999
311280;201611;1299;3577;739;2363;145;536;187;570;332;1106
311290;201611;2028;6615;1821;6104;358;1196;1056;3554;1414;4750
311300;201611;4471;14415;3873;13300;365;1574;2833;9480;3198;11054
311310;201611;589;1921;454;1624;107;371;129;410;236;781
311320;201611;3837;12628;3268;11291;607;2334;1197;3828;1804;6162
311330;201611;4679;13737;3795;12095;991;3428;1613;5041;2604;8469
311340;201611;12118;37392;9997;33020;3005;10531;2320;7466;5325;17997
311350;201611;2332;6437;1678;5118;244;868;792;2141;1036;3009
311360;201611;1119;3078;847;2702;388;1284;121;407;509;1691
311370;201611;3768;11167;2945;9569;655;2483;1141;3278;1796;5761
311380;201611;441;1455;348;1231;97;375;105;366;202;741
311390;201611;1818;6437;1596;6074;661;2860;403;1362;1064;4222
311400;201611;1517;4682;1151;3932;208;817;464;1416;672;2233
311410;201611;1829;6119;1603;5797;426;1712;763;2777;1189;4489
311420;201611;1914;6154;1184;4284;220;867;122;318;342;1185
311430;201611;3901;11567;2542;8504;497;1770;374;1195;871;2965
311440;201611;2494;7840;1694;6240;525;2188;277;990;802;3178
311450;201611;1960;6713;1542;5707;423;1734;286;951;709;2685
311455;201611;1143;3035;857;2523;216;661;341;902;557;1563
311460;201611;647;2063;450;1628;86;361;104;345;190;706
311470;201611;482;1593;361;1316;97;407;61;180;158;587
311480;201611;808;2119;738;2012;166;446;467;1269;633;1715
311490;201611;223;824;191;728;58;245;67;225;125;470
311500;201611;457;1321;346;1112;81;307;147;449;228;756
311510;201611;3082;9244;2204;7538;695;2728;453;1420;1148;4148
311520;201611;622;1985;556;1835;185;670;220;684;405;1354
311530;201611;11767;29952;7800;23154;2025;6868;1777;4968;3802;11836
311535;201611;811;2323;467;1608;124;479;73;217;197;696
311540;201611;626;2131;561;2002;182;637;239;845;421;1482
311545;201611;2156;6428;1874;6053;170;612;1356;4297;1526;4909
311547;201611;1515;4170;1219;3673;69;205;847;2538;916;2743
311550;201611;2947;9156;2269;7692;410;1534;837;2746;1247;4280
311560;201611;273;709;219;627;32;101;126;329;158;430
311570;201611;2033;5140;1532;4432;84;244;1234;3668;1318;3912
311580;201611;2501;4928;1758;4025;444;927;964;2372;1408;3299
311590;201611;476;1446;388;1291;94;359;169;547;263;906
311600;201611;1241;3705;1024;3395;321;1083;493;1656;814;2739
311610;201611;2893;9938;2470;9093;816;2908;921;3587;1737;6495
311615;201611;3196;9725;2562;8642;231;917;1832;6068;2063;6985
311620;201611;425;1270;363;1164;54;200;232;724;286;924
311630;201611;1385;3989;1093;3442;203;630;666;2074;869;2704
311640;201611;770;2455;608;2167;135;505;275;969;410;1474
311650;201611;2294;6370;1870;5642;215;724;1148;3435;1363;4159
311660;201611;2675;8446;1826;6520;372;1358;228;690;600;2048
311670;201611;1710;4826;1284;4095;397;1373;389;1181;786;2554
311680;201611;2116;6517;1698;5741;364;1276;912;3078;1276;4354
311690;201611;521;1293;431;1180;28;79;362;1002;390;1081
311700;201611;2335;5956;1752;5124;94;308;1393;3981;1487;4289
311710;201611;1688;5091;1164;4023;427;1645;266;860;693;2505
311720;201611;402;1318;332;1162;91;323;104;348;195;671
311730;201611;6064;14945;3161;9726;990;3441;606;1431;1596;4872
311740;201611;825;2475;784;2421;150;453;577;1807;727;2260
311750;201611;4135;13116;3408;11810;565;2183;1851;6179;2416;8362
311760;201611;720;2383;598;2057;127;476;144;410;271;886
311770;201611;2272;7113;1795;6129;403;1512;539;1732;942;3244
311780;201611;1226;4200;937;3514;246;1039;200;649;446;1688
311783;201611;2041;6425;1629;5587;61;293;1264;4224;1325;4517
311787;201611;601;2011;416;1465;78;300;113;337;191;637
311790;201611;1582;4635;1136;3754;262;1001;388;1220;650;2221
311800;201611;4855;16020;3667;12840;814;3106;447;1388;1261;4494
311810;201611;1059;3424;877;3040;75;346;557;1859;632;2205
311820;201611;647;1944;515;1635;124;451;265;763;389;1214
311830;201611;8493;27607;6277;22139;1814;6876;662;2129;2476;9005
311840;201611;3016;8918;2639;8306;615;2146;1372;4213;1987;6359
311850;201611;283;876;238;788;39;139;131;424;170;563
311860;201611;51450;148546;41800;130601;7725;25955;21631;64949;29356;90904
311870;201611;2157;6241;1467;4795;268;985;469;1383;737;2368
311880;201611;6860;19221;5869;17831;698;1954;4183;13117;4881;15071
311890;201611;1495;4334;1150;3655;270;919;495;1529;765;2448
311900;201611;746;2204;599;1940;80;291;344;1112;424;1403
311910;201611;4384;12487;3424;10989;787;2652;1441;4551;2228;7203
311920;201611;1920;6161;1613;5568;179;684;977;3321;1156;4005
311930;201611;3600;10067;2886;8833;1189;3717;668;2005;1857;5722
311940;201611;12524;36942;9205;29764;2038;6985;2670;7976;4708;14961
311950;201611;2243;6490;1746;5677;153;591;1241;3935;1394;4526
311960;201611;395;1206;337;1075;64;249;161;432;225;681
311970;201611;384;1278;278;1023;54;221;68;234;122;455
311980;201611;598;1661;374;1228;61;215;131;434;192;649
311990;201611;455;1290;352;1114;113;385;129;384;242;769
311995;201611;1197;3619;616;2131;38;144;61;141;99;285
312000;201611;616;1824;542;1710;57;193;354;1128;411;1321
312010;201611;926;2997;734;2544;112;416;312;1060;424;1476
312015;201611;1404;4434;1213;4067;143;546;785;2571;928;3117
312020;201611;1114;3487;957;3217;213;754;418;1379;631;2133
312030;201611;1846;5195;1622;4903;100;384;1383;4099;1483;4483
312040;201611;756;2678;578;2194;121;489;135;488;256;977
312050;201611;1242;4323;1015;3745;246;1005;156;500;402;1505
312060;201611;765;2293;638;2080;195;668;270;840;465;1508
312070;201611;1051;3181;640;2247;137;523;240;801;377;1324
312080;201611;2725;7375;2068;6275;266;973;1165;3245;1431;4218
312083;201611;944;2595;790;2371;75;252;599;1771;674;2023
312087;201611;2187;6472;1908;6032;186;641;1457;4646;1643;5287
312090;201611;9193;27737;7320;24189;2041;6997;2709;8729;4750;15726
312100;201611;1474;4665;1058;3885;240;978;443;1522;683;2500
312110;201611;1047;3607;869;3184;239;994;165;525;404;1519
312120;201611;729;2347;585;2035;132;540;210;636;342;1176
312125;201611;1114;3536;963;3245;205;663;549;1941;754;2604
312130;201611;892;2482;629;1927;86;295;246;692;332;987
312140;201611;828;2617;672;2221;166;593;194;563;360;1156
312150;201611;478;1381;405;1229;31;117;250;705;281;822
312160;201611;7600;25022;6379;22269;1525;5759;2384;7964;3909;13723
312170;201611;921;2596;744;2279;71;223;457;1373;528;1596
312180;201611;1384;4201;1132;3654;232;819;476;1431;708;2250
312190;201611;610;1937;425;1539;144;566;65;237;209;803
312200;201611;4854;13678;3908;12055;729;2219;2211;6870;2940;9089
312210;201611;1126;2954;826;2479;177;613;447;1239;624;1852
312220;201611;1934;6456;1761;6244;174;490;1482;5514;1656;6004
312230;201611;12814;38888;9249;31568;2964;11052;1112;3508;4076;14560
312235;201611;1618;4728;1392;4392;151;545;997;3120;1148;3665
312240;201611;939;3104;721;2619;171;682;174;597;345;1279
312245;201611;2207;6439;1928;6048;87;312;1589;4944;1676;5256
312247;201611;810;2371;594;1982;165;561;230;789;395;1350
312250;201611;1195;3250;857;2649;142;505;353;1007;495;1512
312260;201611;903;2814;717;2480;115;436;431;1426;546;1862
312270;201611;653;1925;487;1569;53;221;264;765;317;986
312280;201611;425;1393;364;1252;131;474;46;148;177;622
312290;201611;791;2588;684;2376;164;659;222;738;386;1397
312300;201611;891;2926;646;2304;163;633;59;156;222;789
312310;201611;877;3203;782;2966;205;866;311;1126;516;1992
312320;201611;2054;5775;1480;4633;415;1407;309;831;724;2238
312330;201611;1004;2901;807;2601;142;532;558;1754;700;2286
312340;201611;315;843;253;733;38;134;150;388;188;522
312350;201611;295;745;257;701;24;84;212;552;236;636
312352;201611;1660;5118;1467;4821;280;954;948;3207;1228;4161
312360;201611;3146;9865;2449;8379;543;1987;726;2443;1269;4430
312370;201611;1756;5327;1477;4823;410;1513;570;1720;980;3233
312380;201611;1945;5267;1700;4923;63;176;1455;4307;1518;4483
312385;201611;1336;3839;1117;3474;84;331;806;2425;890;2756
312390;201611;2102;6634;1519;5369;387;1423;327;1054;714;2477
312400;201611;3187;10029;2510;8582;974;3440;515;1800;1489;5240
312410;201611;10259;32894;8729;29710;1864;6700;3757;12458;5621;19158
312420;201611;3945;11942;3610;11393;637;1975;2328;7469;2965;9444
312430;201611;8163;23483;6706;20770;964;2960;4291;13330;5255;16290
312440;201611;783;2438;613;2104;240;897;186;665;426;1562
312450;201611;1144;3730;847;3092;274;1047;268;998;542;2045
312460;201611;362;1076;307;994;65;239;159;510;224;749
312470;201611;662;1779;393;1239;82;306;117;327;199;633
312480;201611;1218;3121;886;2729;171;610;506;1448;677;2058
312490;201611;2035;5267;1503;4406;199;647;873;2426;1072;3073
312500;201611;709;2091;585;1879;105;369;238;728;343;1097
312510;201611;3637;10518;2739;8559;408;1414;1401;4095;1809;5509
312520;201611;264;854;205;745;65;244;58;219;123;463
312530;201611;621;1782;521;1619;57;221;348;1050;405;1271
312540;201611;1427;4433;1018;3548;236;888;427;1471;663;2359
312550;201611;698;2076;577;1795;95;298;289;841;384;1139
312560;201611;2099;5427;1684;4869;74;287;1400;3962;1474;4249
312570;201611;2414;7042;1953;6207;539;1807;644;2045;1183;3852
312580;201611;534;1728;420;1465;52;206;168;571;220;777
312590;201611;1707;5522;1388;4807;368;1378;513;1654;881;3032
312595;201611;1954;6462;1719;5913;354;1227;901;3131;1255;4358
312600;201611;813;2581;603;2149;97;431;283;925;380;1356
312610;201611;7122;19814;4797;15241;1146;3882;970;2901;2116;6783
312620;201611;2205;6279;1633;5439;110;400;1229;4186;1339;4586
312630;201611;331;1049;268;924;76;293;87;280;163;573
312640;201611;541;1710;411;1429;84;296;124;402;208;698
312650;201611;2184;6197;1491;4769;178;661;869;2650;1047;3311
312660;201611;1435;3725;1111;3225;118;386;755;2132;873;2518
312670;201611;5588;16257;4536;14657;1254;4419;1565;4885;2819;9304
312675;201611;1289;4048;1057;3542;135;518;703;2301;838;2819
312680;201611;1489;4453;1251;4108;173;682;776;2431;949;3113
312690;201611;2204;5752;1704;4987;260;822;1104;3092;1364;3914
312695;201611;830;2861;771;2765;153;503;494;1850;647;2353
312700;201611;1913;5726;1400;4614;177;636;747;2396;924;3032
312705;201611;1271;3586;987;3045;78;269;704;2093;782;2362
312707;201611;1543;4833;1146;4015;145;607;605;2022;750;2629
312710;201611;7013;17517;4213;12795;1257;4171;841;2444;2098;6615
312720;201611;782;2606;645;2310;128;502;251;814;379;1316
312730;201611;1902;4468;1281;3685;146;483;787;2239;933;2722
312733;201611;1624;4292;1125;3343;53;167;744;2129;797;2296
312735;201611;834;2220;709;2037;180;557;358;961;538;1518
312737;201611;853;2104;578;1688;174;494;201;589;375;1083
312738;201611;523;1596;346;1211;80;313;120;382;200;695
312740;201611;365;857;201;659;56;190;45;144;101;334
312750;201611;1283;4471;1172;4270;221;943;569;1986;790;2929
312760;201611;1988;6283;1422;5029;333;1250;361;1236;694;2486
312770;201611;42884;115085;29752;91527;7512;24382;8043;23468;15555;47850
312780;201611;2727;9174;2353;8490;380;1507;1283;4649;1663;6156
312790;201611;336;844;188;578;26;93;71;180;97;273
312800;201611;5051;16171;3836;13521;1158;4364;817;2838;1975;7202
312810;201611;2134;6366;1353;4736;321;1213;259;793;580;2006
312820;201611;1941;5433;1580;4751;73;248;1128;3273;1201;3521
312825;201611;1342;3593;1140;3312;85;263;885;2565;970;2828
312830;201611;2493;7575;1568;5604;430;1611;268;902;698;2513
312840;201611;1246;3930;939;3293;139;540;323;1015;462;1555
312850;201611;713;2197;511;1758;95;382;153;488;248;870
312860;201611;1220;3558;834;2793;231;856;253;771;484;1627
312870;201611;5741;17466;3682;12898;670;2504;845;2773;1515;5277
312880;201611;1323;3850;1121;3520;119;407;728;2325;847;2732
312890;201611;1705;5112;966;3369;214;784;357;1245;571;2029
312900;201611;1234;3558;1037;3267;125;428;724;2319;849;2747
312910;201611;1694;3351;905;2262;162;441;434;986;596;1427
312920;201611;881;2766;700;2403;156;624;283;887;439;1511
312930;201611;2184;6175;1791;5497;460;1398;744;2288;1204;3686
312940;201611;916;2922;740;2571;188;729;202;642;390;1371
312950;201611;3126;8708;2272;7323;818;2789;465;1475;1283;4264
312960;201611;1965;5555;1644;5085;170;492;1272;4020;1442;4512
312965;201611;1824;5650;1482;4971;156;562;916;3068;1072;3630
312970;201611;1034;3375;812;2970;215;866;209;751;424;1617
312980;201611;18039;59170;16111;54725;4556;16657;6066;19561;10622;36218
312990;201611;484;1390;320;1091;98;389;90;289;188;678
313000;201611;502;1621;385;1377;82;391;149;439;231;830
313005;201611;2654;8289;2282;7570;379;1224;1371;4576;1750;5800
313010;201611;3814;12038;3131;10772;810;3009;1368;4536;2178;7545
313020;201611;992;3232;679;2402;133;520;120;330;253;850
313030;201611;1505;3954;1036;3231;216;785;473;1423;689;2208
313040;201611;839;2740;698;2385;88;372;313;981;401;1353
313050;201611;1851;5653;1297;4719;293;1181;315;1029;608;2210
313055;201611;1646;5045;1480;4798;69;232;1230;4019;1299;4251
313060;201611;754;2391;554;1905;154;547;61;186;215;733
313065;201611;1933;6145;1597;5544;248;925;1061;3681;1309;4606
313070;201611;1040;2977;789;2508;172;605;352;1063;524;1668
313080;201611;463;1396;319;1084;69;280;94;257;163;537
313090;201611;5241;14978;4417;13575;1185;3858;2022;6183;3207;10041
313100;201611;1136;3386;1009;3173;82;255;803;2557;885;2812
313110;201611;1778;4989;1212;3829;173;620;541;1571;714;2191
313115;201611;2478;8201;2246;7691;494;1875;1012;3238;1506;5113
313120;201611;3614;9397;2941;8467;718;2308;1596;4442;2314;6750
313130;201611;26485;78518;21480;67947;4405;15147;8983;26526;13388;41673
313140;201611;585;1492;437;1266;28;93;309;871;337;964
313150;201611;1398;4345;1096;3736;484;1751;189;635;673;2386
313160;201611;977;2948;807;2585;148;540;402;1201;550;1741
313170;201611;9493;31272;6535;23779;1362;5145;1709;5858;3071;11003
313180;201611;2416;6428;1817;5511;387;1289;748;2150;1135;3439
313190;201611;3744;12351;2757;9841;614;2323;716;2361;1330;4684
313200;201611;1161;3675;992;3349;90;345;709;2345;799;2690
313210;201611;4230;12817;3410;11459;770;2709;1535;4964;2305;7673
313220;201611;1543;4537;1033;3422;243;890;231;622;474;1512
313230;201611;2326;7993;2122;7685;296;1154;1475;5278;1771;6432
313240;201611;8479;25333;6164;20767;1140;4320;2444;7718;3584;12038
313250;201611;6922;21385;5567;18806;732;2536;3109;10360;3841;12896
313260;201611;636;1861;408;1357;61;224;113;355;174;579
313270;201611;5458;16038;4329;13953;773;2668;2300;7268;3073;9936
313280;201611;387;1257;264;975;53;214;63;213;116;427
313290;201611;823;2887;643;2529;235;1028;90;309;325;1337
313300;201611;1829;5978;1397;4916;398;1496;175;518;573;2014
313310;201611;1059;3615;879;3192;197;794;178;547;375;1341
313320;201611;2375;6723;1655;5494;336;1226;640;2078;976;3304
313330;201611;4046;12209;3264;10763;324;1335;2017;6358;2341;7693
313340;201611;1915;4687;1419;3905;267;730;762;2104;1029;2834
313350;201611;2897;8915;2107;7074;447;1633;446;1358;893;2991
313360;201611;1331;3746;931;3037;214;847;482;1430;696;2277
313370;201611;1185;3978;1052;3613;158;632;541;1728;699;2360
313375;201611;2389;6120;1493;4680;278;1032;515;1510;793;2542
313380;201611;5136;15691;4053;13327;1086;3837;1305;3949;2391;7786
313390;201611;899;3016;827;2883;81;324;553;1887;634;2211
313400;201611;3717;9928;3160;9239;353;955;2544;7626;2897;8581
313410;201611;1238;3480;1002;3101;226;765;564;1694;790;2459
313420;201611;18942;44798;10272;29551;2098;6623;1652;4599;3750;11222
313430;201611;1048;3249;760;2606;145;572;273;853;418;1425
313440;201611;6629;14618;4173;11457;231;563;2969;8246;3200;8809
313450;201611;638;1875;484;1549;95;344;149;433;244;777
313460;201611;2183;7278;1834;6611;454;1877;647;2093;1101;3970
313470;201611;3125;8424;2631;7635;386;1144;1759;5016;2145;6160
313480;201611;1041;2925;716;2312;110;397;249;732;359;1129
313490;201611;1544;4434;815;3184;242;1034;75;267;317;1301
313500;201611;418;1367;308;1065;56;213;97;318;153;531
313505;201611;9241;26487;8505;25630;279;551;7916;24338;8195;24889
313507;201611;1386;3749;1160;3412;96;305;786;2310;882;2615
313510;201611;15404;43715;12777;39150;1822;5773;7060;21375;8882;27148
313520;201611;14343;43497;11613;38358;1233;4500;7457;24320;8690;28820
313530;201611;616;1853;483;1584;42;154;182;559;224;713
313535;201611;2558;7394;2206;6712;180;555;1606;4804;1786;5359
313540;201611;1068;3310;744;2456;193;687;187;571;380;1258
313545;201611;1297;4657;1131;4308;180;777;636;2299;816;3076
313550;201611;1833;5789;1559;5231;351;1198;757;2496;1108;3694
313560;201611;2250;5107;1789;4559;193;463;1373;3575;1566;4038
313570;201611;881;3011;739;2726;222;894;250;876;472;1770
313580;201611;5782;16402;4369;14145;788;2684;2348;7703;3136;10387
313590;201611;983;2755;726;2362;331;1169;136;397;467;1566
313600;201611;3912;11489;3293;10454;346;1220;2323;7311;2669;8531
313610;201611;1026;2966;855;2625;199;629;437;1326;636;1955
313620;201611;5596;16970;4646;15136;1243;4244;1667;5322;2910;9566
313630;201611;8441;22994;6083;19507;915;3302;3110;10416;4025;13718
313640;201611;791;2283;553;1885;181;657;147;498;328;1155
313650;201611;1921;6268;1662;5826;254;1016;1063;3627;1317;4643
313652;201611;937;3234;846;3057;141;570;485;1674;626;2244
313655;201611;938;2957;764;2655;96;389;467;1593;563;1982
313657;201611;1356;3911;1073;3453;87;372;796;2392;883;2764
313660;201611;841;2739;707;2461;146;577;337;1091;483;1668
313665;201611;3897;12308;3180;10723;632;2357;1510;4845;2142;7202
313670;201611;46717;134362;31934;104259;7457;26293;9885;30782;17342;57075
313680;201611;1081;3126;901;2810;113;432;579;1726;692;2158
313690;201611;883;3137;744;2795;164;624;288;1105;452;1729
313695;201611;1394;4436;1163;3982;123;485;799;2721;922;3206
313700;201611;3510;11849;3023;11190;453;1698;2158;8163;2611;9861
313710;201611;1368;3612;981;2978;180;582;517;1535;697;2117
313720;201611;5555;17336;4032;13782;765;2837;1413;4378;2178;7215
313730;201611;1309;3393;934;2866;128;435;562;1688;690;2123
313740;201611;2056;7351;1614;6147;418;1771;99;301;517;2072
313750;201611;2242;6721;1772;5719;469;1598;489;1404;958;3002
313753;201611;1913;5341;1421;4449;237;831;677;2058;914;2889
313760;201611;4082;12928;3153;10895;850;3113;891;2868;1741;5981
313770;201611;3436;10756;2849;9807;896;3254;1148;3925;2044;7179
313780;201611;4071;11105;2768;8796;449;1595;1091;3344;1540;4939
313790;201611;489;1659;455;1590;93;332;259;920;352;1252
313800;201611;1295;3371;1074;3026;96;304;756;2153;852;2457
313810;201611;1577;4481;1352;4122;157;500;964;2977;1121;3477
313820;201611;13127;34699;9871;29045;1714;5710;4195;11524;5909;17234
313830;201611;429;1395;357;1246;88;352;134;457;222;809
313835;201611;904;2965;815;2807;113;457;448;1456;561;1913
313840;201611;7581;21531;5537;17854;1368;4746;1266;3874;2634;8620
313850;201611;1176;3146;980;2776;178;610;520;1310;698;1920
313860;201611;2805;8345;1957;6403;416;1424;571;1737;987;3161
313862;201611;1271;3176;861;2491;95;269;511;1548;606;1817
313865;201611;2287;6901;2026;6494;161;607;1541;4875;1702;5482
313867;201611;1138;3820;949;3380;295;1106;290;1052;585;2158
313868;201611;1668;5483;1367;4826;109;492;958;3263;1067;3755
313870;201611;804;2485;686;2237;196;705;194;549;390;1254
313880;201611;1431;4404;1169;3882;297;1089;444;1288;741;2377
313890;201611;1901;4993;1482;4384;308;902;857;2693;1165;3595
313900;201611;4031;14237;3416;12773;1043;4268;865;3147;1908;7415
313910;201611;736;2448;576;2104;195;764;67;228;262;992
313920;201611;3286;10836;2752;9789;548;1999;1425;5231;1973;7230
313925;201611;1923;5107;1350;4009;159;447;838;2502;997;2949
313930;201611;6724;24495;5523;22245;710;2535;3539;15386;4249;17921
313940;201611;8770;28450;6686;24682;1989;8065;1738;6637;3727;14702
313950;201611;4230;11757;3028;9698;937;3403;959;2778;1896;6181
313960;201611;5607;14334;3764;11414;991;3247;1076;3012;2067;6259
313970;201611;1459;4198;1210;3822;137;494;739;2403;876;2897
313980;201611;1296;3931;926;3237;202;792;360;1207;562;1999
313990;201611;1788;6513;1448;5639;456;1943;297;989;753;2932
314000;201611;8370;25924;7196;23412;1089;4171;4203;13003;5292;17174
314010;201611;1190;3254;939;2885;72;250;647;1922;719;2172
314015;201611;1534;4945;1198;4312;252;1020;516;1749;768;2769
314020;201611;511;1505;308;1040;79;291;75;232;154;523
314030;201611;858;2746;618;2163;94;361;248;840;342;1201
314040;201611;720;2070;553;1729;214;697;161;492;375;1189
314050;201611;1751;5329;1329;4447;275;1054;518;1585;793;2639
314053;201611;1601;4943;1360;4579;210;720;856;3012;1066;3732
314055;201611;2198;6456;1876;5957;71;276;1516;4835;1587;5111
314060;201611;1179;3569;909;3081;49;217;616;2031;665;2248
314070;201611;4272;13136;3189;10832;858;3016;754;2377;1612;5393
314080;201611;1788;5580;1093;3842;195;729;239;715;434;1444
314085;201611;1997;6561;1675;6023;451;1739;595;2112;1046;3851
314090;201611;3330;11309;2782;10132;733;2982;822;3023;1555;6005
314100;201611;3401;8442;2926;7817;163;346;2510;6941;2673;7287
314110;201611;4103;12889;3412;11301;673;2422;1393;4194;2066;6616
314120;201611;1063;2515;476;1520;101;350;119;363;220;713
314130;201611;699;1989;308;1076;47;174;62;195;109;369
314140;201611;4957;15053;3856;12747;820;2857;1719;5603;2539;8460
314150;201611;1602;4327;1212;3627;158;503;645;1890;803;2393
314160;201611;2610;6643;1846;5404;232;730;1068;3209;1300;3939
314170;201611;1104;3236;868;2708;95;312;499;1495;594;1807
314180;201611;5286;16430;4537;15098;1304;4548;1770;5946;3074;10494
314190;201611;730;2041;526;1686;128;492;189;528;317;1020
314200;201611;2987;9091;2538;8244;266;1009;1755;5530;2021;6539
314210;201611;2038;5788;1741;5258;235;788;1052;3080;1287;3868
314220;201611;1605;4936;1139;3949;334;1251;226;676;560;1927
314225;201611;1344;3822;1171;3559;91;294;892;2729;983;3023
314230;201611;685;2156;619;2035;108;411;338;1086;446;1497
314240;201611;1135;3401;882;2941;190;657;434;1503;624;2160
314250;201611;554;1633;392;1276;87;295;105;297;192;592
314260;201611;1043;3663;884;3260;201;836;270;924;471;1760
314270;201611;2886;9244;2324;8188;231;912;1522;5332;1753;6244
314280;201611;3283;8848;2085;6488;486;1718;704;1942;1190;3660
314290;201611;4880;13291;3998;11757;851;2539;2157;6269;3008;8808
314300;201611;1531;5017;1203;4231;364;1315;317;1070;681;2385
314310;201611;5783;16682;4480;14170;1162;3897;1700;5058;2862;8955
314315;201611;818;3168;721;2967;74;363;486;1969;560;2332
314320;201611;3036;8441;2094;7045;504;1806;978;3393;1482;5199
314330;201611;55212;164255;44333;144555;13079;44900;12234;38657;25313;83557
314340;201611;2992;8023;1467;4893;312;1141;133;282;445;1423
314345;201611;1252;4147;1100;3876;231;863;656;2270;887;3133
314350;201611;1298;3698;926;3014;275;939;136;378;411;1317
314360;201611;676;2155;406;1487;83;348;93;346;176;694
314370;201611;559;1823;508;1742;100;400;345;1134;445;1534
314380;201611;1340;4001;873;3025;248;940;121;407;369;1347
314390;201611;13902;39507;9577;31077;2299;7877;2207;6521;4506;14398
314400;201611;4587;13293;3675;11894;1254;4235;1105;3663;2359;7898
314410;201611;2711;8256;1941;6649;540;2033;591;2011;1131;4044
314420;201611;760;2108;572;1805;28;145;408;1215;436;1360
314430;201611;6547;19210;5242;16585;1442;4912;1595;4932;3037;9844
314435;201611;1365;4301;1172;3953;99;426;804;2656;903;3082
314437;201611;1103;2825;871;2445;32;97;694;1921;726;2018
314440;201611;651;1896;488;1632;157;589;101;280;258;869
314450;201611;1632;4673;1297;4108;254;960;635;1839;889;2799
314460;201611;4151;13714;3134;11374;737;2908;556;1847;1293;4755
314465;201611;2302;7086;2081;6660;96;418;1645;5111;1741;5529
314467;201611;1018;2865;830;2530;55;163;615;1891;670;2054
314470;201611;2360;7315;1870;6238;440;1647;642;1928;1082;3575
314480;201611;6106;19999;3879;13959;658;2500;486;1504;1144;4004
314490;201611;910;2662;668;2152;143;510;304;915;447;1425
314500;201611;1958;5479;1322;4228;299;1031;446;1339;745;2370
314505;201611;1826;5191;1639;4922;196;648;1152;3479;1348;4127
314510;201611;1937;5212;1248;4189;399;1448;297;981;696;2429
314520;201611;2905;10317;2034;8145;430;1911;221;762;651;2673
314530;201611;5997;20783;5504;19799;1049;3547;3241;12153;4290;15700
314535;201611;2778;7616;2258;6828;248;823;1604;4783;1852;5606
314537;201611;1154;3552;896;3065;110;452;542;1794;652;2246
314540;201611;417;1224;300;956;59;201;100;302;159;503
314545;201611;1454;4305;1245;4006;84;281;985;3228;1069;3509
314550;201611;630;1708;433;1399;84;351;170;478;254;829
314560;201611;4490;15224;3552;12857;617;2468;1111;3749;1728;6217
314570;201611;308;894;219;700;56;199;97;290;153;489
314580;201611;527;1719;363;1345;91;392;39;126;130;518
314585;201611;860;2754;593;2153;129;525;153;510;282;1035
314587;201611;2021;6047;1663;5401;353;1096;802;2663;1155;3759
314590;201611;3243;10835;2199;8017;426;1727;405;1356;831;3083
314600;201611;1573;5070;1001;3753;224;899;135;409;359;1308
314610;201611;7159;23906;6163;21496;1324;5129;2556;8278;3880;13407
314620;201611;1651;4845;1444;4533;128;414;1099;3420;1227;3834
314625;201611;1494;4889;1313;4555;166;756;886;2901;1052;3657
314630;201611;4903;14326;4062;12887;275;1123;2963;9159;3238;10282
314640;201611;594;1594;425;1278;110;351;121;298;231;649
314650;201611;1102;3031;720;2328;93;340;282;805;375;1145
314655;201611;1578;4632;1093;3642;295;950;409;1356;704;2306
314660;201611;300;801;199;596;20;59;97;280;117;339
314670;201611;1686;4423;1106;3332;160;504;649;1877;809;2381
314675;201611;1819;5359;1534;4836;138;508;1098;3399;1236;3907
314690;201611;2353;7420;1804;6345;503;1965;353;1166;856;3131
314700;201611;9317;30719;6126;23169;1701;7027;862;3092;2563;10119
314710;201611;8119;24175;5009;17092;873;3261;711;2154;1584;5415
314720;201611;2469;7938;1827;6454;452;1756;470;1641;922;3397
314730;201611;2303;6826;1766;5859;480;1747;617;1901;1097;3648
314740;201611;2941;9246;2450;8231;405;1536;1160;3718;1565;5254
314750;201611;352;1082;260;870;47;168;104;330;151;498
314760;201611;1725;5588;1163;4159;233;951;220;605;453;1556
314770;201611;1045;3227;499;1711;65;247;105;287;170;534
314780;201611;296;779;210;653;50;191;90;250;140;441
314790;201611;11337;33536;7717;26371;3070;11449;606;1594;3676;13043
314795;201611;1683;4781;1407;4333;93;359;1036;3065;1129;3424
314800;201611;11770;33545;7213;23782;1932;6709;749;2240;2681;8949
314810;201611;11899;34047;8549;27752;2477;8696;1657;5314;4134;14010
314820;201611;957;2606;632;2030;150;533;246;759;396;1292
314830;201611;1652;5390;1396;4907;382;1490;595;2086;977;3576
314840;201611;958;3331;757;3012;132;654;431;1624;563;2278
314850;201611;1982;5535;1543;4740;177;692;1062;3109;1239;3801
314860;201611;3333;10782;2822;9753;530;2089;1541;5145;2071;7234
314870;201611;5648;17195;4680;15751;459;1918;3334;11004;3793;12922
314875;201611;1800;5713;1684;5541;195;623;1382;4609;1577;5232
314880;201611;912;2409;714;2121;44;101;544;1714;588;1815
314890;201611;618;1834;411;1366;69;269;155;465;224;734
314900;201611;556;1630;434;1422;86;293;185;583;271;876
314910;201611;1737;5538;1349;4861;393;1584;445;1492;838;3076
314915;201611;2556;7915;2136;7126;154;610;1524;4936;1678;5546
314920;201611;563;1545;378;1238;24;87;214;650;238;737
314930;201611;4814;15961;3984;13994;1046;3935;1040;3424;2086;7359
314940;201611;402;1149;350;1053;48;152;214;607;262;759
314950;201611;354;1017;237;815;47;180;71;223;118;403
314960;201611;766;2319;570;1907;136;497;177;532;313;1029
314970;201611;558;1890;451;1669;104;426;125;470;229;896
314980;201611;1523;4636;1202;4057;333;1257;83;238;416;1495
314990;201611;2646;8229;1866;6410;518;2024;366;1037;884;3061
314995;201611;1640;4933;1379;4500;138;549;932;2969;1070;3518
315000;201611;1086;3053;842;2618;83;296;546;1677;629;1973
315010;201611;446;1345;321;1074;66;283;115;331;181;614
315015;201611;2170;6478;1921;6177;242;806;1404;4720;1646;5526
315020;201611;826;2535;562;1925;97;345;223;716;320;1061
315030;201611;693;2044;512;1692;140;496;98;297;238;793
315040;201611;925;2789;834;2607;160;519;487;1487;647;2006
315050;201611;1402;3989;1072;3435;184;673;508;1596;692;2269
315053;201611;1078;3183;891;2806;145;554;447;1384;592;1938
315057;201611;1738;5787;1457;5257;340;1207;704;2574;1044;3781
315060;201611;839;2682;556;2007;110;424;73;257;183;681
315070;201611;766;2246;604;1953;167;571;246;727;413;1298
315080;201611;2894;9445;2414;8357;625;2336;1028;3477;1653;5813
315090;201611;809;2781;610;2296;154;637;134;458;288;1095
315100;201611;1187;3942;805;2991;179;755;203;679;382;1434
315110;201611;1441;4269;1141;3679;255;874;435;1367;690;2241
315120;201611;14548;33662;9256;26278;1500;4248;4602;13770;6102;18018
315130;201611;1417;4623;1217;4191;299;1141;384;1244;683;2385
315140;201611;2866;8867;2209;7458;458;1780;813;2462;1271;4242
315150;201611;4765;12762;3338;10192;615;2049;1333;3995;1948;6044
315160;201611;1318;3784;1007;3166;215;706;417;1256;632;1962
315170;201611;1567;4727;1129;3809;247;883;233;825;480;1708
315180;201611;17391;48366;8639;28994;1589;5848;1565;4704;3154;10552
315190;201611;2070;5325;1677;4705;394;1156;944;2616;1338;3772
315200;201611;3928;13010;3064;11076;977;3827;556;1921;1533;5748
315210;201611;7993;23228;5933;18709;1128;3879;2245;6668;3373;10547
315213;201611;1124;3390;990;3150;41;147;811;2558;852;2705
315217;201611;2489;8374;1969;7353;218;985;1192;4311;1410;5296
315220;201611;9927;27939;7768;24174;2768;8687;2302;7256;5070;15943
315230;201611;2950;7783;2562;7313;154;218;2250;6797;2404;7015
315240;201611;3088;9321;2522;8362;764;2683;1071;3413;1835;6096
315250;201611;10672;31920;7716;25934;1846;6700;2449;8005;4295;14705
315260;201611;1033;3189;630;2223;127;457;84;259;211;716
315270;201611;730;2339;526;1896;107;427;114;373;221;800
315280;201611;3167;8983;1823;5992;402;1361;270;805;672;2166
315290;201611;1385;3783;897;2936;292;1035;172;560;464;1595
315300;201611;539;1384;332;1100;130;447;132;439;262;886
315310;201611;1272;3984;978;3372;153;613;600;1968;753;2581
315320;201611;789;2323;606;2052;98;397;280;923;378;1320
315330;201611;728;2625;394;1662;94;426;48;187;142;613
315340;201611;3629;10164;2725;8602;578;1926;1052;3161;1630;5087
315350;201611;1918;5148;1356;4284;195;667;866;2737;1061;3404
315360;201611;1733;5684;1332;4704;255;981;431;1420;686;2401
315370;201611;511;1569;415;1382;82;283;199;671;281;954
315380;201611;212;714;155;571;38;169;38;110;76;279
315390;201611;1375;4452;932;3390;211;834;183;611;394;1445
315400;201611;4332;12920;3343;10882;680;2358;1490;4716;2170;7074
315410;201611;2181;5525;1724;4840;159;513;1211;3394;1370;3907
315415;201611;1082;3459;910;3176;351;1287;276;955;627;2242
315420;201611;1266;4003;897;3193;213;779;118;379;331;1158
315430;201611;3751;10066;2597;8059;758;2550;574;1640;1332;4190
315440;201611;973;2913;810;2613;193;720;347;995;540;1715
315445;201611;2118;5769;1560;4864;234;758;994;3098;1228;3856
315450;201611;2479;7592;2139;7018;376;1134;1291;4346;1667;5480
315460;201611;33599;108116;28320;96522;9894;35433;4968;15945;14862;51378
315470;201611;476;1429;365;1203;42;171;192;600;234;771
315480;201611;1778;5348;1094;3769;234;854;217;747;451;1601
315490;201611;3174;8347;2187;6808;388;1356;826;2374;1214;3730
315500;201611;488;1419;281;911;41;150;126;348;167;498
315510;201611;1430;3998;1185;3593;96;323;873;2583;969;2906
315520;201611;1033;3079;805;2656;124;439;489;1561;613;2000
315530;201611;650;2163;506;1776;170;643;142;441;312;1084
315540;201611;1075;3333;843;2872;168;686;293;957;461;1643
315550;201611;1805;5050;1296;4185;312;1095;411;1267;723;2362
315560;201611;6510;21387;5723;20171;551;2213;3851;13590;4402;15803
315570;201611;1930;6103;1688;5570;334;1207;805;2547;1139;3754
315580;201611;2551;7320;1887;6066;474;1723;532;1574;1006;3297
315590;201611;879;2553;746;2321;110;389;398;1196;508;1585
315600;201611;2498;8671;1914;7461;389;1520;935;3808;1324;5328
315610;201611;1010;2828;775;2343;133;507;326;832;459;1339
315620;201611;315;1100;290;1048;89;298;152;590;241;888
315630;201611;936;2939;711;2442;162;568;152;489;314;1057
315640;201611;488;1395;373;1189;74;280;160;457;234;737
315645;201611;889;2618;685;2178;251;841;161;480;412;1321
315650;201611;1857;5038;1418;4388;95;386;1030;3113;1125;3499
315660;201611;2616;6669;2025;5663;274;740;1359;3767;1633;4507
315670;201611;11157;36018;9522;32641;2523;9205;3566;11812;6089;21017
315680;201611;3048;9998;2235;8224;708;2750;547;1989;1255;4739
315690;201611;3422;9572;2142;7133;556;1986;401;1396;957;3382
315700;201611;7439;22756;5921;19583;1078;3851;2728;8570;3806;12421
315710;201611;1849;5176;1358;4340;100;429;886;2698;986;3127
315720;201611;3687;11595;3031;10247;313;1302;1916;6060;2229;7362
315725;201611;1536;4743;1352;4457;218;748;947;3158;1165;3906
315727;201611;614;1846;466;1529;105;385;165;491;270;876
315730;201611;794;2459;698;2229;104;380;358;1091;462;1471
315733;201611;1043;3070;855;2699;272;922;287;841;559;1763
315737;201611;1268;3802;937;3167;68;293;605;2032;673;2325
315740;201611;1040;3095;815;2624;149;568;408;1192;557;1760
315750;201611;1143;3457;992;3168;57;233;732;2305;789;2538
315760;201611;1044;2747;1004;2697;14;48;939;2500;953;2548
315765;201611;1563;4710;1359;4427;57;220;1135;3732;1192;3952
315770;201611;1476;4642;1203;4098;324;1202;294;999;618;2201
315780;201611;23303;74760;20101;67476;4535;16250;7090;22886;11625;39136
315790;201611;3697;12049;3122;10858;778;2691;1629;5804;2407;8495
315800;201611;1449;5550;1049;4320;235;1025;163;620;398;1645
315810;201611;1398;3711;1142;3294;189;567;704;1944;893;2511
315820;201611;2469;8165;2084;7425;681;2482;777;2876;1458;5358
315830;201611;1221;3959;952;3361;111;482;324;998;435;1480
315840;201611;853;2202;502;1517;90;305;145;394;235;699
315850;201611;1020;3566;976;3472;246;970;516;1725;762;2695
315860;201611;527;1756;360;1371;82;367;73;240;155;607
315870;201611;471;1354;376;1197;61;210;194;583;255;793
315880;201611;1219;3099;924;2705;202;707;340;927;542;1634
315890;201611;1525;5085;1301;4666;491;1879;476;1664;967;3543
315895;201611;5559;17175;4491;14681;929;3231;1603;4923;2532;8154
315900;201611;783;2256;737;2173;65;281;590;1605;655;1886
315910;201611;530;1737;480;1644;130;500;266;867;396;1367
315920;201611;1623;4408;817;2647;171;596;161;437;332;1033
315930;201611;1111;2928;747;2266;199;625;189;549;388;1174
315935;201611;956;3148;813;2830;218;843;204;673;422;1516
315940;201611;625;1967;516;1733;102;376;242;789;344;1165
315950;201611;1235;3679;1060;3342;246;745;614;1969;860;2714
315960;201611;3649;11402;2223;8325;745;3181;99;201;844;3382
315970;201611;754;2042;545;1735;48;131;375;1232;423;1363
315980;201611;4082;9919;2381;6979;684;2212;532;1324;1216;3536
315990;201611;4054;11422;3131;9706;573;2036;1502;4448;2075;6484
316000;201611;587;1725;457;1511;127;514;154;466;281;980
316010;201611;652;2087;497;1768;53;227;239;754;292;981
316020;201611;1060;3305;888;2994;121;472;573;1862;694;2334
316030;201611;3222;9283;2250;7461;218;815;1373;4551;1591;5366
316040;201611;3470;10893;2390;8430;391;1535;490;1452;881;2987
316045;201611;2054;6285;1839;5903;264;831;1259;4134;1523;4965
316050;201611;357;1118;265;943;58;245;127;404;185;649
316060;201611;753;2221;575;1933;70;324;335;1025;405;1349
316070;201611;6260;19279;5137;16760;1143;4087;2096;6445;3239;10532
316080;201611;754;2704;627;2370;128;545;76;279;204;824
316090;201611;550;1656;355;1226;57;231;120;378;177;609
316095;201611;1473;4613;1224;4150;186;619;739;2513;925;3132
316100;201611;2804;9080;1909;6839;477;1863;407;1318;884;3181
316105;201611;950;2677;678;2187;171;575;247;806;418;1381
316110;201611;12460;41212;10693;37980;1589;5706;6694;24429;8283;30135
316120;201611;1148;3644;833;2842;215;771;214;620;429;1391
316130;201611;1541;3466;801;2293;132;422;350;916;482;1338
316140;201611;989;2828;741;2426;107;354;446;1477;553;1831
316150;201611;1560;4168;1304;3708;200;651;759;2103;959;2754
316160;201611;1268;3651;914;2932;167;579;410;1252;577;1831
316165;201611;955;2530;756;2228;145;490;403;1160;548;1650
316170;201611;1377;3847;957;3068;157;548;405;1179;562;1727
316180;201611;1452;4480;930;3263;212;827;171;510;383;1337
316190;201611;2905;8881;1343;4763;267;910;244;766;511;1676
316200;201611;3899;12206;2730;9709;590;2352;671;2232;1261;4584
316210;201611;4813;15291;3832;13143;1340;4790;548;1862;1888;6652
316220;201611;790;2424;502;1787;95;372;52;188;147;560
316225;201611;1237;3365;975;2914;159;534;583;1664;742;2198
316230;201611;432;1236;339;1062;44;154;170;570;214;724
316240;201611;6690;20100;5759;18800;665;2080;4142;13721;4807;15801
316245;201611;3293;11165;2937;10516;213;1083;2242;7702;2455;8785
316250;201611;10875;31011;7734;24515;2100;7089;1724;5101;3824;12190
316255;201611;2673;7818;2257;7264;315;1117;1538;4988;1853;6105
316257;201611;1388;3767;979;2989;200;652;309;880;509;1532
316260;201611;1848;5057;1330;4220;213;715;656;2147;869;2862
316265;201611;1348;3765;940;2933;96;346;573;1746;669;2092
316270;201611;3998;13139;3512;12000;918;3396;1300;4240;2218;7636
316280;201611;3246;10324;2814;9421;445;1632;1537;4974;1982;6606
316290;201611;3517;10769;2762;9183;515;1951;1112;3552;1627;5503
316292;201611;3708;11427;3184;10520;497;1842;1949;6157;2446;7999
316294;201611;901;2822;602;2171;127;531;47;162;174;693
316295;201611;1936;6303;1757;5927;189;791;1210;3906;1399;4697
316300;201611;1019;3146;833;2806;68;250;520;1774;588;2024
316310;201611;721;2055;445;1517;86;333;148;462;234;795
316320;201611;627;1947;470;1640;85;336;99;299;184;635
316330;201611;1007;3020;751;2433;86;306;489;1519;575;1825
316340;201611;955;3030;734;2552;145;582;357;1160;502;1742
316350;201611;1338;4173;1139;3804;180;619;669;2228;849;2847
316360;201611;756;1985;584;1726;106;301;365;1096;471;1397
316370;201611;4715;14806;3710;12626;1079;3994;588;1842;1667;5836
316380;201611;1665;4294;1248;3685;70;228;928;2721;998;2949
316390;201611;917;2587;713;2220;163;540;303;956;466;1496
316400;201611;1315;3968;945;3242;207;777;355;1151;562;1928
316410;201611;1087;3550;990;3401;167;587;656;2263;823;2850
316420;201611;1972;6204;1704;5812;145;584;1212;4032;1357;4616
316430;201611;970;2923;647;2218;154;572;146;455;300;1027
316440;201611;676;2198;526;1935;186;796;97;343;283;1139
316443;201611;712;2079;532;1724;141;506;174;511;315;1017
316447;201611;1603;4677;1432;4442;108;363;1183;3671;1291;4034
316450;201611;2205;7258;1779;6358;218;855;1206;4284;1424;5139
316460;201611;761;2331;679;2178;200;663;303;951;503;1614
316470;201611;7463;23523;5589;19480;1509;5905;1437;4676;2946;10581
316480;201611;183;612;148;529;37;136;37;122;74;258
316490;201611;310;943;243;785;45;130;84;248;129;378
316500;201611;1161;4016;686;2595;131;533;39;135;170;668
316510;201611;753;2746;650;2517;231;944;163;616;394;1560
316520;201611;1096;3250;855;2832;146;525;310;919;456;1444
316530;201611;1048;3291;790;2737;165;688;289;823;454;1511
316540;201611;755;2402;636;2154;82;342;226;706;308;1048
316550;201611;1214;3998;1107;3788;198;761;664;2258;862;3019
316553;201611;2033;6988;1513;5664;427;1727;303;1067;730;2794
316555;201611;2858;9608;2495;9108;200;783;1871;6975;2071;7758
316556;201611;655;1640;459;1293;46;141;310;831;356;972
316557;201611;787;2796;721;2666;280;1097;179;599;459;1696
316560;201611;325;1142;265;1008;63;283;60;212;123;495
316570;201611;1259;3988;1039;3507;146;495;509;1734;655;2229
316580;201611;308;847;186;589;44;144;45;137;89;281
316590;201611;1482;3971;985;3075;220;718;473;1367;693;2085
316600;201611;1066;3443;914;3111;257;927;350;1157;607;2084
316610;201611;584;2096;498;1906;88;407;296;1076;384;1483
316620;201611;2198;6567;1800;5825;234;894;1140;3621;1374;4515
316630;201611;1452;4767;1188;4175;499;1798;279;1015;778;2813
316640;201611;177;552;144;469;34;142;63;171;97;313
316650;201611;921;3285;790;3057;95;369;527;2091;622;2460
316660;201611;198;509;85;261;7;27;19;44;26;71
316670;201611;1969;5384;1465;4448;578;1879;388;1052;966;2931
316680;201611;2007;5370;1533;4637;143;451;1117;3348;1260;3799
316690;201611;1182;3972;1009;3574;274;1087;291;1009;565;2096
316695;201611;1103;3409;929;3053;97;342;602;1959;699;2301
316700;201611;373;1094;327;1007;29;125;221;624;250;749
316710;201611;2958;10900;2421;9635;915;3814;512;2176;1427;5990
316720;201611;17251;54526;13140;45162;3375;12027;3445;11363;6820;23390
316730;201611;377;1146;313;1015;83;304;119;350;202;654
316740;201611;686;2250;602;2106;79;329;400;1388;479;1717
316750;201611;409;1363;321;1150;54;224;110;365;164;589
316760;201611;3609;11826;3017;10905;1542;5805;879;3189;2421;8994
316770;201611;1395;3746;1185;3440;70;285;1011;2892;1081;3177
316780;201611;605;1984;485;1730;132;532;67;190;199;722
316790;201611;865;2434;608;1961;146;491;178;568;324;1059
316800;201611;5195;16760;4373;15025;848;3157;2197;7093;3045;10250
316805;201611;815;2036;769;1978;54;137;664;1768;718;1905
316810;201611;627;1875;488;1585;124;446;193;557;317;1003
316820;201611;399;1029;201;666;32;125;29;82;61;207
316830;201611;580;1978;538;1882;158;606;218;736;376;1342
316840;201611;2845;8593;2404;7715;514;1886;1066;3230;1580;5116
316850;201611;2114;6019;1666;5236;266;949;915;2789;1181;3738
316860;201611;18247;56712;14841;49996;3348;12712;5801;18400;9149;31112
316870;201611;6335;20176;4754;16405;1358;5044;853;2790;2211;7834
316880;201611;869;2620;715;2341;215;806;202;632;417;1438
316890;201611;1304;3098;915;2527;242;779;497;1243;739;2022
316900;201611;2613;7650;1909;6130;454;1583;555;1573;1009;3156
316905;201611;469;1533;394;1361;133;482;126;432;259;914
316910;201611;862;2642;576;2039;147;573;75;230;222;803
316920;201611;1630;4320;1067;3443;279;998;372;1134;651;2132
316930;201611;8308;27708;6155;22744;1367;5428;846;2868;2213;8296
316935;201611;5058;14631;3161;10707;869;3129;661;2146;1530;5275
316940;201611;6935;22202;5092;17872;1147;4127;1084;3575;2231;7702
316950;201611;1605;4312;1281;3829;100;342;957;2796;1057;3138
316960;201611;4841;12131;3708;10483;683;2055;2068;5731;2751;7786
316970;201611;3292;10305;2950;9610;692;2539;1157;3432;1849;5971
316980;201611;968;2929;654;2286;200;779;97;313;297;1092
316990;201611;9943;30874;7375;24927;2138;7614;582;1752;2720;9366
317000;201611;2829;9449;2687;9287;277;876;2038;7827;2315;8703
317005;201611;2599;7925;2208;7224;446;1480;1198;3926;1644;5406
317010;201611;31249;76970;17460;54097;4309;14662;3290;10602;7599;25264
317020;201611;66325;178393;34768;112226;7074;24447;7017;20417;14091;44864
317030;201611;715;2080;564;1822;54;221;347;1100;401;1321
317040;201611;10643;30295;7997;25353;2068;6873;2973;9347;5041;16220
317043;201611;724;1915;579;1683;105;294;325;931;430;1225
317047;201611;1148;3016;809;2431;81;252;463;1380;544;1632
317050;201611;1536;5142;1099;4045;238;919;362;1210;600;2129
317052;201611;2303;7374;2072;6972;159;632;1503;4952;1662;5584
317057;201611;1714;4720;1233;3829;103;413;746;2217;849;2630
317060;201611;434;1239;249;816;63;236;56;144;119;380
317065;201611;1306;4013;1128;3678;91;374;822;2614;913;2988
317070;201611;9879;30281;6128;21516;1325;5117;813;2669;2138;7786
317075;201611;1107;3325;814;2646;188;632;184;565;372;1197
317080;201611;6301;16861;4990;14495;1523;4492;1478;4131;3001;8623
317090;201611;4895;15853;4442;15074;540;1741;3072;10585;3612;12326
317100;201611;3108;8319;2136;6601;705;2308;634;1862;1339;4170
317103;201611;1991;6674;1607;5854;221;1039;809;2793;1030;3832
317107;201611;1347;4069;1142;3630;139;533;746;2208;885;2741
317110;201611;700;1718;361;1148;56;214;142;464;198;678
317115;201611;1148;3530;936;3082;97;317;655;2163;752;2480
317120;201611;10765;35474;8358;29584;1832;7045;3257;11061;5089;18106
317130;201611;7686;22414;5939;19031;1343;4637;2214;6913;3557;11550
317140;201611;577;1819;504;1678;73;265;322;1073;395;1338
317150;201611;1014;2744;850;2533;70;242;668;1948;738;2190
317160;201611;3555;9189;2515;7653;183;584;1778;5322;1961;5906
317170;201611;1942;5145;1389;4147;213;712;516;1335;729;2047
317180;201611;1808;6016;1384;5048;356;1366;333;1175;689;2541
317190;201611;1412;3911;1054;3362;97;315;717;2251;814;2566
317200;201611;4613;14220;3711;12259;941;3381;1043;3225;1984;6606
317210;201611;1035;3047;847;2767;118;493;515;1620;633;2113
317220;201611;297;1007;277;974;68;269;130;439;198;708
320010;201611;5078;15709;4160;13726;893;3057;2009;6470;2902;9527
320013;201611;1909;5734;1248;4255;239;839;495;1711;734;2550
320016;201611;3160;8716;2606;7850;282;795;1908;5779;2190;6574
320020;201611;3963;12197;3115;10395;904;3188;929;3078;1833;6266
320030;201611;1700;5352;1208;4210;388;1416;334;1097;722;2513
320035;201611;1822;5328;1503;4790;529;1833;496;1461;1025;3294
320040;201611;3240;10347;2525;8773;566;2080;883;3000;1449;5080
320050;201611;1769;4748;1439;4108;318;968;613;1661;931;2629
320060;201611;11963;37398;8363;28862;1967;7228;1745;5588;3712;12816
320070;201611;1472;4632;1109;3809;234;848;293;923;527;1771
320080;201611;5763;16384;4080;12884;944;3025;1226;3900;2170;6925
320090;201611;8248;23780;6119;19292;1651;5443;2151;6427;3802;11870
320100;201611;2831;8663;2122;7178;649;2231;611;2045;1260;4276
320110;201611;1327;3901;1075;3385;270;841;290;934;560;1775
320115;201611;1790;6315;1585;5913;845;3278;337;1291;1182;4569
320120;201611;16955;50478;12314;41159;3084;11083;3300;10840;6384;21923
320130;201611;37239;118222;32352;107912;6620;24417;15067;48124;21687;72541
320140;201611;3814;11864;2487;8749;656;2490;335;1118;991;3608
320150;201611;15831;43684;10513;32894;2900;9592;1114;3153;4014;12745
320160;201611;5059;15690;4079;13556;1083;3911;1349;4131;2432;8042
320170;201611;1746;5503;1344;4579;326;1160;494;1660;820;2820
320180;201611;776;2597;650;2339;256;955;128;471;384;1426
320190;201611;3712;12667;2730;10106;732;2804;457;1663;1189;4467
320200;201611;1061;3201;823;2762;239;879;223;764;462;1643
320210;201611;4814;13415;3787;11279;803;2620;1722;4727;2525;7347
320220;201611;2449;7501;1916;6417;504;1822;708;2378;1212;4200
320225;201611;1364;4568;1001;3658;368;1447;107;373;475;1820
320230;201611;4384;13809;3518;12186;1090;3990;1259;4374;2349;8364
320240;201611;12957;37725;9746;31613;2561;8758;2749;8847;5310;17605
320245;201611;3414;11533;3027;10550;1013;3718;669;2222;1682;5940
320250;201611;1978;5948;1276;4297;332;1248;215;615;547;1863
320255;201611;1827;6034;1526;5481;659;2522;452;1683;1111;4205
320260;201611;1072;3226;749;2474;192;678;200;574;392;1252
320265;201611;2493;7856;2053;7052;661;2354;794;2755;1455;5109
320270;201611;2749;7996;1920;6315;459;1627;807;2643;1266;4270
320280;201611;6931;20822;5711;18217;1337;4633;1813;5270;3150;9903
320290;201611;1430;4615;925;3309;304;1130;125;458;429;1588
320300;201611;4302;14210;3644;12670;1164;4284;704;2369;1868;6653
320305;201611;4630;14679;3740;12607;940;3395;1438;4617;2378;8012
320310;201611;1991;5843;1572;4948;396;1295;578;1768;974;3063
320313;201611;2286;6483;1391;4423;356;1244;214;592;570;1836
320316;201611;1744;5227;1344;4350;411;1392;385;1213;796;2605
320320;201611;20959;62408;15469;51667;4224;15164;4898;15792;9122;30956
320330;201611;3048;8942;2414;7766;761;2433;875;2979;1636;5412
320332;201611;5464;17493;4592;15788;1549;5664;1528;5126;3077;10790
320334;201611;1987;6190;1240;4485;330;1310;257;858;587;2168
320335;201611;2371;6946;1352;4489;348;1251;141;371;489;1622
320340;201611;6014;15965;4800;13922;1116;3454;2019;5925;3135;9379
320350;201611;5308;13864;3693;10786;751;2219;1642;4716;2393;6935
320360;201611;1757;4631;1203;3524;205;630;469;1293;674;1923
320370;201611;3046;9865;2325;8154;651;2337;651;2245;1302;4582
320380;201611;2260;6612;1896;5910;408;1354;977;2944;1385;4298
320390;201611;7463;22168;5779;18485;1642;5591;1606;4872;3248;10463
320400;201611;3603;10931;2988;9730;730;2582;1294;4026;2024;6608
320405;201611;4390;12625;3668;11302;779;2531;1935;5800;2714;8331
320410;201611;5605;14837;3935;12383;937;3119;1773;5541;2710;8660
320420;201611;2393;7129;1768;5933;552;2031;435;1408;987;3439
320425;201611;2072;5365;1553;4446;195;586;976;2734;1171;3320
320430;201611;2550;7056;2077;6057;410;1234;1107;3096;1517;4330
320435;201611;2810;8991;2183;7651;1041;3800;488;1773;1529;5573
320440;201611;1086;3542;909;3083;218;828;314;994;532;1822
320450;201611;2038;6345;1585;5388;431;1565;626;2051;1057;3616
320455;201611;4312;13970;2940;10537;833;3181;612;2069;1445;5250
320460;201611;2760;8709;1915;6682;480;1816;407;1287;887;3103
320465;201611;1631;4997;1172;3955;187;674;557;1855;744;2529
320470;201611;4560;13510;2873;9647;847;3083;479;1464;1326;4547
320480;201611;1796;5562;1456;4826;378;1361;537;1695;915;3056
320490;201611;16601;50071;13174;43377;3760;13486;3871;12455;7631;25941
320495;201611;1377;3924;800;2688;257;911;82;283;339;1194
320500;201611;49685;147582;41517;131953;9401;31838;19485;59997;28886;91835
320501;201611;4627;14124;3549;12204;1183;4502;859;2702;2042;7204
320503;201611;1891;6379;1425;5314;568;2296;368;1180;936;3476
320506;201611;4052;12404;2527;8611;741;2639;50;130;791;2769
320510;201611;8785;26991;7270;23919;1604;5683;3483;11092;5087;16775
320515;201611;1941;5564;1487;4529;433;1356;308;904;741;2260
320517;201611;2212;7030;1675;5867;544;2052;370;1249;914;3301
320520;201611;38179;113133;29609;96377;7516;26582;10179;32176;17695;58758
320530;201611;28512;84907;22582;72963;4263;15688;11058;33183;15321;48871
330010;201611;20705;62482;17985;57005;4040;13590;9209;28584;13249;42174
330015;201611;1693;4660;1385;4065;219;753;640;1801;859;2554
330020;201611;18107;52502;16033;48809;3053;10141;9161;26924;12214;37065
330022;201611;1932;5619;1559;4962;279;1012;840;2563;1119;3575
330023;201611;3315;10149;2796;9196;789;2775;807;2510;1596;5285
330025;201611;4625;12409;3484;10396;817;2592;1776;5203;2593;7795
330030;201611;8341;27373;7053;24634;1467;5524;3252;10762;4719;16286
330040;201611;12641;36964;10842;33469;2355;7731;5603;16689;7958;24420
330045;201611;74920;201827;62436;182715;8353;25824;41742;119413;50095;145237
330050;201611;2621;7912;2114;6907;610;2183;666;1976;1276;4159
330060;201611;5899;16665;4823;14893;1187;4032;2313;6892;3500;10924
330070;201611;21648;64878;18745;59637;4152;14077;8561;26949;12713;41026
330080;201611;8070;22675;7266;21315;759;2239;5076;14823;5835;17062
330090;201611;2736;7266;2355;6628;415;1270;1280;3469;1695;4739
330093;201611;2133;6199;1678;5355;339;1096;745;2484;1084;3580
330095;201611;1051;3531;879;3131;197;793;286;942;483;1735
330100;201611;59112;183143;52157;170708;8428;30595;29407;94717;37835;125312
330110;201611;2416;7504;2044;6783;514;1793;635;2052;1149;3845
330115;201611;1957;5587;1661;5096;315;1065;864;2530;1179;3595
330120;201611;2701;7322;2325;6730;411;1341;1359;3784;1770;5125
330130;201611;3658;11629;3135;10641;772;2790;1390;4583;2162;7373
330140;201611;3178;9692;2792;9034;582;2092;1488;4697;2070;6789
330150;201611;2418;7075;1786;5763;444;1505;402;1299;846;2804
330160;201611;1206;3752;1022;3412;268;1026;454;1398;722;2424
330170;201611;103190;305755;90324;283114;18789;61010;48394;149388;67183;210398
330180;201611;2071;5981;1661;5188;125;489;1075;3158;1200;3647
330185;201611;8380;25534;7001;22717;1419;4991;3689;11552;5108;16543
330187;201611;3946;11151;3238;9898;507;1673;2028;6052;2535;7725
330190;201611;26430;74427;24227;70782;4206;12885;16233;46941;20439;59826
330200;201611;14461;44938;12504;41350;3300;11178;5842;19405;9142;30583
330205;201611;2221;6033;1844;5347;295;917;1075;3023;1370;3940
330210;201611;3103;8583;2329;6988;706;2138;637;1848;1343;3986
330220;201611;10603;31906;8617;27481;2201;7446;2083;6060;4284;13506
330225;201611;3916;12000;3250;10663;402;1594;1899;5903;2301;7497
330227;201611;17368;49536;15252;46231;3486;10757;8478;25890;11964;36647
330230;201611;1406;4109;1217;3779;238;860;616;1809;854;2669
330240;201611;18516;56061;15087;49151;4806;16712;3985;12267;8791;28979
330245;201611;1308;3955;916;3149;241;892;155;479;396;1371
330250;201611;36649;106292;32077;98018;9673;29546;12205;38257;21878;67803
330260;201611;4115;12764;3386;11177;644;2286;1440;4475;2084;6761
330270;201611;20123;46275;12679;35586;3129;9643;4583;12581;7712;22224
330280;201611;2273;6669;1794;5680;308;1062;881;2594;1189;3656
330285;201611;18825;53218;16429;49333;2859;9140;9906;29224;12765;38364
330290;201611;3469;9733;2975;8887;476;1588;1729;4898;2205;6486
330300;201611;3411;10924;3001;10098;484;1834;1746;5614;2230;7448
330310;201611;2308;6472;1883;5704;271;831;1115;3345;1386;4176
330320;201611;13673;40537;12539;38637;1756;5870;9024;27408;10780;33278
330330;201611;28753;78247;24215;70643;4237;13615;14413;40275;18650;53890
330340;201611;15121;43601;11185;35932;2701;9093;3531;10952;6232;20045
330350;201611;89137;259725;78744;243166;11929;38490;52968;162244;64897;200734
330360;201611;5911;17349;5546;16750;467;1584;4407;13092;4874;14676
330370;201611;3573;12508;3092;11364;1060;3973;912;3346;1972;7319
330380;201611;5139;16403;4134;14245;948;3557;1392;4534;2340;8091
330385;201611;4040;13768;3535;12657;1055;4000;1269;4524;2324;8524
330390;201611;23519;76068;19886;68322;4893;18123;8067;26808;12960;44931
330395;201611;3146;9131;2739;8412;255;933;1851;5495;2106;6428
330400;201611;2679;8271;2353;7640;300;1221;1454;4306;1754;5527
330410;201611;2836;8605;2202;7307;448;1607;973;3082;1421;4689
330411;201611;2448;7594;2050;6706;265;988;1187;3690;1452;4678
330412;201611;1419;4716;1123;4065;228;924;497;1664;725;2588
330414;201611;24646;68813;20887;63073;4438;13114;11773;35827;16211;48941
330415;201611;3643;11018;2917;9583;767;2585;1049;3402;1816;5987
330420;201611;10184;28888;6354;21359;1405;5001;1317;4215;2722;9216
330430;201611;7480;21996;6335;19705;1394;4627;2735;8176;4129;12803
330440;201611;1690;5560;1405;4932;441;1704;335;1045;776;2749
330450;201611;1387;4528;1196;4162;269;1109;597;1984;866;3093
330452;201611;14471;41791;10940;34716;2759;9358;4140;12472;6899;21830
330455;201611;524357;1419670;402914;1212046;90497;284914;198911;584224;289408;869138
330460;201611;1225;3913;1028;3520;210;798;445;1474;655;2272
330470;201611;4517;13472;3880;12259;898;3042;1727;5258;2625;8300
330475;201611;7951;24288;6776;22146;2074;7305;2344;7364;4418;14669
330480;201611;5950;17221;5220;16031;913;2960;3038;9055;3951;12015
330490;201611;112140;292858;96544;267863;10726;31004;68636;188055;79362;219059
330500;201611;5572;16963;5233;16315;759;2579;3464;10622;4223;13201
330510;201611;38111;115331;32869;106166;10849;35175;13035;42672;23884;77847
330513;201611;1511;4449;1347;4143;422;1289;508;1599;930;2888
330515;201611;3079;9397;2583;8392;793;2536;692;2217;1485;4753
330520;201611;11688;34850;10015;31634;2098;6920;4603;14194;6701;21114
330530;201611;1546;4482;1275;3927;327;1100;516;1489;843;2589
330540;201611;3000;8792;2354;7517;615;2045;811;2463;1426;4508
330550;201611;7959;26332;6682;23641;2885;10543;891;3128;3776;13671
330555;201611;10536;30654;9023;28263;1826;5795;5224;16637;7050;22432
330560;201611;4362;12958;3738;11690;653;2213;1936;5737;2589;7950
330570;201611;3425;9988;2780;8775;754;2461;1261;3933;2015;6394
330575;201611;5364;15266;4668;13930;689;2327;3013;8555;3702;10882
330580;201611;14213;44330;11534;38579;3172;11022;4185;13884;7357;24906
330590;201611;1627;4930;1481;4671;261;862;948;2975;1209;3837
330600;201611;11160;32279;8480;27357;1414;5036;4160;12954;5574;17990
330610;201611;9070;27989;7865;25620;1298;4720;4406;13845;5704;18565
330615;201611;1695;5899;1501;5469;669;2589;341;1259;1010;3848
330620;201611;3567;12202;3006;10940;982;3833;631;2222;1613;6055
330630;201611;23959;69463;18693;59481;3064;10951;10258;30936;13322;41887
350010;201611;2039;5983;1253;4301;317;1129;141;440;458;1569
350020;201611;483;1308;300;930;48;166;155;443;203;609
350030;201611;4537;14092;3320;11525;1077;3951;767;2549;1844;6500
350040;201611;491;1658;345;1310;80;326;97;346;177;672
350050;201611;938;2814;708;2346;167;642;230;636;397;1278
350055;201611;645;1883;533;1692;103;338;298;917;401;1255
350060;201611;120;360;95;319;23;89;44;146;67;235
350070;201611;3870;11436;2240;7754;466;1677;485;1495;951;3172
350075;201611;522;1726;379;1405;145;538;64;220;209;758
350080;201611;652;1869;375;1232;67;240;139;420;206;660
350090;201611;642;1655;382;1151;108;308;131;398;239;706
350100;201611;1933;5988;1296;4592;273;1080;403;1315;676;2395
350110;201611;478;1436;337;1117;35;137;187;600;222;737
350115;201611;1265;3773;1064;3338;199;697;548;1531;747;2228
350120;201611;636;1686;275;895;63;214;50;148;113;362
350130;201611;3421;10112;2827;8825;400;1393;1573;4604;1973;5997
350140;201611;611;1967;486;1714;66;275;254;855;320;1130
350150;201611;428;1405;358;1249;115;427;74;255;189;682
350160;201611;8396;24252;5329;17864;1187;4376;2205;6696;3392;11072
350170;201611;1675;5676;1347;4797;341;1278;281;924;622;2202
350180;201611;1112;3078;669;2069;123;379;305;914;428;1293
350190;201611;3149;9712;2397;8001;541;2070;1021;2904;1562;4974
350200;201611;387;1188;331;1081;29;94;220;714;249;808
350210;201611;5216;13797;3633;11022;1015;3249;1451;4269;2466;7518
350220;201611;2675;8397;2203;7300;483;1893;912;2722;1395;4615
350230;201611;758;2417;646;2178;146;526;269;881;415;1407
350240;201611;516;1560;394;1265;50;172;231;713;281;885
350250;201611;2093;7441;1876;6995;673;2660;528;1939;1201;4599
350260;201611;994;2637;640;1953;109;340;289;845;398;1185
350270;201611;5057;15274;4076;13039;755;2551;1783;5403;2538;7954
350275;201611;2030;6569;1784;6117;528;1904;630;2074;1158;3978
350280;201611;22508;54509;12511;36602;2758;8377;3188;8978;5946;17355
350290;201611;2156;6816;1574;5498;350;1322;489;1587;839;2909
350300;201611;546;1543;380;1175;90;278;191;568;281;846
350310;201611;876;2877;702;2441;95;395;306;996;401;1391
350315;201611;529;1656;373;1283;61;255;88;258;149;513
350320;201611;10487;32663;8791;29143;2515;8652;1297;4342;3812;12994
350330;201611;14552;40070;8940;27076;2022;5887;3133;8886;5155;14773
350335;201611;373;1159;316;1038;25;71;237;782;262;853
350340;201611;1141;3358;728;2493;141;530;230;769;371;1299
350350;201611;729;2242;582;1961;109;399;193;623;302;1022
350360;201611;857;2896;693;2500;166;587;266;985;432;1572
350370;201611;616;1812;403;1319;89;311;77;233;166;544
350380;201611;4375;12516;2795;9507;740;2712;711;2145;1451;4857
350390;201611;9343;28452;7740;25150;2329;7716;2775;8688;5104;16404
350395;201611;384;1048;177;601;24;86;49;147;73;233
350400;201611;8056;22924;6056;19043;1415;4844;2292;6760;3707;11604
350410;201611;8468;27844;6173;22673;1697;6687;1137;3897;2834;10584
350420;201611;568;1747;390;1403;88;369;24;81;112;450
350430;201611;749;2285;593;1987;96;364;336;1079;432;1443
350440;201611;1309;4053;1069;3456;260;821;480;1538;740;2359
350450;201611;7793;23753;5785;19393;1340;4773;1422;4443;2762;9216
350460;201611;1481;4045;846;2731;162;591;303;873;465;1464
350470;201611;249;675;195;581;29;111;120;323;149;434
350480;201611;822;2450;517;1776;80;301;96;295;176;596
350490;201611;1870;5529;1480;4790;352;1214;518;1516;870;2730
350500;201611;583;1734;484;1536;84;313;247;749;331;1062
350510;201611;1129;3368;780;2587;128;473;331;1018;459;1491
350520;201611;1489;5457;1094;4374;228;979;267;1011;495;1990
350530;201611;2447;7083;1869;5847;563;1772;550;1619;1113;3391
350535;201611;1257;4038;1149;3824;175;718;738;2309;913;3027
350540;201611;1810;5047;1314;4133;357;1149;449;1418;806;2567
350550;201611;11136;29480;7186;22559;1448;5064;2566;7491;4014;12555
350560;201611;3439;11125;2864;9748;396;1364;1595;5378;1991;6742
350570;201611;18639;60670;15809;54466;4932;18034;5495;17757;10427;35791
350580;201611;1784;5631;1054;3734;206;770;113;317;319;1087
350590;201611;4145;12693;3044;10330;791;2977;1111;3368;1902;6345
350600;201611;42905;104947;26063;74197;4520;13607;11552;30410;16072;44017
350610;201611;7310;21348;5548;17951;1203;4161;2331;7227;3534;11388
350620;201611;409;1151;291;956;49;188;123;358;172;546
350630;201611;1638;4704;1117;3668;193;756;446;1281;639;2037
350635;201611;6681;19480;4943;16192;1160;4143;2026;6291;3186;10434
350640;201611;808;2482;497;1679;85;302;110;342;195;644
350650;201611;8092;24236;4588;15694;1103;4052;849;2576;1952;6628
350660;201611;4868;13973;3670;11700;744;2497;1843;5691;2587;8188
350670;201611;1600;4917;1411;4528;299;985;769;2409;1068;3394
350680;201611;1119;3288;785;2594;180;653;309;993;489;1646
350690;201611;901;2910;662;2354;143;551;217;707;360;1258
350700;201611;4338;12700;2737;9581;764;2834;825;2569;1589;5403
350710;201611;2751;8428;2288;7473;358;1281;1303;4123;1661;5404
350715;201611;806;2415;680;2154;165;555;293;847;458;1402
350720;201611;130;369;108;328;32;95;32;96;64;191
350730;201611;404;1467;367;1370;80;329;149;538;229;867
350740;201611;1833;5548;1208;4022;212;781;334;978;546;1759
350745;201611;509;1574;285;976;42;145;132;415;174;560
350750;201611;10096;30326;7634;25133;1741;6199;1877;5615;3618;11814
350760;201611;13375;38621;10027;32131;2591;8912;2708;7700;5299;16612
350770;201611;729;2043;472;1512;54;183;264;819;318;1002
350775;201611;603;1601;476;1389;61;222;244;667;305;889
350780;201611;1923;5826;1352;4615;445;1621;183;610;628;2231
350790;201611;1948;5961;1314;4600;292;1066;231;693;523;1759
350800;201611;3016;9856;2723;9264;490;1876;1441;4686;1931;6562
350810;201611;2064;5756;1709;5233;467;1505;738;2293;1205;3798
350820;201611;591;1609;387;1190;64;227;167;481;231;708
350830;201611;874;2674;518;1816;75;281;134;412;209;693
350840;201611;2460;8617;1925;7302;613;2397;404;1455;1017;3852
350850;201611;6063;19951;4840;17088;1539;5697;1030;3512;2569;9209
350860;201611;3267;9967;3017;9536;205;836;2346;7239;2551;8075
350870;201611;2751;8637;2139;7497;459;1808;1195;4148;1654;5956
350880;201611;1379;4531;1054;3728;238;872;249;842;487;1714
350890;201611;665;1871;364;1178;43;154;107;284;150;438
350900;201611;4334;13592;2903;10252;878;3301;272;879;1150;4180
350910;201611;856;2503;719;2213;207;686;308;892;515;1578
350920;201611;10778;30292;9262;27442;933;3091;6703;18992;7636;22083
350925;201611;4550;14091;3465;11771;851;3056;1156;3370;2007;6426
350930;201611;1617;4415;1147;3454;138;448;681;1938;819;2386
350940;201611;1891;6119;1659;5680;312;1205;937;3072;1249;4277
350945;201611;970;2980;749;2529;128;502;382;1191;510;1693
350950;201611;76867;227856;58581;187303;12439;42918;25956;77489;38395;120407
350960;201611;4868;15905;3969;13888;787;3095;2038;6690;2825;9785
350970;201611;4345;14780;3409;12458;1111;4304;585;1822;1696;6126
350980;201611;599;1929;515;1771;218;806;144;478;362;1284
350990;201611;1810;5965;1376;5067;378;1484;374;1303;752;2787
350995;201611;776;2613;711;2467;96;438;462;1488;558;1926
351000;201611;3057;9017;2372;7623;417;1431;972;2896;1389;4327
351010;201611;375;1055;207;670;47;166;71;225;118;391
351015;201611;826;2773;677;2475;145;565;308;1107;453;1672
351020;201611;8384;25550;6935;23009;1773;6069;3116;10347;4889;16416
351030;201611;1883;6517;1527;5585;364;1473;471;1588;835;3061
351040;201611;3584;10587;3136;9737;432;1508;2148;6424;2580;7932
351050;201611;15538;43086;10096;33021;2632;9119;2943;9335;5575;18454
351060;201611;37414;107439;29186;91851;5761;19773;14316;43324;20077;63097
351070;201611;1450;4023;866;2883;201;730;88;237;289;967
351080;201611;2678;7697;2002;6730;488;1760;877;2774;1365;4534
351090;201611;363;1226;258;984;59;247;43;157;102;404
351100;201611;2431;7199;1545;5016;394;1307;423;1369;817;2676
351110;201611;7313;18667;3805;12445;867;3107;921;2817;1788;5924
351120;201611;666;1920;482;1507;73;268;226;591;299;859
351130;201611;1002;2788;483;1668;86;308;95;289;181;597
351140;201611;1716;5738;1346;4889;431;1676;276;901;707;2577
351150;201611;1548;5301;990;3804;187;729;121;385;308;1114
351160;201611;1294;4440;1075;3882;263;999;326;1084;589;2083
351170;201611;1440;4529;1133;3807;186;663;533;1660;719;2323
351190;201611;812;2560;589;1982;98;330;188;591;286;921
351200;201611;2019;5863;1580;4956;237;835;638;1838;875;2673
351210;201611;1182;3387;781;2533;135;466;301;883;436;1349
351220;201611;3286;10859;2864;9907;504;1885;1419;4753;1923;6638
351230;201611;1815;5559;1427;4776;284;1099;698;2182;982;3281
351240;201611;1093;3342;760;2575;204;685;239;753;443;1438
351250;201611;1008;2882;557;1828;95;315;202;619;297;934
351260;201611;932;2707;752;2321;220;661;246;728;466;1389
351270;201611;344;1153;288;1034;70;267;95;284;165;551
351280;201611;5021;14275;3442;10966;661;2278;1347;4005;2008;6283
351290;201611;1037;2941;692;2211;153;507;280;847;433;1354
351300;201611;13145;42055;9257;33351;2223;8709;2883;9962;5106;18671
351310;201611;3178;9512;2422;8005;462;1711;1118;3384;1580;5095
351320;201611;834;2768;638;2232;126;491;228;723;354;1214
351330;201611;280;777;205;640;73;212;39;112;112;324
351340;201611;5500;18191;4434;15925;1311;4885;1550;5429;2861;10314
351350;201611;7780;24710;6479;21844;1772;6183;2269;7230;4041;13413
351360;201611;4122;12603;3603;11521;870;3081;1124;3176;1994;6257
351370;201611;2331;7115;1713;5710;363;1336;670;1999;1033;3335
351380;201611;39339;112955;33749;101868;6771;21688;14765;43166;21536;64854
351385;201611;273;813;182;610;29;106;72;212;101;318
351390;201611;1219;3814;958;3252;237;959;394;1160;631;2119
351400;201611;960;3121;875;2915;244;875;415;1346;659;2221
351410;201611;2510;7484;2072;6589;341;1080;1197;3732;1538;4812
351420;201611;322;915;205;675;42;140;52;169;94;309
351430;201611;848;2646;781;2529;135;470;530;1697;665;2167
351440;201611;3518;10409;2384;7785;514;1709;327;955;841;2664
351450;201611;1637;4578;1204;3785;335;1100;413;1317;748;2417
351460;201611;737;2165;601;1906;310;982;143;446;453;1428
351470;201611;1027;3030;851;2670;167;584;406;1195;573;1779
351480;201611;2780;8847;2463;8263;383;1606;1373;4322;1756;5928
351490;201611;1851;6002;1565;5333;161;678;943;3005;1104;3683
351492;201611;271;855;203;676;12;45;119;385;131;430
351495;201611;199;636;141;481;31;127;61;192;92;319
351500;201611;28929;80338;20272;63502;5156;17205;8030;23598;13186;40803
351510;201611;9192;27674;7103;23304;1706;5895;3315;10576;5021;16471
351512;201611;492;1416;340;1055;54;160;159;486;213;646
351515;201611;2336;7136;1508;5218;369;1372;381;1136;750;2508
351518;201611;2170;6567;1400;5026;339;1351;478;1530;817;2881
351519;201611;806;2357;529;1718;84;310;149;359;233;669
351520;201611;825;2234;376;1311;61;248;67;209;128;457
351530;201611;397;1220;225;753;30;97;57;153;87;250
351535;201611;2403;6099;1764;5051;132;459;1204;3274;1336;3733
351540;201611;1749;5210;1307;4277;442;1542;176;532;618;2074
351550;201611;5542;16061;3611;11708;660;2356;1414;4321;2074;6677
351560;201611;419;1338;339;1146;73;281;48;147;121;428
351565;201611;180;594;151;517;31;106;56;180;87;286
351570;201611;13128;39047;10484;33417;2162;7450;5731;17446;7893;24896
351580;201611;331;887;169;526;50;139;35;118;85;257
351590;201611;448;1132;265;773;24;73;134;365;158;438
351600;201611;1822;5002;1427;4252;172;592;860;2412;1032;3004
351610;201611;678;1814;461;1415;52;176;224;605;276;781
351620;201611;19553;61475;14292;50038;2929;11261;3932;12174;6861;23435
351630;201611;21360;65034;18490;59853;4164;14087;10197;32117;14361;46204
351640;201611;13222;38978;10430;33642;1771;6189;6133;19142;7904;25331
351650;201611;459;1364;194;673;36;141;37;101;73;242
351660;201611;806;2516;526;1777;114;400;101;292;215;692
351670;201611;4081;12738;3089;10296;573;2106;1392;4304;1965;6410
351680;201611;619;1879;320;1095;68;226;66;215;134;441
351685;201611;422;1305;347;1151;94;283;143;483;237;766
351690;201611;1136;3311;753;2446;125;416;306;908;431;1324
351700;201611;1156;3371;942;2924;233;694;345;1062;578;1756
351710;201611;582;1898;455;1580;76;259;182;602;258;861
351720;201611;1613;4857;1020;3400;199;708;311;969;510;1677
351730;201611;1118;3141;835;2657;183;639;359;1101;542;1740
351740;201611;3953;10761;2910;8582;591;1823;1172;3228;1763;5051
351750;201611;1103;3477;617;2267;124;469;177;650;301;1119
351760;201611;3522;10810;2617;8726;720;2586;755;2259;1475;4845
351770;201611;2216;6923;1796;6059;530;1867;702;2267;1232;4134
351780;201611;1586;4377;768;2445;127;452;186;542;313;994
351790;201611;1140;3197;930;2838;210;607;470;1451;680;2058
351800;201611;474;1058;220;598;40;108;74;203;114;311
351810;201611;1053;2983;865;2640;109;322;596;1779;705;2101
351820;201611;2462;7737;1621;5748;316;1165;150;513;466;1678
351830;201611;4137;12683;2986;10087;519;1944;1494;4737;2013;6681
351840;201611;7336;24319;6063;21523;1504;5673;2132;7241;3636;12914
351850;201611;2056;5465;1319;4131;181;702;682;1887;863;2589
351860;201611;3456;10814;2849;9477;704;2476;1226;3930;1930;6406
351870;201611;28639;84455;22980;73643;6936;23070;8814;27893;15750;50963
351880;201611;117306;360840;93472;309473;27607;96066;24487;75689;52094;171755
351885;201611;644;2194;560;1996;159;582;216;730;375;1312
351890;201611;656;2002;468;1585;108;387;72;220;180;607
351900;201611;1258;3802;991;3309;265;914;301;973;566;1887
351905;201611;485;1514;368;1266;48;171;193;617;241;788
351907;201611;19113;55471;15165;47610;1425;5390;10116;30393;11541;35783
351910;201611;1055;3234;799;2630;181;623;321;993;502;1616
351920;201611;1019;2743;818;2412;103;346;481;1368;584;1714
351925;201611;960;2917;754;2463;128;472;329;978;457;1450
351930;201611;2792;8842;2612;8483;635;2304;1640;5042;2275;7346
351940;201611;1008;3023;795;2583;148;508;374;1196;522;1704
351950;201611;1491;4042;971;3018;127;422;489;1482;616;1904
351960;201611;4550;13007;3160;10256;738;2614;1325;4151;2063;6765
351970;201611;5595;19763;4802;18006;1303;5243;1736;6193;3039;11436
351980;201611;939;2753;628;2039;132;468;215;604;347;1072
351990;201611;1552;4290;1074;3316;214;784;241;594;455;1378
352000;201611;2417;7737;2061;6919;399;1435;1005;3122;1404;4557
352010;201611;1699;5651;1381;4877;316;1163;238;838;554;2001
352020;201611;1462;4490;1203;3953;298;1034;461;1440;759;2474
352030;201611;4879;14030;3867;12434;882;2974;1974;6307;2856;9281
352040;201611;2027;6513;1440;5113;297;1135;239;766;536;1901
352042;201611;3538;9644;2033;6329;417;1364;898;2711;1315;4075
352044;201611;1713;5165;946;3455;159;591;193;634;352;1225
352050;201611;10844;32671;6711;23050;1558;5799;1246;3715;2804;9514
352060;201611;752;2251;572;1850;114;425;229;655;343;1080
352070;201611;822;2058;616;1697;139;407;216;583;355;990
352080;201611;460;1324;276;900;53;183;100;298;153;481
352090;201611;1212;4174;935;3428;163;638;241;801;404;1439
352100;201611;2942;8878;2170;7340;586;2100;863;2707;1449;4807
352110;201611;513;1765;418;1546;108;415;147;512;255;927
352115;201611;482;1503;395;1328;50;160;242;803;292;963
352120;201611;904;2830;684;2383;119;471;348;1096;467;1567
352130;201611;1865;5378;1126;3717;277;933;241;729;518;1662
352140;201611;1771;5053;967;3244;162;566;356;1128;518;1694
352150;201611;795;2350;585;1920;157;536;270;859;427;1395
352160;201611;1017;2760;727;2210;153;495;238;628;391;1123
352170;201611;2760;8244;2338;7276;459;1526;1183;3421;1642;4947
352180;201611;3287;9277;2613;7879;657;2084;910;2583;1567;4667
352190;201611;1188;3508;896;2863;149;561;310;804;459;1365
352200;201611;378;1291;266;1022;43;183;97;345;140;528
352210;201611;16869;45029;13134;39169;2285;7211;7937;23548;10222;30759
352215;201611;535;1636;470;1518;65;234;281;871;346;1105
352220;201611;12891;40430;10067;34381;3333;12047;2322;7778;5655;19825
352230;201611;12749;42285;10341;37195;2866;11094;3389;11411;6255;22505
352240;201611;12466;35622;9186;29490;2667;9460;2744;7772;5411;17232
352250;201611;22927;72518;19073;64240;5850;20732;5922;19470;11772;40202
352260;201611;5363;15101;3215;10413;691;2432;1162;3382;1853;5814
352265;201611;872;2712;718;2424;73;311;469;1497;542;1808
352270;201611;1750;5965;1357;5007;341;1324;345;1236;686;2560
352280;201611;2251;6639;1710;5566;424;1516;653;1958;1077;3474
352290;201611;1173;3647;941;3103;192;743;384;1131;576;1874
352300;201611;1013;2914;694;2222;139;493;315;915;454;1408
352310;201611;44329;129105;33682;109108;9588;31702;15187;48646;24775;80348
352320;201611;5622;17079;4520;14682;1197;4053;1421;4121;2618;8174
352330;201611;2022;6345;1641;5730;527;1969;459;1530;986;3499
352340;201611;5384;16872;3796;13554;1051;3973;772;2482;1823;6455
352350;201611;1687;5630;1439;5053;249;997;529;1711;778;2708
352360;201611;1092;3305;939;3002;178;677;602;1800;780;2477
352370;201611;870;2922;747;2623;111;437;394;1315;505;1752
352380;201611;1006;3147;807;2733;232;865;184;577;416;1442
352390;201611;19387;50746;11753;35901;2103;7219;5734;16061;7837;23280
352400;201611;3817;10818;2337;7767;688;2342;547;1673;1235;4015
352410;201611;2921;8761;2370;7749;549;1867;972;3029;1521;4896
352420;201611;907;2475;678;2021;159;488;283;798;442;1286
352430;201611;6457;19031;5076;16572;1746;6089;1458;4622;3204;10711
352440;201611;16000;48098;12196;40110;2858;9949;4646;14608;7504;24557
352450;201611;700;2138;421;1477;93;358;115;359;208;717
352460;201611;2385;7547;1843;6400;506;1896;506;1566;1012;3462
352470;201611;3579;9980;2369;7551;338;1181;1104;3219;1442;4400
352480;201611;4384;11786;3093;9275;659;2215;1186;3131;1845;5346
352490;201611;689;2380;517;1923;91;359;134;488;225;847
352500;201611;8535;24047;6913;21323;3371;10730;1391;3535;4762;14265
352510;201611;3000;9377;2278;7912;672;2475;559;1877;1231;4352
352520;201611;2022;7066;1711;6272;463;1779;633;2254;1096;4033
352530;201611;8630;27205;5831;20277;1468;5396;755;2096;2223;7492
352540;201611;511;1592;325;1133;55;191;101;341;156;532
352550;201611;860;2796;543;2025;137;548;115;372;252;920
352560;201611;656;1940;412;1352;66;211;97;270;163;481
352570;201611;1864;5994;1262;4599;295;1181;182;545;477;1726
352580;201611;883;2615;638;2079;133;443;217;628;350;1071
352585;201611;262;825;195;667;37;139;70;232;107;371
352590;201611;12680;38504;9753;32398;3284;11468;3522;10748;6806;22216
352600;201611;1839;5586;1422;4640;336;1162;566;1728;902;2890
352610;201611;3356;10231;2501;8541;652;2441;722;2257;1374;4698
352620;201611;5361;16117;4613;14799;1130;3726;2142;6661;3272;10387
352630;201611;675;2097;586;1875;131;479;229;652;360;1131
352640;201611;2732;8225;2172;7065;240;856;1313;4162;1553;5018
352650;201611;824;2445;525;1733;98;334;151;446;249;780
352660;201611;1070;3615;794;2962;164;672;210;766;374;1438
352670;201611;11248;33185;6023;21122;1403;5310;499;1580;1902;6890
352680;201611;2880;9489;2072;7540;469;1888;724;2341;1193;4229
352690;201611;31704;86476;21214;64734;3108;10315;11172;32200;14280;42515
352700;201611;619;1823;499;1618;145;522;197;587;342;1109
352710;201611;5448;15588;3728;11954;993;3427;1218;3611;2211;7038
352720;201611;7764;24764;6574;21882;2202;7414;1805;5792;4007;13206
352725;201611;439;1237;214;710;31;123;87;260;118;383
352730;201611;2319;7582;1994;6701;417;1491;750;2199;1167;3690
352740;201611;2193;5866;1619;4866;235;825;940;2639;1175;3464
352750;201611;477;1370;234;794;27;106;55;170;82;276
352760;201611;1231;4123;908;3250;299;1090;211;697;510;1787
352770;201611;787;2425;622;2059;137;492;242;745;379;1237
352780;201611;646;2144;471;1700;90;350;152;517;242;867
352790;201611;638;1816;421;1387;85;290;117;370;202;660
352800;201611;1073;3764;722;2766;164;666;206;698;370;1364
352810;201611;1191;3088;710;2124;139;431;222;621;361;1052
352820;201611;656;1766;431;1378;94;325;97;284;191;609
352830;201611;540;1541;275;887;46;164;42;110;88;274
352840;201611;3914;12992;3342;11706;947;3445;1284;4312;2231;7757
352850;201611;9874;28161;6999;23153;1891;6603;2400;7628;4291;14231
352860;201611;839;2797;728;2535;158;591;255;822;413;1413
352870;201611;960;2391;591;1616;72;259;323;755;395;1014
352880;201611;2385;6530;1586;4821;277;860;603;1668;880;2528
352885;201611;243;796;215;731;22;80;143;469;165;549
352890;201611;685;1782;436;1257;63;223;186;460;249;683
352900;201611;20213;58256;13631;44331;2848;10000;4877;14738;7725;24738
352910;201611;372;1068;194;651;20;70;44;133;64;203
352920;201611;2510;7471;1783;5869;355;1283;776;2348;1131;3631
352930;201611;5812;17834;4284;14341;940;3344;1325;4128;2265;7472
352940;201611;20951;66703;16206;55350;5137;18843;1559;4508;6696;23351
352950;201611;361;1052;203;737;52;217;30;92;82;309
352960;201611;638;1901;339;1174;51;195;90;267;141;462
352965;201611;376;1057;217;684;46;145;36;97;82;242
352970;201611;3266;8042;2535;6917;262;746;1759;4784;2021;5530
352980;201611;1048;3298;862;2979;183;637;486;1718;669;2355
352990;201611;4122;12664;3463;11420;909;3293;1411;4308;2320;7601
353000;201611;444;1246;212;699;27;90;42;125;69;215
353010;201611;3027;8299;2012;6255;483;1646;554;1482;1037;3128
353020;201611;4136;11170;2146;6701;399;1282;731;2010;1130;3292
353030;201611;3857;11256;2878;9277;814;2749;515;1569;1329;4318
353040;201611;565;1562;441;1312;106;344;137;373;243;717
353050;201611;4863;16046;3776;13553;1077;4009;1280;4368;2357;8377
353060;201611;40819;118215;33870;105679;3883;14204;23754;70160;27637;84364
353070;201611;10676;32680;7085;24607;1747;6385;1817;6180;3564;12565
353080;201611;5215;16240;3356;11969;776;2981;817;2675;1593;5656
353090;201611;554;1843;476;1644;43;178;292;935;335;1113
353100;201611;294;822;119;397;19;62;24;65;43;127
353110;201611;7617;23009;6361;20843;1282;4508;3723;12129;5005;16637
353120;201611;675;2006;405;1370;78;287;106;298;184;585
353130;201611;2543;7277;1912;6184;605;2067;587;1819;1192;3886
353140;201611;2401;6508;1730;5119;376;1189;792;2203;1168;3392
353150;201611;1664;4970;1266;4208;345;1154;339;1116;684;2270
353160;201611;674;1867;400;1278;88;292;89;232;177;524
353170;201611;450;1385;375;1266;102;436;181;531;283;967
353180;201611;8653;24199;6614;20479;1108;3665;3842;11578;4950;15243
353190;201611;3771;11236;2910;9242;505;1746;1497;4416;2002;6162
353200;201611;1054;3482;730;2607;204;784;178;571;382;1355
353205;201611;379;1211;322;1090;77;264;132;444;209;708
353210;201611;1020;2548;627;1810;40;140;404;1101;444;1241
353215;201611;410;1263;315;1041;50;190;109;298;159;488
353220;201611;668;2040;501;1659;132;446;113;345;245;791
353230;201611;787;2524;678;2300;164;611;194;597;358;1208
353240;201611;2118;6681;1767;5943;340;1270;930;2980;1270;4250
353250;201611;1097;2945;772;2287;113;364;375;1054;488;1418
353260;201611;925;2564;622;1952;106;369;214;627;320;996
353270;201611;657;1887;525;1619;105;326;214;623;319;949
353280;201611;611;1976;446;1564;115;430;88;280;203;710
353282;201611;1789;5588;1568;5114;234;826;928;2880;1162;3706
353284;201611;363;958;185;574;31;97;47;134;78;231
353286;201611;149;455;104;357;20;66;18;62;38;128
353290;201611;785;2411;599;2017;82;340;343;1051;425;1391
353300;201611;1477;4545;1145;3756;260;951;408;1187;668;2138
353310;201611;211;624;162;539;50;173;51;162;101;335
353320;201611;583;1646;454;1389;72;228;234;680;306;908
353325;201611;621;2001;448;1574;62;220;140;469;202;689
353330;201611;622;1749;406;1256;71;250;194;558;265;808
353340;201611;2844;8243;1786;6105;589;2081;446;1489;1035;3570
353350;201611;3291;9790;2384;7790;699;2408;640;1913;1339;4321
353360;201611;469;1530;412;1405;43;169;273;914;316;1083
353370;201611;642;2088;524;1805;61;240;290;951;351;1191
353380;201611;321;1056;238;862;41;166;74;256;115;422
353390;201611;5757;15623;3710;11688;779;2534;1307;3897;2086;6431
353400;201611;493;1497;366;1197;93;316;81;219;174;535
353410;201611;641;1866;496;1570;107;379;248;732;355;1111
353420;201611;591;1672;344;1057;104;311;79;227;183;538
353430;201611;2282;7547;1524;5594;393;1487;240;814;633;2301
353440;201611;59417;185414;45061;151807;12261;42573;15337;49522;27598;92095
353450;201611;426;1243;314;990;67;232;118;339;185;571
353460;201611;3330;9420;2405;7552;352;1216;1154;3589;1506;4805
353470;201611;8158;24278;5555;18759;1231;4534;1295;3939;2526;8473
353475;201611;1542;4376;1045;3213;177;597;354;965;531;1562
353480;201611;1468;4426;1278;4039;178;578;827;2558;1005;3136
353490;201611;988;2859;702;2213;156;496;242;729;398;1225
353500;201611;1029;2727;819;2367;235;690;404;1135;639;1825
353510;201611;998;3160;687;2350;155;552;126;381;281;933
353520;201611;1139;3233;817;2637;128;459;367;1114;495;1573
353530;201611;2552;7394;2061;6405;323;1116;1124;3327;1447;4443
353540;201611;1985;5982;1632;5324;426;1453;675;2122;1101;3575
353550;201611;6421;17666;4893;14846;536;1875;3080;8745;3616;10620
353560;201611;2057;6743;1605;5820;465;1832;387;1257;852;3089
353570;201611;492;1460;329;1074;83;270;141;431;224;701
353580;201611;2487;7236;2088;6497;361;1242;1278;3889;1639;5131
353590;201611;754;2179;498;1608;125;432;157;490;282;922
353600;201611;1778;4876;1451;4224;221;694;760;2097;981;2791
353610;201611;616;2044;421;1599;82;354;81;267;163;621
353620;201611;2267;7149;1761;6034;423;1495;475;1491;898;2986
353625;201611;395;1112;233;784;47;167;82;280;129;447
353630;201611;1500;5179;1093;4068;187;746;143;433;330;1179
353640;201611;1369;4012;968;3103;115;389;487;1512;602;1901
353650;201611;8284;24142;5631;18192;1093;3654;2241;6824;3334;10478
353657;201611;306;960;246;829;41;158;93;289;134;447
353660;201611;1069;2786;729;2122;288;877;74;137;362;1014
353670;201611;3667;11626;2977;10102;929;3491;983;3028;1912;6519
353680;201611;744;2340;592;2057;182;710;204;664;386;1374
353690;201611;522;1402;252;830;49;171;48;116;97;287
353700;201611;2044;6160;1679;5392;223;771;868;2624;1091;3395
353710;201611;3272;7858;1372;4496;356;1126;271;852;627;1978
353715;201611;505;1442;305;994;28;102;93;276;121;378
353720;201611;2043;6198;1632;5487;323;1283;832;2578;1155;3861
353730;201611;4581;13728;3314;10783;657;2336;1135;3324;1792;5660
353740;201611;1865;5499;1312;4315;355;1225;323;1005;678;2230
353750;201611;865;2884;604;2229;126;506;124;445;250;951
353760;201611;10207;27476;7996;24132;1166;4044;5124;14888;6290;18932
353770;201611;732;2275;350;1242;48;178;22;44;70;222
353780;201611;4216;14441;3497;12835;1069;4082;902;3250;1971;7332
353790;201611;2198;7419;1682;6262;471;1990;387;1330;858;3320
353800;201611;16538;49825;12307;41474;3254;11667;4516;14627;7770;26294
353810;201611;1027;3248;727;2550;134;523;240;798;374;1321
353820;201611;1411;4661;1174;4066;233;930;584;1850;817;2780
353830;201611;679;1811;505;1510;86;276;274;776;360;1052
353850;201611;1715;5280;1419;4648;362;1218;527;1664;889;2882
353860;201611;2571;8386;1999;7025;562;2072;502;1673;1064;3745
353870;201611;27835;80326;17849;58918;3465;12389;6394;18723;9859;31112
353880;201611;2750;8605;2204;7536;289;1134;1231;4099;1520;5233
353890;201611;2692;6547;1724;4888;286;878;881;2340;1167;3218
353900;201611;979;2995;652;2289;132;509;169;553;301;1062
353910;201611;1247;4235;1120;3978;292;1063;593;2113;885;3176
353920;201611;2308;6704;1431;4759;328;1191;263;726;591;1917
353930;201611;4539;13581;2932;10321;758;2863;499;1671;1257;4534
353940;201611;1211;3832;839;2927;161;587;265;845;426;1432
353950;201611;3237;10199;2712;9021;579;2054;1281;3954;1860;6008
353960;201611;612;1895;424;1434;92;324;93;281;185;605
353970;201611;595;1698;453;1444;52;177;283;890;335;1067
353980;201611;13436;39695;10859;34422;2428;8008;5218;15883;7646;23891
353990;201611;402;1234;341;1089;42;158;192;578;234;736
354000;201611;2255;6237;1259;4107;246;844;131;387;377;1231
354010;201611;382;1131;304;989;59;190;170;556;229;746
354020;201611;4248;13244;3416;11300;900;3167;1001;2984;1901;6151
354025;201611;871;2443;601;1917;113;373;219;677;332;1050
354030;201611;493;1350;303;968;45;161;134;396;179;557
354040;201611;792;2132;495;1510;55;173;282;801;337;974
354050;201611;965;3023;721;2491;188;687;142;456;330;1143
354060;201611;4934;15178;3181;11008;874;3104;765;2443;1639;5547
354070;201611;2861;9471;2242;7911;552;2077;402;1300;954;3377
354075;201611;1979;7161;1749;6594;502;2019;689;2507;1191;4526
354080;201611;1563;4730;1003;3426;192;664;290;918;482;1582
354085;201611;338;836;297;772;12;46;252;640;264;686
354090;201611;1367;4016;1248;3788;159;539;838;2487;997;3026
354100;201611;14874;48948;11570;42051;3055;11805;4632;16303;7687;28108
354105;201611;913;2665;771;2433;123;419;517;1596;640;2015
354110;201611;737;2002;542;1706;182;623;99;257;281;880
354120;201611;1920;5288;1353;4137;234;775;586;1667;820;2442
354130;201611;6380;18194;4334;13948;1545;5179;394;1035;1939;6214
354140;201611;26524;66506;14804;44127;3389;10533;4368;11821;7757;22354
354150;201611;3897;10411;2769;8248;490;1571;1317;3743;1807;5314
354160;201611;3524;11345;2683;9302;683;2475;930;3071;1613;5546
354165;201611;492;1647;393;1419;105;411;136;488;241;899
354170;201611;1441;4475;1043;3519;203;756;428;1313;631;2069
354180;201611;477;1445;388;1231;55;203;186;501;241;704
354190;201611;1585;4953;1224;4157;298;1090;393;1247;691;2337
354200;201611;998;2778;711;2199;98;316;326;918;424;1234
354210;201611;646;2033;507;1736;73;308;262;815;335;1123
354220;201611;2964;8497;2332;7255;499;1602;1066;3209;1565;4811
354230;201611;650;2091;535;1812;90;344;255;807;345;1151
354240;201611;1281;4153;874;3165;171;655;195;671;366;1326
354250;201611;678;1925;431;1471;137;495;111;397;248;892
354260;201611;7546;22305;5776;18915;1647;5577;1810;5927;3457;11504
354270;201611;1167;3851;902;3207;191;726;299;1015;490;1741
354280;201611;703;2071;618;1913;111;421;395;1124;506;1545
354290;201611;939;3258;791;2884;188;730;295;1067;483;1797
354300;201611;3716;12043;3375;11305;1002;3434;1525;4940;2527;8374
354310;201611;865;2625;659;2191;140;481;320;1036;460;1517
354320;201611;740;2206;570;1852;135;494;190;550;325;1044
354323;201611;469;1278;314;956;62;195;111;291;173;486
354325;201611;1211;3947;875;3106;173;642;307;998;480;1640
354330;201611;6718;19776;5063;16310;1182;4129;2241;6634;3423;10763
354340;201611;24789;74730;19150;64171;5448;19424;6953;22350;12401;41774
354350;201611;1040;3050;893;2726;212;722;475;1323;687;2045
354360;201611;447;1407;232;872;31;108;11;41;42;149
354370;201611;1137;3781;914;3270;103;440;519;1783;622;2223
354380;201611;886;2646;644;2152;194;746;108;281;302;1027
354390;201611;13605;39015;8256;27891;1725;6113;1577;5038;3302;11151
354400;201611;1594;5485;1218;4493;256;1005;366;1321;622;2326
354410;201611;5452;16571;4208;13995;1081;3822;1628;5169;2709;8991
354420;201611;1215;3580;839;2699;199;687;331;1030;530;1717
354425;201611;2405;6759;1904;5768;583;1837;471;1403;1054;3240
354430;201611;1360;4372;1151;3898;240;905;487;1572;727;2477
354440;201611;535;1608;355;1187;39;133;149;463;188;596
354450;201611;414;1167;215;705;34;122;41;113;75;235
354460;201611;993;2760;634;2014;154;529;247;749;401;1278
354470;201611;577;1545;411;1196;41;150;216;554;257;704
354480;201611;785;2132;589;1774;74;237;363;1036;437;1273
354490;201611;731;2429;542;1949;64;254;257;882;321;1136
354500;201611;2191;6964;1832;6295;640;2403;387;1291;1027;3694
354510;201611;835;2271;721;2056;97;229;466;1346;563;1575
354515;201611;275;898;198;713;40;153;76;258;116;411
354520;201611;7922;25482;4223;14725;849;3309;1756;5590;2605;8899
354530;201611;3143;10636;2634;9461;697;2680;1065;3687;1762;6367
354540;201611;1201;3586;948;3108;311;1090;161;494;472;1584
354550;201611;476;1400;378;1202;77;262;179;529;256;791
354560;201611;1697;4704;893;2837;157;494;407;1201;564;1695
354570;201611;1064;2989;440;1433;70;251;71;201;141;452
354580;201611;10918;30415;7051;22759;1318;4564;2712;8097;4030;12661
354600;201611;1616;5194;1327;4606;262;1063;660;2151;922;3214
354610;201611;399;1146;217;710;25;81;73;216;98;297
354620;201611;403;1289;291;1061;58;263;133;455;191;718
354625;201611;293;910;172;617;24;89;46;137;70;226
354630;201611;2119;6959;1760;6140;695;2559;225;708;920;3267
354640;201611;3427;11133;2403;8639;492;1966;464;1429;956;3395
354650;201611;893;2600;735;2274;82;277;491;1510;573;1787
354660;201611;2458;6830;1695;5425;206;741;1035;3198;1241;3939
354670;201611;1299;4042;944;3174;231;851;214;613;445;1464
354680;201611;4428;14275;3862;13072;1024;3617;1683;5547;2707;9164
354690;201611;759;2432;441;1598;84;317;122;412;206;729
354700;201611;1146;3201;723;2238;153;553;297;782;450;1335
354710;201611;521;1546;354;1149;41;155;165;473;206;628
354720;201611;255;686;131;419;39;124;21;58;60;182
354730;201611;8700;27180;6163;21874;1307;4978;2708;9159;4015;14137
354740;201611;251;766;121;441;17;71;19;67;36;138
354750;201611;2296;7093;1713;5813;444;1667;611;1917;1055;3584
354760;201611;1968;6190;1480;5081;448;1602;192;649;640;2251
354765;201611;303;857;117;403;16;57;18;55;34;112
354770;201611;2386;6582;1693;5314;614;1974;461;1388;1075;3362
354780;201611;53529;147833;42445;123748;6827;21918;23375;63579;30202;85497
354790;201611;816;2668;707;2426;113;407;371;1217;484;1624
354800;201611;2209;6334;1830;5752;431;1492;879;2642;1310;4134
354805;201611;1016;3033;668;2233;68;238;180;515;248;753
354810;201611;572;1823;311;1161;52;214;51;148;103;362
354820;201611;965;3277;748;2764;145;581;164;531;309;1112
354830;201611;441;1205;314;955;90;275;121;336;211;611
354840;201611;701;2011;510;1605;116;357;226;701;342;1058
354850;201611;17347;52261;11964;40837;2492;9351;5282;16377;7774;25728
354860;201611;1373;4253;1121;3783;242;917;400;1230;642;2147
354870;201611;47283;136788;39829;120868;8628;27909;18291;53535;26919;81444
354880;201611;4282;11749;2135;6920;348;1308;709;1884;1057;3192
354890;201611;16605;47529;13055;40717;2863;9478;5584;16573;8447;26051
354900;201611;453;1378;307;1033;64;237;73;226;137;463
354910;201611;6365;18894;3251;11820;597;2348;166;542;763;2890
354920;201611;415;1206;244;849;42;165;60;189;102;354
354925;201611;319;940;174;597;23;82;29;87;52;169
354930;201611;316;788;164;517;25;82;74;222;99;304
354940;201611;1827;6441;1372;5201;446;1796;138;451;584;2247
354950;201611;1481;4616;1178;4039;140;607;664;2152;804;2759
354960;201611;790;2398;656;2156;128;469;287;889;415;1358
354970;201611;3928;12710;3253;11225;570;2243;1729;5659;2299;7902
354980;201611;33527;83156;18579;56733;3272;11042;7079;19581;10351;30623
354990;201611;54511;156172;40100;126634;6928;23356;20132;60548;27060;83904
354995;201611;1791;5344;1425;4703;359;1209;691;2223;1050;3432
355000;201611;1441;4543;1187;4015;319;1223;223;616;542;1839
355010;201611;3633;11056;2632;8668;780;2721;631;2071;1411;4792
355020;201611;2982;9758;2154;7941;791;3164;477;1634;1268;4798
355030;201611;1160463;3116982;912890;2615618;204081;627415;399799;1076976;603880;1704391
355040;201611;2633;7937;2241;7208;437;1484;1331;4160;1768;5644
355050;201611;1152;3484;853;2837;259;851;139;450;398;1301
355060;201611;4551;14939;3482;12547;728;2944;1126;3657;1854;6601
355070;201611;6691;20380;5644;18464;1170;4325;2754;8334;3924;12659
355080;201611;957;3240;620;2401;89;388;41;142;130;530
355090;201611;1128;3795;891;3245;171;651;336;1185;507;1836
355100;201611;18472;56186;14593;49158;3869;14018;6711;21783;10580;35801
355110;201611;1189;3829;958;3349;286;1088;185;580;471;1668
355120;201611;642;1983;485;1645;91;363;183;569;274;932
355130;201611;638;1615;266;789;40;121;89;234;129;355
355140;201611;1151;3791;1056;3601;215;815;587;2020;802;2835
355150;201611;3495;10070;2748;8740;575;1878;1313;4115;1888;5993
355160;201611;1703;5269;1301;4507;391;1450;345;1150;736;2600
355170;201611;8666;24265;6286;20043;2133;7127;1652;5333;3785;12460
355180;201611;2854;8741;2185;7394;541;2139;680;2026;1221;4165
355190;201611;1444;4511;1176;3944;391;1464;330;1152;721;2616
355200;201611;814;2836;703;2565;288;1128;154;509;442;1637
355210;201611;2793;8636;2360;7673;336;1302;1425;4364;1761;5666
355220;201611;36588;108841;27847;90313;9248;31367;6853;20129;16101;51496
355230;201611;1396;3783;686;2181;138;425;177;489;315;914
355240;201611;25312;71990;16111;52146;3625;12174;5246;16248;8871;28422
355250;201611;28684;88783;22668;76422;6460;23003;7919;25741;14379;48744
355255;201611;878;2402;480;1542;98;320;134;415;232;735
355260;201611;1275;3705;1033;3239;211;752;452;1265;663;2017
355270;201611;1643;4923;1360;4262;190;635;799;2347;989;2982
355280;201611;27059;77536;20333;63702;3860;13108;8786;25973;12646;39081
355290;201611;942;2958;705;2357;144;474;215;660;359;1134
355300;201611;1250;3985;932;3272;209;755;301;1007;510;1762
355310;201611;1072;3147;781;2583;133;478;426;1376;559;1854
355320;201611;603;1832;487;1571;89;346;192;522;281;868
355330;201611;1956;5929;1337;4613;290;1096;581;1879;871;2975
355340;201611;2631;6696;2253;6055;403;1065;1348;3550;1751;4615
355350;201611;1345;4440;1003;3631;245;929;265;916;510;1845
355360;201611;1208;3813;1014;3372;205;697;605;2070;810;2767
355365;201611;341;999;200;719;52;182;40;139;92;321
355370;201611;7639;18662;5237;15408;1574;4937;1997;6091;3571;11028
355380;201611;3276;9682;2350;7566;520;1745;530;1451;1050;3196
355385;201611;984;3140;827;2796;270;969;230;702;500;1671
355390;201611;862;2498;595;1904;138;482;215;582;353;1064
355395;201611;1861;5656;1229;4120;195;632;564;1775;759;2407
355400;201611;9140;29754;7524;26183;2247;8341;2073;6735;4320;15076
355410;201611;17914;56695;13095;46330;3994;15210;2417;8320;6411;23530
355420;201611;740;2580;640;2360;194;791;167;602;361;1393
355430;201611;3609;9934;2843;8525;592;1855;1349;3903;1941;5758
355440;201611;961;2916;636;2146;113;379;179;547;292;926
355450;201611;3819;10860;2013;6664;395;1349;620;1881;1015;3230
355460;201611;604;1621;380;1200;78;289;119;300;197;589
355465;201611;344;1086;255;885;48;170;66;216;114;386
355470;201611;793;2358;593;1972;150;520;231;732;381;1252
355475;201611;168;553;153;510;37;131;74;225;111;356
355480;201611;2926;10023;2580;9289;592;2273;1226;4287;1818;6560
355490;201611;1012;2880;603;1966;93;294;190;591;283;885
355495;201611;750;2493;611;2178;127;493;163;542;290;1035
355500;201611;7613;21962;4394;14561;806;2816;828;2474;1634;5290
355510;201611;1968;5230;1003;3198;144;538;294;811;438;1349
355520;201611;436;1013;200;540;23;72;94;222;117;294
355530;201611;430;1040;151;497;24;87;41;113;65;200
355535;201611;680;2057;511;1706;173;610;105;283;278;893
355540;201611;8305;25751;7667;24624;1924;6556;3995;12381;5919;18937
355550;201611;752;2295;572;1916;103;379;250;806;353;1185
355560;201611;1264;3800;688;2394;127;497;60;153;187;650
355570;201611;195;615;106;389;17;61;11;45;28;106
355580;201611;1277;3514;788;2500;137;484;328;1002;465;1486
355590;201611;228;600;172;497;25;85;98;264;123;349
355600;201611;1184;3575;913;2971;284;976;290;882;574;1858
355610;201611;1686;4600;1179;3587;225;725;540;1573;765;2298
355620;201611;4289;13263;3227;10742;523;1975;1526;4636;2049;6611
355630;201611;3275;9277;1909;6382;412;1437;510;1684;922;3121
355635;201611;954;3069;792;2776;95;353;543;1923;638;2276
355640;201611;3104;9792;2089;7545;426;1669;341;1171;767;2840
355645;201611;3665;11991;3077;10954;506;1992;1818;6316;2324;8308
355650;201611;7714;22706;6396;20067;1225;4419;3810;11031;5035;15450
355660;201611;1286;4026;947;3259;159;641;428;1356;587;1997
355670;201611;3048;9316;1950;6645;358;1364;826;2452;1184;3816
355680;201611;1726;5631;1150;4127;294;1134;160;550;454;1684
355690;201611;480;1500;324;1173;142;526;18;51;160;577
355695;201611;287;895;131;457;11;41;10;23;21;64
355700;201611;5614;18245;4546;15718;1151;4061;1743;5829;2894;9890
355710;201611;10395;25815;5629;16659;1300;4009;1480;4078;2780;8087
355715;201611;320;951;192;656;54;199;33;101;87;300
355720;201611;1551;5085;1187;4187;295;1097;365;1112;660;2209
355730;201611;858;2787;693;2377;226;781;171;570;397;1351
410010;201611;1406;4304;1116;3612;237;816;216;667;453;1483
410020;201611;1158;3717;943;3210;281;965;334;1124;615;2089
410030;201611;1097;3695;829;3027;219;805;143;518;362;1323
410040;201611;10160;32769;8269;28838;1907;7300;2534;8549;4441;15849
410045;201611;1029;2851;653;2080;153;513;146;406;299;919
410050;201611;2588;7042;1440;4665;425;1421;94;233;519;1654
410060;201611;2303;6919;1873;6018;421;1396;770;2446;1191;3842
410070;201611;1780;4966;1247;3867;365;1220;319;924;684;2144
410080;201611;1402;3928;1013;3146;176;611;438;1263;614;1874
410090;201611;1009;3082;872;2782;188;659;357;1139;545;1798
410100;201611;2715;8219;1742;5812;389;1417;181;521;570;1938
410105;201611;377;1178;209;747;36;155;30;86;66;241
410110;201611;2887;8342;2085;6663;341;1166;676;2076;1017;3242
410115;201611;539;1448;372;1121;62;203;123;326;185;529
410120;201611;2523;8587;2251;8018;859;3237;590;2066;1449;5303
410130;201611;1082;3356;945;3016;398;1336;219;604;617;1940
410140;201611;17844;45953;10455;31948;2260;7352;2559;7223;4819;14575
410150;201611;16414;41414;7468;22686;1570;4977;1198;3274;2768;8251
410160;201611;3082;9378;2606;8452;698;2484;885;2856;1583;5340
410165;201611;685;1995;512;1576;94;305;237;659;331;964
410170;201611;2348;6671;1582;4924;489;1650;208;590;697;2240
410180;201611;11771;36689;9537;31369;2032;7199;4202;12750;6234;19949
410185;201611;541;1494;370;1144;84;257;71;189;155;446
410190;201611;2107;6151;1518;4776;301;1021;268;747;569;1768
410200;201611;3974;10978;2463;7829;577;2021;356;1030;933;3051
410210;201611;2716;7897;1770;5715;284;1051;397;1029;681;2080
410220;201611;668;1811;436;1366;77;270;149;446;226;716
410230;201611;1487;4611;1205;3987;271;1012;496;1566;767;2578
410240;201611;4457;13285;3713;11706;1168;4078;545;1540;1713;5618
410250;201611;2691;7351;1663;5204;401;1299;321;945;722;2244
410260;201611;1631;4647;1231;3906;272;929;496;1564;768;2493
410270;201611;573;1587;407;1227;42;137;218;640;260;777
410275;201611;868;2573;533;1779;84;291;226;747;310;1038
410280;201611;2238;6438;1463;4740;337;1220;396;1151;733;2371
410290;201611;3419;10164;2658;8626;696;2251;966;3158;1662;5409
410300;201611;732;2040;572;1690;106;352;251;644;357;996
410302;201611;457;1219;248;812;30;109;131;426;161;535
410304;201611;1255;3913;1086;3526;294;992;384;1280;678;2272
410305;201611;1893;5108;1449;4281;364;1133;682;1975;1046;3108
410310;201611;2342;7370;1953;6594;422;1557;701;2315;1123;3872
410315;201611;667;1867;360;1226;58;208;110;340;168;548
410320;201611;1212;3680;675;2366;102;405;68;204;170;609
410322;201611;552;1608;289;977;42;134;80;260;122;394
410330;201611;1410;3870;1033;3087;228;688;267;782;495;1470
410335;201611;948;2787;771;2420;129;442;300;853;429;1295
410337;201611;831;2196;557;1649;76;262;195;522;271;784
410340;201611;546;1559;328;972;43;141;150;388;193;529
410345;201611;1912;5521;1204;3902;306;1037;279;865;585;1902
410347;201611;732;1982;442;1393;63;230;148;414;211;644
410350;201611;1045;3117;693;2353;140;522;152;440;292;962
410360;201611;3888;10425;2806;8358;379;1263;1492;4211;1871;5474
410370;201611;12360;35946;8146;25637;1475;5075;2411;6488;3886;11563
410380;201611;1361;3903;1168;3494;131;468;591;1716;722;2184
410390;201611;2475;7411;1830;5917;561;1866;385;1130;946;2996
410395;201611;873;2863;745;2580;204;772;299;1017;503;1789
410400;201611;4525;13898;3382;11260;705;2499;1207;3772;1912;6271
410405;201611;869;2469;662;2059;165;581;224;650;389;1231
410410;201611;1277;3926;1205;3811;310;1207;556;1618;866;2825
410420;201611;7136;22852;5365;18520;1320;4895;732;2136;2052;7031
410425;201611;2831;8860;1783;6344;323;1188;228;696;551;1884
410430;201611;14503;38652;9458;28723;1859;6094;2708;7593;4567;13687
410440;201611;2738;8624;2320;7758;606;2197;906;2918;1512;5115
410442;201611;2739;8972;2292;7917;708;2524;617;2090;1325;4614
410445;201611;2353;7589;1870;6589;545;2078;567;1993;1112;4071
410450;201611;2114;5923;1465;4486;384;1190;141;310;525;1500
410460;201611;1834;5357;1309;4226;386;1248;237;717;623;1965
410465;201611;2176;7043;1710;5941;420;1523;586;1886;1006;3409
410470;201611;1815;5750;1290;4487;301;1186;233;765;534;1951
410480;201611;31841;88525;16635;54843;3058;10398;1617;4308;4675;14706
410490;201611;11396;34615;7974;26939;1883;6937;2195;6670;4078;13607
410500;201611;1587;4918;1163;3900;417;1539;147;399;564;1938
410510;201611;2529;6610;1540;4501;316;892;556;1507;872;2399
410520;201611;3148;10699;2865;10061;825;3041;1195;4201;2020;7242
410530;201611;1598;4375;947;2885;179;568;226;604;405;1172
410540;201611;3188;9297;2072;6826;402;1337;664;2132;1066;3469
410550;201611;6292;18166;3933;12775;778;2749;544;1568;1322;4317
410560;201611;1300;3809;916;2940;240;859;248;672;488;1531
410570;201611;2680;8288;2209;7383;573;2084;614;2188;1187;4272
410580;201611;22438;66413;17029;55047;4060;14284;5378;15870;9438;30154
410590;201611;1377;4236;736;2453;134;454;167;465;301;919
410600;201611;1878;5411;1411;4450;369;1157;465;1461;834;2618
410610;201611;780;2170;556;1705;61;188;221;645;282;833
410620;201611;1762;5865;1184;4368;275;1079;119;401;394;1480
410630;201611;2496;7321;1525;5013;324;1132;178;440;502;1572
410640;201611;4679;12782;3111;9643;822;2859;459;1249;1281;4108
410645;201611;1129;3871;1024;3677;464;1747;205;767;669;2514
410650;201611;2163;6632;1601;5342;534;1863;221;673;755;2536
410655;201611;856;2381;566;1781;91;335;201;560;292;895
410657;201611;783;2169;510;1571;141;467;157;411;298;878
410660;201611;3033;8492;1465;4843;312;1070;167;493;479;1563
410670;201611;978;2663;592;1833;124;390;203;592;327;982
410680;201611;2946;9468;2174;7501;685;2305;480;1747;1165;4052
410685;201611;656;1881;528;1639;79;277;294;865;373;1142
410690;201611;119318;338811;75476;242254;15255;52791;18488;51019;33743;103810
410700;201611;2245;6639;1960;6040;526;1691;791;2300;1317;3991
410710;201611;939;2702;558;1827;127;413;129;359;256;772
410712;201611;834;2472;699;2209;268;921;156;476;424;1397
410715;201611;918;2915;618;2151;120;449;156;506;276;955
410720;201611;3195;9434;2044;6787;413;1456;373;1063;786;2519
410725;201611;1128;3130;694;2227;120;371;116;328;236;699
410730;201611;521;1458;369;1170;103;343;78;254;181;597
410740;201611;890;2615;577;1938;100;392;248;789;348;1181
410750;201611;1840;5327;1405;4356;282;945;445;1266;727;2211
410752;201611;327;889;151;490;35;125;46;128;81;253
410753;201611;398;1149;218;718;34;128;60;165;94;293
410754;201611;1157;3309;944;2924;71;206;597;1986;668;2192
410755;201611;829;2025;585;1608;77;246;344;871;421;1117
410760;201611;2533;7484;2018;6474;581;2011;557;1691;1138;3702
410765;201611;15138;45228;10255;34770;1665;6170;860;2695;2525;8865
410770;201611;919;2538;583;1829;152;506;98;294;250;800
410773;201611;1383;3894;1197;3593;177;626;836;2420;1013;3046
410775;201611;1457;4141;1264;3799;331;1077;419;1220;750;2297
410780;201611;557;1501;336;1023;98;293;94;322;192;615
410785;201611;772;2403;589;1958;204;724;140;442;344;1166
410790;201611;444;1446;346;1173;94;322;25;67;119;389
410800;201611;2894;7185;2042;5647;344;1068;726;1814;1070;2882
410810;201611;331;1015;254;842;48;183;97;311;145;494
410820;201611;842;2510;573;1865;136;479;82;252;218;731
410830;201611;30743;86364;22757;71172;6605;22354;7110;20907;13715;43261
410832;201611;1031;2947;827;2522;102;379;463;1281;565;1660
410840;201611;6473;18694;3584;12133;849;2930;283;752;1132;3682
410845;201611;1242;3633;983;3075;205;689;393;1172;598;1861
410850;201611;2702;8022;2262;7189;526;1835;845;2663;1371;4498
410855;201611;598;1635;394;1187;62;195;146;394;208;589
410860;201611;3703;10551;2669;8276;552;1812;830;2397;1382;4209
410865;201611;1495;4948;1384;4735;363;1324;736;2538;1099;3862
410870;201611;1282;3758;1132;3512;141;453;790;2468;931;2921
410880;201611;3868;12063;2859;9809;552;2018;443;1448;995;3466
410890;201611;936;3032;661;2372;172;670;69;218;241;888
410895;201611;1086;3709;922;3306;339;1308;187;614;526;1922
410900;201611;968;2635;582;1838;90;308;169;477;259;785
410910;201611;413;1079;279;818;29;100;144;397;173;497
410920;201611;854;2369;637;1967;175;603;204;612;379;1215
410930;201611;1643;4828;1267;4029;370;1340;312;907;682;2247
410940;201611;21450;67646;16612;57622;5120;18862;3249;11074;8369;29936
410950;201611;1858;5876;1668;5527;165;583;1251;4115;1416;4698
410960;201611;7659;20850;4375;14402;1312;4641;926;2798;2238;7439
410965;201611;1070;3127;782;2515;212;700;267;792;479;1492
410970;201611;4601;13395;3285;10668;904;3318;508;1524;1412;4842
410975;201611;1635;4555;1181;3639;226;773;424;1226;650;1999
410980;201611;6035;16845;3504;11460;649;2350;1006;3062;1655;5412
410990;201611;945;2745;500;1718;178;658;58;141;236;799
411000;201611;474;1411;278;947;53;191;55;147;108;338
411005;201611;488;1442;266;890;46;172;39;114;85;286
411007;201611;2384;7346;1947;6369;526;1808;551;1744;1077;3552
411010;201611;4054;13623;3401;11968;950;3533;376;1267;1326;4800
411020;201611;2552;7707;2111;6891;642;2273;603;1846;1245;4119
411030;201611;690;1834;444;1324;70;237;132;348;202;585
411040;201611;749;2165;300;1009;59;209;59;185;118;394
411050;201611;2028;6909;1697;6079;476;1867;234;715;710;2582
411060;201611;1634;4852;1071;3561;224;835;151;443;375;1278
411065;201611;372;1106;278;914;50;156;103;337;153;493
411070;201611;6040;17759;4428;14274;1175;4119;1111;3188;2286;7307
411080;201611;2190;6445;1812;5657;439;1477;492;1507;931;2984
411090;201611;850;2116;526;1562;59;201;93;241;152;442
411095;201611;1399;3915;872;2728;114;406;222;600;336;1006
411100;201611;1312;3776;839;2700;173;648;138;400;311;1048
411110;201611;607;1767;276;940;31;122;25;69;56;191
411120;201611;1650;4929;1121;3679;298;1127;284;781;582;1908
411125;201611;4367;14034;3916;13017;1084;3738;1427;4657;2511;8395
411130;201611;711;2095;489;1591;109;367;129;451;238;818
411140;201611;2231;7482;1781;6349;427;1594;696;2493;1123;4087
411150;201611;4194;11737;2842;8836;643;2155;344;883;987;3038
411155;201611;972;2670;622;1932;81;278;280;814;361;1092
411160;201611;274;785;192;608;35;117;54;162;89;279
411170;201611;742;2315;571;1904;130;472;182;570;312;1042
411180;201611;5829;17127;4401;14206;974;3411;1446;4523;2420;7934
411190;201611;1471;4196;1116;3439;271;937;239;629;510;1566
411200;201611;4409;12917;3302;10829;878;3076;915;2818;1793;5894
411210;201611;2049;5728;1404;4432;354;1211;176;468;530;1679
411220;201611;1120;3138;838;2584;209;727;315;858;524;1585
411230;201611;1268;3513;751;2448;141;484;259;809;400;1293
411240;201611;1483;3557;745;2193;127;390;284;759;411;1149
411250;201611;2217;6448;1711;5437;480;1649;431;1358;911;3007
411260;201611;336;876;200;617;23;73;93;264;116;337
411270;201611;1814;5573;1495;4890;252;907;677;2073;929;2980
411275;201611;1355;3933;991;3104;238;758;215;608;453;1366
411280;201611;1593;4576;964;3157;175;602;208;633;383;1235
411290;201611;767;2236;543;1735;140;469;146;444;286;913
411295;201611;980;2690;836;2393;136;422;339;972;475;1394
411300;201611;1175;2986;685;1984;62;179;293;764;355;943
411310;201611;883;2371;601;1837;55;185;207;610;262;795
411320;201611;5424;15641;3593;11810;995;3305;605;1799;1600;5104
411325;201611;1528;4751;1281;4204;277;947;591;1970;868;2917
411330;201611;3141;9639;2460;8179;806;2914;544;1828;1350;4742
411340;201611;958;2798;551;1817;49;187;210;650;259;837
411342;201611;745;2063;569;1696;171;523;181;501;352;1024
411345;201611;917;2809;795;2562;190;692;354;1113;544;1805
411350;201611;2825;8337;1866;6235;518;1882;173;526;691;2408
411360;201611;570;1425;332;987;46;161;141;357;187;518
411370;201611;46942;130549;34279;105290;5168;18001;15376;43154;20544;61155
411373;201611;1507;4545;1187;3904;245;909;318;1017;563;1926
411375;201611;1143;3101;755;2299;145;461;224;640;369;1101
411380;201611;1227;3294;625;1877;133;399;169;451;302;850
411390;201611;1767;5152;1247;3900;265;873;313;891;578;1764
411400;201611;2206;6156;1579;4804;334;1104;461;1306;795;2410
411410;201611;2086;6286;1436;4673;331;1160;328;904;659;2064
411420;201611;4154;11619;2479;7911;393;1387;409;1025;802;2412
411430;201611;3371;9912;2674;8660;635;2241;1292;4026;1927;6267
411435;201611;439;1428;348;1182;74;261;131;407;205;668
411440;201611;2748;8676;2227;7481;665;2311;461;1621;1126;3932
411450;201611;2355;7100;2039;6442;437;1396;932;3052;1369;4448
411460;201611;3372;9777;1543;5430;241;933;89;282;330;1215
411470;201611;825;2440;493;1644;80;287;84;241;164;528
411480;201611;4651;13880;3110;10517;748;2766;434;1299;1182;4065
411490;201611;1451;4386;1131;3718;221;765;272;827;493;1592
411500;201611;1863;4941;1226;3746;240;815;370;1090;610;1905
411510;201611;2068;6062;1485;4772;413;1455;260;753;673;2208
411520;201611;27456;74078;14665;46143;2644;8848;3287;9201;5931;18049
411530;201611;1025;2820;640;2067;147;530;142;405;289;935
411535;201611;521;1572;216;777;21;97;16;37;37;134
411540;201611;3050;8173;2005;5961;448;1450;603;1577;1051;3027
411545;201611;1008;3233;869;2947;132;468;541;1868;673;2336
411550;201611;804;2153;571;1717;185;592;103;296;288;888
411560;201611;2397;7019;1419;4645;222;774;123;326;345;1100
411570;201611;7121;18681;4779;14660;1172;3964;1027;3124;2199;7088
411573;201611;874;2541;794;2404;117;353;485;1485;602;1838
411575;201611;1654;5069;1301;4290;333;1126;400;1294;733;2420
411580;201611;4064;11516;2314;7672;304;1165;297;763;601;1928
411585;201611;779;2456;353;1244;76;258;55;177;131;435
411590;201611;381;1151;310;1006;44;165;142;422;186;587
411600;201611;321;896;209;702;48;187;79;259;127;446
411605;201611;1741;4728;1070;3252;167;576;409;1180;576;1756
411610;201611;2223;6226;1655;5049;357;1164;670;1953;1027;3117
411620;201611;2871;8790;2502;8158;588;2091;1244;3987;1832;6078
411630;201611;553;1443;329;1082;62;244;47;116;109;360
411640;201611;469;1429;337;1097;48;140;109;328;157;468
411650;201611;204;646;140;504;28;113;22;70;50;183
411660;201611;906;2404;614;1838;87;280;300;860;387;1140
411670;201611;1150;3211;844;2497;173;540;289;809;462;1349
411680;201611;1514;4449;1243;3907;255;878;603;1875;858;2753
411690;201611;3451;9983;2477;8010;675;2197;573;1931;1248;4128
411695;201611;803;2563;574;2019;125;464;182;642;307;1106
411700;201611;1736;4945;1082;3526;226;793;153;435;379;1228
411705;201611;1893;6480;1607;5873;394;1420;763;2947;1157;4367
411710;201611;1761;5118;1242;3960;345;1145;206;641;551;1786
411720;201611;923;2583;631;1956;105;357;175;477;280;834
411721;201611;780;2276;569;1821;143;450;72;217;215;667
411722;201611;679;2035;406;1374;82;302;98;284;180;586
411725;201611;1422;4486;765;2766;174;648;138;492;312;1140
411727;201611;1828;5303;1186;3818;321;1043;210;648;531;1691
411729;201611;624;1610;390;1151;119;357;81;190;200;547
411730;201611;5454;15579;4281;13198;1481;4572;993;3003;2474;7575
411740;201611;652;1840;357;1161;60;217;87;243;147;460
411745;201611;898;2555;663;2035;136;424;203;597;339;1021
411750;201611;5067;14915;3561;11451;664;2237;1213;3664;1877;5901
411760;201611;7914;22895;6258;19723;1995;6580;1380;4351;3375;10931
411770;201611;3475;11227;2637;9203;762;2803;422;1388;1184;4191
411780;201611;2920;8822;2560;8179;642;2181;1288;4225;1930;6406
411790;201611;3423;9559;2047;6539;514;1747;445;1336;959;3083
411800;201611;1172;3358;678;2182;108;382;96;254;204;636
411810;201611;1741;4921;1357;4136;280;921;517;1441;797;2362
411820;201611;13997;44583;11141;38292;3875;13661;2426;8397;6301;22058
411830;201611;536;1369;309;941;101;330;13;46;114;376
411840;201611;10726;30319;7116;22709;1665;5688;1383;4316;3048;10004
411845;201611;519;1576;271;913;49;178;27;73;76;251
411850;201611;7397;21750;5584;17829;1433;4896;1499;4546;2932;9442
411860;201611;905;2743;663;2179;136;466;212;642;348;1108
411870;201611;880;2841;558;1951;115;467;102;308;217;775
411880;201611;2358;6706;1656;5356;436;1576;346;978;782;2554
411885;201611;977;2666;736;2203;132;486;269;711;401;1197
411890;201611;1141;3466;659;2244;120;449;50;131;170;580
411900;201611;953;2939;576;1970;129;423;66;227;195;650
411910;201611;1254;4055;875;3090;250;941;206;628;456;1569
411915;201611;17630;47454;9604;30568;1850;6228;2203;6114;4053;12342
411920;201611;892;2968;714;2504;181;727;80;207;261;934
411925;201611;586;1660;366;1203;80;268;81;243;161;511
411930;201611;5972;19483;4970;17340;2313;8623;442;1424;2755;10047
411940;201611;3252;10728;2611;9203;721;2628;500;1633;1221;4261
411950;201611;12190;38088;9866;33224;2235;7968;4366;14223;6601;22191
411960;201611;5599;16278;4806;14679;1112;3701;1859;5378;2971;9079
411965;201611;569;1598;367;1214;66;255;98;318;164;573
411970;201611;785;2162;634;1924;195;597;239;806;434;1403
411980;201611;1689;4952;1351;4200;323;1022;380;1173;703;2195
411990;201611;32854;101703;23724;81341;6049;22451;6515;20892;12564;43343
411995;201611;2609;7810;2080;6766;628;2281;509;1493;1137;3774
412000;201611;2380;5899;1717;4726;255;848;895;2165;1150;3013
412010;201611;716;2399;533;1966;80;312;125;412;205;724
412015;201611;650;1922;492;1576;99;303;228;742;327;1045
412020;201611;386;1128;230;754;43;142;59;170;102;312
412030;201611;717;2210;452;1574;87;340;119;371;206;711
412033;201611;879;2496;519;1638;79;261;141;421;220;682
412035;201611;1006;2740;583;1902;123;417;196;605;319;1022
412040;201611;614;1892;414;1404;77;268;74;240;151;508
412050;201611;1758;5004;1190;3769;210;712;275;834;485;1546
412060;201611;6988;23488;5959;21161;1888;7166;1544;5327;3432;12493
412065;201611;836;2499;593;1958;133;478;166;497;299;975
412070;201611;1366;3604;932;2671;153;461;352;963;505;1424
412080;201611;1406;4310;697;2562;83;319;26;74;109;393
412085;201611;443;1268;106;374;16;56;12;33;28;89
412090;201611;4701;14098;4232;13197;1004;3126;2129;6866;3133;9992
412100;201611;1972;5971;1496;4973;436;1580;303;970;739;2550
412110;201611;1103;3073;661;2091;156;508;132;424;288;932
412120;201611;1740;5875;1378;4938;362;1425;393;1216;755;2641
412125;201611;665;2135;581;1957;137;489;190;599;327;1088
412130;201611;634;1867;410;1331;113;384;63;191;176;575
412135;201611;514;1438;287;913;63;206;91;268;154;474
412140;201611;1646;4887;1215;3903;284;966;216;628;500;1594
412150;201611;2917;8355;2408;7260;365;1172;1381;4014;1746;5186
412160;201611;1197;3789;645;2331;163;633;68;209;231;842
412170;201611;4660;14083;3598;11856;948;3386;1319;4015;2267;7401
412175;201611;1472;4771;1212;4174;250;931;578;1955;828;2886
412180;201611;1732;5183;1172;4034;262;1011;380;1169;642;2180
412190;201611;3346;9302;2269;7212;463;1568;758;2464;1221;4032
412200;201611;2152;6810;1425;4883;286;1032;413;1405;699;2437
412210;201611;692;1878;347;1107;57;194;46;107;103;301
412215;201611;3680;11069;3202;10153;831;2599;1618;5329;2449;7928
412217;201611;1132;3183;966;2861;94;347;687;1899;781;2246
412220;201611;5863;18625;5234;17318;1578;5213;2126;7163;3704;12376
412230;201611;2885;9357;2273;7994;468;1806;643;2027;1111;3833
412240;201611;9031;23134;4783;14809;927;3153;998;2724;1925;5877
412250;201611;1941;5610;1486;4611;370;1182;180;462;550;1644
412260;201611;1395;3814;811;2473;123;419;317;850;440;1269
412265;201611;1007;3022;848;2726;212;728;309;974;521;1702
412270;201611;888;2792;556;1946;90;336;181;583;271;919
412280;201611;635;1945;433;1491;144;540;27;58;171;598
412290;201611;1048;2926;730;2313;139;478;226;642;365;1120
412300;201611;1892;5635;1491;4802;388;1320;313;930;701;2250
412310;201611;1028;2957;813;2568;117;432;393;1230;510;1662
412320;201611;902;2362;567;1730;110;413;197;553;307;966
412330;201611;1574;4466;1062;3340;173;584;476;1469;649;2053
412340;201611;976;3032;571;1971;76;272;101;308;177;580
412350;201611;2280;7010;1554;5272;287;975;76;186;363;1161
412360;201611;308;899;161;525;19;79;58;159;77;238
412370;201611;989;2890;662;2237;134;483;116;383;250;866
412380;201611;1493;4676;1120;3753;289;996;231;756;520;1752
412382;201611;690;1904;425;1323;76;248;97;252;173;500
412385;201611;2388;7312;2009;6431;734;2390;485;1569;1219;3959
412390;201611;2190;6114;1922;5657;469;1498;789;2383;1258;3881
412395;201611;839;2344;610;1897;87;312;329;955;416;1267
412400;201611;943;2926;739;2435;206;727;171;561;377;1288
412402;201611;1890;5520;1357;4367;330;1158;280;785;610;1943
412405;201611;3643;10487;1857;6246;299;1109;100;269;399;1378
412410;201611;5110;15224;3792;12528;1071;3958;758;2287;1829;6245
412420;201611;380;1123;231;745;38;122;71;185;109;307
412430;201611;564;1564;357;1123;69;237;105;301;174;538
412440;201611;3220;9676;2314;7808;566;2061;558;1864;1124;3925
412450;201611;254;835;162;566;25;82;18;48;43;130
412460;201611;757;2352;572;1910;149;522;103;335;252;857
412470;201611;1869;6297;1482;5261;491;1849;278;1018;769;2867
412480;201611;1169;3474;722;2335;119;403;102;247;221;650
412490;201611;943;2750;737;2300;144;463;258;747;402;1210
412500;201611;2002;5695;1489;4619;290;984;354;928;644;1912
412510;201611;2274;7328;1726;5923;541;2006;336;1038;877;3044
412520;201611;1559;4404;1041;3255;301;958;156;429;457;1387
412530;201611;585;1704;389;1215;84;271;83;252;167;523
412535;201611;756;2183;446;1417;83;289;109;314;192;603
412540;201611;1216;3444;803;2536;126;469;246;742;372;1211
412545;201611;786;2242;535;1657;92;323;168;452;260;775
412550;201611;31266;92478;19321;64412;4353;15231;4198;12824;8551;28055
412555;201611;267;786;163;528;28;92;37;100;65;192
412560;201611;5366;16316;3800;12660;762;2932;991;3093;1753;6025
412570;201611;4333;12513;2561;8535;580;2089;376;1253;956;3342
412575;201611;900;2747;650;2109;132;455;208;632;340;1087
412580;201611;1295;3551;848;2618;150;486;311;876;461;1362
412590;201611;450;1314;257;870;53;185;56;171;109;356
412600;201611;1421;4304;959;3204;204;728;259;792;463;1520
412610;201611;769;2281;451;1457;109;357;128;386;237;743
412620;201611;1262;3934;913;3171;233;915;148;434;381;1349
412625;201611;9753;27955;6643;21321;1335;4502;732;2131;2067;6633
412627;201611;987;3012;640;2184;216;783;95;311;311;1094
412630;201611;3348;10426;2412;8222;490;1648;653;2096;1143;3744
412635;201611;480;1394;290;946;74;238;20;42;94;280
412640;201611;914;2713;505;1709;86;293;51;164;137;457
412650;201611;1762;5213;1378;4413;271;976;406;1174;677;2150
412660;201611;2799;7988;2026;6320;435;1522;424;1134;859;2656
412665;201611;638;1657;323;1022;84;268;72;212;156;480
412667;201611;1718;4859;1236;3826;324;1004;292;868;616;1872
412670;201611;576;1743;416;1382;99;366;70;214;169;580
412680;201611;1375;4094;763;2643;127;467;186;569;313;1036
412690;201611;790;2341;545;1784;149;533;101;313;250;846
412700;201611;1867;5599;1511;5015;479;1787;378;1166;857;2953
412710;201611;6978;21854;5393;18225;1187;4367;1298;3961;2485;8328
412720;201611;1414;4310;872;2891;143;494;159;414;302;908
412730;201611;2206;6536;1177;4032;243;893;129;386;372;1279
412740;201611;1487;4694;973;3455;215;816;124;461;339;1277
412750;201611;4062;12217;3491;11171;443;1657;2191;6822;2634;8479
412760;201611;2464;7709;2234;7261;316;1170;1395;4376;1711;5546
412770;201611;11512;31518;5494;17970;833;2869;1020;2855;1853;5724
412780;201611;1334;4025;1046;3408;221;774;405;1230;626;2004
412785;201611;2369;6557;1681;5174;439;1375;707;2194;1146;3569
412788;201611;1437;4528;1163;3918;303;1147;314;890;617;2037
412790;201611;1164;3478;787;2603;161;572;152;405;313;977
412795;201611;1014;2763;682;2078;135;414;239;711;374;1125
412796;201611;2764;8368;2381;7533;573;1950;919;2725;1492;4675
412800;201611;3142;8892;2211;6805;359;1207;794;2276;1153;3483
412810;201611;11415;30976;5835;18493;827;2913;1488;3812;2315;6725
412820;201611;7477;21646;4996;16465;1206;4088;1220;3989;2426;8077
412830;201611;373;1137;242;814;46;167;67;206;113;373
412840;201611;1820;5126;1324;4040;243;793;302;888;545;1681
412850;201611;2808;8174;2076;6743;437;1569;629;1844;1066;3413
412853;201611;1724;4918;1424;4262;140;452;771;2155;911;2607
412855;201611;1503;4299;1022;3153;222;748;218;533;440;1281
412860;201611;1192;3378;884;2759;239;809;304;877;543;1686
412862;201611;775;1998;454;1376;72;228;133;405;205;633
412863;201611;1204;4016;1156;3923;161;593;807;2684;968;3277
412865;201611;732;2205;494;1653;119;415;144;496;263;911
412870;201611;963;2701;678;2171;273;955;92;259;365;1214
412880;201611;884;2554;607;1956;124;437;61;143;185;580
420005;201611;552;1645;300;1034;54;203;100;325;154;528
420010;201611;3269;9025;2512;7891;344;1107;1712;5428;2056;6535
420020;201611;715;2314;349;1309;41;181;46;157;87;338
420030;201611;504;1302;235;783;50;196;29;88;79;284
420040;201611;724;2275;382;1459;72;307;25;77;97;384
420050;201611;726;2068;443;1458;105;352;172;559;277;911
420055;201611;208;639;104;379;22;85;15;53;37;138
420060;201611;245;785;147;532;21;93;27;77;48;170
420070;201611;1364;4297;982;3349;180;690;386;1303;566;1993
420075;201611;174;462;75;232;14;45;13;29;27;74
420080;201611;599;1867;463;1585;142;508;109;378;251;886
420090;201611;503;1642;321;1212;74;298;52;203;126;501
420100;201611;1210;3742;1068;3539;238;812;598;1990;836;2802
420110;201611;330;1099;282;978;65;237;88;305;153;542
420120;201611;295;997;228;835;65;272;50;157;115;429
420125;201611;304;1103;270;1026;74;298;113;422;187;720
420127;201611;553;1592;180;669;42;173;14;40;56;213
420130;201611;1933;6466;1436;5334;374;1528;297;971;671;2499
420140;201611;4633;13497;3022;10179;698;2568;469;1348;1167;3916
420150;201611;751;2092;432;1429;72;259;182;571;254;830
420160;201611;282;784;159;529;27;92;43;137;70;229
420165;201611;223;689;118;406;25;94;23;73;48;167
420170;201611;212;653;122;467;40;168;14;53;54;221
420180;201611;405;1218;200;721;34;127;44;145;78;272
420190;201611;462;1306;187;663;35;131;16;51;51;182
420195;201611;1415;4088;1041;3381;267;920;235;703;502;1623
420200;201611;2746;8477;1478;5458;295;1229;225;747;520;1976
420205;201611;1084;3459;848;2992;197;752;432;1504;629;2256
420207;201611;1612;4665;1012;3388;279;1027;194;596;473;1623
420208;201611;589;1583;297;1056;98;370;62;233;160;603
420209;201611;320;968;180;618;28;111;76;246;104;357
420210;201611;1909;5687;1134;4260;305;1315;379;1284;684;2599
420213;201611;792;2790;723;2624;191;733;344;1250;535;1983
420215;201611;323;1037;197;707;53;203;12;46;65;249
420220;201611;175;619;138;536;36;152;47;163;83;315
420230;201611;4391;12617;3026;10052;591;2286;1140;3514;1731;5800
420240;201611;11561;32025;6883;22731;1069;4148;2990;8761;4059;12909
420243;201611;609;1834;465;1540;100;355;159;514;259;869
420245;201611;1272;3743;800;2736;114;449;297;898;411;1347
420250;201611;545;1717;464;1541;114;459;197;605;311;1064
420253;201611;509;1309;368;1107;45;129;221;688;266;817
420257;201611;308;837;178;581;39;129;79;256;118;385
420260;201611;1227;3855;961;3315;207;796;359;1223;566;2019
420270;201611;634;1888;183;648;31;116;54;166;85;282
420280;201611;2101;5708;1211;4019;255;928;399;1234;654;2162
420285;201611;146;420;57;210;11;40;2;5;13;45
420287;201611;544;1584;425;1380;136;468;127;414;263;882
420290;201611;6394;18845;3930;13020;755;2640;1178;3564;1933;6204
420300;201611;7010;20796;3926;13775;873;3295;667;2089;1540;5384
420310;201611;840;2244;678;1927;102;318;470;1293;572;1611
420315;201611;981;3060;714;2486;238;881;205;681;443;1562
420320;201611;4698;14377;3628;12299;1147;4219;1141;3714;2288;7933
420325;201611;235;783;204;711;38;147;75;247;113;394
420330;201611;1007;3435;685;2601;146;602;179;618;325;1220
420340;201611;1461;4448;980;3291;166;629;95;271;261;900
420350;201611;1502;4386;1013;3382;284;1002;357;1122;641;2124
420360;201611;3114;9389;1743;6242;360;1448;154;462;514;1910
420370;201611;1857;5247;1407;4446;183;607;971;2998;1154;3605
420380;201611;5307;15892;3239;11117;777;2833;789;2554;1566;5387
420390;201611;1474;4075;693;2351;128;485;123;306;251;791
420395;201611;1401;4282;841;2936;111;436;100;277;211;713
420400;201611;1309;3803;825;2773;187;701;183;531;370;1232
420410;201611;772;2046;514;1601;98;334;299;912;397;1246
420415;201611;473;1449;315;1063;90;320;89;288;179;608
420417;201611;734;2332;566;1894;115;388;247;810;362;1198
420419;201611;369;1107;212;771;70;278;14;53;84;331
420420;201611;11133;33108;8241;27150;2912;10250;1654;4898;4566;15148
420425;201611;1246;3342;750;2334;90;344;346;983;436;1327
420430;201611;3499;10516;2034;6956;448;1640;611;2022;1059;3662
420435;201611;301;882;171;585;39;147;69;219;108;366
420440;201611;877;2653;439;1501;177;659;75;221;252;880
420445;201611;386;1115;231;739;51;165;69;212;120;377
420450;201611;839;2519;503;1743;91;344;119;361;210;705
420455;201611;1996;5806;1590;5069;271;1047;759;2236;1030;3283
420460;201611;9108;26256;6401;21145;1423;5347;2417;7328;3840;12675
420470;201611;1118;2927;603;1911;115;402;181;519;296;921
420475;201611;124;358;58;198;18;56;5;15;23;71
420480;201611;5130;14507;3415;11153;900;3100;750;2397;1650;5497
420490;201611;653;1704;324;1113;78;292;69;244;147;536
420500;201611;1561;4868;1091;3891;336;1308;332;1150;668;2458
420510;201611;117;433;84;346;20;93;44;173;64;266
420515;201611;107;346;81;295;12;52;15;52;27;104
420517;201611;838;2585;710;2325;128;476;404;1260;532;1736
420519;201611;557;1457;369;1111;66;203;105;294;171;497
420520;201611;646;1671;325;1080;64;213;78;215;142;428
420530;201611;1208;3791;783;2819;187;775;189;573;376;1348
420535;201611;263;757;104;368;27;84;10;42;37;126
420540;201611;22868;63719;14442;45176;3415;11453;3866;10085;7281;21538
420543;201611;397;1018;289;832;27;92;186;558;213;650
420545;201611;1585;4920;1175;3981;262;969;356;1133;618;2102
420550;201611;4211;13070;2824;10098;747;3090;516;1671;1263;4761
420555;201611;370;1108;260;869;57;218;91;273;148;491
420560;201611;543;1539;386;1249;68;228;178;561;246;789
420570;201611;2234;6988;1542;5333;409;1583;474;1472;883;3055
420580;201611;1561;4668;1157;3943;280;1070;471;1539;751;2609
420590;201611;3429;10159;1962;6639;396;1435;331;927;727;2362
420600;201611;927;2991;817;2751;132;460;462;1600;594;2060
420610;201611;536;1608;268;984;63;260;59;211;122;471
420620;201611;582;1794;486;1584;121;413;132;428;253;841
420630;201611;1038;3150;692;2326;159;578;239;727;398;1305
420640;201611;799;2379;336;1247;90;371;27;87;117;458
420650;201611;2622;7593;1451;5000;252;900;360;1119;612;2019
420660;201611;484;1405;308;1012;70;253;89;274;159;527
420665;201611;719;1997;436;1440;59;205;150;442;209;647
420670;201611;1745;5097;1090;3670;215;832;273;810;488;1642
420675;201611;207;660;134;475;25;97;31;100;56;197
420680;201611;520;1216;273;829;42;140;107;316;149;456
420690;201611;891;3023;578;2136;95;347;96;287;191;634
420700;201611;3313;9649;2322;7521;462;1632;794;2358;1256;3990
420710;201611;644;2102;447;1646;119;488;144;489;263;977
420720;201611;1787;4962;1301;4247;371;1279;577;1842;948;3121
420730;201611;3383;9974;2613;8541;620;2208;1068;3332;1688;5540
420740;201611;830;2534;630;2100;212;769;203;604;415;1373
420750;201611;2435;7649;1607;5662;249;985;518;1609;767;2594
420757;201611;106;254;43;153;6;25;19;69;25;94
420760;201611;390;1209;175;586;39;142;26;69;65;211
420765;201611;599;1884;285;1066;61;248;58;200;119;448
420768;201611;1235;4194;953;3586;424;1605;272;1087;696;2692
420770;201611;647;1878;312;1150;66;285;63;229;129;514
420775;201611;657;1952;336;1136;81;288;60;172;141;460
420780;201611;1526;4572;816;2779;163;549;135;446;298;995
420785;201611;289;866;194;627;32;106;51;145;83;251
420790;201611;1288;4349;945;3510;296;1206;305;1046;601;2252
420800;201611;913;2536;406;1353;96;340;121;386;217;726
420810;201611;2075;6939;1531;5671;459;1904;315;1039;774;2943
420820;201611;8672;25707;5653;20106;1396;5498;1474;4994;2870;10492
420830;201611;2879;8857;2215;7510;635;2317;735;2397;1370;4714
420840;201611;1024;2991;432;1575;96;382;73;228;169;610
420845;201611;1440;4260;898;3203;241;974;198;652;439;1626
420850;201611;1619;5026;882;3339;187;792;56;184;243;976
420860;201611;449;1250;249;854;70;276;62;202;132;478
420870;201611;1153;3199;842;2659;296;1063;213;581;509;1644
420880;201611;1041;3465;733;2620;151;591;124;396;275;987
420890;201611;9814;25768;4384;14462;734;2609;1117;3118;1851;5727
420895;201611;254;693;116;382;33;109;14;42;47;151
420900;201611;1870;5219;1080;3613;204;769;292;865;496;1634
420910;201611;25005;73216;15432;52947;2872;10896;4787;14868;7659;25764
420915;201611;561;2185;393;1672;80;348;160;627;240;975
420917;201611;486;1486;191;638;37;142;73;212;110;354
420920;201611;184;514;67;238;13;55;12;43;25;98
420930;201611;18655;52910;13337;43004;2896;10077;5148;15676;8044;25753
420940;201611;2910;8631;2032;6756;514;1862;162;420;676;2282
420945;201611;205;622;123;427;25;102;33;99;58;201
420950;201611;647;1782;267;992;33;163;54;182;87;345
420960;201611;972;2724;687;2174;140;469;285;834;425;1303
420970;201611;2551;7921;1953;6743;634;2355;450;1464;1084;3819
420980;201611;468;1369;338;1142;121;446;111;410;232;856
420985;201611;503;1421;214;764;42;185;53;168;95;353
420990;201611;904;2444;447;1515;68;248;80;216;148;464
421000;201611;587;1997;343;1337;72;305;56;172;128;477
421003;201611;737;1982;225;769;23;74;31;77;54;151
421005;201611;154;467;113;397;21;79;56;204;77;283
421010;201611;5314;14976;3396;11304;805;2931;699;2046;1504;4977
421020;201611;489;1485;349;1222;43;163;188;668;231;831
421030;201611;760;2703;647;2404;194;807;87;289;281;1096
421040;201611;924;2318;539;1672;91;326;274;799;365;1125
421050;201611;1674;4761;883;2992;173;633;203;592;376;1225
421055;201611;198;555;90;284;22;74;19;38;41;112
421060;201611;539;1778;332;1210;76;308;100;354;176;662
421070;201611;712;2243;391;1416;87;335;60;201;147;536
421080;201611;634;2418;547;2281;88;286;389;1766;477;2052
421085;201611;567;1509;249;862;48;187;66;196;114;383
421090;201611;435;1191;179;589;23;85;59;174;82;259
421100;201611;966;2590;444;1434;125;416;41;119;166;535
421105;201611;1511;4501;1156;3846;262;934;353;1194;615;2128
421110;201611;1014;3592;897;3305;319;1240;173;563;492;1803
421120;201611;1377;4376;818;2918;119;503;221;677;340;1180
421125;201611;413;1141;286;913;90;316;77;208;167;524
421130;201611;3463;11244;2822;9949;920;3484;917;3218;1837;6702
421140;201611;361;1029;249;789;50;155;90;261;140;416
421145;201611;573;1775;319;1092;46;155;103;343;149;498
421150;201611;611;1760;420;1423;82;307;169;541;251;848
421160;201611;1234;3366;543;1797;106;388;180;547;286;935
421165;201611;291;983;207;740;30;101;92;337;122;438
421170;201611;1351;3840;1029;3290;197;674;595;1869;792;2543
421175;201611;1280;3544;793;2631;160;642;295;853;455;1495
421180;201611;578;1574;268;894;56;219;43;117;99;336
421185;201611;414;1135;270;852;49;143;123;414;172;557
421187;201611;292;855;205;674;40;141;89;265;129;406
421189;201611;420;1285;312;1042;61;220;88;264;149;484
421190;201611;11844;33588;6433;22317;1367;5146;978;3043;2345;8189
421200;201611;965;3109;765;2655;171;617;222;717;393;1334
421205;201611;264;809;184;638;40;169;41;116;81;285
421210;201611;1533;4603;1044;3442;283;949;268;876;551;1825
421220;201611;1964;6559;1621;5760;460;1805;254;760;714;2565
421223;201611;544;1698;374;1329;98;367;126;444;224;811
421225;201611;1154;3634;920;3118;199;741;364;1222;563;1963
421227;201611;815;2567;695;2357;147;552;385;1252;532;1804
421230;201611;469;1501;380;1318;96;364;165;548;261;912
421240;201611;422;1327;193;711;25;110;33;97;58;207
421250;201611;1774;5032;1018;3599;287;1059;201;703;488;1762
421260;201611;371;1051;86;309;20;67;19;66;39;133
421265;201611;783;2359;679;2185;109;393;426;1336;535;1729
421270;201611;858;2259;386;1274;75;249;78;279;153;528
421280;201611;1677;5247;1243;4431;357;1431;444;1483;801;2914
421290;201611;945;2619;493;1615;90;304;94;268;184;572
421300;201611;316;954;228;757;65;259;88;255;153;514
421310;201611;248;767;171;571;30;108;59;188;89;296
421315;201611;370;1064;174;619;31;110;22;77;53;187
421320;201611;695;2085;370;1257;62;221;65;154;127;375
421330;201611;576;1842;411;1502;121;478;81;306;202;784
421335;201611;512;1693;391;1429;88;367;76;283;164;650
421340;201611;1772;4979;1330;4232;190;752;731;2233;921;2985
421350;201611;1067;3441;859;2987;140;578;462;1511;602;2089
421360;201611;3018;8576;1695;5871;404;1556;467;1420;871;2976
421370;201611;687;2267;493;1823;130;531;139;494;269;1025
421380;201611;986;2758;777;2334;113;379;390;1120;503;1499
421390;201611;180;507;69;236;27;102;23;64;50;166
421400;201611;292;974;195;777;50;220;66;237;116;457
421410;201611;337;956;189;637;25;85;84;282;109;367
421415;201611;372;1201;143;535;33;132;29;97;62;229
421420;201611;891;2619;597;1958;92;323;219;664;311;987
421430;201611;242;750;174;609;29;110;38;140;67;250
421440;201611;879;2482;551;1871;123;476;227;742;350;1218
421450;201611;435;1322;216;800;32;125;25;98;57;223
421460;201611;663;1816;316;1135;58;235;71;258;129;493
421470;201611;436;1438;324;1171;93;369;84;280;177;649
421480;201611;3211;9000;1856;6402;621;2468;239;579;860;3047
421490;201611;282;842;112;433;23;102;19;63;42;165
421500;201611;2204;7393;1705;6253;531;2167;199;685;730;2852
421505;201611;367;1206;313;1083;77;269;125;427;202;696
421507;201611;533;1597;310;1090;69;260;85;299;154;559
421510;201611;176;563;140;497;23;103;65;177;88;280
421520;201611;895;2382;518;1568;65;238;213;553;278;791
421530;201611;421;1293;231;850;39;176;55;184;94;360
421535;201611;690;1984;344;1233;53;211;140;457;193;668
421540;201611;332;879;234;701;50;160;84;218;134;378
421545;201611;859;2682;571;2085;138;565;156;530;294;1095
421550;201611;2063;6447;1648;5688;495;1899;507;1620;1002;3519
421555;201611;329;953;97;348;16;68;17;48;33;116
421560;201611;210;644;82;287;18;66;16;56;34;122
421565;201611;865;2484;736;2299;246;859;302;946;548;1805
421567;201611;640;2331;542;2095;272;1073;110;426;382;1499
421568;201611;520;1578;314;1072;68;244;90;296;158;540
421569;201611;233;699;92;338;13;48;16;60;29;108
421570;201611;1425;4263;720;2522;186;688;114;363;300;1051
421575;201611;446;1439;348;1194;64;225;164;562;228;787
421580;201611;3096;9702;2113;7410;524;2044;555;1701;1079;3745
421590;201611;224;687;172;583;23;82;94;309;117;391
421600;201611;556;1671;371;1244;87;310;82;234;169;544
421605;201611;643;1937;434;1529;81;319;122;401;203;720
421610;201611;1435;3864;929;2868;145;495;398;1127;543;1622
421620;201611;4668;13873;2850;9983;788;2917;756;2569;1544;5486
421625;201611;391;1075;141;477;32;100;15;52;47;152
421630;201611;3161;9306;1530;5319;360;1312;238;766;598;2078
421635;201611;242;718;113;370;15;58;36;95;51;153
421640;201611;1086;3180;734;2473;160;540;272;899;432;1439
421650;201611;2204;6973;1490;5246;364;1456;198;571;562;2027
421660;201611;7950;25424;6114;21470;1356;5226;1875;5959;3231;11185
421670;201611;1106;3306;689;2332;181;689;201;614;382;1303
421680;201611;1167;3715;916;3159;302;1085;179;586;481;1671
421690;201611;1623;5209;1080;3874;231;913;104;304;335;1217
421700;201611;507;1619;249;939;48;193;62;202;110;395
421710;201611;213;707;97;352;20;78;27;87;47;165
421715;201611;262;691;130;411;33;113;36;98;69;211
421720;201611;1875;5511;1043;3710;280;1074;148;425;428;1499
421725;201611;140;435;103;352;27;97;24;74;51;171
421730;201611;604;1727;261;880;43;153;66;194;109;347
421740;201611;780;2468;493;1753;110;443;90;274;200;717
421750;201611;1046;2756;588;1823;109;366;217;601;326;967
421755;201611;325;937;169;544;36;129;52;159;88;288
421760;201611;882;2628;381;1371;70;260;84;262;154;522
421770;201611;3106;9179;2149;7196;579;2001;683;2332;1262;4333
421775;201611;511;1486;338;1150;53;201;121;383;174;584
421780;201611;1214;4027;844;3101;210;863;226;732;436;1595
421790;201611;853;2243;464;1605;169;637;94;268;263;905
421795;201611;355;1036;207;662;33;117;60;183;93;300
421800;201611;2829;8372;1984;6638;463;1721;728;2238;1191;3959
421810;201611;620;1891;410;1442;109;425;58;181;167;606
421820;201611;1033;2999;568;1947;89;309;96;275;185;584
421825;201611;1481;4640;1364;4380;163;613;988;3084;1151;3697
421830;201611;2521;8498;2113;7589;544;2153;707;2329;1251;4482
421835;201611;166;488;119;417;20;88;77;257;97;345
421840;201611;301;957;198;715;43;180;65;204;108;384
421850;201611;420;1345;219;805;34;144;47;160;81;304
421860;201611;323;990;191;695;35;145;45;130;80;275
421870;201611;4034;11296;2503;8038;761;2633;493;1484;1254;4117
421875;201611;407;1219;160;612;34;147;16;56;50;203
421880;201611;886;2690;605;2056;128;479;122;379;250;858
421885;201611;317;996;241;841;80;295;75;249;155;544
421890;201611;890;2998;733;2658;245;1036;218;706;463;1742
421895;201611;379;1195;331;1109;68;247;187;623;255;870
421900;201611;990;2741;568;1835;146;496;156;454;302;950
421910;201611;492;1550;308;1121;72;306;51;132;123;438
421915;201611;511;1517;287;965;57;180;58;192;115;372
421917;201611;595;1693;393;1358;151;595;113;366;264;961
421920;201611;779;2166;485;1752;252;948;106;382;358;1330
421930;201611;3254;8495;1619;5457;385;1384;216;626;601;2010
421935;201611;674;2179;471;1716;95;405;166;549;261;954
421940;201611;281;938;134;503;17;73;30;90;47;163
421950;201611;3762;10131;1579;5409;378;1383;202;658;580;2041
421960;201611;202;594;138;470;34;124;26;84;60;208
421970;201611;2379;6469;1297;4153;379;1250;365;1055;744;2305
421985;201611;517;1306;250;755;41;148;81;240;122;388
422000;201611;1236;3692;964;3132;271;958;363;1156;634;2114
430003;201611;799;2315;580;1916;147;555;155;482;302;1037
430005;201611;337;1003;230;781;50;184;95;301;145;485
430010;201611;2208;5932;1584;4822;407;1310;632;1918;1039;3228
430020;201611;727;1801;576;1569;88;274;354;916;442;1190
430030;201611;1064;2749;720;2096;254;786;124;317;378;1103
430040;201611;11410;29703;7506;22134;2001;6360;1050;2793;3051;9153
430045;201611;708;1893;490;1443;93;280;202;574;295;854
430047;201611;297;700;121;368;19;51;47;145;66;196
430050;201611;1057;2858;540;1718;114;366;138;414;252;780
430055;201611;312;820;149;460;18;64;66;190;84;254
430057;201611;78;184;33;96;3;6;6;9;9;15
430060;201611;17149;53803;14129;48132;4120;14995;5350;18132;9470;33127
430063;201611;1020;2957;758;2379;204;645;354;1133;558;1778
430064;201611;1322;3876;1011;3277;273;894;299;976;572;1870
430066;201611;174;407;115;306;11;37;67;171;78;208
430070;201611;641;1700;144;479;23;85;20;47;43;132
430080;201611;728;2060;406;1390;98;363;112;330;210;693
430085;201611;938;2428;535;1667;99;341;161;509;260;850
430087;201611;932;2814;828;2599;137;496;478;1369;615;1865
430090;201611;833;2160;270;879;37;133;53;174;90;307
430100;201611;869;2284;418;1325;100;335;110;288;210;623
430105;201611;1058;3024;658;2250;159;595;215;705;374;1300
430107;201611;265;860;177;613;34;127;43;133;77;260
430110;201611;1970;5565;1525;4815;363;1199;697;2066;1060;3265
430120;201611;1796;5251;1250;4053;267;889;547;1734;814;2623
430130;201611;3970;10197;3153;8816;859;2489;1180;3228;2039;5717
430140;201611;1219;3690;765;2628;223;782;221;745;444;1527
430150;201611;793;2100;462;1417;110;358;116;352;226;710
430155;201611;412;1128;184;620;31;115;45;138;76;253
430160;201611;17455;49687;14274;43877;3636;11875;5498;16805;9134;28680
430163;201611;2045;5890;1561;5018;225;811;845;2653;1070;3464
430165;201611;472;1162;110;373;15;50;18;55;33;105
430170;201611;972;2731;320;1166;47;181;32;92;79;273
430175;201611;930;2873;732;2398;212;654;278;989;490;1643
430180;201611;864;2349;659;1977;151;503;328;930;479;1433
430185;201611;605;1552;312;953;55;170;103;263;158;433
430187;201611;679;1978;483;1540;121;422;159;472;280;894
430190;201611;1728;5084;1430;4476;308;1055;724;2181;1032;3236
430192;201611;199;608;73;237;6;18;15;43;21;61
430195;201611;396;1201;74;254;10;36;2;7;12;43
430200;201611;1443;4543;1171;3923;354;1258;284;904;638;2162
430205;201611;595;1662;425;1330;43;151;294;916;337;1067
430210;201611;6668;17364;3583;10724;555;1822;1069;2601;1624;4423
430215;201611;361;992;230;699;40;124;95;269;135;393
430220;201611;750;1876;211;760;38;152;34;108;72;260
430222;201611;286;872;210;690;30;118;99;305;129;423
430223;201611;361;1011;283;863;69;198;131;415;200;613
430225;201611;36;88;16;45;4;12;5;12;9;24
430230;201611;1678;4935;1581;4818;221;543;1298;4130;1519;4673
430235;201611;297;955;224;772;52;193;67;211;119;404
430237;201611;543;1386;367;1068;39;133;232;637;271;770
430240;201611;1060;2719;661;2030;80;291;353;1016;433;1307
430245;201611;873;2666;638;2157;181;625;245;863;426;1488
430250;201611;1216;3445;1003;3045;346;1096;118;341;464;1437
430258;201611;167;469;119;379;10;34;53;175;63;209
430260;201611;811;2252;533;1676;70;223;271;880;341;1103
430265;201611;302;929;229;779;54;174;31;107;85;281
430270;201611;3014;8261;2491;7344;375;1244;1482;4159;1857;5403
430280;201611;4865;12896;3700;10769;892;2667;1616;4677;2508;7344
430290;201611;2526;6508;2270;6125;145;412;1966;5271;2111;5683
430300;201611;9501;27504;7398;23264;1781;5985;3218;10118;4999;16103
430310;201611;6937;20574;4999;16644;1206;4342;1889;5800;3095;10142
430320;201611;871;2489;501;1669;108;323;223;760;331;1083
430330;201611;704;1857;512;1469;140;385;212;573;352;958
430340;201611;713;1762;340;1104;71;235;173;548;244;783
430350;201611;6439;19370;5118;16433;2075;6749;1346;4179;3421;10928
430355;201611;393;981;128;393;26;91;19;53;45;144
430360;201611;1076;2797;801;2265;163;498;338;881;501;1379
430367;201611;289;762;162;507;39;143;56;169;95;312
430370;201611;572;1576;330;1066;85;295;69;196;154;491
430380;201611;875;2252;427;1396;141;508;104;323;245;831
430390;201611;4107;11390;2367;7646;443;1525;355;1057;798;2582
430400;201611;1444;3401;973;2609;315;856;351;885;666;1741
430410;201611;643;1701;431;1312;78;251;209;624;287;875
430420;201611;3712;10588;2734;8371;796;2496;892;2630;1688;5126
430430;201611;765;2027;418;1344;123;417;96;305;219;722
430435;201611;2109;5611;1468;4392;401;1252;497;1460;898;2712
430440;201611;4141;12823;3040;10241;663;2324;1297;4437;1960;6761
430450;201611;7625;20885;5651;16942;1896;5861;1369;4141;3265;10002
430460;201611;29279;85556;21084;69984;5793;20916;5985;18922;11778;39838
430461;201611;514;1357;142;451;22;70;40;122;62;192
430462;201611;280;794;163;574;33;125;31;114;64;239
430463;201611;4392;13765;3629;12249;819;2960;1618;5474;2437;8434
430465;201611;655;1768;528;1533;143;455;270;757;413;1212
430466;201611;3718;10079;3123;9074;722;2245;1594;4432;2316;6677
430467;201611;515;1506;406;1274;87;296;163;469;250;765
430468;201611;1499;4127;1210;3652;305;957;468;1355;773;2312
430469;201611;489;1327;55;196;7;22;8;18;15;40
430470;201611;7983;21073;5107;15906;1505;4883;887;2714;2392;7597
430471;201611;582;1890;489;1671;143;502;111;393;254;895
430480;201611;1047;2748;479;1566;80;270;114;332;194;602
430485;201611;216;590;82;263;16;57;12;29;28;86
430490;201611;329;949;207;684;42;145;91;301;133;446
430495;201611;381;1140;231;801;51;191;66;202;117;393
430500;201611;1211;3296;938;2822;233;774;435;1252;668;2026
430510;201611;22540;64797;16702;52882;5346;18164;4620;13424;9966;31588
430511;201611;392;1208;150;530;23;87;16;40;39;127
430512;201611;1182;3004;942;2559;253;724;275;759;528;1483
430513;201611;815;2094;424;1241;105;333;161;429;266;762
430515;201611;491;1399;328;1051;53;162;147;494;200;656
430517;201611;1200;3746;945;3191;190;659;469;1590;659;2249
430520;201611;1605;4412;933;2924;216;738;239;632;455;1370
430530;201611;1122;2988;467;1500;66;237;119;331;185;568
430535;201611;2580;7667;1814;6074;406;1458;691;2200;1097;3658
430537;201611;491;1565;407;1376;41;142;288;976;329;1118
430540;201611;761;1670;490;1295;91;247;279;733;370;980
430543;201611;514;1292;440;1205;85;247;304;843;389;1090
430544;201611;698;2205;551;1856;133;487;244;775;377;1262
430545;201611;1371;4323;1154;4036;389;1442;471;1642;860;3084
430550;201611;644;1838;348;1143;81;293;64;185;145;478
430558;201611;105;288;52;160;13;48;12;24;25;72
430560;201611;395;955;152;488;17;65;60;171;77;236
430570;201611;1153;2937;679;1974;153;508;279;680;432;1188
430580;201611;1298;3232;750;2302;129;444;363;1099;492;1543
430583;201611;173;464;41;126;4;10;7;22;11;32
430585;201611;346;894;200;578;41;145;85;213;126;358
430587;201611;189;592;146;476;45;153;37;124;82;277
430590;201611;1280;3470;1135;3207;125;405;849;2329;974;2734
430593;201611;24;88;20;74;5;20;9;31;14;51
430595;201611;312;876;79;270;8;39;9;21;17;60
430597;201611;353;1019;212;673;27;90;61;157;88;247
430600;201611;2122;5636;983;2997;194;593;286;800;480;1393
430605;201611;1386;4106;1013;3314;195;720;407;1305;602;2025
430607;201611;787;1866;555;1501;73;194;353;982;426;1176
430610;201611;8300;22022;5991;18091;1747;5666;1413;4122;3160;9788
430613;201611;276;672;95;284;16;41;20;50;36;91
430620;201611;769;2146;581;1762;141;440;231;661;372;1101
430630;201611;446;1372;194;650;33;106;27;78;60;184
430632;201611;703;1951;307;979;59;199;96;264;155;463
430635;201611;614;1736;447;1378;111;381;221;643;332;1024
430637;201611;490;1376;417;1227;64;225;236;642;300;867
430640;201611;1694;4499;650;2146;95;295;43;94;138;389
430642;201611;487;1259;286;877;51;151;127;390;178;541
430645;201611;281;648;91;261;18;51;24;71;42;122
430650;201611;1842;5887;1504;5168;329;1159;783;2712;1112;3871
430655;201611;168;436;141;382;31;111;67;144;98;255
430660;201611;5871;16296;4406;13550;1123;3670;1738;5246;2861;8916
430670;201611;513;1459;452;1336;40;118;346;1056;386;1174
430673;201611;762;1783;309;932;72;219;89;258;161;477
430675;201611;274;798;82;281;8;39;28;82;36;121
430676;201611;3782;11119;2929;9426;732;2508;952;3061;1684;5569
430680;201611;1154;3276;640;2125;141;465;140;405;281;870
430690;201611;4371;12266;3246;9936;1087;3379;694;2109;1781;5488
430692;201611;273;873;198;728;18;79;132;460;150;539
430693;201611;1306;3568;758;2399;155;550;162;461;317;1011
430695;201611;581;1576;347;1078;65;212;133;374;198;586
430697;201611;493;1367;333;1062;88;294;114;364;202;658
430700;201611;10351;26286;4441;14569;826;3031;297;846;1123;3877
430705;201611;288;859;216;693;68;233;57;156;125;389
430710;201611;1823;4535;1274;3566;265;818;507;1418;772;2236
430720;201611;887;2144;518;1576;128;397;152;453;280;850
430730;201611;1619;4189;969;3031;207;659;399;1280;606;1939
430740;201611;601;1653;298;998;65;224;59;205;124;429
430745;201611;510;1435;205;656;29;93;35;118;64;211
430750;201611;1611;4379;1218;3685;233;775;634;1862;867;2637
430755;201611;522;1389;293;890;31;108;138;383;169;491
430760;201611;3111;7520;2043;5912;436;1463;783;2344;1219;3807
430770;201611;6534;18672;4915;15552;958;3246;2557;7856;3515;11102
430780;201611;2512;6636;1393;4425;282;948;439;1349;721;2297
430781;201611;543;1544;324;1070;71;236;77;256;148;492
430783;201611;552;1330;302;875;59;192;139;361;198;553
430786;201611;75;250;44;167;6;27;9;27;15;54
430790;201611;4895;13260;3084;9504;697;2296;1137;3228;1834;5524
430800;201611;919;2555;575;1761;128;416;192;562;320;978
430805;201611;567;1579;331;1056;36;103;168;530;204;633
430807;201611;456;1286;279;878;59;209;81;236;140;445
430810;201611;708;1915;215;742;51;190;38;123;89;313
430820;201611;1358;3909;702;2415;151;530;137;437;288;967
430825;201611;408;1046;125;370;26;65;21;43;47;108
430830;201611;1772;5392;1580;5085;272;947;970;3058;1242;4005
430840;201611;1022;3019;865;2708;242;739;392;1252;634;1991
430843;201611;87;222;38;115;5;16;14;38;19;54
430845;201611;265;786;205;649;95;317;15;32;110;349
430850;201611;2550;7430;2034;6385;581;1981;716;2146;1297;4127
430860;201611;1065;2821;496;1616;116;444;164;476;280;920
430865;201611;642;1677;556;1535;183;516;235;622;418;1138
430870;201611;744;2049;338;1116;81;274;70;185;151;459
430880;201611;1222;3404;800;2532;208;701;215;692;423;1393
430885;201611;257;619;140;440;19;64;95;298;114;362
430890;201611;1797;4719;935;2838;113;390;212;538;325;928
430900;201611;2925;7597;2170;6230;462;1516;967;2551;1429;4067
430905;201611;1100;3087;641;2096;158;534;139;417;297;951
430910;201611;1623;4720;1013;3338;227;836;349;987;576;1823
430912;201611;465;1314;331;1058;52;178;204;638;256;816
430915;201611;594;1837;397;1452;139;533;80;321;219;854
430920;201611;17575;52440;14899;47165;2879;9964;8381;25529;11260;35493
430925;201611;144;324;53;157;12;39;17;49;29;88
430930;201611;10216;28426;6400;20994;1828;6289;1411;4793;3239;11082
430940;201611;1305;3937;687;2377;177;637;87;243;264;880
430950;201611;1010;2741;616;1897;157;511;209;575;366;1086
430955;201611;172;502;69;230;13;53;17;48;30;101
430957;201611;264;843;206;732;43;148;90;320;133;468
430960;201611;1416;3732;1061;3079;257;826;482;1378;739;2204
430965;201611;1569;4318;1266;3761;88;315;977;2810;1065;3125
430970;201611;532;1428;276;867;60;193;75;210;135;403
430975;201611;603;1927;427;1487;106;388;155;548;261;936
430980;201611;450;1099;242;766;57;176;82;252;139;428
430990;201611;589;1848;352;1215;65;237;99;330;164;567
430995;201611;640;1794;448;1383;123;386;163;479;286;865
431000;201611;1645;4172;678;2117;113;369;52;146;165;515
431010;201611;2802;7750;1442;4940;254;936;187;536;441;1472
431020;201611;11518;27799;6699;19009;1773;5172;1663;4507;3436;9679
431030;201611;327;940;131;478;30;111;17;59;47;170
431033;201611;2555;7366;2143;6679;614;2025;924;2896;1538;4921
431036;201611;228;589;88;292;14;47;18;45;32;92
431040;201611;964;2718;724;2273;145;538;339;976;484;1514
431041;201611;540;1394;446;1249;132;389;176;492;308;881
431043;201611;506;1401;263;915;112;406;49;153;161;559
431046;201611;118;331;76;237;6;22;24;71;30;93
431050;201611;1673;4189;1142;3245;308;890;512;1433;820;2323
431053;201611;617;1936;467;1594;147;539;97;319;244;858
431055;201611;689;1815;625;1708;80;206;456;1253;536;1459
431057;201611;378;1100;220;742;49;179;54;165;103;344
431060;201611;5636;16588;4726;14941;1563;5107;1398;4446;2961;9553
431065;201611;561;1582;377;1191;61;223;130;359;191;582
431070;201611;728;2043;362;1159;86;274;60;150;146;424
431075;201611;299;900;197;670;36;134;57;203;93;337
431080;201611;683;2065;429;1454;96;332;112;353;208;685
431085;201611;860;2306;628;1802;117;337;338;950;455;1287
431087;201611;596;1662;494;1456;51;144;339;1013;390;1157
431090;201611;558;1358;203;648;50;163;40;115;90;278
431100;201611;3735;10234;2854;8635;732;2381;901;2603;1633;4984
431110;201611;1573;4099;1066;3048;251;756;350;920;601;1676
431112;201611;571;1828;505;1684;119;404;236;749;355;1153
431113;201611;536;1514;394;1220;106;341;100;324;206;665
431115;201611;1397;3977;1172;3564;215;654;628;1904;843;2558
431120;201611;2767;8314;1987;6652;654;2451;560;1656;1214;4107
431123;201611;464;1338;280;957;75;254;130;449;205;703
431125;201611;1369;4074;891;3001;290;985;165;619;455;1604
431127;201611;254;689;45;150;7;20;10;26;17;46
431130;201611;3531;10054;2307;7548;505;1728;709;2312;1214;4040
431140;201611;5093;12443;2489;7686;382;1264;744;2018;1126;3282
431142;201611;473;1375;393;1225;59;190;235;740;294;930
431150;201611;1133;3339;816;2675;187;673;271;867;458;1540
431160;201611;922;2633;733;2252;133;378;351;1179;484;1557
431162;201611;535;1324;177;600;28;90;20;49;48;139
431164;201611;174;479;44;158;11;41;3;12;14;53
431170;201611;739;2025;489;1549;137;452;133;402;270;854
431171;201611;808;2332;666;2040;185;586;233;689;418;1275
431173;201611;490;1400;364;1166;140;482;76;222;216;704
431175;201611;1057;2926;820;2476;232;729;218;618;450;1347
431177;201611;822;2633;603;2174;194;764;211;724;405;1488
431179;201611;375;813;87;254;17;52;18;45;35;97
431180;201611;2429;6836;1506;4912;347;1199;277;830;624;2029
431190;201611;660;1831;321;1047;50;171;61;174;111;345
431198;201611;371;1214;320;1113;113;403;87;327;200;730
431200;201611;408;1147;91;318;11;36;4;10;15;46
431205;201611;296;888;128;451;32;103;36;134;68;237
431210;201611;789;2065;612;1768;176;502;299;884;475;1386
431213;201611;234;706;172;577;24;91;88;292;112;383
431215;201611;321;933;160;554;30;102;10;25;40;127
431217;201611;173;519;111;379;30;101;40;136;70;237
431220;201611;860;2335;447;1409;34;115;210;601;244;716
431225;201611;1381;3801;985;3034;234;711;361;1112;595;1823
431230;201611;856;2489;586;1892;102;348;243;763;345;1111
431235;201611;115;317;29;88;7;21;4;7;11;28
431237;201611;506;1463;378;1244;74;294;189;596;263;890
431238;201611;41;131;31;107;6;25;9;32;15;57
431240;201611;3400;9983;2727;8695;783;2669;1070;3281;1853;5950
431242;201611;394;1174;316;1016;97;310;106;358;203;668
431244;201611;403;924;212;589;27;86;97;244;124;330
431245;201611;1243;3207;765;2261;124;368;362;1054;486;1422
431247;201611;212;593;134;427;31;101;31;92;62;193
431250;201611;1535;4884;1281;4454;351;1298;464;1596;815;2894
431260;201611;353;981;158;553;19;81;44;133;63;214
431261;201611;256;857;205;732;37;164;90;289;127;453
431262;201611;424;1159;173;578;19;69;92;318;111;387
431265;201611;1498;3776;694;2086;130;406;191;464;321;870
431267;201611;275;785;154;467;24;89;94;259;118;348
431270;201611;2868;7053;1646;4913;422;1373;509;1493;931;2866
431275;201611;230;692;118;428;34;126;13;45;47;171
431280;201611;332;917;109;359;13;47;20;43;33;90
431290;201611;336;1025;222;749;43;165;31;72;74;237
431295;201611;93;253;32;101;0;0;10;26;10;26
431300;201611;389;976;44;169;3;11;1;3;4;14
431301;201611;284;871;86;296;16;56;13;34;29;90
431303;201611;784;2058;410;1264;58;203;146;412;204;615
431306;201611;2388;6112;1345;4128;163;576;404;1044;567;1620
431308;201611;40;136;35;119;20;73;8;25;28;98
431310;201611;754;2216;411;1398;81;287;119;406;200;693
431320;201611;806;2206;379;1264;66;233;68;198;134;431
431330;201611;2958;7226;1288;4082;367;1261;107;277;474;1538
431333;201611;430;1145;153;471;24;76;30;77;54;153
431335;201611;54;162;35;118;12;44;6;13;18;57
431337;201611;2612;7785;1740;5937;397;1434;280;924;677;2358
431339;201611;624;1671;405;1214;86;259;189;558;275;817
431340;201611;25063;66074;16608;50410;3936;12711;4041;11704;7977;24415
431342;201611;565;1389;416;1146;132;414;216;533;348;947
431344;201611;377;1015;249;772;9;20;191;604;200;624
431346;201611;301;759;95;295;18;60;13;39;31;99
431349;201611;757;2086;404;1221;75;229;145;400;220;629
431350;201611;4298;12441;3248;10348;735;2607;1136;3354;1871;5961
431360;201611;685;1720;402;1203;102;308;108;316;210;624
431365;201611;1450;4202;1162;3678;218;747;634;2001;852;2748
431370;201611;4962;13754;3642;11361;993;3276;1199;3812;2192;7088
431380;201611;948;2914;836;2666;121;435;490;1523;611;1958
431390;201611;3193;8317;1702;5348;336;1159;472;1307;808;2466
431395;201611;1303;3845;1037;3334;249;825;458;1480;707;2305
431400;201611;393;1203;155;517;33;116;32;100;65;216
431402;201611;1305;3040;728;2030;149;432;339;899;488;1331
431403;201611;260;723;181;582;51;190;51;141;102;331
431405;201611;4251;11768;3267;10159;627;2153;1687;5046;2314;7199
431406;201611;756;2266;526;1766;132;465;250;820;382;1285
431407;201611;559;1582;347;1155;72;243;108;328;180;571
431410;201611;15014;42489;9228;30497;2671;9702;1325;4072;3996;13774
431413;201611;230;577;82;277;6;23;21;63;27;86
431415;201611;729;2048;483;1558;102;376;144;393;246;769
431417;201611;577;1451;465;1280;59;175;294;795;353;970
431420;201611;1390;3766;1170;3399;253;774;495;1503;748;2277
431430;201611;593;1532;319;984;58;180;119;326;177;506
431440;201611;23810;65316;18107;55467;5462;17511;5283;16982;10745;34493
431442;201611;131;384;68;220;9;29;6;16;15;45
431445;201611;528;1486;182;593;26;81;49;148;75;229
431446;201611;449;1300;286;926;81;266;73;211;154;477
431447;201611;595;1685;426;1327;89;258;187;593;276;851
431449;201611;810;2190;582;1764;59;166;333;1019;392;1185
431450;201611;2244;5403;1892;4836;235;683;1380;3382;1615;4065
431454;201611;62;216;53;193;10;37;22;86;32;123
431455;201611;736;1834;349;979;86;247;110;281;196;528
431460;201611;3387;9190;2665;7735;725;2135;813;2437;1538;4572
431470;201611;1730;5020;1170;3758;257;805;412;1341;669;2146
431475;201611;201;594;29;115;4;22;1;1;5;23
431477;201611;746;1941;451;1325;53;161;226;623;279;784
431478;201611;288;723;82;233;10;27;12;25;22;52
431480;201611;3132;8564;2241;6904;471;1548;1017;3005;1488;4553
431490;201611;112959;301169;93422;270209;11527;38642;63881;178907;75408;217549
431500;201611;616;1690;463;1381;92;258;251;751;343;1009
431505;201611;510;1229;325;933;28;80;203;583;231;663
431507;201611;368;888;198;551;44;120;97;261;141;381
431510;201611;1905;5299;1386;4214;320;1019;455;1280;775;2299
431513;201611;313;838;142;441;19;58;71;220;90;278
431514;201611;112;297;43;147;3;12;9;28;12;40
431515;201611;695;1937;433;1344;103;357;158;435;261;792
431517;201611;81;266;57;202;10;38;13;40;23;78
431520;201611;532;1340;211;678;46;170;29;81;75;251
431530;201611;4405;10193;2902;8108;963;2827;736;2084;1699;4911
431531;201611;278;790;172;554;23;70;62;185;85;255
431532;201611;518;1412;385;1110;83;239;142;397;225;636
431535;201611;345;893;140;428;25;80;41;103;66;183
431540;201611;2117;6822;1814;6320;170;624;1196;4295;1366;4919
431545;201611;340;949;44;160;2;7;12;47;14;54
431550;201611;2276;6576;1876;5785;395;1311;773;2254;1168;3565
431555;201611;712;1747;471;1324;68;194;277;774;345;968
431560;201611;21063;61458;13634;46471;3484;12963;2845;9978;6329;22941
431570;201611;6061;15336;4599;13236;1350;3917;1890;5561;3240;9478
431575;201611;421;1084;285;836;47;153;63;161;110;314
431580;201611;657;1828;347;1123;73;261;97;289;170;550
431590;201611;988;2623;533;1657;139;438;161;498;300;936
431595;201611;445;1244;321;971;42;125;171;509;213;634
431600;201611;2103;5710;1379;4345;312;1102;313;934;625;2036
431610;201611;1500;4209;999;3159;161;504;421;1347;582;1851
431620;201611;490;1424;224;705;54;172;87;249;141;421
431630;201611;1446;3887;812;2493;234;735;220;641;454;1376
431640;201611;6370;17594;5573;16373;1121;3466;3302;9733;4423;13199
431642;201611;525;1392;369;1094;44;134;168;480;212;614
431643;201611;336;871;149;422;24;70;49;113;73;183
431645;201611;1774;4985;1423;4328;259;856;818;2438;1077;3294
431647;201611;157;452;88;287;13;45;16;45;29;90
431650;201611;351;1046;226;760;25;91;68;199;93;290
431660;201611;1178;3293;641;2126;128;457;115;312;243;769
431670;201611;1312;3412;920;2687;176;590;406;1078;582;1668
431673;201611;230;633;97;323;23;75;10;27;33;102
431675;201611;711;1807;130;433;16;55;31;84;47;139
431680;201611;9885;26747;6966;21056;1980;6256;1741;5244;3721;11500
431690;201611;24077;66333;17645;54772;4842;15697;5519;17433;10361;33130
431695;201611;146;440;95;312;18;61;27;64;45;125
431697;201611;460;1302;393;1174;111;339;177;540;288;879
431700;201611;1588;4454;1293;3865;213;639;697;2046;910;2685
431710;201611;12739;36265;9910;31447;3292;11046;2396;8168;5688;19214
431720;201611;7321;20088;5058;15401;1159;3756;1568;4539;2727;8295
431725;201611;28;80;15;52;3;11;4;12;7;23
431730;201611;4018;11502;2996;9591;833;2907;784;2595;1617;5502
431740;201611;5369;14675;3942;11939;1294;4249;631;1699;1925;5948
431750;201611;9218;25814;7567;22890;1941;6239;3117;9405;5058;15644
431755;201611;332;907;60;203;12;38;12;37;24;75
431760;201611;4250;11820;3197;9814;557;1872;1549;4498;2106;6370
431770;201611;2067;5414;1625;4688;307;901;930;2649;1237;3550
431775;201611;209;561;108;339;22;64;10;25;32;89
431780;201611;2480;6673;1700;5091;424;1328;377;1039;801;2367
431790;201611;1197;3518;861;2752;152;533;328;999;480;1532
431795;201611;382;1023;208;629;40;128;61;174;101;302
431800;201611;8729;25325;6422;20675;2006;6915;830;2526;2836;9441
431805;201611;338;827;86;299;12;45;19;68;31;113
431810;201611;3267;8871;2349;6965;458;1460;1012;2874;1470;4334
431820;201611;2605;7981;2131;7016;449;1609;899;2810;1348;4419
431830;201611;11108;26718;8130;22061;2231;6443;3118;8422;5349;14865
431840;201611;2727;8097;2250;7206;545;1858;1027;3308;1572;5166
431842;201611;809;2043;267;837;35;115;58;150;93;265
431843;201611;351;1020;266;843;40;145;130;393;170;538
431844;201611;285;786;69;239;16;60;11;28;27;88
431845;201611;520;1500;351;1111;28;90;224;711;252;801
431846;201611;332;994;282;915;26;101;201;642;227;743
431848;201611;262;701;129;413;13;48;23;63;36;111
431849;201611;480;1169;83;250;14;37;13;31;27;68
431850;201611;4858;14097;3954;12153;958;3084;1305;3909;2263;6993
431860;201611;803;2095;527;1553;91;306;261;705;352;1011
431861;201611;97;291;39;146;7;25;9;23;16;48
431862;201611;496;1607;384;1384;78;319;148;511;226;830
431870;201611;19010;54565;14306;45496;3478;11791;4940;15418;8418;27209
431880;201611;4371;12868;3211;10320;837;2888;1070;3224;1907;6112
431890;201611;5178;13939;3470;10660;1071;3469;664;2081;1735;5550
431900;201611;1129;3113;684;2169;180;643;278;793;458;1436
431910;201611;1020;2435;410;1199;71;201;114;303;185;504
431912;201611;507;1463;398;1250;116;345;160;524;276;869
431915;201611;1305;3511;952;2861;243;761;334;996;577;1757
431920;201611;1311;3638;1099;3279;129;391;780;2291;909;2682
431930;201611;1270;3416;814;2607;227;695;356;1187;583;1882
431935;201611;60;197;46;168;10;36;12;38;22;74
431936;201611;381;1099;254;792;56;198;98;301;154;499
431937;201611;330;848;163;496;40;126;25;65;65;191
431940;201611;2610;7029;1526;4768;350;1164;416;1240;766;2404
431950;201611;1676;5032;1425;4558;275;996;692;2098;967;3094
431960;201611;2966;8375;2353;7064;634;1958;681;2002;1315;3960
431970;201611;495;1351;208;683;41;139;44;132;85;271
431971;201611;98;291;54;196;9;32;7;26;16;58
431973;201611;474;1608;403;1457;53;189;252;933;305;1122
431975;201611;110;256;24;89;4;17;6;20;10;37
431980;201611;1406;4056;1070;3338;236;758;342;1022;578;1780
431990;201611;7634;20843;5253;16675;1003;3488;1688;5090;2691;8578
432000;201611;10447;28832;7887;24161;2555;7952;2605;7898;5160;15850
432010;201611;2282;6319;1727;5246;338;1104;811;2343;1149;3447
432020;201611;2347;5551;1626;4473;327;990;907;2363;1234;3353
432023;201611;554;1517;315;980;54;177;122;313;176;490
432026;201611;1194;3565;840;2797;125;397;435;1445;560;1842
432030;201611;426;1217;295;925;60;185;139;409;199;594
432032;201611;609;1543;374;1102;65;212;162;437;227;649
432035;201611;838;2480;720;2254;277;944;176;557;453;1501
432040;201611;998;2340;402;1297;69;233;155;476;224;709
432045;201611;263;731;134;456;27;92;40;140;67;232
432050;201611;648;1766;527;1539;94;281;291;872;385;1153
432055;201611;959;2673;630;2020;146;499;280;875;426;1374
432057;201611;409;994;282;767;46;113;154;396;200;509
432060;201611;563;1490;180;615;33;133;46;135;79;268
432065;201611;226;641;160;523;46;164;58;169;104;333
432067;201611;984;2962;684;2293;138;444;292;994;430;1438
432070;201611;2388;6568;1381;4417;295;991;297;880;592;1871
432080;201611;3917;10842;3075;9283;975;3136;1053;3107;2028;6243
432085;201611;327;905;209;703;52;181;92;298;144;479
432090;201611;1561;4409;1157;3587;327;1088;450;1332;777;2420
432100;201611;1384;3970;566;1958;92;346;41;99;133;445
432110;201611;2740;8119;1850;6189;428;1624;179;524;607;2148
432120;201611;4720;13821;3739;11955;1372;4577;885;2781;2257;7358
432130;201611;2778;7532;2131;6618;728;2411;797;2451;1525;4862
432132;201611;391;1097;162;560;24;88;40;129;64;217
432135;201611;760;2206;602;1888;104;336;379;1157;483;1493
432140;201611;1937;6125;1448;5141;337;1233;558;2079;895;3312
432143;201611;1416;4098;1146;3619;208;693;556;1780;764;2473
432145;201611;1330;4008;706;2474;117;451;113;356;230;807
432146;201611;181;574;110;391;30;107;22;82;52;189
432147;201611;652;2048;465;1629;125;467;90;322;215;789
432149;201611;372;1020;221;662;43;125;84;247;127;372
432150;201611;3839;10595;2653;8330;609;2093;781;2310;1390;4403
432160;201611;4614;14310;3836;12806;1177;4121;1248;4195;2425;8316
432162;201611;412;993;58;177;11;39;8;21;19;60
432163;201611;374;993;76;243;4;15;1;2;5;17
432166;201611;708;2062;533;1692;83;301;218;633;301;934
432170;201611;1196;3649;766;2675;189;686;151;495;340;1181
432180;201611;2790;7441;1582;4911;356;1142;288;761;644;1903
432183;201611;419;1289;313;1059;107;396;52;166;159;562
432185;201611;942;2435;573;1727;83;264;298;884;381;1148
432190;201611;3359;9005;1939;5849;410;1301;528;1463;938;2764
432195;201611;1137;3009;760;2334;157;464;298;898;455;1362
432200;201611;3162;9356;2433;8031;604;2139;1005;3306;1609;5445
432210;201611;429;1160;286;904;65;231;100;287;165;518
432215;201611;860;2573;714;2327;166;501;379;1321;545;1822
432218;201611;280;708;158;453;29;74;54;140;83;214
432220;201611;4289;11185;3279;9444;457;1496;1896;5214;2353;6710
432225;201611;106;324;80;271;31;114;20;64;51;178
432230;201611;1040;2776;567;1724;124;384;138;353;262;737
432232;201611;540;1504;409;1245;76;255;179;511;255;766
432234;201611;388;1040;213;654;43;130;53;153;96;283
432235;201611;111;318;35;123;6;19;1;1;7;20
432237;201611;476;1267;404;1136;24;82;287;777;311;859
432240;201611;14322;43696;11443;39491;1843;7266;6742;23777;8585;31043
432250;201611;4911;16477;4252;15076;1298;4864;1325;4752;2623;9616
432252;201611;452;1170;294;920;52;175;164;515;216;690
432253;201611;1323;4148;678;2376;146;564;46;131;192;695
432254;201611;876;2343;190;615;38;123;23;55;61;178
432255;201611;220;563;113;369;21;74;35;102;56;176
432260;201611;7847;19307;5141;14723;1208;3487;2080;6204;3288;9691
432270;201611;2655;7753;2081;6643;608;2029;552;1730;1160;3759
432280;201611;1436;3863;674;2137;92;295;179;504;271;799
432285;201611;197;613;22;76;4;16;2;2;6;18
432290;201611;571;1649;326;1062;90;287;78;250;168;537
432300;201611;24538;71710;20625;64581;3850;13036;11507;35156;15357;48192
432310;201611;822;2361;615;1991;157;536;290;911;447;1447
432320;201611;235;596;99;307;21;62;17;43;38;105
432330;201611;334;873;109;355;12;37;14;38;26;75
432335;201611;158;450;55;197;11;38;10;26;21;64
432340;201611;344;826;154;468;28;100;48;130;76;230
432345;201611;661;1815;588;1685;77;274;372;982;449;1256
432350;201611;395;1068;187;615;29;88;56;169;85;257
432360;201611;199;612;36;137;5;20;7;20;12;40
432370;201611;429;1171;294;886;37;114;179;539;216;653
432375;201611;781;1936;569;1586;71;195;327;907;398;1102
432377;201611;237;795;33;126;6;20;10;35;16;55
432380;201611;971;3095;763;2651;241;920;291;970;532;1890
500020;201611;2426;6948;1741;5697;354;1337;739;2303;1093;3640
500025;201611;1420;3282;801;2188;76;193;473;1263;549;1456
500060;201611;7144;20953;5393;17837;777;2516;3363;11549;4140;14065
500070;201611;4486;12672;3286;10436;746;2590;1227;3865;1973;6455
500080;201611;1514;4386;1055;3480;269;964;365;1169;634;2133
500085;201611;2350;5946;1556;4699;147;444;971;2864;1118;3308
500090;201611;2401;6771;1638;5310;334;1116;660;2228;994;3344
500100;201611;2904;8156;2198;6867;479;1626;897;2634;1376;4260
500110;201611;8473;24560;6316;21010;1140;4057;2793;9786;3933;13843
500124;201611;2105;6665;1745;6034;422;1396;846;3257;1268;4653
500150;201611;1423;3589;883;2614;181;598;322;803;503;1401
500190;201611;5084;12827;3700;10823;794;2409;1922;5706;2716;8115
500200;201611;2498;6212;1761;4866;415;1192;681;1739;1096;2931
500210;201611;4852;14274;3849;12592;926;3146;1651;5452;2577;8598
500215;201611;1526;4600;1045;3559;184;659;386;1281;570;1940
500220;201611;3150;9619;2447;8327;511;1832;1063;3637;1574;5469
500230;201611;2909;7342;1944;5729;378;1181;968;2873;1346;4054
500240;201611;4640;14407;3084;11026;528;2087;900;3333;1428;5420
500260;201611;2845;7100;1880;5542;296;932;963;2724;1259;3656
500270;201611;129638;329706;74214;228152;17276;56148;16879;50117;34155;106265
500280;201611;1386;3512;1069;3056;85;252;818;2358;903;2610
500290;201611;4713;10502;2405;6987;501;1523;864;2437;1365;3960
500295;201611;2776;7915;1475;4847;222;793;390;1080;612;1873
500310;201611;806;2094;626;1810;136;442;314;857;450;1299
500315;201611;3223;9914;2537;8715;366;1302;1541;5474;1907;6776
500320;201611;17747;56004;12942;46491;3877;14998;3242;12038;7119;27036
500325;201611;4256;10774;2919;8593;532;1696;1607;4732;2139;6428
500330;201611;7057;18129;4371;13030;896;2852;1884;5456;2780;8308
500345;201611;2231;5741;1650;4825;406;1263;719;2061;1125;3324
500348;201611;2322;6674;1965;6086;169;634;1337;4029;1506;4663
500350;201611;1301;3777;630;2145;70;251;216;726;286;977
500370;201611;24470;72292;17079;58010;3734;14114;5029;16855;8763;30969
500375;201611;2960;8020;2035;6193;411;1284;583;1738;994;3022
500380;201611;3522;9437;2462;7467;573;1771;992;2994;1565;4765
500390;201611;605;1346;320;885;52;167;166;422;218;589
500400;201611;1395;4167;951;3103;213;723;229;689;442;1412
500410;201611;2281;6384;1749;5555;373;1216;915;2978;1288;4194
500430;201611;2766;7522;1893;6175;417;1518;731;2449;1148;3967
500440;201611;1513;3954;945;2921;174;571;400;1227;574;1798
500450;201611;1729;5052;1113;3755;216;778;168;459;384;1237
500460;201611;4151;11934;2671;8889;698;2520;535;1688;1233;4208
500470;201611;3123;9030;1975;6459;531;1877;336;992;867;2869
500480;201611;2352;6938;2112;6630;186;512;1632;5498;1818;6010
500490;201611;979;2660;669;2092;196;695;119;374;315;1069
500500;201611;3976;11784;2863;10000;1064;4214;844;2907;1908;7121
500510;201611;864;2199;508;1527;63;206;226;621;289;827
500515;201611;1966;5132;1530;4511;204;603;961;3033;1165;3636
500520;201611;3257;11000;2753;9979;424;1736;1665;5948;2089;7684
500525;201611;1227;3795;937;3222;158;617;445;1556;603;2173
500540;201611;6440;17338;3375;11350;914;3498;418;1184;1332;4682
500560;201611;4841;15526;4273;14584;517;1917;3049;10440;3566;12357
500568;201611;4461;10772;2656;7864;670;2336;734;1855;1404;4191
500570;201611;8063;21030;4681;14442;1232;4033;863;2533;2095;6566
500580;201611;3798;10449;2910;8944;262;813;2087;6468;2349;7281
500600;201611;4028;10543;2363;7369;611;2036;597;1779;1208;3815
500620;201611;8103;22809;5528;17628;1078;3620;2348;7477;3426;11097
500625;201611;759;2182;382;1295;74;267;130;433;204;700
500627;201611;662;1771;386;1236;87;269;83;262;170;531
500630;201611;6220;16717;4093;12898;1066;3545;1185;3626;2251;7171
500635;201611;2790;10135;2232;9233;276;1116;1535;6806;1811;7922
500640;201611;1702;4039;1237;3356;71;213;907;2415;978;2628
500660;201611;19829;55892;14333;46446;4290;15467;3827;11995;8117;27462
500690;201611;2584;7523;2003;6667;945;3310;462;1624;1407;4934
500710;201611;3555;10345;2785;8933;652;2342;1061;3296;1713;5638
500720;201611;6334;16600;3583;11529;917;3167;702;2133;1619;5300
500730;201611;1022;2787;629;1980;162;542;199;594;361;1136
500740;201611;4504;12016;3097;9369;369;1255;1615;4818;1984;6073
500750;201611;1001;2735;777;2322;131;424;398;1121;529;1545
500755;201611;1223;3533;758;2520;150;508;145;379;295;887
500769;201611;5631;14707;2756;8625;466;1563;591;1554;1057;3117
500770;201611;1773;5053;1119;3740;263;919;282;924;545;1843
500780;201611;1177;3354;826;2650;223;708;220;685;443;1393
500790;201611;10127;27064;7919;23224;1546;5112;4160;11694;5706;16806
500793;201611;2335;6560;1595;5121;469;1566;292;807;761;2373
500795;201611;2416;7021;1996;6410;268;712;1375;4769;1643;5481
500797;201611;853;2280;545;1736;100;359;205;607;305;966
500800;201611;3007;7886;2121;6525;813;2779;421;1327;1234;4106
500830;201611;20365;53393;13023;39215;2596;8420;4633;13056;7229;21476
500840;201611;1387;3777;804;2540;91;300;321;955;412;1255
510010;201611;1277;3716;999;3229;244;760;515;1717;759;2477
510020;201611;3517;9780;1889;6335;404;1395;366;1096;770;2491
510025;201611;7709;22119;5123;16789;1130;3930;1378;4142;2508;8072
510030;201611;1731;4606;1329;3961;271;871;650;1871;921;2742
510035;201611;895;2480;603;2004;151;520;295;987;446;1507
510040;201611;1848;4885;1323;4027;185;592;750;2266;935;2858
510050;201611;1899;5428;1281;4183;336;1190;370;1174;706;2364
510060;201611;1626;4566;1136;3576;205;674;476;1436;681;2110
510080;201611;1039;3295;773;2719;220;812;111;331;331;1143
510100;201611;694;1785;432;1246;49;161;215;563;264;724
510120;201611;311;658;197;514;12;38;137;351;149;389
510125;201611;3185;8241;2233;6476;393;1326;882;2309;1275;3635
510130;201611;1785;4917;1357;4123;379;1221;420;1234;799;2455
510140;201611;2946;9129;2155;7818;902;3641;430;1293;1332;4934
510160;201611;1329;4387;1172;4132;211;798;715;2511;926;3309
510170;201611;5346;15917;4061;13561;810;2896;1783;5724;2593;8620
510180;201611;12717;32598;8076;24869;2353;7521;2152;7434;4505;14955
510185;201611;1420;4163;1094;3703;188;598;673;2526;861;3124
510190;201611;2509;6730;1653;5398;282;965;915;3047;1197;4012
510250;201611;14321;42344;11820;38316;3498;12064;4602;15223;8100;27287
510260;201611;2253;9067;1760;8027;320;1367;948;4981;1268;6348
510263;201611;4237;11280;2869;8901;714;2326;676;1965;1390;4291
510267;201611;5876;16924;3726;12147;796;2760;896;2773;1692;5533
510268;201611;920;2620;755;2373;144;497;444;1373;588;1870
510269;201611;1028;3140;676;2380;235;857;150;518;385;1375
510270;201611;2750;8852;2099;7397;478;1672;759;2649;1237;4321
510279;201611;1854;5586;1379;4496;352;1227;436;1285;788;2512
510285;201611;1231;3548;881;2910;254;904;273;843;527;1747
510300;201611;3477;9904;2748;8816;197;693;2069;6701;2266;7394
510305;201611;1572;4822;1128;3934;282;1045;351;1240;633;2285
510310;201611;827;2448;652;2118;224;760;181;562;405;1322
510320;201611;3843;10824;2595;8381;604;2181;819;2409;1423;4590
510325;201611;5238;16105;4253;14716;1131;4073;2448;8722;3579;12795
510330;201611;2893;9174;2177;7796;529;1952;775;2921;1304;4873
510335;201611;4969;14684;3859;13188;519;1755;2594;9313;3113;11068
510336;201611;601;1819;423;1459;83;296;191;654;274;950
510337;201611;2047;6573;1523;5497;603;2291;234;852;837;3143
510340;201611;79471;209158;50406;160376;16918;58972;8625;27416;25543;86388
510343;201611;1132;3214;820;2598;108;363;459;1423;567;1786
510345;201611;1641;4797;1222;3981;325;1137;418;1295;743;2432
510350;201611;3316;8822;2361;7388;616;2029;1008;3248;1624;5277
510360;201611;1800;4347;1098;3442;99;386;784;2415;883;2801
510370;201611;1381;4388;1049;3813;240;937;541;2014;781;2951
510380;201611;525;1519;286;1005;81;303;22;74;103;377
510385;201611;978;3662;658;2893;82;391;320;1518;402;1909
510390;201611;1095;3438;896;3033;242;756;442;1594;684;2350
510395;201611;789;1882;526;1486;69;215;235;737;304;952
510410;201611;3917;12468;3230;11114;811;2878;1467;5150;2278;8028
510420;201611;2471;6102;1711;4810;278;840;825;2283;1103;3123
510450;201611;761;1966;462;1450;106;360;120;352;226;712
510452;201611;680;2145;474;1651;79;272;249;858;328;1130
510454;201611;881;2714;704;2364;102;360;434;1474;536;1834
510455;201611;989;3014;674;2302;121;463;243;770;364;1233
510460;201611;2345;6046;1647;4964;207;740;956;2739;1163;3479
510480;201611;4675;11975;3029;8867;604;1822;1019;2763;1623;4585
510490;201611;1638;5012;1330;4516;299;1132;690;2234;989;3366
510500;201611;1504;4400;964;3294;199;798;446;1448;645;2246
510510;201611;2771;9398;2190;8206;659;2597;563;2134;1222;4731
510515;201611;6594;18995;4146;13668;877;3101;916;2682;1793;5783
510517;201611;1580;4668;1182;3854;341;1153;256;794;597;1947
510520;201611;2218;4996;1414;3934;54;154;1001;2951;1055;3105
510523;201611;1007;2914;859;2654;125;377;575;1837;700;2214
510525;201611;8275;21464;5208;16185;1033;3269;1793;5418;2826;8687
510530;201611;534;1510;432;1350;44;194;290;854;334;1048
510550;201611;2835;9079;2095;7570;568;2178;661;2372;1229;4550
510558;201611;1940;5513;1545;4879;179;604;964;3134;1143;3738
510560;201611;1746;5195;1017;3875;289;1170;211;832;500;2002
510562;201611;5473;15770;3712;12105;1084;3757;928;3099;2012;6856
510590;201611;3366;8436;2484;7284;494;1383;1460;4459;1954;5842
510600;201611;1639;4142;973;2950;204;627;367;1067;571;1694
510610;201611;2938;8266;2275;7201;205;723;1476;4584;1681;5307
510615;201611;2091;6278;1705;5622;537;1830;668;2250;1205;4080
510617;201611;646;1886;520;1673;37;98;413;1390;450;1488
510618;201611;1535;4317;1019;3276;215;819;483;1436;698;2255
510619;201611;805;2212;413;1389;45;175;52;140;97;315
510620;201611;1448;3574;702;2290;192;690;103;269;295;959
510621;201611;825;2789;705;2526;184;745;189;633;373;1378
510622;201611;4067;12152;2681;9079;741;2656;412;1248;1153;3904
510623;201611;3508;9589;2459;7711;629;2170;831;2392;1460;4562
510624;201611;1662;4688;831;2863;160;615;152;462;312;1077
510625;201611;2119;5957;1494;4863;416;1476;245;758;661;2234
510626;201611;1642;4336;988;3324;302;1151;196;628;498;1779
510627;201611;740;2109;465;1510;133;462;106;335;239;797
510628;201611;1589;3881;1056;3112;197;578;630;1871;827;2449
510629;201611;1819;5864;1383;4864;425;1613;370;1281;795;2894
510630;201611;2511;8346;1594;6248;367;1573;262;1007;629;2580
510631;201611;390;1091;325;976;12;28;271;821;283;849
510637;201611;2807;8102;2268;7173;853;2906;647;1972;1500;4878
510642;201611;4867;15835;4006;14476;1264;5024;1581;5868;2845;10892
510645;201611;994;2197;579;1619;199;537;157;464;356;1001
510650;201611;6559;20876;5708;19793;1542;5548;3299;11836;4841;17384
510665;201611;1757;4536;971;3016;171;543;413;1310;584;1853
510670;201611;404;912;214;633;21;79;106;308;127;387
510675;201611;6546;20178;4824;16611;1405;5227;959;3177;2364;8404
510677;201611;1983;5343;1581;4793;182;568;1165;3658;1347;4226
510680;201611;729;2177;488;1662;109;384;88;265;197;649
510682;201611;2131;6714;1541;5514;439;1730;278;930;717;2660
510685;201611;940;2498;701;2093;87;288;414;1177;501;1465
510700;201611;4376;11208;2782;8821;659;2103;1269;4142;1928;6245
510704;201611;10154;26524;6964;20588;1382;4482;2908;7990;4290;12472
510706;201611;1956;5803;1295;4763;262;980;663;2582;925;3562
510710;201611;3415;9292;2208;6749;503;1563;646;1786;1149;3349
510715;201611;737;1767;451;1252;75;216;175;510;250;726
510718;201611;2377;5842;1445;4653;663;2154;303;1155;966;3309
510719;201611;431;968;234;691;27;98;119;334;146;432
510720;201611;1203;2853;772;2220;204;642;256;631;460;1273
510724;201611;745;2202;519;1731;109;400;194;585;303;985
510726;201611;732;1678;435;1213;69;188;247;658;316;846
510729;201611;731;1813;359;1090;83;283;117;339;200;622
510730;201611;2854;8024;1866;6087;553;1891;461;1429;1014;3320
510735;201611;1020;3264;751;2831;135;571;380;1428;515;1999
510740;201611;1152;2770;738;2107;151;408;379;1147;530;1555
510757;201611;731;2383;584;2086;258;941;141;474;399;1415
510760;201611;33368;83988;19862;60404;5883;19176;3957;10994;9840;30170
510770;201611;4563;11160;3612;9980;365;944;2384;7276;2749;8220
510774;201611;366;1013;283;836;49;172;138;424;187;596
510775;201611;728;2134;550;1778;167;607;133;371;300;978
510776;201611;555;1523;401;1195;100;325;155;453;255;778
510777;201611;1598;4622;1145;3968;152;551;889;3104;1041;3655
510779;201611;652;1935;474;1591;72;231;231;810;303;1041
510780;201611;3824;11078;2936;9627;756;2524;1165;4088;1921;6612
510785;201611;1784;5090;1158;3891;335;1152;185;648;520;1800
510787;201611;2382;7087;1765;5920;753;2636;256;804;1009;3440
510788;201611;578;1479;383;1173;133;406;119;418;252;824
510790;201611;16643;47544;9913;33970;2106;8046;1054;3531;3160;11577
510792;201611;8787;25154;5292;18114;1086;4057;872;2729;1958;6786
510794;201611;1248;3813;909;3133;282;1059;246;786;528;1845
510795;201611;8374;24698;5646;19293;1522;5683;1072;3782;2594;9465
510800;201611;1659;4554;1208;3800;252;838;521;1521;773;2359
510805;201611;2035;5571;1403;4439;307;1076;596;1729;903;2805
510810;201611;674;1626;494;1360;138;369;224;600;362;969
510820;201611;776;1767;455;1264;85;279;179;431;264;710
510830;201611;716;2095;559;1840;115;374;283;994;398;1368
510835;201611;656;1897;453;1500;93;332;189;582;282;914
510840;201611;48163;119442;36550;103282;9123;26650;16550;47840;25673;74490
510850;201611;1681;4596;951;3167;260;903;134;389;394;1292
510860;201611;2740;8287;1792;6424;594;2342;118;382;712;2724
510880;201611;621;2050;510;1838;161;624;184;660;345;1284
510885;201611;656;1820;500;1587;94;325;201;619;295;944
510890;201611;860;2640;675;2352;144;544;348;1212;492;1756
510895;201611;1148;3440;892;2914;199;725;332;991;531;1716
520005;201611;1522;4760;1299;4417;408;1381;562;1999;970;3380
520010;201611;1796;5964;1357;4981;486;1978;210;659;696;2637
520013;201611;3401;9471;2343;7380;574;1857;712;2251;1286;4108
520015;201611;494;1404;381;1213;86;295;129;429;215;724
520017;201611;1098;3211;871;2809;220;787;339;999;559;1786
520020;201611;462;1177;339;993;69;213;153;431;222;644
520025;201611;29744;88187;26782;84280;3545;11776;20059;62913;23604;74689
520030;201611;4830;14673;3789;12775;677;2497;1913;6388;2590;8885
520050;201611;430;1082;241;722;17;43;167;520;184;563
520055;201611;798;2389;651;2076;115;352;344;1099;459;1451
520060;201611;1380;4274;1111;3711;273;1008;356;1120;629;2128
520080;201611;1881;5369;1517;4857;295;881;829;2854;1124;3735
520082;201611;1103;2904;929;2603;178;426;576;1689;754;2115
520085;201611;842;2512;705;2249;164;509;225;713;389;1222
520090;201611;987;2271;682;1860;155;365;345;1045;500;1410
520110;201611;42748;122213;30815;102546;11261;41705;3840;11910;15101;53615
520120;201611;176;456;90;302;16;59;26;82;42;141
520130;201611;3472;9656;3000;8912;718;2285;1542;4606;2260;6891
520140;201611;34802;112370;27756;97790;10304;38661;3826;12842;14130;51503
520145;201611;382;1028;251;778;48;159;71;211;119;370
520150;201611;504;1311;399;1177;62;208;228;651;290;859
520160;201611;914;2412;705;2081;186;543;222;661;408;1204
520170;201611;4551;10248;3435;8926;256;702;2846;7456;3102;8158
520180;201611;2166;6275;1715;5524;287;1084;886;2779;1173;3863
520215;201611;2032;5127;1572;4358;198;550;1003;2802;1201;3352
520235;201611;716;1825;496;1477;100;339;190;532;290;871
520250;201611;1603;4486;1058;3498;293;1063;230;731;523;1794
520260;201611;810;2030;465;1364;91;281;166;453;257;734
520280;201611;575;1662;490;1528;155;503;179;617;334;1120
520310;201611;1224;2898;779;2161;223;668;252;743;475;1411
520320;201611;1958;5975;1517;5088;146;497;987;3377;1133;3874
520330;201611;2725;8288;1925;6813;514;1957;282;946;796;2903
520340;201611;1916;4774;1397;4030;228;577;890;2742;1118;3319
520350;201611;3405;9111;2387;7160;701;2248;877;2507;1578;4755
520355;201611;1119;3612;960;3340;266;993;442;1505;708;2498
520357;201611;868;2309;678;1985;61;188;471;1368;532;1556
520360;201611;730;2069;580;1796;165;532;222;699;387;1231
520380;201611;1320;3516;797;2462;115;386;365;1063;480;1449
520390;201611;1109;2622;608;1926;172;624;181;506;353;1130
520393;201611;546;1297;400;1076;53;143;237;617;290;760
520396;201611;697;2227;562;1954;65;260;364;1233;429;1493
520400;201611;1678;4754;1384;4295;257;849;814;2482;1071;3331
520410;201611;1600;3801;1100;3055;226;706;587;1565;813;2271
520420;201611;333;922;221;671;34;108;92;259;126;367
520425;201611;1290;3510;964;2872;291;881;396;1206;687;2087
520430;201611;1942;5111;1055;3373;234;729;167;471;401;1200
520440;201611;3790;9677;2342;6981;683;2206;466;1346;1149;3552
520450;201611;10831;29389;6341;20808;1530;5309;367;1082;1897;6391
520455;201611;718;2115;540;1792;182;626;179;601;361;1227
520460;201611;907;2531;731;2232;110;388;415;1218;525;1606
520465;201611;896;2320;746;2109;73;251;530;1435;603;1686
520470;201611;1779;5669;1569;5320;367;1294;948;3325;1315;4619
520480;201611;970;2778;605;2025;98;336;177;511;275;847
520485;201611;1330;4158;1128;3814;234;864;683;2313;917;3177
520490;201611;4176;12692;3152;10989;874;3069;1423;5101;2297;8170
520495;201611;1411;3632;1114;3214;93;277;878;2593;971;2870
520500;201611;1312;3653;1054;3240;281;946;411;1230;692;2176
520505;201611;748;2105;618;1883;132;404;320;966;452;1370
520510;201611;9419;25984;6216;20536;1499;5373;1867;6137;3366;11510
520520;201611;1102;3032;845;2641;278;892;231;750;509;1642
520530;201611;2003;6493;1540;5627;560;2064;361;1438;921;3502
520540;201611;2928;8122;1946;6183;536;1752;326;1023;862;2775
520545;201611;1112;3316;850;2774;164;573;261;804;425;1377
520547;201611;678;2105;558;1870;183;616;172;548;355;1164
520549;201611;9914;29022;7973;26082;2299;7775;3556;11753;5855;19528
520551;201611;3767;11344;3360;10708;825;2903;1994;6212;2819;9115
520552;201611;765;2254;678;2136;100;327;473;1512;573;1839
520570;201611;593;1625;392;1252;137;464;132;400;269;864
520580;201611;3218;7736;2134;6174;504;1633;1049;2934;1553;4567
520590;201611;1462;4121;1022;3296;238;786;209;654;447;1440
520620;201611;8105;23747;6898;22016;1714;5610;3676;11858;5390;17468
520630;201611;951;2422;608;1841;110;344;276;803;386;1147
520640;201611;2844;7690;2205;6563;570;1688;862;2630;1432;4318
520650;201611;871;2287;607;1782;106;344;326;933;432;1277
520660;201611;359;1007;263;867;95;343;84;277;179;620
520670;201611;987;2850;858;2655;59;182;681;2084;740;2266
520680;201611;798;2085;577;1707;143;414;232;694;375;1108
520690;201611;327;852;237;706;60;159;105;319;165;478
520710;201611;559;1438;327;976;7;18;210;619;217;637
520725;201611;1644;4161;1160;3327;167;519;741;2075;908;2594
520735;201611;838;2277;549;1717;116;402;192;580;308;982
520740;201611;1869;4892;1423;4272;240;781;796;2336;1036;3117
520750;201611;632;1691;477;1446;102;301;221;703;323;1004
520753;201611;1512;3997;1315;3708;185;510;875;2628;1060;3138
520760;201611;835;2189;713;2022;84;221;514;1537;598;1758
520780;201611;1955;4739;1434;3959;167;448;928;2519;1095;2967
520790;201611;2871;7216;2091;5995;193;503;1541;4597;1734;5100
520800;201611;17220;47079;14208;43318;3063;8854;8399;27416;11462;36270
520810;201611;1104;2684;825;2339;81;224;642;1914;723;2138
520815;201611;591;1851;388;1391;165;648;18;61;183;709
520830;201611;1677;4211;1314;3785;53;141;1118;3211;1171;3352
520840;201611;1753;5593;1426;4996;572;2131;263;981;835;3112
520850;201611;613;1842;429;1514;106;409;122;423;228;832
520860;201611;6700;19609;4844;16322;1210;4328;1644;5626;2854;9954
520870;201611;104767;276334;67958;213274;20280;68396;14310;42494;34590;110890
520880;201611;7190;20287;5086;17005;1913;7135;414;1226;2327;8361
520890;201611;3967;10955;2996;9245;627;2117;1377;4154;2004;6271
520910;201611;3947;11207;2636;8608;944;3266;474;1454;1418;4720
520915;201611;650;1899;469;1525;114;388;219;693;333;1081
520920;201611;3542;9362;2383;7463;468;1541;922;2949;1390;4490
520929;201611;624;1633;443;1330;100;280;228;725;328;1005
520940;201611;1102;3108;852;2721;87;304;626;1963;713;2267
520945;201611;667;1587;502;1293;125;295;254;641;379;936
520960;201611;1037;3000;774;2475;64;193;376;1226;440;1419
520970;201611;2937;8832;2392;7773;633;2213;580;1807;1213;4020
520980;201611;781;2235;649;2022;205;675;330;1019;535;1694
520990;201611;3023;9519;2774;9165;336;1121;1937;6674;2273;7795
520993;201611;980;2466;761;2139;50;138;564;1605;614;1743
520995;201611;2342;6228;1977;5728;408;1116;1191;3541;1599;4657
521000;201611;7358;21846;5562;18245;2022;7088;1181;3564;3203;10652
521010;201611;4128;11812;3034;9684;715;2234;1252;3986;1967;6220
521015;201611;697;1887;580;1693;108;293;364;1073;472;1366
521020;201611;2872;8220;1751;5764;528;1827;171;522;699;2349
521030;201611;669;1678;480;1351;102;282;193;557;295;839
521040;201611;6421;17064;5049;14831;1766;5311;1547;4754;3313;10065
521056;201611;878;2616;683;2261;246;871;173;610;419;1481
521060;201611;1128;2916;843;2455;269;756;307;972;576;1728
521080;201611;1161;2751;629;1836;61;206;269;683;330;889
521090;201611;3022;8068;2253;6944;741;2364;675;2104;1416;4468
521100;201611;2074;4716;1473;3863;264;657;906;2450;1170;3107
521120;201611;4905;12492;3627;10790;986;3083;1330;4295;2316;7378
521130;201611;1051;2818;728;2176;100;363;420;1230;520;1593
521140;201611;1056;3174;802;2637;197;675;256;845;453;1520
521150;201611;12274;30403;7160;21297;2854;8813;1512;4521;4366;13334
521160;201611;878;2044;521;1427;110;306;227;615;337;921
521170;201611;1186;2878;845;2340;162;463;491;1336;653;1799
521180;201611;6568;20922;5676;19232;1553;5547;1839;6260;3392;11807
521190;201611;9523;27085;5827;19811;1485;5453;1175;3890;2660;9343
521200;201611;768;2073;576;1721;67;225;337;980;404;1205
521205;201611;620;1731;465;1448;49;161;278;853;327;1014
521210;201611;952;2640;541;1731;147;542;103;268;250;810
521220;201611;4515;11251;3113;9219;690;2174;1448;4295;2138;6469
521225;201611;409;995;324;896;36;95;237;687;273;782
521230;201611;1269;3929;1086;3549;345;1188;475;1516;820;2704
521250;201611;30858;93818;25105;84420;11164;39134;5792;19863;16956;58997
521260;201611;700;1675;549;1452;93;277;303;770;396;1047
521270;201611;1905;5401;1683;5065;170;438;1246;3904;1416;4342
521280;201611;1900;5702;1480;4862;440;1513;440;1411;880;2924
521290;201611;497;1372;361;1165;90;333;162;495;252;828
521295;201611;1216;2895;966;2538;150;366;671;1842;821;2208
521300;201611;1950;5455;1609;4868;191;559;1029;3128;1220;3687
521305;201611;752;2106;588;1824;114;331;312;1000;426;1331
521308;201611;4494;13200;3405;10978;823;2670;1478;4746;2301;7416
521310;201611;8348;24179;5510;18342;1389;4930;1172;3611;2561;8541
521340;201611;347;892;323;862;18;44;277;733;295;777
521350;201611;2004;5430;1539;4642;247;731;971;2980;1218;3711
521370;201611;967;2798;660;2214;234;828;96;305;330;1133
521375;201611;1379;3846;1069;3352;283;973;466;1392;749;2365
521377;201611;1108;2791;978;2633;61;111;839;2304;900;2415
521380;201611;5586;15664;3274;11005;491;1643;1051;3542;1542;5185
521385;201611;545;1428;454;1310;137;404;194;589;331;993
521390;201611;801;2186;590;1875;174;620;170;512;344;1132
521400;201611;2168;6079;1939;5779;327;1097;1364;4022;1691;5119
521405;201611;1414;3931;1062;3276;321;1051;423;1307;744;2358
521410;201611;735;2198;667;2083;212;609;296;1002;508;1611
521440;201611;1413;4058;1066;3297;190;642;387;1020;577;1662
521450;201611;3990;12733;3021;10658;943;3475;559;1881;1502;5356
521460;201611;6849;19460;5375;16761;1476;4891;2122;6398;3598;11289
521470;201611;697;1968;470;1492;110;347;77;240;187;587
521480;201611;390;1157;245;815;55;198;77;245;132;443
521483;201611;2849;7372;2004;5829;530;1554;576;1617;1106;3171
521486;201611;1673;4221;1302;3646;106;281;971;2730;1077;3011
521487;201611;529;1394;363;1098;110;368;67;184;177;552
521490;201611;813;2275;607;1913;39;168;410;1224;449;1392
521500;201611;1374;4256;929;3220;177;714;212;604;389;1318
521520;201611;896;2067;643;1713;141;384;325;916;466;1300
521523;201611;13474;47310;12146;44772;4275;16874;1746;7099;6021;23973
521525;201611;1077;2743;849;2372;100;321;543;1450;643;1771
521530;201611;1776;5040;1008;3389;244;842;150;483;394;1325
521540;201611;960;2580;615;1952;135;488;211;637;346;1125
521550;201611;1595;4024;933;2645;190;562;424;1174;614;1736
521560;201611;3690;11844;2942;10680;1181;4609;956;3480;2137;8089
521565;201611;614;1585;508;1443;93;228;317;920;410;1148
521570;201611;4744;12971;2723;8805;592;2023;452;1448;1044;3471
521580;201611;567;1299;302;882;77;223;57;148;134;371
521590;201611;666;1814;505;1533;142;466;158;451;300;917
521600;201611;509;1399;319;1014;74;231;73;216;147;447
521630;201611;1423;3520;943;2790;223;779;209;526;432;1305
521640;201611;2166;5416;1574;4546;418;1203;668;1983;1086;3186
521645;201611;583;1704;405;1311;78;257;140;423;218;680
521680;201611;1382;4414;1092;3803;476;1724;133;440;609;2164
521690;201611;580;1676;502;1540;121;423;228;646;349;1069
521710;201611;2944;8535;2193;7091;456;1503;641;2066;1097;3569
521720;201611;1978;5537;1422;4431;279;865;735;2205;1014;3070
521730;201611;3782;12208;3094;10727;1112;4212;545;1604;1657;5816
521740;201611;3743;10274;2758;8705;617;2109;1283;4187;1900;6296
521760;201611;14492;45255;11766;40311;3354;12298;4219;14423;7573;26721
521770;201611;2670;7680;2010;6349;752;2552;513;1503;1265;4055
521800;201611;7082;21233;5837;19016;1837;6228;1972;6682;3809;12910
521805;201611;921;2051;626;1609;161;376;300;847;461;1223
521810;201611;818;2022;570;1653;105;323;259;780;364;1103
521830;201611;5257;16401;4571;15303;698;2562;2980;9841;3678;12403
521839;201611;743;2011;505;1539;102;316;199;567;301;883
521850;201611;7122;18819;5005;14936;1186;3723;1420;3898;2606;7621
521860;201611;2059;5507;1484;4547;344;1155;423;1267;767;2422
521870;201611;519;1714;408;1470;113;421;129;445;242;866
521878;201611;797;2268;529;1700;77;278;214;638;291;916
521880;201611;22490;57536;14129;43292;3884;12445;4187;13080;8071;25525
521890;201611;3504;10210;2388;7853;670;2321;399;1240;1069;3561
521900;201611;1475;3838;968;3017;236;774;320;929;556;1703
521910;201611;949;2531;810;2352;125;378;472;1436;597;1814
521920;201611;297;938;236;812;88;327;48;157;136;484
521925;201611;694;2075;519;1701;106;378;169;504;275;882
521930;201611;3662;11570;2943;10082;1048;3705;484;1670;1532;5375
521935;201611;645;1791;511;1530;132;392;235;664;367;1056
521940;201611;1050;2820;827;2476;164;528;441;1297;605;1825
521945;201611;678;2078;552;1841;110;379;279;979;389;1358
521950;201611;670;1698;528;1483;56;167;366;1028;422;1195
521960;201611;676;1995;506;1642;108;379;225;702;333;1081
521970;201611;2768;7058;2212;6365;181;488;1794;5333;1975;5821
521971;201611;1038;2740;654;2000;122;361;165;483;287;844
521973;201611;974;2978;789;2629;159;535;385;1290;544;1825
521975;201611;12829;34938;11217;32719;2206;6746;7297;20992;9503;27738
521980;201611;2082;5624;1744;5194;264;681;1311;4059;1575;4740
521990;201611;1185;3323;919;2868;120;397;599;1899;719;2296
522000;201611;2330;6288;1615;5328;197;676;900;3100;1097;3776
522005;201611;407;991;260;753;85;229;90;266;175;495
522010;201611;3520;9916;2784;8602;979;3059;606;1871;1585;4930
522015;201611;925;2682;729;2326;171;543;342;1091;513;1634
522020;201611;5258;13464;3774;10975;968;2885;1765;5050;2733;7935
522026;201611;651;1795;454;1530;101;361;154;553;255;914
522028;201611;555;1548;427;1256;55;154;255;750;310;904
522040;201611;2551;6054;1929;5266;375;1022;1243;3451;1618;4473
522045;201611;15792;50741;12136;42774;3281;12481;2012;6835;5293;19316
522050;201611;1187;3364;771;2497;185;623;186;516;371;1139
522060;201611;2367;7125;1898;6334;490;1744;933;3080;1423;4824
522068;201611;1746;5289;1498;4954;194;602;1114;3822;1308;4424
522070;201611;702;2061;612;1907;79;298;395;1195;474;1493
522100;201611;526;1566;443;1438;156;551;169;528;325;1079
522108;201611;867;2629;700;2340;63;259;520;1687;583;1946
522119;201611;1432;4267;1144;3773;263;890;515;1721;778;2611
522130;201611;366;1016;292;923;85;274;154;496;239;770
522140;201611;17939;49913;13664;42078;4026;13095;3106;8909;7132;22004
522145;201611;844;2323;701;2100;235;711;284;919;519;1630
522150;201611;1009;2624;774;2230;222;627;285;846;507;1473
522155;201611;842;2365;712;2149;147;404;412;1315;559;1719
522157;201611;671;1824;550;1641;38;136;414;1216;452;1352
522160;201611;6305;17651;4132;13431;1163;4058;401;1287;1564;5345
522170;201611;2371;6852;1759;5659;580;1961;375;1163;955;3124
522180;201611;352;1009;252;830;78;281;58;200;136;481
522185;201611;16237;45004;12459;39809;3684;12270;5812;18752;9496;31022
522190;201611;889;2188;649;1831;117;338;305;896;422;1234
522200;201611;1753;5585;1290;4486;314;1120;281;927;595;2047
522205;201611;1434;3938;1105;3386;192;617;577;1732;769;2349
522220;201611;1408;3630;1081;3215;221;636;609;1910;830;2546
522230;201611;1255;3486;1025;3109;110;402;650;1933;760;2335
530010;201611;230849;706726;195272;640863;51202;183904;68963;217628;120165;401532
110001;201610;3378;11100;2913;10314;691;2557;1377;4897;2068;7454
110002;201610;13441;38703;9844;32106;3071;10758;2935;9225;6006;19983
110003;201610;768;2438;640;2192;189;680;146;475;335;1155
110004;201610;10169;31490;7744;26384;2380;8594;1386;4868;3766;13462
110005;201610;1858;5839;1537;5200;515;1785;600;2019;1115;3804
110006;201610;1964;5840;1182;4197;341;1270;135;414;476;1684
110007;201610;1407;4169;1193;3756;362;1213;454;1594;816;2807
110008;201610;2374;8004;2201;7757;379;1229;1582;5844;1961;7073
110009;201610;4676;14023;3449;11907;1019;3731;998;3435;2017;7166
110010;201610;7534;22822;6382;21110;1864;6241;2925;10411;4789;16652
110011;201610;7522;23086;6156;20312;2133;7322;1809;5854;3942;13176
110012;201610;15914;45234;11615;37369;3246;10708;2960;9582;6206;20290
110013;201610;5448;17089;4443;15135;1859;6499;982;3510;2841;10009
110014;201610;4128;11902;3385;10621;938;2989;1607;5015;2545;8004
110015;201610;5041;14933;3233;11161;890;3266;477;1588;1367;4854
110018;201610;4173;11642;2893;9545;736;2702;973;3023;1709;5725
110020;201610;68018;182251;46872;151238;10813;36502;20129;66351;30942;102853
110025;201610;4334;12273;3379;10460;533;1770;2075;6295;2608;8065
110026;201610;641;1955;577;1852;146;443;308;1035;454;1478
110028;201610;6847;20489;5051;16775;1438;5137;686;2227;2124;7364
110029;201610;1411;3996;1067;3410;305;1006;425;1355;730;2361
110030;201610;10577;28520;7486;23841;2137;7370;2579;8117;4716;15487
110032;201610;3920;12107;3175;10532;1048;3507;810;2647;1858;6154
110033;201610;5218;16524;4459;15078;1513;5151;1457;5172;2970;10323
110034;201610;3437;9156;2662;8027;861;2696;1326;3900;2187;6596
110037;201610;1995;6693;1629;5907;434;1645;682;2468;1116;4113
110040;201610;3425;10574;2762;9279;803;2879;951;3083;1754;5962
110045;201610;5021;16070;4240;14946;1429;5452;1748;6034;3177;11486
110050;201610;1675;5300;1346;4647;502;1770;469;1638;971;3408
110060;201610;854;2758;641;2301;208;810;127;447;335;1257
110070;201610;1988;6573;1734;5983;560;2082;622;2030;1182;4112
110080;201610;4558;12195;3756;11235;615;1731;2695;8431;3310;10162
110090;201610;729;2170;560;1856;138;497;242;767;380;1264
110092;201610;1305;4300;1162;4080;214;805;719;2558;933;3363
110094;201610;3616;10662;2973;9674;1011;3463;1074;3456;2085;6919
110100;201610;2177;6800;1911;6298;538;1877;937;3062;1475;4939
110110;201610;1631;5144;1358;4692;554;1957;309;1129;863;3086
110120;201610;1779;5531;1295;4435;358;1279;255;845;613;2124
110130;201610;2478;7045;1717;5637;540;1882;393;1273;933;3155
110140;201610;2393;7714;1854;6562;480;1801;455;1454;935;3255
110143;201610;1248;3818;905;3200;307;1135;316;1130;623;2265
110145;201610;1021;2902;773;2472;206;716;349;1086;555;1802
110146;201610;441;1352;366;1235;71;234;189;647;260;881
110147;201610;726;2123;537;1742;139;477;176;523;315;1000
110148;201610;1230;3722;760;2589;142;502;70;206;212;708
110149;201610;3355;9953;2596;8683;907;3005;1001;3526;1908;6531
110150;201610;2441;7039;1963;6311;609;2064;651;2143;1260;4207
110155;201610;870;2662;720;2305;178;613;314;959;492;1572
110160;201610;1927;6205;1554;5425;565;1983;475;1678;1040;3661
110170;201610;2866;7984;1971;6295;467;1569;908;2842;1375;4411
110175;201610;1617;4921;1251;4378;225;816;663;2409;888;3225
110180;201610;1273;3699;1037;3329;280;866;516;1705;796;2571
120001;201610;2808;9492;2519;9016;518;1918;1509;5532;2027;7450
120005;201610;1568;6528;1446;6277;167;787;1032;4628;1199;5415
120010;201610;4784;16064;4531;15665;555;1860;3491;12351;4046;14211
120013;201610;1978;7891;1862;7710;438;1806;1085;4772;1523;6578
120017;201610;1980;7120;1793;6753;523;2002;753;3136;1276;5138
120020;201610;14334;63086;13665;61648;1986;9266;9453;44026;11439;53292
120025;201610;2419;8413;2303;8220;443;1667;1436;5189;1879;6856
120030;201610;6540;25133;6306;24815;213;1100;5710;22427;5923;23527
120032;201610;1510;7324;1423;7083;145;916;1071;5283;1216;6199
120033;201610;3592;14306;3481;14096;220;993;3043;12364;3263;13357
120034;201610;2147;9133;2026;8874;149;902;1645;7057;1794;7959
120035;201610;3163;14043;3068;13840;229;1188;2569;11687;2798;12875
120038;201610;2654;9498;2477;9158;663;2519;1274;4822;1937;7341
120039;201610;1790;8507;1713;8343;166;981;1308;6397;1474;7378
120040;201610;45112;160200;40425;151020;9318;37506;20424;77018;29742;114524
120042;201610;3027;12547;2821;12061;258;1270;2112;9070;2370;10340
120043;201610;914;4210;874;4135;76;373;704;3444;780;3817
120045;201610;4444;15004;4313;14846;458;1739;3656;12562;4114;14301
120050;201610;8144;33117;7630;31989;986;4424;5274;22778;6260;27202
120060;201610;7758;34235;7508;33718;682;3589;5957;26944;6639;30533
120070;201610;2715;10057;2591;9778;448;1675;1663;6453;2111;8128
120080;201610;3613;13558;3414;13197;628;2545;2340;9173;2968;11718
130002;201610;3132;12839;2907;12471;169;880;2527;10837;2696;11717
130006;201610;2047;8581;1729;7922;225;1142;1258;5775;1483;6917
130008;201610;2239;8728;2030;8317;126;607;1656;6766;1782;7373
130010;201610;3144;10194;2856;9852;158;550;2548;8832;2706;9382
130014;201610;3230;10451;2746;9631;504;1880;1711;6051;2215;7931
130020;201610;2764;10268;2621;9988;99;547;2257;8438;2356;8985
130030;201610;7844;29242;7473;28798;264;800;6909;27157;7173;27957
130040;201610;3780;11584;3285;10891;313;1104;2620;8793;2933;9897
130050;201610;6164;25024;5721;24390;365;1595;4867;21277;5232;22872
130060;201610;5883;27062;5549;26450;549;3194;4309;20430;4858;23624
130063;201610;3833;16884;3650;16643;260;1313;3201;14683;3461;15996
130068;201610;3239;13392;2846;12511;246;1257;2070;9110;2316;10367
130070;201610;7378;23933;6457;22817;504;1653;5316;19279;5820;20932
130080;201610;5522;23981;5108;23313;645;3413;3710;16996;4355;20409
130083;201610;2202;8599;2036;8321;264;1221;1459;5927;1723;7148
130090;201610;2729;9652;2593;9427;85;399;2333;8474;2418;8873
130100;201610;5860;21268;5681;21038;133;551;5396;20041;5529;20592
130110;201610;6884;21881;6406;21291;630;1935;5278;18016;5908;19951
130115;201610;4647;16161;4336;15629;155;614;3796;13673;3951;14287
130120;201610;14975;56227;13851;54689;1406;5724;11175;45010;12581;50734
130130;201610;4034;16180;3941;16005;205;1031;3451;13969;3656;15000
130140;201610;6306;24598;6190;24467;256;1060;5771;22862;6027;23922
130150;201610;3457;13591;3352;13450;133;742;3024;12041;3157;12783
130160;201610;4251;17520;4043;17227;445;2204;3256;13844;3701;16048
130165;201610;2904;11904;2746;11627;189;983;2271;9620;2460;10603
130170;201610;9576;33172;8211;31453;927;3806;6376;24772;7303;28578
130180;201610;3494;11509;3414;11394;118;294;3188;10788;3306;11082
130185;201610;11944;37276;10481;35569;856;2425;8735;31082;9591;33507
130190;201610;17126;58543;14651;55095;2496;9510;9768;37933;12264;47443
130195;201610;1983;8321;1900;8200;103;446;1679;7375;1782;7821
130200;201610;2063;7040;1838;6676;383;1401;1172;4375;1555;5776
130210;201610;1278;5048;1179;4910;120;630;932;3832;1052;4462
130220;201610;2054;8300;1844;7876;237;1138;1197;5097;1434;6235
130230;201610;3744;17056;3475;16583;353;1852;2661;13001;3014;14853
130240;201610;8931;32837;7938;31335;372;2008;6934;27239;7306;29247
130250;201610;20286;69746;18786;67702;2825;9888;13682;51361;16507;61249
130255;201610;4350;14792;3979;14185;200;790;3475;12449;3675;13239
130260;201610;252001;817627;218775;757140;64246;236241;92589;318228;156835;554469
130270;201610;7555;30853;6912;29794;910;3979;5111;22702;6021;26681
130280;201610;3359;13857;3226;13690;106;481;2998;12867;3104;13348
130290;201610;11561;40484;10900;39695;211;531;10373;38506;10584;39037
130300;201610;4550;17310;4259;16851;248;1195;3680;14532;3928;15727
130310;201610;5040;19211;4590;18569;355;1626;3786;15460;4141;17086
130320;201610;3028;10838;2707;10333;374;1502;1858;7260;2232;8762
130330;201610;3693;13430;3309;12894;167;817;2848;11059;3015;11876
130340;201610;18506;69666;16862;67466;2288;9080;13190;54255;15478;63335
130350;201610;3349;13769;3242;13597;249;1431;2712;11194;2961;12625
130353;201610;6196;18866;5271;17630;1094;3591;3359;11920;4453;15511
130356;201610;4602;16562;4214;15901;523;1975;3071;11914;3594;13889
130360;201610;3302;9455;2892;9011;94;237;2696;8560;2790;8797
130370;201610;5724;21510;4884;20367;181;1000;4268;17824;4449;18824
130380;201610;8053;33229;7682;32628;494;2494;6551;27830;7045;30324
130390;201610;5261;22965;4890;22231;536;2858;3596;16255;4132;19113
130395;201610;2228;7774;1938;7172;234;937;1363;4986;1597;5923
130400;201610;2187;8155;2032;7917;129;628;1785;6924;1914;7552
130406;201610;10894;41030;9776;39338;2600;10793;5791;23659;8391;34452
130410;201610;3924;14854;3443;13941;1052;4591;1506;6256;2558;10847
130420;201610;10749;44855;10138;43849;1957;8584;7097;31600;9054;40184
130423;201610;3411;13084;3130;12665;249;1224;2622;10519;2871;11743
130426;201610;2394;10126;2292;9953;156;753;1980;8674;2136;9427
130430;201610;3533;12303;3348;12018;287;1044;2767;10070;3054;11114
130440;201610;3600;12967;3352;12664;194;836;2958;11184;3152;12020
140002;201610;1688;5546;1528;5308;116;494;1164;3986;1280;4480
140005;201610;3495;9573;3360;9421;65;150;3240;9143;3305;9293
140010;201610;55520;159708;43865;141251;10850;36498;18276;61387;29126;97885
140015;201610;2967;9378;2750;9105;198;508;2374;8125;2572;8633
140017;201610;3154;10079;2793;9585;275;908;2114;7519;2389;8427
140020;201610;4495;15078;3969;14300;545;2130;2743;9894;3288;12024
140023;201610;2195;7271;1842;6694;209;830;1323;4848;1532;5678
140028;201610;2104;5797;1894;5487;214;713;1418;3929;1632;4642
140030;201610;3802;11784;3479;11328;620;1648;2368;8250;2988;9898
140040;201610;1770;8129;1703;8026;119;723;1489;6917;1608;7640
140045;201610;2497;9177;2228;8770;431;1642;1482;6164;1913;7806
140047;201610;5574;16916;4729;15491;1230;4050;2194;7667;3424;11717
140050;201610;1411;4415;1238;4167;239;814;757;2587;996;3401
140060;201610;1471;4440;1285;4149;227;800;830;2656;1057;3456
140070;201610;1628;8844;1555;8621;130;884;1224;6768;1354;7652
150010;201610;36758;108243;34031;104297;2294;7442;27759;84968;30053;92410
150013;201610;1761;5070;1551;4813;183;528;1168;3730;1351;4258
150020;201610;12683;42144;12132;41342;1507;4677;9649;33831;11156;38508
150030;201610;7398;31144;7133;30734;678;2697;5940;26300;6618;28997
150034;201610;4288;11799;3978;11377;167;505;3570;10240;3737;10745
150040;201610;13190;41281;11262;38905;1570;4720;8467;31135;10037;35855
150050;201610;5717;22380;5372;21743;263;1333;4628;18669;4891;20002
150060;201610;18331;56645;16176;53008;3501;11482;9427;31778;12928;43260
150070;201610;6164;24784;5473;24015;221;1117;5010;22147;5231;23264
150080;201610;76421;196721;61934;176034;13370;37282;32262;96012;45632;133294
150085;201610;5647;18921;5340;18527;441;1322;4570;16321;5011;17643
150090;201610;10363;39364;9680;38261;842;3501;7568;30376;8410;33877
150095;201610;5413;17464;4822;16554;363;1187;3882;13701;4245;14888
150100;201610;3300;12196;3037;11677;186;845;2413;9132;2599;9977
150110;201610;3628;17098;3603;17051;210;1026;3205;15319;3415;16345
150120;201610;6648;24079;6453;23740;479;1586;5354;20395;5833;21981
150125;201610;730;2129;617;1985;103;374;404;1279;507;1653
150130;201610;22586;68101;20425;64822;2444;7397;15032;48817;17476;56214
150140;201610;168766;465499;153785;444189;19669;55039;114561;336058;134230;391097
150145;201610;4651;14566;4158;13891;532;1875;3213;10822;3745;12697
150150;201610;12415;37132;11165;35147;1866;6097;7396;23491;9262;29588
150157;201610;3188;9487;2688;8740;358;1325;1855;6089;2213;7414
150160;201610;3160;9940;2920;9572;873;2912;1524;5097;2397;8009
150170;201610;21893;80200;20442;77683;2927;11348;14580;56296;17507;67644
150172;201610;3122;10527;2700;9804;368;1375;1907;7072;2275;8447
150175;201610;1918;5799;1770;5624;156;484;1433;4711;1589;5195
150178;201610;10310;31481;8763;29540;958;3446;6509;22433;7467;25879
150180;201610;18918;74993;18031;73726;1222;5583;15326;63066;16548;68649
150190;201610;7076;24208;6761;23754;232;887;6134;21718;6366;22605
150195;201610;5403;17495;5025;16870;173;603;4498;15211;4671;15814
150200;201610;5362;16837;5086;16512;110;373;4778;15620;4888;15993
150210;201610;25417;94040;24386;92544;1824;6957;20331;79053;22155;86010
150215;201610;7444;23316;6365;21483;1991;6952;2550;8739;4541;15691
150220;201610;12049;37187;10573;34744;2491;8257;5343;17965;7834;26222
150230;201610;12051;37238;10287;34651;1512;5241;6746;23097;8258;28338
150240;201610;35934;106160;29945;94938;10130;32949;7918;25895;18048;58844
150250;201610;4047;16833;3870;16552;771;3320;2563;11435;3334;14755
150260;201610;2074;8144;1940;7881;349;1389;1203;5019;1552;6408
150270;201610;8632;26198;6617;23513;1807;6595;3411;12481;5218;19076
150275;201610;5995;21571;5597;20900;663;2357;4139;15838;4802;18195
150276;201610;2223;6601;1949;6227;339;1138;1419;4562;1758;5700
150277;201610;4943;15022;4155;13974;989;3432;2584;8871;3573;12303
150280;201610;6013;26673;5778;26124;892;4125;4132;19071;5024;23196
150285;201610;3003;11447;2748;10987;343;1464;1933;7846;2276;9310
150290;201610;10192;28720;9634;28084;631;1509;8351;25070;8982;26579
150293;201610;9752;26178;6919;22110;2129;7024;2389;8227;4518;15251
150295;201610;7704;22278;6162;20415;1514;4993;3380;12208;4894;17201
150300;201610;2017;6587;1857;6346;101;455;1536;5189;1637;5644
150304;201610;4238;13303;3577;12173;635;2181;2228;7801;2863;9982
150307;201610;6722;22009;6169;21172;407;1301;5188;17947;5595;19248
150309;201610;6203;21154;5414;19864;1312;4741;2933;11319;4245;16060
150310;201610;6407;27217;6113;26736;519;2503;4979;21939;5498;24442
150320;201610;9604;24206;8692;23102;748;1812;7140;19268;7888;21080
150330;201610;14241;47865;13144;46134;1962;6869;9415;33905;11377;40774
150340;201610;2560;8005;2316;7596;244;807;1741;5736;1985;6543
150345;201610;6838;22328;6319;21583;613;2071;4956;17245;5569;19316
150350;201610;8256;24697;7573;23784;1324;3472;5411;17905;6735;21377
150360;201610;21653;66348;18507;62128;3174;10487;12190;42601;15364;53088
150370;201610;10083;36157;9159;34807;1171;4327;6817;26831;7988;31158
150375;201610;2915;12771;2801;12600;285;1312;2306;10503;2591;11815
150380;201610;10115;28818;8758;26873;521;1592;7336;22742;7857;24334
150390;201610;8011;34350;7381;33102;1295;5560;4747;22223;6042;27783
150400;201610;5984;23125;5651;22415;467;1773;4485;18146;4952;19919
150405;201610;8386;24979;7310;23558;1097;2793;5204;18229;6301;21022
150410;201610;1617;6086;1462;5748;208;909;896;3505;1104;4414
150420;201610;37270;123351;30111;110958;9821;38980;8904;34534;18725;73514
150430;201610;7471;24899;7026;24163;954;3046;5155;18301;6109;21347
150440;201610;5530;18786;5231;18338;576;1937;4123;14752;4699;16689
150442;201610;22242;63304;18939;58012;3556;10732;11357;35869;14913;46601
150445;201610;5420;18517;4934;17677;581;2036;3678;13487;4259;15523
150450;201610;4265;20577;4085;20253;502;2439;3141;16053;3643;18492
150460;201610;7141;26246;6527;25453;296;1439;5518;22198;5814;23637
150470;201610;17797;54407;16996;53412;616;1526;15744;50180;16360;51706
150475;201610;3483;12007;3176;11562;281;1070;2555;9411;2836;10481
150480;201610;14150;47786;12804;45581;1337;4886;9960;35938;11297;40824
150490;201610;7185;27332;6976;27001;267;1164;6173;24066;6440;25230
150495;201610;5019;18350;4839;18107;172;690;4450;16733;4622;17423
150497;201610;2736;9937;2400;9237;802;3208;1008;3948;1810;7156
150500;201610;3196;8760;2925;8358;252;693;2332;6644;2584;7337
150503;201610;3691;11246;3020;10311;1020;3569;1499;5323;2519;8892
150506;201610;11156;38420;10032;36756;2388;8378;6071;23773;8459;32151
150510;201610;9906;38246;8823;35912;1419;5770;5706;24142;7125;29912
150520;201610;6750;26572;6594;26357;254;977;6123;24732;6377;25709
150530;201610;12543;42677;11071;40239;1195;3935;8499;31546;9694;35481
150540;201610;4750;14273;4143;13363;259;846;3430;11055;3689;11901
150543;201610;5911;18044;5073;16771;1109;3734;3013;10216;4122;13950
150548;201610;9386;29861;8656;28919;432;1291;7852;26609;8284;27900
150549;201610;2077;6669;1886;6433;65;225;1717;5926;1782;6151
150550;201610;20521;64546;17230;58631;5358;18472;6400;22624;11758;41096
150553;201610;23358;79809;18596;69617;6841;27158;4334;16546;11175;43704
150555;201610;1775;5212;1426;4614;106;356;1047;3370;1153;3726
150560;201610;1965;6391;1798;6022;295;972;1073;3610;1368;4582
150563;201610;2716;8960;2477;8527;610;2256;1274;4350;1884;6606
150565;201610;3954;13490;3524;12764;151;700;2963;10730;3114;11430
150570;201610;5938;21321;5660;20787;546;2079;4365;16130;4911;18209
150580;201610;9850;40903;9533;40494;605;2586;8357;36157;8962;38743
150590;201610;5732;22725;5492;22409;161;750;5067;20726;5228;21476
150600;201610;8114;30902;7693;30266;325;1421;6877;27269;7202;28690
150610;201610;2462;8229;2207;7692;211;786;1573;5416;1784;6202
150611;201610;2793;9438;2573;9011;145;537;2138;7517;2283;8054
150613;201610;12698;37515;10037;33291;3184;11014;4084;13807;7268;24821
150616;201610;3110;9415;2290;7947;569;2141;724;2369;1293;4510
150618;201610;6477;21815;5688;20335;1502;5425;2943;10778;4445;16203
150619;201610;5242;17786;4736;16909;556;2133;3384;12056;3940;14189
150620;201610;6463;22887;5803;21989;740;2881;4410;17046;5150;19927
150630;201610;5960;17680;5587;17222;516;1614;4615;14477;5131;16091
150635;201610;4071;13097;3528;11964;925;3217;1462;5085;2387;8302
150640;201610;1939;5724;1824;5581;182;528;1543;4888;1725;5416
150650;201610;12433;37224;10693;34021;2995;9546;4425;14636;7420;24182
150655;201610;5211;16932;4819;16202;588;2032;3548;12004;4136;14036
150658;201610;4548;13594;3860;12609;821;2908;2378;7932;3199;10840
150660;201610;5665;17516;5030;16499;1213;3960;2618;8806;3831;12766
150670;201610;7566;19730;6073;17818;645;1996;4779;14227;5424;16223
150680;201610;60068;204457;50026;186872;15035;57587;19869;80039;34904;137626
150690;201610;2071;6306;1827;5911;229;700;1277;4199;1506;4899
150700;201610;6229;19407;5586;18483;947;3147;3711;12573;4658;15720
150710;201610;4289;14353;3783;13489;426;1543;2678;9688;3104;11231
150715;201610;5042;15656;4294;14455;446;1652;3208;10818;3654;12470
150720;201610;6613;26294;6176;25468;709;3161;4560;19141;5269;22302
150730;201610;10315;34588;9360;32969;1199;4338;7068;25380;8267;29718
150740;201610;3732;11810;3275;10934;704;2444;1700;5666;2404;8110
150745;201610;5180;16343;4594;15477;1241;4440;2587;8659;3828;13099
150746;201610;1393;4497;1301;4321;124;395;969;3254;1093;3649
150747;201610;5349;16438;4619;15500;411;1212;3527;12610;3938;13822
150750;201610;3413;10914;3035;10342;196;785;2467;8388;2663;9173
150760;201610;11419;36207;10476;34913;1713;5818;7291;24716;9004;30534
150770;201610;6028;22707;5700;22118;297;1020;4994;20296;5291;21316
150775;201610;1150;3475;965;3139;185;712;519;1648;704;2360
150780;201610;3592;11466;3450;11293;124;462;3161;10347;3285;10809
150790;201610;5032;16353;4636;15870;382;1338;3703;13444;4085;14782
150795;201610;15266;48499;13483;45618;3112;10185;7841;27716;10953;37901
150796;201610;3158;9130;2807;8683;317;1011;2172;6829;2489;7840
150797;201610;3771;12850;3381;12104;118;486;2847;10159;2965;10645
150800;201610;14126;45822;12809;44105;2709;8668;8457;30821;11166;39489
150803;201610;6759;24127;6288;23338;688;2699;4659;17437;5347;20136
150805;201610;2680;9578;2436;9141;348;1287;1713;6538;2061;7825
150808;201610;5884;19319;4553;16592;1714;6774;564;2014;2278;8788
150810;201610;19484;59083;15778;54225;2632;8778;10152;36789;12784;45567
150812;201610;5318;16591;4809;15650;548;2024;3410;10763;3958;12787
150815;201610;8631;28323;7624;26998;844;2911;5954;21638;6798;24549
150820;201610;11607;33252;10168;31527;888;2184;8158;26141;9046;28325
150830;201610;13005;48509;12017;47047;592;2905;10038;40182;10630;43087
150835;201610;2262;7887;2056;7476;463;1669;1088;4075;1551;5744
150840;201610;7395;22476;5901;19777;1333;4799;2849;9441;4182;14240
160005;201610;818;2775;769;2680;66;271;624;2130;690;2401
160010;201610;1319;4387;1315;4382;43;86;1261;4272;1304;4358
160015;201610;1735;6439;1686;6359;69;219;1553;5965;1622;6184
160020;201610;1925;6872;1762;6617;227;890;1287;4910;1514;5800
160021;201610;1049;4464;1000;4379;116;639;724;3161;840;3800
160023;201610;1001;4118;980;4076;99;398;816;3440;915;3838
160025;201610;1426;4346;1409;4328;14;56;1381;4234;1395;4290
160027;201610;8329;24607;7639;23820;1576;4837;5252;16929;6828;21766
160030;201610;49902;169872;42704;157423;10604;38880;21960;86097;32564;124977
160040;201610;4318;16823;4203;16653;167;966;3835;14965;4002;15931
160050;201610;3207;11954;2814;11344;1561;6168;700;3237;2261;9405
160053;201610;2989;11214;2900;11074;755;2816;1753;6948;2508;9764
160055;201610;569;2244;559;2230;29;130;494;1965;523;2095
160060;201610;15803;53555;14633;52076;2014;6807;11039;40308;13053;47115
160070;201610;2641;10408;2463;10084;189;913;2060;8408;2249;9321
160080;201610;2591;9720;2529;9634;70;334;2378;9019;2448;9353
170025;201610;527;1707;463;1611;127;447;237;830;364;1277
170030;201610;1186;3885;1003;3543;244;879;432;1537;676;2416
170035;201610;1449;4126;1107;3452;189;643;552;1691;741;2334
170040;201610;1907;5935;1633;5573;213;801;902;3329;1115;4130
170070;201610;1695;4513;1278;3935;247;826;723;2186;970;3012
170100;201610;2412;7136;2024;6507;227;725;1532;4979;1759;5704
170105;201610;773;2390;573;1964;127;474;264;873;391;1347
170110;201610;959;3110;803;2813;178;666;348;1211;526;1877
170130;201610;1364;4292;1075;3718;277;1006;456;1619;733;2625
170190;201610;1540;4535;1098;3777;411;1339;213;870;624;2209
170200;201610;1615;4465;961;3160;277;964;194;596;471;1560
170210;201610;31644;89403;23876;76017;7672;26134;4972;16306;12644;42440
170215;201610;1226;3747;1016;3403;104;396;708;2350;812;2746
170220;201610;5632;19163;5068;17994;1243;4547;2572;9227;3815;13774
170230;201610;1389;4397;1064;3727;234;897;448;1504;682;2401
170240;201610;2761;8153;2169;7173;234;916;1457;4736;1691;5652
170255;201610;3427;10757;2669;9326;875;3084;1042;3691;1917;6775
170270;201610;1041;2537;684;2031;63;187;458;1341;521;1528
170290;201610;2811;8048;2444;7614;297;644;1929;6510;2226;7154
170300;201610;1958;5887;1536;5165;177;634;985;3326;1162;3960
170305;201610;748;2229;569;1878;99;353;305;998;404;1351
170307;201610;1056;3680;864;3301;184;756;408;1609;592;2365
170310;201610;1606;4413;1138;3580;302;990;489;1536;791;2526
170320;201610;1145;3273;808;2687;182;637;342;1165;524;1802
170330;201610;815;2624;732;2484;64;246;580;1938;644;2184
170360;201610;477;1481;376;1291;71;251;182;597;253;848
170370;201610;1345;3796;953;3107;160;581;511;1618;671;2199
170380;201610;1748;5563;1349;4864;228;889;674;2446;902;3335
170382;201610;574;1888;466;1698;67;268;312;1153;379;1421
170384;201610;1588;6357;1428;6031;359;1595;712;3049;1071;4644
170386;201610;927;2736;761;2460;234;868;285;853;519;1721
170388;201610;643;1912;502;1663;104;384;186;586;290;970
170389;201610;932;3117;830;2931;66;259;631;2213;697;2472
170390;201610;1288;3664;1041;3327;97;323;792;2548;889;2871
170410;201610;548;1725;441;1521;35;145;280;952;315;1097
170460;201610;495;1343;307;994;59;217;115;352;174;569
170510;201610;774;2535;575;2125;94;391;293;1022;387;1413
170550;201610;6872;19373;4619;15163;1565;5550;586;1855;2151;7405
170555;201610;1356;3846;1041;3339;204;691;517;1700;721;2391
170560;201610;1074;3440;813;3065;166;668;456;1784;622;2452
170600;201610;1324;3865;1134;3583;342;1031;623;2049;965;3080
170610;201610;1716;5104;1302;4384;147;537;810;2682;957;3219
170625;201610;427;1280;298;1000;43;145;107;339;150;484
170650;201610;1235;3926;950;3370;235;852;334;1267;569;2119
170700;201610;4213;12914;3253;11229;710;2623;1402;4955;2112;7578
170710;201610;1784;5207;1356;4394;244;843;739;2356;983;3199
170720;201610;1906;5088;1569;4525;187;451;1204;3653;1391;4104
170730;201610;991;2905;751;2478;207;698;290;974;497;1672
170740;201610;2176;7717;1846;7063;282;1103;1166;4508;1448;5611
170755;201610;787;2450;575;1979;100;387;246;810;346;1197
170765;201610;1318;3574;938;2928;247;786;364;1191;611;1977
170770;201610;1688;5673;1504;5332;331;1161;861;3123;1192;4284
170820;201610;3543;11422;3078;10552;649;2349;1520;5247;2169;7596
170825;201610;742;2185;592;1892;88;294;316;988;404;1282
170830;201610;1419;4118;1197;3767;81;190;1034;3354;1115;3544
170900;201610;2520;8924;2353;8647;218;849;1880;6989;2098;7838
170930;201610;3888;11447;3181;10267;790;2673;1534;5044;2324;7717
170950;201610;13889;40085;9528;31848;2883;10788;1405;4549;4288;15337
170980;201610;504;1461;349;1179;70;236;145;481;215;717
171050;201610;1508;5005;1311;4601;101;444;1012;3493;1113;3937
171070;201610;1455;4546;1305;4317;319;1035;730;2513;1049;3548
171090;201610;1086;2895;863;2557;65;170;641;1906;706;2076
171110;201610;601;1752;424;1416;128;476;168;491;296;967
171150;201610;1056;2851;631;2054;102;353;378;1221;480;1574
171180;201610;703;2099;446;1550;113;391;171;632;284;1023
171190;201610;1612;5981;1385;5468;279;1142;645;2675;924;3817
171195;201610;866;3001;710;2705;96;413;441;1684;537;2097
171200;201610;688;2150;527;1834;164;615;160;522;324;1137
171215;201610;466;1360;338;1106;51;187;163;532;214;719
171240;201610;700;2546;633;2412;64;308;399;1548;463;1856
171245;201610;622;2060;477;1701;106;414;163;561;269;975
171250;201610;1036;3005;782;2555;181;632;376;1180;557;1812
171270;201610;403;1634;371;1565;137;538;123;597;260;1135
171280;201610;880;2698;698;2355;168;589;312;1098;480;1687
171320;201610;3841;11526;3103;10189;915;2983;1243;4206;2158;7189
171330;201610;2828;8176;2213;7170;600;2075;997;3194;1597;5269
171360;201610;1450;4625;1281;4357;116;423;987;3367;1103;3790
171370;201610;665;1899;560;1750;114;408;316;967;430;1375
171380;201610;1288;4111;1021;3585;414;1478;226;862;640;2340
171395;201610;886;2661;633;2131;111;437;309;986;420;1423
171420;201610;2044;6219;1455;5001;362;1281;530;1813;892;3094
171430;201610;1077;3262;855;2850;162;550;469;1545;631;2095
171488;201610;2521;7648;2088;6981;467;1553;1129;3930;1596;5483
171500;201610;859;2495;673;2184;82;264;461;1518;543;1782
171510;201610;881;3057;761;2823;70;293;538;2011;608;2304
171515;201610;512;1472;382;1227;56;172;215;687;271;859
171525;201610;645;2034;530;1821;66;254;322;1065;388;1319
171550;201610;334;1107;246;931;74;315;67;256;141;571
171570;201610;1256;3951;1072;3574;222;707;677;2341;899;3048
171575;201610;1942;5375;1359;4286;283;956;645;2000;928;2956
171610;201610;5406;17041;4258;14848;1129;4288;1334;4616;2463;8904
171620;201610;2714;7805;2267;7167;117;459;1870;5906;1987;6365
171630;201610;921;2781;747;2500;218;760;349;1176;567;1936
171650;201610;2192;6787;1611;5510;431;1556;543;1840;974;3396
171660;201610;2418;6721;1738;5434;266;872;965;2984;1231;3856
171665;201610;1486;4309;1129;3717;211;734;594;2040;805;2774
171670;201610;1928;5385;1526;4708;419;1409;606;1781;1025;3190
171700;201610;1106;3497;895;3076;141;501;515;1753;656;2254
171720;201610;746;2197;613;1965;171;558;293;955;464;1513
171750;201610;1158;3603;850;2963;235;796;238;877;473;1673
171780;201610;1160;3132;821;2631;101;360;446;1390;547;1750
171790;201610;1398;4925;1183;4451;311;1170;608;2421;919;3591
171800;201610;696;2158;570;1940;71;248;361;1263;432;1511
171820;201610;10413;30767;8288;27245;1689;5851;4078;13540;5767;19391
171830;201610;1383;5099;1177;4614;376;1421;423;1783;799;3204
171840;201610;763;2098;628;1899;46;147;479;1418;525;1565
171845;201610;714;1952;536;1648;75;261;294;901;369;1162
171850;201610;919;3247;782;2951;89;384;492;1866;581;2250
171855;201610;1127;3578;1008;3343;60;232;773;2520;833;2752
171865;201610;455;1505;376;1357;71;250;182;653;253;903
171870;201610;730;2172;547;1811;141;489;202;715;343;1204
171875;201610;1273;4047;1027;3620;93;382;698;2429;791;2811
171880;201610;830;3040;799;2993;90;332;631;2430;721;2762
171884;201610;909;2499;623;2026;166;584;143;533;309;1117
171886;201610;1405;4525;1055;3778;318;1236;219;768;537;2004
171888;201610;730;2158;504;1683;59;196;285;941;344;1137
171889;201610;504;1566;430;1440;90;293;216;768;306;1061
171890;201610;1208;3614;965;3239;167;552;530;1783;697;2335
171900;201610;490;1775;363;1444;107;449;144;563;251;1012
172000;201610;582;1873;477;1651;77;274;263;888;340;1162
172010;201610;1194;4113;1086;3901;115;490;795;2823;910;3313
172015;201610;339;1314;262;1144;59;227;126;580;185;807
172020;201610;2318;7654;2107;7285;295;1092;1443;5009;1738;6101
172025;201610;707;2048;485;1643;69;247;257;890;326;1137
172030;201610;1159;3664;978;3338;52;218;772;2609;824;2827
172049;201610;1333;3417;938;2729;463;1455;321;856;784;2311
172065;201610;1370;3576;1110;3279;78;208;985;2970;1063;3178
172080;201610;2418;7561;1998;6759;203;800;1321;4405;1524;5205
172085;201610;515;1423;340;1057;55;156;107;343;162;499
172090;201610;3820;10449;3078;9325;119;391;2654;8078;2773;8469
172093;201610;606;1806;441;1490;96;369;193;637;289;1006
172097;201610;614;1827;471;1572;100;335;172;577;272;912
172100;201610;35392;102187;25174;83607;7089;25852;6590;21747;13679;47599
172110;201610;1651;6187;1432;5806;170;800;1003;4125;1173;4925
172120;201610;5143;15847;4106;14303;778;2713;2517;8979;3295;11692
172125;201610;246;766;195;669;40;158;89;300;129;458
172130;201610;557;1530;407;1267;39;148;257;776;296;924
172208;201610;2173;6324;1850;5797;252;786;1155;3637;1407;4423
172210;201610;2575;7684;2188;7097;440;1560;1301;4158;1741;5718
210005;201610;22097;68109;17970;61277;6382;22881;5705;19586;12087;42467
210010;201610;1780;6585;1595;6245;96;428;1309;5193;1405;5621
210015;201610;3447;10772;3000;10053;196;488;2555;8862;2751;9350
210020;201610;7224;17265;6698;16617;203;495;6142;15186;6345;15681
210030;201610;5538;18275;5146;17708;408;1648;4160;14240;4568;15888
210040;201610;1910;5199;1752;5010;79;205;1566;4528;1645;4733
210043;201610;6930;19080;5801;17630;694;1890;4132;13367;4826;15257
210047;201610;6670;24361;5966;23210;523;2325;4606;17916;5129;20241
210050;201610;2319;8491;1875;7581;697;2870;634;2754;1331;5624
210055;201610;1768;6088;1570;5763;119;475;1223;4476;1342;4951
210060;201610;7288;28150;6654;26907;992;4159;4331;17967;5323;22126
210070;201610;7294;21244;6694;20497;96;306;6183;19072;6279;19378
210080;201610;3740;12814;3632;12672;30;136;3469;12155;3499;12291
210083;201610;4517;15675;4057;15138;121;534;3803;14228;3924;14762
210087;201610;3007;8769;2705;8360;277;816;2151;6794;2428;7610
210090;201610;10250;32714;9641;31735;371;1342;8509;28065;8880;29407
210095;201610;6070;21543;5767;21105;307;1231;4917;18153;5224;19384
210100;201610;7422;21911;6668;20885;300;1190;5654;17445;5954;18635
210110;201610;2867;9915;2737;9735;113;505;2450;8675;2563;9180
210120;201610;26725;74115;22610;69044;2950;7544;16267;53064;19217;60608
210125;201610;3656;11444;3512;11288;183;398;3159;10473;3342;10871
210130;201610;4246;12481;3870;11925;258;832;3216;9877;3474;10709
210135;201610;1671;4907;1422;4537;93;301;1143;3671;1236;3972
210140;201610;17411;54852;14581;50714;2840;10382;8634;30653;11474;41035
210150;201610;4714;11491;4150;10764;85;229;3864;9983;3949;10212
210160;201610;17846;55766;16576;53832;1928;5620;12854;43261;14782;48881
210170;201610;14210;49753;13679;49016;748;2745;12079;43726;12827;46471
210173;201610;2065;8176;1912;7907;75;420;1739;7124;1814;7544
210177;201610;3140;9548;2953;9317;131;400;2684;8568;2815;8968
210180;201610;1503;4541;1387;4357;57;215;1178;3668;1235;3883
210190;201610;4925;15490;4400;14480;186;798;3500;11244;3686;12042
210193;201610;1405;4389;1254;4135;73;253;1035;3466;1108;3719
210197;201610;2090;6963;1910;6741;241;817;1449;5302;1690;6119
210200;201610;8426;28170;7729;27134;1007;3311;5813;21215;6820;24526
210203;201610;6914;21381;6446;20760;407;1139;5609;18449;6016;19588
210207;201610;3060;9790;2806;9317;292;892;2079;7073;2371;7965
210210;201610;8449;28431;7887;27662;70;312;7341;26071;7411;26383
210215;201610;1163;4807;1098;4697;89;458;867;3739;956;4197
210220;201610;6218;24111;5857;23506;324;1564;4940;19937;5264;21501
210230;201610;5363;17128;4942;16457;268;875;4280;14376;4548;15251
210232;201610;13178;41886;10715;38606;1681;6233;6912;26518;8593;32751
210235;201610;3714;11497;3257;10902;175;676;2770;9277;2945;9953
210237;201610;2363;8959;2287;8849;32;149;2182;8493;2214;8642
210240;201610;3034;9479;2796;9126;158;509;2337;7647;2495;8156
210250;201610;5311;16980;4947;16493;126;629;4510;14884;4636;15513
210255;201610;2655;8468;2362;7919;276;982;1741;5820;2017;6802
210260;201610;5238;16936;4744;16157;479;1564;3665;12740;4144;14304
210270;201610;5458;15250;4700;14151;123;562;4153;12354;4276;12916
210275;201610;3673;8798;3426;8514;171;321;3153;8020;3324;8341
210280;201610;5691;16990;4726;15560;271;1188;3624;11563;3895;12751
210290;201610;5825;18993;5292;18312;306;1080;4516;15812;4822;16892
210300;201610;38630;106206;30956;96204;2889;9000;22632;73045;25521;82045
210310;201610;2954;8235;2655;7811;86;184;2353;7016;2439;7200
210312;201610;2277;7074;2116;6845;54;259;1898;6089;1952;6348
210315;201610;2784;8741;2431;8284;130;440;2129;7366;2259;7806
210317;201610;4237;13089;4020;12819;148;540;3702;11834;3850;12374
210320;201610;19607;63124;17835;60902;877;3216;15378;53173;16255;56389
210325;201610;3735;11358;3256;10609;221;786;2614;8579;2835;9365
210330;201610;35924;88493;27488;79118;5157;13231;16812;54886;21969;68117
210340;201610;12017;35551;10659;33630;2225;6989;6776;22753;9001;29742
210350;201610;10111;30586;8836;28713;553;1838;7185;23530;7738;25368
210355;201610;3966;14406;3549;13730;186;811;3019;11834;3205;12645
210360;201610;16291;48739;14382;45909;1109;3854;11280;35941;12389;39795
210370;201610;9407;22552;7784;20789;292;565;6912;19130;7204;19695
210375;201610;3240;9647;2620;8788;824;2820;1199;4142;2023;6962
210380;201610;6197;16984;5435;15910;477;1218;4412;13226;4889;14444
210390;201610;2935;10317;2636;9815;154;777;2197;8107;2351;8884
210400;201610;4917;15314;4686;15048;100;271;4474;14511;4574;14782
210405;201610;8391;22768;6500;19988;2126;6618;2322;7904;4448;14522
210407;201610;2045;7250;1710;6614;212;825;1204;4686;1416;5511
210408;201610;2460;9445;2281;9204;149;693;1917;7927;2066;8620
210409;201610;3762;13531;3508;13133;208;1007;2900;10827;3108;11834
210410;201610;3706;12142;3544;11918;356;1035;2884;10145;3240;11180
210420;201610;4157;13593;3714;12784;228;791;3037;10580;3265;11371
210430;201610;2166;6697;2076;6585;103;328;1813;5761;1916;6089
210440;201610;4025;12440;3834;12176;200;566;3447;11084;3647;11650
210450;201610;2829;8799;2456;8202;143;482;1951;6472;2094;6954
210455;201610;3950;11479;3500;10812;527;1571;2496;8043;3023;9614
210460;201610;3664;11879;3343;11353;178;722;2766;9363;2944;10085
210462;201610;1468;5259;1336;5001;81;379;1070;3983;1151;4362
210465;201610;2634;8512;2393;8163;193;550;2034;7123;2227;7673
210467;201610;6298;20701;5837;20146;376;1232;4976;17519;5352;18751
210470;201610;2067;5596;1464;4670;86;239;1134;3651;1220;3890
210480;201610;15122;47716;12850;44722;2257;7554;8739;32394;10996;39948
210490;201610;3712;10095;3129;9245;100;323;2717;7979;2817;8302
210500;201610;6409;26189;6093;25567;630;2777;4692;20017;5322;22794
210510;201610;6577;22234;6155;21695;338;1006;5239;19052;5577;20058
210515;201610;3733;11689;3554;11482;72;193;3357;11006;3429;11199
210520;201610;2674;8043;2388;7625;190;585;1965;6380;2155;6965
210530;201610;44951;128014;30680;104940;7300;27871;12704;44422;20004;72293
210535;201610;3305;11242;3115;10971;117;418;2772;9869;2889;10287
210540;201610;13579;44041;11684;41260;2241;7810;7045;26364;9286;34174
210542;201610;5951;16953;5355;16293;316;737;4649;14571;4965;15308
210545;201610;2369;7574;2229;7334;47;256;1979;6412;2026;6668
210547;201610;3754;13335;3447;12773;343;1178;2604;9902;2947;11080
210550;201610;6148;17929;5543;17294;281;603;5048;16286;5329;16889
210560;201610;4107;12749;3611;11880;171;633;3060;10024;3231;10657
210565;201610;1507;5353;1265;4940;79;409;968;3812;1047;4221
210570;201610;12566;35194;11304;33719;713;1619;9807;30129;10520;31748
210580;201610;3249;9472;2873;8977;286;637;2240;7583;2526;8220
210590;201610;4100;12928;3767;12481;261;916;3210;10676;3471;11592
210592;201610;2538;7901;2417;7690;38;168;2142;6790;2180;6958
210594;201610;2693;7539;2041;6497;114;271;1577;5205;1691;5476
210596;201610;2755;10140;2576;9790;253;1026;1917;7389;2170;8415
210598;201610;1898;5825;1731;5616;91;339;1506;4860;1597;5199
210600;201610;3301;9359;2763;8587;157;512;2220;6876;2377;7388
210610;201610;2552;8275;2362;8022;125;553;2048;6832;2173;7385
210620;201610;1980;6427;1797;6181;54;143;1653;5798;1707;5941
210630;201610;3692;12833;3259;12081;323;1433;2296;8469;2619;9902
210632;201610;4606;15759;4192;15095;479;1818;3178;11477;3657;13295
210635;201610;1911;6633;1790;6440;91;311;1570;5736;1661;6047
210637;201610;2702;9198;2460;8846;150;579;1994;7241;2144;7820
210640;201610;4643;17045;4531;16911;4;16;4437;16671;4441;16687
210650;201610;6922;20963;6697;20679;179;525;6358;19739;6537;20264
210660;201610;8479;24607;7523;23135;292;955;6799;20783;7091;21738
210663;201610;2790;8338;2611;8120;161;528;2228;7000;2389;7528
210667;201610;1886;6449;1754;6236;79;342;1530;5447;1609;5789
210670;201610;4603;16752;4337;16304;219;973;3628;13702;3847;14675
210675;201610;5195;14264;4662;13563;452;1161;3789;11313;4241;12474
210680;201610;4130;11160;3576;10464;189;465;3082;9138;3271;9603
210690;201610;7516;25169;7171;24776;289;913;6305;22513;6594;23426
210700;201610;2689;7877;2427;7559;494;1246;1590;5663;2084;6909
210710;201610;4948;16058;4594;15485;215;908;3900;13018;4115;13926
210720;201610;2628;9431;2461;9186;133;618;2185;8090;2318;8708
210725;201610;1106;4175;940;3820;127;497;600;2527;727;3024
210730;201610;1167;3548;1002;3287;87;250;790;2618;877;2868
210735;201610;4223;14357;3777;13585;508;1902;2737;10038;3245;11940
210740;201610;5004;14787;4669;14425;203;880;4207;12719;4410;13599
210745;201610;4052;11818;3765;11434;236;633;3213;9855;3449;10488
210750;201610;21008;56064;17985;52470;2189;6302;13333;39726;15522;46028
210760;201610;5981;17094;5479;16544;40;124;5332;16156;5372;16280
210770;201610;6075;16505;5129;15340;118;457;4678;13923;4796;14380
210780;201610;8221;27285;7374;25748;877;3000;5208;18698;6085;21698
210790;201610;4744;14669;4218;14014;307;781;3442;12039;3749;12820
210800;201610;4900;13626;4343;12933;125;409;3913;11672;4038;12081
210805;201610;3860;15656;3687;15344;179;932;3166;13202;3345;14134
210810;201610;5510;16594;5027;15959;327;646;4356;14428;4683;15074
210820;201610;7935;22737;6906;21033;1027;3005;4726;14690;5753;17695
210825;201610;5760;19746;5452;19317;607;2024;4315;15772;4922;17796
210830;201610;8510;24748;7989;24083;865;2160;6373;20065;7238;22225
210840;201610;3702;10038;3233;9304;112;308;2754;7891;2866;8199
210845;201610;5911;17645;5699;17414;80;183;5502;16998;5582;17181
210850;201610;6390;22360;5645;21061;568;2438;4112;15301;4680;17739
210860;201610;18253;53253;16047;49999;1280;3969;12718;40072;13998;44041
210870;201610;5856;19503;5268;18722;577;1990;4027;14614;4604;16604
210880;201610;4330;13999;4092;13672;298;1098;3414;11398;3712;12496
210890;201610;5206;15295;4677;14666;363;1007;3893;12716;4256;13723
210900;201610;5064;15001;3999;13203;1645;5682;964;3380;2609;9062
210905;201610;1865;5794;1625;5415;124;318;1290;4449;1414;4767
210910;201610;8746;27535;7666;25665;1084;3778;5161;17333;6245;21111
210920;201610;2899;10509;2737;10228;157;785;2253;8351;2410;9136
210923;201610;1527;5151;1386;4917;136;530;936;3411;1072;3941
210927;201610;4868;15470;4562;15126;74;225;4349;14540;4423;14765
210930;201610;2568;9234;2369;8904;111;621;2007;7382;2118;8003
210940;201610;3038;11239;2907;10991;186;850;2470;9218;2656;10068
210945;201610;5926;17954;5682;17669;292;453;5184;16506;5476;16959
210950;201610;5342;16346;4465;14922;447;1490;3286;11146;3733;12636
210955;201610;1923;6130;1658;5721;166;578;1179;4157;1345;4735
210960;201610;9416;29641;8483;28286;2103;6634;4804;17230;6907;23864
210970;201610;1389;4806;1201;4486;153;609;842;3141;995;3750
210975;201610;1810;5998;1689;5761;108;398;1341;4554;1449;4952
210980;201610;10509;24364;10045;23869;664;1238;8954;21820;9618;23058
210990;201610;16886;51326;13285;45979;3284;11839;6293;22459;9577;34298
211000;201610;15884;50050;13880;47593;802;3286;11629;40235;12431;43521
211003;201610;4943;17880;4391;17074;304;1383;3340;13362;3644;14745
211010;201610;6539;23914;6183;23450;76;365;5888;22475;5964;22840
211020;201610;7543;24225;7177;23611;581;2121;5872;19184;6453;21305
211023;201610;2237;7530;2132;7352;185;698;1730;5959;1915;6657
211027;201610;2891;11015;2799;10864;286;1158;2232;8736;2518;9894
211030;201610;3914;11864;3631;11564;635;1446;2713;9453;3348;10899
211040;201610;4495;16666;4250;16274;161;913;3722;14208;3883;15121
211050;201610;10438;26608;9914;26024;235;562;9380;24670;9615;25232
211060;201610;6262;21843;6018;21470;468;1768;5127;18439;5595;20207
211065;201610;1998;6363;1792;6060;68;233;1628;5534;1696;5767
211070;201610;8316;28199;7548;26884;410;1524;6287;22636;6697;24160
211080;201610;1377;4086;1147;3728;73;342;890;2763;963;3105
211085;201610;1997;6695;1799;6351;244;887;1279;4598;1523;5485
211090;201610;3580;10305;3294;9892;113;437;2859;8454;2972;8891
211100;201610;6744;17455;6537;17214;40;139;6371;16761;6411;16900
211102;201610;2991;11380;2799;11092;247;1022;2323;9356;2570;10378
211105;201610;2684;8604;2263;7925;212;828;1664;5763;1876;6591
211107;201610;4542;14391;4036;13689;228;795;3330;11566;3558;12361
211110;201610;6491;19070;5099;16909;915;2931;3183;11022;4098;13953
211120;201610;36486;100955;32483;96032;5338;15077;22765;69703;28103;84780
211125;201610;2097;6602;1833;6173;110;424;1517;5097;1627;5521
211130;201610;161804;433954;140638;401453;24773;71876;75188;225245;99961;297121
211140;201610;5436;17942;4975;17185;179;707;4264;14728;4443;15435
211150;201610;9998;28512;8874;27062;394;1340;7574;23125;7968;24465
211153;201610;2888;8798;2570;8358;652;2165;1626;5405;2278;7570
211157;201610;1224;3900;1024;3583;80;364;697;2468;777;2832
211160;201610;4218;13630;3476;12319;234;1093;2432;8350;2666;9443
211163;201610;1717;5601;1592;5414;37;126;1448;5012;1485;5138
211167;201610;1533;5079;1457;4962;38;176;1364;4638;1402;4814
211170;201610;6392;16816;6094;16455;95;282;5691;15311;5786;15593
211172;201610;2513;7283;2235;6880;104;438;1930;5845;2034;6283
211174;201610;2860;8279;2557;7888;62;307;2334;7102;2396;7409
211176;201610;4403;13601;3701;12642;355;1373;2750;9449;3105;10822
211178;201610;4131;10521;3759;10054;55;149;3583;9532;3638;9681
211180;201610;4334;14927;4042;14477;281;1096;3372;12176;3653;13272
211190;201610;2886;9495;2642;9121;70;336;2288;7854;2358;8190
211195;201610;1496;4461;1233;4119;62;179;1046;3586;1108;3765
211200;201610;2178;7127;1875;6691;351;1186;1144;4322;1495;5508
211210;201610;6891;21095;6442;20442;411;1302;5471;17422;5882;18724
211220;201610;35475;100366;29655;92616;5431;17178;19074;60949;24505;78127
211223;201610;5290;16180;4755;15305;567;1729;3486;11465;4053;13194
211227;201610;1652;5771;1498;5522;94;395;1239;4604;1333;4999
211230;201610;8437;27159;7515;25566;784;2740;5566;19162;6350;21902
211240;201610;8170;27895;7671;27226;265;1204;6884;24215;7149;25419
211245;201610;5605;16541;5553;16486;107;180;5393;16202;5500;16382
211250;201610;13431;42838;12508;41694;1177;3350;10245;35553;11422;38903
211260;201610;8660;26756;8153;26049;446;1518;7283;23284;7729;24802
211270;201610;10467;35551;9220;33899;479;2201;7427;27602;7906;29803
211280;201610;13184;39126;11754;37085;1011;2593;9584;31275;10595;33868
211285;201610;1800;6540;1529;5930;262;1107;768;3077;1030;4184
211290;201610;7275;23678;6908;23160;402;1238;5972;20363;6374;21601
211300;201610;8414;24945;7712;23944;192;530;7088;22119;7280;22649
211400;201610;12053;37120;10306;34561;2721;9248;4972;18299;7693;27547
220005;201610;1869;5292;1644;4935;68;243;1331;3864;1399;4107
220010;201610;1439;4168;1237;3838;41;151;1010;3065;1051;3216
220020;201610;3352;10581;3121;10172;555;1813;1976;6442;2531;8255
220025;201610;2299;5622;2018;5194;31;93;1724;4343;1755;4436
220027;201610;1392;3742;1208;3482;65;198;982;2821;1047;3019
220030;201610;3296;8925;3209;8786;159;528;2826;7606;2985;8134
220040;201610;7842;24183;7101;22776;1432;4546;4377;14076;5809;18622
220045;201610;1410;4633;1260;4334;64;303;963;3210;1027;3513
220050;201610;4529;13584;3838;12356;180;748;3123;9906;3303;10654
220060;201610;2119;5166;1887;4865;51;100;1718;4439;1769;4539
220070;201610;2487;7185;2222;6755;151;434;1787;5422;1938;5856
220080;201610;724;2151;666;2060;46;200;563;1679;609;1879
220090;201610;1855;4652;1504;4158;49;173;1314;3557;1363;3730
220095;201610;732;1965;681;1891;13;53;632;1729;645;1782
220100;201610;1365;4096;1090;3589;74;307;846;2721;920;3028
220105;201610;2287;7191;1997;6617;149;484;1490;4964;1639;5448
220110;201610;3454;9934;3214;9530;100;390;2823;8222;2923;8612
220115;201610;2631;8681;2507;8477;130;515;2228;7469;2358;7984
220117;201610;1320;3477;1065;3081;51;153;893;2561;944;2714
220120;201610;12447;35910;11360;34485;160;696;10646;32171;10806;32867
220130;201610;864;2911;761;2738;34;200;657;2294;691;2494
220140;201610;1714;4511;1477;4209;169;384;1202;3517;1371;3901
220150;201610;7150;21521;6648;20761;166;677;5876;18090;6042;18767
220155;201610;1129;3423;874;2927;39;142;578;1904;617;2046
220157;201610;1086;2715;910;2418;19;57;784;2029;803;2086
220160;201610;2650;7969;2312;7335;86;383;1851;5761;1937;6144
220170;201610;1399;4174;1179;3802;37;169;969;3074;1006;3243
220173;201610;2085;6232;1656;5367;45;222;1365;4289;1410;4511
220177;201610;1779;5292;1733;5222;42;164;1640;4917;1682;5081
220180;201610;1136;3084;932;2690;21;70;680;1878;701;1948
220190;201610;4712;15043;4263;14397;518;1784;3243;10972;3761;12756
220191;201610;1434;4725;1324;4529;135;495;984;3297;1119;3792
220192;201610;1824;5143;1433;4432;68;220;1097;3383;1165;3603
220194;201610;1738;5209;1540;4868;97;357;1218;3762;1315;4119
220196;201610;2060;5937;1849;5549;135;472;1491;4410;1626;4882
220198;201610;1356;3823;1023;3375;13;46;960;3203;973;3249
220200;201610;4575;15000;4212;14468;359;1272;3393;11729;3752;13001
220202;201610;2181;6510;1852;5890;35;171;1620;5028;1655;5199
220205;201610;2797;7332;2472;6867;46;178;2196;6007;2242;6185
220207;201610;911;2750;744;2433;77;279;518;1667;595;1946
220208;201610;1859;5910;1542;5321;255;922;933;3204;1188;4126
220209;201610;1578;4712;1335;4271;36;153;1115;3514;1151;3667
220210;201610;1682;4496;1421;4058;32;137;1154;3172;1186;3309
220211;201610;1615;4484;1491;4296;46;187;1324;3743;1370;3930
220213;201610;1767;4981;1578;4607;33;127;1294;3652;1327;3779
220217;201610;2035;6400;1933;6271;41;145;1794;5888;1835;6033
220220;201610;10944;30036;9517;27726;712;1770;7083;21081;7795;22851
220225;201610;1106;3159;884;2820;29;110;731;2294;760;2404
220230;201610;5477;14782;4859;13858;217;597;4242;12109;4459;12706
220240;201610;2941;9025;2665;8496;116;434;2195;6950;2311;7384
220245;201610;1534;4077;1255;3682;18;58;1132;3366;1150;3424
220250;201610;3191;9122;2858;8610;83;318;2507;7513;2590;7831
220253;201610;1620;4848;1341;4321;217;758;882;2797;1099;3555
220255;201610;1774;4906;1503;4428;41;152;1233;3464;1274;3616
220260;201610;4691;14947;4023;13656;305;1048;3012;10265;3317;11313
220265;201610;1348;4632;1202;4363;116;467;792;2897;908;3364
220270;201610;6943;22440;6544;21667;414;1700;5384;17310;5798;19010
220271;201610;1496;4155;1308;3847;69;184;1090;3253;1159;3437
220272;201610;1818;5412;1615;5031;50;209;1280;3887;1330;4096
220273;201610;1237;3561;1059;3239;80;246;789;2398;869;2644
220275;201610;2150;5389;1720;4845;27;122;1550;4265;1577;4387
220277;201610;2267;6219;1926;5634;67;210;1575;4516;1642;4726
220280;201610;1584;4235;1355;3820;85;285;1076;2948;1161;3233
220285;201610;1666;4366;1367;3956;25;98;1244;3609;1269;3707
220290;201610;6137;20265;5191;18811;541;2135;3702;13443;4243;15578
220300;201610;1876;6207;1659;5869;74;401;1343;4619;1417;5020
220310;201610;2511;8316;2243;7983;87;384;1904;6795;1991;7179
220320;201610;3034;9231;2542;8301;253;922;1795;5818;2048;6740
220323;201610;1518;5283;1317;4983;136;553;1021;3876;1157;4429
220325;201610;1179;3740;954;3270;70;288;701;2352;771;2640
220327;201610;1326;4224;1186;3965;38;205;975;3153;1013;3358
220330;201610;3720;9905;3324;9403;100;246;3033;8653;3133;8899
220335;201610;1849;5673;1660;5450;25;72;1571;5215;1596;5287
220340;201610;1872;5104;1530;4539;101;325;1132;3270;1233;3595
220342;201610;1147;3756;1069;3630;63;286;866;2909;929;3195
220345;201610;2915;7362;2536;6788;52;105;2334;6254;2386;6359
220350;201610;3989;10435;3272;9233;185;580;2533;7009;2718;7589
220360;201610;1310;3562;1098;3223;80;246;859;2474;939;2720
220370;201610;9414;26732;8403;25359;303;1066;7513;22538;7816;23604
220375;201610;1503;4708;1393;4565;16;45;1343;4442;1359;4487
220380;201610;1420;3802;1153;3408;40;146;935;2671;975;2817
220385;201610;856;2178;674;1867;16;60;551;1491;567;1551
220390;201610;9639;29089;8153;26321;2133;6988;3206;10555;5339;17543
220400;201610;1522;3810;1123;3135;94;180;873;2417;967;2597
220410;201610;1239;3582;1037;3250;66;229;805;2474;871;2703
220415;201610;877;2378;740;2160;48;141;539;1536;587;1677
220420;201610;2180;6239;1766;5390;103;278;1337;4081;1440;4359
220430;201610;2622;7327;2543;7217;116;371;2255;6337;2371;6708
220435;201610;1665;4892;1481;4560;35;142;1206;3654;1241;3796
220440;201610;2371;7833;2177;7525;167;574;1745;5961;1912;6535
220450;201610;2097;6457;1735;5922;415;1513;960;3277;1375;4790
220455;201610;1374;4236;1262;4049;47;157;1128;3628;1175;3785
220460;201610;903;2474;820;2368;48;138;699;1997;747;2135
220465;201610;2405;7872;2155;7466;329;1197;1506;5251;1835;6448
220470;201610;3886;11352;3467;10660;152;453;2745;8328;2897;8781
220480;201610;2529;7136;2150;6507;134;349;1659;5003;1793;5352
220490;201610;2286;6456;2071;6164;50;178;1843;5422;1893;5600
220500;201610;3241;8688;2667;7667;87;388;2137;5917;2224;6305
220510;201610;2808;8067;2187;6944;77;279;1673;5265;1750;5544
220515;201610;1911;4636;1665;4304;123;282;1387;3594;1510;3876
220520;201610;5246;14172;4718;13441;116;339;4260;12160;4376;12499
220525;201610;1285;3637;1206;3515;39;139;1031;2974;1070;3113
220527;201610;1399;4239;1213;3853;113;358;885;2867;998;3225
220530;201610;1288;3646;1116;3381;46;184;976;2876;1022;3060
220535;201610;872;2620;825;2556;68;221;633;1949;701;2170
220540;201610;3539;11242;3354;10949;110;509;2945;9482;3055;9991
220545;201610;1411;4672;1317;4483;134;513;1002;3353;1136;3866
220550;201610;9317;29531;8317;27684;721;2494;6190;20452;6911;22946
220551;201610;1484;4635;1298;4299;66;286;1019;3268;1085;3554
220552;201610;1650;5036;1390;4524;58;292;1093;3412;1151;3704
220553;201610;1637;4719;1319;4220;51;193;1068;3435;1119;3628
220554;201610;822;2358;714;2187;57;159;562;1730;619;1889
220555;201610;2231;6915;2029;6610;54;270;1791;5719;1845;5989
220556;201610;1451;4432;1262;4053;54;231;953;2924;1007;3155
220557;201610;1598;5126;1413;4757;121;422;995;3340;1116;3762
220558;201610;1095;3328;961;3104;48;228;759;2365;807;2593
220559;201610;1602;4498;1390;4127;26;85;1203;3560;1229;3645
220560;201610;1686;4180;1380;3732;39;104;1193;3169;1232;3273
220570;201610;7419;23686;6848;22643;1052;3463;4604;15470;5656;18933
220580;201610;6661;20617;6458;20293;255;828;5854;18325;6109;19153
220585;201610;2119;7137;1914;6743;121;488;1566;5448;1687;5936
220590;201610;1356;3989;1181;3725;142;474;829;2651;971;3125
220595;201610;2428;7025;2234;6758;32;150;2051;6120;2083;6270
220600;201610;1320;3170;1053;2808;144;235;799;2263;943;2498
220605;201610;1953;5679;1632;5102;63;223;1305;3999;1368;4222
220610;201610;2767;8315;2609;8078;54;227;2380;7306;2434;7533
220620;201610;7734;25560;7385;25058;286;1364;6542;21905;6828;23269
220630;201610;396;1217;308;1043;53;191;160;542;213;733
220635;201610;1704;5802;1471;5279;67;324;1106;3854;1173;4178
220640;201610;2671;7771;2344;7281;104;380;1961;6006;2065;6386
220650;201610;2211;6416;1895;5813;113;381;1428;4329;1541;4710
220660;201610;2848;8473;2536;8042;107;529;2216;6800;2323;7329
220665;201610;1203;3997;1082;3782;22;124;937;3225;959;3349
220667;201610;1704;5594;1544;5297;81;292;1273;4345;1354;4637
220669;201610;1871;6046;1759;5844;224;931;1238;4005;1462;4936
220670;201610;2001;5863;1745;5527;119;315;1445;4669;1564;4984
220672;201610;2527;7265;2332;7019;166;526;1983;5996;2149;6522
220675;201610;1289;3676;1186;3484;76;181;934;2762;1010;2943
220680;201610;2467;7545;2309;7319;141;445;1967;6276;2108;6721
220690;201610;1743;4783;1468;4323;118;317;1120;3364;1238;3681
220695;201610;967;2724;864;2535;35;97;693;2018;728;2115
220700;201610;8662;24411;7378;22366;521;1695;5601;16810;6122;18505
220710;201610;825;2434;637;2050;42;114;485;1557;527;1671
220720;201610;2107;5414;1949;5173;60;173;1707;4492;1767;4665
220730;201610;1401;3949;1161;3567;27;113;983;2972;1010;3085
220735;201610;1036;2614;806;2205;35;99;650;1750;685;1849
220740;201610;1413;4363;1199;4062;61;215;1006;3448;1067;3663
220750;201610;4042;11232;3645;10601;279;731;2990;8792;3269;9523
220755;201610;1211;3377;1056;3111;47;163;830;2383;877;2546
220760;201610;2802;9234;2520;8840;134;618;2117;7317;2251;7935
220770;201610;22441;73908;19368;67711;6778;24631;5565;20115;12343;44746
220775;201610;1237;3304;1178;3235;16;55;1149;3149;1165;3204
220777;201610;1626;4387;1307;3846;89;201;1017;3002;1106;3203
220779;201610;1405;3589;1316;3461;42;139;1170;3036;1212;3175
220780;201610;5936;15851;5146;14625;444;1278;4075;11553;4519;12831
220785;201610;1318;3357;1238;3230;39;99;1139;2950;1178;3049
220790;201610;10363;31102;9366;29461;644;2303;7600;23596;8244;25899
220793;201610;832;2351;728;2180;33;118;605;1793;638;1911
220795;201610;1468;4158;1360;4000;63;208;1228;3585;1291;3793
220800;201610;16498;44535;14319;41065;2121;6405;9425;26167;11546;32572
220810;201610;3387;9648;2863;8722;115;446;2281;6790;2396;7236
220820;201610;5557;14860;4898;13877;310;732;4171;11829;4481;12561
220830;201610;7663;21378;6982;20243;558;1624;5539;16055;6097;17679
220840;201610;14224;44522;12205;40285;2621;8695;6143;20544;8764;29239
220850;201610;2936;9876;2734;9604;92;411;2487;8743;2579;9154
220855;201610;619;1892;531;1726;27;116;404;1286;431;1402
220860;201610;964;2570;839;2369;41;138;701;1947;742;2085
220865;201610;2652;7213;2059;6157;62;295;1667;4782;1729;5077
220870;201610;2300;7555;2016;7171;54;260;1830;6480;1884;6740
220880;201610;4790;12868;4396;12390;73;215;4121;11640;4194;11855
220885;201610;1293;4601;1114;4261;80;364;849;3212;929;3576
220887;201610;1378;3419;1196;3160;11;44;1112;2904;1123;2948
220890;201610;1664;5653;1433;5174;119;411;1084;3984;1203;4395
220900;201610;1942;5302;1685;4863;44;122;1474;4237;1518;4359
220910;201610;1562;4676;1341;4330;48;131;1178;3869;1226;4000
220915;201610;1042;2904;855;2540;26;110;673;1915;699;2025
220920;201610;1369;4873;1220;4646;84;444;926;3411;1010;3855
220930;201610;1470;4680;1340;4476;44;205;1125;3726;1169;3931
220935;201610;1098;3285;876;2781;55;188;591;1798;646;1986
220937;201610;1518;4123;1247;3647;49;177;975;2776;1024;2953
220940;201610;1358;4271;1225;3986;71;312;866;2733;937;3045
220945;201610;437;1613;385;1499;34;151;267;1012;301;1163
220950;201610;1339;3272;884;2498;19;75;716;1937;735;2012
220955;201610;1495;4233;1267;3819;74;192;986;2974;1060;3166
220960;201610;935;2397;726;2048;23;66;569;1593;592;1659
220965;201610;1673;4940;1562;4758;46;228;1352;3988;1398;4216
220970;201610;2186;5734;1562;4688;106;341;1151;3450;1257;3791
220975;201610;708;2260;645;2174;27;159;584;1901;611;2060
220980;201610;1318;3903;1134;3584;64;222;862;2730;926;2952
220985;201610;1218;3578;1125;3427;75;270;866;2552;941;2822
220987;201610;1495;4725;1321;4411;74;334;1033;3356;1107;3690
220990;201610;1838;5279;1541;4743;44;216;1202;3589;1246;3805
220995;201610;1271;3710;925;3142;82;293;657;2273;739;2566
220997;201610;2327;6992;2195;6782;43;199;2062;6292;2105;6491
221000;201610;4258;12928;3928;12330;273;1070;3098;9525;3371;10595
221005;201610;1475;4552;1320;4250;476;1392;586;2021;1062;3413
221010;201610;1215;3106;1016;2837;37;111;885;2435;922;2546
221020;201610;1783;5530;1618;5209;62;266;1196;3767;1258;4033
221030;201610;1532;4473;1322;4103;50;209;1071;3248;1121;3457
221035;201610;1493;4061;1370;3899;64;146;1256;3637;1320;3783
221037;201610;631;1859;537;1686;16;67;384;1136;400;1203
221038;201610;602;1700;468;1462;29;93;306;956;335;1049
221039;201610;964;2648;841;2457;25;102;697;1965;722;2067
221040;201610;4616;14211;4214;13505;214;703;3337;10711;3551;11414
221050;201610;3549;10626;3258;10206;120;426;2839;8838;2959;9264
221060;201610;8298;24122;6983;21865;465;1544;5417;16831;5882;18375
221062;201610;1297;4504;1135;4152;64;295;912;3291;976;3586
221063;201610;1100;3543;973;3304;150;491;636;2198;786;2689
221065;201610;2838;7551;2465;6921;83;233;2100;5801;2183;6034
221070;201610;3784;11906;3193;10731;178;698;2450;8186;2628;8884
221080;201610;3528;8894;2781;7781;101;319;2344;6470;2445;6789
221090;201610;1469;3949;1208;3517;37;163;1018;2874;1055;3037
221093;201610;1652;4867;1525;4582;220;681;909;2664;1129;3345
221095;201610;972;2593;826;2345;15;38;709;1977;724;2015
221097;201610;819;2271;642;1937;25;99;481;1402;506;1501
221100;201610;113912;331166;101583;309255;20389;64375;57722;172246;78111;236621
221110;201610;10500;32704;9636;31564;374;1578;8182;26455;8556;28033
221120;201610;4172;13330;3905;12828;646;2200;2649;8715;3295;10915
221130;201610;4765;13561;3793;11517;1187;3494;1532;4723;2719;8217
221135;201610;1538;4622;1392;4406;99;360;1155;3606;1254;3966
221140;201610;1364;3312;1194;3055;38;84;1056;2676;1094;2760
221150;201610;1245;3133;954;2603;30;119;767;2018;797;2137
221160;201610;830;2178;758;2067;30;77;590;1606;620;1683
221170;201610;1183;3541;1062;3326;50;149;852;2664;902;2813
230010;201610;3411;9152;2668;7830;204;675;2053;5900;2257;6575
230015;201610;2943;9990;2672;9389;332;1304;1743;6012;2075;7316
230020;201610;13826;44756;13280;43808;663;2534;11235;36826;11898;39360
230030;201610;12175;34529;10724;32176;469;1616;8813;26140;9282;27756
230040;201610;4568;12453;3752;11020;286;993;2736;7883;3022;8876
230050;201610;2669;8936;1892;6773;489;1698;533;1979;1022;3677
230060;201610;2293;6481;1889;5739;72;301;1463;4320;1535;4621
230070;201610;4282;11798;3498;10361;316;1064;2352;6956;2668;8020
230075;201610;9023;31423;8250;29823;642;2942;6307;22252;6949;25194
230080;201610;2506;6419;1975;5597;88;324;1653;4588;1741;4912
230090;201610;3983;11278;3414;10261;334;1128;2445;7262;2779;8390
230100;201610;17076;50178;15398;47035;2568;8387;9151;27943;11719;36330
230110;201610;13247;41629;11726;38277;2294;7596;6073;19613;8367;27209
230120;201610;8015;22068;6752;20095;783;2139;4535;14144;5318;16283
230125;201610;3116;8832;2458;7617;161;554;1819;5570;1980;6124
230130;201610;5785;18770;4723;16386;596;2144;3016;10293;3612;12437
230140;201610;3597;11249;2918;9922;225;867;2034;6865;2259;7732
230150;201610;1738;5352;1460;4752;299;1027;767;2465;1066;3492
230160;201610;6422;18610;5627;17379;276;1082;4566;13920;4842;15002
230170;201610;6438;19850;5401;17792;312;1167;3947;12811;4259;13978
230180;201610;1738;5067;1493;4558;67;286;1110;3232;1177;3518
230185;201610;3955;12795;3446;11806;565;1976;2137;7450;2702;9426
230190;201610;12907;40730;10924;36467;2282;7961;5132;16955;7414;24916
230195;201610;5419;16290;4623;14845;371;1309;3518;11072;3889;12381
230200;201610;5224;14861;4611;13624;371;1145;3471;10080;3842;11225
230205;201610;4196;13515;3714;12616;237;1003;2638;8818;2875;9821
230210;201610;9175;25817;7753;23436;1247;3768;4848;14807;6095;18575
230220;201610;13543;37974;11914;35010;936;3037;8830;25479;9766;28516
230230;201610;7545;23676;6726;22010;707;2309;4720;15442;5427;17751
230240;201610;14027;38552;11865;34780;542;1714;9305;26814;9847;28528
230250;201610;9910;30266;9646;29708;574;2105;7461;22425;8035;24530
230260;201610;14528;47691;12921;44190;2015;7134;7389;25465;9404;32599
230270;201610;7664;22127;6143;19189;819;2682;3947;12331;4766;15013
230280;201610;20207;58676;17350;53533;1403;4548;13012;39549;14415;44097
230290;201610;4873;14598;4043;12868;536;1588;2706;8652;3242;10240
230300;201610;4499;13279;4230;12882;245;901;3434;10275;3679;11176
230310;201610;4941;14655;4112;13093;183;739;2976;9237;3159;9976
230320;201610;7347;22275;6514;20717;414;1628;4919;15316;5333;16944
230330;201610;4878;14062;3984;12255;319;1017;2818;8527;3137;9544
230340;201610;3488;11548;3069;10607;322;1220;2025;6853;2347;8073
230350;201610;18569;55422;16187;50894;1741;6160;9890;31329;11631;37489
230360;201610;3296;9246;2501;7700;185;630;1692;5110;1877;5740
230365;201610;3101;8137;2620;7293;99;362;2162;5917;2261;6279
230370;201610;56191;176237;48954;163032;13194;45494;20668;71000;33862;116494
230380;201610;6673;19218;5300;16485;221;740;3913;12016;4134;12756
230390;201610;3533;11043;3042;10150;197;861;2193;7150;2390;8011
230393;201610;3237;10445;2663;9221;158;776;1934;6412;2092;7188
230395;201610;5846;16751;5038;15255;775;2326;3017;9331;3792;11657
230400;201610;5642;16660;4849;15326;242;1065;3820;11742;4062;12807
230410;201610;14791;46328;12293;40899;1713;5866;7377;24514;9090;30380
230420;201610;24842;78430;21644;71709;4440;15412;10169;33408;14609;48820
230423;201610;4296;13864;3849;12924;240;967;2938;9736;3178;10703
230425;201610;5655;18540;5007;17056;692;2398;3170;10829;3862;13227
230426;201610;2701;7461;2038;6167;69;304;1537;4508;1606;4812
230427;201610;1897;5567;1352;4345;147;460;799;2471;946;2931
230428;201610;8918;27365;8208;25920;1439;4885;4438;13718;5877;18603
230430;201610;4636;14424;4134;13422;279;1084;2985;9402;3264;10486
230435;201610;5123;15880;4436;14546;674;2462;2493;8016;3167;10478
230440;201610;371587;1072124;322606;982415;72222;227614;153325;464777;225547;692391
230445;201610;4654;12420;3779;10970;290;830;2700;7811;2990;8641
230450;201610;3703;11424;3127;10342;307;1277;2147;6917;2454;8194
230460;201610;1992;6400;1667;5773;148;598;1142;3888;1290;4486
230465;201610;4023;11871;3240;10336;231;838;2179;6751;2410;7589
230470;201610;11139;39841;10094;37563;1261;5139;6886;25411;8147;30550
230480;201610;1493;4596;1209;4013;144;562;814;2626;958;3188
230490;201610;2342;7061;1946;6226;273;920;977;2998;1250;3918
230495;201610;5898;18997;5074;17374;813;3067;2676;9059;3489;12126
230500;201610;9160;31997;8576;30776;582;2548;6437;22895;7019;25443
230510;201610;1520;5309;1070;4091;280;1102;335;1265;615;2367
230520;201610;4902;14704;4287;13521;426;1482;2804;8682;3230;10164
230523;201610;15279;48548;12394;41688;2916;10318;3151;10766;6067;21084
230526;201610;4166;12251;3482;10998;191;830;2695;8291;2886;9121
230530;201610;5508;17423;4839;16475;1023;3688;2977;10324;4000;14012
230533;201610;4111;11292;3457;10021;385;1023;2469;7250;2854;8273
230535;201610;5625;16364;4756;14725;571;1702;3036;9697;3607;11399
230540;201610;17733;51154;15664;47718;523;2118;13186;39511;13709;41629
230550;201610;19982;58330;17006;52406;3009;9944;8970;26868;11979;36812
230560;201610;6974;19802;5808;17588;174;716;4553;13488;4727;14204
230565;201610;3536;9640;2776;8211;98;362;2087;6091;2185;6453
230570;201610;3721;9993;3191;9222;102;365;2669;7617;2771;7982
230580;201610;10202;30245;9286;28859;669;2247;7700;23795;8369;26042
230590;201610;9256;28038;7593;24742;621;2289;5320;16806;5941;19095
230600;201610;3805;10351;2681;8007;202;593;1757;5286;1959;5879
230610;201610;6318;19686;5606;18422;714;2306;3910;12928;4624;15234
230620;201610;2200;6182;1653;4976;193;625;953;2762;1146;3387
230625;201610;8036;25636;6909;23008;2043;7230;1895;6285;3938;13515
230630;201610;11058;34571;9833;32152;2659;8167;4389;15395;7048;23562
230640;201610;26798;85214;24076;80822;2405;8894;17978;59864;20383;68758
230650;201610;4926;14881;4329;13675;326;1218;3193;9788;3519;11006
230655;201610;9420;34811;8926;33833;749;3164;6915;26249;7664;29413
230660;201610;6217;19090;5181;16992;298;1370;4030;12851;4328;14221
230670;201610;6136;16143;4686;13545;148;490;3748;10461;3896;10951
230680;201610;2706;7871;2262;6974;319;963;1368;4215;1687;5178
230690;201610;6458;20534;5914;19271;786;2706;3643;11566;4429;14272
230700;201610;9856;27092;8372;24240;562;1938;6063;16847;6625;18785
230710;201610;7640;24369;6408;21911;742;2565;4410;15077;5152;17642
230720;201610;1877;5860;1538;5096;204;691;925;3039;1129;3730
230725;201610;3760;12602;3125;10958;738;2647;1025;3539;1763;6186
230730;201610;58058;173321;46281;152242;13242;48062;9527;32271;22769;80333
230740;201610;6250;18332;5509;17017;198;790;4461;13532;4659;14322
230750;201610;8567;24376;7055;21709;361;1282;5407;16255;5768;17537
230760;201610;11240;32827;9996;30209;1074;3642;6918;20101;7992;23743
230763;201610;4368;13067;3731;11753;181;732;2845;8572;3026;9304
230765;201610;40068;124544;34136;112259;8952;30898;9953;33562;18905;64460
230770;201610;25391;69271;22135;64124;2976;8900;14264;41069;17240;49969
230780;201610;5991;22787;5632;21931;1307;5151;2771;11263;4078;16414
230790;201610;2861;8956;2592;8473;214;785;1968;6421;2182;7206
230800;201610;7684;26655;6770;24547;1391;5376;3191;11292;4582;16668
230810;201610;12441;39517;11452;37722;858;3064;8660;28217;9518;31281
230820;201610;3362;11425;2828;10191;397;1632;1570;5516;1967;7148
230830;201610;7645;22796;6563;20697;365;1396;4977;15414;5342;16810
230835;201610;4099;10566;3196;9134;195;569;2479;7051;2674;7620
230837;201610;3270;10821;2674;9518;235;956;1906;6589;2141;7545
230840;201610;9274;29717;8361;28088;670;2504;6334;21327;7004;23831
230850;201610;9673;29888;8778;28237;1103;3524;5891;19091;6994;22615
230860;201610;5188;14495;4494;13374;231;768;3652;10764;3883;11532
230870;201610;18963;49186;15797;44132;674;2032;12316;34126;12990;36158
230880;201610;2021;6746;1888;6463;118;533;1344;4481;1462;5014
230890;201610;4025;14352;3610;13410;378;1728;2380;8534;2758;10262
230900;201610;2924;9639;2333;8271;519;1720;1021;3753;1540;5473
230910;201610;3188;9179;2546;7987;175;757;1908;5792;2083;6549
230920;201610;4781;13575;4406;13087;181;638;3795;11330;3976;11968
230930;201610;7173;21320;6092;19177;534;1777;4167;13025;4701;14802
230940;201610;7986;22344;6847;20453;271;930;5614;16690;5885;17620
230945;201610;6129;18321;5272;16839;378;1335;3659;11789;4037;13124
230950;201610;6567;17413;5894;16513;198;512;5120;14624;5318;15136
230960;201610;14493;44207;12587;40266;2465;8025;5822;18685;8287;26710
230970;201610;14141;42237;11858;37863;2389;8219;5343;16625;7732;24844
230980;201610;2985;9149;2517;8257;683;2175;1208;4167;1891;6342
230990;201610;1792;5239;1431;4512;116;476;946;2856;1062;3332
231000;201610;2765;7461;2122;6149;109;381;1436;4033;1545;4414
231010;201610;3150;8558;2489;7404;262;812;1662;4806;1924;5618
231020;201610;7939;26380;7261;24799;1252;4209;4283;14862;5535;19071
231025;201610;8061;24348;7144;22665;1070;3489;4530;14556;5600;18045
231030;201610;7634;24345;6140;21100;1118;3979;3267;11245;4385;15224
231040;201610;3155;9808;2738;8932;121;530;2064;6512;2185;7042
231050;201610;12164;33964;9994;29960;720;2292;7407;21990;8127;24282
231060;201610;2483;7949;2241;7481;125;628;1680;5431;1805;6059
231070;201610;8718;27196;7600;24844;1427;4750;3974;13134;5401;17884
231080;201610;3919;12130;3485;11307;136;728;2738;8499;2874;9227
231085;201610;4967;15200;4674;14730;606;1944;3299;10645;3905;12589
231090;201610;4244;11703;3213;9584;164;541;2304;6728;2468;7269
231095;201610;2232;7124;1879;6368;201;773;1240;4184;1441;4957
231100;201610;3247;9926;2606;8630;218;779;1865;6116;2083;6895
231110;201610;3568;11660;3487;11494;387;1359;2336;7629;2723;8988
231120;201610;2018;6743;1853;6368;276;994;1147;3940;1423;4934
231123;201610;2079;5643;1739;5023;130;358;1324;3789;1454;4147
231126;201610;6402;17919;5072;15449;227;830;3754;11172;3981;12002
231130;201610;19589;58743;17123;54491;3048;9953;10182;33481;13230;43434
231135;201610;4244;12514;3487;11083;251;856;2487;7822;2738;8678
231140;201610;17389;53414;14611;47883;1113;4791;9853;30997;10966;35788
231150;201610;5863;16773;4876;14899;804;2503;2380;7358;3184;9861
231160;201610;5899;19274;5324;18071;884;2999;3068;10437;3952;13436
231170;201610;4353;13815;3766;12522;298;1117;2630;8538;2928;9655
231180;201610;14622;42755;12364;37916;2539;7897;6341;19155;8880;27052
231190;201610;4619;12898;3785;11550;248;905;2842;8410;3090;9315
231195;201610;4702;15410;3926;13791;378;1619;2682;9200;3060;10819
231200;201610;7907;26417;6690;23745;346;1756;4882;16725;5228;18481
231210;201610;5062;15619;4297;14437;262;1231;3302;10843;3564;12074
231220;201610;12016;34035;10233;30612;583;2029;7547;21997;8130;24026
231230;201610;9322;30629;8306;29004;716;2946;6165;21450;6881;24396
231240;201610;12375;38124;10836;34915;2208;7230;5414;17468;7622;24698
231250;201610;1940;5505;1222;3725;379;1156;313;900;692;2056
231260;201610;3508;10401;3076;9658;549;1700;1812;5797;2361;7497
231270;201610;7403;19970;6336;18220;260;1047;4930;13840;5190;14887
231280;201610;1773;5749;1624;5442;173;604;1090;3681;1263;4285
231290;201610;34388;114268;29953;103763;6086;22718;12693;42885;18779;65603
231300;201610;4556;13050;3543;10983;256;899;2410;7250;2666;8149
231310;201610;7579;21347;5960;17891;839;2526;3467;10187;4306;12713
231320;201610;7142;21337;5643;18197;256;1011;4200;13292;4456;14303
231325;201610;2789;8044;2339;7281;432;1522;1302;3935;1734;5457
231330;201610;12217;38012;10011;33407;2003;6618;5210;17569;7213;24187
231335;201610;5603;15528;4701;13833;145;563;3863;11103;4008;11666
231340;201610;18159;58764;16351;55730;1288;4344;12538;43458;13826;47802
231350;201610;14549;42550;13529;41071;767;2182;11767;36222;12534;38404
231355;201610;4661;14515;4148;13580;250;987;3075;9880;3325;10867
231360;201610;7805;24612;6801;22774;1204;4059;4143;14199;5347;18258
231370;201610;2453;6758;1849;5717;65;218;1403;4287;1468;4505
231375;201610;4280;14335;3906;13599;219;1004;3043;10381;3262;11385
231380;201610;5625;16774;5242;16253;295;903;4279;13546;4574;14449
231390;201610;3515;10777;3164;10133;256;896;2237;7055;2493;7951
231395;201610;3928;12712;3462;11786;632;2095;1961;6750;2593;8845
231400;201610;9130;27893;8265;26077;498;1912;6170;19112;6668;21024
231410;201610;14624;48736;13159;46289;1117;4112;9939;35015;11056;39127
240010;201610;2483;7332;1954;6202;295;1056;1069;3264;1364;4320
240020;201610;10875;33614;9340;30503;1831;6240;4826;15742;6657;21982
240030;201610;2580;7233;2477;7076;161;451;2107;6004;2268;6455
240040;201610;845;2472;671;2109;19;97;490;1454;509;1551
240050;201610;3503;9428;2891;8312;93;318;2350;6611;2443;6929
240060;201610;1435;4053;1239;3670;52;193;989;2797;1041;2990
240070;201610;2581;7614;2366;7178;322;1001;1594;4767;1916;5768
240080;201610;3084;8195;2587;7448;153;452;1995;5674;2148;6126
240090;201610;2312;6141;1842;5262;44;169;1467;4090;1511;4259
240100;201610;7939;22771;6880;20504;580;1900;4900;14133;5480;16033
240110;201610;4875;15126;4189;13650;649;2319;2293;7201;2942;9520
240120;201610;2739;9323;2535;8861;341;1346;1606;5504;1947;6850
240130;201610;2830;7496;2416;6810;86;284;2014;5577;2100;5861
240140;201610;2261;6745;1858;5972;249;910;1100;3402;1349;4312
240145;201610;5860;18233;5101;16798;1337;4532;2564;8624;3901;13156
240150;201610;1003;3026;808;2601;70;284;547;1668;617;1952
240160;201610;1461;4586;1215;4123;124;505;802;2708;926;3213
240165;201610;906;2818;743;2447;140;428;418;1421;558;1849
240170;201610;2349;7064;1992;6362;453;1527;981;3098;1434;4625
240180;201610;2736;8553;2343;7727;397;1389;1385;4589;1782;5978
240185;201610;1425;4696;1315;4509;84;326;1042;3574;1126;3900
240190;201610;973;3058;841;2807;35;166;654;2161;689;2327
240200;201610;13547;35420;10818;31088;2525;7458;4388;12805;6913;20263
240210;201610;2967;8150;2630;7610;145;536;2164;6099;2309;6635
240220;201610;7474;24643;6747;23453;650;2731;4891;16759;5541;19490
240230;201610;5736;15123;4847;13677;142;446;4148;11647;4290;12093
240240;201610;1822;5468;1058;3510;220;783;184;530;404;1313
240250;201610;2722;7911;2548;7667;106;332;2221;6678;2327;7010
240260;201610;12547;41724;11701;40230;1883;6848;7369;25363;9252;32211
240270;201610;2282;7251;2060;6848;184;664;1541;5150;1725;5814
240280;201610;1607;4491;1412;4191;71;230;1135;3354;1206;3584
240290;201610;1275;3978;1091;3603;50;258;716;2209;766;2467
240300;201610;2295;6256;1596;4754;215;687;776;2237;991;2924
240310;201610;9679;27253;8301;24795;1337;4234;4510;13444;5847;17678
240320;201610;2073;6060;1527;4885;51;203;1142;3483;1193;3686
240325;201610;35127;96349;26642;81910;8096;26029;6652;21131;14748;47160
240330;201610;1531;4617;1253;4006;60;232;802;2460;862;2692
240340;201610;2091;5376;1699;4725;153;457;1263;3444;1416;3901
240350;201610;2088;5787;1925;5585;86;307;1723;4955;1809;5262
240360;201610;7356;22179;6410;20630;1597;5208;3116;10406;4713;15614
240370;201610;2061;5645;1594;4740;171;468;1037;3082;1208;3550
240375;201610;868;2320;732;2069;53;191;522;1372;575;1563
240380;201610;2449;7248;1785;5710;262;851;920;2904;1182;3755
240390;201610;944;2603;754;2222;38;124;556;1577;594;1701
240400;201610;1359;3649;1039;3011;62;209;736;2055;798;2264
240410;201610;503;1647;442;1519;78;329;244;779;322;1108
240420;201610;4779;18069;4361;17075;798;3509;2327;9006;3125;12515
240430;201610;3346;9395;2988;8720;122;500;2379;6660;2501;7160
240440;201610;2525;6543;2217;6061;428;1231;1293;3477;1721;4708
240450;201610;3879;11467;3191;10069;363;1380;1888;5600;2251;6980
240460;201610;2898;8904;2712;8635;192;793;2178;6748;2370;7541
240470;201610;3594;11212;2719;9244;829;2669;1116;3901;1945;6570
240480;201610;522;1398;368;1078;26;83;196;555;222;638
240485;201610;2003;6315;1712;5694;236;845;1066;3551;1302;4396
240490;201610;1753;4393;1405;3818;34;118;1220;3266;1254;3384
240500;201610;2185;6201;1948;5831;112;385;1560;4621;1672;5006
240510;201610;1817;5339;1678;5106;167;496;1323;4041;1490;4537
240520;201610;1258;3613;1100;3339;87;315;853;2499;940;2814
240530;201610;2010;6478;1809;6129;321;1107;1186;4023;1507;5130
240540;201610;1784;5267;1668;5074;101;332;1394;4201;1495;4533
240550;201610;798;2274;665;2028;49;149;490;1477;539;1626
240560;201610;3300;9405;3017;8970;345;902;2298;6943;2643;7845
240570;201610;3106;8589;2127;6304;477;1459;768;2033;1245;3492
240580;201610;7834;24030;7160;22796;658;2366;5565;17429;6223;19795
240590;201610;785;2175;667;1956;26;95;507;1449;533;1544
240600;201610;1628;4757;1207;3821;118;429;696;2093;814;2522
240610;201610;4690;13404;3932;11861;394;1289;2578;7520;2972;8809
240615;201610;1051;3049;816;2574;155;496;447;1359;602;1855
240620;201610;1843;5574;1621;5178;155;495;1226;3911;1381;4406
240630;201610;2105;6291;1870;5869;169;452;1296;4165;1465;4617
240640;201610;939;2632;769;2342;47;205;564;1651;611;1856
240650;201610;3981;11696;3448;10812;176;618;2750;8503;2926;9121
240660;201610;2416;7640;2243;7367;177;637;1747;5694;1924;6331
240670;201610;2662;7901;2126;6735;259;844;1224;3787;1483;4631
240680;201610;1529;4437;1167;3736;92;316;804;2507;896;2823
240690;201610;966;2618;810;2346;45;168;654;1820;699;1988
240700;201610;2639;7818;2152;6883;66;280;1691;5283;1757;5563
240710;201610;18956;49185;15788;44050;3292;8925;8389;23827;11681;32752
240720;201610;5277;14976;4654;13765;1385;4205;2057;5857;3442;10062
240725;201610;1094;3272;843;2699;70;239;505;1558;575;1797
240730;201610;2162;6486;1825;5827;118;382;1356;4303;1474;4685
240740;201610;2020;5842;1745;5312;143;534;1242;3622;1385;4156
240750;201610;2208;8146;2001;7715;463;1939;939;3643;1402;5582
240760;201610;1357;3640;1089;3241;108;291;799;2487;907;2778
240770;201610;3192;9076;2815;8523;137;565;2329;6876;2466;7441
240780;201610;6190;16957;4801;14601;675;2050;2848;8737;3523;10787
240790;201610;914;2752;731;2386;34;134;521;1704;555;1838
240800;201610;35842;101972;30619;92581;7168;22177;12618;38366;19786;60543
240810;201610;87509;250106;78350;233343;21535;64193;33958;102876;55493;167069
240820;201610;6415;19578;5460;17943;1304;4529;2312;7878;3616;12407
240830;201610;8813;27044;8088;25904;335;1498;6830;21458;7165;22956
240840;201610;1234;3375;1002;2955;104;299;623;1776;727;2075
240850;201610;1328;3859;917;2889;127;413;481;1494;608;1907
240860;201610;1340;3763;1039;3194;43;155;808;2383;851;2538
240870;201610;1200;3229;934;2725;143;413;543;1504;686;1917
240880;201610;1195;3951;1114;3798;76;358;901;2968;977;3326
240890;201610;5073;14295;4092;12336;856;2624;1713;5029;2569;7653
240895;201610;2718;9248;2460;8760;257;978;1766;6322;2023;7300
240910;201610;2965;8765;2567;7989;139;513;2009;6157;2148;6670
240920;201610;775;2489;655;2210;118;422;335;1118;453;1540
240930;201610;3553;9045;3042;8375;123;347;2527;6997;2650;7344
240933;201610;1486;4038;1234;3586;49;196;1034;2869;1083;3065
240940;201610;6687;17600;5166;14931;715;2023;3200;9146;3915;11169
240950;201610;976;3169;887;2998;53;235;654;2128;707;2363
240960;201610;806;2490;682;2226;61;214;491;1599;552;1813
240970;201610;1924;5304;1597;4737;85;322;1223;3492;1308;3814
240980;201610;3001;9819;2721;9273;499;1777;1617;5487;2116;7264
240990;201610;2832;8345;2598;7841;426;1385;1635;4839;2061;6224
241000;201610;1068;2955;878;2596;45;167;615;1778;660;1945
241010;201610;2807;9479;2586;9021;347;1469;1759;5862;2106;7331
241020;201610;2077;5736;1543;4614;225;633;948;2781;1173;3414
241025;201610;1660;5022;1371;4450;68;290;1022;3217;1090;3507
241030;201610;2435;7984;2089;7241;213;844;1457;4977;1670;5821
241040;201610;2234;7563;1988;7080;140;589;1453;5178;1593;5767
241050;201610;1290;3792;1091;3418;57;227;825;2524;882;2751
241060;201610;882;2515;777;2327;60;190;556;1636;616;1826
241070;201610;785;2257;693;2082;65;239;498;1404;563;1643
241080;201610;1170;3424;925;2929;32;150;680;2081;712;2231
241090;201610;2149;6366;1756;5653;94;427;1346;4229;1440;4656
241100;201610;1205;3550;995;3050;86;286;678;2039;764;2325
241105;201610;1217;3626;1026;3268;256;797;460;1537;716;2334
241110;201610;855;2633;666;2196;45;173;437;1372;482;1545
241120;201610;7356;22323;6502;20784;1631;5019;3289;11111;4920;16130
241140;201610;3493;9433;2932;8271;268;719;2084;5763;2352;6482
241142;201610;731;2159;523;1690;113;411;225;682;338;1093
241150;201610;5523;16098;4803;14794;570;1799;3215;9856;3785;11655
241160;201610;980;2870;859;2654;142;435;514;1562;656;1997
241170;201610;1174;3407;1072;3217;99;310;838;2479;937;2789
241180;201610;959;2659;721;2153;88;277;391;1119;479;1396
241190;201610;1213;3329;938;2752;46;172;630;1760;676;1932
241200;201610;19637;56273;16690;51389;4134;13145;7148;22404;11282;35549
241210;201610;1478;4129;1130;3387;150;520;654;1876;804;2396
241220;201610;8174;26420;7357;24818;2126;7282;3230;11153;5356;18435
241230;201610;3047;8816;2769;8345;158;551;2275;6713;2433;7264
241240;201610;1234;3616;779;2526;85;303;353;1137;438;1440
241250;201610;6113;18642;4982;16386;196;1038;3825;12107;4021;13145
241255;201610;1736;6553;1533;6029;335;1448;755;2944;1090;4392
241260;201610;5235;14041;4055;12078;183;755;3059;8840;3242;9595
241270;201610;1925;5813;1614;5150;108;435;1154;3575;1262;4010
241280;201610;1880;5407;1665;4979;163;480;1194;3557;1357;4037
241290;201610;3073;8487;2522;7487;188;620;1827;5297;2015;5917
241300;201610;1473;4191;1219;3697;52;168;852;2552;904;2720
241310;201610;1685;4920;1513;4606;100;370;1196;3582;1296;3952
241320;201610;924;3175;815;2936;96;414;525;1843;621;2257
241330;201610;1443;4478;1350;4348;93;383;1133;3577;1226;3960
241335;201610;2806;8433;2504;7848;134;469;2059;6343;2193;6812
241340;201610;1851;5691;1520;4921;343;1186;662;2041;1005;3227
241350;201610;1944;6115;1723;5676;128;557;1283;4065;1411;4622
241355;201610;1455;4005;1138;3430;49;172;911;2701;960;2873
241360;201610;2122;5708;1671;4795;70;205;1251;3464;1321;3669
241370;201610;1369;4074;1068;3451;104;364;669;2086;773;2450
241380;201610;663;1878;542;1628;73;233;321;930;394;1163
241390;201610;2801;9079;2566;8653;257;987;1926;6436;2183;7423
241400;201610;3711;10635;3312;10019;360;1146;2466;7466;2826;8612
241410;201610;2516;7627;2213;7143;360;1247;1390;4449;1750;5696
241415;201610;1673;4982;1481;4657;123;426;1125;3450;1248;3876
241420;201610;2311;7939;1971;7306;602;2379;462;1678;1064;4057
241430;201610;585;1725;437;1386;43;151;245;737;288;888
241440;201610;6420;22771;5920;21889;830;3390;4208;15565;5038;18955
241445;201610;1007;2902;953;2836;72;174;781;2457;853;2631
241450;201610;3019;8170;2605;7561;323;987;1754;5025;2077;6012
241460;201610;3465;9973;2960;8917;238;800;2141;6256;2379;7056
241470;201610;1434;3921;1144;3510;104;358;857;2606;961;2964
241475;201610;1276;3796;997;3219;41;221;753;2271;794;2492
241480;201610;2806;9225;2499;8633;1015;3605;540;2052;1555;5657
241490;201610;690;1822;566;1630;29;83;373;1027;402;1110
241500;201610;741;2308;615;2122;17;66;524;1794;541;1860
250010;201610;2816;8688;2321;7591;87;377;1756;5587;1843;5964
250020;201610;1691;4778;1231;3874;58;232;854;2581;912;2813
250030;201610;7031;20251;6402;19292;410;1306;5217;15530;5627;16836
250040;201610;4158;13890;3757;12982;558;1958;2321;8045;2879;10003
250050;201610;3458;10768;3135;10202;522;1729;1890;5970;2412;7699
250053;201610;1262;3762;1140;3573;139;437;777;2452;916;2889
250057;201610;620;2634;605;2616;9;15;576;2563;585;2578
250060;201610;5250;15476;4823;14791;468;1539;3700;11213;4168;12752
250070;201610;4061;12395;3655;11624;123;593;2835;8629;2958;9222
250073;201610;808;2375;678;2136;25;89;530;1604;555;1693
250077;201610;2187;6331;1747;5563;123;415;1215;3865;1338;4280
250080;201610;4220;12227;3975;11781;308;937;3105;9060;3413;9997
250090;201610;2589;7384;2391;7039;192;432;1877;5549;2069;5981
250100;201610;3896;12598;3617;12062;281;1041;2811;9181;3092;10222
250110;201610;5143;15195;4792;14642;406;1460;3783;11311;4189;12771
250115;201610;537;1708;460;1539;23;127;327;1024;350;1151
250120;201610;1989;6058;1656;5396;99;371;1277;4109;1376;4480
250130;201610;5377;16626;4796;15533;193;883;3985;12645;4178;13528
250135;201610;1086;3237;979;3039;33;122;786;2419;819;2541
250140;201610;2075;6797;1946;6571;163;690;1502;4985;1665;5675
250150;201610;5133;17003;4557;15870;236;1066;3446;11741;3682;12807
250153;201610;1476;3988;1244;3641;44;193;1065;3040;1109;3233
250157;201610;1726;5582;1541;5203;201;698;1054;3568;1255;4266
250160;201610;3311;9704;3117;9380;101;369;2847;8532;2948;8901
250170;201610;1629;4724;1448;4430;125;435;1108;3357;1233;3792
250180;201610;16188;46894;14820;44593;1784;5683;10378;30547;12162;36230
250190;201610;4281;12182;3774;11293;561;1641;2399;7122;2960;8763
250200;201610;2035;5926;1661;5339;83;306;1377;4385;1460;4691
250205;201610;883;3014;791;2805;35;166;579;2033;614;2199
250210;201610;1483;4831;1352;4603;107;471;1032;3386;1139;3857
250215;201610;1364;4428;1273;4281;149;523;785;2625;934;3148
250220;201610;759;2281;643;2107;31;129;515;1682;546;1811
250230;201610;1551;3902;1214;3310;47;166;979;2526;1026;2692
250240;201610;2343;7688;2196;7408;106;396;1769;5953;1875;6349
250250;201610;4399;13111;3953;12447;183;626;3384;10628;3567;11254
250260;201610;1726;5203;1454;4737;79;262;1142;3710;1221;3972
250270;201610;1318;4076;1154;3860;92;302;879;3027;971;3329
250280;201610;3653;10662;3144;9809;309;983;2344;7292;2653;8275
250290;201610;1925;5109;1569;4613;30;112;1409;4126;1439;4238
250300;201610;5635;16355;5280;15908;473;1812;4362;12801;4835;14613
250310;201610;1169;3539;1019;3278;95;338;757;2381;852;2719
250320;201610;8289;24439;7672;23392;867;2883;5451;16195;6318;19078
250330;201610;2448;7565;2063;6964;152;554;1554;5187;1706;5741
250340;201610;1109;3255;975;3008;34;132;826;2502;860;2634
250350;201610;4199;11620;3732;11021;128;461;3227;9516;3355;9977
250355;201610;1925;6144;1750;5885;53;266;1521;5035;1574;5301
250360;201610;1864;5435;1687;5138;53;148;1426;4335;1479;4483
250370;201610;11837;33765;10519;32204;735;2308;9049;27754;9784;30062
250375;201610;1088;3274;966;3073;50;174;799;2533;849;2707
250380;201610;1696;4815;1587;4654;82;311;1343;3832;1425;4143
250390;201610;1885;5137;1462;4385;184;517;939;2805;1123;3322
250400;201610;74308;196215;56026;165702;15222;46494;20673;61600;35895;108094
250403;201610;1532;4998;1390;4780;212;900;919;3035;1131;3935
250407;201610;1219;3382;1017;3041;84;215;734;2166;818;2381
250410;201610;549;1780;501;1684;23;112;394;1286;417;1398
250415;201610;1873;5574;1649;5149;106;333;1259;3884;1365;4217
250420;201610;1295;3788;1160;3574;27;104;1036;3168;1063;3272
250430;201610;6065;16337;5440;15315;289;895;4558;12531;4847;13426
250435;201610;1382;4188;1204;3849;103;386;856;2703;959;3089
250440;201610;4546;12931;4076;12234;123;427;3515;10434;3638;10861
250450;201610;1972;5541;1716;5186;58;214;1450;4301;1508;4515
250460;201610;6609;19663;6104;18939;486;1565;4933;15478;5419;17043
250470;201610;1606;4308;1324;3896;119;412;926;2609;1045;3021
250480;201610;3800;11401;3456;10888;82;349;3051;9587;3133;9936
250485;201610;673;1690;538;1472;27;89;434;1149;461;1238
250490;201610;3876;11939;3734;11724;729;2183;2619;8336;3348;10519
250500;201610;1801;5391;1567;4972;146;454;1198;3833;1344;4287
250510;201610;5007;13953;4367;12975;155;477;3851;11447;4006;11924
250520;201610;1790;5360;1636;5100;234;792;1004;3062;1238;3854
250523;201610;1694;5117;1631;5022;140;505;1335;4049;1475;4554
250527;201610;1431;4262;1353;4162;23;118;1245;3761;1268;3879
250530;201610;624;1888;532;1770;32;117;459;1520;491;1637
250535;201610;1335;4163;1226;3936;43;205;991;3082;1034;3287
250540;201610;2442;6821;2234;6560;52;225;1937;5536;1989;5761
250550;201610;916;3015;824;2861;44;221;655;2208;699;2429
250560;201610;1678;5245;1582;5074;86;362;1337;4167;1423;4529
250570;201610;2669;8321;2297;7578;113;487;1791;5717;1904;6204
250580;201610;1133;3014;958;2731;66;237;775;2136;841;2373
250590;201610;864;2654;783;2528;56;217;648;2032;704;2249
250600;201610;7410;21494;6825;20573;721;2032;5226;15884;5947;17916
250610;201610;3179;9140;2899;8685;230;715;2229;6634;2459;7349
250620;201610;705;2055;611;1859;78;258;398;1184;476;1442
250625;201610;2450;7830;2375;7720;48;114;2269;7437;2317;7551
250630;201610;9562;29488;8521;27269;1875;6039;4416;14039;6291;20078
250640;201610;3466;10595;3246;10279;187;792;2720;8388;2907;9180
250650;201610;865;2389;739;2197;39;154;557;1549;596;1703
250660;201610;1840;4842;1668;4607;23;47;1576;4395;1599;4442
250670;201610;2410;8068;2274;7818;119;556;1892;6358;2011;6914
250680;201610;4955;13848;4660;13466;188;614;4196;12108;4384;12722
250690;201610;6135;15876;5809;15473;384;987;5175;13792;5559;14779
250700;201610;4742;14004;4280;13262;714;2255;2746;8431;3460;10686
250710;201610;4480;13788;3932;12962;468;1594;2751;9152;3219;10746
250720;201610;2717;7832;2500;7485;73;319;2225;6565;2298;6884
250730;201610;3534;10629;3239;10187;238;831;2505;7702;2743;8533
250740;201610;1934;5560;1647;5112;161;598;1250;3724;1411;4322
250750;201610;101779;284982;90462;266703;12130;38095;59989;172933;72119;211028
250760;201610;2301;6430;2007;5967;147;520;1627;4751;1774;5271
250770;201610;3953;13011;3661;12558;441;1727;2603;8789;3044;10516
250780;201610;1845;5342;1540;4754;162;591;1008;3000;1170;3591
250790;201610;2409;7776;2231;7449;502;1627;1276;4400;1778;6027
250800;201610;2720;7544;2343;6900;101;286;1937;5617;2038;5903
250810;201610;1310;3814;1124;3516;67;278;890;2724;957;3002
250820;201610;1874;5845;1787;5734;95;391;1582;5016;1677;5407
250830;201610;5658;18115;5111;16947;483;1805;3572;11588;4055;13393
250840;201610;914;2964;748;2590;56;228;502;1734;558;1962
250850;201610;2026;6166;1804;5789;83;381;1441;4508;1524;4889
250855;201610;1099;3205;941;2936;47;200;719;2158;766;2358
250860;201610;3211;10350;2658;9273;632;2309;995;3471;1627;5780
250870;201610;1065;3089;905;2747;26;93;730;2165;756;2258
250880;201610;1509;4068;1250;3696;128;394;957;2831;1085;3225
250890;201610;9469;28136;8793;27103;1129;3983;6185;18465;7314;22448
250900;201610;2840;9111;2429;8255;207;683;1810;6155;2017;6838
250905;201610;2060;6459;1949;6294;220;771;1516;4860;1736;5631
250910;201610;5009;14439;4626;13821;223;767;3862;11388;4085;12155
250915;201610;1454;4422;1411;4361;99;219;1233;3938;1332;4157
250920;201610;3308;9328;3040;8881;294;790;2239;6531;2533;7321
250930;201610;2049;6222;1900;5963;151;593;1425;4353;1576;4946
250933;201610;1138;3711;1030;3471;80;300;695;2294;775;2594
250937;201610;685;2106;601;1936;46;171;442;1384;488;1555
250939;201610;1559;4714;1421;4462;157;523;988;3056;1145;3579
250940;201610;3842;11291;3520;10731;106;394;3064;9304;3170;9698
250950;201610;1297;3916;1113;3648;45;185;906;2953;951;3138
250960;201610;1087;3489;1018;3372;62;231;819;2677;881;2908
250970;201610;8561;23503;7284;21378;619;1863;5404;15649;6023;17512
250980;201610;2612;7585;2287;6952;87;359;1781;5174;1868;5533
250990;201610;1984;6657;1736;6089;235;950;1109;3738;1344;4688
251000;201610;2149;6292;1857;5794;47;210;1568;4810;1615;5020
251010;201610;2794;8158;2470;7620;92;321;2102;6468;2194;6789
251020;201610;1669;4696;1518;4499;72;217;1375;4073;1447;4290
251030;201610;1086;3053;965;2821;61;207;696;1972;757;2179
251040;201610;1806;5635;1583;5230;75;346;1217;3869;1292;4215
251050;201610;1094;3164;881;2732;133;413;528;1604;661;2017
251060;201610;1048;2379;764;2000;33;104;612;1573;645;1677
251065;201610;474;1420;407;1307;27;93;279;847;306;940
251070;201610;650;1811;574;1698;33;117;463;1316;496;1433
251080;201610;19546;54382;16957;49949;4672;14235;7318;22040;11990;36275
251090;201610;3007;9184;2585;8351;191;698;1904;6015;2095;6713
251100;201610;995;3108;872;2876;78;312;580;1823;658;2135
251110;201610;1944;5638;1659;5072;131;369;1155;3508;1286;3877
251120;201610;6210;20779;5815;20019;575;2324;4376;14753;4951;17077
251130;201610;4015;10218;3653;9814;75;196;3508;9484;3583;9680
251140;201610;4277;12933;3975;12430;109;477;3356;10394;3465;10871
251150;201610;2672;8357;2418;7949;191;800;1799;5747;1990;6547
251160;201610;1882;5993;1817;5908;53;213;1681;5450;1734;5663
251170;201610;1437;4349;1352;4237;76;308;1160;3561;1236;3869
251180;201610;2563;7702;2276;7219;341;1083;1423;4493;1764;5576
251190;201610;4444;12184;4177;11811;131;393;3810;10650;3941;11043
251200;201610;3841;12415;3625;12127;81;344;3330;11102;3411;11446
251203;201610;1034;3423;978;3304;43;187;746;2459;789;2646
251207;201610;1126;3436;915;3011;46;220;645;2026;691;2246
251210;201610;8018;22481;6732;20727;674;2043;5157;16187;5831;18230
251220;201610;1192;3128;956;2775;88;253;725;2113;813;2366
251230;201610;4645;13657;4222;13118;223;818;3733;11464;3956;12282
251240;201610;3337;9989;3007;9505;366;1198;2259;7056;2625;8254
251250;201610;10536;30735;9561;29166;744;2625;7303;21701;8047;24326
251260;201610;488;1539;442;1467;24;102;327;1060;351;1162
251270;201610;4278;13757;3871;13204;123;586;3401;11502;3524;12088
251272;201610;1389;3953;1312;3841;86;277;1147;3332;1233;3609
251274;201610;913;2807;800;2598;75;300;533;1670;608;1970
251275;201610;1267;3642;1162;3460;61;267;910;2574;971;2841
251276;201610;1233;3745;1144;3581;68;279;874;2655;942;2934
251278;201610;604;1872;514;1685;55;204;342;1115;397;1319
251280;201610;2378;7036;2171;6669;99;391;1746;5175;1845;5566
251290;201610;5733;15543;5300;14963;567;1958;4102;11161;4669;13119
251300;201610;783;2595;723;2493;35;153;580;1968;615;2121
251310;201610;3005;8911;2713;8468;123;538;2172;6558;2295;7096
251315;201610;1647;5597;1551;5421;138;491;1138;3971;1276;4462
251320;201610;1908;5255;1410;4397;48;167;1044;3236;1092;3403
251330;201610;1804;4796;1501;4374;70;318;1298;3632;1368;3950
251335;201610;1041;3454;941;3276;75;336;676;2289;751;2625
251340;201610;3440;9620;2980;8887;184;706;2281;6552;2465;7258
251350;201610;1290;4071;1189;3881;85;319;911;2889;996;3208
251360;201610;1837;5705;1552;5285;52;210;1351;4628;1403;4838
251365;201610;803;2356;617;1947;18;71;450;1397;468;1468
251370;201610;22801;70240;21743;68577;2036;7285;16916;52048;18952;59333
251380;201610;1363;4199;1159;3838;29;160;983;3128;1012;3288
251385;201610;798;2118;653;1879;61;171;442;1226;503;1397
251390;201610;5914;19953;5128;18319;1528;5536;2129;7669;3657;13205
251392;201610;1064;3143;915;2879;56;196;705;2190;761;2386
251394;201610;617;1928;497;1698;44;159;344;1159;388;1318
251396;201610;840;2363;703;2129;84;243;457;1372;541;1615
251398;201610;990;2832;838;2537;35;135;580;1699;615;1834
251400;201610;1178;3291;985;2997;82;299;721;2112;803;2411
251410;201610;1512;3900;1262;3483;41;164;1069;2842;1110;3006
251420;201610;2012;5710;1734;5358;188;620;1247;3798;1435;4418
251430;201610;1646;5587;1474;5296;63;320;1243;4363;1306;4683
251440;201610;1252;3682;996;3169;45;183;760;2389;805;2572
251445;201610;1514;4630;1416;4484;107;429;1107;3373;1214;3802
251450;201610;4641;14649;4255;14076;110;518;3597;11792;3707;12310
251455;201610;1089;3470;943;3166;68;262;662;2204;730;2466
251460;201610;819;2550;746;2420;68;216;595;1940;663;2156
251465;201610;451;1426;385;1281;17;90;287;916;304;1006
251470;201610;1186;3447;944;2948;80;289;593;1795;673;2084
251480;201610;950;2665;820;2442;30;139;643;1824;673;1963
251490;201610;1788;5303;1558;4916;141;529;1091;3354;1232;3883
251500;201610;1721;5471;1615;5269;99;412;1314;4166;1413;4578
251510;201610;2621;8500;2323;7886;400;1416;1335;4499;1735;5915
251520;201610;961;2612;822;2358;107;295;530;1499;637;1794
251530;201610;12211;33693;11372;32440;269;1145;9992;27860;10261;29005
251540;201610;2925;9239;2643;8681;162;655;2098;6773;2260;7428
251550;201610;3543;9194;2916;8279;84;286;2473;6944;2557;7230
251560;201610;713;2216;645;2085;87;317;391;1198;478;1515
251570;201610;1018;2996;781;2495;42;177;563;1731;605;1908
251580;201610;1926;5373;1747;5121;345;848;1135;3483;1480;4331
251590;201610;1497;4609;1411;4474;49;171;1167;3677;1216;3848
251593;201610;1009;3119;919;2981;139;473;554;1745;693;2218
251597;201610;1942;5908;1869;5810;51;207;1685;5178;1736;5385
251600;201610;6575;19171;6031;18284;345;1059;4867;14665;5212;15724
251610;201610;3343;9931;2924;9156;276;838;2159;6810;2435;7648
251615;201610;1160;3291;893;2807;81;244;613;1892;694;2136
251620;201610;15662;41952;13479;39283;588;1655;11400;34110;11988;35765
251630;201610;4698;12019;3871;10769;320;925;2943;7998;3263;8923
251640;201610;2573;7443;2128;6640;100;414;1650;5048;1750;5462
251650;201610;4005;11471;3605;10905;225;683;3065;9244;3290;9927
251660;201610;3567;11344;3213;10686;110;526;2687;8655;2797;9181
251670;201610;4503;13307;3877;12494;44;141;3586;11726;3630;11867
251675;201610;738;2307;674;2216;117;434;423;1337;540;1771
251680;201610;2788;7924;2227;7020;83;339;1761;5471;1844;5810
251690;201610;3312;9891;2922;9078;126;433;2233;6736;2359;7169
251700;201610;1958;6307;1818;6110;91;447;1531;5012;1622;5459
251710;201610;902;2344;558;1619;110;358;255;664;365;1022
251720;201610;1430;4363;1194;3917;52;257;915;2874;967;3131
251740;201610;784;2194;593;1855;54;179;376;1166;430;1345
260005;201610;26447;63487;21550;56153;4628;11588;11665;30637;16293;42225
260010;201610;10222;27342;8136;24373;1152;3492;4897;15046;6049;18538
260020;201610;6213;16903;5114;15201;211;760;4187;12428;4398;13188
260030;201610;6261;17745;5404;16323;369;1215;4266;12777;4635;13992
260040;201610;9994;24133;8029;21720;726;1829;6176;17267;6902;19096
260050;201610;11507;35075;10591;33888;527;1901;9170;29537;9697;31438
260060;201610;3944;10972;3420;10026;333;946;2488;7412;2821;8358
260070;201610;9962;28490;8924;26738;1168;3820;6032;17676;7200;21496
260080;201610;5976;15501;5193;14347;672;1716;3702;10237;4374;11953
260090;201610;5258;14284;4808;13610;631;1714;3498;9972;4129;11686
260100;201610;3428;9326;2879;8522;145;580;2416;7068;2561;7648
260105;201610;5061;13948;4724;13370;175;661;4099;11315;4274;11976
260110;201610;21454;59483;19496;57032;792;2442;17325;50668;18117;53110
260120;201610;12460;37089;10772;34016;2404;7687;5670;18292;8074;25979
260130;201610;3302;9122;3023;8654;385;1133;2179;6191;2564;7324
260140;201610;13290;32630;11186;29963;795;2301;8876;23775;9671;26076
260150;201610;3254;8924;2867;8393;202;710;2267;6570;2469;7280
260160;201610;5642;17486;4797;16302;262;1145;3956;13376;4218;14521
260170;201610;16771;46585;15728;44991;985;3132;13134;37111;14119;40243
260180;201610;3338;9989;2984;9462;175;551;2519;8023;2694;8574
260190;201610;16531;37987;14731;35590;438;1128;12895;30734;13333;31862
260200;201610;11452;29080;10394;27621;467;1431;9023;23893;9490;25324
260210;201610;11961;35442;10409;32963;555;1992;8507;26937;9062;28929
260220;201610;9621;27381;9185;26757;417;1552;8116;23222;8533;24774
260230;201610;9833;27642;8882;26217;436;1492;7253;21309;7689;22801
260240;201610;3012;8826;2568;8156;309;1066;1831;5818;2140;6884
260250;201610;2333;6324;2028;5874;121;362;1665;4771;1786;5133
260260;201610;12500;34987;11192;32984;1232;3896;8373;24789;9605;28685
260270;201610;3706;10621;3337;10016;242;986;2528;7228;2770;8214
260280;201610;13099;41810;11738;39640;691;2406;9791;33265;10482;35671
260290;201610;32841;97164;30285;92330;5342;16793;18581;55912;23923;72705
260300;201610;8796;26600;7489;24457;369;1543;5976;19441;6345;20984
260310;201610;4699;13657;4197;12853;1092;3037;2350;7665;3442;10702
260320;201610;7349;23215;6642;21977;381;1449;5419;17853;5800;19302
260330;201610;2676;8491;2426;7995;107;426;1897;6108;2004;6534
260340;201610;1902;5483;1730;5209;43;147;1558;4665;1601;4812
260345;201610;23265;71522;20927;66688;5784;19811;7719;23322;13503;43133
260350;201610;4941;13174;4499;12513;177;593;3891;10677;4068;11270
260360;201610;2402;6827;2068;6224;137;503;1498;4409;1635;4912
260370;201610;5759;17732;4936;16157;386;1535;3554;11484;3940;13019
260380;201610;4905;15953;4372;15053;246;1004;3301;11273;3547;12277
260390;201610;4332;13676;3645;12229;292;1061;2604;8576;2896;9637
260392;201610;3518;11118;3151;10614;216;978;2616;8555;2832;9533
260400;201610;14077;39258;13016;37406;1566;4911;9064;25425;10630;30336
260410;201610;62504;176431;52310;159084;14724;46800;19595;60510;34319;107310
260415;201610;3889;12014;3203;10567;232;983;2139;6731;2371;7714
260420;201610;12383;27859;10787;26039;220;708;9855;23482;10075;24190
260430;201610;2930;9358;2475;8431;242;868;1651;5593;1893;6461
260440;201610;3371;10041;2893;9055;363;1235;1863;5667;2226;6902
260450;201610;5071;14691;4811;14305;200;645;4261;12707;4461;13352
260460;201610;5675;17875;5011;16474;896;3152;2765;8851;3661;12003
260470;201610;4619;13660;4112;12989;164;471;3654;11798;3818;12269
260480;201610;4184;11777;3541;10776;539;1743;2316;7083;2855;8826
260490;201610;5105;13292;4351;11983;237;713;3530;9504;3767;10217
260500;201610;6002;17044;5181;15625;809;2425;3323;10047;4132;12472
260510;201610;8990;23641;8196;22534;349;1107;7223;19664;7572;20771
260515;201610;4827;14371;3552;11684;254;904;2271;7433;2525;8337
260520;201610;16536;42306;15471;40729;1628;4213;12041;31504;13669;35717
260530;201610;9927;29858;8629;27795;378;1449;7301;23444;7679;24893
260540;201610;6240;15205;5600;14468;891;1585;4231;11779;5122;13364
260545;201610;71;254;40;159;8;33;11;38;19;71
260550;201610;2797;8992;2238;7707;415;1512;987;3374;1402;4886
260560;201610;6291;16572;5531;15424;151;598;4874;13329;5025;13927
260570;201610;7010;22512;6284;21273;559;2131;4644;15599;5203;17730
260580;201610;3775;10394;3427;9777;116;388;2937;8212;3053;8600
260590;201610;6257;15530;5798;14963;316;792;5031;13009;5347;13801
260600;201610;28647;82591;24887;75988;1977;6977;18281;54976;20258;61953
260610;201610;6641;19746;6185;18947;709;2298;4424;13326;5133;15624
260620;201610;15889;47642;14858;45711;2328;7909;9382;27992;11710;35901
260630;201610;2275;6618;1973;6120;101;412;1608;4864;1709;5276
260640;201610;17497;47581;16100;45505;2288;6738;10862;30574;13150;37312
260650;201610;5498;17036;4778;15751;287;1085;3808;12560;4095;13645
260660;201610;7878;21588;6890;20214;378;1174;5794;16866;6172;18040
260670;201610;2420;6393;1928;5666;126;391;1389;4073;1515;4464
260680;201610;22055;61830;19276;56476;3691;10880;9798;28466;13489;39346
260690;201610;3696;9912;2930;8575;203;579;2279;6609;2482;7188
260700;201610;5873;17330;5697;17134;34;62;5593;16970;5627;17032
260710;201610;1359;3954;1262;3822;85;277;939;2898;1024;3175
260720;201610;18344;57218;16738;53995;3488;11510;9073;29080;12561;40590
260730;201610;6863;22541;6307;21560;812;2911;4564;15459;5376;18370
260740;201610;1323;3888;1131;3523;91;321;849;2637;940;2958
260750;201610;6959;20749;6056;19550;293;908;5303;17376;5596;18284
260760;201610;4809;12820;4404;12235;215;696;3745;10358;3960;11054
260765;201610;7892;26351;7371;25415;1007;4327;4934;16271;5941;20598
260770;201610;3876;10272;3427;9512;122;389;2813;7689;2935;8078
260775;201610;5053;14760;4644;14042;434;1566;3312;9684;3746;11250
260780;201610;3703;11807;3367;11109;682;2406;1714;5422;2396;7828
260790;201610;113514;284310;101791;265182;21049;55223;57721;148706;78770;203929
260795;201610;3125;9156;2724;8516;230;787;1983;6191;2213;6978
260800;201610;4988;13206;4601;12650;139;513;4121;11006;4260;11519
260805;201610;3868;11331;3172;10096;355;1281;2181;6784;2536;8065
260810;201610;6949;19120;6596;18633;324;965;5709;16020;6033;16985
260820;201610;4172;11628;3537;10542;753;2264;1869;5490;2622;7754
260825;201610;2931;9277;2564;8643;169;642;1941;6528;2110;7170
260830;201610;3758;11962;3297;11020;512;1658;2108;7173;2620;8831
260840;201610;4297;12176;3738;11313;239;828;3049;9103;3288;9931
260845;201610;4236;12180;3939;11617;452;1369;2881;8528;3333;9897
260850;201610;5001;16227;4272;14533;798;2901;1987;6640;2785;9541
260860;201610;3597;10868;3028;9697;151;540;2341;7378;2492;7918
260870;201610;4339;11487;3681;10557;315;897;2928;8348;3243;9245
260875;201610;6580;18192;5657;16585;830;2372;3712;10939;4542;13311
260880;201610;9906;29565;8813;27666;570;1843;7070;22292;7640;24135
260890;201610;13346;37855;12101;35707;744;2438;9374;27322;10118;29760
260900;201610;5929;18022;4915;15958;396;1578;3164;10004;3560;11582
260910;201610;3091;9164;2697;8487;161;579;2078;6445;2239;7024
260915;201610;4612;15263;4300;14812;86;430;3947;13510;4033;13940
260920;201610;3246;9837;2941;9385;158;577;2394;7715;2552;8292
260930;201610;3926;12606;3356;11567;351;1239;2361;8108;2712;9347
260940;201610;14180;37272;12473;34254;1519;4593;8429;22417;9948;27010
260950;201610;6409;19572;5496;17601;820;2955;2853;8602;3673;11557
260960;201610;57106;156418;50374;144677;10049;29894;26215;74035;36264;103929
260970;201610;5061;14978;4527;14230;284;1022;3565;11188;3849;12210
260980;201610;4048;12988;3741;12561;120;495;3331;11137;3451;11632
260990;201610;17739;53550;15788;50655;1065;3841;12577;40238;13642;44079
261000;201610;16213;43566;12764;37965;2252;6989;6757;20533;9009;27522
261010;201610;2566;6994;2327;6702;133;295;2049;6046;2182;6341
261020;201610;6341;18207;5439;16552;549;1666;4007;11989;4556;13655
261030;201610;3701;11458;3216;10588;185;737;2571;8291;2756;9028
261040;201610;5172;16496;4312;14647;378;1454;3066;10207;3444;11661
261050;201610;7970;23068;7267;21700;938;2784;4829;14417;5767;17201
261060;201610;12468;36031;11282;33833;934;3185;8400;24564;9334;27749
261070;201610;54230;130613;46240;118438;6033;15614;31230;79276;37263;94890
261080;201610;5811;16515;5404;15879;333;874;4621;13793;4954;14667
261090;201610;16759;45338;15040;42781;1188;3295;12003;34289;13191;37584
261100;201610;8293;25669;7162;23588;1286;4368;4159;13815;5445;18183
261110;201610;62640;183344;53433;168210;13457;44539;24078;76625;37535;121164
261120;201610;3846;10043;3270;9284;75;264;2951;8355;3026;8619
261130;201610;7181;18183;6525;17376;151;471;5960;15779;6111;16250
261140;201610;3295;9069;2897;8412;380;1237;1844;5206;2224;6443
261150;201610;5454;15415;4945;14590;309;1121;4116;12008;4425;13129
261153;201610;2182;6280;1758;5602;84;338;1294;4085;1378;4423
261160;201610;201105;522992;179205;487669;46658;130026;79252;216737;125910;346763
261170;201610;5976;16044;5318;15044;420;1224;4182;11838;4602;13062
261180;201610;9733;26780;8766;25231;1000;3096;5991;16909;6991;20005
261190;201610;5258;16001;4813;15398;463;1896;3457;10654;3920;12550
261200;201610;3635;9028;3230;8522;360;941;2540;6745;2900;7686
261210;201610;1917;5039;1751;4814;137;372;1510;4161;1647;4533
261220;201610;13458;41247;10836;35493;1554;5504;6010;19335;7564;24839
261230;201610;4671;14412;4198;13755;127;528;3659;12031;3786;12559
261240;201610;5020;14475;4518;13587;593;1644;3155;9624;3748;11268
261245;201610;3615;10965;3014;9831;150;662;2348;7413;2498;8075
261247;201610;3301;9995;2698;8824;256;929;1882;6207;2138;7136
261250;201610;19671;51785;18019;49381;3423;9000;11859;33420;15282;42420
261255;201610;4090;12531;3520;11457;219;944;2795;8782;3014;9726
261260;201610;12569;34726;10951;32564;523;1665;9332;27781;9855;29446
261270;201610;3709;10938;3263;10156;314;1108;2304;6961;2618;8069
261280;201610;2610;7817;2329;7354;117;445;1918;5928;2035;6373
261290;201610;2980;8417;2636;7928;149;537;2143;6429;2292;6966
261300;201610;10693;33973;8962;30611;1213;4636;5619;18708;6832;23344
261310;201610;7377;22516;6790;21388;1699;5433;3563;11211;5262;16644
261320;201610;5905;18012;5289;16841;208;776;4271;13404;4479;14180
261330;201610;5774;15997;5373;15434;345;1174;4501;12659;4846;13833
261340;201610;3988;13165;3687;12618;355;1491;2542;8550;2897;10041
261350;201610;8177;26501;7502;25260;242;1260;6162;20087;6404;21347
261360;201610;8253;21518;7114;19799;616;1776;5556;15114;6172;16890
261370;201610;20015;58422;18123;55138;3777;11820;9939;30169;13716;41989
261380;201610;4198;14116;3793;13212;568;2189;2382;8192;2950;10381
261390;201610;16613;49921;14479;46053;2053;6820;8820;28066;10873;34886
261400;201610;4732;16067;4091;14662;292;1256;2936;10367;3228;11623
261410;201610;8930;24461;7849;22725;689;2101;6096;17535;6785;19636
261420;201610;7572;25095;7133;24440;1530;5892;4218;14116;5748;20008
261430;201610;3496;10618;2962;9765;237;761;2278;7631;2515;8392
261440;201610;1590;4941;1393;4599;46;243;1094;3502;1140;3745
261450;201610;14426;40551;13677;39520;311;1163;12403;35520;12714;36683
261460;201610;7315;21147;6759;20376;417;1199;5787;17630;6204;18829
261470;201610;4132;11168;3737;10640;83;253;3366;9724;3449;9977
261480;201610;3791;13322;3395;12560;259;1052;2529;9166;2788;10218
261485;201610;5035;15344;4386;14129;611;2213;2730;8581;3341;10794
261500;201610;5692;15766;4946;14679;541;1494;3567;10886;4108;12380
261510;201610;1900;6030;1676;5637;117;427;1247;4196;1364;4623
261520;201610;2700;8675;2423;8128;135;537;1672;5771;1807;6308
261530;201610;11533;36797;9929;33387;2133;7746;4183;13866;6316;21612
261540;201610;7101;22805;6521;21707;1673;5457;3501;11999;5174;17456
261550;201610;3506;9758;3209;9278;274;915;2455;6916;2729;7831
261560;201610;7169;23344;6404;22242;773;3039;4686;16246;5459;19285
261570;201610;3465;10298;2901;9279;417;1372;1812;5743;2229;7115
261580;201610;6155;18378;5469;17233;302;1259;4630;14367;4932;15626
261590;201610;2478;6932;2075;6264;172;518;1541;4678;1713;5196
261600;201610;5297;14229;4436;12931;304;908;3459;10108;3763;11016
261610;201610;2424;6797;2075;6294;136;509;1667;5000;1803;5509
261618;201610;2544;7005;2248;6583;162;502;1717;4909;1879;5411
261620;201610;4149;12756;3805;12151;789;2471;2325;7606;3114;10077
261630;201610;7732;22405;6227;19413;736;2583;3683;11139;4419;13722
261640;201610;34219;84395;31843;81428;2069;4664;26014;69289;28083;73953
261650;201610;3789;11164;3408;10587;257;950;2593;8043;2850;8993
270010;201610;4543;16636;4053;15636;319;1495;2901;11090;3220;12585
270020;201610;3967;11071;3624;10545;313;1021;2887;8209;3200;9230
270030;201610;36109;107927;32898;102220;7444;23229;18158;56601;25602;79830
270040;201610;10732;32262;9733;30867;1647;5318;6327;20317;7974;25635
270050;201610;4451;12266;3983;11672;352;1096;3222;9442;3574;10538
270060;201610;1915;5560;1748;5331;285;890;1172;3626;1457;4516
270070;201610;4439;13394;3996;12751;181;808;3411;10608;3592;11416
270080;201610;1290;4023;1081;3581;141;492;690;2229;831;2721
270090;201610;2097;6439;1874;5975;69;338;1528;4643;1597;4981
270100;201610;5782;17494;5358;16748;594;2128;3933;12033;4527;14161
270110;201610;3269;8858;2834;8347;358;1053;1921;6010;2279;7063
270120;201610;3180;8809;2724;8197;101;388;2402;7170;2503;7558
270130;201610;5199;15527;4716;14941;619;2050;3504;11286;4123;13336
270135;201610;1800;4764;1597;4491;183;382;1330;3899;1513;4281
270140;201610;10599;24943;8763;22482;948;3071;6777;16374;7725;19445
270150;201610;2728;8727;2628;8601;49;162;2526;8298;2575;8460
270160;201610;5101;16627;4592;15930;170;763;3966;13612;4136;14375
270170;201610;3820;12104;3428;11509;533;2053;2109;6900;2642;8953
270180;201610;2306;7457;2086;7125;81;424;1730;5754;1811;6178
270190;201610;1817;5894;1706;5734;91;348;1441;4862;1532;5210
270200;201610;2611;8602;2406;8305;203;875;1794;6023;1997;6898
270210;201610;4759;13990;4414;13485;255;1022;3739;11190;3994;12212
270220;201610;1345;4376;1209;4116;237;873;672;2223;909;3096
270230;201610;11070;34247;9341;31247;1110;4482;5800;18653;6910;23135
270235;201610;6501;20589;5971;19713;347;1461;4871;15898;5218;17359
270240;201610;9605;28714;7846;26308;1951;6742;3699;12663;5650;19405
270250;201610;3266;8486;2923;8043;452;1202;2186;6045;2638;7247
270255;201610;4983;14884;3785;12643;227;939;2728;8862;2955;9801
270260;201610;5952;18885;5703;18507;387;1650;4778;15107;5165;16757
270270;201610;1187;3355;1061;3153;223;674;609;1777;832;2451
270280;201610;3533;9863;2989;8998;343;879;2137;6496;2480;7375
270290;201610;8221;28180;7549;26960;541;2479;5858;20468;6399;22947
270300;201610;3685;11546;3230;10937;327;1193;2415;8126;2742;9319
270310;201610;7655;22729;6573;21022;248;1268;5500;17047;5748;18315
270320;201610;5942;18378;5537;17660;861;2984;3729;11701;4590;14685
270330;201610;4310;14522;3987;14060;409;1535;3086;10954;3495;12489
270340;201610;1759;5266;1523;4938;175;570;1130;3629;1305;4199
270350;201610;1944;5120;1721;4840;157;466;1260;3561;1417;4027
270360;201610;2025;6172;1928;6059;150;433;1657;5305;1807;5738
270370;201610;1530;4986;1360;4678;105;434;992;3374;1097;3808
270375;201610;2934;7991;2583;7508;89;306;2301;6655;2390;6961
270380;201610;5872;17677;5334;16874;737;2115;3931;12820;4668;14935
270390;201610;1270;3453;1087;3157;54;188;846;2367;900;2555
270400;201610;6446;18998;5609;17677;343;1283;4156;12707;4499;13990
270410;201610;4868;15110;4357;14104;408;1436;3082;9800;3490;11236
270420;201610;5949;18685;5614;18188;237;1076;4614;14567;4851;15643
270430;201610;139920;398300;119861;365963;34367;109622;43084;134330;77451;243952
270440;201610;4724;14005;4207;13214;165;676;3506;10914;3671;11590
270450;201610;6377;19410;6021;18920;330;1295;4956;15304;5286;16599
270460;201610;3474;9060;3063;8513;113;390;2695;7341;2808;7731
270470;201610;10444;32790;9363;30944;1053;3879;6332;20835;7385;24714
270480;201610;2864;8767;2489;8071;287;1084;1690;5244;1977;6328
270490;201610;988;3092;886;2926;43;179;700;2280;743;2459
270500;201610;4871;16400;4536;15952;282;1222;3751;13091;4033;14313
270510;201610;6099;17753;5358;16650;599;2380;4033;11958;4632;14338
270520;201610;3510;11074;3136;10399;998;3606;987;3354;1985;6960
270530;201610;1395;4276;1266;4062;115;386;879;2861;994;3247
270540;201610;2090;6790;1868;6439;104;548;1540;5112;1644;5660
270550;201610;7262;20836;6199;19410;768;2491;4321;13806;5089;16297
270560;201610;3123;9229;2856;8804;261;926;2136;6444;2397;7370
270570;201610;3773;12068;3388;11371;568;1772;2339;7939;2907;9711
270580;201610;2075;6266;1935;6073;139;441;1592;5059;1731;5500
270590;201610;1393;4537;1320;4420;9;41;1284;4304;1293;4345
270600;201610;2873;9391;2576;8861;139;666;2080;6974;2219;7640
270610;201610;3266;10001;2977;9549;160;581;2500;7918;2660;8499
270620;201610;1420;4695;1317;4517;85;370;1047;3466;1132;3836
270630;201610;16549;47774;14840;44928;2004;6009;10241;31498;12245;37507
270640;201610;5768;17482;5079;16363;312;1290;4052;12711;4364;14001
270642;201610;2306;8106;2128;7840;211;1010;1599;5723;1810;6733
270644;201610;2747;7958;2360;7403;253;765;1776;5658;2029;6423
270650;201610;3738;11504;3491;11136;412;1859;2504;7455;2916;9314
270660;201610;2139;5490;1583;4634;127;356;1167;3377;1294;3733
270670;201610;16973;42761;14295;39558;1846;4932;10420;29473;12266;34405
270680;201610;4375;12594;4135;12306;119;331;3850;11525;3969;11856
270690;201610;9244;25292;8078;23877;2646;7313;4120;13053;6766;20366
270700;201610;639;1982;557;1837;83;341;361;1121;444;1462
270710;201610;5996;18934;5594;18362;406;1667;4596;14746;5002;16413
270720;201610;3428;11379;3062;10711;127;729;2545;8661;2672;9390
270730;201610;6471;18431;6032;17937;557;1711;4987;14979;5544;16690
270740;201610;2328;6600;2171;6363;197;648;1721;4971;1918;5619
270750;201610;5215;15781;4732;14972;647;2177;3346;10523;3993;12700
270760;201610;3445;10187;3044;9504;125;492;2476;7621;2601;8113
270770;201610;19307;49900;15493;45088;3224;9221;8758;26754;11982;35975
270780;201610;1844;5858;1722;5640;191;729;1267;4079;1458;4808
270790;201610;1516;4741;1370;4514;320;1137;710;2299;1030;3436
270800;201610;11567;33422;10518;31935;627;2365;8859;26367;9486;28732
270810;201610;3359;10072;2540;8519;287;1033;1576;5335;1863;6368
270820;201610;1827;5855;1600;5459;259;946;990;3357;1249;4303
270830;201610;5855;15292;5124;14366;395;1052;4122;11951;4517;13003
270840;201610;8005;25227;7286;24228;330;1688;6257;20148;6587;21836
270850;201610;7498;22852;7078;22259;871;3420;5097;15078;5968;18498
270860;201610;11097;30852;9198;28308;1149;3994;6143;18413;7292;22407
270870;201610;2170;6519;1785;5712;222;777;1183;3709;1405;4486
270880;201610;8306;26193;7586;25064;421;1744;6221;20237;6642;21981
270890;201610;2480;7503;2275;7105;224;858;1682;5085;1906;5943
270895;201610;2928;10557;2764;10285;127;646;2401;8808;2528;9454
270900;201610;1952;5196;1554;4613;110;326;1127;3280;1237;3606
270910;201610;3565;11539;3220;10888;248;1022;2456;8093;2704;9115
270915;201610;9572;31416;8377;29184;1270;5050;4962;16793;6232;21843
270920;201610;6178;19290;5880;18843;259;1279;5169;16053;5428;17332
270930;201610;17580;46026;14176;41681;3200;9028;7908;24294;11108;33322
270940;201610;5614;18363;5149;17752;464;2109;3667;12141;4131;14250
280010;201610;665;1923;561;1732;47;200;374;1066;421;1266
280020;201610;4919;13927;4066;12407;688;2236;2540;7547;3228;9783
280030;201610;76969;197730;62593;175148;18536;53264;22750;65069;41286;118333
280040;201610;3154;9470;2752;8836;228;799;2054;6513;2282;7312
280050;201610;3828;11964;3444;11273;1048;3582;1461;4830;2509;8412
280060;201610;5085;15657;4232;14093;865;3054;2085;7044;2950;10098
280067;201610;7357;20314;6122;18285;951;2788;3664;11051;4615;13839
280070;201610;1982;6382;1867;6200;214;745;1411;4689;1625;5434
280100;201610;3883;11799;3395;10922;490;1731;2219;7107;2709;8838
280110;201610;1436;4223;1283;3973;53;213;1092;3319;1145;3532
280120;201610;7897;24502;7129;23210;1092;3227;4876;16439;5968;19666
280130;201610;7713;21055;6893;19814;922;2820;4790;13741;5712;16561
280140;201610;5894;15337;5274;14414;401;1160;4259;11652;4660;12812
280150;201610;3547;10451;3224;9881;257;899;2417;7195;2674;8094
280160;201610;1383;3993;1160;3616;171;570;746;2272;917;2842
280170;201610;4891;14231;4322;13332;451;1362;3250;10149;3701;11511
280190;201610;1207;3157;1012;2847;79;255;786;2133;865;2388
280200;201610;1195;3504;1054;3275;104;394;776;2324;880;2718
280210;201610;14195;40801;12177;37675;2566;8244;6652;20675;9218;28919
280220;201610;1628;4891;1491;4663;68;267;1252;3857;1320;4124
280230;201610;3539;10356;3094;9612;353;1164;2040;6361;2393;7525
280240;201610;3511;9956;3129;9329;180;568;2523;7459;2703;8027
280250;201610;840;2183;648;1869;110;352;355;959;465;1311
280260;201610;2155;5579;1988;5367;64;194;1819;4919;1883;5113
280270;201610;2264;6950;1983;6486;114;437;1567;5015;1681;5452
280280;201610;4179;13413;3648;12459;846;2366;2053;7737;2899;10103
280290;201610;17854;52907;15707;49355;2587;8617;9411;29558;11998;38175
280300;201610;9770;28945;9031;28009;713;2432;7072;22675;7785;25107
280310;201610;1408;3888;1190;3496;51;207;880;2508;931;2715
280320;201610;8839;27420;7853;25659;1352;4706;4300;13826;5652;18532
280330;201610;4541;12793;4045;11934;442;1505;2962;8361;3404;9866
280340;201610;3930;10746;3648;10348;300;901;2949;8478;3249;9379
280350;201610;22916;62447;19672;57355;2916;8774;12719;37032;15635;45806
280360;201610;5938;18336;5311;17220;992;3510;2939;9288;3931;12798
280370;201610;1925;5295;1597;4719;183;485;1107;3286;1290;3771
280380;201610;1053;3191;936;2996;91;334;648;2001;739;2335
280390;201610;3222;9302;2653;8209;502;1579;1606;4971;2108;6550
280400;201610;4232;11684;3728;10892;1128;3217;1758;5350;2886;8567
280410;201610;2235;7030;1828;6182;280;1026;1005;3249;1285;4275
280420;201610;4235;12095;3844;11468;209;655;3267;9716;3476;10371
280430;201610;2300;5811;2037;5426;104;356;1596;4124;1700;4480
280440;201610;4791;13737;4285;13034;350;1135;3407;10194;3757;11329
280445;201610;2543;6961;2284;6489;70;246;1841;5102;1911;5348
280450;201610;9333;24325;8518;23232;615;1379;7162;20105;7777;21484
280460;201610;7042;18088;6261;16910;773;2088;4553;12424;5326;14512
280470;201610;1851;5521;1617;5083;151;460;1180;3739;1331;4199
280480;201610;33259;93814;30355;89223;4886;15590;19672;56506;24558;72096
280490;201610;3910;11527;3374;10606;212;786;2517;7744;2729;8530
280500;201610;942;2474;830;2316;45;118;690;1912;735;2030
280510;201610;2710;7714;2284;7108;190;656;1663;5143;1853;5799
280520;201610;1841;4888;1643;4633;143;369;1358;3876;1501;4245
280530;201610;2515;6663;2269;6346;137;407;1898;5305;2035;5712
280540;201610;9555;25764;8680;24463;257;965;7617;20954;7874;21919
280550;201610;7135;18175;5781;16046;577;1561;4063;11251;4640;12812
280560;201610;7719;22451;7198;21649;361;1235;6036;17875;6397;19110
280570;201610;6572;17555;5541;16074;565;1736;3807;10904;4372;12640
280580;201610;5646;17054;4667;15273;798;2501;2778;9348;3576;11849
280590;201610;2626;7284;2246;6753;335;1127;1397;4129;1732;5256
280600;201610;3700;11183;3379;10656;288;1015;2535;7852;2823;8867
280610;201610;2517;6933;2245;6503;185;633;1625;4557;1810;5190
280620;201610;5383;15501;4608;14124;618;1750;3094;9876;3712;11626
280630;201610;3681;11825;3384;11345;308;1027;2667;9121;2975;10148
280640;201610;2245;6657;2118;6510;80;234;1968;6091;2048;6325
280650;201610;1139;3478;1009;3260;94;341;723;2304;817;2645
280660;201610;2796;7612;2619;7376;321;863;2119;6003;2440;6866
280670;201610;17018;43474;15275;40923;2095;5933;10530;27817;12625;33750
280680;201610;2877;7643;2441;6917;187;547;1907;5311;2094;5858
280690;201610;965;2715;834;2520;110;353;580;1729;690;2082
280700;201610;1076;3155;929;2899;69;214;657;2029;726;2243
280710;201610;12358;31598;11021;29929;672;1469;9472;26397;10144;27866
280720;201610;2371;6197;2135;5892;253;683;1481;4255;1734;4938
280730;201610;927;2749;843;2613;76;295;666;2000;742;2295
280740;201610;13573;35821;11160;31769;1521;4126;7249;20883;8770;25009
280750;201610;3549;10606;3168;9915;309;1002;2259;7090;2568;8092
280760;201610;5814;17332;5135;16246;881;2926;3004;9734;3885;12660
290010;201610;3036;6771;2139;5348;41;160;1730;4106;1771;4266
290020;201610;4456;14512;4307;14292;399;1025;3559;12113;3958;13138
290030;201610;3252;9817;3015;9463;477;1494;2177;6868;2654;8362
290035;201610;4714;11802;3986;10791;210;670;3082;8581;3292;9251
290040;201610;4274;11093;3523;10195;220;770;2752;7889;2972;8659
290050;201610;2494;8030;2144;7373;153;632;1558;5271;1711;5903
290060;201610;1329;3374;1079;3043;134;454;815;2198;949;2652
290070;201610;34841;85002;28601;76429;5765;15099;14625;40843;20390;55942
290080;201610;6185;18111;5088;16520;712;2351;3466;11442;4178;13793
290090;201610;2194;4712;1691;4161;121;274;1455;3645;1576;3919
290100;201610;9704;27407;8283;25072;1164;3546;5123;15865;6287;19411
290110;201610;4963;14480;4595;13806;732;2282;2905;8550;3637;10832
290115;201610;4908;14543;4305;13733;256;754;3507;11471;3763;12225
290120;201610;6924;17771;5612;16163;239;800;4646;13234;4885;14034
290130;201610;4692;12072;3786;10882;161;575;3064;8563;3225;9138
290135;201610;4733;11565;3819;10071;329;978;2769;6966;3098;7944
290140;201610;4399;13139;3693;12176;222;867;3041;10008;3263;10875
290150;201610;2236;6600;2094;6337;239;780;1604;4762;1843;5542
290160;201610;3530;8803;3316;8513;348;719;2680;6998;3028;7717
290170;201610;2798;8895;2498;8440;146;656;2103;6966;2249;7622
290180;201610;2982;8568;2522;7827;161;578;1935;5933;2096;6511
290190;201610;3850;12600;3605;12200;197;815;2789;9306;2986;10121
290195;201610;2215;5904;1786;5201;61;268;1506;4277;1567;4545
290200;201610;3996;12174;3414;11218;235;814;2702;8842;2937;9656
290205;201610;3335;9444;2890;8687;213;802;2209;6446;2422;7248
290210;201610;15067;42027;13328;39625;2180;5802;9056;28570;11236;34372
290220;201610;2332;6799;2153;6497;124;503;1731;5068;1855;5571
290225;201610;3038;7263;2680;6848;131;355;2428;6185;2559;6540
290230;201610;2296;7293;2138;7079;121;483;1762;5805;1883;6288
290240;201610;3655;9817;3204;9073;231;700;2524;7015;2755;7715
290250;201610;4006;12288;3603;11704;136;381;3056;10379;3192;10760
290260;201610;5274;14560;4291;13028;372;1201;3263;9883;3635;11084
290265;201610;3488;10664;3001;9715;160;680;2337;7439;2497;8119
290270;201610;12229;43723;11452;42360;1318;5287;8323;30785;9641;36072
290280;201610;5438;17324;4854;16237;509;1750;3570;11915;4079;13665
290290;201610;10064;30845;8659;28393;1233;3999;5770;19168;7003;23167
290300;201610;4748;13155;3285;10327;221;698;2267;7253;2488;7951
290310;201610;1463;4323;1226;3913;187;626;720;2286;907;2912
290320;201610;29369;81953;24281;74974;5490;17842;12179;38411;17669;56253
290323;201610;3960;10586;3406;9893;156;441;2824;8174;2980;8615
290327;201610;4516;13453;3773;12022;510;1651;2437;7759;2947;9410
290330;201610;1876;4529;1713;4346;100;268;1519;3877;1619;4145
290340;201610;5148;15380;4673;14762;1294;4154;2622;8344;3916;12498
290350;201610;4498;13624;3788;12471;337;1104;2703;9059;3040;10163
290360;201610;4651;13774;3938;12749;148;568;3280;10677;3428;11245
290370;201610;4882;13166;4084;12059;313;882;3311;9876;3624;10758
290380;201610;5661;16146;4845;14875;281;912;3819;11897;4100;12809
290390;201610;15123;45099;13219;42131;2007;6484;8305;27118;10312;33602
290395;201610;2639;8500;2320;7882;117;542;1768;5978;1885;6520
290400;201610;3689;10627;2993;9467;239;765;2163;6733;2402;7498
290405;201610;4791;14803;3871;12993;512;1677;2389;8177;2901;9854
290410;201610;6069;17599;4767;15414;362;1433;3431;10705;3793;12138
290420;201610;3331;9508;2705;8534;210;688;2099;6614;2309;7302
290430;201610;3202;9795;2742;8915;480;1602;1661;5446;2141;7048
290440;201610;3057;7920;2370;6909;146;493;1839;5394;1985;5887
290450;201610;3371;9608;2758;8632;232;845;1974;6062;2206;6907
290460;201610;13046;37418;11289;34157;3451;10514;3964;11983;7415;22497
290470;201610;4461;12148;3275;10301;685;2340;1531;4919;2216;7259
290475;201610;5715;17947;4895;16320;216;1016;3873;12516;4089;13532
290480;201610;2541;6747;2347;6486;231;644;1692;4946;1923;5590
290485;201610;4865;15222;4171;14149;244;1199;3371;11202;3615;12401
290490;201610;8385;21573;7806;20771;573;1675;6477;16944;7050;18619
290500;201610;4229;13119;3328;11235;510;1827;1773;5941;2283;7768
290510;201610;3427;9488;2909;8735;157;535;2372;7078;2529;7613
290515;201610;3595;10014;2956;9140;215;643;2408;7586;2623;8229
290520;201610;11913;36015;9040;30133;859;3067;5494;18061;6353;21128
290530;201610;5234;15237;4468;13984;309;928;3508;11002;3817;11930
290540;201610;3992;11294;3660;10730;296;879;2920;8552;3216;9431
290550;201610;4714;11957;4044;11151;96;270;3714;10248;3810;10518
290560;201610;6588;18499;5619;17040;1311;3818;3213;10004;4524;13822
290570;201610;43643;117687;38952;110767;3992;11369;28309;80127;32301;91496
290580;201610;7021;23452;6476;22517;659;2431;4867;17061;5526;19492
290590;201610;7416;23274;6252;21145;248;1027;5100;17150;5348;18177
290600;201610;17993;53273;16359;50856;1934;5800;12203;38887;14137;44687
290610;201610;2530;8379;1985;7225;122;565;1409;4976;1531;5541
290620;201610;6555;19479;5839;18293;346;1113;4767;14821;5113;15934
290630;201610;8467;21481;7251;20030;556;1552;6061;16814;6617;18366
290640;201610;2743;7796;2134;6762;123;454;1642;5105;1765;5559
290650;201610;11328;32251;10471;30932;2284;6611;6178;18802;8462;25413
290660;201610;3757;10182;3108;9188;116;361;2341;7180;2457;7541
290670;201610;7034;21134;6060;19406;656;2143;4264;13724;4920;15867
290680;201610;10572;30788;9225;28893;412;1653;7577;23231;7989;24884
290682;201610;4694;13165;4066;12213;138;533;3517;10411;3655;10944
290685;201610;3825;8939;2428;6916;279;823;1528;4441;1807;5264
290687;201610;7638;21317;5759;18284;1312;4168;2709;9012;4021;13180
290689;201610;3231;9194;2769;8459;246;821;2069;6501;2315;7322
290690;201610;5635;15595;4796;14386;717;2102;3178;9573;3895;11675
290700;201610;2418;7310;2220;6982;140;458;1755;5530;1895;5988
290710;201610;7861;24369;7202;23300;508;1566;5879;19171;6387;20737
290720;201610;19136;54662;17249;52091;1387;3756;14080;43552;15467;47308
290730;201610;7391;19809;6462;18498;729;1890;4631;13434;5360;15324
290740;201610;966;2792;737;2370;65;229;530;1685;595;1914
290750;201610;10486;28690;8715;25300;1353;4256;5073;14154;6426;18410
290755;201610;2382;6687;1809;5619;114;392;1278;3900;1392;4292
290760;201610;4314;12844;3355;10993;469;1377;2003;6783;2472;8160
290770;201610;2562;8835;2355;8524;93;439;1929;6975;2022;7414
290780;201610;9192;22857;7767;20743;796;1618;5891;16383;6687;18001
290790;201610;4493;13137;4089;12560;228;681;3495;10764;3723;11445
290800;201610;7335;15350;5594;13400;443;840;4441;11123;4884;11963
290810;201610;5512;16357;4461;14602;171;614;3410;11172;3581;11786
290820;201610;5740;15733;5003;14704;451;1427;3773;11192;4224;12619
290830;201610;4429;11534;3966;10819;192;636;3007;7975;3199;8611
290840;201610;17940;50282;15474;46410;2329;6681;9807;30651;12136;37332
290850;201610;6227;17852;5863;17359;837;2219;4363;13435;5200;15654
290860;201610;5209;17137;4751;16519;452;1550;3714;13236;4166;14786
290870;201610;4835;13940;3781;12137;216;816;2705;8611;2921;9427
290880;201610;1484;3935;1139;3358;99;278;790;2362;889;2640
290890;201610;7333;18428;6197;17133;541;1251;5126;14515;5667;15766
290900;201610;2490;7039;1814;5800;239;788;987;3148;1226;3936
290910;201610;4864;12657;3876;11154;89;335;3312;9356;3401;9691
290920;201610;5040;13457;4569;12790;219;606;3909;10903;4128;11509
290930;201610;8355;24557;7032;22362;298;1334;5602;17393;5900;18727
290940;201610;3583;11123;3028;10201;101;344;2474;8442;2575;8786
290950;201610;1587;4315;1347;3922;133;383;928;2725;1061;3108
290960;201610;5890;16342;5251;15473;165;565;4405;13038;4570;13603
290970;201610;3811;11571;3205;10536;251;831;2208;7290;2459;8121
290980;201610;10820;30392;8682;26256;2486;7599;2386;7227;4872;14826
290990;201610;9215;26996;7766;24479;681;2366;5780;17806;6461;20172
291000;201610;3102;8917;2740;8467;125;441;2431;7472;2556;7913
291005;201610;14806;37823;12806;35067;1348;3762;9390;25928;10738;29690
291010;201610;3331;10148;2535;8426;228;761;1668;5582;1896;6343
291020;201610;1382;3580;1010;2896;96;265;570;1540;666;1805
291030;201610;2298;6134;1581;4686;137;438;1004;2866;1141;3304
291040;201610;5707;16692;4895;15404;287;1169;3871;12005;4158;13174
291050;201610;8078;25667;7167;23913;1714;6135;3703;12083;5417;18218
291060;201610;6071;21979;5608;21143;887;3719;3542;13105;4429;16824
291070;201610;16593;46585;14082;42728;860;2956;10987;33015;11847;35971
291072;201610;23834;69023;18224;57521;4527;15206;6222;19652;10749;34858
291075;201610;5267;14633;4550;13459;290;760;3459;10304;3749;11064
291077;201610;1500;4215;1166;3626;81;263;786;2417;867;2680
291080;201610;80542;247932;68397;222627;24407;79947;12866;41528;37273;121475
291085;201610;5803;15035;4873;13729;369;1084;3966;11188;4335;12272
291090;201610;1684;3839;1471;3570;69;151;1306;3173;1375;3324
291100;201610;2620;6606;2059;5938;104;390;1620;4566;1724;4956
291110;201610;5164;17857;4562;16874;555;2293;3245;11725;3800;14018
291120;201610;7390;19662;6652;18480;763;2125;4787;13311;5550;15436
291125;201610;1977;3870;1488;3343;91;236;1201;2700;1292;2936
291130;201610;2905;8964;2347;7890;94;422;1775;5810;1869;6232
291140;201610;4239;12432;3468;10905;512;1456;2159;6890;2671;8346
291150;201610;2011;5074;1850;4873;79;252;1571;4050;1650;4302
291160;201610;5308;16442;4540;15086;801;2776;2522;8292;3323;11068
291165;201610;2592;7153;1925;5889;37;156;1428;4237;1465;4393
291170;201610;22364;57276;18146;50716;1731;5234;11785;32584;13516;37818
291180;201610;6317;16314;4976;14182;412;1195;3651;10460;4063;11655
291185;201610;3755;10050;3273;9279;165;482;2702;7577;2867;8059
291190;201610;7394;19673;6363;18144;407;1456;5243;14635;5650;16091
291200;201610;2946;8672;2251;7288;139;450;1498;4897;1637;5347
291210;201610;6996;16637;5707;15008;248;777;4458;11640;4706;12417
291220;201610;4296;13082;3842;12290;511;1858;2548;7922;3059;9780
291230;201610;4050;10091;3631;9612;91;171;3397;9124;3488;9295
291240;201610;4704;12558;3954;11176;125;390;3257;9029;3382;9419
291250;201610;3598;10852;2738;9184;255;842;1804;6129;2059;6971
291260;201610;1095;3138;984;2992;54;252;829;2416;883;2668
291270;201610;4607;14427;4005;13237;1294;4351;1913;6348;3207;10699
291280;201610;2123;6157;1666;5329;322;1122;835;2565;1157;3687
291290;201610;5712;15738;4791;14429;738;2173;2991;9153;3729;11326
291300;201610;4428;12383;3244;10286;199;699;2380;7421;2579;8120
291310;201610;5465;15308;4625;13739;270;818;3618;10683;3888;11501
291320;201610;6221;19107;4875;16375;1223;4067;2128;7304;3351;11371
291330;201610;1624;4838;1397;4430;95;334;1003;3121;1098;3455
291340;201610;3989;10845;3183;9643;141;405;2590;7814;2731;8219
291345;201610;3423;10681;3133;10301;208;637;2601;8748;2809;9385
291350;201610;5838;16853;4980;15356;266;877;3894;12099;4160;12976
291360;201610;34744;92566;29025;83960;7276;20995;15010;44480;22286;65475
291370;201610;8425;23684;7787;22799;642;1875;5944;17555;6586;19430
291380;201610;3774;11113;3177;10130;173;630;2445;7817;2618;8447
291390;201610;10446;27599;9446;26291;1079;2943;7243;20192;8322;23135
291400;201610;14029;38142;12032;34997;2291;6181;7495;22874;9786;29055
291410;201610;3366;8719;2383;7081;120;515;1764;5023;1884;5538
291420;201610;2122;5644;1768;5176;79;273;1494;4335;1573;4608
291430;201610;3318;9449;2844;8745;159;672;2267;6709;2426;7381
291440;201610;6828;20096;5560;17856;578;1888;4047;13097;4625;14985
291450;201610;8408;23963;7167;22157;280;811;5838;18782;6118;19593
291460;201610;13498;40240;11892;37596;1576;5356;7626;24170;9202;29526
291465;201610;8176;22925;7022;21523;417;1676;5768;17327;6185;19003
291470;201610;16357;42760;13994;39795;944;2552;10584;30982;11528;33534
291480;201610;36547;91283;28793;79688;4826;13816;15916;43787;20742;57603
291490;201610;4308;13557;3958;13019;594;1933;2715;9072;3309;11005
291500;201610;4416;12320;3575;10980;188;732;2886;8697;3074;9429
291510;201610;3759;11059;3345;10458;71;271;2948;9275;3019;9546
291520;201610;3924;10507;3227;9483;539;1621;2027;5917;2566;7538
291530;201610;2222;5922;1679;5089;404;1220;834;2695;1238;3915
291535;201610;3801;11436;3380;10748;216;704;2620;8392;2836;9096
291540;201610;2140;5014;1770;4629;122;220;1562;4214;1684;4434
291550;201610;5201;13477;4374;12266;764;1948;2635;7567;3399;9515
291560;201610;18997;44165;12838;36633;859;2450;9683;28435;10542;30885
291570;201610;2241;5830;1974;5479;167;323;1651;4785;1818;5108
291580;201610;5594;16565;4792;15321;455;1787;3463;10890;3918;12677
291590;201610;1789;5538;1583;5182;161;562;1180;3884;1341;4446
291600;201610;5216;14240;3805;11808;971;3156;1633;4909;2604;8065
291610;201610;4967;15553;4757;15296;132;429;4378;14214;4510;14643
291620;201610;3132;7189;2216;6152;142;424;1757;4929;1899;5353
291630;201610;3224;7656;2597;6900;243;610;2015;5461;2258;6071
291640;201610;17119;46079;12873;39228;3310;10435;3713;11752;7023;22187
291650;201610;8459;24221;7685;23231;630;1543;6343;19661;6973;21204
291660;201610;2210;5700;1689;4856;129;451;1111;2988;1240;3439
291670;201610;1897;5213;1676;4892;97;266;1337;3975;1434;4241
291680;201610;4123;11769;3479;10635;589;1915;2080;6342;2669;8257
291685;201610;4837;12063;3900;10792;582;1499;2586;7412;3168;8911
291690;201610;3935;10405;2943;8689;215;612;2065;6017;2280;6629
291700;201610;9276;28375;8107;26254;886;2781;5923;19445;6809;22226
291710;201610;5360;13763;4175;12107;293;884;3069;8816;3362;9700
291720;201610;4632;14727;3760;12816;324;1218;2667;8825;2991;10043
291730;201610;6289;18162;5590;17166;480;1525;4386;13631;4866;15156
291733;201610;2785;7772;2152;6814;209;710;1426;4530;1635;5240
291735;201610;3007;8167;2460;7334;110;387;2057;6081;2167;6468
291740;201610;3842;10851;3182;9870;205;707;2561;7900;2766;8607
291750;201610;22815;57877;17073;48639;3709;10681;8324;24325;12033;35006
291760;201610;11101;34826;9418;31747;3801;14132;2199;7275;6000;21407
291770;201610;7799;22241;6308;19407;875;2796;3905;11739;4780;14535
291780;201610;4546;13489;4183;12859;193;613;3540;10849;3733;11462
291790;201610;2754;8143;2558;7850;88;315;2177;6590;2265;6905
291800;201610;31125;83236;26491;76490;4007;11438;16643;49163;20650;60601
291810;201610;10936;28961;8977;26426;439;1439;7344;21506;7783;22945
291820;201610;3832;11189;3334;10399;183;649;2574;8041;2757;8690
291830;201610;4253;11093;3829;10448;324;901;3007;8238;3331;9139
291835;201610;6450;19772;4918;16799;1505;5322;2185;7591;3690;12913
291840;201610;48982;135530;41914;126670;6347;18660;28514;88814;34861;107474
291845;201610;2643;7541;2447;7287;138;338;2194;6703;2332;7041
291850;201610;4628;13098;3722;11605;362;973;2705;8772;3067;9745
291855;201610;1859;4452;1573;4069;127;435;1225;3043;1352;3478
291860;201610;2192;6071;1569;4751;269;915;874;2457;1143;3372
291870;201610;1431;3811;955;2900;69;258;622;1794;691;2052
291875;201610;2877;8897;2528;8310;99;379;1805;5798;1904;6177
291880;201610;4995;15837;4459;14693;509;1662;3152;10394;3661;12056
291890;201610;1335;3360;1034;2946;205;507;681;2010;886;2517
291900;201610;1298;3401;1006;2907;56;191;760;2149;816;2340
291905;201610;2748;7365;1965;5867;100;335;1470;4235;1570;4570
291910;201610;2812;7457;2312;6833;111;408;1973;5786;2084;6194
291915;201610;7149;21566;5810;19081;528;1833;4232;13937;4760;15770
291920;201610;26142;76384;23511;72367;3278;10749;15080;46187;18358;56936
291930;201610;2659;7730;2278;7062;188;672;1633;4928;1821;5600
291940;201610;3440;9562;2417;7675;318;1064;1401;4318;1719;5382
291950;201610;8990;29309;7838;27009;1421;4894;4289;15188;5710;20082
291955;201610;11377;32016;10219;30372;2513;7469;5298;16572;7811;24041
291960;201610;3202;9184;2548;8165;225;712;1863;6180;2088;6892
291970;201610;3996;12009;3616;11338;345;1204;2439;7666;2784;8870
291980;201610;12168;33983;9101;29412;1016;3287;6060;19952;7076;23239
291990;201610;2220;6630;2015;6362;78;259;1731;5576;1809;5835
291992;201610;2956;8846;2861;8665;416;1199;2122;6484;2538;7683
291995;201610;2127;5977;1790;5481;80;308;1493;4481;1573;4789
292000;201610;2479;6820;2126;6275;182;589;1532;4567;1714;5156
292010;201610;6587;16108;5022;13825;519;1305;3619;10276;4138;11581
292020;201610;4150;13897;3814;13286;502;1881;2773;9554;3275;11435
292030;201610;1979;6176;1709;5717;314;1072;846;2753;1160;3825
292040;201610;4532;11877;3770;11023;206;402;3239;9925;3445;10327
292045;201610;3235;9918;2886;9425;123;356;2607;8551;2730;8907
292050;201610;6493;19476;5206;16752;540;1898;3306;10453;3846;12351
292060;201610;13040;31926;11817;30311;881;2010;9800;25041;10681;27051
292070;201610;4878;14670;4473;14134;512;1469;3579;11512;4091;12981
292080;201610;3642;9222;2919;8287;204;619;2439;6941;2643;7560
292090;201610;4086;10333;3378;9474;256;867;2768;7732;3024;8599
292100;201610;11545;30492;9527;27510;2193;6529;4691;13942;6884;20471
292105;201610;3113;9343;2721;8686;102;434;2209;6998;2311;7432
292110;201610;6594;17403;4871;14517;1488;4357;2024;6162;3512;10519
292120;201610;7603;21062;6154;18295;1147;3323;3402;10355;4549;13678
292130;201610;2937;7993;2460;7279;365;981;1586;4875;1951;5856
292140;201610;5090;13158;4085;11639;655;1696;2760;8064;3415;9760
292145;201610;2417;7297;2077;6700;237;725;1442;4801;1679;5526
292150;201610;12889;38438;11729;36523;387;1463;9834;30417;10221;31880
292160;201610;2527;7148;2131;6613;89;359;1864;5699;1953;6058
292170;201610;8938;25085;7136;21876;903;2944;4528;13840;5431;16784
292180;201610;3072;8738;2302;7356;469;1417;1213;4003;1682;5420
292190;201610;3354;9378;2695;8259;503;1639;1467;4479;1970;6118
292200;201610;6940;20896;5675;18557;1620;5550;2041;6720;3661;12270
292205;201610;3928;11627;3419;10804;167;677;2794;8611;2961;9288
292210;201610;6599;17053;5435;15467;257;855;4594;12988;4851;13843
292220;201610;1883;5080;1642;4688;413;1114;846;2424;1259;3538
292225;201610;3278;10014;2922;9442;164;687;2399;7655;2563;8342
292230;201610;6958;19275;6385;18308;251;1031;5185;14313;5436;15344
292240;201610;4836;14457;4097;12859;388;1197;2868;8917;3256;10114
292250;201610;5244;15893;4750;14953;1011;3237;2442;7776;3453;11013
292260;201610;3249;9351;2955;8923;190;535;2464;7508;2654;8043
292265;201610;3229;9623;2701;8683;115;513;2076;6473;2191;6986
292270;201610;4199;10398;3365;9414;187;541;2817;7930;3004;8471
292273;201610;2822;6375;2092;5447;158;348;1608;4357;1766;4705
292275;201610;1617;4392;1409;4079;173;439;1045;3149;1218;3588
292280;201610;2277;6134;1942;5722;192;465;1484;4631;1676;5096
292285;201610;2535;6721;2023;5953;95;341;1605;4673;1700;5014
292290;201610;7078;20932;5801;19139;357;1448;4477;14811;4834;16259
292300;201610;8512;24967;7195;23226;2031;6828;3590;11836;5621;18664
292303;201610;2953;8770;2603;8251;82;321;2237;7010;2319;7331
292305;201610;2931;7874;2729;7569;56;226;2485;6797;2541;7023
292310;201610;5968;17403;5407;16532;153;574;4465;13502;4618;14076
292320;201610;6879;18796;5631;16602;422;1278;4297;12550;4719;13828
292330;201610;2283;5911;2042;5566;158;477;1647;4440;1805;4917
292335;201610;5244;13604;4575;12655;373;976;3704;10361;4077;11337
292340;201610;6575;18044;5405;16051;344;1021;4094;12069;4438;13090
292350;201610;2368;6808;1993;6254;122;465;1618;5049;1740;5514
292360;201610;5355;13660;4874;12809;238;520;4001;10873;4239;11393
292370;201610;8686;24079;7495;22394;651;1602;5979;18195;6630;19797
292380;201610;7378;21461;6569;20094;716;1970;4938;15301;5654;17271
292390;201610;3638;7976;2883;7109;498;655;2212;6018;2710;6673
292400;201610;21156;64034;19116;60460;2952;9337;12544;39654;15496;48991
292405;201610;4642;11329;3653;9980;204;459;2938;8093;3142;8552
292410;201610;2034;5331;1828;5061;146;365;1523;4251;1669;4616
292420;201610;3817;12137;3553;11715;233;986;2853;9283;3086;10269
292430;201610;5603;16223;4034;13843;351;1288;2642;9073;2993;10361
292440;201610;8633;28083;7895;26972;161;687;7182;24686;7343;25373
292450;201610;4071;12046;3232;10562;317;1051;2248;7371;2565;8422
292460;201610;4990;14695;4141;13175;479;1597;2761;8753;3240;10350
292465;201610;2467;7244;1983;6398;186;647;1280;4176;1466;4823
292467;201610;1907;6010;1794;5831;330;1097;1145;3824;1475;4921
292470;201610;2993;7819;2381;6768;112;319;1877;5323;1989;5642
292480;201610;6465;16509;5304;14926;127;444;4814;13427;4941;13871
292490;201610;2448;6569;1952;5807;141;445;1465;4333;1606;4778
292500;201610;6671;19500;5542;17439;660;2105;3653;11582;4313;13687
292510;201610;12920;36574;10653;32946;863;2994;7912;24440;8775;27434
292520;201610;5771;16105;4835;14598;1023;3102;2686;8184;3709;11286
292525;201610;5470;14021;4603;12984;140;430;3949;11178;4089;11608
292530;201610;27771;78226;23613;72049;6045;18640;11338;35577;17383;54217
292540;201610;3026;7985;2620;7465;297;843;2007;5752;2304;6595
292550;201610;6771;20429;5644;18852;646;2291;4191;14202;4837;16493
292560;201610;4139;11372;3518;10406;193;731;2717;7860;2910;8591
292570;201610;4335;11901;3872;11341;109;314;3555;10571;3664;10885
292575;201610;6562;21148;6270;20670;412;1332;5265;17538;5677;18870
292580;201610;6803;20019;6255;19198;302;1009;5343;16345;5645;17354
292590;201610;7682;21729;7084;20804;381;1160;6029;17476;6410;18636
292593;201610;3086;7865;2488;6890;338;881;1724;4741;2062;5622
292595;201610;5943;16171;5142;15081;306;948;4102;12007;4408;12955
292600;201610;10922;30534;9544;28576;882;2119;7371;22784;8253;24903
292610;201610;4782;13046;3772;11348;263;773;2407;7535;2670;8308
292620;201610;6353;18641;5499;17627;115;376;5110;16527;5225;16903
292630;201610;9450;23656;7585;20655;905;2295;5101;14222;6006;16517
292640;201610;7871;25085;7092;23740;381;1409;5435;18288;5816;19697
292650;201610;4765;12571;4420;12119;363;882;3674;10119;4037;11001
292660;201610;11039;32478;9943;30809;1087;3384;7384;23105;8471;26489
292665;201610;2378;7382;2221;7166;36;94;2042;6664;2078;6758
292670;201610;3802;10506;2834;8698;318;1016;1723;5286;2041;6302
292680;201610;3770;10913;3250;9938;373;1071;2317;7037;2690;8108
292690;201610;2910;7780;2034;6340;168;481;1372;4407;1540;4888
292700;201610;9619;28006;8188;25809;1262;3558;5121;17100;6383;20658
292710;201610;2167;7059;2019;6856;72;264;1766;6020;1838;6284
292720;201610;9508;23824;8082;22177;286;903;6937;19265;7223;20168
292730;201610;3715;10906;3502;10550;219;663;2824;8511;3043;9174
292740;201610;340547;900846;309722;849927;57345;164170;185104;499798;242449;663968
292750;201610;6695;17749;5550;16028;270;840;4474;12914;4744;13754
292760;201610;4120;12551;3583;11540;397;1348;2456;7876;2853;9224
292770;201610;6174;17775;5259;16365;948;3086;3134;9957;4082;13043
292780;201610;1923;4361;1417;3693;139;304;1016;2677;1155;2981
292790;201610;3442;8188;3290;8028;60;97;3174;7823;3234;7920
292800;201610;9467;27290;8510;25609;553;1727;6743;20184;7296;21911
292805;201610;3064;8491;2605;7803;256;793;1946;5822;2202;6615
292810;201610;9703;28188;7584;24917;895;2942;5145;17165;6040;20107
292820;201610;7566;21123;5449;17914;353;1389;4256;13807;4609;15196
292830;201610;1763;5150;1559;4832;60;252;1343;4102;1403;4354
292840;201610;8309;24286;7724;23438;311;1110;6845;20506;7156;21616
292850;201610;3157;8331;2464;7197;271;789;1604;4597;1875;5386
292860;201610;15711;39537;14091;37299;1048;2803;11192;29461;12240;32264
292870;201610;19514;52964;16425;47731;1898;6119;9769;27630;11667;33749
292880;201610;12906;35849;11123;33119;816;2842;8081;23352;8897;26194
292890;201610;5608;18328;4902;17000;603;2186;3267;11354;3870;13540
292895;201610;2908;6915;2133;5692;246;638;1464;3898;1710;4536
292900;201610;2833;8545;2647;8227;145;635;2025;6030;2170;6665
292905;201610;4137;12024;3185;10432;344;1066;2149;7141;2493;8207
292910;201610;5086;14828;4435;13600;591;1828;2665;8157;3256;9985
292920;201610;9520;27335;8925;26421;438;1593;7523;21684;7961;23277
292925;201610;5250;15554;4650;14632;318;1008;3648;11506;3966;12514
292930;201610;6613;20822;5971;19555;410;1763;4256;13454;4666;15217
292935;201610;2049;5910;1691;5498;78;263;1451;4866;1529;5129
292937;201610;3319;8298;2718;7524;170;470;2209;6141;2379;6611
292940;201610;3364;8941;2595;7843;234;718;1838;5707;2072;6425
292950;201610;8322;23957;7527;22513;443;1606;5680;16550;6123;18156
292960;201610;5389;13590;4531;12373;258;748;3449;9288;3707;10036
292970;201610;4392;12790;3760;11897;143;658;3097;9691;3240;10349
292975;201610;3674;9457;3361;9033;357;851;2798;7638;3155;8489
292980;201610;3365;8620;2544;7399;196;638;1886;5374;2082;6012
292990;201610;12189;33912;10182;30716;434;1384;8353;25000;8787;26384
293000;201610;2914;7353;2568;6884;48;157;2035;5743;2083;5900
293010;201610;18229;49926;14883;44140;2383;7146;8713;25679;11096;32825
293015;201610;7710;25810;6494;23310;719;2928;4254;15096;4973;18024
293020;201610;9249;30117;8592;29132;269;1195;7487;25197;7756;26392
293030;201610;5730;16030;4238;13540;464;1392;2802;9336;3266;10728
293040;201610;3851;12246;3629;11819;212;665;3161;10347;3373;11012
293050;201610;21127;57043;17936;52554;3368;9835;9531;29158;12899;38993
293060;201610;3676;9765;2950;8516;226;700;2169;6167;2395;6867
293070;201610;25037;66464;19466;57985;4601;13562;8749;27259;13350;40821
293075;201610;3300;11024;2993;10532;189;824;2378;8364;2567;9188
293076;201610;3790;10286;3328;9627;165;430;2762;8166;2927;8596
293077;201610;5100;15532;4367;14412;831;2822;2617;8820;3448;11642
293080;201610;4678;14526;4124;13582;171;833;3394;10911;3565;11744
293090;201610;3340;10449;2670;9367;229;822;1925;6878;2154;7700
293100;201610;5943;17158;4769;15017;546;1729;3349;10637;3895;12366
293105;201610;4070;13157;3473;11976;470;1629;2259;7894;2729;9523
293110;201610;2085;5776;1778;5305;80;252;1447;4319;1527;4571
293120;201610;3844;12322;3597;11910;259;833;2883;9647;3142;10480
293130;201610;4120;11393;3440;10608;134;484;3048;9457;3182;9941
293135;201610;31104;78054;22222;64497;5217;16348;7993;23085;13210;39433
293140;201610;2003;5521;1854;5277;124;444;1509;4141;1633;4585
293150;201610;5550;18009;4593;16068;677;2413;2846;10115;3523;12528
293160;201610;3860;9814;3376;9194;471;948;2545;7396;3016;8344
293170;201610;3467;9906;3077;9289;262;871;2229;6771;2491;7642
293180;201610;5424;14910;4223;12931;148;605;3347;9978;3495;10583
293190;201610;13923;41318;12483;39024;489;2111;10555;32295;11044;34406
293200;201610;7354;19915;6204;18313;185;657;4941;14636;5126;15293
293210;201610;5182;14560;4426;13229;302;941;3377;10021;3679;10962
293220;201610;5080;14802;4081;12883;1086;3373;1458;4742;2544;8115
293230;201610;3841;11443;3353;10630;455;1643;2271;7067;2726;8710
293240;201610;4441;12082;3431;10324;131;380;2587;7795;2718;8175
293245;201610;4368;12169;3812;11318;221;654;3060;9104;3281;9758
293250;201610;5751;15442;5029;14300;514;1464;3560;10069;4074;11533
293260;201610;4643;13480;3787;12159;249;813;2759;8858;3008;9671
293270;201610;5808;14926;5148;14164;331;814;4464;12431;4795;13245
293280;201610;5466;14731;4457;13252;288;748;3466;10465;3754;11213
293290;201610;14689;48166;13249;45269;3370;11666;5706;20103;9076;31769
293300;201610;7073;16447;5797;14874;401;948;4385;11430;4786;12378
293305;201610;4913;12085;4020;10817;131;403;3372;9001;3503;9404
293310;201610;2545;6554;1968;5531;207;585;1309;3626;1516;4211
293315;201610;4387;10930;3631;9744;355;786;2726;7472;3081;8258
293317;201610;2523;7092;2176;6423;173;489;1571;4622;1744;5111
293320;201610;7839;25273;7507;24798;1150;3753;5368;18082;6518;21835
293325;201610;1860;5220;1486;4592;197;684;966;2931;1163;3615
293330;201610;51342;163578;44861;151277;10038;35414;20389;69174;30427;104588
293340;201610;2690;7570;2051;6421;261;838;1190;3736;1451;4574
293345;201610;3400;9942;2900;9237;257;644;2229;7455;2486;8099
293350;201610;6630;19297;6198;18773;208;435;5653;17641;5861;18076
293360;201610;13475;39592;12033;37697;686;2411;10502;32794;11188;35205
310010;201610;929;2489;685;2079;111;397;302;838;413;1235
310020;201610;2901;8970;2259;7635;512;1878;300;929;812;2807
310030;201610;2378;7257;1896;6393;396;1450;1016;3363;1412;4813
310040;201610;994;2619;796;2324;65;225;609;1722;674;1947
310050;201610;1885;6334;1691;5904;328;1297;746;2503;1074;3800
310060;201610;3317;10011;2839;9356;258;1019;2254;7333;2512;8352
310070;201610;352;970;248;775;13;60;164;466;177;526
310080;201610;745;2186;580;1879;100;397;215;647;315;1044
310090;201610;4675;13638;3865;12171;478;1605;2518;7878;2996;9483
310100;201610;3527;10474;2884;9388;154;606;2276;7338;2430;7944
310110;201610;4909;13707;3961;11959;638;2117;2116;6121;2754;8238
310120;201610;643;1908;462;1541;122;496;171;445;293;941
310130;201610;404;1223;346;1118;90;352;168;466;258;818
310140;201610;215;700;168;619;54;236;46;137;100;373
310150;201610;4815;14486;3899;12593;943;3278;1273;3924;2216;7202
310160;201610;6502;20628;5043;17474;1609;5893;632;2074;2241;7967
310163;201610;1066;3384;857;2940;297;1063;211;680;508;1743
310170;201610;9264;25503;8025;23643;1002;3100;5548;16434;6550;19534
310180;201610;1731;4882;1438;4401;236;798;818;2395;1054;3193
310190;201610;2854;9299;2376;8323;648;2469;411;1394;1059;3863
310200;201610;1839;5930;1507;5219;303;1154;504;1707;807;2861
310205;201610;1140;3231;833;2724;139;452;444;1487;583;1939
310210;201610;2797;7828;2327;7093;191;569;1741;5263;1932;5832
310220;201610;1065;3152;921;2916;147;527;568;1732;715;2259
310230;201610;2595;7829;2079;6662;287;1065;1174;3531;1461;4596
310240;201610;926;3296;803;3023;114;474;457;1715;571;2189
310250;201610;813;2645;766;2553;133;551;461;1410;594;1961
310260;201610;3211;10052;2239;7890;558;2211;374;1101;932;3312
310270;201610;2627;7213;2044;6331;170;670;1594;4807;1764;5477
310280;201610;2373;6131;1813;5198;337;1097;949;2575;1286;3672
310285;201610;2035;7094;1841;6768;204;859;1342;5003;1546;5862
310290;201610;1149;3438;1049;3253;258;901;540;1505;798;2406
310300;201610;1727;5728;1598;5468;384;1493;766;2476;1150;3969
310310;201610;371;1008;254;782;38;107;120;385;158;492
310320;201610;402;1253;314;1078;40;192;159;501;199;693
310330;201610;526;1304;317;894;32;98;134;332;166;430
310340;201610;8457;24738;6608;21367;1506;4842;2907;9791;4413;14633
310350;201610;14067;36917;9384;28654;2454;8086;2311;6722;4765;14808
310360;201610;453;1300;407;1229;22;84;305;878;327;962
310370;201610;1421;4710;1227;4315;369;1307;503;1791;872;3098
310375;201610;1242;3355;753;2424;121;406;286;907;407;1313
310380;201610;385;995;212;671;65;215;70;197;135;412
310390;201610;460;1582;371;1373;79;309;76;244;155;553
310400;201610;10523;28651;7306;22894;1758;5911;1972;6009;3730;11920
310410;201610;750;2442;497;1961;101;423;95;370;196;793
310420;201610;5677;15737;3307;10557;644;2196;491;1322;1135;3518
310430;201610;1349;4295;913;3333;216;858;145;492;361;1350
310440;201610;572;1630;407;1313;68;248;162;511;230;759
310445;201610;1251;4040;1001;3548;121;465;654;2299;775;2764
310450;201610;4643;12751;3565;11066;339;1062;2478;7755;2817;8817
310460;201610;1612;4718;1250;4116;338;1190;318;1114;656;2304
310470;201610;4107;9139;3450;8341;256;563;2951;7241;3207;7804
310480;201610;1258;3607;907;2890;200;620;387;1182;587;1802
310490;201610;3029;9583;2400;8244;613;2439;935;2977;1548;5416
310500;201610;1333;4432;1128;3961;264;1007;436;1476;700;2483
310510;201610;2081;6485;1513;5168;373;1363;242;810;615;2173
310520;201610;1442;3656;1042;3013;79;217;726;2075;805;2292
310530;201610;995;2951;461;1604;61;241;62;176;123;417
310540;201610;3155;10008;2704;9110;727;2532;1098;3619;1825;6151
310550;201610;1226;3386;952;2930;161;604;540;1554;701;2158
310560;201610;15790;47278;12570;40727;3381;11976;3630;10785;7011;22761
310570;201610;1185;3462;980;3092;145;581;648;1943;793;2524
310590;201610;4402;12643;3433;10733;535;1787;1689;5130;2224;6917
310600;201610;1434;4645;1205;4104;262;993;500;1588;762;2581
310610;201610;471;1565;398;1396;89;383;123;368;212;751
310620;201610;147206;444153;119871;388286;28103;100262;43081;126523;71184;226785
310630;201610;4315;12823;3782;11830;333;1161;2798;8605;3131;9766
310640;201610;1292;3913;986;3323;285;1075;253;776;538;1851
310650;201610;2689;8289;2013;7017;337;1209;1098;3807;1435;5016
310660;201610;1357;4065;1181;3826;116;398;861;2758;977;3156
310665;201610;1290;3777;1130;3542;78;252;920;2951;998;3203
310670;201610;41592;125950;35341;112305;8728;29089;13220;40457;21948;69546
310680;201610;694;1931;596;1773;85;284;412;1189;497;1473
310690;201610;1443;4547;1122;3957;215;888;438;1435;653;2323
310700;201610;545;1319;414;1146;64;213;264;700;328;913
310710;201610;6403;20445;4531;16947;883;3830;554;1827;1437;5657
310720;201610;814;2394;715;2229;65;239;523;1600;588;1839
310730;201610;9470;28892;8151;26506;1361;4764;4683;15008;6044;19772
310740;201610;5176;16201;3747;13077;898;3291;825;2709;1723;6000
310750;201610;1491;3686;1032;3010;201;609;459;1229;660;1838
310760;201610;607;1801;472;1544;81;284;192;619;273;903
310770;201610;933;2910;691;2473;137;548;309;1040;446;1588
310780;201610;3872;10445;3109;9080;417;1220;2054;5909;2471;7129
310790;201610;1991;6331;1727;5791;476;1632;724;2519;1200;4151
310800;201610;2858;8916;2033;7179;588;2366;145;442;733;2808
310810;201610;1172;3267;1002;2934;166;554;563;1531;729;2085
310820;201610;1331;3775;868;2822;211;731;209;649;420;1380
310825;201610;2577;8521;1976;7430;120;655;1435;5259;1555;5914
310830;201610;1378;4404;1051;3730;286;1074;345;1174;631;2248
310840;201610;2195;6533;1536;5229;322;1158;403;1251;725;2409
310850;201610;1546;4501;1291;4154;127;471;943;3002;1070;3473
310855;201610;3018;9250;2523;8448;392;1431;1640;5466;2032;6897
310860;201610;7486;22665;6025;19845;746;2541;3533;11752;4279;14293
310870;201610;1080;2871;836;2466;139;425;494;1459;633;1884
310880;201610;1078;3305;818;2770;138;508;424;1416;562;1924
310890;201610;2679;7981;1911;6571;467;1763;391;1168;858;2931
310900;201610;4239;13153;3127;10709;690;2638;1139;3559;1829;6197
310910;201610;1937;5429;1120;3724;191;712;144;381;335;1093
310920;201610;1906;5483;1446;4714;321;1148;647;2052;968;3200
310925;201610;958;3039;831;2806;286;1034;329;1070;615;2104
310930;201610;6266;17338;4783;15009;716;2405;2889;9181;3605;11586
310940;201610;6248;17157;5015;15175;735;2326;3041;9044;3776;11370
310945;201610;1175;3393;1005;3115;140;483;600;1789;740;2272
310950;201610;2155;6667;1462;5115;338;1384;507;1646;845;3030
310960;201610;407;1283;327;1127;85;317;132;466;217;783
310970;201610;1459;4739;988;3618;221;892;147;452;368;1344
310980;201610;445;1073;263;761;37;123;132;337;169;460
310990;201610;1192;3789;906;3122;205;780;289;879;494;1659
311000;201610;3589;11999;3133;11045;1024;3840;920;3014;1944;6854
311010;201610;740;2450;664;2286;231;853;263;900;494;1753
311020;201610;982;2810;709;2306;114;423;367;1115;481;1538
311030;201610;1705;4592;1090;3423;285;1015;333;916;618;1931
311040;201610;463;1541;377;1330;87;304;86;289;173;593
311050;201610;2308;6954;1898;6259;468;1702;824;2674;1292;4376
311060;201610;2561;7431;1736;5614;317;1150;585;1723;902;2873
311070;201610;1434;4816;1194;4319;263;1070;488;1716;751;2786
311080;201610;821;2507;674;2208;149;541;255;771;404;1312
311090;201610;1700;6114;1382;5451;437;1857;420;1560;857;3417
311100;201610;2097;6924;1570;5743;516;2041;196;682;712;2723
311110;201610;3559;8450;2442;6817;435;1282;1182;3278;1617;4560
311115;201610;1253;3580;1029;3235;93;371;700;2149;793;2520
311120;201610;7994;22197;5707;17848;1257;4344;1623;4597;2880;8941
311130;201610;2122;6381;1641;5557;297;1198;695;2200;992;3398
311140;201610;1377;3586;1002;3027;82;284;655;1962;737;2246
311150;201610;1765;6044;1588;5720;253;998;984;3515;1237;4513
311160;201610;4032;13317;3153;11623;1081;4344;698;2530;1779;6874
311170;201610;811;2406;611;2012;99;335;268;917;367;1252
311180;201610;1163;3347;868;2759;259;857;211;644;470;1501
311190;201610;1113;3118;780;2441;179;625;203;580;382;1205
311200;201610;2002;6022;1487;4922;403;1442;249;730;652;2172
311205;201610;1019;3319;835;2920;123;506;393;1354;516;1860
311210;201610;1015;3179;921;3047;144;475;656;2222;800;2697
311220;201610;871;2686;679;2263;151;543;236;744;387;1287
311230;201610;8401;26342;6087;21258;1320;4856;1984;7080;3304;11936
311240;201610;1059;3170;798;2714;206;764;266;879;472;1643
311250;201610;805;2570;694;2377;219;797;196;597;415;1394
311260;201610;2438;6410;1701;5113;401;1308;602;1755;1003;3063
311265;201610;1258;3485;970;2997;172;580;533;1646;705;2226
311270;201610;3437;10721;2956;9994;264;1265;2083;6725;2347;7990
311280;201610;1294;3581;740;2380;147;547;187;578;334;1125
311290;201610;2019;6593;1825;6123;354;1183;1058;3582;1412;4765
311300;201610;4473;14457;3888;13371;368;1582;2831;9514;3199;11096
311310;201610;591;1925;467;1649;112;391;133;412;245;803
311320;201610;3832;12624;3276;11316;606;2321;1196;3839;1802;6160
311330;201610;4675;13735;3811;12137;991;3425;1614;5031;2605;8456
311340;201610;12118;37437;10028;33131;2996;10507;2384;7688;5380;18195
311350;201610;2334;6453;1684;5143;246;878;791;2144;1037;3022
311360;201610;1119;3077;848;2703;389;1285;121;407;510;1692
311370;201610;3747;11123;2944;9569;644;2452;1152;3312;1796;5764
311380;201610;441;1460;352;1243;97;379;109;374;206;753
311390;201610;1809;6428;1593;6077;670;2895;404;1366;1074;4261
311400;201610;1504;4664;1153;3945;210;833;473;1445;683;2278
311410;201610;1823;6107;1603;5795;420;1695;768;2790;1188;4485
311420;201610;1912;6151;1184;4286;222;879;123;320;345;1199
311430;201610;3891;11540;2544;8509;499;1777;363;1152;862;2929
311440;201610;2483;7813;1696;6251;531;2215;274;976;805;3191
311450;201610;1953;6686;1543;5713;427;1749;289;962;716;2711
311455;201610;1139;3027;863;2537;216;667;355;936;571;1603
311460;201610;643;2051;455;1639;86;358;106;346;192;704
311470;201610;481;1586;364;1319;100;421;64;188;164;609
311480;201610;804;2105;736;2005;163;437;467;1266;630;1703
311490;201610;222;821;190;725;55;234;69;233;124;467
311500;201610;456;1320;348;1116;80;304;150;459;230;763
311510;201610;3059;9209;2217;7563;693;2719;464;1456;1157;4175
311520;201610;622;1993;557;1846;183;673;224;696;407;1369
311530;201610;11740;29901;7849;23261;2018;6888;1835;5121;3853;12009
311535;201610;813;2324;472;1622;124;481;77;231;201;712
311540;201610;624;2128;560;2003;185;651;237;842;422;1493
311545;201610;2141;6393;1871;6047;173;631;1352;4293;1525;4924
311547;201610;1514;4166;1219;3671;70;205;847;2539;917;2744
311550;201610;2948;9163;2280;7722;414;1554;844;2757;1258;4311
311560;201610;270;703;219;631;28;84;131;355;159;439
311570;201610;2021;5112;1520;4407;86;262;1213;3604;1299;3866
311580;201610;2483;4905;1763;4036;434;899;974;2396;1408;3295
311590;201610;474;1441;387;1288;94;361;167;541;261;902
311600;201610;1240;3717;1025;3409;272;916;545;1841;817;2757
311610;201610;2889;9944;2477;9121;819;2915;926;3622;1745;6537
311615;201610;3188;9715;2559;8642;227;904;1830;6082;2057;6986
311620;201610;426;1282;365;1176;57;207;228;718;285;925
311630;201610;1384;3984;1096;3446;206;637;666;2072;872;2709
311640;201610;763;2439;605;2156;134;503;273;958;407;1461
311650;201610;2288;6358;1876;5657;213;708;1150;3447;1363;4155
311660;201610;2652;8391;1811;6482;365;1333;207;628;572;1961
311670;201610;1703;4821;1289;4108;389;1342;402;1236;791;2578
311680;201610;2115;6520;1705;5774;363;1275;917;3101;1280;4376
311690;201610;521;1290;432;1179;28;79;363;1001;391;1080
311700;201610;2324;5931;1747;5105;98;313;1385;3966;1483;4279
311710;201610;1675;5055;1169;4032;432;1660;269;867;701;2527
311720;201610;401;1316;336;1170;88;319;117;392;205;711
311730;201610;6053;14944;3160;9742;995;3473;607;1440;1602;4913
311740;201610;821;2463;781;2411;156;475;567;1773;723;2248
311750;201610;4115;13062;3407;11798;574;2243;1846;6167;2420;8410
311760;201610;717;2369;597;2051;128;482;148;422;276;904
311770;201610;2265;7085;1798;6133;414;1552;541;1733;955;3285
311780;201610;1215;4171;937;3517;255;1085;200;647;455;1732
311783;201610;2030;6400;1618;5561;61;293;1251;4191;1312;4484
311787;201610;596;2003;413;1461;79;304;110;330;189;634
311790;201610;1575;4612;1129;3730;263;1003;382;1200;645;2203
311800;201610;4814;15911;3649;12788;809;3087;438;1362;1247;4449
311810;201610;1058;3414;876;3033;71;333;564;1890;635;2223
311820;201610;640;1929;509;1621;123;448;259;752;382;1200
311830;201610;8482;27619;6312;22267;1838;6975;670;2155;2508;9130
311840;201610;3014;8926;2648;8336;625;2179;1358;4169;1983;6348
311850;201610;282;873;237;785;38;137;131;423;169;560
311860;201610;51067;147640;41568;129995;7732;26058;21381;64255;29113;90313
311870;201610;2148;6221;1469;4799;274;1009;478;1420;752;2429
311880;201610;6856;19288;5901;17980;686;1943;4228;13313;4914;15256
311890;201610;1489;4331;1154;3677;262;903;508;1560;770;2463
311900;201610;750;2221;608;1972;80;292;352;1139;432;1431
311910;201610;4368;12442;3429;10991;794;2674;1427;4511;2221;7185
311920;201610;1901;6139;1608;5574;182;690;975;3342;1157;4032
311930;201610;3590;10043;2888;8838;1172;3679;681;2034;1853;5713
311940;201610;12847;37898;9499;30679;2150;7367;2658;7945;4808;15312
311950;201610;2236;6472;1747;5672;154;592;1234;3908;1388;4500
311960;201610;392;1196;334;1065;65;258;157;413;222;671
311970;201610;378;1265;275;1014;54;224;67;235;121;459
311980;201610;600;1668;380;1244;62;217;134;441;196;658
311990;201610;453;1287;350;1110;113;385;127;381;240;766
311995;201610;1195;3609;617;2136;39;150;62;143;101;293
312000;201610;611;1818;538;1705;59;200;346;1109;405;1309
312010;201610;933;3016;751;2594;112;423;324;1090;436;1513
312015;201610;1398;4424;1213;4067;140;535;792;2606;932;3141
312020;201610;1107;3469;952;3203;213;757;420;1388;633;2145
312030;201610;1850;5215;1631;4931;102;389;1383;4105;1485;4494
312040;201610;753;2678;580;2212;122;498;134;487;256;985
312050;201610;1235;4295;1013;3730;242;985;156;500;398;1485
312060;201610;761;2280;634;2067;185;635;278;868;463;1503
312070;201610;1050;3187;644;2268;141;547;246;821;387;1368
312080;201610;2715;7364;2079;6301;272;1002;1169;3258;1441;4260
312083;201610;933;2570;783;2351;77;257;589;1744;666;2001
312087;201610;2185;6469;1910;6036;192;665;1456;4640;1648;5305
312090;201610;9147;27628;7335;24220;2053;7041;2714;8744;4767;15785
312100;201610;1473;4657;1052;3868;240;976;438;1508;678;2484
312110;201610;1046;3608;872;3194;243;1013;166;532;409;1545
312120;201610;730;2355;587;2044;131;537;211;641;342;1178
312125;201610;1121;3557;971;3267;208;674;553;1950;761;2624
312130;201610;886;2475;630;1935;85;292;247;701;332;993
312140;201610;825;2608;672;2220;167;593;193;560;360;1153
312150;201610;491;1425;416;1265;35;129;254;720;289;849
312160;201610;7560;24966;6369;22299;1527;5779;2375;7983;3902;13762
312170;201610;920;2605;748;2298;68;213;465;1409;533;1622
312180;201610;1382;4192;1137;3664;230;811;480;1440;710;2251
312190;201610;604;1928;427;1544;143;562;63;231;206;793
312200;201610;4837;13651;3900;12042;732;2232;2199;6837;2931;9069
312210;201610;1120;2941;823;2472;177;613;437;1211;614;1824
312220;201610;1933;6437;1758;6223;173;497;1473;5463;1646;5960
312230;201610;12747;38724;9251;31585;2970;11102;1125;3557;4095;14659
312235;201610;1604;4713;1388;4391;146;545;1000;3121;1146;3666
312240;201610;933;3098;719;2622;171;683;173;598;344;1281
312245;201610;2203;6427;1925;6040;85;306;1589;4945;1674;5251
312247;201610;804;2356;595;1985;168;580;239;813;407;1393
312250;201610;1193;3246;862;2667;146;521;351;1000;497;1521
312260;201610;897;2795;713;2465;111;424;436;1440;547;1864
312270;201610;650;1914;487;1568;56;230;261;757;317;987
312280;201610;421;1381;366;1256;131;474;45;147;176;621
312290;201610;789;2584;692;2395;168;675;225;749;393;1424
312300;201610;894;2938;659;2345;164;633;60;159;224;792
312310;201610;874;3198;783;2981;206;874;313;1140;519;2014
312320;201610;2043;5747;1477;4623;412;1400;307;827;719;2227
312330;201610;1001;2895;803;2594;142;535;555;1747;697;2282
312340;201610;317;855;256;747;38;134;153;397;191;531
312350;201610;293;738;255;694;24;84;210;545;234;629
312352;201610;1653;5116;1464;4824;281;961;946;3208;1227;4169
312360;201610;3128;9836;2445;8372;550;2021;708;2391;1258;4412
312370;201610;1749;5316;1486;4846;422;1555;570;1723;992;3278
312380;201610;1939;5256;1695;4913;62;175;1451;4300;1513;4475
312385;201610;1337;3850;1118;3485;85;337;805;2425;890;2762
312390;201610;2106;6660;1534;5415;398;1468;321;1030;719;2498
312400;201610;3183;10018;2508;8573;972;3430;520;1820;1492;5250
312410;201610;10227;32825;8706;29665;1855;6666;3755;12481;5610;19147
312420;201610;3942;11941;3625;11444;617;1914;2363;7588;2980;9502
312430;201610;8140;23445;6719;20813;940;2892;4339;13485;5279;16377
312440;201610;786;2450;617;2119;240;891;190;681;430;1572
312450;201610;1132;3689;840;3062;267;1015;267;997;534;2012
312460;201610;361;1074;307;994;71;264;155;500;226;764
312470;201610;663;1785;395;1246;80;299;118;331;198;630
312480;201610;1218;3130;891;2749;172;608;507;1466;679;2074
312490;201610;2025;5244;1496;4389;198;645;872;2429;1070;3074
312500;201610;705;2084;584;1883;108;389;234;717;342;1106
312510;201610;3598;10410;2715;8483;405;1412;1386;4049;1791;5461
312520;201610;265;858;206;749;63;234;60;230;123;464
312530;201610;620;1782;523;1625;56;219;350;1053;406;1272
312540;201610;1431;4437;1026;3565;229;853;443;1527;672;2380
312550;201610;695;2070;575;1790;96;302;283;825;379;1127
312560;201610;2098;5438;1690;4893;77;300;1404;3979;1481;4279
312570;201610;2396;7002;1943;6181;533;1800;644;2036;1177;3836
312580;201610;527;1708;417;1455;52;206;166;559;218;765
312590;201610;1693;5491;1381;4797;333;1269;537;1731;870;3000
312595;201610;1956;6464;1724;5920;348;1204;914;3173;1262;4377
312600;201610;814;2585;604;2153;97;431;286;938;383;1369
312610;201610;7106;19783;4802;15255;1148;3906;972;2893;2120;6799
312620;201610;2204;6283;1638;5451;113;420;1233;4187;1346;4607
312630;201610;333;1055;270;933;78;305;87;279;165;584
312640;201610;543;1723;417;1449;84;297;127;412;211;709
312650;201610;2171;6186;1487;4779;180;680;861;2635;1041;3315
312660;201610;1432;3718;1114;3231;116;384;761;2143;877;2527
312670;201610;5578;16268;4545;14715;1263;4463;1566;4895;2829;9358
312675;201610;1286;4046;1055;3542;138;516;693;2287;831;2803
312680;201610;1480;4434;1244;4092;178;708;767;2402;945;3110
312690;201610;2180;5710;1699;4976;261;824;1093;3070;1354;3894
312695;201610;829;2858;772;2766;149;497;504;1881;653;2378
312700;201610;1908;5705;1399;4599;174;628;741;2365;915;2993
312705;201610;1271;3590;990;3054;76;265;710;2113;786;2378
312707;201610;1544;4831;1148;4014;145;603;608;2030;753;2633
312710;201610;6997;17472;4227;12826;1261;4182;835;2416;2096;6598
312720;201610;781;2605;645;2314;137;543;244;798;381;1341
312730;201610;1895;4447;1279;3676;145;487;783;2220;928;2707
312733;201610;1626;4294;1134;3365;51;156;750;2151;801;2307
312735;201610;828;2215;705;2038;178;568;356;952;534;1520
312737;201610;849;2097;578;1691;174;502;205;606;379;1108
312738;201610;519;1587;350;1223;78;304;121;385;199;689
312740;201610;349;818;193;629;53;176;43;138;96;314
312750;201610;1274;4451;1172;4265;225;969;572;1981;797;2950
312760;201610;1991;6310;1430;5060;341;1288;361;1241;702;2529
312770;201610;42617;114557;29832;91686;7572;24636;8082;23578;15654;48214
312780;201610;2705;9138;2348;8486;382;1535;1281;4656;1663;6191
312790;201610;332;837;186;574;28;104;65;158;93;262
312800;201610;5034;16138;3839;13543;1156;4367;843;2934;1999;7301
312810;201610;2121;6361;1377;4821;331;1249;262;809;593;2058
312820;201610;1936;5434;1581;4763;74;254;1126;3277;1200;3531
312825;201610;1340;3592;1140;3314;83;258;886;2571;969;2829
312830;201610;2518;7687;1596;5724;428;1609;279;958;707;2567
312840;201610;1240;3914;940;3293;137;533;321;1011;458;1544
312850;201610;710;2193;514;1767;97;391;154;492;251;883
312860;201610;1215;3539;831;2779;233;862;256;778;489;1640
312870;201610;5726;17453;3678;12914;689;2595;833;2765;1522;5360
312880;201610;1314;3827;1122;3513;121;418;729;2316;850;2734
312890;201610;1702;5092;968;3363;214;780;357;1238;571;2018
312900;201610;1229;3563;1037;3283;125;425;732;2354;857;2779
312910;201610;1692;3350;907;2266;163;442;433;983;596;1425
312920;201610;881;2771;700;2411;159;632;278;876;437;1508
312930;201610;2180;6156;1799;5515;428;1311;776;2374;1204;3685
312940;201610;913;2931;745;2598;189;737;200;639;389;1376
312950;201610;3123;8709;2287;7376;821;2788;471;1502;1292;4290
312960;201610;1957;5539;1643;5086;171;501;1270;4020;1441;4521
312965;201610;1814;5628;1483;4978;157;572;912;3047;1069;3619
312970;201610;1035;3377;813;2972;215;866;210;753;425;1619
312980;201610;17890;58735;16045;54496;4568;16734;6067;19596;10635;36330
312990;201610;487;1403;324;1105;99;383;101;342;200;725
313000;201610;502;1619;387;1379;82;388;153;455;235;843
313005;201610;2640;8280;2275;7579;391;1266;1346;4527;1737;5793
313010;201610;3786;11948;3120;10724;811;3005;1363;4527;2174;7532
313020;201610;985;3201;672;2370;132;515;121;330;253;845
313030;201610;1505;3967;1042;3256;210;778;494;1488;704;2266
313040;201610;837;2729;697;2379;90;379;311;971;401;1350
313050;201610;1838;5618;1290;4698;292;1176;315;1032;607;2208
313055;201610;1648;5055;1484;4816;66;227;1238;4049;1304;4276
313060;201610;747;2374;553;1897;154;545;60;183;214;728
313065;201610;1930;6142;1596;5547;254;949;1050;3645;1304;4594
313070;201610;1039;2981;797;2530;168;600;361;1086;529;1686
313080;201610;459;1390;321;1088;68;276;95;253;163;529
313090;201610;5248;14999;4438;13623;1116;3649;2142;6543;3258;10192
313100;201610;1130;3374;1004;3162;80;251;801;2553;881;2804
313110;201610;1781;5001;1220;3852;175;625;548;1592;723;2217
313115;201610;2467;8187;2236;7678;495;1893;1007;3227;1502;5120
313120;201610;3589;9336;2934;8432;700;2250;1600;4455;2300;6705
313130;201610;26360;78228;21460;67890;4426;15214;8933;26435;13359;41649
313140;201610;585;1493;438;1268;29;97;311;878;340;975
313150;201610;1398;4351;1097;3742;483;1745;192;647;675;2392
313160;201610;959;2900;801;2570;144;532;407;1216;551;1748
313170;201610;9422;31054;6484;23598;1353;5110;1647;5672;3000;10782
313180;201610;2406;6425;1826;5548;391;1306;748;2156;1139;3462
313190;201610;3696;12218;2728;9737;597;2269;716;2366;1313;4635
313200;201610;1156;3672;985;3340;93;353;702;2340;795;2693
313210;201610;4228;12843;3420;11513;750;2655;1548;5019;2298;7674
313220;201610;1535;4511;1033;3416;242;885;231;619;473;1504
313230;201610;2311;7998;2110;7697;299;1179;1458;5259;1757;6438
313240;201610;8412;25175;6152;20730;1153;4377;2448;7753;3601;12130
313250;201610;6923;21388;5571;18822;723;2509;3117;10382;3840;12891
313260;201610;633;1860;414;1381;64;240;113;356;177;596
313270;201610;5444;16018;4334;13981;785;2702;2309;7329;3094;10031
313280;201610;384;1245;266;976;52;210;64;213;116;423
313290;201610;826;2898;647;2544;239;1047;91;313;330;1360
313300;201610;1824;5970;1399;4921;394;1484;174;513;568;1997
313310;201610;1060;3619;882;3205;200;811;178;549;378;1360
313320;201610;2364;6702;1657;5502;321;1166;664;2173;985;3339
313330;201610;4043;12213;3268;10781;328;1339;2014;6371;2342;7710
313340;201610;1917;4700;1432;3939;269;738;773;2130;1042;2868
313350;201610;2895;8901;2108;7073;447;1630;445;1352;892;2982
313360;201610;1328;3750;935;3056;214;853;489;1455;703;2308
313370;201610;1187;3970;1060;3619;157;633;553;1755;710;2388
313375;201610;2390;6126;1509;4717;286;1063;516;1509;802;2572
313380;201610;5099;15596;4038;13286;1085;3866;1308;3953;2393;7819
313390;201610;894;2995;823;2863;86;345;545;1846;631;2191
313400;201610;3716;9937;3161;9253;333;901;2574;7729;2907;8630
313410;201610;1237;3487;1006;3116;223;758;569;1713;792;2471
313420;201610;18906;44701;10304;29627;2109;6671;1636;4549;3745;11220
313430;201610;1047;3248;764;2622;146;581;279;874;425;1455
313440;201610;6589;14590;4183;11486;235;577;2973;8262;3208;8839
313450;201610;637;1877;487;1559;98;356;151;443;249;799
313460;201610;2175;7271;1832;6620;453;1877;638;2077;1091;3954
313470;201610;3108;8402;2642;7674;379;1122;1784;5091;2163;6213
313480;201610;1034;2905;714;2303;111;405;250;733;361;1138
313490;201610;1537;4419;816;3179;242;1034;75;268;317;1302
313500;201610;416;1362;307;1063;52;196;100;331;152;527
313505;201610;9223;26483;8486;25630;286;565;7892;24331;8178;24896
313507;201610;1388;3767;1165;3435;99;316;784;2314;883;2630
313510;201610;15399;43712;12811;39275;1821;5769;7127;21650;8948;27419
313520;201610;14324;43483;11627;38406;1223;4474;7501;24486;8724;28960
313530;201610;614;1848;481;1577;37;136;195;611;232;747
313535;201610;2550;7396;2208;6738;186;587;1609;4833;1795;5420
313540;201610;1067;3304;743;2450;194;692;185;560;379;1252
313545;201610;1292;4656;1131;4320;178;781;637;2305;815;3086
313550;201610;1827;5784;1553;5227;359;1214;741;2465;1100;3679
313560;201610;2240;5100;1796;4582;197;466;1368;3580;1565;4046
313570;201610;882;3021;742;2739;223;889;248;878;471;1767
313580;201610;5753;16349;4383;14198;778;2671;2364;7740;3142;10411
313590;201610;980;2742;724;2350;332;1172;138;403;470;1575
313600;201610;3890;11473;3284;10463;346;1227;2302;7275;2648;8502
313610;201610;1025;2965;856;2631;198;634;438;1324;636;1958
313620;201610;5572;16905;4633;15103;1239;4242;1654;5292;2893;9534
313630;201610;8385;22881;6060;19451;927;3375;3064;10254;3991;13629
313640;201610;788;2280;558;1900;177;651;154;515;331;1166
313650;201610;1920;6274;1661;5832;251;1007;1064;3637;1315;4644
313652;201610;933;3233;844;3059;141;570;492;1713;633;2283
313655;201610;940;2964;766;2662;96;389;468;1595;564;1984
313657;201610;1357;3908;1075;3455;86;366;798;2395;884;2761
313660;201610;839;2734;710;2475;146;579;340;1109;486;1688
313665;201610;3859;12233;3163;10686;625;2335;1489;4792;2114;7127
313670;201610;46414;133683;31882;104140;7474;26390;9867;30843;17341;57233
313680;201610;1081;3130;904;2820;111;433;583;1732;694;2165
313690;201610;878;3128;744;2798;161;610;290;1115;451;1725
313695;201610;1379;4395;1159;3971;117;455;803;2745;920;3200
313700;201610;3503;11837;3026;11191;456;1712;2162;8172;2618;9884
313710;201610;1359;3590;977;2962;181;591;514;1517;695;2108
313720;201610;5513;17244;4050;13843;766;2851;1403;4342;2169;7193
313730;201610;1304;3382;936;2871;132;450;562;1687;694;2137
313740;201610;2051;7336;1621;6177;422;1794;103;318;525;2112
313750;201610;2234;6709;1774;5731;472;1606;492;1416;964;3022
313753;201610;1913;5345;1423;4459;251;876;673;2053;924;2929
313760;201610;4060;12882;3140;10872;848;3130;894;2885;1742;6015
313770;201610;3433;10751;2857;9829;884;3206;1158;3967;2042;7173
313780;201610;4058;11068;2787;8828;459;1628;1103;3391;1562;5019
313790;201610;489;1661;455;1592;93;332;259;922;352;1254
313800;201610;1289;3369;1069;3023;94;294;754;2159;848;2453
313810;201610;1571;4462;1355;4120;143;454;984;3036;1127;3490
313820;201610;13092;34667;9914;29192;1733;5767;4279;11843;6012;17610
313830;201610;426;1382;355;1237;87;349;132;451;219;800
313835;201610;903;2966;816;2813;113;460;448;1458;561;1918
313840;201610;7586;21547;5575;17946;1380;4785;1285;3932;2665;8717
313850;201610;1175;3157;988;2804;178;606;527;1342;705;1948
313860;201610;2792;8317;1955;6396;417;1427;557;1703;974;3130
313862;201610;1272;3178;856;2484;99;282;496;1506;595;1788
313865;201610;2283;6901;2031;6509;158;590;1556;4945;1714;5535
313867;201610;1134;3819;947;3391;289;1094;292;1068;581;2162
313868;201610;1658;5465;1364;4822;111;504;951;3249;1062;3753
313870;201610;800;2477;684;2235;195;708;193;545;388;1253
313880;201610;1428;4395;1171;3887;296;1091;449;1306;745;2397
313890;201610;1897;4993;1487;4401;305;898;868;2723;1173;3621
313900;201610;4007;14191;3413;12788;1050;4317;864;3146;1914;7463
313910;201610;736;2453;584;2128;202;786;70;237;272;1023
313920;201610;3285;10840;2757;9807;525;1916;1457;5346;1982;7262
313925;201610;1904;5096;1343;4017;125;354;855;2574;980;2928
313930;201610;6723;24565;5545;22366;705;2519;3563;15532;4268;18051
313940;201610;8712;28341;6700;24738;1962;7974;1816;6959;3778;14933
313950;201610;4201;11718;3018;9690;925;3367;967;2815;1892;6182
313960;201610;5581;14264;3759;11399;1008;3311;1059;2966;2067;6277
313970;201610;1459;4200;1214;3840;140;507;742;2411;882;2918
313980;201610;1288;3908;929;3243;204;795;367;1241;571;2036
313990;201610;1787;6525;1456;5674;460;1962;302;1014;762;2976
314000;201610;8323;25843;7179;23409;1096;4201;4196;13020;5292;17221
314010;201610;1185;3246;940;2893;73;252;644;1920;717;2172
314015;201610;1492;4845;1168;4238;257;1030;491;1691;748;2721
314020;201610;510;1506;308;1044;81;297;73;227;154;524
314030;201610;850;2730;617;2166;92;357;243;823;335;1180
314040;201610;711;2027;547;1694;222;714;159;485;381;1199
314050;201610;1740;5309;1328;4453;279;1076;511;1568;790;2644
314053;201610;1604;4953;1364;4593;213;725;859;3023;1072;3748
314055;201610;2200;6460;1878;5962;69;271;1522;4855;1591;5126
314060;201610;1176;3563;909;3082;50;219;612;2022;662;2241
314070;201610;4243;13052;3157;10736;841;2956;733;2327;1574;5283
314080;201610;1789;5576;1095;3845;195;729;239;711;434;1440
314085;201610;1988;6550;1673;6031;450;1750;599;2130;1049;3880
314090;201610;3330;11318;2794;10177;731;2966;849;3129;1580;6095
314100;201610;3394;8439;2926;7824;164;348;2512;6948;2676;7296
314110;201610;4080;12822;3402;11279;676;2449;1392;4194;2068;6643
314120;201610;1058;2514;477;1531;103;357;115;358;218;715
314130;201610;700;1993;309;1078;47;174;63;197;110;371
314140;201610;4951;15075;3875;12819;828;2908;1733;5663;2561;8571
314150;201610;1602;4331;1220;3644;157;496;649;1905;806;2401
314160;201610;2613;6630;1851;5403;212;668;1102;3316;1314;3984
314170;201610;1101;3232;865;2706;98;323;496;1492;594;1815
314180;201610;5277;16454;4540;15141;1299;4548;1779;5999;3078;10547
314190;201610;728;2042;530;1700;131;505;188;522;319;1027
314200;201610;2983;9085;2535;8238;273;1034;1747;5515;2020;6549
314210;201610;2026;5771;1737;5256;228;772;1060;3114;1288;3886
314220;201610;1597;4924;1139;3955;338;1270;219;650;557;1920
314225;201610;1340;3819;1173;3569;89;289;905;2768;994;3057
314230;201610;679;2148;616;2035;108;413;336;1083;444;1496
314240;201610;1128;3385;884;2951;177;612;454;1574;631;2186
314250;201610;555;1639;394;1285;87;303;109;310;196;613
314260;201610;1039;3652;888;3274;205;845;272;935;477;1780
314270;201610;2889;9264;2333;8223;233;926;1536;5388;1769;6314
314280;201610;3262;8811;2075;6472;484;1727;701;1930;1185;3657
314290;201610;4863;13272;4000;11773;839;2526;2193;6369;3032;8895
314300;201610;1522;4999;1203;4233;360;1301;316;1073;676;2374
314310;201610;5677;16499;4473;14157;1166;3913;1672;4990;2838;8903
314315;201610;820;3174;726;2981;74;359;489;1980;563;2339
314320;201610;3025;8410;2090;7029;505;1810;975;3389;1480;5199
314330;201610;55298;164637;44646;145478;12926;44535;12830;40529;25756;85064
314340;201610;2987;8008;1476;4913;319;1163;132;278;451;1441
314345;201610;1247;4135;1098;3871;230;845;655;2283;885;3128
314350;201610;1295;3698;943;3056;280;955;142;396;422;1351
314360;201610;676;2155;407;1488;83;350;90;336;173;686
314370;201610;560;1833;515;1762;106;425;345;1132;451;1557
314380;201610;1332;3978;868;3011;247;942;121;407;368;1349
314390;201610;13848;39427;9614;31190;2310;7948;2254;6684;4564;14632
314400;201610;4579;13270;3686;11919;1271;4279;1131;3760;2402;8039
314410;201610;2694;8222;1948;6663;544;2053;593;2022;1137;4075
314420;201610;759;2112;570;1808;29;151;405;1215;434;1366
314430;201610;6518;19136;5249;16584;1452;4939;1596;4947;3048;9886
314435;201610;1352;4283;1160;3937;99;421;789;2635;888;3056
314437;201610;1103;2833;873;2457;32;97;696;1931;728;2028
314440;201610;650;1892;489;1636;161;606;100;280;261;886
314450;201610;1638;4688;1312;4151;262;995;645;1869;907;2864
314460;201610;4136;13696;3136;11392;745;2948;554;1851;1299;4799
314465;201610;2292;7104;2090;6721;103;460;1652;5153;1755;5613
314467;201610;1018;2874;831;2542;55;164;617;1900;672;2064
314470;201610;2351;7282;1868;6223;425;1591;651;1963;1076;3554
314480;201610;6060;19873;3855;13884;649;2470;479;1483;1128;3953
314490;201610;909;2666;669;2159;149;527;301;909;450;1436
314500;201610;1984;5558;1345;4304;300;1026;464;1395;764;2421
314505;201610;1821;5192;1635;4923;199;665;1145;3467;1344;4132
314510;201610;1917;5158;1235;4149;389;1408;294;978;683;2386
314520;201610;2970;10553;2090;8366;444;1967;228;795;672;2762
314530;201610;5987;20785;5507;19840;1038;3531;3264;12248;4302;15779
314535;201610;2773;7631;2260;6857;249;825;1611;4823;1860;5648
314537;201610;1149;3554;892;3068;109;453;540;1799;649;2252
314540;201610;417;1225;300;957;59;202;100;302;159;504
314545;201610;1448;4296;1241;4000;86;293;975;3201;1061;3494
314550;201610;630;1711;436;1408;82;348;172;484;254;832
314560;201610;4462;15161;3551;12850;611;2440;1112;3771;1723;6211
314570;201610;307;895;218;701;57;205;97;291;154;496
314580;201610;530;1726;368;1359;94;402;41;131;135;533
314585;201610;851;2730;592;2151;128;530;153;509;281;1039
314587;201610;2009;6029;1660;5400;351;1084;803;2680;1154;3764
314590;201610;3240;10835;2205;8037;429;1736;390;1304;819;3040
314600;201610;1571;5071;1008;3781;227;919;141;429;368;1348
314610;201610;7126;23823;6153;21477;1331;5149;2558;8324;3889;13473
314620;201610;1649;4844;1446;4539;127;411;1101;3427;1228;3838
314625;201610;1486;4876;1308;4548;165;752;881;2895;1046;3647
314630;201610;4886;14284;4077;12911;270;1101;2980;9220;3250;10321
314640;201610;595;1598;436;1307;114;365;122;301;236;666
314650;201610;1102;3032;725;2340;94;343;284;813;378;1156
314655;201610;1573;4626;1095;3658;300;969;402;1339;702;2308
314660;201610;297;791;199;593;20;60;97;274;117;334
314670;201610;1682;4420;1114;3360;161;514;657;1902;818;2416
314675;201610;1813;5365;1533;4854;142;528;1091;3391;1233;3919
314690;201610;2354;7431;1822;6396;514;1997;363;1205;877;3202
314700;201610;9277;30655;6129;23221;1702;7058;872;3143;2574;10201
314710;201610;8037;23932;4949;16894;849;3166;692;2115;1541;5281
314720;201610;2459;7929;1832;6480;448;1739;485;1705;933;3444
314730;201610;2296;6788;1767;5862;476;1732;625;1929;1101;3661
314740;201610;2926;9217;2444;8227;409;1560;1155;3710;1564;5270
314750;201610;351;1077;260;866;46;164;104;329;150;493
314760;201610;1719;5572;1155;4136;228;938;220;609;448;1547
314770;201610;1058;3261;508;1735;65;248;106;286;171;534
314780;201610;293;773;211;657;50;189;92;259;142;448
314790;201610;11311;33441;7702;26299;3030;11323;631;1670;3661;12993
314795;201610;1687;4797;1411;4349;96;372;1039;3077;1135;3449
314800;201610;11553;32983;7181;23708;1957;6845;758;2269;2715;9114
314810;201610;11862;33962;8547;27721;2486;8723;1666;5328;4152;14051
314820;201610;956;2608;632;2033;153;546;250;772;403;1318
314830;201610;1652;5392;1400;4918;391;1528;592;2075;983;3603
314840;201610;954;3320;756;3005;131;644;435;1641;566;2285
314850;201610;1974;5533;1539;4748;181;712;1054;3109;1235;3821
314860;201610;3318;10773;2819;9770;536;2137;1518;5076;2054;7213
314870;201610;5635;17194;4691;15808;452;1907;3357;11096;3809;13003
314875;201610;1796;5700;1684;5535;196;628;1381;4598;1577;5226
314880;201610;906;2401;715;2130;43;101;541;1708;584;1809
314890;201610;616;1829;410;1364;68;265;155;467;223;732
314900;201610;554;1630;433;1426;83;284;194;618;277;902
314910;201610;1724;5525;1349;4871;392;1586;440;1486;832;3072
314915;201610;2537;7877;2126;7118;157;625;1516;4929;1673;5554
314920;201610;564;1550;379;1244;24;87;215;658;239;745
314930;201610;4801;15926;3983;13989;1048;3957;1048;3448;2096;7405
314940;201610;402;1151;352;1059;54;177;215;610;269;787
314950;201610;348;1004;236;814;45;176;70;221;115;397
314960;201610;761;2306;566;1895;137;499;172;517;309;1016
314970;201610;566;1920;460;1700;105;427;130;496;235;923
314980;201610;1512;4619;1195;4043;336;1272;87;259;423;1531
314990;201610;2634;8210;1864;6422;513;2024;374;1066;887;3090
314995;201610;1640;4938;1381;4509;135;538;938;2990;1073;3528
315000;201610;1081;3050;839;2616;83;299;549;1689;632;1988
315010;201610;441;1337;322;1081;69;297;113;320;182;617
315015;201610;2170;6482;1923;6183;245;813;1405;4725;1650;5538
315020;201610;826;2535;562;1925;98;348;222;713;320;1061
315030;201610;693;2041;519;1710;143;505;101;305;244;810
315040;201610;921;2779;840;2626;154;495;510;1569;664;2064
315050;201610;1402;3993;1078;3452;187;687;515;1615;702;2302
315053;201610;1074;3178;893;2814;145;555;448;1389;593;1944
315057;201610;1730;5769;1456;5261;344;1231;698;2548;1042;3779
315060;201610;837;2689;557;2023;110;427;74;259;184;686
315070;201610;763;2242;604;1950;164;558;251;749;415;1307
315080;201610;2897;9457;2418;8370;629;2348;1029;3484;1658;5832
315090;201610;806;2777;608;2293;156;656;136;466;292;1122
315100;201610;1180;3926;806;3004;175;745;205;688;380;1433
315110;201610;1435;4268;1147;3696;262;900;434;1365;696;2265
315120;201610;14555;33714;9289;26394;1498;4254;4621;13836;6119;18090
315130;201610;1416;4618;1221;4202;311;1193;383;1244;694;2437
315140;201610;2841;8814;2202;7454;465;1808;803;2450;1268;4258
315150;201610;4732;12688;3345;10198;617;2067;1316;3937;1933;6004
315160;201610;1307;3761;1004;3159;209;683;425;1290;634;1973
315170;201610;1554;4694;1133;3817;252;907;245;860;497;1767
315180;201610;17366;48296;8681;29125;1596;5876;1575;4737;3171;10613
315190;201610;2060;5309;1678;4706;397;1170;935;2590;1332;3760
315200;201610;3914;13000;3076;11129;992;3884;573;2010;1565;5894
315210;201610;7970;23194;5958;18772;1139;3903;2246;6688;3385;10591
315213;201610;1116;3385;986;3156;40;143;812;2575;852;2718
315217;201610;2476;8346;1963;7346;217;983;1182;4289;1399;5272
315220;201610;9896;27858;7820;24313;2736;8559;2426;7697;5162;16256
315230;201610;2946;7778;2558;7308;147;207;2255;6809;2402;7016
315240;201610;3077;9304;2519;8357;745;2621;1089;3486;1834;6107
315250;201610;10608;31803;7691;25903;1848;6737;2436;7988;4284;14725
315260;201610;1035;3193;634;2234;127;467;87;264;214;731
315270;201610;727;2331;533;1927;107;427;116;376;223;803
315280;201610;3140;8920;1811;5960;403;1369;270;807;673;2176
315290;201610;1374;3774;909;2964;289;1023;177;576;466;1599
315300;201610;537;1381;333;1103;131;450;131;438;262;888
315310;201610;1273;3990;981;3387;153;616;603;1979;756;2595
315320;201610;790;2327;608;2058;98;397;283;934;381;1331
315330;201610;728;2627;397;1672;92;418;51;197;143;615
315340;201610;3618;10161;2733;8638;591;1983;1055;3177;1646;5160
315350;201610;1917;5150;1366;4309;196;671;866;2743;1062;3414
315360;201610;1728;5677;1335;4714;255;991;441;1455;696;2446
315370;201610;512;1577;419;1399;83;292;204;687;287;979
315380;201610;211;711;154;568;38;169;38;110;76;279
315390;201610;1371;4448;930;3388;210;833;179;599;389;1432
315400;201610;4328;12911;3354;10907;676;2353;1503;4752;2179;7105
315410;201610;2171;5520;1719;4843;152;501;1212;3399;1364;3900
315415;201610;1068;3421;905;3150;352;1292;280;963;632;2255
315420;201610;1253;3968;893;3178;214;778;120;387;334;1165
315430;201610;3736;10041;2598;8065;745;2521;584;1667;1329;4188
315440;201610;974;2918;812;2618;194;728;348;995;542;1723
315445;201610;2114;5781;1563;4901;220;729;1014;3161;1234;3890
315450;201610;2465;7577;2133;7019;381;1149;1288;4365;1669;5514
315460;201610;33393;107624;28225;96270;9836;35353;5024;16159;14860;51512
315470;201610;475;1421;368;1206;43;175;197;618;240;793
315480;201610;1771;5332;1089;3754;228;833;210;725;438;1558
315490;201610;3162;8322;2197;6825;369;1281;854;2476;1223;3757
315500;201610;489;1421;286;928;42;152;123;338;165;490
315510;201610;1424;3991;1180;3590;99;333;855;2530;954;2863
315520;201610;1030;3075;806;2658;123;439;490;1559;613;1998
315530;201610;652;2168;509;1785;174;654;144;452;318;1106
315540;201610;1072;3333;845;2886;172;704;289;952;461;1656
315550;201610;1795;5025;1291;4169;312;1094;411;1269;723;2363
315560;201610;6520;21466;5752;20285;526;2121;3913;13839;4439;15960
315570;201610;1925;6107;1706;5625;291;1059;888;2828;1179;3887
315580;201610;2545;7323;1889;6085;478;1738;525;1565;1003;3303
315590;201610;877;2546;751;2329;110;387;408;1227;518;1614
315600;201610;2494;8657;1923;7488;389;1533;944;3835;1333;5368
315610;201610;1010;2829;776;2345;133;506;326;830;459;1336
315620;201610;315;1101;291;1053;89;301;153;593;242;894
315630;201610;935;2940;716;2460;165;578;153;496;318;1074
315640;201610;488;1398;372;1191;73;276;165;485;238;761
315645;201610;890;2627;688;2192;250;841;163;487;413;1328
315650;201610;1853;5025;1418;4385;94;381;1035;3127;1129;3508
315660;201610;2598;6620;2011;5627;270;733;1355;3752;1625;4485
315670;201610;11135;35984;9507;32629;2530;9262;3555;11807;6085;21069
315680;201610;3049;10000;2241;8245;704;2728;552;2012;1256;4740
315690;201610;3418;9568;2147;7147;560;1998;400;1393;960;3391
315700;201610;7418;22726;5944;19652;1076;3881;2761;8674;3837;12555
315710;201610;1835;5155;1359;4346;107;444;874;2668;981;3112
315720;201610;3681;11577;3024;10225;324;1346;1896;5998;2220;7344
315725;201610;1530;4745;1349;4464;225;782;931;3115;1156;3897
315727;201610;611;1851;471;1548;103;378;164;488;267;866
315730;201610;798;2470;707;2257;104;383;373;1142;477;1525
315733;201610;1033;3043;853;2690;270;915;284;834;554;1749
315737;201610;1269;3809;937;3170;70;302;611;2050;681;2352
315740;201610;1037;3090;818;2637;147;563;416;1223;563;1786
315750;201610;1142;3478;1000;3206;58;230;729;2316;787;2546
315760;201610;1033;2721;996;2675;13;47;928;2469;941;2516
315765;201610;1544;4684;1347;4408;60;233;1112;3674;1172;3907
315770;201610;1472;4631;1198;4083;322;1197;291;983;613;2180
315780;201610;23133;74353;20007;67232;4584;16427;6974;22611;11558;39038
315790;201610;3692;12034;3124;10858;652;2234;1757;6262;2409;8496
315800;201610;1448;5554;1052;4339;236;1028;162;618;398;1646
315810;201610;1395;3708;1141;3293;189;568;702;1939;891;2507
315820;201610;2464;8153;2076;7409;669;2454;785;2896;1454;5350
315830;201610;1223;3983;957;3394;117;512;323;998;440;1510
315840;201610;849;2197;507;1537;91;311;146;399;237;710
315850;201610;1011;3542;967;3448;242;957;512;1718;754;2675
315860;201610;525;1757;360;1376;83;377;72;237;155;614
315870;201610;470;1351;378;1202;65;232;191;567;256;799
315880;201610;1216;3094;926;2708;201;698;341;931;542;1629
315890;201610;1523;5088;1305;4684;491;1877;489;1717;980;3594
315895;201610;5508;17042;4463;14585;926;3230;1582;4864;2508;8094
315900;201610;784;2261;738;2178;64;278;591;1606;655;1884
315910;201610;529;1739;479;1646;132;508;264;864;396;1372
315920;201610;1623;4415;827;2684;170;594;163;441;333;1035
315930;201610;1104;2917;753;2278;192;599;195;568;387;1167
315935;201610;951;3129;809;2814;219;846;204;674;423;1520
315940;201610;622;1964;522;1751;105;388;244;796;349;1184
315950;201610;1227;3663;1058;3336;243;727;616;1989;859;2716
315960;201610;3623;11327;2229;8337;746;3175;99;204;845;3379
315970;201610;752;2035;544;1729;46;122;377;1240;423;1362
315980;201610;4074;9903;2385;6981;688;2219;538;1330;1226;3549
315990;201610;4038;11409;3134;9733;548;1976;1522;4517;2070;6493
316000;201610;587;1722;458;1510;127;514;161;484;288;998
316010;201610;645;2076;496;1768;54;235;242;773;296;1008
316020;201610;1052;3293;892;3011;122;474;577;1888;699;2362
316030;201610;3209;9256;2257;7491;220;840;1379;4570;1599;5410
316040;201610;3463;10877;2391;8438;394;1546;486;1445;880;2991
316045;201610;2051;6284;1837;5903;259;820;1260;4137;1519;4957
316050;201610;355;1113;267;945;57;240;128;406;185;646
316060;201610;752;2221;578;1943;68;313;338;1037;406;1350
316070;201610;6230;19225;5139;16781;1128;4050;2111;6513;3239;10563
316080;201610;752;2696;626;2367;129;540;77;282;206;822
316090;201610;544;1641;349;1209;55;224;117;370;172;594
316095;201610;1464;4584;1217;4125;185;615;738;2513;923;3128
316100;201610;2802;9082;1913;6857;479;1872;401;1297;880;3169
316105;201610;946;2666;678;2181;172;575;246;799;418;1374
316110;201610;12411;41195;10690;38078;1517;5521;6755;24687;8272;30208
316120;201610;1146;3641;844;2876;215;772;216;630;431;1402
316130;201610;1536;3453;809;2308;132;424;355;930;487;1354
316140;201610;986;2816;739;2416;107;351;445;1474;552;1825
316150;201610;1559;4164;1311;3721;201;654;769;2131;970;2785
316160;201610;1262;3647;909;2929;171;595;399;1227;570;1822
316165;201610;953;2523;756;2225;145;491;404;1156;549;1647
316170;201610;1379;3856;962;3093;160;561;408;1192;568;1753
316180;201610;1442;4456;925;3248;213;830;168;503;381;1333
316190;201610;2893;8855;1348;4772;278;947;239;739;517;1686
316200;201610;3883;12167;2729;9698;589;2339;665;2219;1254;4558
316210;201610;4797;15249;3831;13145;1340;4791;542;1847;1882;6638
316220;201610;788;2411;503;1786;96;378;54;195;150;573
316225;201610;1229;3347;969;2899;154;523;585;1665;739;2188
316230;201610;429;1227;338;1059;45;156;169;567;214;723
316240;201610;6699;20132;5769;18845;670;2122;4148;13741;4818;15863
316245;201610;3283;11166;2942;10547;214;1102;2249;7737;2463;8839
316250;201610;10852;30983;7772;24634;2095;7097;1768;5233;3863;12330
316255;201610;2657;7806;2255;7277;317;1128;1548;5028;1865;6156
316257;201610;1383;3753;973;2973;193;634;316;902;509;1536
316260;201610;1830;5053;1333;4255;184;630;688;2263;872;2893
316265;201610;1349;3763;942;2936;95;340;575;1753;670;2093
316270;201610;3991;13134;3518;12030;903;3356;1342;4387;2245;7743
316280;201610;3228;10299;2810;9432;448;1652;1537;4987;1985;6639
316290;201610;3505;10733;2774;9208;512;1942;1125;3585;1637;5527
316292;201610;3687;11422;3179;10533;515;1908;1914;6076;2429;7984
316294;201610;902;2823;603;2171;126;530;49;168;175;698
316295;201610;1866;6111;1692;5745;192;817;1151;3730;1343;4547
316300;201610;1017;3124;830;2783;67;244;524;1777;591;2021
316310;201610;721;2058;444;1519;88;345;143;446;231;791
316320;201610;625;1944;469;1639;84;333;98;298;182;631
316330;201610;999;3010;751;2442;78;282;498;1562;576;1844
316340;201610;952;3015;733;2541;148;597;355;1146;503;1743
316350;201610;1335;4156;1138;3791;177;613;667;2209;844;2822
316360;201610;748;1974;579;1721;100;295;371;1115;471;1410
316370;201610;4694;14765;3710;12641;1070;3965;592;1868;1662;5833
316380;201610;1659;4288;1246;3684;71;231;923;2715;994;2946
316390;201610;916;2594;715;2232;169;570;300;951;469;1521
316400;201610;1316;3979;956;3280;211;787;357;1166;568;1953
316410;201610;1087;3557;990;3408;166;589;659;2274;825;2863
316420;201610;1968;6192;1701;5801;140;567;1220;4057;1360;4624
316430;201610;967;2914;646;2216;154;572;144;448;298;1020
316440;201610;676;2207;528;1948;192;818;97;348;289;1166
316443;201610;706;2061;531;1718;125;455;190;558;315;1013
316447;201610;1595;4667;1428;4440;106;353;1182;3683;1288;4036
316450;201610;2191;7224;1775;6347;217;861;1199;4257;1416;5118
316460;201610;754;2315;672;2162;194;655;311;969;505;1624
316470;201610;7432;23468;5598;19512;1514;5946;1447;4733;2961;10679
316480;201610;183;614;149;534;36;133;38;127;74;260
316490;201610;309;946;243;788;43;120;87;264;130;384
316500;201610;1160;4020;688;2615;135;549;34;119;169;668
316510;201610;753;2740;652;2518;232;949;160;604;392;1553
316520;201610;1090;3251;855;2847;147;528;305;915;452;1443
316530;201610;1048;3299;795;2758;170;716;288;819;458;1535
316540;201610;748;2387;633;2146;82;343;228;709;310;1052
316550;201610;1207;3984;1104;3786;204;793;660;2254;864;3047
316553;201610;2028;6974;1517;5676;430;1742;303;1062;733;2804
316555;201610;2858;9620;2495;9118;200;786;1874;6990;2074;7776
316556;201610;653;1632;460;1293;45;137;311;832;356;969
316557;201610;783;2792;723;2674;283;1110;180;603;463;1713
316560;201610;323;1136;269;1013;63;283;60;209;123;492
316570;201610;1258;3985;1048;3534;135;463;529;1802;664;2265
316580;201610;307;843;185;584;44;147;45;133;89;280
316590;201610;1483;3968;992;3084;214;705;482;1383;696;2088
316600;201610;1063;3429;913;3103;255;932;353;1168;608;2100
316610;201610;583;2092;497;1901;87;406;300;1088;387;1494
316620;201610;2191;6566;1798;5842;235;900;1143;3642;1378;4542
316630;201610;1442;4752;1188;4180;496;1799;282;1022;778;2821
316640;201610;176;551;144;472;32;136;63;173;95;309
316650;201610;913;3272;786;3048;97;375;520;2075;617;2450
316660;201610;197;505;84;257;7;27;19;44;26;71
316670;201610;1958;5375;1460;4444;573;1863;374;1021;947;2884
316680;201610;2005;5376;1537;4656;148;474;1122;3376;1270;3850
316690;201610;1173;3935;1005;3555;283;1119;286;986;569;2105
316695;201610;1099;3405;924;3046;99;351;596;1948;695;2299
316700;201610;373;1094;327;1007;30;129;222;627;252;756
316710;201610;2944;10860;2421;9632;914;3796;518;2200;1432;5996
316720;201610;17109;54110;13063;44905;3362;12005;3374;11140;6736;23145
316730;201610;375;1139;311;1008;81;297;119;350;200;647
316740;201610;668;2216;590;2081;85;355;381;1329;466;1684
316750;201610;408;1366;322;1159;52;221;111;371;163;592
316760;201610;3595;11785;3010;10885;1549;5834;867;3153;2416;8987
316770;201610;1371;3714;1181;3442;70;286;1001;2879;1071;3165
316780;201610;603;1977;487;1732;134;537;68;192;202;729
316790;201610;863;2440;614;1993;142;482;188;614;330;1096
316800;201610;5178;16752;4426;15191;839;3168;2224;7174;3063;10342
316805;201610;813;2041;768;1984;52;135;666;1777;718;1912
316810;201610;622;1870;486;1588;125;450;193;566;318;1016
316820;201610;399;1034;204;676;35;137;29;83;64;220
316830;201610;580;1980;540;1892;159;611;218;736;377;1347
316840;201610;2846;8610;2422;7775;514;1896;1078;3270;1592;5166
316850;201610;2107;6020;1667;5261;251;893;936;2873;1187;3766
316860;201610;18134;56442;14819;49923;3357;12798;5838;18537;9195;31335
316870;201610;6294;20050;4753;16374;1361;5064;848;2779;2209;7843
316880;201610;869;2623;721;2359;212;803;214;667;426;1470
316890;201610;1295;3093;918;2544;246;790;496;1251;742;2041
316900;201610;2603;7630;1915;6151;461;1606;548;1561;1009;3167
316905;201610;468;1535;394;1364;132;483;126;434;258;917
316910;201610;863;2645;576;2037;149;581;75;228;224;809
316920;201610;1627;4331;1073;3472;285;1031;377;1152;662;2183
316930;201610;8285;27681;6148;22744;1357;5391;834;2828;2191;8219
316935;201610;5042;14583;3166;10720;866;3133;655;2119;1521;5252
316940;201610;6946;22262;5121;17974;1153;4178;1071;3523;2224;7701
316950;201610;1598;4297;1287;3839;101;350;959;2795;1060;3145
316960;201610;4832;12115;3707;10483;680;2052;2072;5748;2752;7800
316970;201610;3283;10279;2950;9605;692;2531;1156;3439;1848;5970
316980;201610;970;2934;656;2292;202;789;99;318;301;1107
316990;201610;9880;30726;7367;24924;2161;7724;576;1741;2737;9465
317000;201610;2827;9461;2689;9306;278;875;2038;7844;2316;8719
317005;201610;2593;7943;2211;7267;438;1449;1234;4075;1672;5524
317010;201610;30877;76125;17312;53684;4281;14628;3280;10595;7561;25223
317020;201610;65866;177271;34700;111984;7024;24340;7012;20437;14036;44777
317030;201610;716;2079;566;1823;54;220;347;1099;401;1319
317040;201610;10609;30266;8006;25400;2052;6831;2997;9435;5049;16266
317043;201610;722;1911;582;1692;104;289;335;963;439;1252
317047;201610;1145;3003;806;2422;82;252;457;1368;539;1620
317050;201610;1548;5185;1120;4115;246;945;379;1276;625;2221
317052;201610;2306;7398;2082;7015;157;626;1522;5025;1679;5651
317057;201610;1700;4690;1223;3804;104;411;739;2210;843;2621
317060;201610;432;1237;250;819;63;236;56;144;119;380
317065;201610;1302;4020;1127;3692;94;388;822;2620;916;3008
317070;201610;9840;30208;6150;21601;1338;5165;822;2714;2160;7879
317075;201610;1101;3309;812;2641;186;627;184;565;370;1192
317080;201610;6266;16853;4997;14579;1525;4528;1479;4179;3004;8707
317090;201610;4886;15892;4440;15130;537;1743;3081;10682;3618;12425
317100;201610;3090;8287;2127;6586;692;2286;646;1893;1338;4179
317103;201610;1982;6652;1603;5842;215;1011;806;2786;1021;3797
317107;201610;1337;4054;1137;3635;146;566;740;2208;886;2774
317110;201610;698;1723;364;1158;55;206;143;466;198;672
317115;201610;1147;3523;941;3089;96;314;666;2193;762;2507
317120;201610;10703;35259;8342;29492;1837;7077;3232;10999;5069;18076
317130;201610;7648;22348;5941;19057;1345;4667;2250;7044;3595;11711
317140;201610;574;1811;504;1677;69;248;331;1107;400;1355
317150;201610;998;2729;852;2548;74;254;667;1957;741;2211
317160;201610;3553;9190;2521;7675;185;592;1780;5319;1965;5911
317170;201610;1930;5130;1397;4187;203;685;534;1400;737;2085
317180;201610;1804;6007;1383;5047;354;1360;333;1185;687;2545
317190;201610;1408;3913;1055;3369;92;307;721;2262;813;2569
317200;201610;4592;14180;3716;12277;939;3370;1068;3324;2007;6694
317210;201610;1033;3041;845;2765;121;504;508;1601;629;2105
317220;201610;292;991;272;958;65;261;136;457;201;718
320010;201610;5060;15679;4158;13729;854;2939;2047;6605;2901;9544
320013;201610;1914;5755;1252;4271;231;812;506;1753;737;2565
320016;201610;3150;8718;2606;7871;291;832;1893;5743;2184;6575
320020;201610;3919;12122;3130;10419;909;3213;947;3127;1856;6340
320030;201610;1695;5335;1212;4225;386;1412;333;1094;719;2506
320035;201610;1818;5326;1502;4800;528;1834;497;1471;1025;3305
320040;201610;3214;10253;2504;8687;563;2063;861;2930;1424;4993
320050;201610;1760;4734;1435;4104;318;972;619;1681;937;2653
320060;201610;11954;37396;8389;28947;1973;7283;1798;5760;3771;13043
320070;201610;1471;4633;1114;3823;233;849;297;931;530;1780
320080;201610;5749;16399;4090;12950;950;3051;1229;3943;2179;6994
320090;201610;8242;23778;6140;19371;1658;5483;2163;6478;3821;11961
320100;201610;2828;8649;2130;7188;648;2234;631;2118;1279;4352
320110;201610;1316;3880;1074;3382;275;853;293;939;568;1792
320115;201610;1782;6296;1580;5902;840;3261;342;1319;1182;4580
320120;201610;16874;50270;12286;41082;3096;11144;3329;10969;6425;22113
320130;201610;37055;117727;32232;107567;6587;24338;15051;48146;21638;72484
320140;201610;3785;11812;2477;8730;654;2489;326;1099;980;3588
320150;201610;15832;43692;10523;32951;2881;9555;1144;3253;4025;12808
320160;201610;5048;15675;4089;13601;1077;3909;1358;4163;2435;8072
320170;201610;1736;5462;1339;4553;329;1165;489;1637;818;2802
320180;201610;770;2564;649;2320;260;958;130;475;390;1433
320190;201610;3704;12641;2743;10152;731;2804;472;1712;1203;4516
320200;201610;1048;3165;817;2738;236;855;230;800;466;1655
320210;201610;4804;13392;3794;11299;806;2634;1719;4726;2525;7360
320220;201610;2444;7508;1919;6434;501;1817;713;2402;1214;4219
320225;201610;1362;4555;999;3646;363;1425;108;377;471;1802
320230;201610;4357;13759;3523;12216;1102;4032;1269;4423;2371;8455
320240;201610;12849;37422;9656;31348;2545;8738;2702;8673;5247;17411
320245;201610;3412;11542;3032;10581;1021;3751;691;2309;1712;6060
320250;201610;1952;5880;1271;4271;329;1241;219;629;548;1870
320255;201610;1813;6008;1518;5463;648;2482;459;1721;1107;4203
320260;201610;1072;3240;748;2485;196;694;195;567;391;1261
320265;201610;2479;7813;2059;7060;646;2314;847;2929;1493;5243
320270;201610;2743;7999;1925;6342;452;1612;820;2686;1272;4298
320280;201610;6908;20771;5709;18209;1358;4697;1827;5334;3185;10031
320290;201610;1423;4605;925;3324;308;1148;123;464;431;1612
320300;201610;4287;14179;3639;12667;1171;4306;731;2482;1902;6788
320305;201610;4619;14671;3738;12616;931;3377;1441;4639;2372;8016
320310;201610;1989;5839;1579;4970;402;1317;573;1749;975;3066
320313;201610;2278;6481;1391;4435;352;1240;223;623;575;1863
320316;201610;1744;5227;1346;4360;412;1392;391;1240;803;2632
320320;201610;20888;62317;15467;51723;4203;15132;4944;15988;9147;31120
320330;201610;3032;8903;2408;7746;746;2380;893;3039;1639;5419
320332;201610;5441;17467;4575;15767;1559;5708;1511;5102;3070;10810
320334;201610;1967;6130;1227;4444;326;1295;247;834;573;2129
320335;201610;2368;6938;1363;4516;352;1261;141;368;493;1629
320340;201610;5999;15960;4805;13942;1106;3428;2048;6012;3154;9440
320350;201610;5274;13786;3679;10739;753;2240;1621;4644;2374;6884
320360;201610;1748;4607;1205;3528;202;610;465;1280;667;1890
320370;201610;3025;9836;2324;8168;650;2335;661;2305;1311;4640
320380;201610;2244;6561;1892;5879;412;1360;982;2964;1394;4324
320390;201610;7444;22129;5775;18483;1642;5584;1587;4820;3229;10404
320400;201610;3595;10919;2992;9736;739;2610;1277;3963;2016;6573
320405;201610;4318;12458;3635;11233;775;2519;1911;5748;2686;8267
320410;201610;5596;14762;3934;12366;942;3131;1777;5555;2719;8686
320420;201610;2376;7090;1762;5918;542;2003;436;1403;978;3406
320425;201610;2061;5342;1551;4436;189;575;982;2743;1171;3318
320430;201610;2531;7010;2081;6068;419;1268;1109;3114;1528;4382
320435;201610;2817;9027;2205;7723;1045;3808;515;1866;1560;5674
320440;201610;1082;3529;907;3076;220;833;309;984;529;1817
320450;201610;2032;6341;1584;5400;425;1560;632;2073;1057;3633
320455;201610;4294;13920;2928;10488;832;3173;616;2085;1448;5258
320460;201610;2758;8701;1918;6694;484;1831;415;1311;899;3142
320465;201610;1628;4999;1173;3965;189;676;561;1876;750;2552
320470;201610;4548;13496;2875;9662;848;3098;479;1455;1327;4553
320480;201610;1795;5559;1457;4830;380;1360;532;1689;912;3049
320490;201610;16507;49848;13127;43244;3742;13450;3868;12453;7610;25903
320495;201610;1374;3925;804;2703;261;922;84;291;345;1213
320500;201610;49381;146862;41325;131466;9396;31899;19419;59901;28815;91800
320501;201610;4518;13904;3558;12227;1207;4574;899;2860;2106;7434
320503;201610;1886;6359;1424;5307;585;2351;364;1171;949;3522
320506;201610;4038;12375;2535;8643;747;2665;52;135;799;2800
320510;201610;8721;26834;7223;23792;1601;5679;3466;11059;5067;16738
320515;201610;1932;5543;1487;4529;422;1316;302;884;724;2200
320517;201610;2212;7036;1681;5883;545;2050;373;1263;918;3313
320520;201610;38150;113001;29610;96329;7569;26817;10207;32242;17776;59059
320530;201610;28333;84470;22455;72635;4261;15696;10985;33047;15246;48743
330010;201610;20773;62675;18068;57242;4043;13619;9300;28851;13343;42470
330015;201610;1677;4621;1377;4043;220;754;639;1803;859;2557
330020;201610;18070;52360;16020;48719;3023;10010;9234;27157;12257;37167
330022;201610;1916;5582;1550;4945;285;1040;829;2527;1114;3567
330023;201610;3293;10101;2785;9175;788;2777;816;2558;1604;5335
330025;201610;4629;12413;3489;10405;814;2585;1787;5232;2601;7817
330030;201610;8284;27192;7012;24500;1465;5539;3228;10686;4693;16225
330040;201610;12634;36930;10849;33465;2357;7738;5609;16703;7966;24441
330045;201610;74557;201039;62253;182250;8232;25530;41820;119699;50052;145229
330050;201610;2615;7914;2115;6924;607;2185;672;1993;1279;4178
330060;201610;5876;16647;4827;14929;1180;4035;2332;6968;3512;11003
330070;201610;21651;64945;18752;59707;4154;14096;8562;26990;12716;41086
330080;201610;8049;22657;7248;21300;755;2223;5057;14817;5812;17040
330090;201610;2723;7238;2346;6608;414;1271;1279;3466;1693;4737
330093;201610;2117;6156;1672;5332;337;1092;742;2475;1079;3567
330095;201610;1048;3513;876;3115;201;806;285;943;486;1749
330100;201610;58718;182307;51928;170212;8434;30759;29207;94312;37641;125071
330110;201610;2414;7503;2047;6790;516;1792;638;2063;1154;3855
330115;201610;1956;5580;1661;5091;314;1061;864;2527;1178;3588
330120;201610;2690;7295;2317;6709;415;1350;1351;3773;1766;5123
330130;201610;3658;11645;3138;10664;783;2841;1391;4595;2174;7436
330140;201610;3170;9682;2794;9047;592;2125;1483;4695;2075;6820
330150;201610;2414;7063;1784;5752;437;1488;409;1318;846;2806
330160;201610;1195;3723;1011;3383;275;1053;445;1366;720;2419
330170;201610;102884;305196;90231;282979;18413;60047;48921;151139;67334;211186
330180;201610;2067;5978;1665;5203;131;511;1071;3148;1202;3659
330185;201610;8327;25416;6965;22638;1435;5058;3656;11479;5091;16537
330187;201610;3920;11093;3243;9897;496;1643;2054;6111;2550;7754
330190;201610;26167;73778;24000;70210;4255;13048;15966;46245;20221;59293
330200;201610;14473;44996;12528;41430;3275;11090;5900;19607;9175;30697
330205;201610;2217;6027;1844;5348;298;929;1074;3021;1372;3950
330210;201610;3167;8764;2376;7123;719;2186;636;1831;1355;4017
330220;201610;10581;31885;8630;27543;2201;7462;2147;6255;4348;13717
330225;201610;3897;11953;3252;10653;397;1578;1908;5919;2305;7497
330227;201610;17258;49255;15188;46029;3531;10928;8381;25583;11912;36511
330230;201610;1401;4098;1219;3780;248;886;603;1776;851;2662
330240;201610;18370;55687;14985;48852;4775;16639;3922;12067;8697;28706
330245;201610;1307;3951;918;3152;244;904;157;480;401;1384
330250;201610;36555;106004;32049;97870;9666;29503;12297;38569;21963;68072
330260;201610;4101;12717;3378;11142;644;2294;1440;4473;2084;6767
330270;201610;19995;46023;12618;35452;3116;9623;4545;12503;7661;22126
330280;201610;2271;6669;1801;5699;309;1067;888;2614;1197;3681
330285;201610;18799;53204;16422;49349;2842;9082;9927;29340;12769;38422
330290;201610;3459;9711;2968;8872;474;1582;1728;4905;2202;6487
330300;201610;3411;10927;3008;10117;474;1797;1775;5722;2249;7519
330310;201610;2299;6455;1884;5706;277;850;1108;3322;1385;4172
330320;201610;13636;40428;12521;38569;1736;5809;9073;27567;10809;33376
330330;201610;28469;77623;24066;70272;4163;13403;14431;40421;18594;53824
330340;201610;15045;43445;11154;35869;2717;9180;3486;10821;6203;20001
330350;201610;88979;259585;78695;243188;11988;38663;52900;162289;64888;200952
330360;201610;5901;17345;5570;16828;426;1461;4567;13605;4993;15066
330370;201610;3542;12405;3074;11294;1058;3976;925;3397;1983;7373
330380;201610;5097;16276;4117;14188;947;3574;1401;4551;2348;8125
330385;201610;4038;13758;3542;12662;1061;4018;1266;4513;2327;8531
330390;201610;23420;75836;19834;68209;4880;18109;8089;26931;12969;45040
330395;201610;3114;9049;2714;8349;254;928;1827;5441;2081;6369
330400;201610;2669;8266;2346;7645;295;1195;1463;4378;1758;5573
330410;201610;2835;8602;2212;7336;450;1617;977;3095;1427;4712
330411;201610;2444;7576;2048;6696;260;973;1189;3694;1449;4667
330412;201610;1410;4708;1122;4084;223;920;497;1668;720;2588
330414;201610;24556;68720;20883;63118;4398;13042;11846;36050;16244;49092
330415;201610;3636;11005;2916;9588;769;2596;1053;3424;1822;6020
330420;201610;10158;28826;6346;21344;1411;5036;1305;4186;2716;9222
330430;201610;7468;21966;6339;19711;1389;4594;2763;8296;4152;12890
330440;201610;1686;5553;1402;4918;438;1690;332;1034;770;2724
330450;201610;1385;4524;1196;4161;263;1088;601;1999;864;3087
330452;201610;14371;41592;10895;34624;2759;9395;4142;12550;6901;21945
330455;201610;520741;1412375;401512;1209145;90288;284759;199050;586563;289338;871322
330460;201610;1224;3917;1032;3535;216;826;450;1490;666;2316
330470;201610;4503;13459;3877;12253;889;3020;1736;5294;2625;8314
330475;201610;7961;24356;6807;22256;2074;7317;2397;7541;4471;14858
330480;201610;5947;17227;5244;16078;919;2990;3088;9204;4007;12194
330490;201610;111729;292294;96472;267886;10602;30625;68868;189074;79470;219699
330500;201610;5560;16951;5228;16315;742;2518;3479;10692;4221;13210
330510;201610;38101;115263;32958;106355;10816;35026;13328;43672;24144;78698
330513;201610;1506;4439;1346;4145;421;1292;517;1639;938;2931
330515;201610;3072;9366;2574;8350;796;2543;687;2196;1483;4739
330520;201610;11675;34845;10009;31641;2097;6903;4612;14247;6709;21150
330530;201610;1539;4471;1277;3936;320;1076;526;1529;846;2605
330540;201610;2983;8772;2347;7530;612;2057;817;2484;1429;4541
330550;201610;7927;26233;6666;23584;2894;10576;919;3232;3813;13808
330555;201610;10514;30618;9027;28284;1820;5772;5244;16717;7064;22489
330560;201610;4351;12933;3743;11693;655;2228;1942;5758;2597;7986
330570;201610;3423;9987;2779;8780;753;2461;1265;3953;2018;6414
330575;201610;5353;15243;4667;13937;675;2278;3038;8662;3713;10940
330580;201610;14157;44171;11515;38503;3153;10959;4243;14101;7396;25060
330590;201610;1621;4914;1479;4664;264;878;944;2954;1208;3832
330600;201610;11138;32198;8475;27321;1401;5012;4172;12986;5573;17998
330610;201610;9054;27962;7876;25649;1300;4745;4426;13894;5726;18639
330615;201610;1697;5905;1503;5475;666;2576;343;1264;1009;3840
330620;201610;3562;12186;3017;10960;976;3817;639;2246;1615;6063
330630;201610;23846;69174;18644;59321;3065;10928;10217;30843;13282;41771
350010;201610;2022;5958;1257;4308;315;1127;147;459;462;1586
350020;201610;476;1292;301;926;49;166;155;441;204;607
350030;201610;4516;14046;3313;11502;1087;4008;762;2534;1849;6542
350040;201610;488;1649;343;1304;79;326;95;337;174;663
350050;201610;938;2820;710;2358;168;646;232;650;400;1296
350055;201610;644;1893;535;1705;93;315;314;967;407;1282
350060;201610;120;360;95;319;23;89;44;146;67;235
350070;201610;3860;11411;2231;7741;466;1683;472;1471;938;3154
350075;201610;516;1716;377;1406;145;540;64;220;209;760
350080;201610;638;1849;378;1245;69;243;138;424;207;667
350090;201610;637;1642;383;1154;107;306;132;401;239;707
350100;201610;1917;5950;1289;4578;270;1070;396;1306;666;2376
350110;201610;473;1419;336;1110;34;133;189;605;223;738
350115;201610;1265;3775;1064;3334;210;734;539;1506;749;2240
350120;201610;635;1683;274;899;61;204;48;147;109;351
350130;201610;3382;9990;2811;8760;404;1412;1558;4551;1962;5963
350140;201610;613;1971;488;1718;64;264;256;864;320;1128
350150;201610;427;1402;359;1253;117;433;73;251;190;684
350160;201610;8278;23922;5284;17698;1194;4400;2146;6517;3340;10917
350170;201610;1669;5662;1347;4801;343;1296;280;917;623;2213
350180;201610;1107;3073;673;2078;122;384;307;917;429;1301
350190;201610;3121;9623;2390;7970;541;2069;1027;2925;1568;4994
350200;201610;386;1195;332;1094;30;98;220;723;250;821
350210;201610;5152;13629;3614;10958;1007;3224;1448;4260;2455;7484
350220;201610;2675;8399;2215;7347;489;1911;909;2719;1398;4630
350230;201610;752;2405;646;2177;147;535;264;859;411;1394
350240;201610;507;1532;396;1268;60;205;234;723;294;928
350250;201610;2086;7414;1874;6979;671;2655;543;1991;1214;4646
350260;201610;985;2619;642;1959;109;344;286;837;395;1181
350270;201610;5049;15277;4078;13058;752;2555;1792;5440;2544;7995
350275;201610;2022;6549;1779;6102;500;1808;648;2128;1148;3936
350280;201610;22412;54314;12480;36536;2771;8416;3137;8847;5908;17263
350290;201610;2126;6732;1561;5451;347;1309;482;1568;829;2877
350300;201610;546;1543;380;1175;90;278;191;568;281;846
350310;201610;867;2854;701;2437;96;396;304;995;400;1391
350315;201610;529;1656;373;1283;61;255;88;258;149;513
350320;201610;10456;32526;8770;29038;2502;8613;1287;4308;3789;12921
350330;201610;14498;39937;8928;27047;2007;5836;3101;8796;5108;14632
350335;201610;371;1157;316;1038;25;71;235;778;260;849
350340;201610;1137;3350;729;2488;141;530;232;772;373;1302
350350;201610;727;2241;586;1964;111;409;197;628;308;1037
350360;201610;854;2891;692;2500;167;595;269;996;436;1591
350370;201610;618;1814;405;1323;89;312;78;237;167;549
350380;201610;4356;12444;2787;9477;738;2712;713;2157;1451;4869
350390;201610;9287;28275;7724;25082;2308;7672;2793;8713;5101;16385
350395;201610;384;1048;179;606;25;90;51;152;76;242
350400;201610;8047;22902;6059;19050;1405;4817;2315;6849;3720;11666
350410;201610;8398;27618;6122;22526;1694;6696;1110;3827;2804;10523
350420;201610;566;1743;391;1405;86;362;26;90;112;452
350430;201610;742;2262;588;1973;98;371;326;1044;424;1415
350440;201610;1298;4023;1071;3462;262;829;482;1544;744;2373
350450;201610;7767;23659;5780;19345;1344;4783;1411;4397;2755;9180
350460;201610;1473;4038;847;2745;162;590;301;878;463;1468
350470;201610;249;673;195;579;29;111;121;325;150;436
350480;201610;823;2466;520;1789;79;298;96;294;175;592
350490;201610;1858;5511;1495;4841;359;1239;527;1542;886;2781
350500;201610;579;1717;486;1542;86;321;251;763;337;1084
350510;201610;1127;3363;784;2597;132;486;323;994;455;1480
350520;201610;1471;5417;1078;4342;227;977;251;967;478;1944
350530;201610;2439;7060;1875;5850;571;1797;569;1673;1140;3470
350535;201610;1260;4046;1152;3832;170;693;745;2339;915;3032
350540;201610;1803;5047;1332;4170;365;1167;460;1458;825;2625
350550;201610;11138;29494;7229;22677;1467;5155;2595;7575;4062;12730
350560;201610;3410;11053;2863;9747;402;1386;1573;5332;1975;6718
350570;201610;18498;60335;15731;54267;4882;17878;5523;17961;10405;35839
350580;201610;1776;5624;1070;3791;212;796;113;320;325;1116
350590;201610;4129;12647;3047;10330;790;2983;1113;3372;1903;6355
350600;201610;42716;104490;26092;74216;4553;13714;11566;30480;16119;44194
350610;201610;7279;21244;5535;17896;1208;4196;2328;7223;3536;11419
350620;201610;410;1152;292;957;49;188;122;356;171;544
350630;201610;1637;4710;1116;3673;194;760;442;1277;636;2037
350635;201610;6623;19340;4909;16111;1155;4122;2004;6265;3159;10387
350640;201610;808;2486;499;1688;86;307;107;334;193;641
350650;201610;8038;24110;4570;15665;1103;4078;818;2497;1921;6575
350660;201610;4826;13892;3665;11690;746;2528;1828;5632;2574;8160
350670;201610;1602;4923;1415;4538;297;974;779;2442;1076;3416
350680;201610;1113;3275;784;2590;176;645;315;1008;491;1653
350690;201610;904;2925;666;2380;145;559;213;701;358;1260
350700;201610;4328;12704;2736;9588;765;2840;819;2555;1584;5395
350710;201610;2739;8392;2288;7464;354;1267;1317;4174;1671;5441
350715;201610;802;2413;676;2153;167;564;289;849;456;1413
350720;201610;128;365;106;324;32;99;32;95;64;194
350730;201610;403;1466;367;1371;81;334;146;529;227;863
350740;201610;1824;5541;1210;4034;212;783;340;1001;552;1784
350745;201610;505;1568;285;980;42;145;130;413;172;558
350750;201610;10098;30328;7633;25154;1743;6208;1876;5644;3619;11852
350760;201610;13313;38466;10014;32095;2578;8920;2782;7914;5360;16834
350770;201610;729;2043;473;1513;54;183;264;818;318;1001
350775;201610;596;1575;473;1371;65;230;242;663;307;893
350780;201610;1916;5808;1361;4630;436;1579;192;642;628;2221
350790;201610;1949;5971;1319;4609;300;1091;231;691;531;1782
350800;201610;3003;9826;2718;9258;474;1816;1472;4818;1946;6634
350810;201610;2065;5768;1709;5242;466;1513;744;2304;1210;3817
350820;201610;584;1587;386;1181;62;221;169;482;231;703
350830;201610;870;2663;519;1813;76;284;133;408;209;692
350840;201610;2438;8555;1913;7260;605;2369;408;1472;1013;3841
350850;201610;6012;19805;4814;17008;1546;5728;1021;3483;2567;9211
350860;201610;3258;9940;3018;9526;206;838;2351;7249;2557;8087
350870;201610;2746;8625;2161;7560;459;1816;1243;4324;1702;6140
350880;201610;1353;4465;1049;3717;240;882;246;841;486;1723
350890;201610;661;1855;364;1171;43;154;104;268;147;422
350900;201610;4176;13274;2850;10109;864;3259;261;860;1125;4119
350910;201610;856;2505;719;2215;210;696;307;890;517;1586
350920;201610;10711;30125;9222;27332;928;3067;6664;18905;7592;21972
350925;201610;4540;14072;3471;11790;859;3080;1152;3368;2011;6448
350930;201610;1613;4415;1155;3484;139;450;689;1969;828;2419
350940;201610;1862;6024;1637;5609;302;1169;937;3087;1239;4256
350945;201610;969;2982;758;2551;131;512;391;1219;522;1731
350950;201610;76000;225640;58016;185789;12394;42885;25594;76632;37988;119517
350960;201610;4836;15816;3954;13837;772;3037;2055;6756;2827;9793
350970;201610;4325;14714;3408;12449;1118;4334;590;1828;1708;6162
350980;201610;595;1934;516;1788;221;824;145;491;366;1315
350990;201610;1799;5945;1383;5093;383;1506;375;1308;758;2814
350995;201610;771;2594;707;2454;96;436;458;1476;554;1912
351000;201610;3052;9024;2387;7677;410;1413;991;2953;1401;4366
351010;201610;370;1044;205;666;46;161;70;229;116;390
351015;201610;821;2757;672;2455;140;551;317;1132;457;1683
351020;201610;8346;25483;6909;22970;1743;5989;3136;10442;4879;16431
351030;201610;1857;6443;1514;5546;358;1465;465;1566;823;3031
351040;201610;3551;10514;3124;9712;428;1509;2132;6373;2560;7882
351050;201610;15417;42843;10051;32911;2614;9087;2912;9267;5526;18354
351060;201610;37167;106899;29032;91483;5782;19897;14188;42977;19970;62874
351070;201610;1432;3986;864;2880;206;746;89;246;295;992
351080;201610;2679;7707;2001;6735;478;1723;889;2824;1367;4547
351090;201610;361;1237;270;1022;58;245;47;174;105;419
351100;201610;2394;7120;1537;5006;390;1295;420;1360;810;2655
351110;201610;7310;18659;3820;12475;874;3141;919;2797;1793;5938
351120;201610;663;1910;482;1505;72;266;224;584;296;850
351130;201610;998;2772;481;1651;86;308;94;284;180;592
351140;201610;1710;5715;1347;4892;432;1674;282;924;714;2598
351150;201610;1543;5293;990;3804;183;710;126;400;309;1110
351160;201610;1293;4450;1079;3903;259;996;333;1100;592;2096
351170;201610;1432;4499;1127;3789;185;660;534;1676;719;2336
351190;201610;802;2533;580;1958;96;322;183;579;279;901
351200;201610;2020;5875;1586;4969;238;840;637;1826;875;2666
351210;201610;1175;3375;782;2535;143;489;297;866;440;1355
351220;201610;3264;10822;2861;9921;503;1890;1418;4772;1921;6662
351230;201610;1796;5508;1418;4738;282;1099;702;2184;984;3283
351240;201610;1086;3308;756;2549;209;703;235;733;444;1436
351250;201610;1001;2878;562;1844;96;315;204;630;300;945
351260;201610;928;2701;752;2328;218;657;247;739;465;1396
351270;201610;344;1155;288;1036;69;264;96;289;165;553
351280;201610;4999;14227;3419;10908;659;2281;1312;3895;1971;6176
351290;201610;1034;2922;695;2211;158;527;277;834;435;1361
351300;201610;13074;41902;9222;33274;2215;8705;2867;9932;5082;18637
351310;201610;3155;9446;2409;7971;453;1685;1110;3367;1563;5052
351320;201610;830;2764;638;2244;131;515;224;714;355;1229
351330;201610;279;771;205;635;74;219;40;114;114;333
351340;201610;5487;18148;4427;15898;1306;4868;1554;5448;2860;10316
351350;201610;7777;24713;6477;21848;1781;6213;2253;7179;4034;13392
351360;201610;4113;12598;3605;11538;863;3049;1141;3238;2004;6287
351370;201610;2316;7078;1714;5717;361;1327;672;2008;1033;3335
351380;201610;39110;112493;33647;101666;6749;21689;14719;43101;21468;64790
351385;201610;268;796;178;594;27;99;73;217;100;316
351390;201610;1218;3821;962;3266;237;955;397;1179;634;2134
351400;201610;954;3107;873;2910;251;908;407;1317;658;2225
351410;201610;2502;7465;2070;6592;342;1092;1200;3738;1542;4830
351420;201610;320;909;207;681;42;140;52;168;94;308
351430;201610;845;2640;777;2520;137;476;525;1686;662;2162
351440;201610;3490;10335;2379;7778;519;1733;326;960;845;2693
351450;201610;1635;4574;1209;3796;325;1060;424;1360;749;2420
351460;201610;734;2153;602;1905;310;979;142;445;452;1424
351470;201610;1023;3022;854;2673;167;589;404;1189;571;1778
351480;201610;2764;8800;2471;8275;384;1618;1415;4467;1799;6085
351490;201610;1842;5980;1563;5328;160;668;942;3021;1102;3689
351492;201610;270;853;202;674;12;45;118;383;130;428
351495;201610;198;632;140;477;30;123;61;192;91;315
351500;201610;28580;79523;20095;63012;5128;17154;7937;23378;13065;40532
351510;201610;9125;27551;7088;23293;1717;5951;3304;10566;5021;16517
351512;201610;492;1412;342;1059;55;168;159;481;214;649
351515;201610;2303;7073;1498;5205;365;1360;373;1116;738;2476
351518;201610;2156;6548;1388;5009;339;1358;469;1524;808;2882
351519;201610;801;2345;528;1718;82;302;152;370;234;672
351520;201610;821;2221;377;1313;60;242;67;213;127;455
351530;201610;395;1211;229;761;31;96;58;155;89;251
351535;201610;2398;6100;1770;5072;134;469;1208;3290;1342;3759
351540;201610;1743;5197;1311;4287;442;1552;178;547;620;2099
351550;201610;5498;15957;3586;11649;657;2351;1388;4257;2045;6608
351560;201610;417;1331;341;1153;72;278;49;154;121;432
351565;201610;177;584;148;507;29;99;58;188;87;287
351570;201610;12901;38475;10335;32988;2168;7490;5607;17107;7775;24597
351580;201610;331;892;172;534;49;136;35;118;84;254
351590;201610;448;1134;267;780;25;76;134;367;159;443
351600;201610;1812;4981;1435;4273;172;593;859;2413;1031;3006
351610;201610;668;1798;456;1406;52;175;221;602;273;777
351620;201610;19384;61031;14188;49756;2903;11204;3886;12033;6789;23237
351630;201610;21145;64625;18443;59823;4175;14148;10198;32335;14373;46483
351640;201610;13114;38720;10370;33477;1759;6175;6095;19076;7854;25251
351650;201610;457;1356;193;665;36;141;36;98;72;239
351660;201610;798;2497;521;1765;112;391;97;286;209;677
351670;201610;4051;12653;3086;10264;569;2078;1402;4337;1971;6415
351680;201610;622;1894;329;1131;69;230;67;218;136;448
351685;201610;419;1296;346;1147;96;287;142;484;238;771
351690;201610;1131;3303;752;2445;124;416;303;904;427;1320
351700;201610;1140;3334;930;2896;233;696;334;1034;567;1730
351710;201610;585;1906;459;1588;75;250;186;616;261;866
351720;201610;1607;4854;1017;3406;198;711;312;983;510;1694
351730;201610;1114;3143;839;2675;186;650;355;1091;541;1741
351740;201610;3961;10793;2930;8646;601;1855;1167;3236;1768;5091
351750;201610;1084;3429;614;2253;122;461;177;649;299;1110
351760;201610;3538;10878;2649;8839;716;2575;784;2358;1500;4933
351770;201610;2214;6920;1800;6073;515;1817;713;2297;1228;4114
351780;201610;1583;4384;778;2483;129;452;182;533;311;985
351790;201610;1135;3190;931;2842;210;609;468;1444;678;2053
351800;201610;469;1044;225;614;37;105;76;210;113;315
351810;201610;1051;2976;864;2636;107;317;602;1804;709;2121
351820;201610;2461;7733;1634;5796;345;1257;149;517;494;1774
351830;201610;4096;12576;2975;10064;518;1943;1480;4716;1998;6659
351840;201610;7296;24193;6038;21441;1506;5676;2134;7280;3640;12956
351850;201610;2035;5408;1303;4092;178;692;671;1864;849;2556
351860;201610;3449;10787;2857;9490;704;2481;1233;3937;1937;6418
351870;201610;28536;84278;22969;73641;6893;22951;8871;28099;15764;51050
351880;201610;116358;358051;92998;307707;27450;95670;24405;75137;51855;170807
351885;201610;642;2187;562;2001;158;567;225;775;383;1342
351890;201610;655;2010;476;1612;112;396;76;235;188;631
351900;201610;1248;3791;989;3311;264;914;302;982;566;1896
351905;201610;486;1516;369;1266;48;171;193;616;241;787
351907;201610;18941;55044;15051;47323;1460;5534;9942;29923;11402;35457
351910;201610;1049;3233;797;2636;180;619;317;989;497;1608
351920;201610;1008;2732;823;2429;103;346;482;1380;585;1726
351925;201610;928;2849;736;2422;121;448;328;991;449;1439
351930;201610;2727;8666;2555;8321;581;2166;1642;5036;2223;7202
351940;201610;1007;3021;795;2582;151;520;372;1187;523;1707
351950;201610;1491;4051;978;3046;138;461;479;1456;617;1917
351960;201610;4513;12898;3138;10192;724;2576;1329;4167;2053;6743
351970;201610;5546;19620;4769;17918;1296;5244;1732;6191;3028;11435
351980;201610;939;2756;629;2043;133;477;213;595;346;1072
351990;201610;1540;4254;1088;3347;216;784;242;597;458;1381
352000;201610;2407;7699;2061;6902;405;1455;1006;3121;1411;4576
352010;201610;1699;5659;1387;4898;324;1195;245;862;569;2057
352020;201610;1453;4457;1201;3945;301;1052;466;1459;767;2511
352030;201610;4849;14005;3852;12437;878;2979;1977;6329;2855;9308
352040;201610;2004;6463;1459;5169;320;1223;248;807;568;2030
352042;201610;3536;9656;2032;6336;415;1359;899;2717;1314;4076
352044;201610;1707;5179;951;3480;161;603;191;634;352;1237
352050;201610;10715;32326;6682;22954;1550;5780;1251;3736;2801;9516
352060;201610;751;2242;570;1836;114;425;228;646;342;1071
352070;201610;821;2059;617;1703;141;412;215;582;356;994
352080;201610;454;1301;274;890;53;183;101;299;154;482
352090;201610;1194;4122;940;3433;161;621;238;782;399;1403
352100;201610;2893;8741;2132;7233;566;2039;852;2685;1418;4724
352110;201610;508;1750;415;1539;105;407;151;528;256;935
352115;201610;483;1512;399;1344;52;168;241;799;293;967
352120;201610;903;2819;690;2389;113;445;360;1139;473;1584
352130;201610;1825;5250;1116;3676;277;935;236;714;513;1649
352140;201610;1767;5057;968;3263;161;569;360;1154;521;1723
352150;201610;790;2348;585;1928;159;549;266;851;425;1400
352160;201610;1016;2756;728;2209;154;500;243;640;397;1140
352170;201610;2759;8248;2351;7315;449;1486;1213;3523;1662;5009
352180;201610;3274;9257;2602;7855;650;2067;915;2594;1565;4661
352190;201610;1182;3493;893;2853;144;549;309;800;453;1349
352200;201610;373;1278;266;1018;44;187;97;347;141;534
352210;201610;16784;44837;13100;39065;2274;7152;7929;23560;10203;30712
352215;201610;544;1660;478;1540;62;223;290;898;352;1121
352220;201610;12750;40087;10015;34257;3310;11990;2345;7872;5655;19862
352230;201610;12695;42140;10352;37215;2872;11117;3436;11592;6308;22709
352240;201610;12398;35495;9153;29444;2643;9430;2750;7795;5393;17225
352250;201610;22851;72348;19041;64161;5826;20654;5932;19537;11758;40191
352260;201610;5318;14974;3208;10397;689;2434;1149;3358;1838;5792
352265;201610;867;2708;712;2416;65;281;470;1517;535;1798
352270;201610;1747;5954;1362;5023;340;1320;351;1257;691;2577
352280;201610;2239;6617;1708;5565;416;1489;659;1985;1075;3474
352290;201610;1168;3632;941;3102;192;750;372;1092;564;1842
352300;201610;1003;2878;700;2228;144;511;315;908;459;1419
352310;201610;43969;128307;33626;108978;9462;31432;15338;49198;24800;80630
352320;201610;5598;17022;4529;14719;1204;4093;1424;4132;2628;8225
352330;201610;1992;6271;1614;5662;517;1942;442;1491;959;3433
352340;201610;5332;16741;3764;13458;1038;3933;751;2427;1789;6360
352350;201610;1691;5649;1443;5072;249;997;532;1727;781;2724
352360;201610;1084;3279;934;2987;183;699;597;1781;780;2480
352370;201610;864;2913;743;2622;110;442;393;1315;503;1757
352380;201610;999;3129;811;2740;230;855;183;577;413;1432
352390;201610;19249;50503;11719;35835;2097;7198;5732;16109;7829;23307
352400;201610;3817;10826;2338;7773;688;2349;544;1663;1232;4012
352410;201610;2910;8725;2363;7724;543;1846;968;3020;1511;4866
352420;201610;904;2469;686;2041;159;485;294;831;453;1316
352430;201610;6427;18974;5073;16575;1741;6100;1475;4664;3216;10764
352440;201610;15766;47426;12039;39626;2832;9881;4571;14428;7403;24309
352450;201610;699;2133;430;1504;94;361;122;383;216;744
352460;201610;2367;7513;1833;6382;500;1882;515;1602;1015;3484
352470;201610;3540;9894;2338;7470;341;1204;1075;3147;1416;4351
352480;201610;4410;11877;3123;9366;669;2260;1187;3134;1856;5394
352490;201610;689;2384;516;1924;88;347;136;500;224;847
352500;201610;8750;24796;7160;22142;3563;11452;1467;3748;5030;15200
352510;201610;2973;9295;2258;7845;673;2495;553;1850;1226;4345
352520;201610;2016;7041;1709;6263;456;1768;653;2319;1109;4087
352530;201610;8567;27008;5826;20250;1475;5419;781;2209;2256;7628
352540;201610;507;1582;324;1129;54;187;100;339;154;526
352550;201610;862;2814;548;2050;134;541;114;367;248;908
352560;201610;652;1929;415;1364;66;211;99;281;165;492
352570;201610;1856;5971;1259;4583;297;1206;184;542;481;1748
352580;201610;874;2592;662;2144;140;474;232;676;372;1150
352585;201610;258;823;195;672;40;150;66;222;106;372
352590;201610;12616;38314;9717;32282;3249;11380;3509;10709;6758;22089
352600;201610;1823;5551;1426;4649;329;1139;574;1753;903;2892
352610;201610;3324;10142;2498;8522;665;2472;720;2273;1385;4745
352620;201610;5320;16031;4617;14817;1104;3650;2209;6908;3313;10558
352630;201610;671;2083;586;1869;126;455;238;690;364;1145
352640;201610;2729;8224;2167;7053;240;865;1304;4134;1544;4999
352650;201610;824;2449;533;1758;98;334;155;463;253;797
352660;201610;1070;3619;794;2964;163;671;212;772;375;1443
352670;201610;11214;33079;6037;21150;1422;5376;505;1606;1927;6982
352680;201610;2863;9449;2067;7531;470;1895;709;2296;1179;4191
352690;201610;31574;86173;21197;64674;3129;10411;11109;32038;14238;42449
352700;201610;615;1811;501;1618;142;512;201;596;343;1108
352710;201610;5416;15536;3730;11960;983;3406;1230;3646;2213;7052
352720;201610;7772;24826;6596;22001;2203;7437;1794;5784;3997;13221
352725;201610;430;1210;219;726;29;115;92;276;121;391
352730;201610;2303;7538;1990;6692;413;1483;742;2181;1155;3664
352740;201610;2186;5860;1616;4868;235;824;941;2651;1176;3475
352750;201610;478;1372;236;798;30;117;51;158;81;275
352760;201610;1225;4114;914;3274;299;1091;213;701;512;1792
352770;201610;785;2423;627;2071;136;488;244;750;380;1238
352780;201610;639;2125;471;1704;92;352;150;516;242;868
352790;201610;636;1812;419;1380;81;276;119;379;200;655
352800;201610;1069;3748;719;2755;163;665;205;698;368;1363
352810;201610;1185;3071;711;2123;141;433;220;612;361;1045
352820;201610;657;1768;434;1382;95;331;97;283;192;614
352830;201610;539;1543;278;905;47;171;40;105;87;276
352840;201610;3904;12981;3337;11702;947;3451;1280;4305;2227;7756
352850;201610;9780;28002;6983;23139;1885;6584;2424;7749;4309;14333
352860;201610;831;2775;729;2535;155;582;255;823;410;1405
352870;201610;958;2385;593;1628;72;259;324;761;396;1020
352880;201610;2378;6520;1592;4852;283;876;596;1662;879;2538
352885;201610;238;784;217;739;21;77;148;492;169;569
352890;201610;682;1776;434;1253;62;221;187;461;249;682
352900;201610;20146;58110;13638;44346;2847;9980;4893;14862;7740;24842
352910;201610;373;1072;196;656;20;70;42;126;62;196
352920;201610;2489;7418;1785;5871;354;1294;775;2331;1129;3625
352930;201610;5796;17812;4281;14346;954;3399;1302;4069;2256;7468
352940;201610;20933;66786;16257;55577;5166;18943;1561;4529;6727;23472
352950;201610;356;1036;203;732;52;217;30;89;82;306
352960;201610;635;1898;340;1183;51;191;87;268;138;459
352965;201610;377;1059;217;681;47;149;36;96;83;245
352970;201610;3254;8044;2534;6935;273;776;1743;4768;2016;5544
352980;201610;1041;3284;856;2965;181;629;480;1705;661;2334
352990;201610;4109;12635;3458;11415;906;3300;1422;4363;2328;7663
353000;201610;450;1275;216;715;26;86;41;125;67;211
353010;201610;3008;8239;2010;6235;475;1616;558;1496;1033;3112
353020;201610;4133;11180;2163;6761;395;1281;746;2040;1141;3321
353030;201610;3843;11246;2891;9315;814;2741;521;1583;1335;4324
353040;201610;562;1550;443;1320;106;346;141;387;247;733
353050;201610;4839;15969;3777;13533;1081;4022;1269;4320;2350;8342
353060;201610;40452;117325;33693;105171;3829;14036;23706;70142;27535;84178
353070;201610;10610;32499;7045;24484;1731;6330;1794;6136;3525;12466
353080;201610;5198;16214;3354;11975;767;2961;811;2657;1578;5618
353090;201610;551;1822;474;1630;43;176;290;924;333;1100
353100;201610;290;812;118;393;18;59;21;55;39;114
353110;201610;7623;23051;6373;20891;1291;4552;3723;12126;5014;16678
353120;201610;675;2006;405;1368;80;294;108;304;188;598
353130;201610;2534;7253;1917;6195;615;2099;591;1844;1206;3943
353140;201610;2388;6484;1730;5120;382;1205;789;2197;1171;3402
353150;201610;1666;4983;1269;4219;350;1178;340;1116;690;2294
353160;201610;666;1857;391;1262;83;276;84;229;167;505
353170;201610;429;1357;376;1275;102;433;178;537;280;970
353180;201610;8580;23999;6576;20347;1107;3663;3810;11467;4917;15130
353190;201610;3756;11205;2905;9239;507;1757;1505;4464;2012;6221
353200;201610;1058;3487;743;2648;215;831;181;579;396;1410
353205;201610;380;1222;325;1106;76;261;135;459;211;720
353210;201610;1012;2535;641;1846;33;115;425;1165;458;1280
353215;201610;406;1254;314;1039;49;185;109;301;158;486
353220;201610;664;2029;497;1650;133;452;113;347;246;799
353230;201610;787;2522;682;2303;164;608;197;602;361;1210
353240;201610;2097;6607;1756;5892;339;1260;923;2947;1262;4207
353250;201610;1092;2948;775;2304;108;356;381;1075;489;1431
353260;201610;909;2501;617;1919;102;353;216;629;318;982
353270;201610;657;1891;532;1638;104;322;216;632;320;954
353280;201610;608;1960;446;1563;112;420;92;295;204;715
353282;201610;1784;5588;1568;5123;235;825;914;2842;1149;3667
353284;201610;364;964;189;584;34;106;48;137;82;243
353286;201610;149;455;104;357;20;66;18;62;38;128
353290;201610;776;2383;594;2004;85;353;334;1027;419;1380
353300;201610;1463;4493;1139;3728;256;944;414;1197;670;2141
353310;201610;212;627;164;546;49;169;54;173;103;342
353320;201610;578;1630;454;1384;72;226;235;684;307;910
353325;201610;620;2006;450;1586;63;228;138;463;201;691
353330;201610;620;1744;406;1252;71;250;192;551;263;801
353340;201610;2821;8173;1778;6077;581;2050;444;1486;1025;3536
353350;201610;3267;9700;2387;7793;703;2428;652;1953;1355;4381
353360;201610;469;1528;415;1409;44;174;276;919;320;1093
353370;201610;641;2081;527;1804;62;244;293;950;355;1194
353380;201610;320;1048;241;868;41;166;79;270;120;436
353390;201610;5705;15479;3696;11642;772;2513;1316;3924;2088;6437
353400;201610;494;1503;370;1208;94;322;82;221;176;543
353410;201610;642;1859;498;1573;103;358;252;753;355;1111
353420;201610;592;1681;349;1072;105;320;84;240;189;560
353430;201610;2269;7530;1517;5592;390;1484;237;812;627;2296
353440;201610;59112;184631;44993;151565;12248;42562;15418;49871;27666;92433
353450;201610;426;1245;315;993;68;236;119;342;187;578
353460;201610;3322;9396;2442;7622;347;1199;1229;3815;1576;5014
353470;201610;8133;24228;5550;18756;1234;4557;1281;3915;2515;8472
353475;201610;1540;4358;1051;3212;182;608;350;943;532;1551
353480;201610;1463;4408;1279;4039;177;585;826;2547;1003;3132
353490;201610;979;2836;701;2202;157;505;243;730;400;1235
353500;201610;1025;2721;823;2373;237;701;404;1132;641;1833
353510;201610;998;3162;691;2362;154;548;128;391;282;939
353520;201610;1136;3223;818;2636;125;448;366;1110;491;1558
353530;201610;2549;7395;2075;6449;322;1128;1127;3324;1449;4452
353540;201610;1973;5961;1637;5337;427;1462;676;2128;1103;3590
353550;201610;6338;17397;4887;14785;509;1811;3143;8926;3652;10737
353560;201610;2046;6701;1597;5781;458;1803;386;1249;844;3052
353570;201610;470;1435;331;1072;83;269;142;426;225;695
353580;201610;2464;7184;2088;6499;353;1213;1296;3960;1649;5173
353590;201610;738;2133;498;1605;125;431;159;498;284;929
353600;201610;1776;4865;1457;4233;220;690;768;2121;988;2811
353610;201610;600;2020;419;1598;83;358;82;274;165;632
353620;201610;2245;7095;1756;6020;422;1495;483;1514;905;3009
353625;201610;390;1100;232;781;47;167;81;279;128;446
353630;201610;1497;5180;1104;4101;194;783;140;420;334;1203
353640;201610;1350;3977;965;3103;113;383;497;1553;610;1936
353650;201610;8202;23911;5571;18006;1081;3621;2183;6655;3264;10276
353657;201610;305;959;247;831;41;157;94;294;135;451
353660;201610;1070;2779;734;2132;295;908;82;152;377;1060
353670;201610;3643;11562;2972;10080;914;3442;988;3059;1902;6501
353680;201610;739;2327;589;2046;184;716;199;644;383;1360
353690;201610;523;1406;255;837;50;175;48;116;98;291
353700;201610;2042;6152;1687;5412;227;790;873;2629;1100;3419
353710;201610;3251;7800;1367;4479;347;1098;264;832;611;1930
353715;201610;504;1440;305;993;29;104;92;273;121;377
353720;201610;2040;6203;1635;5499;323;1279;837;2600;1160;3879
353730;201610;4572;13715;3312;10785;658;2346;1133;3327;1791;5673
353740;201610;1859;5494;1309;4318;354;1225;324;1012;678;2237
353750;201610;861;2872;605;2232;126;498;127;459;253;957
353760;201610;10172;27437;7979;24121;1162;4028;5103;14879;6265;18907
353770;201610;754;2349;357;1268;47;174;21;45;68;219
353780;201610;4199;14386;3501;12850;1079;4126;939;3381;2018;7507
353790;201610;2185;7388;1686;6280;465;1963;385;1335;850;3298
353800;201610;16421;49565;12260;41364;3228;11624;4489;14554;7717;26178
353810;201610;1020;3231;723;2541;136;533;232;776;368;1309
353820;201610;1402;4643;1176;4070;231;920;593;1881;824;2801
353830;201610;676;1803;508;1517;87;274;272;775;359;1049
353850;201610;1701;5248;1413;4646;363;1232;531;1683;894;2915
353860;201610;2520;8286;1995;7022;567;2103;490;1636;1057;3739
353870;201610;28153;80872;17964;59238;3471;12402;6309;18522;9780;30924
353880;201610;2726;8555;2193;7495;287;1123;1225;4082;1512;5205
353890;201610;2674;6514;1721;4885;289;883;872;2320;1161;3203
353900;201610;979;2999;662;2320;136;524;178;583;314;1107
353910;201610;1245;4232;1117;3973;295;1072;590;2111;885;3183
353920;201610;2294;6670;1419;4725;325;1191;265;735;590;1926
353930;201610;4529;13558;2927;10310;751;2833;512;1735;1263;4568
353940;201610;1211;3823;846;2939;159;583;274;863;433;1446
353950;201610;3238;10212;2726;9065;556;1983;1328;4131;1884;6114
353960;201610;616;1919;428;1465;92;330;93;287;185;617
353970;201610;582;1683;458;1452;51;174;280;878;331;1052
353980;201610;13324;39403;10826;34292;2424;7997;5180;15756;7604;23753
353990;201610;374;1154;318;1024;41;158;173;527;214;685
354000;201610;2245;6208;1255;4087;249;862;132;395;381;1257
354010;201610;376;1119;300;979;58;188;169;555;227;743
354020;201610;4241;13252;3426;11337;891;3126;1008;3014;1899;6140
354025;201610;871;2443;605;1929;111;367;222;690;333;1057
354030;201610;492;1347;302;967;46;165;130;388;176;553
354040;201610;786;2114;495;1507;54;169;283;805;337;974
354050;201610;957;3003;723;2490;185;674;145;470;330;1144
354060;201610;4913;15148;3185;11037;864;3075;767;2462;1631;5537
354070;201610;2847;9420;2240;7900;560;2099;408;1335;968;3434
354075;201610;1963;7127;1743;6593;497;2007;698;2556;1195;4563
354080;201610;1547;4689;999;3417;195;681;281;883;476;1564
354085;201610;335;834;295;772;12;46;250;640;262;686
354090;201610;1364;4015;1245;3788;159;547;837;2490;996;3037
354100;201610;14800;48759;11572;42068;3046;11774;4685;16531;7731;28305
354105;201610;905;2645;766;2417;120;410;513;1582;633;1992
354110;201610;732;1988;541;1701;183;629;98;248;281;877
354120;201610;1915;5271;1362;4161;237;786;588;1672;825;2458
354130;201610;6336;18088;4343;13973;1577;5278;398;1054;1975;6332
354140;201610;26420;66215;14788;44067;3367;10466;4374;11848;7741;22314
354150;201610;3887;10412;2768;8261;492;1583;1316;3742;1808;5325
354160;201610;3499;11279;2663;9246;678;2458;924;3057;1602;5515
354165;201610;487;1630;392;1417;105;414;135;485;240;899
354170;201610;1420;4418;1049;3526;199;745;430;1313;629;2058
354180;201610;476;1439;390;1236;54;201;192;521;246;722
354190;201610;1587;4959;1233;4179;306;1116;396;1262;702;2378
354200;201610;998;2794;724;2238;95;308;332;935;427;1243
354210;201610;639;2009;504;1721;75;315;256;792;331;1107
354220;201610;2958;8492;2341;7287;508;1642;1076;3244;1584;4886
354230;201610;645;2084;534;1816;91;347;252;809;343;1156
354240;201610;1258;4101;868;3145;166;638;191;660;357;1298
354250;201610;674;1908;428;1456;137;496;109;385;246;881
354260;201610;7476;22150;5869;19076;1622;5515;2009;6369;3631;11884
354270;201610;1161;3838;902;3208;190;726;302;1025;492;1751
354280;201610;704;2069;620;1913;107;403;403;1150;510;1553
354290;201610;932;3239;789;2882;188;729;302;1101;490;1830
354300;201610;3686;11962;3366;11277;999;3429;1535;4989;2534;8418
354310;201610;858;2602;658;2182;139;478;324;1054;463;1532
354320;201610;738;2205;573;1861;134;497;190;547;324;1044
354323;201610;467;1281;316;965;64;202;111;292;175;494
354325;201610;1202;3914;870;3087;176;651;305;993;481;1644
354330;201610;6673;19689;5054;16310;1144;4017;2268;6735;3412;10752
354340;201610;24700;74478;19104;64045;5406;19337;7018;22587;12424;41924
354350;201610;1045;3066;901;2752;223;760;473;1318;696;2078
354360;201610;446;1406;231;871;31;108;11;41;42;149
354370;201610;1137;3788;919;3292;103;450;525;1803;628;2253
354380;201610;854;2533;631;2096;190;730;108;279;298;1009
354390;201610;13546;38927;8248;27895;1714;6101;1580;5050;3294;11151
354400;201610;1580;5433;1206;4452;253;985;360;1309;613;2294
354410;201610;5414;16484;4208;13991;1063;3766;1648;5242;2711;9008
354420;201610;1207;3563;842;2709;208;714;323;1015;531;1729
354425;201610;2390;6735;1906;5787;591;1871;463;1385;1054;3256
354430;201610;1359;4366;1158;3914;240;896;489;1575;729;2471
354440;201610;530;1592;355;1183;42;142;145;454;187;596
354450;201610;411;1161;215;706;36;134;42;115;78;249
354460;201610;990;2758;635;2026;155;534;243;742;398;1276
354470;201610;579;1553;414;1206;41;150;219;564;260;714
354480;201610;775;2132;594;1795;77;248;360;1032;437;1280
354490;201610;724;2402;544;1949;64;251;256;878;320;1129
354500;201610;2176;6933;1827;6286;637;2379;380;1285;1017;3664
354510;201610;832;2268;719;2055;96;229;467;1351;563;1580
354515;201610;274;896;198;712;39;150;77;262;116;412
354520;201610;7861;25300;4199;14637;851;3324;1729;5494;2580;8818
354530;201610;3125;10582;2632;9447;696;2671;1069;3710;1765;6381
354540;201610;1196;3581;955;3133;318;1112;161;496;479;1608
354550;201610;473;1391;377;1195;79;267;177;522;256;789
354560;201610;1692;4698;892;2841;153;483;412;1214;565;1697
354570;201610;1064;2993;445;1454;72;259;72;205;144;464
354580;201610;10861;30258;7035;22694;1300;4490;2711;8104;4011;12594
354600;201610;1612;5194;1336;4629;256;1053;673;2185;929;3238
354610;201610;398;1138;220;713;26;84;71;208;97;292
354620;201610;403;1291;296;1080;61;270;134;467;195;737
354625;201610;292;906;171;613;25;89;45;135;70;224
354630;201610;2106;6922;1760;6135;697;2575;230;724;927;3299
354640;201610;3412;11086;2400;8625;491;1959;466;1443;957;3402
354650;201610;889;2591;738;2278;86;297;490;1492;576;1789
354660;201610;2439;6795;1701;5438;208;749;1021;3155;1229;3904
354670;201610;1292;4023;937;3151;233;857;214;615;447;1472
354680;201610;4409;14238;3855;13058;1022;3629;1686;5573;2708;9202
354690;201610;759;2428;441;1597;84;319;122;415;206;734
354700;201610;1142;3201;718;2231;152;552;296;780;448;1332
354710;201610;518;1540;356;1150;44;167;163;463;207;630
354720;201610;253;679;132;420;37;115;22;64;59;179
354730;201610;8647;27061;6129;21794;1314;5030;2682;9089;3996;14119
354740;201610;251;766;121;441;17;71;19;67;36;138
354750;201610;2285;7060;1714;5808;444;1660;603;1887;1047;3547
354760;201610;1964;6168;1478;5063;444;1591;189;631;633;2222
354765;201610;301;849;117;403;16;57;17;50;33;107
354770;201610;2370;6538;1684;5282;608;1956;462;1387;1070;3343
354780;201610;52835;146294;42091;122920;6739;21758;23330;63516;30069;85274
354790;201610;813;2666;709;2435;115;417;370;1215;485;1632
354800;201610;2186;6292;1833;5754;431;1492;886;2656;1317;4148
354805;201610;1014;3029;664;2219;67;236;179;511;246;747
354810;201610;568;1819;309;1158;51;211;51;146;102;357
354820;201610;962;3272;760;2795;150;609;171;549;321;1158
354830;201610;420;1148;305;932;86;270;118;325;204;595
354840;201610;676;1926;507;1594;115;355;230;710;345;1065
354850;201610;17142;51739;11860;40547;2478;9308;5159;16024;7637;25332
354860;201610;1373;4259;1125;3794;238;902;408;1258;646;2160
354870;201610;46864;135776;39597;120255;8646;28040;18069;52979;26715;81019
354880;201610;4299;11798;2164;7016;341;1293;719;1907;1060;3200
354890;201610;16530;47337;13023;40624;2867;9528;5537;16431;8404;25959
354900;201610;452;1375;308;1032;67;247;71;218;138;465
354910;201610;6350;18863;3256;11824;604;2378;166;545;770;2923
354920;201610;415;1209;245;855;44;174;62;200;106;374
354925;201610;318;940;173;596;27;98;30;91;57;189
354930;201610;316;787;164;517;25;82;73;219;98;301
354940;201610;1860;6568;1405;5324;470;1879;141;474;611;2353
354950;201610;1478;4620;1183;4059;141;616;664;2162;805;2778
354960;201610;784;2397;659;2173;133;493;284;883;417;1376
354970;201610;3907;12663;3246;11220;566;2226;1736;5714;2302;7940
354980;201610;33435;82882;18568;56651;3258;10981;7024;19465;10282;30446
354990;201610;54158;155191;39965;126192;6922;23387;20062;60394;26984;83781
354995;201610;1764;5296;1428;4717;354;1200;694;2248;1048;3448
355000;201610;1439;4543;1188;4017;318;1215;232;651;550;1866
355010;201610;3630;11052;2652;8724;782;2719;661;2170;1443;4889
355020;201610;2951;9653;2130;7851;797;3184;462;1582;1259;4766
355030;201610;1149845;3092829;909579;2607155;202915;624967;401160;1083907;604075;1708874
355040;201610;2618;7923;2243;7228;444;1497;1318;4144;1762;5641
355050;201610;1151;3483;856;2845;259;849;139;451;398;1300
355060;201610;4502;14786;3454;12455;728;2933;1104;3598;1832;6531
355070;201610;6650;20255;5611;18361;1165;4299;2735;8289;3900;12588
355080;201610;959;3249;625;2425;92;402;40;139;132;541
355090;201610;1122;3789;889;3245;172;659;341;1206;513;1865
355100;201610;18293;55718;14475;48810;3834;13956;6651;21606;10485;35562
355110;201610;1190;3829;963;3362;284;1076;190;601;474;1677
355120;201610;637;1968;480;1631;92;371;181;560;273;931
355130;201610;637;1617;264;786;40;121;90;240;130;361
355140;201610;1144;3765;1053;3585;223;850;578;1978;801;2828
355150;201610;3487;10046;2761;8757;578;1887;1333;4178;1911;6065
355160;201610;1698;5258;1301;4511;396;1470;342;1142;738;2612
355170;201610;8572;24009;6229;19855;2121;7088;1631;5269;3752;12357
355180;201610;2853;8742;2198;7434;543;2150;693;2079;1236;4229
355190;201610;1436;4486;1176;3940;382;1431;335;1168;717;2599
355200;201610;813;2837;705;2572;288;1125;155;515;443;1640
355210;201610;2763;8557;2341;7620;344;1332;1406;4309;1750;5641
355220;201610;36001;107309;27485;89277;9177;31218;6708;19776;15885;50994
355230;201610;1391;3779;683;2176;137;425;178;492;315;917
355240;201610;25275;71867;16150;52204;3639;12209;5237;16216;8876;28425
355250;201610;28492;88424;22628;76402;6452;23005;7962;25975;14414;48980
355255;201610;878;2402;484;1550;98;317;136;417;234;734
355260;201610;1260;3662;1027;3219;213;757;443;1243;656;2000
355270;201610;1631;4846;1377;4282;177;600;860;2559;1037;3159
355280;201610;26555;76390;20028;62965;3763;12920;8743;25888;12506;38808
355290;201610;937;2941;704;2355;147;491;216;663;363;1154
355300;201610;1245;3975;938;3291;209;758;304;1014;513;1772
355310;201610;1065;3126;776;2566;136;488;420;1359;556;1847
355320;201610;597;1813;486;1566;85;334;195;529;280;863
355330;201610;1943;5890;1328;4584;293;1106;567;1843;860;2949
355340;201610;2612;6689;2261;6088;381;1016;1383;3649;1764;4665
355350;201610;1339;4431;1006;3646;249;948;267;929;516;1877
355360;201610;1203;3795;1010;3356;200;679;608;2081;808;2760
355365;201610;325;944;198;706;51;180;44;152;95;332
355370;201610;7647;18680;5267;15470;1584;4960;2015;6127;3599;11087
355380;201610;3270;9676;2352;7582;516;1737;536;1479;1052;3216
355385;201610;970;3095;814;2755;270;965;221;678;491;1643
355390;201610;860;2480;595;1895;140;496;215;571;355;1067
355395;201610;1855;5652;1228;4130;193;627;563;1788;756;2415
355400;201610;9091;29622;7490;26076;2244;8341;2064;6722;4308;15063
355410;201610;17713;56172;13045;46158;3984;15201;2433;8425;6417;23626
355420;201610;741;2583;643;2367;196;798;170;608;366;1406
355430;201610;3559;9824;2814;8451;573;1804;1349;3906;1922;5710
355440;201610;957;2906;638;2149;114;381;181;555;295;936
355450;201610;3806;10829;1999;6634;392;1352;617;1888;1009;3240
355460;201610;604;1623;380;1202;79;299;118;297;197;596
355465;201610;344;1093;262;906;53;186;67;221;120;407
355470;201610;792;2362;593;1978;148;519;237;752;385;1271
355475;201610;166;547;152;506;37;131;72;219;109;350
355480;201610;2900;9933;2560;9212;584;2242;1210;4231;1794;6473
355490;201610;1009;2869;601;1960;93;294;185;575;278;869
355495;201610;741;2480;617;2202;127;492;171;565;298;1057
355500;201610;7563;21820;4418;14623;797;2788;821;2473;1618;5261
355510;201610;1966;5239;1014;3233;146;550;298;821;444;1371
355520;201610;431;1003;198;535;25;81;91;212;116;293
355530;201610;431;1041;152;498;24;85;39;106;63;191
355535;201610;673;2041;505;1693;167;592;107;295;274;887
355540;201610;8279;25702;7660;24607;1927;6598;4003;12401;5930;18999
355550;201610;744;2273;573;1922;105;386;254;821;359;1207
355560;201610;1255;3773;685;2382;130;505;60;153;190;658
355570;201610;196;618;106;391;17;65;9;37;26;102
355580;201610;1279;3517;789;2506;138;488;325;994;463;1482
355590;201610;226;595;169;489;25;85;96;259;121;344
355600;201610;1180;3565;916;2982;282;970;288;877;570;1847
355610;201610;1672;4578;1175;3585;222;715;535;1564;757;2279
355620;201610;4241;13145;3207;10675;522;1980;1515;4610;2037;6590
355630;201610;3269;9260;1913;6389;408;1418;518;1714;926;3132
355635;201610;946;3048;789;2764;93;350;540;1913;633;2263
355640;201610;3083;9731;2074;7497;424;1670;319;1097;743;2767
355645;201610;3595;11855;3051;10903;500;1971;1808;6329;2308;8300
355650;201610;7725;22750;6408;20112;1225;4419;3819;11065;5044;15484
355660;201610;1280;4027;947;3270;163;660;424;1352;587;2012
355670;201610;3012;9230;1936;6611;356;1359;823;2463;1179;3822
355680;201610;1722;5622;1157;4162;302;1164;167;584;469;1748
355690;201610;481;1510;328;1191;149;554;18;51;167;605
355695;201610;287;895;131;457;11;41;10;23;21;64
355700;201610;5575;18135;4520;15642;1146;4041;1738;5835;2884;9876
355710;201610;10339;25696;5629;16649;1302;4011;1458;4021;2760;8032
355715;201610;317;950;193;661;53;196;33;103;86;299
355720;201610;1552;5088;1190;4195;293;1093;370;1133;663;2226
355730;201610;853;2777;690;2380;224;773;171;582;395;1355
410010;201610;1398;4295;1117;3627;238;824;219;682;457;1506
410020;201610;1153;3712;940;3207;274;950;336;1127;610;2077
410030;201610;1102;3721;835;3052;222;827;146;530;368;1357
410040;201610;10089;32584;8245;28759;1910;7304;2524;8536;4434;15840
410045;201610;1027;2853;654;2088;156;521;142;401;298;922
410050;201610;2566;6999;1429;4637;416;1394;89;213;505;1607
410060;201610;2296;6909;1878;6041;413;1354;787;2525;1200;3879
410070;201610;1777;4959;1249;3879;368;1230;314;911;682;2141
410080;201610;1394;3913;1010;3140;171;600;444;1276;615;1876
410090;201610;1002;3062;870;2768;186;659;357;1130;543;1789
410100;201610;2709;8202;1754;5846;392;1419;187;544;579;1963
410105;201610;375;1169;209;744;36;155;30;86;66;241
410110;201610;2872;8304;2079;6643;336;1142;680;2101;1016;3243
410115;201610;538;1444;376;1122;64;214;129;338;193;552
410120;201610;2507;8524;2241;7979;832;3129;615;2160;1447;5289
410130;201610;1069;3330;940;3013;404;1353;217;615;621;1968
410140;201610;17763;45746;10466;31960;2255;7336;2606;7377;4861;14713
410150;201610;16317;41191;7469;22688;1552;4922;1203;3298;2755;8220
410160;201610;3068;9340;2603;8450;687;2462;892;2881;1579;5343
410165;201610;681;1987;509;1570;93;306;234;654;327;960
410170;201610;2344;6663;1583;4928;484;1642;217;613;701;2255
410180;201610;11607;36215;9417;31016;2037;7228;4094;12442;6131;19670
410185;201610;541;1487;370;1138;84;257;72;188;156;445
410190;201610;2104;6153;1516;4776;299;1010;271;756;570;1766
410200;201610;3941;10908;2470;7853;574;2021;356;1036;930;3057
410210;201610;2694;7861;1778;5746;284;1060;402;1053;686;2113
410220;201610;662;1798;432;1355;80;287;152;452;232;739
410230;201610;1476;4575;1195;3958;271;1016;486;1538;757;2554
410240;201610;4441;13252;3726;11741;1184;4135;551;1568;1735;5703
410250;201610;2677;7345;1668;5229;397;1281;320;946;717;2227
410260;201610;1617;4627;1230;3912;280;960;493;1558;773;2518
410270;201610;573;1587;407;1227;42;137;218;640;260;777
410275;201610;865;2568;531;1777;79;277;229;758;308;1035
410280;201610;2277;6506;1493;4800;347;1246;410;1178;757;2424
410290;201610;3422;10151;2682;8675;699;2263;991;3226;1690;5489
410300;201610;726;2023;570;1687;105;348;248;635;353;983
410302;201610;458;1221;248;811;30;109;130;422;160;531
410304;201610;1248;3903;1085;3534;291;991;387;1292;678;2283
410305;201610;1893;5109;1450;4283;344;1080;703;2035;1047;3115
410310;201610;2326;7330;1946;6578;416;1541;708;2354;1124;3895
410315;201610;662;1870;363;1238;58;208;110;340;168;548
410320;201610;1209;3671;673;2358;104;412;63;190;167;602
410322;201610;548;1593;287;969;44;144;81;264;125;408
410330;201610;1407;3866;1034;3092;231;696;268;793;499;1489
410335;201610;950;2859;778;2505;131;454;303;922;434;1376
410337;201610;825;2188;554;1648;76;260;195;528;271;788
410340;201610;542;1554;326;972;43;143;148;390;191;533
410345;201610;1904;5512;1206;3918;308;1049;277;858;585;1907
410347;201610;720;1947;442;1384;61;222;146;407;207;629
410350;201610;1063;3149;710;2385;142;527;153;437;295;964
410360;201610;3872;10419;2814;8402;384;1284;1484;4214;1868;5498
410370;201610;12261;35688;8132;25587;1481;5114;2388;6421;3869;11535
410380;201610;1354;3884;1166;3491;131;468;592;1724;723;2192
410390;201610;2464;7375;1843;5947;564;1871;395;1158;959;3029
410395;201610;870;2857;744;2578;202;768;300;1020;502;1788
410400;201610;4516;13864;3403;11305;702;2491;1216;3803;1918;6294
410405;201610;863;2458;657;2054;162;571;218;636;380;1207
410410;201610;1262;3881;1192;3769;312;1213;540;1566;852;2779
410420;201610;7103;22779;5360;18514;1317;4890;738;2168;2055;7058
410425;201610;2817;8846;1778;6341;328;1198;216;677;544;1875
410430;201610;14438;38534;9461;28762;1863;6128;2711;7632;4574;13760
410440;201610;2733;8620;2323;7771;607;2204;905;2917;1512;5121
410442;201610;2728;8938;2285;7892;705;2519;619;2092;1324;4611
410445;201610;2354;7592;1884;6631;550;2104;577;2033;1127;4137
410450;201610;2114;5933;1477;4530;383;1190;149;329;532;1519
410460;201610;1829;5352;1311;4235;380;1227;242;740;622;1967
410465;201610;2151;6986;1690;5898;414;1498;574;1879;988;3377
410470;201610;1809;5734;1292;4495;300;1178;236;778;536;1956
410480;201610;31553;87996;16712;54982;3101;10581;1681;4513;4782;15094
410490;201610;11297;34408;7968;26958;1890;7007;2209;6749;4099;13756
410500;201610;1574;4888;1158;3890;429;1584;153;425;582;2009
410510;201610;2519;6596;1550;4533;309;864;569;1542;878;2406
410520;201610;3137;10675;2856;10042;816;3010;1197;4215;2013;7225
410530;201610;1597;4372;950;2904;182;589;229;614;411;1203
410540;201610;3159;9244;2052;6777;400;1345;651;2101;1051;3446
410550;201610;6277;18146;3936;12799;773;2742;541;1560;1314;4302
410560;201610;1293;3790;908;2912;236;848;245;667;481;1515
410570;201610;2665;8265;2206;7381;574;2083;610;2182;1184;4265
410580;201610;22234;66007;17002;55019;4066;14319;5284;15646;9350;29965
410590;201610;1377;4234;737;2456;134;449;170;476;304;925
410600;201610;1868;5379;1409;4430;367;1139;472;1485;839;2624
410610;201610;777;2156;556;1705;63;193;215;629;278;822
410620;201610;1745;5831;1178;4362;270;1068;115;398;385;1466
410630;201610;2492;7313;1536;5046;322;1125;182;457;504;1582
410640;201610;4661;12743;3120;9656;820;2855;468;1282;1288;4137
410645;201610;1130;3872;1027;3681;464;1734;205;774;669;2508
410650;201610;2141;6579;1599;5340;522;1829;229;705;751;2534
410655;201610;851;2375;565;1783;90;332;202;572;292;904
410657;201610;774;2136;505;1550;146;483;150;387;296;870
410660;201610;3016;8458;1468;4848;313;1068;164;479;477;1547
410670;201610;973;2653;592;1832;118;370;199;575;317;945
410680;201610;2932;9436;2181;7533;681;2286;493;1804;1174;4090
410685;201610;661;1890;534;1649;79;277;299;877;378;1154
410690;201610;118596;337117;75324;241861;15290;52992;18351;50697;33641;103689
410700;201610;2240;6630;1956;6037;521;1671;794;2322;1315;3993
410710;201610;932;2693;560;1841;130;422;125;347;255;769
410712;201610;831;2470;700;2214;270;935;155;477;425;1412
410715;201610;912;2891;617;2147;118;437;158;513;276;950
410720;201610;3197;9470;2048;6824;399;1424;379;1096;778;2520
410725;201610;1120;3114;693;2225;115;360;117;331;232;691
410730;201610;522;1463;376;1191;107;355;79;258;186;613
410740;201610;896;2642;589;1990;103;404;249;804;352;1208
410750;201610;1833;5315;1404;4366;286;960;447;1282;733;2242
410752;201610;327;891;152;495;34;123;46;127;80;250
410753;201610;393;1129;214;701;30;115;60;166;90;281
410754;201610;1152;3298;940;2916;71;204;598;1998;669;2202
410755;201610;821;2001;582;1595;75;243;347;877;422;1120
410760;201610;2517;7451;2010;6453;567;1968;568;1744;1135;3712
410765;201610;15171;45264;10304;34888;1654;6119;863;2718;2517;8837
410770;201610;917;2522;582;1815;149;499;100;298;249;797
410773;201610;1372;3873;1185;3568;174;617;823;2390;997;3007
410775;201610;1445;4115;1262;3795;307;998;436;1277;743;2275
410780;201610;556;1506;342;1048;97;288;101;354;198;642
410785;201610;768;2390;585;1945;198;694;142;459;340;1153
410790;201610;441;1436;344;1165;93;319;23;57;116;376
410800;201610;2870;7125;2035;5619;348;1079;721;1807;1069;2886
410810;201610;329;1015;253;844;49;187;94;304;143;491
410820;201610;845;2515;583;1892;140;491;85;262;225;753
410830;201610;30609;86103;22768;71249;6569;22322;7221;21308;13790;43630
410832;201610;1028;2944;834;2549;99;369;475;1327;574;1696
410840;201610;6446;18636;3590;12131;839;2893;291;778;1130;3671
410845;201610;1242;3631;988;3086;206;691;391;1165;597;1856
410850;201610;2702;8019;2271;7207;530;1838;855;2701;1385;4539
410855;201610;597;1634;397;1193;65;204;146;394;211;598
410860;201610;3683;10490;2676;8297;555;1824;826;2387;1381;4211
410865;201610;1499;4970;1392;4767;362;1321;750;2597;1112;3918
410870;201610;1274;3741;1132;3510;145;468;787;2454;932;2922
410880;201610;3828;11969;2853;9801;575;2123;446;1458;1021;3581
410890;201610;930;3012;659;2364;171;667;72;228;243;895
410895;201610;1088;3719;925;3322;339;1308;189;623;528;1931
410900;201610;962;2628;584;1850;93;321;167;473;260;794
410910;201610;411;1074;279;818;31;104;143;395;174;499
410920;201610;844;2346;634;1966;176;613;200;604;376;1217
410930;201610;1641;4830;1270;4044;367;1336;319;931;686;2267
410940;201610;21330;67346;16643;57679;5114;18838;3302;11279;8416;30117
410950;201610;1834;5837;1653;5503;169;595;1238;4103;1407;4698
410960;201610;7601;20720;4351;14329;1319;4667;906;2735;2225;7402
410965;201610;1066;3126;781;2514;213;700;264;790;477;1490
410970;201610;4586;13357;3288;10671;912;3346;515;1565;1427;4911
410975;201610;1630;4558;1193;3687;224;777;431;1243;655;2020
410980;201610;6002;16749;3494;11414;639;2310;985;3001;1624;5311
410990;201610;936;2719;496;1703;177;662;59;145;236;807
411000;201610;478;1417;282;953;53;191;59;154;112;345
411005;201610;487;1439;265;888;45;170;39;114;84;284
411007;201610;2368;7312;1938;6352;530;1830;546;1745;1076;3575
411010;201610;4037;13587;3395;11969;941;3515;383;1296;1324;4811
411020;201610;2544;7697;2115;6911;646;2289;612;1889;1258;4178
411030;201610;686;1825;444;1327;73;248;131;354;204;602
411040;201610;732;2111;294;989;61;217;57;188;118;405
411050;201610;2028;6918;1707;6117;484;1895;239;738;723;2633
411060;201610;1620;4820;1074;3576;220;819;150;445;370;1264
411065;201610;367;1090;274;900;49;153;103;336;152;489
411070;201610;6014;17708;4427;14282;1165;4108;1103;3162;2268;7270
411080;201610;2177;6418;1814;5663;437;1475;490;1499;927;2974
411090;201610;849;2116;525;1562;58;198;94;247;152;445
411095;201610;1390;3891;870;2727;116;419;216;585;332;1004
411100;201610;1316;3787;847;2725;173;653;142;411;315;1064
411110;201610;605;1764;275;940;31;124;25;69;56;193
411120;201610;1653;4948;1135;3723;302;1139;298;830;600;1969
411125;201610;4351;13991;3918;13024;1084;3739;1444;4725;2528;8464
411130;201610;700;2060;486;1577;110;372;127;443;237;815
411140;201610;2217;7460;1781;6368;433;1610;693;2504;1126;4114
411150;201610;4180;11713;2861;8881;651;2167;354;922;1005;3089
411155;201610;971;2663;631;1950;83;284;281;812;364;1096
411160;201610;271;779;190;604;36;119;50;154;86;273
411170;201610;740;2313;572;1910;126;459;185;577;311;1036
411180;201610;5806;17074;4405;14215;972;3420;1447;4552;2419;7972
411190;201610;1458;4164;1115;3436;271;942;240;634;511;1576
411200;201610;4381;12854;3288;10796;873;3067;918;2834;1791;5901
411210;201610;2041;5719;1415;4458;354;1219;177;464;531;1683
411220;201610;1120;3130;842;2590;202;703;321;879;523;1582
411230;201610;1270;3518;755;2454;140;473;267;846;407;1319
411240;201610;1479;3549;737;2179;127;388;275;738;402;1126
411250;201610;2198;6399;1700;5408;474;1637;433;1369;907;3006
411260;201610;331;875;198;621;20;64;93;271;113;335
411270;201610;1808;5567;1490;4890;250;901;673;2070;923;2971
411275;201610;1354;3934;993;3110;237;758;219;621;456;1379
411280;201610;1583;4543;959;3142;177;608;200;611;377;1219
411290;201610;766;2236;543;1738;136;457;146;445;282;902
411295;201610;978;2686;837;2398;136;422;338;977;474;1399
411300;201610;1169;2973;689;1996;60;174;298;780;358;954
411310;201610;879;2363;598;1829;55;183;207;617;262;800
411320;201610;5402;15573;3598;11807;977;3257;613;1830;1590;5087
411325;201610;1526;4737;1281;4196;280;966;589;1947;869;2913
411330;201610;3129;9602;2470;8192;811;2940;548;1827;1359;4767
411340;201610;952;2790;548;1808;53;206;206;641;259;847
411342;201610;745;2073;572;1709;169;527;189;515;358;1042
411345;201610;914;2799;795;2557;191;692;357;1117;548;1809
411350;201610;2801;8281;1864;6241;520;1895;176;533;696;2428
411360;201610;564;1408;329;976;46;162;140;355;186;517
411370;201610;46634;129883;34190;105128;5257;18349;15203;42800;20460;61149
411373;201610;1506;4557;1195;3932;247;921;320;1025;567;1946
411375;201610;1134;3071;748;2272;146;463;221;629;367;1092
411380;201610;1254;3376;638;1922;135;403;171;469;306;872
411390;201610;1780;5190;1274;3995;269;896;318;906;587;1802
411400;201610;2189;6116;1567;4773;331;1091;443;1260;774;2351
411410;201610;2079;6263;1434;4669;325;1149;339;941;664;2090
411420;201610;4130;11564;2478;7902;386;1361;409;1035;795;2396
411430;201610;3348;9855;2659;8615;640;2263;1287;4017;1927;6280
411435;201610;438;1429;349;1187;72;257;136;423;208;680
411440;201610;2745;8676;2243;7536;674;2355;477;1678;1151;4033
411450;201610;2336;7043;2030;6414;421;1344;935;3070;1356;4414
411460;201610;3346;9702;1524;5374;244;943;92;290;336;1233
411470;201610;821;2441;492;1646;80;289;81;230;161;519
411480;201610;4627;13805;3118;10536;762;2815;430;1294;1192;4109
411490;201610;1456;4403;1140;3746;222;770;271;818;493;1588
411500;201610;1859;4925;1220;3730;239;807;365;1083;604;1890
411510;201610;2051;6035;1485;4782;406;1428;254;742;660;2170
411520;201610;27301;73686;14662;46122;2647;8846;3281;9259;5928;18105
411530;201610;1015;2801;646;2073;144;522;139;392;283;914
411535;201610;521;1575;219;791;25;116;16;37;41;153
411540;201610;3037;8156;2007;5978;447;1457;591;1542;1038;2999
411545;201610;998;3214;863;2935;133;468;538;1873;671;2341
411550;201610;802;2149;576;1728;185;594;106;309;291;903
411560;201610;2380;6962;1425;4652;224;782;124;329;348;1111
411570;201610;7097;18647;4832;14767;1179;3979;1044;3174;2223;7153
411573;201610;871;2534;792;2398;119;357;482;1476;601;1833
411575;201610;1642;5038;1297;4277;333;1126;398;1290;731;2416
411580;201610;4047;11477;2315;7675;297;1144;302;785;599;1929
411585;201610;775;2447;354;1249;74;255;56;177;130;432
411590;201610;380;1147;311;1006;46;170;138;407;184;577
411600;201610;318;892;208;702;47;184;78;257;125;441
411605;201610;1729;4699;1075;3269;167;575;409;1185;576;1760
411610;201610;2217;6203;1662;5064;349;1138;687;2003;1036;3141
411620;201610;2854;8751;2492;8132;592;2097;1226;3945;1818;6042
411630;201610;543;1431;330;1094;65;267;48;120;113;387
411640;201610;466;1420;336;1095;46;135;110;328;156;463
411650;201610;204;652;143;515;28;113;24;78;52;191
411660;201610;906;2406;619;1843;94;306;298;853;392;1159
411670;201610;1147;3201;842;2488;172;540;291;811;463;1351
411680;201610;1494;4399;1236;3892;255;891;598;1857;853;2748
411690;201610;3431;9936;2482;8030;677;2210;576;1947;1253;4157
411695;201610;804;2575;580;2044;125;467;184;653;309;1120
411700;201610;1735;4944;1089;3556;227;798;154;440;381;1238
411705;201610;1886;6464;1600;5857;385;1379;764;2963;1149;4342
411710;201610;1749;5091;1240;3957;352;1168;199;626;551;1794
411720;201610;922;2584;634;1970;108;366;178;490;286;856
411721;201610;774;2271;574;1838;148;476;70;207;218;683
411722;201610;677;2034;406;1379;83;308;98;285;181;593
411725;201610;1422;4488;773;2799;177;663;139;498;316;1161
411727;201610;1817;5289;1185;3825;319;1046;212;658;531;1704
411729;201610;620;1599;390;1149;118;350;80;188;198;538
411730;201610;5434;15544;4271;13191;1486;4603;989;2995;2475;7598
411740;201610;649;1836;355;1159;57;208;89;254;146;462
411745;201610;899;2564;666;2050;134;421;208;615;342;1036
411750;201610;5022;14781;3549;11402;664;2234;1186;3590;1850;5824
411760;201610;7888;22840;6263;19730;2006;6586;1407;4476;3413;11062
411770;201610;3459;11191;2640;9211;757;2786;434;1434;1191;4220
411780;201610;2907;8800;2561;8189;587;1989;1365;4498;1952;6487
411790;201610;3409;9542;2063;6603;526;1808;453;1366;979;3174
411800;201610;1167;3351;681;2200;112;396;94;248;206;644
411810;201610;1737;4915;1357;4136;280;923;512;1421;792;2344
411820;201610;13913;44367;11092;38145;3846;13578;2449;8509;6295;22087
411830;201610;525;1341;302;921;100;324;12;44;112;368
411840;201610;10684;30223;7138;22802;1667;5690;1382;4335;3049;10025
411845;201610;517;1581;273;925;49;181;31;90;80;271
411850;201610;7343;21617;5561;17760;1415;4840;1483;4506;2898;9346
411860;201610;901;2727;667;2184;141;482;214;640;355;1122
411870;201610;871;2816;552;1932;116;470;105;318;221;788
411880;201610;2350;6686;1656;5345;437;1576;338;950;775;2526
411885;201610;962;2627;728;2178;130;477;262;699;392;1176
411890;201610;1133;3448;665;2265;126;476;48;121;174;597
411900;201610;956;2951;580;1983;133;438;65;224;198;662
411910;201610;1250;4053;875;3097;248;933;208;636;456;1569
411915;201610;17478;47142;9572;30507;1841;6209;2182;6087;4023;12296
411920;201610;881;2936;710;2493;185;740;73;190;258;930
411925;201610;584;1659;366;1208;78;263;80;240;158;503
411930;201610;5956;19443;4957;17297;2323;8666;447;1424;2770;10090
411940;201610;3245;10722;2617;9229;716;2603;512;1697;1228;4300
411950;201610;12167;38038;9864;33226;2234;7966;4398;14348;6632;22314
411960;201610;5558;16182;4785;14616;1081;3618;1881;5450;2962;9068
411965;201610;567;1593;366;1212;68;267;98;319;166;586
411970;201610;782;2162;635;1929;197;608;240;805;437;1413
411980;201610;1677;4925;1347;4192;316;1007;380;1176;696;2183
411990;201610;32431;100682;23637;81067;6042;22458;6530;21033;12572;43491
411995;201610;2595;7777;2082;6769;627;2268;509;1488;1136;3756
412000;201610;2368;5870;1716;4725;251;843;895;2155;1146;2998
412010;201610;719;2415;539;1991;82;317;128;422;210;739
412015;201610;647;1914;491;1572;97;297;227;738;324;1035
412020;201610;385;1125;230;754;41;134;62;182;103;316
412030;201610;715;2202;453;1571;87;340;114;353;201;693
412033;201610;869;2470;518;1636;78;261;141;423;219;684
412035;201610;1007;2743;584;1905;124;420;196;605;320;1025
412040;201610;610;1882;418;1419;78;272;75;240;153;512
412050;201610;1751;4998;1195;3790;211;722;277;842;488;1564
412060;201610;6956;23409;5962;21174;1891;7186;1559;5390;3450;12576
412065;201610;831;2479;594;1951;132;474;166;493;298;967
412070;201610;1360;3599;932;2683;149;451;350;965;499;1416
412080;201610;1429;4383;713;2615;84;319;23;62;107;381
412085;201610;445;1275;106;374;16;56;14;42;30;98
412090;201610;4666;14028;4205;13148;931;2911;2173;7034;3104;9945
412100;201610;1976;5994;1507;5006;439;1592;311;999;750;2591
412110;201610;1103;3077;668;2117;161;523;132;426;293;949
412120;201610;1726;5841;1375;4939;362;1434;394;1216;756;2650
412125;201610;659;2121;576;1944;139;501;190;599;329;1100
412130;201610;631;1863;412;1340;111;379;64;192;175;571
412135;201610;506;1416;280;894;61;199;87;259;148;458
412140;201610;1633;4850;1217;3904;284;967;218;637;502;1604
412150;201610;2904;8350;2398;7264;367;1177;1371;4016;1738;5193
412160;201610;1198;3781;654;2347;166;641;73;222;239;863
412170;201610;4635;14033;3591;11847;950;3394;1306;3999;2256;7393
412175;201610;1466;4769;1210;4182;243;908;584;1985;827;2893
412180;201610;1715;5139;1159;3989;267;1034;367;1124;634;2158
412190;201610;3326;9265;2273;7232;469;1588;762;2492;1231;4080
412200;201610;2147;6802;1424;4887;282;1025;418;1427;700;2452
412210;201610;691;1880;349;1122;59;203;44;103;103;306
412215;201610;3667;11037;3206;10168;818;2566;1642;5412;2460;7978
412217;201610;1124;3160;960;2843;92;341;680;1878;772;2219
412220;201610;5831;18579;5232;17336;1574;5206;2175;7350;3749;12556
412230;201610;2862;9299;2284;8003;469;1809;645;2028;1114;3837
412240;201610;8969;22957;4749;14712;923;3160;977;2668;1900;5828
412250;201610;1932;5596;1487;4619;368;1185;184;471;552;1656
412260;201610;1386;3785;807;2466;122;413;318;859;440;1272
412265;201610;1004;3018;847;2729;211;728;315;1002;526;1730
412270;201610;883;2788;553;1945;93;356;174;562;267;918
412280;201610;634;1946;434;1496;147;549;26;56;173;605
412290;201610;1038;2898;729;2306;140;482;225;635;365;1117
412300;201610;1885;5621;1485;4792;383;1301;315;951;698;2252
412310;201610;1023;2943;813;2566;118;429;394;1238;512;1667
412320;201610;897;2352;567;1727;110;411;196;552;306;963
412330;201610;1562;4430;1063;3343;174;588;476;1469;650;2057
412340;201610;972;3008;565;1950;73;264;101;305;174;569
412350;201610;2275;6998;1563;5300;287;979;77;186;364;1165
412360;201610;309;901;162;527;20;81;59;162;79;243
412370;201610;984;2872;658;2222;136;490;118;390;254;880
412380;201610;1512;4753;1144;3842;292;1009;228;745;520;1754
412382;201610;688;1902;425;1325;76;248;94;245;170;493
412385;201610;2387;7308;2013;6438;735;2395;485;1568;1220;3963
412390;201610;2172;6080;1916;5651;476;1535;780;2364;1256;3899
412395;201610;828;2321;605;1890;83;305;330;966;413;1271
412400;201610;937;2923;740;2452;206;729;171;570;377;1299
412402;201610;1887;5521;1364;4393;334;1173;279;786;613;1959
412405;201610;3634;10464;1864;6257;305;1132;101;273;406;1405
412410;201610;5090;15199;3797;12550;1077;3989;752;2275;1829;6264
412420;201610;380;1124;231;744;37;118;73;195;110;313
412430;201610;561;1557;356;1118;68;234;106;304;174;538
412440;201610;3222;9685;2335;7865;573;2085;566;1881;1139;3966
412450;201610;253;831;159;556;24;76;18;48;42;124
412460;201610;756;2349;573;1914;148;517;107;348;255;865
412470;201610;1861;6271;1485;5260;497;1850;282;1042;779;2892
412480;201610;1170;3478;720;2334;121;410;100;246;221;656
412490;201610;934;2723;730;2286;134;436;256;750;390;1186
412500;201610;1989;5669;1487;4614;288;971;351;924;639;1895
412510;201610;2265;7290;1729;5915;555;2060;376;1172;931;3232
412520;201610;1554;4397;1043;3268;307;971;154;426;461;1397
412530;201610;589;1718;400;1251;91;291;83;255;174;546
412535;201610;753;2180;450;1436;81;284;110;318;191;602
412540;201610;1216;3448;812;2560;125;466;246;739;371;1205
412545;201610;779;2227;535;1653;87;307;172;456;259;763
412550;201610;30951;91603;19194;63995;4353;15296;4182;12798;8535;28094
412555;201610;269;789;164;530;28;92;37;98;65;190
412560;201610;5357;16270;3812;12689;753;2902;1016;3166;1769;6068
412570;201610;4310;12464;2562;8543;588;2120;379;1261;967;3381
412575;201610;883;2686;637;2058;134;464;196;579;330;1043
412580;201610;1284;3517;841;2593;151;485;305;863;456;1348
412590;201610;450;1317;259;878;53;185;57;176;110;361
412600;201610;1419;4301;962;3217;205;735;261;792;466;1527
412610;201610;761;2257;448;1450;108;352;124;374;232;726
412620;201610;1243;3881;904;3143;225;888;141;413;366;1301
412625;201610;9752;27939;6676;21390;1344;4547;739;2143;2083;6690
412627;201610;978;2976;639;2174;212;771;91;295;303;1066
412630;201610;3337;10394;2428;8251;500;1670;656;2108;1156;3778
412635;201610;479;1392;290;947;73;236;19;39;92;275
412640;201610;908;2696;501;1694;82;284;49;153;131;437
412650;201610;1740;5147;1369;4378;270;972;400;1158;670;2130
412660;201610;2790;7987;2027;6332;429;1500;426;1147;855;2647
412665;201610;637;1657;321;1018;84;268;69;205;153;473
412667;201610;1709;4841;1242;3844;321;995;289;858;610;1853
412670;201610;573;1741;415;1379;100;374;71;217;171;591
412680;201610;1370;4078;766;2645;129;476;184;565;313;1041
412690;201610;789;2342;545;1783;150;523;103;333;253;856
412700;201610;1856;5570;1506;4996;494;1851;370;1142;864;2993
412710;201610;6960;21802;5391;18218;1182;4341;1294;3950;2476;8291
412720;201610;1409;4299;870;2887;143;495;160;424;303;919
412730;201610;2195;6516;1170;4014;238;876;130;389;368;1265
412740;201610;1471;4633;968;3436;220;835;125;458;345;1293
412750;201610;4061;12211;3491;11166;439;1647;2198;6845;2637;8492
412760;201610;2460;7691;2235;7253;332;1234;1374;4280;1706;5514
412770;201610;11435;31291;5495;17928;829;2855;1020;2864;1849;5719
412780;201610;1328;4015;1048;3416;215;751;406;1238;621;1989
412785;201610;2365;6572;1681;5191;438;1373;711;2217;1149;3590
412788;201610;1427;4491;1158;3897;295;1118;329;944;624;2062
412790;201610;1163;3478;796;2627;159;571;154;412;313;983
412795;201610;1006;2736;678;2060;133;407;239;708;372;1115
412796;201610;2752;8341;2381;7530;577;1970;911;2696;1488;4666
412800;201610;3118;8833;2202;6780;355;1188;791;2280;1146;3468
412810;201610;11376;30847;5828;18453;830;2919;1470;3759;2300;6678
412820;201610;7461;21614;5002;16482;1209;4127;1222;3986;2431;8113
412830;201610;373;1137;244;821;43;158;68;203;111;361
412840;201610;1810;5120;1326;4052;247;804;299;887;546;1691
412850;201610;2795;8133;2072;6721;434;1562;631;1854;1065;3416
412853;201610;1754;5005;1459;4360;141;467;802;2231;943;2698
412855;201610;1494;4279;1029;3170;221;743;224;554;445;1297
412860;201610;1190;3375;883;2753;235;794;312;906;547;1700
412862;201610;775;1991;459;1375;74;233;132;390;206;623
412863;201610;1196;3996;1150;3907;167;616;798;2656;965;3272
412865;201610;727;2191;494;1650;115;401;149;513;264;914
412870;201610;962;2704;679;2178;276;970;94;262;370;1232
412880;201610;882;2544;604;1950;126;445;59;141;185;586
420005;201610;546;1633;300;1037;58;210;93;302;151;512
420010;201610;3252;9014;2512;7912;347;1120;1710;5444;2057;6564
420020;201610;712;2299;345;1294;38;166;44;150;82;316
420030;201610;505;1309;236;789;50;196;30;94;80;290
420040;201610;726;2287;383;1466;73;307;24;76;97;383
420050;201610;728;2074;449;1473;104;347;177;573;281;920
420055;201610;208;641;104;381;22;87;15;53;37;140
420060;201610;242;780;146;530;22;97;27;77;49;174
420070;201610;1362;4294;982;3350;178;684;385;1299;563;1983
420075;201610;175;464;76;236;16;50;12;28;28;78
420080;201610;605;1889;466;1597;143;516;113;388;256;904
420090;201610;502;1640;320;1210;76;308;50;196;126;504
420100;201610;1214;3755;1072;3552;238;807;604;2019;842;2826
420110;201610;330;1105;283;985;64;229;96;334;160;563
420120;201610;288;975;223;822;65;273;49;154;114;427
420125;201610;299;1088;265;1011;72;288;110;413;182;701
420127;201610;550;1591;181;672;44;178;14;41;58;219
420130;201610;1928;6461;1446;5369;369;1513;305;1003;674;2516
420140;201610;4613;13449;3010;10148;700;2576;463;1348;1163;3924
420150;201610;750;2098;429;1428;74;269;177;562;251;831
420160;201610;280;770;160;523;26;88;44;138;70;226
420165;201610;223;688;118;406;24;90;24;77;48;167
420170;201610;215;663;132;490;42;175;16;57;58;232
420180;201610;404;1215;200;722;33;124;44;145;77;269
420190;201610;463;1311;188;668;35;131;16;51;51;182
420195;201610;1411;4066;1050;3398;272;938;243;723;515;1661
420200;201610;2695;8353;1455;5377;290;1214;218;723;508;1937
420205;201610;1073;3439;846;2993;195;748;433;1524;628;2272
420207;201610;1601;4624;1010;3364;278;1019;195;600;473;1619
420208;201610;589;1588;297;1061;96;365;63;238;159;603
420209;201610;320;971;181;625;28;111;77;250;105;361
420210;201610;1884;5646;1137;4276;311;1336;372;1278;683;2614
420213;201610;792;2802;725;2642;185;715;358;1305;543;2020
420215;201610;325;1041;200;714;53;197;11;45;64;242
420220;201610;174;622;139;545;35;147;45;161;80;308
420230;201610;4359;12534;3003;9990;581;2251;1154;3590;1735;5841
420240;201610;11441;31719;6810;22533;1070;4153;2942;8655;4012;12808
420243;201610;608;1833;465;1540;100;355;158;512;258;867
420245;201610;1252;3697;786;2700;117;455;281;861;398;1316
420250;201610;540;1709;463;1543;119;482;193;593;312;1075
420253;201610;503;1299;366;1102;47;134;220;687;267;821
420257;201610;309;846;181;599;37;123;83;277;120;400
420260;201610;1225;3858;974;3362;208;801;363;1236;571;2037
420270;201610;629;1874;181;641;30;113;53;162;83;275
420280;201610;2118;5767;1226;4082;250;915;412;1288;662;2203
420285;201610;149;433;58;215;11;40;1;1;12;41
420287;201610;541;1582;422;1378;135;464;129;423;264;887
420290;201610;6352;18774;3925;13004;761;2653;1174;3555;1935;6208
420300;201610;6974;20721;3936;13824;867;3281;665;2100;1532;5381
420310;201610;799;2124;672;1909;102;317;474;1307;576;1624
420315;201610;977;3055;717;2494;241;892;206;682;447;1574
420320;201610;4724;14476;3659;12419;1154;4236;1160;3793;2314;8029
420325;201610;235;782;204;710;37;141;76;252;113;393
420330;201610;1004;3422;683;2591;147;606;176;603;323;1209
420340;201610;1461;4456;988;3315;170;655;103;294;273;949
420350;201610;1490;4362;1012;3385;278;976;361;1149;639;2125
420360;201610;3116;9388;1756;6284;371;1482;152;455;523;1937
420370;201610;1851;5240;1403;4441;176;583;979;3038;1155;3621
420380;201610;5253;15819;3235;11118;768;2832;777;2525;1545;5357
420390;201610;1470;4062;691;2341;124;466;126;319;250;785
420395;201610;1408;4294;849;2953;112;432;102;290;214;722
420400;201610;1303;3778;821;2757;189;709;183;534;372;1243
420410;201610;769;2045;514;1611;99;342;298;913;397;1255
420415;201610;470;1450;314;1070;90;324;88;288;178;612
420417;201610;736;2340;572;1917;111;376;252;832;363;1208
420419;201610;369;1108;212;772;74;295;14;53;88;348
420420;201610;11087;33005;8266;27221;2913;10281;1739;5192;4652;15473
420425;201610;1244;3342;753;2344;86;332;352;1000;438;1332
420430;201610;3457;10410;2009;6890;435;1602;604;2029;1039;3631
420435;201610;299;874;169;577;38;142;69;219;107;361
420440;201610;915;2794;479;1643;201;737;86;268;287;1005
420445;201610;389;1128;238;765;54;179;72;220;126;399
420450;201610;838;2512;502;1745;92;347;116;358;208;705
420455;201610;1993;5817;1612;5132;273;1058;775;2294;1048;3352
420460;201610;9089;26205;6400;21136;1417;5336;2448;7433;3865;12769
420470;201610;1119;2934;608;1923;115;399;182;522;297;921
420475;201610;124;359;57;194;18;56;5;15;23;71
420480;201610;5088;14445;3429;11199;940;3252;753;2414;1693;5666
420490;201610;654;1704;324;1112;80;303;70;242;150;545
420500;201610;1557;4872;1092;3903;340;1331;334;1159;674;2490
420510;201610;117;433;85;350;20;95;45;176;65;271
420515;201610;106;347;81;297;12;52;15;52;27;104
420517;201610;839;2589;712;2331;131;484;403;1259;534;1743
420519;201610;557;1457;369;1111;67;207;105;294;172;501
420520;201610;646;1648;344;1124;69;227;87;234;156;461
420530;201610;1156;3684;760;2764;181;757;181;557;362;1314
420535;201610;263;760;108;390;29;92;9;42;38;134
420540;201610;22707;63386;14450;45226;3447;11592;3873;10136;7320;21728
420543;201610;395;1018;289;836;25;82;186;567;211;649
420545;201610;1560;4850;1167;3955;268;1001;351;1108;619;2109
420550;201610;4206;13074;2830;10119;750;3103;515;1669;1265;4772
420555;201610;368;1107;260;875;58;221;90;275;148;496
420560;201610;546;1548;390;1261;69;233;181;571;250;804
420570;201610;2221;6946;1539;5322;406;1573;477;1475;883;3048
420580;201610;1551;4650;1168;3964;277;1057;476;1553;753;2610
420590;201610;3383;10021;1965;6620;394;1427;333;934;727;2361
420600;201610;931;3000;823;2765;136;471;471;1629;607;2100
420610;201610;533;1602;266;979;61;256;60;217;121;473
420620;201610;581;1791;486;1582;119;400;135;442;254;842
420630;201610;1028;3131;686;2314;154;555;237;731;391;1286
420640;201610;800;2382;340;1264;91;373;27;87;118;460
420650;201610;2605;7561;1452;5006;247;886;355;1106;602;1992
420660;201610;482;1396;308;1006;73;259;90;278;163;537
420665;201610;712;1980;434;1430;59;205;149;440;208;645
420670;201610;1734;5068;1091;3670;217;834;270;810;487;1644
420675;201610;206;658;136;483;26;102;36;118;62;220
420680;201610;529;1252;285;867;44;148;101;297;145;445
420690;201610;893;3030;583;2152;97;353;95;285;192;638
420700;201610;3282;9561;2307;7474;465;1642;780;2331;1245;3973
420710;201610;642;2102;446;1650;119;490;145;497;264;987
420720;201610;1783;4972;1305;4270;375;1298;580;1854;955;3152
420730;201610;3369;9932;2612;8532;621;2207;1064;3326;1685;5533
420740;201610;829;2540;633;2119;217;789;211;635;428;1424
420750;201610;2430;7653;1606;5670;250;991;514;1593;764;2584
420757;201610;106;252;43;151;6;25;20;72;26;97
420760;201610;380;1179;175;590;41;152;26;70;67;222
420765;201610;597;1879;283;1061;62;252;55;191;117;443
420768;201610;1228;4180;947;3573;412;1566;275;1094;687;2660
420770;201610;647;1881;313;1156;68;293;61;222;129;515
420775;201610;654;1945;336;1138;80;285;60;172;140;457
420780;201610;1523;4585;817;2792;161;544;135;449;296;993
420785;201610;288;870;194;632;31;104;50;150;81;254
420790;201610;1281;4331;944;3511;293;1191;308;1061;601;2252
420800;201610;913;2542;408;1361;99;352;119;379;218;731
420810;201610;2063;6906;1531;5670;462;1921;319;1050;781;2971
420820;201610;8579;25445;5590;19908;1397;5543;1441;4907;2838;10450
420830;201610;2849;8798;2213;7517;631;2299;734;2409;1365;4708
420840;201610;1021;2980;431;1572;96;386;76;239;172;625
420845;201610;1395;4132;882;3138;238;964;196;648;434;1612
420850;201610;1648;5111;899;3404;191;799;56;193;247;992
420860;201610;449;1249;254;870;69;273;69;227;138;500
420870;201610;1148;3182;843;2654;289;1038;222;605;511;1643
420880;201610;1028;3406;729;2594;151;591;124;394;275;985
420890;201610;10012;26368;4476;14774;750;2666;1107;3082;1857;5748
420895;201610;252;686;114;375;33;109;13;39;46;148
420900;201610;1868;5209;1086;3624;209;784;289;856;498;1640
420910;201610;25003;73244;15435;53005;2880;10960;4734;14744;7614;25704
420915;201610;560;2180;392;1667;80;352;162;639;242;991
420917;201610;485;1485;190;636;37;142;72;209;109;351
420920;201610;185;519;68;241;14;58;12;43;26;101
420930;201610;18547;52720;13354;43080;2925;10197;5145;15707;8070;25904
420940;201610;2901;8606;2034;6753;523;1895;162;418;685;2313
420945;201610;202;614;122;423;24;99;33;98;57;197
420950;201610;644;1773;263;979;29;145;51;176;80;321
420960;201610;965;2700;687;2163;142;480;280;813;422;1293
420970;201610;2546;7907;1957;6752;634;2360;464;1513;1098;3873
420980;201610;466;1359;337;1137;119;438;113;416;232;854
420985;201610;502;1417;215;768;40;174;53;165;93;339
420990;201610;899;2432;450;1537;70;257;81;221;151;478
421000;201610;579;1962;339;1317;67;278;58;183;125;461
421003;201610;735;1976;226;767;24;87;36;85;60;172
421005;201610;154;467;113;397;21;79;56;204;77;283
421010;201610;5315;14981;3395;11312;813;2963;693;2038;1506;5001
421020;201610;490;1487;350;1224;40;150;193;688;233;838
421030;201610;756;2695;645;2399;190;784;89;301;279;1085
421040;201610;921;2310;540;1673;90;323;275;804;365;1127
421050;201610;1668;4739;885;2989;175;638;202;587;377;1225
421055;201610;195;543;91;285;22;74;18;35;40;109
421060;201610;533;1766;328;1201;77;313;99;350;176;663
421070;201610;699;2219;393;1429;85;329;59;198;144;527
421080;201610;536;1629;449;1492;88;286;291;977;379;1263
421085;201610;566;1503;251;868;51;198;68;202;119;400
421090;201610;434;1189;183;601;23;85;60;175;83;260
421100;201610;964;2587;444;1434;128;424;40;117;168;541
421105;201610;1499;4470;1147;3824;255;912;358;1221;613;2133
421110;201610;1007;3581;891;3297;321;1255;175;577;496;1832
421120;201610;1371;4372;823;2946;120;511;223;686;343;1197
421125;201610;412;1135;287;913;89;311;80;220;169;531
421130;201610;3450;11198;2816;9916;927;3520;908;3176;1835;6696
421140;201610;359;1026;249;790;53;168;90;263;143;431
421145;201610;573;1789;322;1111;48;163;103;350;151;513
421150;201610;609;1764;419;1428;81;305;171;558;252;863
421160;201610;1234;3366;543;1797;106;388;180;547;286;935
421165;201610;288;968;204;725;30;101;90;325;120;426
421170;201610;1350;3855;1032;3313;202;696;595;1877;797;2573
421175;201610;1275;3530;809;2671;164;651;291;848;455;1499
421180;201610;579;1585;270;908;59;234;42;116;101;350
421185;201610;410;1136;271;857;48;138;126;424;174;562
421187;201610;291;848;204;668;42;143;86;255;128;398
421189;201610;419;1280;316;1050;59;212;89;266;148;478
421190;201610;11777;33430;6401;22218;1362;5133;969;3025;2331;8158
421200;201610;961;3100;766;2660;171;616;222;720;393;1336
421205;201610;264;809;183;636;40;167;40;113;80;280
421210;201610;1522;4594;1057;3474;288;964;275;900;563;1864
421220;201610;1958;6554;1618;5761;464;1827;264;795;728;2622
421223;201610;541;1694;374;1332;97;362;124;439;221;801
421225;201610;1152;3633;920;3126;196;732;366;1234;562;1966
421227;201610;807;2559;692;2359;148;552;381;1253;529;1805
421230;201610;467;1495;381;1316;91;348;168;554;259;902
421240;201610;420;1322;193;712;24;104;36;112;60;216
421250;201610;1757;4998;1025;3623;283;1042;204;716;487;1758
421260;201610;363;1030;86;317;19;66;19;66;38;132
421265;201610;777;2346;674;2173;109;392;423;1330;532;1722
421270;201610;859;2264;387;1279;75;249;78;279;153;528
421280;201610;1669;5228;1242;4433;360;1436;434;1459;794;2895
421290;201610;1006;2800;528;1729;96;327;97;280;193;607
421300;201610;316;953;228;756;65;259;88;255;153;514
421310;201610;247;762;172;572;32;116;58;182;90;298
421315;201610;370;1066;179;637;32;113;21;75;53;188
421320;201610;692;2073;368;1246;64;227;66;156;130;383
421330;201610;574;1850;418;1532;122;484;82;317;204;801
421335;201610;508;1677;389;1418;85;356;79;290;164;646
421340;201610;1775;4991;1333;4244;190;752;733;2241;923;2993
421350;201610;1036;3361;835;2923;147;616;433;1423;580;2039
421360;201610;3013;8580;1705;5915;398;1532;481;1475;879;3007
421370;201610;692;2289;500;1851;134;547;138;491;272;1038
421380;201610;976;2732;767;2308;113;380;382;1102;495;1482
421390;201610;179;506;68;235;27;102;22;63;49;165
421400;201610;286;957;190;762;48;211;63;231;111;442
421410;201610;337;955;190;638;25;85;85;285;110;370
421415;201610;372;1196;144;536;32;127;29;99;61;226
421420;201610;883;2623;604;1977;91;317;225;682;316;999
421430;201610;237;732;170;596;27;103;37;133;64;236
421440;201610;848;2431;539;1848;122;474;221;730;343;1204
421450;201610;458;1392;240;875;38;146;27;103;65;249
421460;201610;652;1787;313;1120;58;235;70;253;128;488
421470;201610;437;1447;325;1180;91;360;87;297;178;657
421480;201610;3199;8985;1852;6404;616;2464;242;589;858;3053
421490;201610;283;847;113;438;23;105;20;65;43;170
421500;201610;2208;7424;1710;6282;536;2203;205;702;741;2905
421505;201610;362;1195;311;1080;77;269;129;443;206;712
421507;201610;534;1603;310;1094;70;267;86;301;156;568
421510;201610;177;573;142;509;24;108;67;186;91;294
421520;201610;899;2388;533;1604;68;251;221;564;289;815
421530;201610;418;1285;230;849;39;176;53;178;92;354
421535;201610;689;1977;345;1233;55;219;139;453;194;672
421540;201610;329;874;234;701;49;158;85;220;134;378
421545;201610;851;2664;568;2074;136;557;155;527;291;1084
421550;201610;2050;6435;1652;5707;501;1917;505;1619;1006;3536
421555;201610;328;956;97;349;18;70;14;45;32;115
421560;201610;210;643;82;286;17;60;16;56;33;116
421565;201610;864;2482;736;2298;247;862;302;945;549;1807
421567;201610;640;2336;544;2104;273;1079;111;429;384;1508
421568;201610;518;1575;313;1070;68;244;89;294;157;538
421569;201610;233;698;92;338;13;48;15;56;28;104
421570;201610;1420;4260;722;2527;187;700;116;366;303;1066
421575;201610;446;1444;359;1238;65;229;184;641;249;870
421580;201610;3085;9676;2111;7408;527;2054;548;1680;1075;3734
421590;201610;221;682;172;583;23;82;93;306;116;388
421600;201610;555;1670;368;1237;86;310;81;230;167;540
421605;201610;641;1936;434;1530;80;316;122;403;202;719
421610;201610;1436;3868;949;2924;148;513;411;1164;559;1677
421620;201610;4599;13685;2833;9909;782;2897;782;2661;1564;5558
421625;201610;386;1066;136;466;30;98;15;52;45;150
421630;201610;3108;9153;1520;5288;357;1304;230;744;587;2048
421635;201610;242;720;115;377;15;58;35;93;50;151
421640;201610;1080;3170;730;2464;160;543;273;904;433;1447
421650;201610;2187;6946;1491;5261;363;1452;193;557;556;2009
421660;201610;7892;25282;6083;21389;1357;5260;1864;5938;3221;11198
421670;201610;1104;3308;698;2358;183;703;204;625;387;1328
421680;201610;1163;3695;912;3137;296;1060;180;590;476;1650
421690;201610;1638;5275;1121;4015;236;923;107;318;343;1241
421700;201610;503;1604;247;932;49;201;60;192;109;393
421710;201610;214;711;98;356;21;81;28;90;49;171
421715;201610;261;689;129;409;32;111;36;98;68;209
421720;201610;1871;5482;1037;3676;273;1044;150;430;423;1474
421725;201610;136;423;103;349;27;97;24;71;51;168
421730;201610;603;1728;260;883;43;153;64;190;107;343
421740;201610;782;2478;496;1766;112;450;91;277;203;727
421750;201610;1044;2758;593;1838;112;376;223;625;335;1001
421755;201610;325;939;171;550;37;134;52;159;89;293
421760;201610;870;2592;381;1376;71;269;85;268;156;537
421770;201610;3090;9149;2155;7208;578;2005;683;2329;1261;4334
421775;201610;507;1479;335;1147;57;221;119;379;176;600
421780;201610;1214;4045;851;3138;212;877;227;742;439;1619
421790;201610;833;2208;456;1582;158;601;92;265;250;866
421795;201610;356;1042;208;669;33;118;61;188;94;306
421800;201610;2810;8322;1974;6613;460;1715;730;2261;1190;3976
421810;201610;618;1890;409;1441;109;425;57;179;166;604
421820;201610;1034;2995;569;1943;91;317;97;276;188;593
421825;201610;1472;4626;1355;4362;160;604;980;3069;1140;3673
421830;201610;2510;8473;2115;7603;538;2140;721;2395;1259;4535
421835;201610;164;480;117;409;19;84;76;253;95;337
421840;201610;298;952;197;714;44;184;63;199;107;383
421850;201610;414;1328;219;806;35;148;46;156;81;304
421860;201610;319;978;188;687;36;147;43;125;79;272
421870;201610;4020;11260;2510;8053;759;2627;492;1485;1251;4112
421875;201610;412;1237;162;618;34;147;16;56;50;203
421880;201610;889;2697;607;2061;127;480;125;383;252;863
421885;201610;313;989;239;838;79;292;74;248;153;540
421890;201610;886;2991;737;2672;249;1054;222;719;471;1773
421895;201610;377;1189;329;1103;67;243;188;629;255;872
421900;201610;984;2722;565;1824;147;502;159;466;306;968
421910;201610;491;1548;305;1114;70;308;49;127;119;435
421915;201610;511;1518;287;963;56;178;57;184;113;362
421917;201610;598;1695;399;1374;152;594;118;387;270;981
421920;201610;775;2163;483;1751;255;959;105;384;360;1343
421930;201610;3241;8465;1620;5470;382;1378;220;649;602;2027
421935;201610;677;2194;475;1733;94;402;167;558;261;960
421940;201610;289;962;135;505;17;73;31;94;48;167
421950;201610;3743;10104;1572;5399;378;1383;203;675;581;2058
421960;201610;202;600;137;471;32;118;29;93;61;211
421970;201610;2356;6424;1316;4203;387;1280;374;1081;761;2361
421985;201610;508;1300;247;757;41;153;80;241;121;394
422000;201610;1229;3668;961;3121;272;966;362;1151;634;2117
430003;201610;799;2317;583;1928;147;558;160;499;307;1057
430005;201610;335;992;231;780;48;175;98;311;146;486
430010;201610;2201;5906;1581;4810;409;1309;633;1925;1042;3234
430020;201610;727;1798;576;1564;87;273;354;911;441;1184
430030;201610;1062;2749;719;2096;247;766;117;298;364;1064
430040;201610;11407;29682;7590;22307;2053;6516;1091;2890;3144;9406
430045;201610;709;1896;491;1446;94;283;202;574;296;857
430047;201610;297;699;126;378;18;46;50;154;68;200
430050;201610;1054;2853;539;1717;112;359;141;422;253;781
430055;201610;313;828;151;469;19;68;67;196;86;264
430057;201610;77;180;32;92;4;9;6;9;10;18
430060;201610;17068;53592;14118;48080;4067;14766;5470;18609;9537;33375
430063;201610;1018;2952;757;2376;202;641;353;1131;555;1772
430064;201610;1346;3945;1036;3349;278;905;322;1048;600;1953
430066;201610;172;403;113;302;11;37;65;167;76;204
430070;201610;641;1701;145;481;23;81;20;47;43;128
430080;201610;721;2033;400;1366;96;357;110;323;206;680
430085;201610;939;2428;538;1672;99;340;164;516;263;856
430087;201610;933;2817;830;2606;138;502;479;1372;617;1874
430090;201610;846;2199;277;899;36;129;53;175;89;304
430100;201610;871;2297;424;1349;99;339;111;293;210;632
430105;201610;1049;3016;658;2257;159;599;215;713;374;1312
430107;201610;264;858;177;613;33;125;43;133;76;258
430110;201610;1967;5582;1531;4851;372;1240;694;2066;1066;3306
430120;201610;1791;5244;1250;4054;266;887;552;1748;818;2635
430130;201610;3946;10106;3140;8748;843;2442;1181;3196;2024;5638
430140;201610;1215;3666;763;2611;222;777;222;744;444;1521
430150;201610;787;2085;465;1431;105;340;119;367;224;707
430155;201610;410;1123;183;617;32;120;45;138;77;258
430160;201610;17404;49568;14277;43878;3594;11814;5560;16983;9154;28797
430163;201610;2015;5804;1543;4951;221;802;832;2595;1053;3397
430165;201610;472;1162;110;373;15;50;18;55;33;105
430170;201610;969;2719;319;1162;42;157;33;98;75;255
430175;201610;931;2874;733;2399;211;649;277;986;488;1635
430180;201610;861;2343;660;1983;149;494;331;946;480;1440
430185;201610;606;1563;315;967;55;172;104;268;159;440
430187;201610;673;1960;481;1531;118;409;160;476;278;885
430190;201610;1727;5080;1434;4487;303;1033;745;2256;1048;3289
430192;201610;200;608;75;244;6;18;16;47;22;65
430195;201610;395;1197;75;259;10;36;2;7;12;43
430200;201610;1438;4528;1168;3915;349;1244;287;920;636;2164
430205;201610;596;1669;428;1344;42;155;300;932;342;1087
430210;201610;6639;17317;3575;10721;565;1853;1050;2574;1615;4427
430215;201610;361;992;230;698;41;128;95;268;136;396
430220;201610;755;1904;218;788;37;155;34;109;71;264
430222;201610;285;867;210;690;31;123;100;307;131;430
430223;201610;362;1017;284;869;70;201;131;418;201;619
430225;201610;36;88;16;45;4;12;5;12;9;24
430230;201610;1673;4920;1582;4816;218;532;1311;4171;1529;4703
430235;201610;293;943;221;762;53;201;67;209;120;410
430237;201610;544;1387;370;1073;38;127;235;646;273;773
430240;201610;1064;2727;667;2040;82;301;360;1032;442;1333
430245;201610;873;2667;638;2158;181;625;246;868;427;1493
430250;201610;1218;3453;1014;3075;354;1112;126;373;480;1485
430258;201610;165;465;118;379;10;34;53;179;63;213
430260;201610;811;2250;533;1675;70;225;273;883;343;1108
430265;201610;301;927;229;779;54;173;31;105;85;278
430270;201610;3010;8258;2490;7345;381;1266;1467;4112;1848;5378
430280;201610;4849;12858;3698;10760;886;2650;1618;4680;2504;7330
430290;201610;2526;6512;2272;6133;148;418;1969;5287;2117;5705
430300;201610;9481;27457;7411;23297;1776;5971;3229;10167;5005;16138
430310;201610;6903;20492;4984;16609;1199;4327;1886;5801;3085;10128
430320;201610;868;2496;502;1681;106;315;225;776;331;1091
430330;201610;701;1848;512;1470;140;387;214;581;354;968
430340;201610;711;1761;338;1101;71;235;173;550;244;785
430350;201610;6402;19291;5113;16440;2060;6728;1354;4214;3414;10942
430355;201610;393;981;128;393;25;89;20;55;45;144
430360;201610;1074;2794;803;2273;166;510;338;880;504;1390
430367;201610;289;761;162;506;39;143;54;161;93;304
430370;201610;573;1581;333;1075;86;299;69;195;155;494
430380;201610;871;2236;426;1391;140;500;107;336;247;836
430390;201610;4071;11302;2373;7665;446;1535;362;1079;808;2614
430400;201610;1439;3398;971;2610;313;859;352;885;665;1744
430410;201610;643;1703;429;1307;77;247;209;625;286;872
430420;201610;3700;10579;2739;8400;796;2506;919;2711;1715;5217
430430;201610;761;2014;417;1339;122;417;96;302;218;719
430435;201610;2097;5589;1469;4399;396;1243;506;1489;902;2732
430440;201610;4105;12718;3027;10195;640;2248;1345;4617;1985;6865
430450;201610;7632;20890;5664;16968;1906;5904;1375;4137;3281;10041
430460;201610;29224;85436;21094;69990;5814;21015;6016;19032;11830;40047
430461;201610;513;1359;143;454;22;70;40;122;62;192
430462;201610;279;794;163;576;31;119;31;114;62;233
430463;201610;4366;13711;3612;12218;813;2943;1623;5512;2436;8455
430465;201610;654;1760;528;1528;145;459;269;750;414;1209
430466;201610;3709;10055;3123;9075;706;2198;1609;4478;2315;6676
430467;201610;513;1507;411;1290;88;295;167;490;255;785
430468;201610;1493;4120;1205;3646;306;964;466;1360;772;2324
430469;201610;486;1313;55;192;7;22;7;17;14;39
430470;201610;7963;21016;5125;15923;1512;4946;875;2645;2387;7591
430471;201610;582;1890;489;1671;143;502;111;393;254;895
430480;201610;1041;2740;483;1574;80;274;114;332;194;606
430485;201610;216;591;85;271;16;57;13;30;29;87
430490;201610;326;937;204;672;44;151;86;283;130;434
430495;201610;383;1154;234;817;49;182;67;214;116;396
430500;201610;1219;3313;946;2842;233;777;437;1261;670;2038
430510;201610;22346;64338;16630;52689;5361;18266;4608;13418;9969;31684
430511;201610;395;1215;152;533;24;88;16;39;40;127
430512;201610;1176;2995;942;2560;255;732;280;772;535;1504
430513;201610;815;2098;424;1242;104;328;161;432;265;760
430515;201610;492;1401;329;1053;52;159;152;508;204;667
430517;201610;1201;3758;951;3215;198;686;483;1647;681;2333
430520;201610;1599;4404;937;2946;220;757;241;643;461;1400
430530;201610;1120;2981;470;1508;72;258;117;323;189;581
430535;201610;2529;7538;1784;5994;399;1447;674;2155;1073;3602
430537;201610;490;1557;408;1378;35;117;296;1005;331;1122
430540;201610;759;1673;490;1300;91;248;280;740;371;988
430543;201610;505;1281;434;1197;85;247;300;844;385;1091
430544;201610;694;2186;547;1839;131;476;246;785;377;1261
430545;201610;1367;4314;1152;4030;383;1422;473;1655;856;3077
430550;201610;643;1839;350;1151;81;292;66;193;147;485
430558;201610;104;283;50;154;12;43;11;23;23;66
430560;201610;394;952;151;485;17;65;60;170;77;235
430570;201610;1148;2934;681;1988;154;509;276;683;430;1192
430580;201610;1296;3224;750;2298;126;433;364;1105;490;1538
430583;201610;173;467;43;134;4;10;7;22;11;32
430585;201610;344;890;202;581;44;152;86;214;130;366
430587;201610;190;595;150;490;46;156;36;120;82;276
430590;201610;1279;3478;1141;3228;124;400;848;2332;972;2732
430593;201610;24;88;20;74;5;20;9;31;14;51
430595;201610;311;873;78;265;7;34;9;21;16;55
430597;201610;352;1015;210;667;27;90;60;153;87;243
430600;201610;2116;5614;982;2995;193;589;286;805;479;1394
430605;201610;1381;4092;1012;3309;195;707;403;1295;598;2002
430607;201610;783;1855;554;1497;68;185;357;987;425;1172
430610;201610;8291;22016;5996;18122;1733;5612;1447;4240;3180;9852
430613;201610;275;668;95;282;16;41;19;46;35;87
430620;201610;771;2148;582;1762;142;446;230;654;372;1100
430630;201610;443;1366;192;647;33;109;27;79;60;188
430632;201610;705;1955;311;991;60;200;97;267;157;467
430635;201610;611;1736;448;1384;107;372;223;651;330;1023
430637;201610;488;1372;417;1230;63;217;235;645;298;862
430640;201610;1690;4494;646;2136;92;284;40;90;132;374
430642;201610;489;1266;287;881;53;159;128;391;181;550
430645;201610;277;635;87;247;15;42;23;66;38;108
430650;201610;1845;5895;1510;5183;330;1167;794;2746;1124;3913
430655;201610;170;437;144;385;30;110;74;156;104;266
430660;201610;5864;16296;4417;13587;1106;3631;1768;5354;2874;8985
430670;201610;517;1472;456;1349;40;118;350;1069;390;1187
430673;201610;761;1785;311;939;72;220;92;266;164;486
430675;201610;274;800;85;290;9;42;31;94;40;136
430676;201610;3754;11069;2911;9397;732;2510;933;3015;1665;5525
430680;201610;1156;3289;642;2132;143;475;140;402;283;877
430690;201610;4369;12260;3258;9971;1090;3397;705;2149;1795;5546
430692;201610;275;886;201;743;20;90;132;460;152;550
430693;201610;1304;3559;763;2418;159;564;168;484;327;1048
430695;201610;580;1575;352;1090;66;213;133;373;199;586
430697;201610;494;1371;337;1071;90;295;116;365;206;660
430700;201610;10397;26428;4499;14741;842;3054;300;871;1142;3925
430705;201610;286;855;216;692;73;254;55;148;128;402
430710;201610;1821;4532;1275;3572;266;837;508;1416;774;2253
430720;201610;886;2137;518;1571;128;397;152;451;280;848
430730;201610;1644;4240;997;3098;219;686;408;1304;627;1990
430740;201610;596;1639;297;991;68;230;57;197;125;427
430745;201610;511;1435;204;648;31;102;32;100;63;202
430750;201610;1606;4365;1221;3685;237;795;638;1864;875;2659
430755;201610;518;1382;290;885;31;110;135;377;166;487
430760;201610;3111;7523;2054;5941;441;1483;784;2344;1225;3827
430770;201610;6501;18603;4902;15522;951;3211;2549;7852;3500;11063
430780;201610;2505;6617;1399;4445;285;954;431;1323;716;2277
430781;201610;542;1543;325;1074;70;233;77;256;147;489
430783;201610;552;1333;304;883;57;184;142;372;199;556
430786;201610;75;250;44;167;6;27;9;27;15;54
430790;201610;4880;13231;3089;9512;696;2287;1141;3244;1837;5531
430800;201610;919;2557;575;1763;128;416;193;567;321;983
430805;201610;570;1586;337;1072;36;103;172;541;208;644
430807;201610;460;1292;284;891;61;218;84;239;145;457
430810;201610;710;1919;221;760;51;192;42;139;93;331
430820;201610;1341;3866;702;2411;150;524;142;460;292;984
430825;201610;406;1045;122;363;26;65;20;42;46;107
430830;201610;1765;5383;1578;5084;267;935;976;3083;1243;4018
430840;201610;1015;3000;864;2702;237;731;397;1264;634;1995
430843;201610;87;223;38;115;5;16;14;38;19;54
430845;201610;267;796;205;656;92;312;17;37;109;349
430850;201610;2549;7432;2038;6404;578;1976;721;2157;1299;4133
430860;201610;1064;2818;495;1613;116;442;160;465;276;907
430865;201610;641;1680;556;1539;183;520;238;630;421;1150
430870;201610;737;2030;337;1116;80;268;66;172;146;440
430880;201610;1218;3390;803;2539;207;688;218;717;425;1405
430885;201610;255;611;138;432;20;66;92;288;112;354
430890;201610;1791;4709;1006;3082;145;535;249;641;394;1176
430900;201610;2915;7581;2180;6250;445;1467;996;2634;1441;4101
430905;201610;1094;3076;638;2092;161;547;135;403;296;950
430910;201610;1615;4686;1011;3327;223;824;359;1016;582;1840
430912;201610;470;1327;341;1084;49;166;212;664;261;830
430915;201610;593;1833;395;1443;137;525;80;322;217;847
430920;201610;17477;52255;14842;47066;2870;9949;8361;25561;11231;35510
430925;201610;144;324;54;160;11;34;19;57;30;91
430930;201610;10158;28315;6395;20988;1823;6284;1417;4828;3240;11112
430940;201610;1299;3916;682;2362;170;615;90;255;260;870
430950;201610;1004;2731;621;1916;156;527;215;585;371;1112
430955;201610;172;502;69;230;14;57;19;53;33;110
430957;201610;264;844;206;733;45;158;88;312;133;470
430960;201610;1408;3715;1067;3092;261;833;486;1392;747;2225
430965;201610;1566;4314;1273;3776;80;293;994;2859;1074;3152
430970;201610;528;1424;276;874;58;187;73;208;131;395
430975;201610;605;1929;434;1506;101;368;172;602;273;970
430980;201610;450;1099;243;768;57;179;84;256;141;435
430990;201610;588;1842;351;1206;67;243;98;323;165;566
430995;201610;632;1773;447;1380;123;388;163;476;286;864
431000;201610;1644;4168;684;2134;116;377;53;147;169;524
431010;201610;2780;7711;1441;4937;260;961;190;549;450;1510
431020;201610;11505;27811;6715;19078;1757;5127;1672;4551;3429;9678
431030;201610;328;946;132;482;28;105;18;62;46;167
431033;201610;2523;7304;2148;6694;608;2004;938;2953;1546;4957
431036;201610;225;579;87;288;14;47;18;45;32;92
431040;201610;960;2713;725;2277;143;530;344;997;487;1527
431041;201610;538;1391;445;1248;133;391;173;486;306;877
431043;201610;506;1412;265;930;116;423;51;160;167;583
431046;201610;116;327;75;235;6;22;24;71;30;93
431050;201610;1675;4200;1145;3258;305;884;516;1449;821;2333
431053;201610;615;1936;465;1590;144;530;100;333;244;863
431055;201610;687;1819;626;1717;76;196;461;1275;537;1471
431057;201610;379;1103;222;750;49;176;55;172;104;348
431060;201610;5633;16548;4761;15007;1545;5049;1472;4648;3017;9697
431065;201610;561;1590;378;1199;62;226;131;367;193;593
431070;201610;725;2035;359;1151;86;274;59;148;145;422
431075;201610;299;897;199;676;37;139;58;207;95;346
431080;201610;672;2031;425;1436;96;330;110;347;206;677
431085;201610;859;2307;636;1824;116;332;348;984;464;1316
431087;201610;594;1656;493;1452;51;144;336;1005;387;1149
431090;201610;557;1359;209;666;49;160;42;122;91;282
431100;201610;3727;10238;2869;8690;741;2418;901;2596;1642;5014
431110;201610;1574;4109;1076;3074;247;732;366;969;613;1701
431112;201610;575;1841;510;1701;121;411;238;754;359;1165
431113;201610;532;1506;392;1216;105;340;101;326;206;666
431115;201610;1397;3980;1177;3579;214;649;632;1918;846;2567
431120;201610;2757;8314;1992;6682;648;2442;583;1736;1231;4178
431123;201610;467;1346;283;965;73;244;134;462;207;706
431125;201610;1381;4107;905;3042;297;1005;173;644;470;1649
431127;201610;257;696;50;163;7;20;9;22;16;42
431130;201610;3505;9971;2309;7531;497;1713;731;2366;1228;4079
431140;201610;5070;12379;2491;7699;388;1277;735;1993;1123;3270
431142;201610;470;1360;389;1207;55;175;236;740;291;915
431150;201610;1135;3338;825;2690;183;654;278;884;461;1538
431160;201610;918;2625;732;2251;128;369;356;1189;484;1558
431162;201610;534;1327;181;612;30;101;22;56;52;157
431164;201610;172;475;44;158;11;41;3;12;14;53
431170;201610;737;2019;490;1547;140;456;131;395;271;851
431171;201610;802;2317;663;2028;187;594;228;673;415;1267
431173;201610;489;1401;364;1170;140;485;78;226;218;711
431175;201610;1058;2932;827;2504;242;769;222;634;464;1403
431177;201610;823;2648;606;2194;197;782;221;767;418;1549
431179;201610;375;813;88;255;17;52;19;46;36;98
431180;201610;2415;6800;1505;4905;348;1209;282;841;630;2050
431190;201610;649;1802;322;1049;50;171;63;179;113;350
431198;201610;374;1227;326;1132;116;415;91;339;207;754
431200;201610;409;1150;91;317;11;36;4;10;15;46
431205;201610;296;887;130;456;30;95;36;134;66;229
431210;201610;788;2064;612;1768;174;497;300;889;474;1386
431213;201610;232;704;171;579;23;90;88;294;111;384
431215;201610;317;917;158;544;31;104;9;23;40;127
431217;201610;172;521;113;388;31;105;40;139;71;244
431220;201610;860;2325;449;1407;35;116;207;589;242;705
431225;201610;1377;3790;991;3044;237;718;367;1123;604;1841
431230;201610;853;2472;587;1895;97;330;248;779;345;1109
431235;201610;115;317;29;88;7;21;4;7;11;28
431237;201610;505;1467;384;1269;79;313;191;602;270;915
431238;201610;41;131;31;107;6;25;9;32;15;57
431240;201610;3339;9803;2703;8612;787;2686;1053;3222;1840;5908
431242;201610;392;1175;318;1032;97;314;109;369;206;683
431244;201610;404;925;217;599;27;85;104;260;131;345
431245;201610;1240;3208;772;2283;123;366;365;1058;488;1424
431247;201610;210;592;135;430;32;106;32;95;64;201
431250;201610;1532;4876;1283;4458;350;1303;471;1614;821;2917
431260;201610;351;975;160;560;20;86;47;142;67;228
431261;201610;256;854;205;729;39;172;91;288;130;460
431262;201610;425;1161;175;581;20;72;92;313;112;385
431265;201610;1484;3748;699;2106;134;423;187;461;321;884
431267;201610;275;784;156;472;25;93;95;260;120;353
431270;201610;2862;7053;1658;4945;421;1361;513;1510;934;2871
431275;201610;229;691;117;427;34;126;13;45;47;171
431280;201610;333;920;110;362;13;46;21;47;34;93
431290;201610;334;1018;223;753;43;166;30;70;73;236
431295;201610;93;256;34;108;1;4;11;30;12;34
431300;201610;390;980;47;182;4;17;2;7;6;24
431301;201610;284;871;87;300;15;50;15;42;30;92
431303;201610;782;2051;412;1265;59;209;146;407;205;616
431306;201610;2391;6116;1359;4156;166;586;416;1081;582;1667
431308;201610;40;136;35;119;20;73;8;25;28;98
431310;201610;755;2225;420;1428;83;289;119;409;202;698
431320;201610;805;2210;377;1262;66;234;67;200;133;434
431330;201610;2946;7195;1293;4090;368;1261;101;265;469;1526
431333;201610;426;1135;151;465;23;71;27;68;50;139
431335;201610;54;162;35;118;12;44;6;13;18;57
431337;201610;2592;7726;1734;5907;400;1454;279;903;679;2357
431339;201610;623;1669;405;1217;87;261;188;559;275;820
431340;201610;24961;65856;16628;50430;3945;12762;4106;11880;8051;24642
431342;201610;565;1388;416;1145;131;414;218;537;349;951
431344;201610;377;1012;247;765;10;25;187;588;197;613
431346;201610;301;760;94;293;18;60;13;40;31;100
431349;201610;754;2085;405;1233;78;240;141;394;219;634
431350;201610;4273;12379;3240;10331;722;2560;1140;3377;1862;5937
431360;201610;682;1713;398;1194;101;311;106;307;207;618
431365;201610;1423;4142;1151;3652;220;752;625;1990;845;2742
431370;201610;5012;13889;3697;11505;1011;3345;1197;3794;2208;7139
431380;201610;945;2911;835;2667;120;434;489;1521;609;1955
431390;201610;3184;8291;1712;5364;332;1141;483;1343;815;2484
431395;201610;1297;3836;1038;3337;249;836;464;1488;713;2324
431400;201610;391;1199;157;526;34;124;30;95;64;219
431402;201610;1304;3043;727;2031;152;440;335;889;487;1329
431403;201610;260;724;180;580;55;200;45;127;100;327
431405;201610;4222;11697;3259;10138;621;2125;1678;5043;2299;7168
431406;201610;754;2261;524;1761;134;471;247;812;381;1283
431407;201610;559;1583;348;1161;73;246;107;326;180;572
431410;201610;14886;42114;9196;30381;2675;9747;1311;4016;3986;13763
431413;201610;230;577;81;273;6;23;21;63;27;86
431415;201610;728;2054;484;1569;101;372;144;400;245;772
431417;201610;577;1451;465;1280;59;175;294;795;353;970
431420;201610;1392;3774;1172;3407;254;777;495;1506;749;2283
431430;201610;589;1517;315;966;55;173;119;321;174;494
431440;201610;23628;64944;18075;55390;5430;17435;5351;17228;10781;34663
431442;201610;128;374;66;214;9;29;5;13;14;42
431445;201610;527;1486;184;597;26;82;54;164;80;246
431446;201610;449;1302;288;928;80;260;77;224;157;484
431447;201610;591;1676;430;1337;94;283;189;596;283;879
431449;201610;804;2181;578;1759;56;160;334;1026;390;1186
431450;201610;2246;5415;1907;4883;242;704;1387;3410;1629;4114
431454;201610;63;219;54;196;11;40;22;86;33;126
431455;201610;737;1834;350;981;87;250;110;281;197;531
431460;201610;3382;9195;2682;7782;735;2172;812;2439;1547;4611
431470;201610;1739;5039;1179;3776;264;829;414;1342;678;2171
431475;201610;201;594;29;115;4;22;1;1;5;23
431477;201610;746;1938;453;1324;53;162;226;616;279;778
431478;201610;288;723;82;234;11;31;13;26;24;57
431480;201610;3120;8553;2234;6894;472;1557;1008;2980;1480;4537
431490;201610;112513;299903;93217;269454;11431;38372;63969;179115;75400;217487
431500;201610;614;1693;465;1394;91;262;254;762;345;1024
431505;201610;509;1230;324;935;27;76;201;583;228;659
431507;201610;368;889;199;554;44;120;98;265;142;385
431510;201610;1906;5300;1388;4217;319;1015;459;1289;778;2304
431513;201610;313;834;142;437;21;60;69;214;90;274
431514;201610;111;297;41;143;3;12;8;28;11;40
431515;201610;691;1932;435;1344;101;348;158;434;259;782
431517;201610;80;262;56;198;10;38;12;36;22;74
431520;201610;530;1330;210;677;45;167;28;79;73;246
431530;201610;4396;10193;2943;8209;962;2829;774;2190;1736;5019
431531;201610;279;796;176;570;25;79;62;188;87;267
431532;201610;515;1405;385;1112;82;236;141;395;223;631
431535;201610;347;899;141;432;24;77;41;103;65;180
431540;201610;2106;6815;1807;6319;169;625;1196;4313;1365;4938
431545;201610;345;962;48;169;3;10;12;48;15;58
431550;201610;2276;6586;1895;5842;399;1331;796;2329;1195;3660
431555;201610;701;1719;471;1317;66;186;284;796;350;982
431560;201610;20940;61180;13628;46452;3447;12837;2922;10261;6369;23098
431570;201610;6057;15348;4605;13265;1335;3875;1916;5646;3251;9521
431575;201610;420;1082;283;829;46;149;63;161;109;310
431580;201610;654;1818;346;1120;70;252;98;293;168;545
431590;201610;986;2628;531;1660;131;411;165;518;296;929
431595;201610;444;1239;325;977;43;126;178;532;221;658
431600;201610;2097;5689;1380;4332;311;1088;317;948;628;2036
431610;201610;1507;4231;1010;3192;162;498;426;1367;588;1865
431620;201610;486;1411;222;699;56;179;82;231;138;410
431630;201610;1442;3872;818;2514;238;751;223;647;461;1398
431640;201610;6354;17564;5564;16364;1125;3488;3281;9679;4406;13167
431642;201610;523;1385;370;1095;47;143;172;492;219;635
431643;201610;334;864;150;424;25;73;50;114;75;187
431645;201610;1768;4961;1422;4315;254;837;813;2420;1067;3257
431647;201610;157;452;88;287;13;45;16;45;29;90
431650;201610;354;1055;230;772;25;91;69;200;94;291
431660;201610;1171;3286;645;2140;127;455;118;319;245;774
431670;201610;1308;3409;919;2689;182;610;397;1059;579;1669
431673;201610;230;634;97;316;23;75;12;32;35;107
431675;201610;710;1810;129;436;16;55;32;93;48;148
431680;201610;9878;26715;6982;21084;1993;6296;1715;5174;3708;11470
431690;201610;24017;66211;17678;54861;4838;15700;5581;17662;10419;33362
431695;201610;145;440;94;310;18;61;26;62;44;123
431697;201610;460;1306;393;1178;107;326;179;552;286;878
431700;201610;1581;4451;1295;3886;213;645;708;2088;921;2733
431710;201610;12724;36238;9918;31467;3294;11065;2386;8126;5680;19191
431720;201610;7335;20123;5120;15543;1162;3744;1631;4735;2793;8479
431725;201610;28;82;15;54;3;13;4;12;7;25
431730;201610;4005;11508;3010;9647;834;2909;789;2620;1623;5529
431740;201610;5322;14596;3948;11987;1327;4379;630;1683;1957;6062
431750;201610;9178;25719;7571;22884;1892;6083;3196;9636;5088;15719
431755;201610;331;906;62;211;14;47;12;37;26;84
431760;201610;4219;11756;3180;9781;569;1908;1504;4380;2073;6288
431770;201610;2063;5406;1628;4697;306;898;931;2648;1237;3546
431775;201610;209;555;108;334;21;59;11;29;32;88
431780;201610;2478;6658;1721;5136;431;1357;378;1021;809;2378
431790;201610;1188;3505;864;2770;154;535;329;1017;483;1552
431795;201610;382;1023;211;636;40;123;62;180;102;303
431800;201610;8745;25415;6477;20853;2031;6986;854;2606;2885;9592
431805;201610;341;832;92;315;13;47;22;75;35;122
431810;201610;3268;8869;2358;6996;446;1431;1051;2998;1497;4429
431820;201610;2591;7960;2121;7004;453;1640;891;2783;1344;4423
431830;201610;11074;26692;8147;22134;2238;6466;3123;8460;5361;14926
431840;201610;2717;8072;2246;7198;552;1887;1016;3267;1568;5154
431842;201610;807;2039;267;839;34;111;62;166;96;277
431843;201610;353;1024;271;853;41;148;132;394;173;542
431844;201610;285;788;70;244;17;65;11;28;28;93
431845;201610;522;1506;353;1117;28;90;227;720;255;810
431846;201610;330;991;280;912;27;105;198;635;225;740
431848;201610;259;691;127;406;13;48;23;63;36;111
431849;201610;481;1172;84;253;15;39;14;34;29;73
431850;201610;4858;14100;3986;12252;945;3052;1346;4031;2291;7083
431860;201610;799;2088;528;1557;94;316;261;708;355;1024
431861;201610;103;299;42;150;8;28;10;26;18;54
431862;201610;491;1592;381;1375;79;325;145;500;224;825
431870;201610;18887;54214;14249;45303;3480;11808;4917;15371;8397;27179
431880;201610;4363;12857;3224;10358;835;2896;1077;3233;1912;6129
431890;201610;5159;13888;3485;10702;1070;3464;693;2176;1763;5640
431900;201610;1118;3083;684;2173;181;644;275;788;456;1432
431910;201610;1019;2434;412;1204;65;180;117;318;182;498
431912;201610;504;1457;396;1246;113;334;158;523;271;857
431915;201610;1303;3510;954;2864;238;753;336;999;574;1752
431920;201610;1310;3635;1099;3278;128;383;780;2294;908;2677
431930;201610;1265;3403;810;2595;225;690;352;1175;577;1865
431935;201610;58;190;45;162;10;36;10;29;20;65
431936;201610;383;1107;257;802;56;197;99;304;155;501
431937;201610;333;855;167;506;41;129;25;65;66;194
431940;201610;2602;7022;1533;4790;346;1148;420;1255;766;2403
431950;201610;1668;5022;1418;4544;269;966;687;2090;956;3056
431960;201610;2955;8358;2365;7095;628;1930;700;2070;1328;4000
431970;201610;496;1355;209;687;40;137;45;137;85;274
431971;201610;99;292;55;197;9;32;8;27;17;59
431973;201610;473;1606;402;1455;50;181;252;931;302;1112
431975;201610;109;254;23;87;4;17;6;20;10;37
431980;201610;1394;4026;1066;3325;236;762;346;1029;582;1791
431990;201610;7607;20794;5260;16690;998;3461;1702;5140;2700;8601
432000;201610;10382;28695;7850;24085;2541;7939;2601;7908;5142;15847
432010;201610;2277;6312;1730;5261;343;1118;806;2345;1149;3463
432020;201610;2348;5555;1628;4480;320;967;917;2401;1237;3368
432023;201610;548;1506;319;990;57;189;121;311;178;500
432026;201610;1191;3560;838;2795;126;392;428;1434;554;1826
432030;201610;422;1206;292;915;57;171;141;419;198;590
432032;201610;608;1542;376;1110;67;221;164;439;231;660
432035;201610;839;2485;723;2263;279;955;179;564;458;1519
432040;201610;990;2316;394;1273;67;227;149;457;216;684
432045;201610;262;728;136;463;30;103;38;131;68;234
432050;201610;649;1769;528;1542;95;284;291;872;386;1156
432055;201610;957;2673;633;2035;141;485;293;916;434;1401
432057;201610;409;994;282;767;44;109;157;403;201;512
432060;201610;557;1475;178;611;33;133;45;134;78;267
432065;201610;226;641;160;523;46;164;58;169;104;333
432067;201610;982;2958;683;2286;138;446;295;1000;433;1446
432070;201610;2382;6550;1382;4415;299;1006;296;880;595;1886
432080;201610;3907;10835;3083;9312;969;3122;1068;3158;2037;6280
432085;201610;325;900;209;702;51;177;92;297;143;474
432090;201610;1553;4397;1152;3583;317;1060;458;1362;775;2422
432100;201610;1379;3957;567;1962;92;342;41;99;133;441
432110;201610;2740;8131;1854;6213;432;1658;181;524;613;2182
432120;201610;4752;13897;3782;12072;1398;4654;894;2808;2292;7462
432130;201610;2761;7491;2138;6632;717;2390;801;2453;1518;4843
432132;201610;390;1092;161;555;24;88;40;129;64;217
432135;201610;756;2206;603;1895;101;326;383;1175;484;1501
432140;201610;1929;6109;1450;5148;336;1227;561;2097;897;3324
432143;201610;1417;4106;1148;3629;205;675;559;1804;764;2479
432145;201610;1314;3961;703;2463;119;462;112;356;231;818
432146;201610;182;579;114;409;31;113;23;86;54;199
432147;201610;655;2057;468;1637;127;472;98;355;225;827
432149;201610;370;1018;220;661;45;131;81;240;126;371
432150;201610;3833;10571;2660;8337;607;2082;789;2346;1396;4428
432160;201610;4612;14327;3850;12871;1181;4140;1266;4285;2447;8425
432162;201610;413;995;57;176;11;39;8;21;19;60
432163;201610;373;987;76;243;4;15;1;2;5;17
432166;201610;703;2045;533;1687;79;287;228;668;307;955
432170;201610;1190;3625;762;2655;185;665;146;475;331;1140
432180;201610;2797;7447;1599;4955;359;1155;296;786;655;1941
432183;201610;419;1291;314;1064;110;406;53;171;163;577
432185;201610;940;2424;571;1718;83;264;297;878;380;1142
432190;201610;3373;9043;1950;5880;416;1319;537;1492;953;2811
432195;201610;1136;3002;762;2336;153;451;307;920;460;1371
432200;201610;3155;9338;2435;8034;599;2129;1023;3366;1622;5495
432210;201610;427;1153;287;908;66;235;96;279;162;514
432215;201610;859;2570;714;2327;165;499;383;1333;548;1832
432218;201610;279;705;159;457;29;74;54;142;83;216
432220;201610;4281;11164;3290;9462;451;1475;1910;5254;2361;6729
432225;201610;107;329;81;274;32;117;20;64;52;181
432230;201610;1041;2777;571;1730;123;383;142;360;265;743
432232;201610;537;1496;407;1240;76;257;181;521;257;778
432234;201610;387;1039;213;654;44;133;56;162;100;295
432235;201610;111;319;35;124;6;19;1;1;7;20
432237;201610;473;1266;407;1145;22;78;290;786;312;864
432240;201610;14284;43701;11478;39670;1771;7092;6868;24234;8639;31326
432250;201610;4876;16371;4223;14982;1295;4875;1320;4723;2615;9598
432252;201610;449;1170;293;922;51;171;165;525;216;696
432253;201610;1316;4135;678;2385;149;581;46;132;195;713
432254;201610;877;2345;193;624;39;127;23;55;62;182
432255;201610;220;566;113;372;20;71;37;111;57;182
432260;201610;7824;19271;5133;14710;1205;3487;2060;6151;3265;9638
432270;201610;2648;7726;2082;6644;604;2011;562;1762;1166;3773
432280;201610;1420;3820;670;2131;95;308;168;473;263;781
432285;201610;196;613;22;76;4;16;2;2;6;18
432290;201610;569;1646;326;1065;90;289;77;248;167;537
432300;201610;24396;71344;20553;64360;3843;12986;11519;35284;15362;48270
432310;201610;820;2363;617;2001;155;529;293;922;448;1451
432320;201610;236;602;99;307;21;62;17;43;38;105
432330;201610;334;870;110;357;13;41;14;36;27;77
432335;201610;157;450;56;199;12;41;10;26;22;67
432340;201610;316;766;151;460;28;100;50;137;78;237
432345;201610;660;1820;590;1695;78;281;374;986;452;1267
432350;201610;396;1070;190;623;29;88;58;176;87;264
432360;201610;198;610;37;140;5;20;7;20;12;40
432370;201610;422;1163;295;893;38;112;181;557;219;669
432375;201610;781;1942;571;1598;72;197;328;917;400;1114
432377;201610;229;760;31;114;5;18;9;27;14;45
432380;201610;956;3049;759;2635;244;937;290;964;534;1901
500020;201610;2419;6954;1744;5728;357;1354;737;2304;1094;3658
500025;201610;1411;3266;797;2172;78;202;468;1244;546;1446
500060;201610;7126;20909;5394;17830;773;2504;3381;11606;4154;14110
500070;201610;4483;12674;3303;10468;748;2597;1246;3910;1994;6507
500080;201610;1514;4394;1063;3499;279;1006;360;1152;639;2158
500085;201610;2337;5912;1555;4689;150;454;967;2847;1117;3301
500090;201610;2393;6754;1640;5318;331;1103;678;2297;1009;3400
500100;201610;2887;8150;2197;6886;491;1686;892;2629;1383;4315
500110;201610;8475;24591;6337;21074;1128;4025;2823;9883;3951;13908
500124;201610;2096;6645;1742;6027;424;1400;845;3256;1269;4656
500150;201610;1423;3595;890;2630;182;600;328;820;510;1420
500190;201610;5065;12818;3699;10842;792;2413;1924;5735;2716;8148
500200;201610;2493;6207;1757;4862;409;1177;688;1765;1097;2942
500210;201610;4849;14265;3866;12620;928;3147;1677;5539;2605;8686
500215;201610;1529;4619;1055;3602;188;675;385;1291;573;1966
500220;201610;3134;9586;2458;8355;502;1789;1072;3671;1574;5460
500230;201610;2888;7291;1937;5705;379;1186;957;2844;1336;4030
500240;201610;4646;14446;3105;11095;534;2102;917;3398;1451;5500
500260;201610;2837;7096;1884;5555;297;936;965;2732;1262;3668
500270;201610;128868;327851;74390;228361;17390;56519;16996;50527;34386;107046
500280;201610;1385;3492;1092;3072;78;233;854;2425;932;2658
500290;201610;4694;10501;2421;7042;513;1581;858;2415;1371;3996
500295;201610;2759;7872;1464;4810;226;811;385;1064;611;1875
500310;201610;805;2090;626;1808;135;440;316;861;451;1301
500315;201610;3210;9871;2538;8705;354;1240;1557;5526;1911;6766
500320;201610;17666;55770;12967;46495;3870;14940;3270;12161;7140;27101
500325;201610;4229;10716;2939;8622;546;1722;1615;4740;2161;6462
500330;201610;6986;18019;4388;13056;865;2783;1911;5521;2776;8304
500345;201610;2219;5710;1644;4800;402;1253;733;2104;1135;3357
500348;201610;2316;6663;1963;6083;156;584;1358;4110;1514;4694
500350;201610;1290;3756;622;2131;68;244;210;713;278;957
500370;201610;24375;72081;17075;57988;3745;14157;5019;16842;8764;30999
500375;201610;2946;7997;2041;6213;411;1279;584;1746;995;3025
500380;201610;3505;9404;2464;7477;566;1750;990;2989;1556;4739
500390;201610;604;1336;320;881;53;170;166;418;219;588
500400;201610;1394;4168;954;3110;211;713;237;719;448;1432
500410;201610;2257;6329;1748;5545;364;1197;907;2958;1271;4155
500430;201610;2758;7491;1898;6174;410;1487;746;2490;1156;3977
500440;201610;1508;3933;945;2910;169;559;408;1242;577;1801
500450;201610;1714;4996;1109;3735;216;778;175;484;391;1262
500460;201610;4105;11897;2677;8939;704;2573;533;1677;1237;4250
500470;201610;3106;8988;1968;6443;522;1845;333;983;855;2828
500480;201610;2347;6920;2113;6622;188;509;1638;5531;1826;6040
500490;201610;983;2683;674;2115;199;708;120;382;319;1090
500500;201610;3982;11803;2876;10033;1075;4254;850;2927;1925;7181
500510;201610;864;2208;511;1544;64;213;225;612;289;825
500515;201610;1960;5125;1532;4518;205;603;957;3027;1162;3630
500520;201610;3249;10966;2756;9991;409;1683;1706;6121;2115;7804
500525;201610;1216;3772;929;3205;154;603;437;1540;591;2143
500540;201610;6422;17313;3388;11394;917;3524;434;1232;1351;4756
500560;201610;4823;15498;4262;14567;515;1912;3045;10439;3560;12351
500568;201610;4448;10740;2686;7921;665;2309;773;1975;1438;4284
500570;201610;8042;20961;4692;14447;1243;4060;870;2546;2113;6606
500580;201610;3788;10434;2909;8943;260;814;2088;6470;2348;7284
500600;201610;4027;10546;2372;7389;609;2031;602;1789;1211;3820
500620;201610;8043;22638;5522;17584;1067;3576;2335;7437;3402;11013
500625;201610;756;2172;382;1293;69;244;130;438;199;682
500627;201610;664;1775;388;1240;86;271;88;277;174;548
500630;201610;6199;16683;4115;12960;1065;3550;1211;3716;2276;7266
500635;201610;2794;10133;2236;9234;271;1078;1544;6841;1815;7919
500640;201610;1698;4034;1246;3369;72;219;923;2455;995;2674
500660;201610;19779;55810;14349;46507;4281;15431;3879;12196;8160;27627
500690;201610;2587;7540;2012;6695;947;3313;478;1675;1425;4988
500710;201610;3538;10293;2790;8937;632;2275;1099;3419;1731;5694
500720;201610;6328;16592;3609;11600;924;3196;719;2185;1643;5381
500730;201610;1015;2770;627;1974;154;513;199;593;353;1106
500740;201610;4467;11940;3105;9386;374;1280;1610;4808;1984;6088
500750;201610;995;2719;781;2333;133;434;401;1132;534;1566
500755;201610;1222;3524;757;2513;149;505;145;377;294;882
500769;201610;5601;14645;2762;8632;472;1582;582;1524;1054;3106
500770;201610;1766;5044;1134;3776;271;945;285;932;556;1877
500780;201610;1174;3342;830;2653;222;699;221;689;443;1388
500790;201610;10057;26954;7893;23194;1524;5063;4151;11700;5675;16763
500793;201610;2280;6427;1591;5111;478;1614;304;824;782;2438
500795;201610;2414;7036;1998;6432;265;703;1378;4790;1643;5493
500797;201610;852;2281;544;1734;100;356;209;623;309;979
500800;201610;3004;7887;2125;6546;823;2832;433;1358;1256;4190
500830;201610;20309;53328;13032;39273;2583;8391;4625;13044;7208;21435
500840;201610;1382;3769;811;2561;88;295;328;974;416;1269
510010;201610;1276;3717;997;3229;242;758;519;1730;761;2488
510020;201610;3485;9722;1898;6368;408;1416;379;1141;787;2557
510025;201610;7691;22098;5139;16840;1145;3976;1395;4209;2540;8185
510030;201610;1724;4600;1330;3961;268;869;656;1883;924;2752
510035;201610;874;2442;600;1994;138;473;303;1018;441;1491
510040;201610;1843;4896;1327;4056;189;617;753;2283;942;2900
510050;201610;1897;5429;1284;4192;336;1187;373;1183;709;2370
510060;201610;1630;4579;1143;3598;204;674;479;1450;683;2124
510080;201610;1040;3302;778;2734;219;819;115;344;334;1163
510100;201610;689;1782;431;1250;48;156;212;560;260;716
510120;201610;312;665;199;522;11;36;139;360;150;396
510125;201610;3200;8280;2259;6550;406;1367;893;2335;1299;3702
510130;201610;1782;4914;1361;4135;382;1234;423;1246;805;2480
510140;201610;2933;9100;2148;7798;913;3676;416;1251;1329;4927
510160;201610;1329;4400;1178;4160;213;808;715;2510;928;3318
510170;201610;5318;15845;4060;13555;798;2871;1792;5749;2590;8620
510180;201610;12645;32433;8085;24852;2368;7555;2200;7598;4568;15153
510185;201610;1398;4120;1093;3693;182;568;679;2548;861;3116
510190;201610;2495;6715;1652;5406;281;969;914;3053;1195;4022
510250;201610;14233;42172;11771;38209;3533;12170;4483;14904;8016;27074
510260;201610;2209;8978;1763;8026;329;1393;942;4954;1271;6347
510263;201610;4197;11147;2875;8883;717;2336;691;2005;1408;4341
510267;201610;5858;16880;3730;12156;798;2784;907;2804;1705;5588
510268;201610;920;2619;758;2378;148;507;447;1379;595;1886
510269;201610;1012;3101;679;2385;235;860;150;511;385;1371
510270;201610;2735;8816;2092;7377;468;1651;763;2657;1231;4308
510279;201610;1845;5563;1379;4495;356;1239;434;1278;790;2517
510285;201610;1252;3614;905;2983;259;923;277;863;536;1786
510300;201610;3465;9884;2751;8828;195;691;2073;6726;2268;7417
510305;201610;1551;4754;1121;3893;281;1046;346;1219;627;2265
510310;201610;818;2433;649;2111;220;748;182;571;402;1319
510320;201610;3825;10779;2589;8365;599;2183;819;2404;1418;4587
510325;201610;5233;16121;4262;14756;1147;4124;2451;8748;3598;12872
510330;201610;2831;8846;2128;7496;525;1926;732;2650;1257;4576
510335;201610;4937;14600;3845;13133;520;1754;2585;9279;3105;11033
510336;201610;606;1836;426;1474;83;294;192;664;275;958
510337;201610;2044;6579;1531;5529;605;2302;235;856;840;3158
510340;201610;79100;208456;50426;160412;16905;58971;8752;27894;25657;86865
510343;201610;1131;3226;827;2626;107;361;469;1456;576;1817
510345;201610;1645;4812;1236;4017;324;1136;426;1314;750;2450
510350;201610;3297;8787;2358;7378;603;1992;1024;3301;1627;5293
510360;201610;1788;4339;1096;3448;102;397;780;2412;882;2809
510370;201610;1379;4397;1051;3830;236;912;542;2033;778;2945
510380;201610;526;1526;288;1010;81;302;23;77;104;379
510385;201610;974;3641;656;2878;80;382;320;1516;400;1898
510390;201610;1093;3446;902;3052;243;762;447;1604;690;2366
510395;201610;785;1882;521;1486;72;229;232;731;304;960
510410;201610;3908;12466;3232;11131;810;2881;1485;5213;2295;8094
510420;201610;2456;6089;1720;4825;253;777;845;2334;1098;3111
510450;201610;728;1895;449;1408;102;350;122;357;224;707
510452;201610;679;2142;475;1646;79;271;252;864;331;1135
510454;201610;883;2709;707;2363;100;348;447;1518;547;1866
510455;201610;988;3015;678;2312;123;481;245;771;368;1252
510460;201610;2333;6030;1649;4970;204;731;955;2735;1159;3466
510480;201610;4645;11924;3034;8880;609;1843;997;2711;1606;4554
510490;201610;1633;5010;1334;4531;304;1148;694;2261;998;3409
510500;201610;1508;4416;970;3312;198;799;448;1447;646;2246
510510;201610;2756;9372;2189;8212;658;2596;564;2148;1222;4744
510515;201610;6559;19137;4194;13942;883;3152;957;2929;1840;6081
510517;201610;1588;4691;1192;3880;342;1153;262;813;604;1966
510520;201610;2167;4931;1427;3952;53;153;1008;2955;1061;3108
510523;201610;1005;2911;857;2650;123;370;589;1882;712;2252
510525;201610;8261;21447;5220;16243;1039;3292;1824;5542;2863;8834
510530;201610;534;1507;434;1353;43;194;294;860;337;1054
510550;201610;2817;9048;2092;7565;568;2185;659;2361;1227;4546
510558;201610;1930;5481;1540;4858;187;622;956;3113;1143;3735
510560;201610;1740;5169;1014;3862;288;1168;209;819;497;1987
510562;201610;5448;15744;3725;12148;1088;3766;923;3073;2011;6839
510590;201610;3342;8395;2472;7265;492;1380;1457;4457;1949;5837
510600;201610;1637;4137;976;2955;207;632;369;1077;576;1709
510610;201610;2939;8276;2283;7226;208;739;1493;4637;1701;5376
510615;201610;2091;6283;1705;5627;527;1806;679;2285;1206;4091
510617;201610;638;1858;516;1651;37;95;412;1381;449;1476
510618;201610;1519;4293;1021;3293;213;815;483;1444;696;2259
510619;201610;810;2221;421;1414;45;175;54;145;99;320
510620;201610;1447;3574;710;2319;193;690;104;279;297;969
510621;201610;833;2824;716;2568;189;757;193;650;382;1407
510622;201610;4036;12065;2669;9029;729;2619;429;1290;1158;3909
510623;201610;3435;9471;2447;7689;632;2188;836;2415;1468;4603
510624;201610;1579;4492;835;2857;161;615;156;468;317;1083
510625;201610;2114;5936;1497;4856;413;1461;248;771;661;2232
510626;201610;1588;4206;959;3240;297;1118;194;624;491;1742
510627;201610;735;2093;465;1505;130;450;102;327;232;777
510628;201610;1585;3882;1060;3126;189;554;641;1907;830;2461
510629;201610;1817;5854;1383;4861;425;1619;375;1293;800;2912
510630;201610;2498;8311;1610;6286;368;1577;264;1006;632;2583
510631;201610;390;1092;326;979;14;33;270;816;284;849
510637;201610;2799;8081;2271;7182;843;2870;661;2024;1504;4894
510642;201610;4841;15769;3992;14431;1260;5008;1584;5888;2844;10896
510645;201610;977;2187;594;1652;203;540;160;475;363;1015
510650;201610;6392;20731;5654;19804;1476;5389;3381;12227;4857;17616
510665;201610;1748;4525;972;3026;171;541;408;1305;579;1846
510670;201610;405;914;215;638;21;79;106;308;127;387
510675;201610;6524;20153;4829;16652;1405;5248;972;3241;2377;8489
510677;201610;1948;5249;1571;4739;178;545;1165;3655;1343;4200
510680;201610;725;2166;484;1649;109;385;85;254;194;639
510682;201610;2127;6707;1535;5497;438;1732;276;927;714;2659
510685;201610;942;2504;707;2107;86;281;428;1226;514;1507
510700;201610;4367;11200;2792;8846;653;2087;1277;4177;1930;6264
510704;201610;10096;26373;6996;20625;1376;4440;2948;8093;4324;12533
510706;201610;1947;5784;1296;4760;272;1020;658;2561;930;3581
510710;201610;3402;9292;2215;6802;502;1568;638;1770;1140;3338
510715;201610;735;1765;449;1250;74;215;177;516;251;731
510718;201610;2364;5832;1461;4698;669;2167;314;1195;983;3362
510719;201610;429;964;234;689;29;106;119;333;148;439
510720;201610;1201;2849;774;2220;204;645;256;619;460;1264
510724;201610;741;2204;520;1737;108;399;200;611;308;1010
510726;201610;669;1594;444;1232;70;193;244;643;314;836
510729;201610;728;1809;362;1102;84;288;117;339;201;627
510730;201610;2839;7995;1876;6115;553;1919;466;1438;1019;3357
510735;201610;1008;3265;749;2844;139;580;381;1451;520;2031
510740;201610;1151;2758;746;2121;153;412;381;1151;534;1563
510757;201610;730;2378;586;2091;262;962;143;474;405;1436
510760;201610;33059;83366;19872;60371;5881;19212;4026;11207;9907;30419
510770;201610;4527;11121;3619;9996;363;924;2391;7309;2754;8233
510774;201610;367;1024;298;881;51;176;153;473;204;649
510775;201610;724;2120;553;1782;164;591;139;392;303;983
510776;201610;554;1518;399;1186;95;314;155;444;250;758
510777;201610;1594;4603;1145;3957;156;562;886;3089;1042;3651
510779;201610;646;1925;471;1585;73;238;229;801;302;1039
510780;201610;3808;11048;2933;9621;756;2529;1168;4090;1924;6619
510785;201610;1783;5099;1169;3920;333;1145;193;674;526;1819
510787;201610;2373;7066;1765;5916;757;2671;259;803;1016;3474
510788;201610;572;1456;378;1154;137;420;112;391;249;811
510790;201610;16531;47270;9884;33881;2091;8011;1067;3600;3158;11611
510792;201610;8721;24994;5257;18018;1074;4023;865;2721;1939;6744
510794;201610;1247;3815;911;3143;282;1064;250;795;532;1859
510795;201610;8362;24685;5656;19338;1527;5709;1086;3835;2613;9544
510800;201610;1650;4559;1210;3831;255;860;518;1518;773;2378
510805;201610;2024;5536;1401;4427;310;1088;607;1769;917;2857
510810;201610;670;1628;495;1368;138;380;226;603;364;983
510820;201610;770;1757;453;1261;83;275;178;430;261;705
510830;201610;710;2072;554;1820;113;369;281;982;394;1351
510835;201610;651;1881;450;1488;90;320;189;585;279;905
510840;201610;48043;119185;36500;103147;9085;26567;16602;48000;25687;74567
510850;201610;1675;4593;953;3184;254;892;135;399;389;1291
510860;201610;2719;8260;1791;6422;584;2323;115;366;699;2689
510880;201610;621;2045;512;1841;164;631;186;667;350;1298
510885;201610;653;1815;500;1590;94;325;200;617;294;942
510890;201610;856;2640;673;2356;152;589;337;1167;489;1756
510895;201610;1133;3417;895;2920;204;750;336;998;540;1748
520005;201610;1514;4728;1295;4393;396;1334;568;2015;964;3349
520010;201610;1778;5920;1345;4954;487;2000;209;660;696;2660
520013;201610;3387;9435;2340;7362;576;1864;706;2237;1282;4101
520015;201610;490;1386;378;1197;86;295;127;417;213;712
520017;201610;1087;3181;864;2782;218;782;333;981;551;1763
520020;201610;463;1184;340;1000;69;213;154;438;223;651
520025;201610;28694;86543;26273;83267;3320;11157;20050;63272;23370;74429
520030;201610;4792;14613;3779;12761;674;2499;1914;6406;2588;8905
520050;201610;429;1079;247;738;18;46;174;538;192;584
520055;201610;783;2347;647;2056;114;353;347;1110;461;1463
520060;201610;1372;4263;1113;3725;271;1001;362;1148;633;2149
520080;201610;1865;5348;1511;4847;296;882;837;2889;1133;3771
520082;201610;1109;2929;937;2637;168;397;593;1744;761;2141
520085;201610;840;2505;708;2254;161;510;235;739;396;1249
520090;201610;988;2276;686;1875;157;368;345;1052;502;1420
520110;201610;42593;121768;30814;102436;11295;41906;4028;12522;15323;54428
520120;201610;177;464;92;312;17;64;25;81;42;145
520130;201610;3447;9596;2984;8872;686;2193;1557;4658;2243;6851
520140;201610;36272;116373;28786;101014;10535;39517;4144;13923;14679;53440
520145;201610;383;1031;252;781;49;162;71;211;120;373
520150;201610;501;1307;398;1178;61;206;227;650;288;856
520160;201610;911;2407;703;2077;189;550;219;657;408;1207
520170;201610;4533;10218;3426;8909;257;701;2837;7444;3094;8145
520180;201610;2137;6187;1691;5446;285;1076;872;2741;1157;3817
520215;201610;2018;5106;1569;4357;196;551;1002;2800;1198;3351
520235;201610;718;1831;502;1493;100;341;194;542;294;883
520250;201610;1592;4455;1054;3483;290;1057;232;736;522;1793
520260;201610;806;2023;466;1370;90;283;171;465;261;748
520280;201610;570;1641;491;1529;156;507;179;615;335;1122
520310;201610;1225;2905;787;2180;221;662;258;761;479;1423
520320;201610;1950;5959;1516;5087;144;489;989;3393;1133;3882
520330;201610;2719;8277;1938;6853;519;1976;282;946;801;2922
520340;201610;1911;4769;1402;4044;219;550;903;2782;1122;3332
520350;201610;3390;9081;2389;7167;695;2230;885;2539;1580;4769
520355;201610;1114;3596;956;3326;265;990;441;1502;706;2492
520357;201610;866;2311;688;2006;63;194;473;1375;536;1569
520360;201610;724;2048;577;1783;162;518;220;694;382;1212
520380;201610;1313;3506;804;2488;115;382;362;1065;477;1447
520390;201610;1107;2617;611;1937;174;631;180;502;354;1133
520393;201610;542;1295;399;1078;52;142;239;624;291;766
520396;201610;696;2224;560;1950;63;257;363;1230;426;1487
520400;201610;1674;4745;1389;4307;257;854;825;2514;1082;3368
520410;201610;1591;3784;1104;3064;222;690;595;1599;817;2289
520420;201610;331;917;229;698;37;121;91;255;128;376
520425;201610;1276;3486;952;2848;286;866;393;1201;679;2067
520430;201610;1942;5115;1059;3385;237;737;169;478;406;1215
520440;201610;3789;9693;2353;7024;693;2253;472;1370;1165;3623
520450;201610;10784;29279;6342;20777;1511;5236;385;1144;1896;6380
520455;201610;715;2105;536;1780;178;615;180;601;358;1216
520460;201610;909;2539;733;2240;108;383;419;1233;527;1616
520465;201610;885;2297;738;2093;73;250;523;1426;596;1676
520470;201610;1765;5634;1557;5288;359;1265;943;3317;1302;4582
520480;201610;970;2779;604;2023;97;333;181;521;278;854
520485;201610;1329;4150;1129;3812;239;888;676;2279;915;3167
520490;201610;4167;12679;3161;11025;895;3129;1406;5057;2301;8186
520495;201610;1414;3658;1122;3250;89;271;891;2637;980;2908
520500;201610;1338;3714;1064;3292;283;949;430;1302;713;2251
520505;201610;745;2100;617;1881;133;410;321;975;454;1385
520510;201610;9387;25929;6224;20557;1499;5367;1916;6325;3415;11692
520520;201610;1097;3014;840;2623;277;895;232;747;509;1642
520530;201610;1999;6493;1552;5666;566;2070;380;1511;946;3581
520540;201610;2913;8111;1956;6222;534;1748;334;1060;868;2808
520545;201610;1108;3308;853;2780;167;581;262;807;429;1388
520547;201610;675;2091;555;1856;185;623;170;538;355;1161
520549;201610;9869;28858;7959;26011;2303;7806;3568;11780;5871;19586
520551;201610;3745;11287;3362;10687;821;2883;2005;6242;2826;9125
520552;201610;766;2258;679;2142;101;332;472;1512;573;1844
520570;201610;590;1626;394;1261;140;478;131;396;271;874
520580;201610;3218;7766;2142;6217;504;1651;1053;2961;1557;4612
520590;201610;1453;4093;1016;3274;237;782;210;652;447;1434
520620;201610;7955;23523;6832;21893;1685;5541;3661;11868;5346;17409
520630;201610;945;2413;609;1846;108;335;278;817;386;1152
520640;201610;2836;7672;2201;6546;572;1699;862;2626;1434;4325
520650;201610;862;2268;602;1770;111;371;325;932;436;1303
520660;201610;360;1012;264;872;96;345;86;285;182;630
520670;201610;981;2844;856;2657;60;186;680;2088;740;2274
520680;201610;797;2075;575;1695;142;411;237;703;379;1114
520690;201610;324;848;236;705;60;159;104;316;164;475
520710;201610;557;1439;326;975;7;18;210;623;217;641
520725;201610;1632;4135;1153;3314;168;526;729;2041;897;2567
520735;201610;834;2273;548;1720;113;395;191;581;304;976
520740;201610;1856;4855;1412;4238;238;775;787;2310;1025;3085
520750;201610;633;1692;478;1448;105;303;219;697;324;1000
520753;201610;1503;3992;1308;3706;184;517;866;2609;1050;3126
520760;201610;833;2189;713;2024;85;225;513;1535;598;1760
520780;201610;1955;4744;1436;3967;166;450;939;2556;1105;3006
520790;201610;2847;7182;2086;5998;195;511;1535;4585;1730;5096
520800;201610;16948;46693;14115;43169;3002;8678;8416;27526;11418;36204
520810;201610;1102;2681;825;2337;85;232;638;1906;723;2138
520815;201610;592;1856;393;1405;165;647;18;58;183;705
520830;201610;1672;4218;1318;3812;50;136;1124;3243;1174;3379
520840;201610;1741;5553;1417;4959;564;2109;268;995;832;3104
520850;201610;606;1834;431;1521;107;411;123;426;230;837
520860;201610;6697;19594;4842;16307;1206;4316;1659;5682;2865;9998
520870;201610;104276;275037;67813;212645;20163;68168;14459;42746;34622;110914
520880;201610;7174;20258;5077;16981;1891;7050;434;1306;2325;8356
520890;201610;3948;10908;3000;9248;623;2116;1395;4215;2018;6331
520910;201610;3938;11183;2639;8603;947;3276;474;1451;1421;4727
520915;201610;650;1895;475;1542;115;393;219;690;334;1083
520920;201610;3533;9344;2391;7481;464;1531;928;2967;1392;4498
520929;201610;624;1633;443;1330;100;280;228;725;328;1005
520940;201610;1093;3089;852;2720;88;312;621;1947;709;2259
520945;201610;664;1586;505;1303;125;290;256;655;381;945
520960;201610;1039;3006;779;2493;69;211;402;1322;471;1533
520970;201610;2933;8824;2395;7778;631;2207;594;1851;1225;4058
520980;201610;774;2222;654;2030;205;671;333;1027;538;1698
520990;201610;3008;9497;2768;9156;340;1137;1922;6638;2262;7775
520993;201610;980;2472;764;2150;48;136;567;1615;615;1751
520995;201610;2340;6214;1979;5720;402;1093;1204;3579;1606;4672
521000;201610;7348;21811;5587;18300;1991;6967;1250;3813;3241;10780
521010;201610;4103;11769;3030;9689;715;2251;1240;3957;1955;6208
521015;201610;693;1880;575;1684;110;301;356;1055;466;1356
521020;201610;2868;8200;1747;5744;523;1812;170;519;693;2331
521030;201610;669;1676;478;1344;102;283;190;546;292;829
521040;201610;6366;16956;5035;14793;1757;5285;1564;4812;3321;10097
521056;201610;875;2620;690;2294;251;894;182;649;433;1543
521060;201610;1128;2917;853;2478;264;745;320;1000;584;1745
521080;201610;1150;2745;632;1855;65;227;264;672;329;899
521090;201610;3012;8047;2254;6946;739;2361;661;2066;1400;4427
521100;201610;2060;4669;1482;3878;255;629;934;2537;1189;3166
521120;201610;4882;12461;3611;10771;928;2919;1378;4452;2306;7371
521130;201610;1052;2832;740;2214;106;384;430;1258;536;1642
521140;201610;1056;3177;806;2650;200;684;261;865;461;1549
521150;201610;12214;30280;7153;21260;2824;8718;1549;4637;4373;13355
521160;201610;869;2032;518;1423;106;294;230;624;336;918
521170;201610;1171;2844;837;2318;162;472;485;1310;647;1782
521180;201610;6537;20844;5668;19205;1546;5536;1848;6282;3394;11818
521190;201610;9479;26985;5829;19803;1477;5415;1185;3930;2662;9345
521200;201610;768;2067;578;1722;65;217;341;995;406;1212
521205;201610;616;1723;460;1437;49;156;273;845;322;1001
521210;201610;947;2629;543;1732;147;544;105;271;252;815
521220;201610;4473;11203;3124;9265;688;2191;1452;4311;2140;6502
521225;201610;407;987;325;893;38;98;234;677;272;775
521230;201610;1265;3932;1088;3562;337;1185;484;1532;821;2717
521250;201610;30497;93207;24985;84179;11082;38941;5869;20163;16951;59104
521260;201610;697;1670;547;1450;94;281;304;772;398;1053
521270;201610;1904;5399;1682;5063;168;436;1245;3899;1413;4335
521280;201610;1873;5653;1477;4860;420;1438;452;1467;872;2905
521290;201610;493;1355;358;1149;87;321;163;494;250;815
521295;201610;1219;2920;969;2563;149;366;676;1868;825;2234
521300;201610;1946;5448;1606;4864;191;555;1024;3123;1215;3678
521305;201610;750;2102;588;1823;112;323;312;1005;424;1328
521308;201610;4476;13132;3399;10937;831;2701;1457;4658;2288;7359
521310;201610;8291;24052;5498;18328;1376;4913;1174;3634;2550;8547
521340;201610;338;871;313;839;17;43;269;715;286;758
521350;201610;1998;5422;1541;4651;245;716;971;2998;1216;3714
521370;201610;966;2796;661;2218;232;826;103;323;335;1149
521375;201610;1363;3827;1067;3345;281;967;468;1391;749;2358
521377;201610;1108;2795;980;2640;63;113;839;2309;902;2422
521380;201610;5637;15804;3361;11206;499;1694;1212;3972;1711;5666
521385;201610;535;1411;447;1297;134;402;192;580;326;982
521390;201610;801;2192;590;1882;181;654;172;518;353;1172
521400;201610;2167;6078;1938;5778;328;1100;1366;4028;1694;5128
521405;201610;1411;3920;1060;3265;323;1061;419;1285;742;2346
521410;201610;734;2200;666;2085;214;618;297;1011;511;1629
521440;201610;1406;4049;1068;3305;185;623;397;1056;582;1679
521450;201610;3973;12664;3015;10622;954;3503;558;1885;1512;5388
521460;201610;6823;19402;5367;16743;1456;4831;2154;6518;3610;11349
521470;201610;698;1977;474;1509;112;359;76;242;188;601
521480;201610;383;1135;241;801;54;194;75;239;129;433
521483;201610;2852;7386;2018;5864;528;1540;591;1666;1119;3206
521486;201610;1664;4204;1302;3647;109;289;965;2714;1074;3003
521487;201610;530;1394;364;1100;112;373;67;184;179;557
521490;201610;803;2248;609;1920;38;164;412;1233;450;1397
521500;201610;1379;4279;935;3245;178;714;214;614;392;1328
521520;201610;892;2066;651;1737;148;408;320;900;468;1308
521523;201610;13430;47269;12155;44840;4295;16976;1736;7065;6031;24041
521525;201610;1076;2760;864;2414;103;331;548;1474;651;1805
521530;201610;1768;5021;1014;3401;245;850;151;485;396;1335
521540;201610;959;2581;617;1959;130;479;213;645;343;1124
521550;201610;1593;4025;941;2666;195;581;435;1206;630;1787
521560;201610;3675;11777;2947;10663;1167;4587;960;3449;2127;8036
521565;201610;612;1578;511;1443;92;224;320;924;412;1148
521570;201610;4696;12869;2716;8792;603;2077;458;1470;1061;3547
521580;201610;567;1293;302;877;76;216;58;154;134;370
521590;201610;666;1815;507;1537;142;463;157;450;299;913
521600;201610;504;1384;317;1010;72;232;71;213;143;445
521630;201610;1425;3534;951;2814;228;800;206;518;434;1318
521640;201610;2152;5394;1575;4547;418;1206;664;1972;1082;3178
521645;201610;582;1700;403;1306;78;262;140;426;218;688
521680;201610;1375;4399;1105;3842;491;1793;136;446;627;2239
521690;201610;580;1675;502;1539;123;429;228;645;351;1074
521710;201610;2935;8516;2205;7119;454;1513;683;2198;1137;3711
521720;201610;1960;5491;1432;4452;289;877;727;2181;1016;3058
521730;201610;3755;12144;3093;10719;1102;4190;555;1633;1657;5823
521740;201610;3734;10229;2755;8676;619;2116;1266;4120;1885;6236
521760;201610;13911;44112;11577;39795;3254;11999;4345;14931;7599;26930
521770;201610;2660;7666;2012;6364;756;2559;510;1504;1266;4063
521800;201610;7065;21192;5835;19014;1838;6232;1987;6738;3825;12970
521805;201610;921;2057;626;1616;161;377;302;854;463;1231
521810;201610;816;2017;569;1650;104;320;261;785;365;1105
521830;201610;5261;16445;4594;15393;703;2588;3039;10067;3742;12655
521839;201610;740;2003;509;1549;102;319;198;562;300;881
521850;201610;7086;18735;5000;14922;1182;3716;1426;3915;2608;7631
521860;201610;2045;5474;1478;4529;339;1136;424;1278;763;2414
521870;201610;520;1719;410;1477;108;403;132;456;240;859
521878;201610;796;2258;529;1693;79;282;212;627;291;909
521880;201610;22971;58678;14428;44148;3975;12756;4255;13313;8230;26069
521890;201610;3482;10172;2404;7910;670;2325;407;1262;1077;3587
521900;201610;1476;3846;971;3030;236;775;322;939;558;1714
521910;201610;942;2519;809;2352;130;389;468;1433;598;1822
521920;201610;299;946;239;824;90;336;49;160;139;496
521925;201610;694;2085;527;1733;111;392;177;536;288;928
521930;201610;3653;11544;2947;10083;1038;3680;488;1682;1526;5362
521935;201610;634;1765;508;1522;129;382;235;670;364;1052
521940;201610;1045;2811;822;2466;165;538;434;1273;599;1811
521945;201610;676;2077;553;1847;110;374;282;997;392;1371
521950;201610;664;1691;523;1477;57;172;361;1021;418;1193
521960;201610;671;1996;507;1651;110;385;218;687;328;1072
521970;201610;2747;7036;2206;6364;180;485;1784;5324;1964;5809
521971;201610;1034;2734;651;1995;119;354;164;482;283;836
521973;201610;964;2950;785;2619;157;533;384;1285;541;1818
521975;201610;12732;34733;11167;32585;2137;6556;7338;21124;9475;27680
521980;201610;2072;5616;1741;5197;260;664;1316;4094;1576;4758
521990;201610;1181;3312;918;2866;115;381;603;1913;718;2294
522000;201610;2323;6280;1617;5339;196;679;906;3123;1102;3802
522005;201610;407;987;261;751;83;226;93;271;176;497
522010;201610;3510;9898;2785;8612;985;3087;610;1885;1595;4972
522015;201610;922;2682;730;2332;172;547;342;1089;514;1636
522020;201610;5233;13422;3785;11016;937;2797;1805;5164;2742;7961
522026;201610;653;1804;456;1539;103;370;155;558;258;928
522028;201610;554;1540;426;1251;55;152;255;750;310;902
522040;201610;2532;6019;1914;5237;375;1027;1220;3398;1595;4425
522045;201610;15620;50244;12038;42440;3281;12493;2029;6918;5310;19411
522050;201610;1180;3346;772;2502;182;609;187;523;369;1132
522060;201610;2367;7153;1899;6365;491;1755;937;3113;1428;4868
522068;201610;1752;5309;1511;4990;198;607;1124;3863;1322;4470
522070;201610;702;2067;613;1915;78;302;402;1222;480;1524
522100;201610;521;1553;439;1428;157;565;168;519;325;1084
522108;201610;871;2632;707;2349;63;260;529;1708;592;1968
522119;201610;1415;4241;1138;3761;267;918;508;1704;775;2622
522130;201610;362;1008;290;917;83;269;157;507;240;776
522140;201610;17894;49753;13655;42007;4039;13133;3173;9136;7212;22269
522145;201610;838;2299;700;2085;241;727;279;895;520;1622
522150;201610;999;2616;772;2234;220;628;285;850;505;1478
522155;201610;837;2350;708;2135;144;395;421;1347;565;1742
522157;201610;665;1805;550;1633;37;130;425;1251;462;1381
522160;201610;6274;17570;4127;13410;1168;4098;400;1271;1568;5369
522170;201610;2360;6836;1770;5700;577;1949;384;1196;961;3145
522180;201610;351;1004;251;825;80;287;58;198;138;485
522185;201610;15912;44564;12412;39738;3644;12180;5926;19147;9570;31327
522190;201610;906;2234;667;1882;117;338;317;934;434;1272
522200;201610;1727;5514;1296;4498;323;1164;291;955;614;2119
522205;201610;1431;3929;1105;3378;194;626;576;1721;770;2347
522220;201610;1399;3633;1080;3226;223;652;604;1898;827;2550
522230;201610;1255;3490;1029;3122;113;411;652;1941;765;2352
530010;201610;230110;705535;194913;640294;51225;184079;68669;217106;119894;401185
110001;201609;3376;11113;2919;10344;674;2492;1400;4990;2074;7482
110002;201609;13351;38584;9835;32149;3076;10799;2924;9253;6000;20052
110003;201609;767;2448;642;2207;190;684;144;474;334;1158
110004;201609;10137;31419;7746;26392;2384;8602;1385;4866;3769;13468
110005;201609;1843;5804;1531;5188;513;1773;593;2008;1106;3781
110006;201609;1952;5829;1188;4233;344;1293;142;438;486;1731
110007;201609;1380;4140;1198;3785;365;1236;454;1597;819;2833
110008;201609;2360;7979;2193;7749;372;1219;1588;5869;1960;7088
110009;201609;4659;14001;3456;11936;1023;3756;1001;3446;2024;7202
110010;201609;7535;22757;6406;21102;1839;6110;3012;10703;4851;16813
110011;201609;7506;23072;6161;20356;2154;7425;1836;5972;3990;13397
110012;201609;15798;44911;11602;37276;3254;10769;2988;9686;6242;20455
110013;201609;5385;16945;4445;15162;1835;6421;1039;3720;2874;10141
110014;201609;4087;11862;3394;10688;916;2928;1645;5183;2561;8111
110015;201609;4971;14756;3227;11144;880;3230;515;1732;1395;4962
110018;201609;4157;11628;2908;9596;741;2732;997;3100;1738;5832
110020;201609;66876;179742;46411;149858;10612;35922;20184;66633;30796;102555
110025;201609;4301;12216;3364;10434;547;1811;2063;6296;2610;8107
110026;201609;635;1935;573;1835;142;428;312;1047;454;1475
110028;201609;6817;20427;5056;16798;1444;5165;687;2217;2131;7382
110029;201609;1400;3987;1070;3428;304;1004;433;1390;737;2394
110030;201609;10473;28273;7496;23812;2127;7321;2680;8470;4807;15791
110032;201609;3901;12063;3177;10548;1042;3487;826;2704;1868;6191
110033;201609;5214;16531;4487;15157;1508;5102;1513;5392;3021;10494
110034;201609;3415;9134;2681;8078;849;2632;1362;4047;2211;6679
110037;201609;1988;6678;1628;5910;436;1666;694;2506;1130;4172
110040;201609;3433;10613;2789;9367;819;2938;971;3151;1790;6089
110045;201609;5021;16102;4236;14972;1422;5437;1776;6174;3198;11611
110050;201609;1661;5278;1347;4657;481;1713;497;1720;978;3433
110060;201609;853;2762;646;2317;210;814;129;453;339;1267
110070;201609;1979;6584;1760;6091;565;2119;659;2161;1224;4280
110080;201609;4463;12035;3719;11147;611;1717;2665;8352;3276;10069
110090;201609;732;2175;563;1861;137;497;244;769;381;1266
110092;201609;1298;4294;1160;4080;210;792;726;2593;936;3385
110094;201609;3613;10694;2982;9734;1013;3478;1091;3528;2104;7006
110100;201609;2177;6840;1920;6352;542;1888;941;3105;1483;4993
110110;201609;1623;5156;1365;4732;564;1997;308;1127;872;3124
110120;201609;1775;5538;1301;4461;366;1308;254;842;620;2150
110130;201609;2453;7031;1714;5652;548;1925;361;1180;909;3105
110140;201609;2382;7688;1858;6568;484;1816;455;1459;939;3275
110143;201609;1236;3802;903;3211;299;1098;330;1197;629;2295
110145;201609;1012;2868;770;2451;206;709;352;1101;558;1810
110146;201609;443;1351;369;1238;73;236;192;662;265;898
110147;201609;727;2125;541;1753;140;470;178;540;318;1010
110148;201609;1231;3720;762;2590;139;490;74;219;213;709
110149;201609;3343;9946;2602;8708;914;3034;1006;3550;1920;6584
110150;201609;2440;7059;1968;6339;598;2027;673;2225;1271;4252
110155;201609;868;2651;722;2306;175;597;324;995;499;1592
110160;201609;1917;6171;1554;5421;558;1955;486;1724;1044;3679
110170;201609;2858;7950;1970;6280;461;1541;918;2881;1379;4422
110175;201609;1621;4950;1258;4413;215;774;680;2488;895;3262
110180;201609;1276;3716;1041;3349;280;863;527;1751;807;2614
120001;201609;2788;9460;2517;9010;510;1891;1526;5601;2036;7492
120005;201609;1560;6502;1441;6256;163;779;1034;4626;1197;5405
120010;201609;4687;15821;4441;15434;545;1865;3419;12148;3964;14013
120013;201609;1954;7797;1841;7621;441;1807;1064;4689;1505;6496
120017;201609;1978;7140;1800;6796;528;2025;768;3198;1296;5223
120020;201609;14312;63147;13666;61774;1981;9291;9500;44264;11481;53555
120025;201609;2419;8418;2304;8228;444;1668;1439;5205;1883;6873
120030;201609;6494;25044;6265;24734;213;1089;5679;22390;5892;23479
120032;201609;1493;7247;1407;7008;142;892;1063;5256;1205;6148
120033;201609;3579;14260;3472;14056;224;1009;3039;12346;3263;13355
120034;201609;2129;9020;2011;8771;152;922;1626;6947;1778;7869
120035;201609;3142;14014;3047;13811;225;1181;2560;11700;2785;12881
120038;201609;2653;9505;2477;9164;662;2525;1281;4846;1943;7371
120039;201609;1776;8493;1702;8336;163;981;1303;6398;1466;7379
120040;201609;44766;159347;40182;150393;9387;37852;20256;76635;29643;114487
120042;201609;3015;12537;2812;12055;258;1281;2108;9086;2366;10367
120043;201609;934;4260;894;4185;77;376;723;3484;800;3860
120045;201609;4411;14931;4281;14774;467;1784;3613;12438;4080;14222
120050;201609;8115;33051;7615;31950;994;4471;5266;22753;6260;27224
120060;201609;7754;34247;7509;33742;685;3615;5958;26962;6643;30577
120070;201609;2703;10036;2585;9775;447;1691;1668;6470;2115;8161
120080;201609;3602;13558;3408;13205;616;2517;2349;9231;2965;11748
130002;201609;3121;12800;2902;12442;175;912;2520;10796;2695;11708
130006;201609;2002;8494;1698;7862;226;1168;1227;5697;1453;6865
130008;201609;2228;8699;2023;8305;130;617;1658;6798;1788;7415
130010;201609;3089;10056;2804;9721;159;559;2494;8687;2653;9246
130014;201609;3209;10417;2749;9643;493;1838;1724;6098;2217;7936
130020;201609;2743;10174;2612;9915;87;482;2269;8467;2356;8949
130030;201609;7761;29000;7408;28582;276;866;6828;26872;7104;27738
130040;201609;3777;11586;3289;10902;301;1064;2633;8843;2934;9907
130050;201609;6147;25027;5719;24416;364;1589;4885;21380;5249;22969
130060;201609;5868;27061;5553;26504;534;3129;4334;20558;4868;23687
130063;201609;3791;16740;3622;16522;266;1337;3165;14536;3431;15873
130068;201609;3236;13382;2846;12510;258;1297;2051;9032;2309;10329
130070;201609;7261;23224;6349;22117;528;1746;5173;18451;5701;20197
130080;201609;5519;23976;5107;23312;640;3372;3739;17134;4379;20506
130083;201609;2189;8564;2028;8303;261;1205;1455;5930;1716;7135
130090;201609;2704;9617;2578;9416;85;397;2321;8475;2406;8872
130100;201609;5863;21263;5683;21032;132;531;5396;20036;5528;20567
130110;201609;6824;21740;6355;21161;638;1968;5219;17857;5857;19825
130115;201609;4582;16022;4278;15503;156;636;3746;13556;3902;14192
130120;201609;14890;55987;13808;54525;1376;5597;11197;45135;12573;50732
130130;201609;4009;16105;3916;15928;203;1028;3445;13968;3648;14996
130140;201609;6294;24531;6177;24398;227;925;5793;22960;6020;23885
130150;201609;3455;13569;3353;13432;132;735;3025;12029;3157;12764
130160;201609;4241;17480;4041;17201;442;2179;3265;13876;3707;16055
130165;201609;2907;11890;2749;11613;195;1015;2272;9593;2467;10608
130170;201609;9535;33149;8201;31475;931;3840;6366;24774;7297;28614
130180;201609;3485;11487;3406;11373;118;292;3178;10758;3296;11050
130185;201609;11792;37030;10375;35382;827;2356;8657;30952;9484;33308
130190;201609;17050;58411;14617;55034;2528;9612;9741;37931;12269;47543
130195;201609;1979;8303;1898;8185;104;454;1674;7342;1778;7796
130200;201609;2061;7053;1840;6694;406;1472;1153;4331;1559;5803
130210;201609;1272;5005;1180;4879;123;637;940;3838;1063;4475
130220;201609;2026;8232;1821;7813;271;1321;1136;4852;1407;6173
130230;201609;3731;16993;3466;16525;354;1852;2658;12989;3012;14841
130240;201609;8895;32826;7949;31423;363;1929;6959;27444;7322;29373
130250;201609;20168;69563;18694;67558;2802;9823;13648;51396;16450;61219
130255;201609;4345;14780;3982;14190;189;750;3497;12522;3686;13272
130260;201609;249402;811001;217279;752697;63678;234289;92985;320944;156663;555233
130270;201609;7507;30722;6875;29681;920;3975;5065;22612;5985;26587
130280;201609;3345;13821;3213;13655;105;483;2987;12833;3092;13316
130290;201609;11497;40377;10873;39628;213;549;10346;38427;10559;38976
130300;201609;4524;17250;4239;16800;247;1192;3661;14489;3908;15681
130310;201609;5013;19131;4584;18523;346;1539;3813;15569;4159;17108
130320;201609;3022;10790;2711;10317;371;1486;1879;7337;2250;8823
130330;201609;3638;13300;3262;12777;173;847;2797;10917;2970;11764
130340;201609;18350;69332;16780;67251;2376;9394;13023;53759;15399;63153
130350;201609;3327;13749;3226;13587;250;1438;2698;11192;2948;12630
130353;201609;6148;18759;5242;17547;1103;3618;3317;11808;4420;15426
130356;201609;4589;16542;4217;15911;506;1928;3110;12046;3616;13974
130360;201609;3270;9331;2861;8889;100;258;2656;8411;2756;8669
130370;201609;5687;21388;4856;20256;181;1014;4242;17708;4423;18722
130380;201609;8045;33178;7682;32595;501;2498;6561;27865;7062;30363
130390;201609;5236;22844;4865;22108;551;2910;3556;16075;4107;18985
130395;201609;2213;7739;1929;7150;234;939;1356;4972;1590;5911
130400;201609;2176;8134;2031;7910;129;631;1774;6879;1903;7510
130406;201609;10834;40881;9740;39235;2515;10510;5845;23869;8360;34379
130410;201609;3912;14825;3447;13949;1053;4580;1509;6280;2562;10860
130420;201609;10706;44768;10115;43805;1996;8663;7066;31586;9062;40249
130423;201609;3378;13004;3107;12605;259;1274;2594;10441;2853;11715
130426;201609;2369;10044;2273;9885;159;768;1947;8556;2106;9324
130430;201609;3505;12237;3322;11955;297;1089;2732;9965;3029;11054
130440;201609;3586;12916;3343;12619;206;886;2937;11091;3143;11977
140002;201609;1680;5517;1522;5281;117;497;1154;3948;1271;4445
140005;201609;3429;9485;3295;9332;64;151;3175;9052;3239;9203
140010;201609;55807;160976;44273;142754;10981;37003;18563;62477;29544;99480
140015;201609;2942;9331;2732;9067;205;529;2347;8065;2552;8594
140017;201609;3115;9914;2762;9433;273;902;2088;7384;2361;8286
140020;201609;4454;15017;3954;14284;533;2096;2758;9963;3291;12059
140023;201609;2167;7224;1825;6673;193;768;1328;4899;1521;5667
140028;201609;2102;5801;1901;5510;219;734;1421;3936;1640;4670
140030;201609;3788;11777;3473;11338;588;1578;2400;8347;2988;9925
140040;201609;1757;8082;1690;7979;118;714;1478;6887;1596;7601
140045;201609;2470;9110;2208;8718;430;1617;1462;6131;1892;7748
140047;201609;5554;16836;4728;15460;1229;4043;2184;7622;3413;11665
140050;201609;1395;4387;1228;4149;247;854;748;2565;995;3419
140060;201609;1469;4445;1288;4165;232;817;838;2686;1070;3503
140070;201609;1622;8806;1552;8593;126;855;1224;6760;1350;7615
150010;201609;36597;108118;33934;104294;2264;7347;27720;85193;29984;92540
150013;201609;1764;5073;1556;4820;183;529;1179;3748;1362;4277
150020;201609;12676;42132;12138;41350;1491;4618;9673;33916;11164;38534
150030;201609;7304;30875;7041;30470;698;2763;5826;25978;6524;28741
150034;201609;4274;11781;4000;11434;167;502;3602;10331;3769;10833
150040;201609;13127;41202;11215;38846;1563;4688;8430;31122;9993;35810
150050;201609;5714;22339;5380;21726;265;1337;4650;18738;4915;20075
150060;201609;18173;56260;16098;52778;3369;11011;9653;32568;13022;43579
150070;201609;6106;24652;5426;23900;233;1181;4947;21955;5180;23136
150080;201609;75322;194085;61499;174600;12963;36171;32796;97466;45759;133637
150085;201609;5570;18691;5267;18305;433;1280;4505;16150;4938;17430
150090;201609;10301;39202;9638;38143;826;3388;7592;30586;8418;33974
150095;201609;5367;17383;4806;16538;371;1223;3850;13632;4221;14855
150100;201609;3281;12184;3032;11700;173;808;2425;9203;2598;10011
150110;201609;3554;16961;3529;16914;212;1051;3132;15165;3344;16216
150120;201609;6572;23953;6384;23630;469;1596;5297;20280;5766;21876
150125;201609;721;2115;613;1976;107;381;398;1265;505;1646
150130;201609;22473;67867;20380;64735;2437;7416;15085;49059;17522;56475
150140;201609;167135;462725;152930;442665;19052;53601;114801;337531;133853;391132
150145;201609;4618;14542;4137;13884;522;1860;3204;10845;3726;12705
150150;201609;12329;36931;11108;34999;1876;6115;7332;23335;9208;29450
150157;201609;3174;9468;2698;8765;349;1289;1893;6205;2242;7494
150160;201609;3138;9921;2908;9576;887;2969;1514;5112;2401;8081
150170;201609;21832;80066;20401;77605;2916;11305;14572;56364;17488;67669
150172;201609;3087;10447;2672;9734;381;1430;1871;6958;2252;8388
150175;201609;1909;5775;1762;5601;153;482;1436;4721;1589;5203
150178;201609;10261;31431;8788;29617;968;3452;6531;22555;7499;26007
150180;201609;18832;74784;17993;73614;1237;5627;15328;63156;16565;68783
150190;201609;7057;24157;6750;23717;229;851;6138;21758;6367;22609
150195;201609;5342;17385;4968;16766;180;623;4429;15077;4609;15700
150200;201609;5358;16849;5084;16527;110;372;4779;15646;4889;16018
150210;201609;25337;93903;24329;92444;1878;7166;20230;78792;22108;85958
150215;201609;7333;23051;6289;21282;1979;6922;2517;8658;4496;15580
150220;201609;12036;37196;10572;34785;2499;8326;5351;17987;7850;26313
150230;201609;12063;37315;10315;34751;1507;5237;6783;23219;8290;28456
150240;201609;35783;105838;29974;95049;10122;32922;8132;26705;18254;59627
150250;201609;4020;16774;3851;16511;742;3198;2583;11552;3325;14750
150260;201609;2072;8149;1939;7888;353;1396;1200;5025;1553;6421
150270;201609;8595;26158;6619;23529;1768;6470;3486;12748;5254;19218
150275;201609;5994;21628;5615;20993;666;2390;4156;15923;4822;18313
150276;201609;2194;6497;1923;6124;336;1130;1395;4466;1731;5596
150277;201609;4882;14883;4118;13869;897;3139;2642;9068;3539;12207
150280;201609;6005;26660;5772;26114;904;4191;4110;18998;5014;23189
150285;201609;2968;11376;2735;10963;358;1527;1911;7777;2269;9304
150290;201609;10133;28680;9590;28059;635;1516;8306;25027;8941;26543
150293;201609;9716;26188;6933;22196;2115;7029;2425;8391;4540;15420
150295;201609;7655;22164;6141;20344;1503;4961;3382;12228;4885;17189
150300;201609;1984;6523;1829;6291;103;463;1498;5092;1601;5555
150304;201609;4196;13196;3553;12119;630;2157;2230;7852;2860;10009
150307;201609;6714;21987;6165;21155;410;1309;5177;17913;5587;19222
150309;201609;6195;21191;5432;19959;1264;4575;3030;11688;4294;16263
150310;201609;6381;27180;6103;26727;523;2529;4967;21929;5490;24458
150320;201609;9583;23995;8698;22940;678;1617;7240;19396;7918;21013
150330;201609;14167;47705;13115;46059;1940;6812;9414;33924;11354;40736
150340;201609;2525;7964;2298;7587;248;825;1727;5730;1975;6555
150345;201609;6801;22274;6291;21545;594;2006;4946;17276;5540;19282
150350;201609;8217;24701;7546;23804;1299;3410;5411;17991;6710;21401
150360;201609;21480;65998;18409;61889;3120;10351;12193;42664;15313;53015
150370;201609;10033;36101;9148;34813;1170;4310;6842;27006;8012;31316
150375;201609;2897;12709;2792;12560;273;1263;2328;10600;2601;11863
150380;201609;10086;28758;8765;26888;527;1610;7354;22811;7881;24421
150390;201609;7975;34252;7366;33061;1275;5493;4779;22365;6054;27858
150400;201609;5955;23104;5630;22405;447;1707;4499;18264;4946;19971
150405;201609;8355;24952;7304;23571;1113;2833;5177;18189;6290;21022
150410;201609;1612;6083;1461;5754;205;901;893;3500;1098;4401
150420;201609;37096;122993;30051;110830;9734;38741;9021;34984;18755;73725
150430;201609;7455;24869;7028;24179;951;3060;5157;18312;6108;21372
150440;201609;5507;18771;5216;18337;605;2046;4081;14654;4686;16700
150442;201609;22104;63144;18915;58055;3525;10660;11407;36147;14932;46807
150445;201609;5368;18384;4898;17577;593;2083;3631;13346;4224;15429
150450;201609;4267;20568;4092;20263;484;2372;3182;16189;3666;18561
150460;201609;7125;26184;6522;25417;293;1429;5531;22240;5824;23669
150470;201609;17690;54147;16924;53213;532;1352;15801;50301;16333;51653
150475;201609;3405;11731;3104;11296;273;1028;2516;9270;2789;10298
150480;201609;14092;47706;12791;45588;1331;4901;9989;36081;11320;40982
150490;201609;7171;27319;6968;27001;262;1142;6181;24131;6443;25273
150495;201609;5009;18345;4828;18101;175;689;4442;16755;4617;17444
150497;201609;2711;9907;2386;9230;790;3177;1017;4018;1807;7195
150500;201609;3187;8746;2919;8355;233;647;2343;6677;2576;7324
150503;201609;3675;11185;3036;10328;1034;3612;1518;5372;2552;8984
150506;201609;11089;38332;9980;36692;2389;8387;6044;23782;8433;32169
150510;201609;9831;38122;8811;35944;1434;5893;5712;24189;7146;30082
150520;201609;6738;26464;6583;26249;255;977;6109;24624;6364;25601
150530;201609;12504;42540;11056;40150;1184;3912;8507;31549;9691;35461
150540;201609;4739;14251;4139;13358;258;838;3433;11080;3691;11918
150543;201609;5879;17976;5051;16718;1100;3691;3001;10213;4101;13904
150548;201609;9359;29831;8659;28937;444;1341;7849;26614;8293;27955
150549;201609;2067;6641;1880;6410;67;237;1712;5902;1779;6139
150550;201609;20430;64334;17218;58606;5334;18392;6468;22910;11802;41302
150553;201609;23237;79564;18569;69588;6847;27217;4353;16647;11200;43864
150555;201609;1779;5239;1437;4655;105;357;1062;3426;1167;3783
150560;201609;1966;6402;1808;6053;289;947;1095;3689;1384;4636
150563;201609;2711;8976;2478;8560;616;2309;1284;4392;1900;6701
150565;201609;3927;13440;3512;12747;148;684;2949;10715;3097;11399
150570;201609;5912;21271;5649;20772;547;2110;4354;16106;4901;18216
150580;201609;9817;40778;9506;40380;621;2602;8324;36061;8945;38663
150590;201609;5733;22736;5493;22420;162;751;5065;20727;5227;21478
150600;201609;8066;30793;7658;30178;327;1426;6852;27227;7179;28653
150610;201609;2442;8183;2194;7663;208;788;1567;5402;1775;6190
150611;201609;2784;9421;2569;9005;147;553;2130;7497;2277;8050
150613;201609;12477;37019;9917;32972;3155;10948;4001;13596;7156;24544
150616;201609;3081;9360;2293;7969;562;2138;750;2472;1312;4610
150618;201609;6451;21789;5684;20349;1539;5579;2891;10623;4430;16202
150619;201609;5211;17704;4720;16864;547;2116;3373;12027;3920;14143
150620;201609;6400;22762;5767;21907;735;2825;4409;17128;5144;19953
150630;201609;5913;17618;5554;17181;519;1630;4590;14453;5109;16083
150635;201609;4043;13038;3507;11926;912;3187;1477;5151;2389;8338
150640;201609;1922;5686;1814;5554;188;541;1523;4844;1711;5385
150650;201609;12432;37252;10724;34137;2981;9518;4486;14849;7467;24367
150655;201609;5194;16918;4811;16205;595;2066;3532;11971;4127;14037
150658;201609;4533;13550;3855;12581;825;2932;2361;7874;3186;10806
150660;201609;5642;17499;5021;16503;1232;4008;2598;8792;3830;12800
150670;201609;7532;19646;6056;17763;647;1995;4768;14226;5415;16221
150680;201609;59894;204220;50025;186985;15068;57774;19894;80210;34962;137984
150690;201609;2068;6301;1829;5914;232;702;1278;4206;1510;4908
150700;201609;6205;19339;5571;18433;953;3176;3691;12494;4644;15670
150710;201609;4265;14297;3770;13458;429;1562;2680;9723;3109;11285
150715;201609;5025;15664;4288;14486;448;1670;3203;10849;3651;12519
150720;201609;6562;26179;6133;25371;707;3159;4523;19076;5230;22235
150730;201609;10227;34331;9298;32759;1161;4174;7079;25450;8240;29624
150740;201609;3712;11786;3260;10917;689;2399;1711;5730;2400;8129
150745;201609;5152;16304;4585;15468;1220;4367;2601;8728;3821;13095
150746;201609;1382;4482;1298;4328;128;412;949;3192;1077;3604
150747;201609;5326;16401;4611;15487;397;1181;3530;12639;3927;13820
150750;201609;3382;10837;3030;10313;197;780;2472;8405;2669;9185
150760;201609;11283;35905;10363;34649;1751;5987;7137;24286;8888;30273
150770;201609;6001;22535;5671;21937;308;1057;4951;20075;5259;21132
150775;201609;1142;3461;966;3141;191;737;517;1639;708;2376
150780;201609;3461;11129;3329;10969;125;460;3046;10045;3171;10505
150790;201609;5024;16370;4630;15892;387;1368;3692;13426;4079;14794
150795;201609;15229;48395;13470;45568;3084;10153;7881;27796;10965;37949
150796;201609;3122;9062;2782;8635;330;1055;2138;6753;2468;7808
150797;201609;3758;12821;3376;12090;114;477;2850;10170;2964;10647
150800;201609;14040;45656;12751;43977;2687;8569;8439;30848;11126;39417
150803;201609;6768;24195;6304;23422;684;2682;4679;17533;5363;20215
150805;201609;2663;9511;2429;9101;323;1183;1743;6648;2066;7831
150808;201609;5832;19207;4554;16616;1736;6866;573;2050;2309;8916
150810;201609;19376;58919;15760;54225;2618;8767;10149;36830;12767;45597
150812;201609;5278;16516;4787;15615;524;1956;3417;10816;3941;12772
150815;201609;8594;28240;7602;26931;845;2915;5937;21588;6782;24503
150820;201609;11566;33204;10153;31525;860;2094;8200;26332;9060;28426
150830;201609;12959;48419;11978;46967;603;2960;9982;40032;10585;42992
150835;201609;2218;7763;2023;7375;453;1636;1084;4074;1537;5710
150840;201609;7368;22380;5900;19741;1335;4804;2855;9442;4190;14246
160005;201609;816;2776;767;2681;67;277;623;2133;690;2410
160010;201609;1320;4397;1316;4392;48;95;1257;4273;1305;4368
160015;201609;1726;6424;1681;6354;62;196;1560;6004;1622;6200
160020;201609;1919;6881;1767;6652;228;892;1293;4950;1521;5842
160021;201609;1054;4472;1005;4387;121;661;727;3160;848;3821
160023;201609;1000;4108;979;4066;98;396;813;3419;911;3815
160025;201609;1409;4289;1392;4271;15;56;1363;4177;1378;4233
160027;201609;8312;24548;7625;23772;1669;5122;5131;16558;6800;21680
160030;201609;49302;168640;42374;156620;10586;38954;21840;85824;32426;124778
160040;201609;4273;16726;4159;16559;171;996;3788;14842;3959;15838
160050;201609;3176;11847;2802;11285;1516;5987;737;3376;2253;9363
160053;201609;2969;11159;2883;11021;729;2738;1767;6996;2496;9734
160055;201609;570;2250;561;2238;30;134;495;1969;525;2103
160060;201609;15710;53246;14544;51775;2007;6770;10944;40006;12951;46776
160070;201609;2607;10280;2436;9973;189;920;2034;8301;2223;9221
160080;201609;2585;9703;2524;9617;75;360;2370;8989;2445;9349
170025;201609;522;1692;459;1597;127;442;235;828;362;1270
170030;201609;1178;3867;998;3529;249;892;417;1487;666;2379
170035;201609;1446;4133;1114;3484;191;645;555;1715;746;2360
170040;201609;1900;5931;1640;5588;264;974;905;3317;1169;4291
170070;201609;1690;4519;1276;3934;258;861;701;2118;959;2979
170100;201609;2388;7107;2019;6508;225;718;1555;5079;1780;5797
170105;201609;760;2342;571;1947;123;466;265;865;388;1331
170110;201609;959;3112;805;2820;177;658;351;1228;528;1886
170130;201609;1355;4255;1072;3696;276;1000;458;1622;734;2622
170190;201609;1540;4532;1098;3777;411;1340;211;860;622;2200
170200;201609;1608;4462;965;3181;280;985;204;627;484;1612
170210;201609;31580;89387;23960;76338;7702;26336;5130;16868;12832;43204
170215;201609;1220;3737;1011;3397;108;417;703;2340;811;2757
170220;201609;5588;19153;5052;18046;1238;4571;2573;9285;3811;13856
170230;201609;1379;4385;1068;3742;229;883;457;1541;686;2424
170240;201609;2754;8160;2173;7205;245;961;1459;4764;1704;5725
170255;201609;3410;10766;2696;9443;880;3119;1053;3748;1933;6867
170270;201609;1037;2530;692;2047;65;189;463;1357;528;1546
170290;201609;2801;8080;2442;7653;286;629;1947;6580;2233;7209
170300;201609;1938;5878;1543;5206;180;655;997;3391;1177;4046
170305;201609;743;2221;570;1881;96;345;313;1026;409;1371
170307;201609;1042;3643;854;3278;180;747;402;1604;582;2351
170310;201609;1603;4418;1148;3617;305;1002;502;1594;807;2596
170320;201609;1138;3258;798;2662;184;646;324;1102;508;1748
170330;201609;815;2625;731;2484;67;255;575;1921;642;2176
170360;201609;470;1466;371;1276;70;245;174;587;244;832
170370;201609;1342;3789;963;3133;166;608;526;1657;692;2265
170380;201609;1745;5560;1355;4882;223;876;680;2458;903;3334
170382;201609;572;1886;465;1698;68;269;313;1160;381;1429
170384;201609;1570;6297;1413;5982;336;1512;729;3116;1065;4628
170386;201609;920;2719;757;2448;230;843;291;882;521;1725
170388;201609;640;1908;505;1670;104;382;189;602;293;984
170389;201609;927;3123;832;2955;67;263;629;2221;696;2484
170390;201609;1282;3652;1052;3346;97;320;815;2630;912;2950
170410;201609;547;1727;444;1535;37;151;283;964;320;1115
170460;201609;492;1343;306;996;61;223;114;354;175;577
170510;201609;766;2518;565;2102;94;394;291;1026;385;1420
170550;201609;6868;19382;4630;15222;1570;5581;579;1837;2149;7418
170555;201609;1352;3844;1041;3346;204;695;517;1708;721;2403
170560;201609;1069;3432;816;3074;171;692;457;1795;628;2487
170600;201609;1329;3886;1141;3607;339;1026;631;2074;970;3100
170610;201609;1703;5083;1305;4399;148;546;834;2770;982;3316
170625;201609;422;1260;295;985;44;145;104;328;148;473
170650;201609;1234;3946;956;3404;237;864;332;1266;569;2130
170700;201609;4183;12878;3247;11236;706;2617;1414;5028;2120;7645
170710;201609;1789;5236;1371;4443;250;860;764;2459;1014;3319
170720;201609;1889;5071;1563;4530;203;495;1185;3621;1388;4116
170730;201609;981;2877;751;2476;200;670;298;1007;498;1677
170740;201609;2181;7728;1856;7089;296;1179;1185;4582;1481;5761
170755;201609;780;2436;572;1965;98;377;250;826;348;1203
170765;201609;1318;3568;941;2926;256;814;371;1208;627;2022
170770;201609;1678;5665;1499;5333;322;1136;857;3123;1179;4259
170820;201609;3526;11389;3073;10555;654;2370;1516;5240;2170;7610
170825;201609;737;2180;587;1887;90;299;308;974;398;1273
170830;201609;1410;4090;1190;3744;82;194;1028;3336;1110;3530
170900;201609;2508;8889;2345;8620;210;820;1883;6993;2093;7813
170930;201609;3847;11390;3173;10258;801;2701;1500;4961;2301;7662
170950;201609;13817;39957;9555;31934;2922;10956;1420;4600;4342;15556
170980;201609;501;1453;346;1169;67;221;144;482;211;703
171050;201609;1506;4998;1316;4615;91;407;1030;3558;1121;3965
171070;201609;1449;4533;1300;4304;321;1043;723;2489;1044;3532
171090;201609;1079;2882;859;2550;67;178;636;1890;703;2068
171110;201609;597;1749;422;1412;125;470;170;496;295;966
171150;201609;1046;2822;628;2042;109;381;383;1243;492;1624
171180;201609;700;2096;449;1564;115;399;173;647;288;1046
171190;201609;1631;6037;1402;5520;287;1183;657;2710;944;3893
171195;201609;856;2967;711;2692;98;413;434;1652;532;2065
171200;201609;683;2138;524;1826;166;619;158;518;324;1137
171215;201609;466;1359;338;1105;48;173;165;543;213;716
171240;201609;694;2527;627;2393;62;296;401;1569;463;1865
171245;201609;619;2059;479;1712;107;419;157;540;264;959
171250;201609;1034;3003;781;2552;181;637;374;1170;555;1807
171270;201609;399;1629;369;1564;134;532;129;628;263;1160
171280;201609;880;2701;699;2360;170;587;315;1115;485;1702
171320;201609;3815;11463;3102;10176;912;2975;1254;4262;2166;7237
171330;201609;2816;8135;2213;7152;604;2082;980;3129;1584;5211
171360;201609;1432;4601;1267;4338;116;427;977;3352;1093;3779
171370;201609;654;1880;553;1734;113;409;311;952;424;1361
171380;201609;1282;4106;1020;3590;412;1473;229;870;641;2343
171395;201609;888;2675;638;2156;116;457;309;987;425;1444
171420;201609;2055;6236;1473;5045;363;1293;543;1837;906;3130
171430;201609;1076;3270;866;2898;173;584;474;1576;647;2160
171488;201609;2506;7624;2082;6972;474;1565;1125;3927;1599;5492
171500;201609;856;2498;669;2184;82;261;470;1562;552;1823
171510;201609;881;3064;762;2830;70;291;538;2014;608;2305
171515;201609;507;1448;381;1214;52;156;215;680;267;836
171525;201609;642;2032;531;1831;68;257;323;1081;391;1338
171550;201609;333;1107;246;933;80;341;62;236;142;577
171570;201609;1247;3920;1065;3550;226;731;662;2275;888;3006
171575;201609;1941;5386;1366;4310;289;966;645;2010;934;2976
171610;201609;5347;16910;4237;14806;1127;4289;1347;4699;2474;8988
171620;201609;2689;7747;2256;7136;117;456;1860;5877;1977;6333
171630;201609;910;2759;738;2482;219;779;341;1145;560;1924
171650;201609;2172;6754;1615;5547;435;1570;544;1873;979;3443
171660;201609;2413;6720;1756;5481;265;876;970;2992;1235;3868
171665;201609;1475;4295;1138;3738;207;718;620;2123;827;2841
171670;201609;1926;5392;1533;4731;418;1402;629;1864;1047;3266
171700;201609;1092;3474;894;3085;137;507;524;1793;661;2300
171720;201609;732;2152;605;1934;176;578;274;890;450;1468
171750;201609;1154;3575;851;2952;245;823;238;870;483;1693
171780;201609;1150;3113;819;2626;101;356;439;1369;540;1725
171790;201609;1396;4917;1189;4464;310;1158;625;2483;935;3641
171800;201609;685;2138;571;1943;67;229;379;1337;446;1566
171820;201609;10335;30583;8268;27184;1680;5839;4152;13823;5832;19662
171830;201609;1381;5090;1182;4624;368;1382;447;1873;815;3255
171840;201609;773;2136;645;1949;46;140;506;1516;552;1656
171845;201609;713;1950;537;1652;83;281;290;895;373;1176
171850;201609;916;3243;788;2974;87;378;501;1896;588;2274
171855;201609;1127;3587;1011;3359;64;247;771;2519;835;2766
171865;201609;453;1497;380;1369;73;264;190;684;263;948
171870;201609;730;2174;548;1817;140;487;204;722;344;1209
171875;201609;1268;4040;1026;3618;93;383;698;2435;791;2818
171880;201609;825;3052;794;3005;87;323;631;2458;718;2781
171884;201609;901;2475;621;2018;162;574;141;523;303;1097
171886;201609;1402;4524;1060;3798;312;1219;227;806;539;2025
171888;201609;726;2142;501;1667;58;197;287;943;345;1140
171889;201609;508;1584;438;1468;93;314;221;778;314;1092
171890;201609;1209;3643;969;3278;166;546;528;1800;694;2346
171900;201609;488;1777;367;1464;107;450;149;584;256;1034
172000;201609;572;1856;474;1645;76;271;266;904;342;1175
172010;201609;1185;4100;1084;3914;115;490;797;2853;912;3343
172015;201609;337;1300;261;1133;59;217;129;595;188;812
172020;201609;2310;7638;2106;7287;268;983;1477;5146;1745;6129
172025;201609;706;2049;488;1655;77;283;263;911;340;1194
172030;201609;1147;3652;977;3347;55;238;776;2634;831;2872
172049;201609;1335;3436;940;2748;477;1508;317;850;794;2358
172065;201609;1368;3580;1110;3286;75;196;992;3005;1067;3201
172080;201609;2419;7570;2002;6775;203;797;1330;4445;1533;5242
172085;201609;514;1414;344;1066;58;165;105;332;163;497
172090;201609;3799;10414;3066;9302;127;420;2625;7998;2752;8418
172093;201609;605;1804;445;1502;97;368;193;642;290;1010
172097;201609;604;1819;470;1579;106;365;169;568;275;933
172100;201609;34764;101027;24976;83208;7061;25829;6508;21583;13569;47412
172110;201609;1656;6213;1446;5857;170;777;1040;4288;1210;5065
172120;201609;5120;15810;4114;14321;782;2720;2550;9110;3332;11830
172125;201609;246;774;198;682;40;158;93;321;133;479
172130;201609;550;1510;412;1278;37;144;265;808;302;952
172208;201609;2148;6266;1854;5813;257;827;1175;3709;1432;4536
172210;201609;2550;7655;2178;7093;453;1617;1274;4082;1727;5699
210005;201609;22005;67936;17974;61316;6248;22449;5874;20264;12122;42713
210010;201609;1779;6586;1594;6246;100;445;1302;5170;1402;5615
210015;201609;3442;10762;3001;10053;194;485;2556;8861;2750;9346
210020;201609;7218;17238;6695;16594;202;494;6140;15163;6342;15657
210030;201609;5525;18273;5145;17728;356;1512;4204;14364;4560;15876
210040;201609;1908;5190;1753;5006;78;202;1569;4527;1647;4729
210043;201609;6895;19043;5783;17626;669;1845;4139;13403;4808;15248
210047;201609;6646;24455;5962;23340;534;2396;4607;18046;5141;20442
210050;201609;2307;8466;1879;7596;706;2904;637;2779;1343;5683
210055;201609;1767;6074;1571;5753;114;460;1231;4491;1345;4951
210060;201609;7257;28077;6639;26867;987;4131;4335;18003;5322;22134
210070;201609;7228;21157;6641;20427;101;327;6111;18942;6212;19269
210080;201609;3725;12769;3617;12626;29;129;3456;12118;3485;12247
210083;201609;4495;15606;4051;15091;135;632;3785;14086;3920;14718
210087;201609;2997;8752;2698;8347;272;815;2151;6794;2423;7609
210090;201609;10204;32676;9608;31716;387;1383;8449;27955;8836;29338
210095;201609;6042;21562;5749;21143;313;1253;4896;18181;5209;19434
210100;201609;7373;21823;6633;20818;344;1330;5572;17228;5916;18558
210110;201609;2863;9902;2738;9728;110;498;2461;8700;2571;9198
210120;201609;26457;71945;22410;66982;2925;7418;16101;51159;19026;58577
210125;201609;3644;11429;3503;11276;180;402;3147;10437;3327;10839
210130;201609;4228;12464;3876;11948;255;805;3218;9910;3473;10715
210135;201609;1672;4902;1426;4539;94;298;1146;3679;1240;3977
210140;201609;17328;54684;14611;50764;2801;10215;8775;31213;11576;41428
210150;201609;4696;11454;4152;10757;78;205;3876;10016;3954;10221
210160;201609;17784;55680;16531;53782;1682;4911;13084;44012;14766;48923
210170;201609;14154;49685;13640;48974;746;2744;12056;43749;12802;46493
210173;201609;2057;8175;1915;7927;79;450;1732;7096;1811;7546
210177;201609;3109;9496;2934;9284;139;425;2656;8508;2795;8933
210180;201609;1488;4514;1374;4331;55;214;1170;3656;1225;3870
210190;201609;4925;15516;4412;14529;188;803;3511;11301;3699;12104
210193;201609;1398;4383;1249;4134;73;254;1031;3467;1104;3721
210197;201609;2090;6961;1913;6744;244;835;1461;5331;1705;6166
210200;201609;8392;28147;7709;27134;1008;3316;5795;21222;6803;24538
210203;201609;6898;21382;6430;20762;424;1183;5563;18365;5987;19548
210207;201609;3056;9766;2805;9299;288;878;2085;7078;2373;7956
210210;201609;8423;28375;7872;27628;73;328;7328;26043;7401;26371
210215;201609;1157;4797;1093;4688;88;452;862;3731;950;4183
210220;201609;6230;24253;5873;23655;329;1582;4956;20092;5285;21674
210230;201609;5311;17033;4899;16377;263;885;4245;14303;4508;15188
210232;201609;13119;41799;10677;38557;1613;6025;6952;26737;8565;32762
210235;201609;3711;11511;3258;10922;170;656;2772;9305;2942;9961
210237;201609;2358;8985;2283;8876;33;161;2175;8502;2208;8663
210240;201609;3031;9452;2796;9104;159;499;2337;7638;2496;8137
210250;201609;5312;17000;4952;16519;126;629;4516;14915;4642;15544
210255;201609;2635;8416;2352;7894;285;1005;1718;5761;2003;6766
210260;201609;5192;16883;4712;16127;491;1604;3616;12672;4107;14276
210270;201609;5442;15226;4691;14132;125;575;4139;12308;4264;12883
210275;201609;3672;8807;3422;8519;182;353;3137;7988;3319;8341
210280;201609;5663;16952;4718;15559;274;1198;3625;11619;3899;12817
210290;201609;5805;18937;5280;18268;306;1059;4509;15799;4815;16858
210300;201609;38497;106094;30943;96311;2554;8071;23079;74476;25633;82547
210310;201609;2947;8222;2651;7803;86;183;2347;7003;2433;7186
210312;201609;2255;7035;2100;6817;55;260;1886;6082;1941;6342
210315;201609;2737;8713;2407;8281;130;439;2106;7359;2236;7798
210317;201609;4231;13064;4015;12796;149;544;3696;11810;3845;12354
210320;201609;19480;62839;17727;60648;870;3159;15274;52957;16144;56116
210325;201609;3721;11361;3247;10623;225;807;2596;8559;2821;9366
210330;201609;35866;88256;27468;78985;4912;12521;17088;55642;22000;68163
210340;201609;11966;35447;10646;33595;1775;5294;7223;24465;8998;29759
210350;201609;10101;30675;8865;28874;559;1856;7216;23714;7775;25570
210355;201609;3960;14410;3556;13760;188;827;3033;11894;3221;12721
210360;201609;16227;48703;14346;45923;1103;3835;11271;36062;12374;39897
210370;201609;9385;22528;7765;20768;287;546;6902;19129;7189;19675
210375;201609;3207;9598;2613;8778;817;2816;1207;4168;2024;6984
210380;201609;6190;16965;5433;15896;470;1208;4416;13219;4886;14427
210390;201609;2929;10311;2639;9832;159;809;2201;8123;2360;8932
210400;201609;4911;15351;4681;15086;100;273;4468;14543;4568;14816
210405;201609;8361;22700;6502;19978;2139;6654;2310;7865;4449;14519
210407;201609;2040;7232;1713;6619;213;826;1202;4688;1415;5514
210408;201609;2447;9425;2273;9193;146;668;1916;7962;2062;8630
210409;201609;3757;13558;3506;13163;207;1003;2897;10852;3104;11855
210410;201609;3683;12109;3526;11894;348;1002;2874;10151;3222;11153
210420;201609;4150;13593;3712;12791;237;805;3026;10556;3263;11361
210430;201609;2167;6702;2077;6590;103;328;1814;5766;1917;6094
210440;201609;4018;12445;3834;12192;205;598;3443;11073;3648;11671
210450;201609;2822;8774;2453;8187;141;472;1945;6441;2086;6913
210455;201609;3947;11478;3500;10814;528;1577;2488;8020;3016;9597
210460;201609;3628;11831;3323;11329;183;735;2738;9319;2921;10054
210462;201609;1471;5276;1342;5025;83;385;1073;3997;1156;4382
210465;201609;2604;8481;2379;8155;196;571;2012;7069;2208;7640
210467;201609;6304;20738;5843;20183;378;1240;4981;17553;5359;18793
210470;201609;2066;5598;1464;4673;82;224;1138;3674;1220;3898
210480;201609;15049;47670;12824;44732;2281;7665;8698;32303;10979;39968
210490;201609;3693;10061;3123;9235;101;338;2702;7933;2803;8271
210500;201609;6360;26096;6056;25503;651;2867;4658;19983;5309;22850
210510;201609;6545;22200;6140;21688;342;996;5242;19143;5584;20139
210515;201609;3728;11702;3551;11498;71;192;3353;11020;3424;11212
210520;201609;2672;8033;2382;7612;187;575;1968;6404;2155;6979
210530;201609;42205;123700;30519;104695;7382;28282;12661;44446;20043;72728
210535;201609;3262;11152;3090;10914;109;370;2776;9938;2885;10308
210540;201609;13546;44045;11657;41279;2247;7837;7001;26312;9248;34149
210542;201609;5917;16935;5344;16303;313;725;4642;14588;4955;15313
210545;201609;2365;7591;2226;7352;48;259;1976;6432;2024;6691
210547;201609;3761;13362;3455;12806;342;1176;2617;9956;2959;11132
210550;201609;6110;17906;5517;17285;275;600;5033;16294;5308;16894
210560;201609;4096;12746;3600;11877;171;631;3050;10023;3221;10654
210565;201609;1488;5335;1253;4932;93;486;947;3751;1040;4237
210570;201609;12541;35157;11292;33699;715;1624;9790;30101;10505;31725
210580;201609;3242;9488;2869;8999;289;637;2242;7624;2531;8261
210590;201609;4100;12919;3767;12476;261;917;3214;10685;3475;11602
210592;201609;2537;7909;2419;7704;40;178;2149;6829;2189;7007
210594;201609;2689;7535;2050;6525;112;261;1604;5309;1716;5570
210596;201609;2751;10155;2575;9813;254;1039;1927;7449;2181;8488
210598;201609;1898;5841;1731;5629;94;348;1501;4856;1595;5204
210600;201609;3292;9354;2766;8600;157;507;2223;6891;2380;7398
210610;201609;2542;8298;2354;8047;126;558;2040;6858;2166;7416
210620;201609;1962;6390;1787;6160;53;142;1644;5773;1697;5915
210630;201609;3674;12820;3244;12077;321;1419;2296;8532;2617;9951
210632;201609;4589;15768;4190;15134;477;1820;3184;11529;3661;13349
210635;201609;1901;6613;1782;6423;94;326;1561;5711;1655;6037
210637;201609;2695;9190;2462;8853;155;609;2004;7271;2159;7880
210640;201609;4494;16413;4382;16274;5;25;4273;15979;4278;16004
210650;201609;6913;20984;6691;20705;186;549;6348;19756;6534;20305
210660;201609;8434;24475;7496;23039;291;937;6794;20802;7085;21739
210663;201609;2771;8302;2596;8092;163;545;2222;6987;2385;7532
210667;201609;1879;6450;1749;6239;80;344;1526;5454;1606;5798
210670;201609;4588;16728;4324;16284;215;960;3623;13702;3838;14662
210675;201609;5175;14221;4654;13541;441;1110;3804;11378;4245;12488
210680;201609;4132;11183;3582;10497;183;460;3097;9182;3280;9642
210690;201609;7476;25073;7136;24686;291;932;6276;22424;6567;23356
210700;201609;2670;7861;2417;7557;492;1253;1583;5663;2075;6916
210710;201609;4942;16086;4594;15522;210;882;3909;13094;4119;13976
210720;201609;2629;9445;2463;9202;134;623;2182;8087;2316;8710
210725;201609;1099;4157;936;3806;117;470;599;2524;716;2994
210730;201609;1164;3539;1000;3280;86;240;791;2625;877;2865
210735;201609;4201;14363;3767;13609;529;1992;2714;10007;3243;11999
210740;201609;4999;14814;4673;14464;203;870;4213;12782;4416;13652
210745;201609;4018;11767;3738;11396;235;639;3188;9813;3423;10452
210750;201609;20868;55926;17940;52472;2106;6055;13463;40259;15569;46314
210760;201609;5970;17067;5480;16531;32;96;5354;16205;5386;16301
210770;201609;6046;16441;5119;15308;117;464;4668;13880;4785;14344
210780;201609;8196;27266;7364;25759;882;3015;5194;18692;6076;21707
210790;201609;4717;14672;4200;14031;283;718;3463;12168;3746;12886
210800;201609;4892;13625;4337;12934;125;409;3909;11684;4034;12093
210805;201609;3848;15679;3681;15380;175;914;3168;13272;3343;14186
210810;201609;5498;16595;5029;15983;331;657;4352;14430;4683;15087
210820;201609;7853;22634;6925;21142;1043;3057;4751;14838;5794;17895
210825;201609;5755;19734;5449;19308;622;2072;4292;15705;4914;17777
210830;201609;8466;24739;7973;24114;868;2203;6353;20052;7221;22255
210840;201609;3702;10037;3239;9315;113;304;2761;7909;2874;8213
210845;201609;5850;17599;5645;17375;75;166;5452;16975;5527;17141
210850;201609;6372;22334;5643;21065;589;2524;4079;15191;4668;17715
210860;201609;18038;52948;15904;49860;1243;3940;12640;40042;13883;43982
210870;201609;5853;19529;5271;18763;581;1997;4026;14652;4607;16649
210880;201609;4305;13947;4074;13630;305;1109;3392;11353;3697;12462
210890;201609;5207;15279;4683;14657;374;1044;3890;12682;4264;13726
210900;201609;5042;14950;3998;13194;1620;5584;975;3435;2595;9019
210905;201609;1860;5787;1623;5415;124;314;1288;4457;1412;4771
210910;201609;8706;27460;7658;25659;1068;3752;5196;17482;6264;21234
210920;201609;2896;10486;2740;10217;156;752;2255;8369;2411;9121
210923;201609;1517;5146;1380;4919;139;546;932;3416;1071;3962
210927;201609;4879;15493;4577;15157;76;234;4371;14593;4447;14827
210930;201609;2546;9194;2356;8885;108;613;2003;7392;2111;8005
210940;201609;2989;11144;2866;10912;186;846;2437;9168;2623;10014
210945;201609;5922;17936;5684;17662;289;457;5209;16571;5498;17028
210950;201609;5327;16320;4474;14932;439;1463;3311;11222;3750;12685
210955;201609;1906;6103;1649;5712;157;543;1176;4176;1333;4719
210960;201609;9402;29633;8494;28349;2066;6521;4905;17607;6971;24128
210970;201609;1389;4804;1206;4493;152;600;847;3161;999;3761
210975;201609;1804;5998;1690;5781;107;400;1352;4616;1459;5016
210980;201609;10464;24301;10014;23823;670;1255;8918;21768;9588;23023
210990;201609;16836;51268;13299;46067;3234;11714;6420;22966;9654;34680
211000;201609;15727;49935;13765;47537;780;3253;11546;40246;12326;43499
211003;201609;4918;17558;4385;16786;306;1375;3350;13164;3656;14539
211010;201609;6534;23885;6193;23450;76;371;5900;22476;5976;22847
211020;201609;7513;24180;7162;23596;613;2211;5853;19188;6466;21399
211023;201609;2235;7544;2131;7369;181;681;1730;5979;1911;6660
211027;201609;2884;11086;2796;10943;288;1153;2236;8856;2524;10009
211030;201609;3908;11854;3625;11554;632;1444;2705;9439;3337;10883
211040;201609;4476;16623;4235;16238;158;889;3706;14183;3864;15072
211050;201609;10421;26618;9912;26050;240;575;9370;24675;9610;25250
211060;201609;6219;21837;5989;21488;472;1785;5111;18501;5583;20286
211065;201609;1988;6371;1792;6082;73;263;1620;5518;1693;5781
211070;201609;8300;28200;7533;26888;404;1493;6274;22657;6678;24150
211080;201609;1365;4082;1142;3738;74;348;885;2771;959;3119
211085;201609;1981;6689;1787;6352;251;918;1262;4578;1513;5496
211090;201609;3579;10317;3297;9913;118;443;2859;8479;2977;8922
211100;201609;6750;17466;6543;17225;39;136;6378;16775;6417;16911
211102;201609;2975;11333;2787;11051;243;1007;2320;9350;2563;10357
211105;201609;2672;8578;2262;7927;207;818;1671;5802;1878;6620
211107;201609;4529;14366;4027;13675;222;778;3334;11597;3556;12375
211110;201609;6467;19037;5097;16909;921;2958;3177;11006;4098;13964
211120;201609;36343;100745;32388;95897;5340;15082;22655;69544;27995;84626
211125;201609;2092;6611;1829;6183;113;436;1510;5093;1623;5529
211130;201609;159174;428428;139114;398032;24545;71208;75548;227036;100093;298244
211140;201609;5485;18325;5042;17606;175;704;4336;15166;4511;15870
211150;201609;9954;28479;8850;27056;405;1385;7547;23107;7952;24492
211153;201609;2888;8809;2572;8371;643;2132;1639;5466;2282;7598
211157;201609;1219;3891;1026;3592;81;369;694;2458;775;2827
211160;201609;4191;13588;3459;12299;237;1106;2431;8391;2668;9497
211163;201609;1708;5596;1588;5417;37;126;1441;5004;1478;5130
211167;201609;1532;5079;1463;4981;38;173;1368;4653;1406;4826
211170;201609;6398;16853;6103;16498;93;278;5704;15366;5797;15644
211172;201609;2504;7264;2229;6864;105;440;1923;5826;2028;6266
211174;201609;2848;8240;2547;7852;63;311;2323;7065;2386;7376
211176;201609;4380;13568;3685;12621;356;1386;2727;9393;3083;10779
211178;201609;4092;10491;3732;10040;54;148;3556;9510;3610;9658
211180;201609;4303;14856;4022;14423;288;1118;3343;12087;3631;13205
211190;201609;2876;9474;2634;9105;69;332;2285;7859;2354;8191
211195;201609;1494;4470;1231;4128;58;164;1054;3635;1112;3799
211200;201609;2171;7123;1875;6699;346;1170;1151;4353;1497;5523
211210;201609;6875;21090;6437;20452;424;1338;5450;17389;5874;18727
211220;201609;35306;100171;29590;92589;5476;17336;18945;60686;24421;78022
211223;201609;5242;15968;4715;15108;533;1636;3481;11368;4014;13004
211227;201609;1631;5735;1479;5489;107;440;1211;4539;1318;4979
211230;201609;8423;27198;7526;25674;771;2709;5633;19453;6404;22162
211240;201609;8094;27778;7618;27151;271;1242;6830;24120;7101;25362
211245;201609;5594;16494;5546;16444;108;183;5383;16151;5491;16334
211250;201609;13503;43318;12606;42208;1220;3493;10289;35908;11509;39401
211260;201609;8652;26764;8160;26078;448;1526;7286;23303;7734;24829
211270;201609;10427;35523;9188;33886;481;2207;7387;27553;7868;29760
211280;201609;13149;39029;11840;37185;1012;2572;9646;31381;10658;33953
211285;201609;1754;6397;1505;5847;271;1150;764;3069;1035;4219
211290;201609;7276;23744;6926;23266;415;1296;5975;20411;6390;21707
211300;201609;8423;25003;7744;24043;190;523;7123;22238;7313;22761
211400;201609;12023;37142;10325;34669;2724;9270;4981;18373;7705;27643
220005;201609;1866;5298;1648;4955;68;244;1348;3936;1416;4180
220010;201609;1420;4133;1231;3828;42;160;1012;3084;1054;3244
220020;201609;3347;10561;3118;10158;562;1826;1979;6471;2541;8297
220025;201609;2293;5613;2017;5191;28;86;1735;4379;1763;4465
220027;201609;1390;3729;1218;3495;67;202;997;2856;1064;3058
220030;201609;3290;8923;3205;8788;156;522;2827;7620;2983;8142
220040;201609;7782;24070;7065;22709;1444;4600;4351;14009;5795;18609
220045;201609;1407;4624;1260;4330;61;292;968;3235;1029;3527
220050;201609;4504;13548;3845;12380;189;783;3121;9915;3310;10698
220060;201609;2108;5156;1886;4870;48;97;1720;4449;1768;4546
220070;201609;2481;7177;2216;6746;149;427;1785;5428;1934;5855
220080;201609;720;2148;663;2058;47;202;559;1674;606;1876
220090;201609;1848;4635;1513;4169;50;173;1329;3592;1379;3765
220095;201609;731;1966;680;1892;13;53;632;1734;645;1787
220100;201609;1365;4095;1092;3590;77;313;837;2687;914;3000
220105;201609;2284;7185;2000;6629;154;503;1489;4962;1643;5465
220110;201609;3440;9909;3211;9529;106;419;2820;8221;2926;8640
220115;201609;2591;8643;2472;8450;122;500;2210;7487;2332;7987
220117;201609;1318;3474;1069;3084;51;151;899;2578;950;2729
220120;201609;12412;35853;11344;34464;156;685;10641;32180;10797;32865
220130;201609;862;2912;760;2741;36;212;655;2294;691;2506
220140;201609;1704;4509;1474;4214;173;391;1199;3526;1372;3917
220150;201609;7146;21537;6648;20789;168;686;5881;18139;6049;18825
220155;201609;1127;3414;879;2932;41;150;591;1940;632;2090
220157;201609;1083;2710;912;2425;19;55;786;2039;805;2094
220160;201609;2648;7966;2316;7347;83;364;1854;5772;1937;6136
220170;201609;1397;4171;1186;3822;39;183;980;3104;1019;3287
220173;201609;2074;6210;1652;5366;44;219;1361;4288;1405;4507
220177;201609;1780;5294;1734;5224;43;168;1640;4915;1683;5083
220180;201609;1137;3088;933;2694;21;70;681;1882;702;1952
220190;201609;4679;15024;4250;14408;517;1805;3230;10960;3747;12765
220191;201609;1424;4707;1320;4523;130;492;981;3278;1111;3770
220192;201609;1816;5127;1431;4432;73;245;1085;3341;1158;3586
220194;201609;1734;5179;1541;4846;103;373;1217;3737;1320;4110
220196;201609;2054;5933;1846;5552;138;485;1492;4429;1630;4914
220198;201609;1356;3832;1027;3392;14;49;962;3216;976;3265
220200;201609;4559;14963;4200;14437;377;1338;3363;11633;3740;12971
220202;201609;2188;6520;1867;5919;38;183;1633;5054;1671;5237
220205;201609;2793;7327;2473;6872;45;174;2205;6040;2250;6214
220207;201609;909;2739;742;2422;78;281;518;1665;596;1946
220208;201609;1857;5909;1550;5348;254;936;941;3219;1195;4155
220209;201609;1575;4717;1339;4289;40;169;1114;3508;1154;3677
220210;201609;1679;4492;1420;4056;35;153;1155;3174;1190;3327
220211;201609;1605;4474;1487;4297;48;201;1321;3743;1369;3944
220213;201609;1768;4982;1584;4618;35;133;1306;3693;1341;3826
220217;201609;2024;6373;1922;6244;39;135;1785;5871;1824;6006
220220;201609;10908;29985;9499;27713;732;1812;7050;21036;7782;22848
220225;201609;1100;3155;890;2850;35;128;746;2363;781;2491
220230;201609;5450;14790;4869;13939;198;519;4298;12359;4496;12878
220240;201609;2944;9030;2671;8507;119;446;2196;6945;2315;7391
220245;201609;1528;4061;1251;3670;21;74;1130;3357;1151;3431
220250;201609;3192;9136;2867;8639;82;310;2529;7594;2611;7904
220253;201609;1619;4851;1355;4358;201;712;911;2878;1112;3590
220255;201609;1769;4902;1505;4441;38;140;1251;3539;1289;3679
220260;201609;4670;14898;4019;13650;305;1051;3014;10270;3319;11321
220265;201609;1345;4624;1205;4374;112;448;797;2919;909;3367
220270;201609;6934;22415;6543;21661;410;1704;5409;17379;5819;19083
220271;201609;1493;4158;1307;3851;70;184;1093;3271;1163;3455
220272;201609;1808;5397;1612;5032;50;208;1282;3906;1332;4114
220273;201609;1235;3555;1062;3244;80;244;794;2412;874;2656
220275;201609;2136;5373;1718;4851;27;124;1552;4288;1579;4412
220277;201609;2248;6203;1920;5642;67;215;1568;4518;1635;4733
220280;201609;1570;4213;1359;3842;83;286;1094;3011;1177;3297
220285;201609;1646;4351;1353;3950;25;98;1228;3595;1253;3693
220290;201609;6089;20208;5174;18813;528;2125;3721;13538;4249;15663
220300;201609;1856;6179;1658;5877;75;403;1355;4687;1430;5090
220310;201609;2495;8293;2231;7965;87;384;1891;6770;1978;7154
220320;201609;3034;9236;2543;8307;254;925;1796;5825;2050;6750
220323;201609;1518;5292;1317;4992;134;548;1022;3883;1156;4431
220325;201609;1174;3731;950;3263;73;298;695;2334;768;2632
220327;201609;1321;4210;1183;3959;41;222;967;3125;1008;3347
220330;201609;3703;9877;3313;9384;101;247;3021;8635;3122;8882
220335;201609;1850;5720;1663;5502;25;72;1575;5272;1600;5344
220340;201609;1864;5094;1524;4531;100;332;1127;3258;1227;3590
220342;201609;1139;3739;1060;3612;61;274;858;2898;919;3172
220345;201609;2902;7350;2534;6794;53;106;2324;6243;2377;6349
220350;201609;3980;10434;3302;9315;182;564;2583;7179;2765;7743
220360;201609;1311;3581;1104;3250;84;265;863;2488;947;2753
220370;201609;9373;26681;8395;25371;307;1087;7530;22636;7837;23723
220375;201609;1490;4696;1385;4562;16;45;1333;4435;1349;4480
220380;201609;1410;3775;1160;3410;34;126;970;2773;1004;2899
220385;201609;849;2172;676;1884;15;56;549;1496;564;1552
220390;201609;9608;29055;8155;26354;2134;6990;3194;10539;5328;17529
220400;201609;1495;3765;1119;3139;92;179;865;2418;957;2597
220410;201609;1234;3573;1037;3249;63;224;809;2484;872;2708
220415;201609;878;2383;750;2188;50;156;549;1563;599;1719
220420;201609;2171;6240;1771;5420;83;236;1378;4206;1461;4442
220430;201609;2619;7327;2541;7218;116;370;2253;6341;2369;6711
220435;201609;1654;4882;1483;4579;32;127;1225;3732;1257;3859
220440;201609;2366;7819;2179;7524;164;556;1755;5993;1919;6549
220450;201609;2096;6449;1738;5922;404;1465;974;3324;1378;4789
220455;201609;1365;4199;1255;4016;47;158;1120;3590;1167;3748
220460;201609;900;2467;817;2361;45;126;703;2019;748;2145
220465;201609;2396;7849;2151;7450;341;1241;1492;5208;1833;6449
220470;201609;3874;11350;3464;10670;149;462;2752;8354;2901;8816
220480;201609;2527;7153;2160;6552;132;354;1684;5097;1816;5451
220490;201609;2288;6477;2085;6208;52;189;1862;5480;1914;5669
220500;201609;3245;8691;2674;7677;86;388;2151;5950;2237;6338
220510;201609;2799;8035;2193;6946;73;262;1689;5313;1762;5575
220515;201609;1902;4638;1658;4308;125;289;1377;3587;1502;3876
220520;201609;5252;14192;4727;13469;115;333;4272;12202;4387;12535
220525;201609;1280;3634;1207;3524;40;139;1031;2987;1071;3126
220527;201609;1394;4249;1209;3867;117;372;878;2868;995;3240
220530;201609;1288;3646;1116;3381;46;184;976;2876;1022;3060
220535;201609;871;2621;825;2559;69;224;633;1955;702;2179
220540;201609;3535;11245;3350;10951;112;519;2939;9472;3051;9991
220545;201609;1401;4652;1311;4474;132;510;1004;3373;1136;3883
220550;201609;9301;29544;8326;27750;707;2499;6265;20726;6972;23225
220551;201609;1484;4637;1304;4315;66;285;1026;3283;1092;3568
220552;201609;1645;5043;1390;4543;56;292;1095;3434;1151;3726
220553;201609;1620;4688;1311;4208;52;202;1057;3417;1109;3619
220554;201609;819;2349;712;2180;49;146;570;1742;619;1888
220555;201609;2228;6890;2029;6594;52;263;1798;5731;1850;5994
220556;201609;1453;4441;1268;4076;52;218;969;2997;1021;3215
220557;201609;1586;5107;1404;4743;121;431;988;3324;1109;3755
220558;201609;1091;3311;964;3102;49;221;758;2365;807;2586
220559;201609;1596;4485;1387;4122;29;94;1198;3550;1227;3644
220560;201609;1682;4173;1380;3731;39;104;1194;3174;1233;3278
220570;201609;7366;23566;6802;22534;1088;3589;4508;15198;5596;18787
220580;201609;6639;20601;6437;20278;247;819;5853;18365;6100;19184
220585;201609;2112;7124;1908;6733;136;538;1546;5396;1682;5934
220590;201609;1352;3982;1182;3734;146;491;835;2679;981;3170
220595;201609;2419;7008;2236;6764;30;143;2063;6167;2093;6310
220600;201609;1316;3166;1060;2825;144;239;804;2274;948;2513
220605;201609;1952;5677;1645;5149;60;213;1333;4095;1393;4308
220610;201609;2748;8294;2597;8069;54;226;2368;7301;2422;7527
220620;201609;7707;25499;7363;25005;286;1365;6532;21895;6818;23260
220630;201609;398;1226;315;1062;51;184;168;566;219;750
220635;201609;1696;5800;1470;5296;69;331;1088;3814;1157;4145
220640;201609;2658;7752;2341;7286;100;358;1977;6083;2077;6441
220650;201609;2213;6425;1905;5846;115;395;1441;4365;1556;4760
220660;201609;2831;8438;2526;8019;110;540;2205;6771;2315;7311
220665;201609;1202;4011;1087;3804;23;126;950;3282;973;3408
220667;201609;1696;5575;1545;5304;82;297;1285;4392;1367;4689
220669;201609;1869;6048;1759;5849;233;966;1227;3972;1460;4938
220670;201609;1993;5838;1742;5512;123;324;1439;4656;1562;4980
220672;201609;2529;7256;2337;7015;169;531;1989;6005;2158;6536
220675;201609;1283;3670;1182;3481;75;178;933;2768;1008;2946
220680;201609;2468;7537;2309;7310;136;434;1974;6280;2110;6714
220690;201609;1743;4790;1474;4345;114;312;1133;3401;1247;3713
220695;201609;963;2707;863;2525;34;99;696;2021;730;2120
220700;201609;8642;24411;7381;22411;510;1682;5635;16953;6145;18635
220710;201609;822;2418;638;2042;42;113;487;1555;529;1668
220720;201609;2097;5400;1955;5202;54;156;1730;4577;1784;4733
220730;201609;1395;3934;1157;3556;29;117;980;2960;1009;3077
220735;201609;1034;2611;812;2217;36;100;657;1770;693;1870
220740;201609;1413;4364;1200;4062;61;210;1007;3457;1068;3667
220750;201609;4028;11241;3654;10647;279;732;3000;8842;3279;9574
220755;201609;1211;3377;1056;3111;48;167;830;2382;878;2549
220760;201609;2765;9170;2491;8792;126;575;2105;7345;2231;7920
220770;201609;22360;73766;19369;67755;6727;24491;5694;20622;12421;45113
220775;201609;1239;3320;1182;3255;17;56;1151;3166;1168;3222
220777;201609;1622;4380;1305;3842;83;187;1019;3008;1102;3195
220779;201609;1410;3600;1326;3484;43;145;1183;3070;1226;3215
220780;201609;5914;15817;5139;14610;418;1209;4103;11648;4521;12857
220785;201609;1318;3356;1238;3229;39;99;1139;2949;1178;3048
220790;201609;10349;31120;9373;29532;653;2322;7612;23701;8265;26023
220793;201609;831;2348;728;2179;36;136;601;1772;637;1908
220795;201609;1465;4160;1365;4021;64;208;1234;3615;1298;3823
220800;201609;16453;44533;14354;41229;1574;4746;10088;28314;11662;33060
220810;201609;3387;9663;2873;8757;108;420;2301;6864;2409;7284
220820;201609;5536;14867;4903;13931;282;692;4205;11924;4487;12616
220830;201609;7628;21299;6961;20192;558;1640;5535;16050;6093;17690
220840;201609;14198;44473;12206;40300;2640;8753;6114;20475;8754;29228
220850;201609;2914;9845;2714;9574;91;398;2471;8740;2562;9138
220855;201609;617;1882;532;1727;29;122;404;1278;433;1400
220860;201609;963;2565;839;2364;38;131;708;1961;746;2092
220865;201609;2637;7190;2050;6145;63;307;1651;4749;1714;5056
220870;201609;2294;7563;2018;7193;50;235;1838;6540;1888;6775
220880;201609;4768;12842;4380;12371;76;225;4106;11620;4182;11845
220885;201609;1286;4608;1111;4278;75;352;853;3248;928;3600
220887;201609;1382;3433;1200;3174;11;44;1118;2924;1129;2968
220890;201609;1655;5641;1435;5187;118;395;1091;4031;1209;4426
220900;201609;1941;5302;1684;4861;43;121;1473;4237;1516;4358
220910;201609;1556;4673;1336;4329;53;161;1169;3843;1222;4004
220915;201609;1031;2876;854;2530;25;105;675;1921;700;2026
220920;201609;1368;4872;1220;4647;86;452;924;3403;1010;3855
220930;201609;1445;4663;1340;4495;47;213;1147;3835;1194;4048
220935;201609;1095;3281;874;2778;53;192;590;1788;643;1980
220937;201609;1520;4140;1252;3670;54;199;970;2760;1024;2959
220940;201609;1356;4269;1235;4021;75;326;894;2838;969;3164
220945;201609;435;1605;385;1498;33;156;269;1018;302;1174
220950;201609;1334;3262;882;2492;18;72;715;1933;733;2005
220955;201609;1487;4226;1268;3830;73;193;985;2982;1058;3175
220960;201609;930;2392;726;2049;22;66;571;1598;593;1664
220965;201609;1663;4920;1551;4736;48;240;1333;3939;1381;4179
220970;201609;2190;5748;1575;4725;112;366;1160;3474;1272;3840
220975;201609;707;2261;644;2175;27;161;584;1904;611;2065
220980;201609;1312;3892;1130;3577;61;220;862;2727;923;2947
220985;201609;1212;3572;1122;3426;73;264;871;2584;944;2848
220987;201609;1494;4729;1322;4420;73;321;1032;3371;1105;3692
220990;201609;1837;5286;1548;4767;43;212;1220;3653;1263;3865
220995;201609;1269;3707;929;3153;83;292;662;2291;745;2583
220997;201609;2309;6975;2183;6775;43;197;2055;6308;2098;6505
221000;201609;4251;12917;3930;12339;275;1069;3106;9556;3381;10625
221005;201609;1469;4546;1318;4251;487;1425;572;1986;1059;3411
221010;201609;1200;3078;1002;2813;39;123;876;2423;915;2546
221020;201609;1781;5526;1622;5219;61;263;1205;3794;1266;4057
221030;201609;1528;4487;1323;4124;51;213;1083;3310;1134;3523
221035;201609;1487;4057;1369;3903;65;146;1254;3642;1319;3788
221037;201609;629;1858;538;1692;15;64;395;1184;410;1248
221038;201609;602;1697;473;1469;26;83;312;969;338;1052
221039;201609;956;2631;848;2466;29;118;698;1957;727;2075
221040;201609;4599;14195;4205;13507;216;725;3339;10734;3555;11459
221050;201609;3527;10613;3247;10206;121;427;2827;8840;2948;9267
221060;201609;8269;24057;6985;21869;470;1545;5421;16888;5891;18433
221062;201609;1285;4481;1133;4158;43;220;938;3394;981;3614
221063;201609;1093;3529;977;3315;160;520;645;2247;805;2767
221065;201609;2836;7555;2478;6960;85;237;2109;5841;2194;6078
221070;201609;3788;11938;3222;10837;161;623;2515;8437;2676;9060
221080;201609;3533;8902;2831;7873;93;285;2430;6700;2523;6985
221090;201609;1465;3947;1211;3529;36;163;1021;2890;1057;3053
221093;201609;1649;4875;1531;4613;219;688;924;2718;1143;3406
221095;201609;968;2574;827;2340;12;33;720;2006;732;2039
221097;201609;815;2263;640;1935;23;91;484;1415;507;1506
221100;201609;113568;330531;101529;309263;20349;64497;58013;173397;78362;237894
221110;201609;10457;32663;9611;31546;363;1530;8186;26572;8549;28102
221120;201609;4155;13302;3892;12809;647;2190;2637;8708;3284;10898
221130;201609;4748;13502;3791;11494;1189;3498;1525;4703;2714;8201
221135;201609;1529;4622;1389;4419;99;363;1155;3619;1254;3982
221140;201609;1362;3308;1198;3063;37;83;1056;2673;1093;2756
221150;201609;1239;3125;956;2613;26;103;773;2050;799;2153
221160;201609;829;2181;764;2084;30;78;606;1657;636;1735
221170;201609;1180;3545;1064;3342;48;139;861;2709;909;2848
230010;201609;3414;9162;2673;7843;209;697;2055;5905;2264;6602
230015;201609;2956;10046;2688;9451;335;1308;1737;6008;2072;7316
230020;201609;13808;44774;13269;43836;668;2562;11239;36914;11907;39476
230030;201609;12151;34560;10733;32264;463;1616;8814;26188;9277;27804
230040;201609;4562;12430;3758;11026;280;966;2742;7900;3022;8866
230050;201609;2664;8938;1899;6809;490;1724;537;1995;1027;3719
230060;201609;2278;6465;1889;5747;71;294;1464;4341;1535;4635
230070;201609;4255;11688;3491;10303;307;1042;2366;6967;2673;8009
230075;201609;9012;31473;8260;29924;596;2853;6369;22462;6965;25315
230080;201609;2478;6374;1962;5585;88;320;1635;4562;1723;4882
230090;201609;3972;11288;3418;10300;341;1137;2456;7352;2797;8489
230100;201609;17005;50052;15386;47038;2557;8375;9199;28151;11756;36526
230110;201609;13207;41605;11742;38400;2304;7702;6122;19818;8426;27520
230120;201609;8004;22059;6763;20138;786;2179;4543;14185;5329;16364
230125;201609;3103;8812;2455;7609;159;550;1812;5555;1971;6105
230130;201609;5779;18792;4748;16478;523;1930;3137;10711;3660;12641
230140;201609;3586;11250;2920;9949;249;956;2028;6878;2277;7834
230150;201609;1735;5341;1461;4752;292;1013;779;2493;1071;3506
230160;201609;6407;18622;5623;17406;276;1071;4554;13935;4830;15006
230170;201609;6412;19844;5399;17846;315;1188;3952;12886;4267;14074
230180;201609;1732;5060;1492;4562;69;296;1106;3225;1175;3521
230185;201609;3942;12776;3443;11811;568;1978;2130;7459;2698;9437
230190;201609;12839;40574;10948;36561;2273;7979;5197;17205;7470;25184
230195;201609;5395;16256;4611;14836;328;1222;3562;11200;3890;12422
230200;201609;5204;14831;4608;13636;390;1212;3444;10013;3834;11225
230205;201609;4187;13494;3720;12635;237;1016;2655;8877;2892;9893
230210;201609;9137;25776;7753;23485;1274;3905;4817;14745;6091;18650
230220;201609;13494;37903;11888;34984;936;3060;8808;25446;9744;28506
230230;201609;7472;23565;6707;22036;750;2500;4668;15343;5418;17843
230240;201609;14016;38613;11898;34932;551;1767;9331;26940;9882;28707
230250;201609;9861;30209;9612;29689;555;2068;7441;22428;7996;24496
230260;201609;14498;47714;12959;44381;2009;7103;7450;25775;9459;32878
230270;201609;7642;22111;6174;19303;780;2618;3998;12476;4778;15094
230280;201609;20197;58738;17378;53675;1399;4567;13046;39701;14445;44268
230290;201609;4861;14592;4037;12874;538;1597;2705;8665;3243;10262
230300;201609;4486;13264;4228;12887;246;896;3431;10276;3677;11172
230310;201609;4922;14628;4124;13134;184;744;3017;9393;3201;10137
230320;201609;7251;22177;6447;20682;413;1628;4846;15263;5259;16891
230330;201609;4869;14073;4006;12335;313;1007;2837;8598;3150;9605
230340;201609;3465;11491;3054;10566;323;1226;2010;6817;2333;8043
230350;201609;18507;55349;16248;51110;1694;6042;9987;31730;11681;37772
230360;201609;3288;9241;2511;7734;194;657;1688;5106;1882;5763
230365;201609;3091;8153;2622;7325;102;374;2154;5924;2256;6298
230370;201609;55912;175821;48813;162918;13172;45558;20608;71000;33780;116558
230380;201609;6644;19159;5302;16515;229;769;3912;12042;4141;12811
230390;201609;3530;11024;3041;10134;205;890;2188;7127;2393;8017
230393;201609;3230;10445;2668;9244;161;792;1945;6461;2106;7253
230395;201609;5796;16675;5008;15229;778;2320;3000;9355;3778;11675
230400;201609;5611;16655;4834;15350;241;1051;3798;11756;4039;12807
230410;201609;14747;46293;12308;40997;1702;5855;7389;24582;9091;30437
230420;201609;24723;78251;21653;71844;4495;15714;10169;33460;14664;49174
230423;201609;4271;13845;3836;12929;243;987;2927;9758;3170;10745
230425;201609;5618;18457;4988;17011;693;2422;3161;10794;3854;13216
230426;201609;2696;7478;2063;6249;63;279;1568;4629;1631;4908
230427;201609;1889;5552;1345;4329;149;471;794;2458;943;2929
230428;201609;8875;27286;8218;25967;1405;4767;4534;14064;5939;18831
230430;201609;4624;14454;4149;13518;295;1145;2995;9487;3290;10632
230435;201609;5098;15849;4443;14594;691;2550;2471;7956;3162;10506
230440;201609;368143;1065918;321923;981779;72419;229221;153039;465606;225458;694827
230445;201609;4630;12379;3785;10992;286;816;2707;7844;2993;8660
230450;201609;3687;11417;3125;10358;307;1276;2146;6936;2453;8212
230460;201609;1987;6402;1669;5785;149;605;1152;3936;1301;4541
230465;201609;4012;11859;3258;10407;225;870;2184;6754;2409;7624
230470;201609;11099;39826;10085;37623;1233;5037;6921;25666;8154;30703
230480;201609;1495;4607;1217;4040;153;591;811;2614;964;3205
230490;201609;2328;7034;1943;6230;281;943;978;3017;1259;3960
230495;201609;5860;18963;5061;17390;780;3025;2705;9171;3485;12196
230500;201609;9130;31980;8578;30838;581;2549;6469;23088;7050;25637
230510;201609;1520;5308;1076;4117;279;1104;335;1268;614;2372
230520;201609;4890;14729;4292;13592;423;1484;2806;8740;3229;10224
230523;201609;15196;48397;12431;41881;2922;10412;3166;10822;6088;21234
230526;201609;4148;12233;3489;11036;194;853;2695;8296;2889;9149
230530;201609;5481;17362;4828;16445;953;3450;3050;10594;4003;14044
230533;201609;4092;11251;3456;10023;401;1075;2433;7149;2834;8224
230535;201609;5614;16347;4755;14724;588;1747;3018;9666;3606;11413
230540;201609;17697;51158;15676;47819;517;2113;13206;39661;13723;41774
230550;201609;19874;58183;17020;52501;2994;9942;9014;27043;12008;36985
230560;201609;6938;19727;5804;17583;171;704;4555;13499;4726;14203
230565;201609;3528;9640;2785;8253;94;354;2099;6140;2193;6494
230570;201609;3716;9987;3207;9265;99;367;2683;7651;2782;8018
230580;201609;10176;30236;9276;28883;651;2198;7711;23890;8362;26088
230590;201609;9255;28106;7645;24933;609;2314;5409;17104;6018;19418
230600;201609;3876;10492;2730;8118;181;534;1800;5379;1981;5913
230610;201609;6286;19677;5595;18458;714;2336;3910;13009;4624;15345
230620;201609;2198;6188;1657;4993;200;647;953;2765;1153;3412
230625;201609;7990;25549;6900;22996;2041;7236;1909;6352;3950;13588
230630;201609;11032;34623;9853;32315;2642;8144;4426;15562;7068;23706
230640;201609;26634;85066;23975;80809;2452;9102;17822;59619;20274;68721
230650;201609;4921;14922;4345;13766;319;1215;3241;9985;3560;11200
230655;201609;9372;34773;8891;33824;758;3204;6876;26248;7634;29452
230660;201609;6208;19079;5202;17067;307;1405;4023;12824;4330;14229
230670;201609;6127;16141;4691;13566;148;479;3744;10476;3892;10955
230680;201609;2690;7856;2255;6982;316;960;1368;4228;1684;5188
230690;201609;6405;20400;5904;19254;732;2555;3688;11711;4420;14266
230700;201609;9806;27028;8374;24301;572;1980;6052;16882;6624;18862
230710;201609;7616;24334;6425;21965;733;2539;4410;15096;5143;17635
230720;201609;1876;5874;1546;5131;211;717;925;3045;1136;3762
230725;201609;3754;12588;3144;11028;746;2657;1060;3693;1806;6350
230730;201609;57790;172837;46372;152516;13168;47876;9767;33179;22935;81055
230740;201609;6216;18290;5486;17001;196;794;4453;13542;4649;14336
230750;201609;8522;24310;7030;21685;348;1287;5425;16355;5773;17642
230760;201609;11172;32704;9990;30216;1076;3672;6900;20066;7976;23738
230763;201609;4351;13049;3738;11793;180;744;2840;8563;3020;9307
230765;201609;39874;124196;34108;112321;8936;30997;9997;33744;18933;64741
230770;201609;25306;69196;22162;64286;2958;8871;14323;41352;17281;50223
230780;201609;5993;22813;5650;21991;1328;5260;2780;11286;4108;16546
230790;201609;2840;8924;2579;8456;216;800;1945;6361;2161;7161
230800;201609;7648;26596;6752;24539;1395;5425;3140;11147;4535;16572
230810;201609;12422;39559;11457;37810;859;3055;8722;28561;9581;31616
230820;201609;3357;11438;2840;10242;404;1671;1586;5581;1990;7252
230830;201609;7615;22717;6556;20676;382;1466;4974;15408;5356;16874
230835;201609;4088;10563;3190;9142;184;563;2483;7065;2667;7628
230837;201609;3262;10812;2670;9514;241;993;1897;6568;2138;7561
230840;201609;9273;29749;8373;28153;652;2455;6384;21526;7036;23981
230850;201609;9660;29910;8796;28330;1076;3475;5967;19357;7043;22832
230860;201609;5178;14534;4503;13454;209;713;3700;10970;3909;11683
230870;201609;18917;49226;15838;44346;673;2036;12322;34251;12995;36287
230880;201609;2003;6717;1874;6442;119;543;1336;4482;1455;5025
230890;201609;4013;14333;3612;13426;401;1846;2328;8316;2729;10162
230900;201609;2914;9626;2328;8267;510;1699;1036;3807;1546;5506
230910;201609;3175;9154;2538;7979;180;789;1893;5741;2073;6530
230920;201609;4762;13575;4394;13094;180;636;3781;11333;3961;11969
230930;201609;7171;21372;6137;19337;530;1765;4209;13195;4739;14960
230940;201609;8010;22415;6885;20559;267;926;5662;16838;5929;17764
230945;201609;6129;18359;5278;16895;390;1376;3670;11857;4060;13233
230950;201609;6522;17392;5863;16514;197;511;5093;14629;5290;15140
230960;201609;14475;44155;12664;40468;2472;8088;5927;19035;8399;27123
230970;201609;14056;42087;11848;37863;2352;8128;5350;16660;7702;24788
230980;201609;2979;9150;2518;8276;674;2157;1219;4204;1893;6361
230990;201609;1789;5236;1432;4517;115;473;945;2857;1060;3330
231000;201609;2753;7440;2127;6173;121;420;1424;4005;1545;4425
231010;201609;3150;8583;2489;7430;260;821;1670;4853;1930;5674
231020;201609;7927;26383;7299;24920;1265;4246;4297;14920;5562;19166
231025;201609;8044;24334;7144;22687;1060;3445;4524;14576;5584;18021
231030;201609;7598;24321;6152;21190;1106;3975;3310;11412;4416;15387
231040;201609;3155;9860;2745;9000;123;538;2059;6537;2182;7075
231050;201609;12092;33885;9948;29932;727;2319;7348;21935;8075;24254
231060;201609;2469;7917;2238;7472;126;634;1668;5392;1794;6026
231070;201609;8723;27273;7626;24977;1442;4832;3993;13212;5435;18044
231080;201609;3909;12124;3476;11308;138;737;2727;8487;2865;9224
231085;201609;4946;15132;4662;14687;597;1913;3302;10655;3899;12568
231090;201609;4223;11675;3217;9609;174;581;2299;6743;2473;7324
231095;201609;2222;7128;1879;6392;202;772;1239;4210;1441;4982
231100;201609;3234;9913;2600;8632;206;758;1873;6147;2079;6905
231110;201609;3557;11659;3481;11503;343;1240;2385;7801;2728;9041
231120;201609;2003;6743;1854;6411;277;1005;1148;3985;1425;4990
231123;201609;2078;5658;1743;5050;132;367;1330;3822;1462;4189
231126;201609;6373;17905;5081;15518;238;886;3761;11225;3999;12111
231130;201609;19494;58661;17105;54560;3089;10147;10156;33507;13245;43654
231135;201609;4235;12507;3489;11096;252;865;2498;7863;2750;8728
231140;201609;17344;53473;14684;48235;1102;4748;9923;31373;11025;36121
231150;201609;5847;16743;4883;14918;799;2494;2406;7436;3205;9930
231160;201609;5878;19253;5363;18183;917;3123;3105;10583;4022;13706
231170;201609;4353;13804;3776;12545;291;1119;2647;8561;2938;9680
231180;201609;14529;42603;12352;37938;2476;7752;6407;19414;8883;27166
231190;201609;4616;12906;3807;11612;244;893;2874;8506;3118;9399
231195;201609;4681;15387;3923;13810;374;1618;2692;9265;3066;10883
231200;201609;7900;26468;6726;23905;357;1807;4897;16828;5254;18635
231210;201609;5042;15589;4291;14442;256;1189;3303;10907;3559;12096
231220;201609;11984;34049;10241;30716;571;2018;7572;22142;8143;24160
231230;201609;9418;30923;8396;29293;745;3056;6191;21545;6936;24601
231240;201609;12332;38003;10805;34817;2219;7264;5371;17335;7590;24599
231250;201609;1941;5512;1233;3757;379;1165;312;892;691;2057
231260;201609;3495;10381;3083;9682;529;1642;1840;5903;2369;7545
231270;201609;7371;20001;6328;18304;265;1071;4907;13865;5172;14936
231280;201609;1776;5760;1630;5464;177;620;1104;3727;1281;4347
231290;201609;34308;114167;30011;104047;6135;23113;12762;43097;18897;66210
231300;201609;4544;13041;3546;11010;257;917;2409;7258;2666;8175
231310;201609;7534;21265;5956;17900;842;2541;3446;10167;4288;12708
231320;201609;7097;21279;5672;18311;263;1062;4193;13283;4456;14345
231325;201609;2790;8057;2349;7310;364;1300;1409;4271;1773;5571
231330;201609;12215;38044;10040;33515;1973;6533;5290;17832;7263;24365
231335;201609;5559;15443;4673;13786;153;596;3817;11002;3970;11598
231340;201609;18030;58543;16284;55629;1241;4195;12618;43887;13859;48082
231350;201609;14465;42474;13473;41047;803;2297;11725;36197;12528;38494
231355;201609;4622;14459;4138;13596;227;913;3100;10019;3327;10932
231360;201609;7797;24624;6798;22789;1196;4054;4134;14197;5330;18251
231370;201609;2443;6757;1853;5746;71;242;1401;4305;1472;4547
231375;201609;4276;14377;3918;13683;214;973;3088;10619;3302;11592
231380;201609;5549;16681;5189;16194;295;953;4204;13379;4499;14332
231390;201609;3494;10750;3151;10128;255;898;2240;7094;2495;7992
231395;201609;3918;12697;3466;11800;622;2079;1979;6810;2601;8889
231400;201609;9110;27891;8278;26152;506;1942;6192;19224;6698;21166
231410;201609;14559;48689;13111;46268;1114;4119;9921;35075;11035;39194
240010;201609;2492;7385;1972;6281;304;1083;1064;3262;1368;4345
240020;201609;10813;33486;9324;30493;1857;6359;4774;15618;6631;21977
240030;201609;2577;7234;2472;7071;147;436;2114;6011;2261;6447
240040;201609;849;2485;677;2125;20;100;495;1467;515;1567
240050;201609;3495;9414;2888;8312;94;323;2353;6626;2447;6949
240060;201609;1428;4041;1244;3681;51;185;993;2819;1044;3004
240070;201609;2572;7601;2359;7169;327;1022;1582;4741;1909;5763
240080;201609;3079;8186;2596;7476;158;479;2006;5717;2164;6196
240090;201609;2305;6138;1837;5266;46;173;1459;4085;1505;4258
240100;201609;7910;22734;6871;20517;554;1817;4948;14335;5502;16152
240110;201609;4858;15099;4194;13674;642;2300;2300;7220;2942;9520
240120;201609;2739;9351;2576;9011;347;1373;1653;5690;2000;7063
240130;201609;2810;7485;2404;6808;85;287;2004;5588;2089;5875
240140;201609;2252;6717;1860;5967;250;923;1099;3391;1349;4314
240145;201609;5833;18184;5090;16777;1358;4606;2514;8479;3872;13085
240150;201609;1003;3031;809;2609;71;286;544;1666;615;1952
240160;201609;1460;4590;1215;4129;128;515;799;2711;927;3226
240165;201609;896;2798;747;2466;131;400;434;1489;565;1889
240170;201609;2349;7081;1995;6381;463;1578;965;3055;1428;4633
240180;201609;2717;8517;2341;7730;382;1342;1412;4691;1794;6033
240185;201609;1425;4700;1316;4514;84;324;1045;3591;1129;3915
240190;201609;969;3052;843;2815;36;172;650;2149;686;2321
240200;201609;13538;35366;10887;31255;2511;7413;4466;13031;6977;20444
240210;201609;2967;8155;2639;7635;147;534;2177;6151;2324;6685
240220;201609;7416;24570;6757;23522;678;2871;4954;17027;5632;19898
240230;201609;5728;15128;4849;13699;141;448;4152;11679;4293;12127
240240;201609;1828;5494;1076;3560;221;789;189;541;410;1330
240250;201609;2711;7909;2538;7666;107;341;2206;6653;2313;6994
240260;201609;12461;41592;11656;40186;1778;6619;7494;25813;9272;32432
240270;201609;2274;7259;2062;6874;185;674;1552;5209;1737;5883
240280;201609;1598;4485;1407;4190;72;236;1127;3342;1199;3578
240290;201609;1271;3975;1089;3605;50;259;714;2207;764;2466
240300;201609;2294;6254;1607;4784;218;697;775;2228;993;2925
240310;201609;9647;27224;8312;24848;1321;4215;4508;13461;5829;17676
240320;201609;2060;6040;1525;4893;52;207;1133;3464;1185;3671
240325;201609;34961;95953;26622;81835;8134;26221;6599;20997;14733;47218
240330;201609;1524;4595;1249;3999;61;236;801;2460;862;2696
240340;201609;2086;5383;1721;4788;158;474;1285;3513;1443;3987
240350;201609;2075;5813;1915;5614;87;314;1711;4977;1798;5291
240360;201609;7293;22021;6372;20521;1569;5138;3133;10466;4702;15604
240370;201609;2057;5639;1595;4752;172;472;1039;3095;1211;3567
240375;201609;866;2314;732;2066;53;194;529;1387;582;1581
240380;201609;2445;7239;1786;5711;263;857;921;2909;1184;3766
240390;201609;938;2593;757;2233;38;129;560;1590;598;1719
240400;201609;1347;3639;1036;3019;63;210;729;2051;792;2261
240410;201609;498;1641;440;1520;73;307;248;806;321;1113
240420;201609;4752;18024;4367;17129;818;3612;2360;9184;3178;12796
240430;201609;3336;9370;2982;8701;121;489;2385;6700;2506;7189
240440;201609;2511;6503;2209;6035;441;1265;1268;3400;1709;4665
240450;201609;3876;11462;3198;10088;356;1373;1916;5691;2272;7064
240460;201609;2894;8897;2712;8635;176;757;2195;6800;2371;7557
240470;201609;3593;11208;2735;9281;822;2648;1149;4002;1971;6650
240480;201609;523;1402;374;1094;27;87;197;556;224;643
240485;201609;1996;6294;1714;5694;242;868;1066;3547;1308;4415
240490;201609;1751;4399;1412;3843;35;124;1220;3269;1255;3393
240500;201609;2171;6187;1937;5820;113;391;1545;4594;1658;4985
240510;201609;1816;5340;1679;5114;153;450;1338;4095;1491;4545
240520;201609;1256;3619;1101;3355;99;353;842;2477;941;2830
240530;201609;2008;6477;1814;6145;319;1112;1192;4029;1511;5141
240540;201609;1769;5246;1667;5070;101;328;1391;4200;1492;4528
240550;201609;797;2274;666;2033;49;149;490;1477;539;1626
240560;201609;3277;9367;3006;8950;344;911;2287;6914;2631;7825
240570;201609;3099;8578;2142;6357;471;1474;781;2053;1252;3527
240580;201609;7809;24019;7159;22841;665;2387;5559;17459;6224;19846
240590;201609;785;2180;666;1959;24;87;507;1459;531;1546
240600;201609;1626;4742;1209;3814;119;429;698;2089;817;2518
240610;201609;4669;13356;3943;11898;404;1328;2576;7556;2980;8884
240615;201609;1051;3057;817;2591;158;521;453;1386;611;1907
240620;201609;1839;5567;1621;5184;155;492;1230;3938;1385;4430
240630;201609;2098;6277;1868;5866;162;422;1318;4243;1480;4665
240640;201609;933;2625;763;2336;44;188;561;1662;605;1850
240650;201609;3961;11663;3445;10825;174;618;2762;8570;2936;9188
240660;201609;2409;7640;2241;7376;181;656;1747;5711;1928;6367
240670;201609;2648;7887;2122;6732;260;853;1221;3793;1481;4646
240680;201609;1524;4433;1178;3769;94;327;803;2508;897;2835
240690;201609;962;2617;808;2348;45;165;651;1822;696;1987
240700;201609;2632;7813;2154;6899;68;289;1687;5278;1755;5567
240710;201609;18894;49118;15791;44126;3245;8837;8510;24239;11755;33076
240720;201609;5265;14994;4660;13824;1361;4168;2113;6032;3474;10200
240725;201609;1076;3225;835;2675;70;236;500;1553;570;1789
240730;201609;2156;6484;1823;5836;120;385;1350;4302;1470;4687
240740;201609;2012;5840;1747;5329;147;556;1256;3684;1403;4240
240750;201609;2203;8141;1998;7716;463;1943;929;3603;1392;5546
240760;201609;1355;3637;1095;3253;108;291;804;2499;912;2790
240770;201609;3187;9080;2818;8546;141;593;2329;6889;2470;7482
240780;201609;6166;16916;4801;14617;666;2040;2871;8830;3537;10870
240790;201609;912;2746;731;2384;33;133;527;1722;560;1855
240800;201609;35686;101683;30679;92777;7214;22352;12669;38592;19883;60944
240810;201609;87006;249114;78186;233123;21401;63901;34268;104175;55669;168076
240820;201609;6394;19527;5452;17920;1309;4575;2302;7843;3611;12418
240830;201609;8797;27009;8090;25911;338;1494;6851;21570;7189;23064
240840;201609;1221;3367;994;2960;94;276;620;1785;714;2061
240850;201609;1323;3857;922;2911;134;434;476;1485;610;1919
240860;201609;1336;3754;1042;3201;44;160;808;2380;852;2540
240870;201609;1194;3225;947;2752;132;387;560;1537;692;1924
240880;201609;1195;3947;1115;3800;84;386;897;2956;981;3342
240890;201609;5046;14243;4092;12352;858;2657;1719;5053;2577;7710
240895;201609;2704;9216;2453;8748;257;981;1769;6352;2026;7333
240910;201609;2942;8721;2554;7962;133;494;2005;6165;2138;6659
240920;201609;771;2483;658;2227;123;447;332;1111;455;1558
240930;201609;3532;9034;3038;8389;125;347;2523;7023;2648;7370
240933;201609;1475;4023;1223;3575;49;203;1023;2848;1072;3051
240940;201609;6667;17590;5169;14968;696;1972;3213;9203;3909;11175
240950;201609;970;3161;883;2996;54;243;656;2150;710;2393
240960;201609;804;2495;690;2258;58;208;507;1663;565;1871
240970;201609;1922;5308;1602;4757;84;324;1236;3538;1320;3862
240980;201609;2991;9815;2716;9280;498;1789;1614;5489;2112;7278
240990;201609;2827;8333;2604;7862;422;1375;1634;4835;2056;6210
241000;201609;1068;2953;886;2615;43;158;627;1815;670;1973
241010;201609;2797;9476;2580;9023;330;1410;1780;5956;2110;7366
241020;201609;2070;5712;1555;4632;223;628;951;2778;1174;3406
241025;201609;1652;5004;1373;4454;68;293;1025;3224;1093;3517
241030;201609;2431;7989;2098;7275;201;806;1484;5078;1685;5884
241040;201609;2216;7530;1980;7070;140;592;1445;5163;1585;5755
241050;201609;1291;3792;1096;3425;58;228;828;2527;886;2755
241060;201609;880;2516;778;2337;62;193;557;1648;619;1841
241070;201609;782;2252;692;2081;63;236;497;1404;560;1640
241080;201609;1168;3423;928;2940;34;162;678;2073;712;2235
241090;201609;2147;6365;1754;5653;95;432;1348;4258;1443;4690
241100;201609;1193;3538;993;3062;88;294;670;2027;758;2321
241105;201609;1213;3629;1029;3283;255;806;465;1552;720;2358
241110;201609;857;2636;675;2228;51;200;437;1377;488;1577
241120;201609;7347;22332;6528;20877;1610;4991;3359;11317;4969;16308
241140;201609;3479;9413;2928;8277;267;724;2082;5777;2349;6501
241142;201609;729;2160;525;1705;117;427;224;682;341;1109
241150;201609;5507;16103;4796;14818;557;1771;3212;9886;3769;11657
241160;201609;977;2866;859;2658;143;437;516;1576;659;2013
241170;201609;1171;3414;1069;3224;90;287;847;2522;937;2809
241180;201609;961;2666;733;2191;90;284;401;1154;491;1438
241190;201609;1206;3314;933;2746;49;183;616;1725;665;1908
241200;201609;19472;56082;16639;51395;4153;13282;7081;22261;11234;35543
241210;201609;1468;4109;1128;3387;154;537;648;1861;802;2398
241220;201609;8106;26307;7316;24755;2054;7096;3341;11557;5395;18653
241230;201609;3042;8837;2768;8376;153;556;2286;6756;2439;7312
241240;201609;1235;3617;786;2536;87;313;356;1133;443;1446
241250;201609;6093;18636;4980;16415;200;1057;3828;12153;4028;13210
241255;201609;1719;6518;1526;6022;332;1435;759;2974;1091;4409
241260;201609;5215;14005;4055;12089;179;735;3072;8916;3251;9651
241270;201609;1924;5818;1618;5167;110;443;1155;3582;1265;4025
241280;201609;1872;5392;1658;4965;162;477;1188;3543;1350;4020
241290;201609;3055;8475;2519;7504;180;595;1827;5332;2007;5927
241300;201609;1466;4184;1227;3725;55;176;855;2568;910;2744
241310;201609;1657;4882;1493;4588;100;363;1175;3565;1275;3928
241320;201609;926;3176;820;2942;94;399;529;1849;623;2248
241330;201609;1449;4490;1358;4363;91;375;1142;3598;1233;3973
241335;201609;2805;8426;2509;7857;135;474;2068;6368;2203;6842
241340;201609;1851;5713;1529;4969;345;1195;671;2089;1016;3284
241350;201609;1943;6128;1728;5698;129;549;1291;4112;1420;4661
241355;201609;1447;3992;1136;3432;51;182;913;2717;964;2899
241360;201609;2118;5699;1671;4793;71;209;1248;3453;1319;3662
241370;201609;1365;4071;1073;3466;110;391;666;2082;776;2473
241380;201609;661;1878;543;1633;71;226;327;957;398;1183
241390;201609;2800;9096;2572;8687;251;985;1935;6470;2186;7455
241400;201609;3704;10630;3311;10029;368;1185;2456;7440;2824;8625
241410;201609;2507;7607;2210;7135;369;1283;1382;4421;1751;5704
241415;201609;1666;4975;1478;4659;115;411;1135;3485;1250;3896
241420;201609;2304;7908;1963;7272;603;2380;456;1647;1059;4027
241430;201609;581;1713;437;1384;44;153;243;731;287;884
241440;201609;6383;22720;5898;21870;834;3444;4185;15506;5019;18950
241445;201609;1005;2911;952;2846;71;172;781;2469;852;2641
241450;201609;3023;8193;2610;7585;332;1022;1753;5031;2085;6053
241460;201609;3451;9942;2953;8903;237;801;2137;6262;2374;7063
241470;201609;1427;3921;1144;3523;113;391;848;2587;961;2978
241475;201609;1274;3781;999;3213;40;211;760;2291;800;2502
241480;201609;2803;9224;2508;8661;1008;3596;544;2066;1552;5662
241490;201609;690;1823;569;1637;29;83;373;1025;402;1108
241500;201609;733;2301;610;2119;19;77;508;1744;527;1821
250010;201609;2815;8685;2335;7633;94;400;1778;5666;1872;6066
250020;201609;1686;4777;1245;3926;58;225;858;2601;916;2826
250030;201609;7032;20284;6431;19388;430;1374;5244;15636;5674;17010
250040;201609;4160;13914;3768;13028;564;1998;2326;8055;2890;10053
250050;201609;3452;10790;3142;10257;501;1685;1953;6207;2454;7892
250053;201609;1257;3755;1137;3571;142;456;770;2428;912;2884
250057;201609;621;2633;605;2613;9;15;576;2560;585;2575
250060;201609;5235;15477;4836;14856;435;1439;3780;11497;4215;12936
250070;201609;4053;12429;3668;11707;126;612;2875;8810;3001;9422
250073;201609;811;2365;682;2129;29;106;556;1684;585;1790
250077;201609;2187;6328;1760;5601;121;409;1234;3929;1355;4338
250080;201609;4204;12208;3965;11774;304;935;3106;9076;3410;10011
250090;201609;2584;7382;2395;7055;149;375;1929;5640;2078;6015
250100;201609;3893;12635;3619;12111;283;1059;2808;9202;3091;10261
250110;201609;5139;15182;4790;14636;406;1481;3793;11335;4199;12816
250115;201609;536;1703;461;1539;23;127;328;1025;351;1152
250120;201609;1991;6057;1662;5400;98;364;1289;4139;1387;4503
250130;201609;5350;16613;4808;15613;201;886;4007;12801;4208;13687
250135;201609;1083;3228;979;3038;33;122;795;2455;828;2577
250140;201609;2062;6792;1938;6576;159;683;1507;5035;1666;5718
250150;201609;5099;16976;4542;15887;239;1087;3429;11741;3668;12828
250153;201609;1473;4001;1253;3674;43;188;1083;3103;1126;3291
250157;201609;1720;5582;1544;5225;205;716;1061;3598;1266;4314
250160;201609;3308;9722;3117;9405;100;364;2851;8571;2951;8935
250170;201609;1618;4714;1443;4434;130;450;1103;3363;1233;3813
250180;201609;16103;46761;14826;44648;1665;5443;10598;31218;12263;36661
250190;201609;4274;12183;3772;11305;574;1680;2386;7091;2960;8771
250200;201609;2029;5918;1662;5352;85;319;1378;4395;1463;4714
250205;201609;885;3027;798;2836;36;175;586;2057;622;2232
250210;201609;1474;4819;1361;4633;101;434;1060;3502;1161;3936
250215;201609;1373;4458;1283;4313;106;401;843;2811;949;3212
250220;201609;760;2287;651;2130;31;131;529;1729;560;1860
250230;201609;1543;3884;1218;3315;47;169;989;2553;1036;2722
250240;201609;2336;7718;2192;7445;107;420;1768;5986;1875;6406
250250;201609;4385;13093;3949;12446;175;589;3401;10712;3576;11301
250260;201609;1724;5202;1458;4756;79;267;1143;3720;1222;3987
250270;201609;1308;4060;1151;3852;92;303;878;3028;970;3331
250280;201609;3647;10704;3150;9882;318;1013;2352;7375;2670;8388
250290;201609;1924;5119;1571;4627;33;128;1408;4127;1441;4255
250300;201609;5602;16320;5267;15903;474;1841;4352;12785;4826;14626
250310;201609;1166;3540;1023;3292;89;320;774;2442;863;2762
250320;201609;8222;24332;7636;23335;852;2864;5445;16222;6297;19086
250330;201609;2431;7549;2060;6969;145;540;1562;5219;1707;5759
250340;201609;1105;3247;976;3010;33;128;826;2506;859;2634
250350;201609;4187;11624;3729;11038;121;429;3235;9589;3356;10018
250355;201609;1910;6116;1739;5865;53;265;1510;5012;1563;5277
250360;201609;1863;5445;1698;5171;55;154;1449;4418;1504;4572
250370;201609;11774;33746;10496;32250;753;2356;9048;27890;9801;30246
250375;201609;1090;3292;973;3106;35;132;832;2655;867;2787
250380;201609;1695;4825;1588;4668;82;313;1346;3853;1428;4166
250390;201609;1872;5096;1458;4360;170;481;952;2838;1122;3319
250400;201609;73997;195661;56032;165822;14972;46047;21145;62999;36117;109046
250403;201609;1526;4979;1389;4773;207;889;929;3065;1136;3954
250407;201609;1217;3386;1021;3064;86;231;734;2163;820;2394
250410;201609;548;1781;500;1685;22;111;396;1294;418;1405
250415;201609;1866;5560;1646;5149;105;321;1261;3903;1366;4224
250420;201609;1294;3785;1160;3572;27;109;1036;3162;1063;3271
250430;201609;6003;16249;5417;15304;264;839;4569;12618;4833;13457
250435;201609;1382;4194;1209;3865;106;398;861;2719;967;3117
250440;201609;4510;12892;4054;12217;125;434;3492;10416;3617;10850
250450;201609;1957;5525;1714;5189;60;218;1451;4317;1511;4535
250460;201609;6586;19623;6085;18907;486;1552;4913;15450;5399;17002
250470;201609;1601;4302;1324;3899;119;414;927;2612;1046;3026
250480;201609;3797;11420;3467;10931;84;368;3082;9693;3166;10061
250485;201609;667;1685;539;1479;31;106;437;1162;468;1268
250490;201609;3861;11936;3722;11724;723;2192;2616;8340;3339;10532
250500;201609;1790;5372;1558;4961;149;463;1184;3802;1333;4265
250510;201609;4980;13973;4361;13030;158;487;3849;11512;4007;11999
250520;201609;1786;5350;1633;5093;233;780;1001;3059;1234;3839
250523;201609;1679;5124;1619;5034;145;522;1323;4057;1468;4579
250527;201609;1433;4273;1356;4174;23;118;1248;3773;1271;3891
250530;201609;621;1882;535;1775;31;109;466;1542;497;1651
250535;201609;1337;4164;1235;3954;46;216;1001;3107;1047;3323
250540;201609;2437;6836;2232;6580;52;222;1941;5585;1993;5807
250550;201609;915;3010;829;2871;43;214;660;2225;703;2439
250560;201609;1676;5237;1592;5098;79;334;1370;4281;1449;4615
250570;201609;2655;8319;2286;7579;113;490;1782;5720;1895;6210
250580;201609;1134;3018;958;2733;67;240;771;2121;838;2361
250590;201609;860;2641;783;2522;56;218;654;2054;710;2272
250600;201609;7406;21504;6835;20606;723;2049;5253;15979;5976;18028
250610;201609;3174;9133;2897;8684;230;724;2229;6633;2459;7357
250620;201609;703;2055;611;1862;79;267;398;1187;477;1454
250625;201609;2431;7792;2366;7702;57;133;2256;7418;2313;7551
250630;201609;9532;29482;8536;27374;1904;6126;4400;14071;6304;20197
250640;201609;3468;10619;3252;10315;181;768;2772;8603;2953;9371
250650;201609;859;2380;736;2192;38;143;554;1551;592;1694
250660;201609;1857;4908;1687;4679;24;49;1597;4471;1621;4520
250670;201609;2404;8059;2269;7812;121;568;1886;6345;2007;6913
250680;201609;4938;13837;4663;13489;186;605;4201;12141;4387;12746
250690;201609;6120;15885;5799;15487;388;1012;5163;13786;5551;14798
250700;201609;4750;14000;4296;13276;678;2161;2820;8615;3498;10776
250710;201609;4464;13758;3931;12968;455;1574;2781;9260;3236;10834
250720;201609;2720;7829;2506;7487;73;319;2233;6575;2306;6894
250730;201609;3535;10633;3247;10206;235;814;2523;7762;2758;8576
250740;201609;1930;5574;1649;5132;159;591;1251;3742;1410;4333
250750;201609;101472;284689;90738;267606;12093;38047;61093;176847;73186;214894
250760;201609;2279;6418;1999;5977;143;529;1629;4777;1772;5306
250770;201609;3944;13031;3659;12593;448;1762;2603;8827;3051;10589
250780;201609;1842;5328;1543;4754;158;578;1018;3024;1176;3602
250790;201609;2408;7795;2233;7475;498;1616;1295;4481;1793;6097
250800;201609;2707;7533;2339;6906;93;276;1945;5645;2038;5921
250810;201609;1307;3816;1124;3523;67;279;895;2749;962;3028
250820;201609;1871;5853;1790;5751;83;352;1604;5098;1687;5450
250830;201609;5645;18093;5118;16989;489;1839;3576;11599;4065;13438
250840;201609;909;2957;747;2593;57;234;505;1750;562;1984
250850;201609;2004;6147;1790;5784;84;385;1423;4496;1507;4881
250855;201609;1093;3200;940;2940;48;206;715;2146;763;2352
250860;201609;3201;10333;2658;9277;639;2347;985;3441;1624;5788
250870;201609;1055;3059;903;2738;25;93;724;2143;749;2236
250880;201609;1494;4049;1239;3685;133;412;944;2810;1077;3222
250890;201609;9412;28086;8764;27110;1116;3972;6219;18652;7335;22624
250900;201609;2844;9137;2431;8276;208;689;1812;6174;2020;6863
250905;201609;2051;6458;1947;6309;223;773;1520;4907;1743;5680
250910;201609;4981;14424;4610;13827;215;744;3859;11441;4074;12185
250915;201609;1416;4336;1382;4285;101;227;1203;3851;1304;4078
250920;201609;3307;9336;3045;8898;274;753;2276;6642;2550;7395
250930;201609;2034;6208;1888;5954;155;610;1421;4371;1576;4981
250933;201609;1134;3704;1033;3486;82;304;696;2302;778;2606
250937;201609;678;2082;595;1915;46;172;438;1370;484;1542
250939;201609;1553;4708;1418;4464;151;515;993;3075;1144;3590
250940;201609;3822;11259;3515;10728;100;366;3083;9407;3183;9773
250950;201609;1295;3934;1114;3675;46;192;903;2960;949;3152
250960;201609;1086;3494;1019;3381;59;228;828;2710;887;2938
250970;201609;8544;23481;7303;21434;620;1894;5442;15766;6062;17660
250980;201609;2598;7573;2283;6967;92;380;1761;5132;1853;5512
250990;201609;1976;6640;1731;6080;234;952;1104;3722;1338;4674
251000;201609;2136;6266;1858;5794;50;220;1574;4829;1624;5049
251010;201609;2785;8149;2477;7646;79;267;2138;6602;2217;6869
251020;201609;1654;4688;1508;4497;70;211;1366;4075;1436;4286
251030;201609;1085;3062;976;2857;60;207;715;2034;775;2241
251040;201609;1794;5618;1580;5233;74;347;1209;3853;1283;4200
251050;201609;1093;3155;886;2732;134;422;537;1613;671;2035
251060;201609;1047;2379;765;2002;34;106;613;1575;647;1681
251065;201609;474;1423;408;1313;27;93;280;852;307;945
251070;201609;636;1784;563;1674;33;117;452;1293;485;1410
251080;201609;19520;54506;17006;50194;4606;14090;7432;22443;12038;36533
251090;201609;3007;9197;2599;8399;191;691;1915;6059;2106;6750
251100;201609;996;3122;879;2902;75;307;596;1883;671;2190
251110;201609;1947;5656;1665;5099;130;364;1159;3529;1289;3893
251120;201609;6168;20717;5789;19989;572;2325;4348;14706;4920;17031
251130;201609;4001;10246;3647;9851;97;251;3480;9462;3577;9713
251140;201609;4275;12961;3981;12474;102;452;3382;10509;3484;10961
251150;201609;2643;8309;2409;7943;181;764;1804;5789;1985;6553
251160;201609;1877;5995;1812;5910;54;222;1676;5446;1730;5668
251170;201609;1432;4345;1350;4238;76;308;1157;3560;1233;3868
251180;201609;2550;7678;2276;7223;345;1103;1427;4511;1772;5614
251190;201609;4410;12112;4207;11854;147;448;3919;10972;4066;11420
251200;201609;3829;12389;3618;12112;81;351;3332;11118;3413;11469
251203;201609;1029;3407;979;3301;44;196;753;2476;797;2672
251207;201609;1118;3428;913;3015;46;219;645;2039;691;2258
251210;201609;7998;22457;6727;20731;684;2055;5154;16224;5838;18279
251220;201609;1188;3121;954;2771;86;250;724;2112;810;2362
251230;201609;4626;13661;4215;13142;223;824;3732;11502;3955;12326
251240;201609;3320;9966;3003;9516;355;1162;2260;7085;2615;8247
251250;201609;10510;30691;9549;29148;756;2661;7288;21682;8044;24343
251260;201609;487;1543;441;1471;24;104;327;1065;351;1169
251270;201609;4265;13741;3875;13219;120;570;3419;11582;3539;12152
251272;201609;1384;3955;1309;3847;88;286;1147;3344;1235;3630
251274;201609;913;2815;801;2607;75;307;542;1706;617;2013
251275;201609;1267;3645;1168;3475;61;270;917;2595;978;2865
251276;201609;1230;3742;1143;3583;67;269;868;2643;935;2912
251278;201609;604;1879;517;1699;57;212;345;1126;402;1338
251280;201609;2367;7022;2171;6676;97;379;1755;5222;1852;5601
251290;201609;5729;15570;5321;15039;556;1940;4167;11371;4723;13311
251300;201609;782;2592;727;2499;36;155;581;1963;617;2118
251310;201609;2996;8916;2716;8493;123;547;2194;6644;2317;7191
251315;201609;1645;5620;1551;5447;143;516;1146;4023;1289;4539
251320;201609;1906;5263;1422;4435;48;166;1051;3257;1099;3423
251330;201609;1799;4794;1505;4390;69;312;1314;3711;1383;4023
251335;201609;1039;3452;941;3276;72;322;680;2308;752;2630
251340;201609;3431;9607;2980;8897;186;718;2285;6579;2471;7297
251350;201609;1290;4081;1190;3893;82;315;919;2922;1001;3237
251360;201609;1828;5703;1552;5302;54;221;1355;4656;1409;4877
251365;201609;802;2354;624;1967;17;68;455;1410;472;1478
251370;201609;22653;70030;21659;68482;2041;7412;16853;51926;18894;59338
251380;201609;1365;4203;1164;3848;32;172;988;3139;1020;3311
251385;201609;796;2109;658;1884;64;177;449;1242;513;1419
251390;201609;5913;19958;5164;18419;1472;5346;2260;8105;3732;13451
251392;201609;1061;3134;922;2896;56;198;712;2205;768;2403
251394;201609;618;1936;498;1706;42;158;349;1179;391;1337
251396;201609;835;2354;699;2122;84;248;454;1369;538;1617
251398;201609;986;2830;837;2540;31;123;586;1725;617;1848
251400;201609;1177;3289;990;3008;83;294;724;2122;807;2416
251410;201609;1512;3893;1264;3479;42;168;1070;2834;1112;3002
251420;201609;2007;5724;1737;5391;194;645;1268;3878;1462;4523
251430;201609;1641;5584;1471;5297;64;327;1238;4358;1302;4685
251440;201609;1251;3683;996;3173;47;190;759;2390;806;2580
251445;201609;1507;4609;1411;4466;106;421;1108;3389;1214;3810
251450;201609;4628;14628;4248;14061;107;493;3609;11866;3716;12359
251455;201609;1086;3473;956;3214;69;267;667;2232;736;2499
251460;201609;817;2533;747;2409;73;228;591;1925;664;2153
251465;201609;447;1413;389;1292;15;78;293;936;308;1014
251470;201609;1184;3449;948;2967;81;292;593;1801;674;2093
251480;201609;947;2659;817;2439;29;136;653;1869;682;2005
251490;201609;1779;5281;1555;4909;138;513;1101;3405;1239;3918
251500;201609;1711;5447;1632;5297;103;427;1360;4301;1463;4728
251510;201609;2610;8490;2310;7866;405;1445;1323;4466;1728;5911
251520;201609;960;2612;822;2363;104;297;531;1501;635;1798
251530;201609;12166;33647;11359;32453;261;1103;10000;27970;10261;29073
251540;201609;2918;9241;2641;8696;168;685;2104;6812;2272;7497
251550;201609;3533;9179;2922;8295;80;284;2481;6966;2561;7250
251560;201609;709;2199;642;2070;87;322;391;1189;478;1511
251570;201609;1016;2997;787;2517;42;177;561;1727;603;1904
251580;201609;1926;5375;1748;5125;347;855;1136;3486;1483;4341
251590;201609;1494;4619;1417;4506;48;168;1175;3713;1223;3881
251593;201609;1003;3108;916;2975;138;466;552;1736;690;2202
251597;201609;1931;5879;1860;5786;50;206;1674;5144;1724;5350
251600;201609;6542;19134;6017;18280;334;1044;4881;14737;5215;15781
251610;201609;3339;9922;2927;9165;271;826;2167;6829;2438;7655
251615;201609;1149;3274;895;2817;80;252;612;1892;692;2144
251620;201609;15585;41943;13421;39306;606;1736;11343;34104;11949;35840
251630;201609;4692;12047;3899;10871;332;963;2976;8120;3308;9083
251640;201609;2568;7434;2127;6642;103;423;1648;5052;1751;5475
251650;201609;3986;11440;3598;10895;225;672;3062;9260;3287;9932
251660;201609;3561;11340;3223;10715;112;542;2718;8765;2830;9307
251670;201609;4472;13270;3851;12463;43;138;3561;11694;3604;11832
251675;201609;738;2313;674;2222;115;429;425;1349;540;1778
251680;201609;2777;7910;2228;7031;83;339;1754;5456;1837;5795
251690;201609;3305;9891;2928;9107;126;438;2244;6783;2370;7221
251700;201609;1950;6281;1812;6088;88;431;1532;5028;1620;5459
251710;201609;899;2349;559;1630;113;369;252;657;365;1026
251720;201609;1427;4362;1203;3940;58;285;931;2923;989;3208
251740;201609;785;2198;598;1867;57;185;383;1194;440;1379
260005;201609;26181;62985;21388;55849;4565;11502;11571;30509;16136;42011
260010;201609;10166;27241;8124;24375;1176;3575;4861;14990;6037;18565
260020;201609;6173;16867;5092;15196;221;795;4134;12323;4355;13118
260030;201609;6241;17693;5405;16314;370;1218;4274;12797;4644;14015
260040;201609;9965;24075;8029;21718;704;1782;6182;17293;6886;19075
260050;201609;11451;35043;10556;33894;536;1943;9128;29508;9664;31451
260060;201609;3927;10965;3419;10048;327;934;2504;7491;2831;8425
260070;201609;9921;28464;8911;26771;1184;3895;6016;17682;7200;21577
260080;201609;5910;15423;5151;14313;631;1681;3674;10162;4305;11843
260090;201609;5246;14268;4806;13608;657;1790;3474;9923;4131;11713
260100;201609;3405;9303;2890;8555;147;590;2417;7074;2564;7664
260105;201609;5033;13924;4690;13331;184;701;4045;11202;4229;11903
260110;201609;21378;59408;19467;57022;797;2475;17285;50622;18082;53097
260120;201609;12351;36876;10718;33908;2409;7753;5625;18162;8034;25915
260130;201609;3287;9112;3019;8666;400;1182;2160;6147;2560;7329
260140;201609;13303;32654;11203;29995;798;2307;8895;23816;9693;26123
260150;201609;3227;8917;2847;8396;193;710;2251;6563;2444;7273
260160;201609;5640;17523;4809;16368;268;1165;3968;13452;4236;14617
260170;201609;16667;46430;15664;44914;1017;3266;13039;36932;14056;40198
260180;201609;3327;9986;2978;9474;173;544;2509;8019;2682;8563
260190;201609;16451;37892;14693;35567;440;1157;12848;30682;13288;31839
260200;201609;11415;29095;10386;27679;473;1452;9003;23921;9476;25373
260210;201609;11878;35355;10380;32965;542;2029;8524;27034;9066;29063
260220;201609;9610;27436;9187;26832;418;1526;8116;23320;8534;24846
260230;201609;9783;27620;8855;26241;429;1485;7265;21455;7694;22940
260240;201609;3015;8862;2573;8197;321;1114;1818;5790;2139;6904
260250;201609;2324;6322;2034;5906;124;370;1669;4808;1793;5178
260260;201609;12455;34891;11171;32955;1247;3958;8378;24858;9625;28816
260270;201609;3696;10603;3334;10010;241;993;2527;7233;2768;8226
260280;201609;13079;41865;11739;39731;706;2454;9774;33322;10480;35776
260290;201609;32333;96047;29898;91471;5182;16487;18523;55941;23705;72428
260300;201609;8751;26517;7477;24437;373;1552;5940;19356;6313;20908
260310;201609;4677;13642;4183;12847;1096;3069;2333;7632;3429;10701
260320;201609;7312;23188;6641;22031;374;1401;5488;18197;5862;19598
260330;201609;2667;8484;2418;7991;106;431;1903;6147;2009;6578
260340;201609;1894;5480;1727;5216;44;149;1554;4670;1598;4819
260345;201609;23191;71410;20930;66771;5694;19613;7827;23687;13521;43300
260350;201609;4932;13167;4500;12524;180;605;3893;10689;4073;11294
260360;201609;2389;6807;2069;6228;135;504;1492;4398;1627;4902
260370;201609;5748;17753;4940;16218;392;1554;3554;11533;3946;13087
260380;201609;4887;15936;4368;15063;243;1001;3298;11287;3541;12288
260390;201609;4314;13687;3648;12289;291;1064;2622;8688;2913;9752
260392;201609;3520;11132;3158;10640;215;964;2635;8646;2850;9610
260400;201609;13985;39112;12965;37325;1570;4934;9011;25363;10581;30297
260410;201609;62182;175885;52277;159160;14772;47116;19694;60928;34466;108044
260415;201609;3881;12022;3219;10626;232;987;2146;6767;2378;7754
260420;201609;12310;27738;10728;25946;214;702;9794;23366;10008;24068
260430;201609;2929;9377;2487;8483;241;873;1661;5638;1902;6511
260440;201609;3358;10037;2894;9078;364;1245;1858;5665;2222;6910
260450;201609;5052;14694;4793;14310;194;636;4247;12714;4441;13350
260460;201609;5663;17829;5019;16488;906;3186;2768;8885;3674;12071
260470;201609;4596;13657;4114;13022;170;488;3651;11838;3821;12326
260480;201609;4174;11771;3548;10815;522;1722;2337;7144;2859;8866
260490;201609;5094;13280;4349;11988;242;744;3521;9488;3763;10232
260500;201609;5972;17019;5169;15637;804;2414;3311;10042;4115;12456
260510;201609;8965;23627;8182;22543;356;1134;7201;19649;7557;20783
260515;201609;4815;14401;3569;11801;235;847;2318;7641;2553;8488
260520;201609;16469;42265;15441;40759;1648;4288;11993;31485;13641;35773
260530;201609;9914;29886;8644;27877;371;1405;7333;23613;7704;25018
260540;201609;6215;15160;5587;14453;879;1559;4236;11791;5115;13350
260545;201609;71;254;40;159;8;33;11;38;19;71
260550;201609;2777;8961;2228;7690;419;1526;980;3365;1399;4891
260560;201609;6261;16519;5530;15422;151;589;4888;13393;5039;13982
260570;201609;6990;22526;6285;21337;560;2128;4643;15655;5203;17783
260580;201609;3766;10417;3438;9843;117;389;2946;8277;3063;8666
260590;201609;6220;15475;5765;14918;314;795;5000;12961;5314;13756
260600;201609;28491;82413;24908;76200;2001;7147;18257;55076;20258;62223
260610;201609;6612;19708;6170;18943;725;2348;4401;13303;5126;15651
260620;201609;15844;47566;14845;45712;2305;7818;9413;28172;11718;35990
260630;201609;2264;6596;1972;6112;101;418;1617;4889;1718;5307
260640;201609;17460;47560;16084;45526;2299;6775;10820;30521;13119;37296
260650;201609;5489;17100;4783;15842;291;1102;3798;12597;4089;13699
260660;201609;7883;21650;6907;20303;351;1113;5871;17134;6222;18247
260670;201609;2411;6381;1925;5665;126;393;1386;4062;1512;4455
260680;201609;21877;61391;19204;56293;3734;11080;9712;28268;13446;39348
260690;201609;3696;9914;2938;8596;207;594;2274;6587;2481;7181
260700;201609;5856;17302;5680;17105;35;64;5575;16940;5610;17004
260710;201609;1356;3945;1259;3813;86;278;939;2894;1025;3172
260720;201609;18237;56998;16677;53870;3518;11647;9073;29168;12591;40815
260730;201609;6845;22551;6305;21603;816;2932;4560;15502;5376;18434
260740;201609;1304;3864;1115;3504;92;320;821;2574;913;2894
260750;201609;6921;20706;6033;19532;296;921;5264;17312;5560;18233
260760;201609;4801;12800;4397;12220;217;706;3729;10318;3946;11024
260765;201609;7865;26290;7356;25381;967;4217;4991;16476;5958;20693
260770;201609;3856;10216;3427;9494;123;389;2812;7678;2935;8067
260775;201609;5026;14685;4625;13988;431;1571;3304;9654;3735;11225
260780;201609;3697;11818;3372;11143;662;2395;1752;5542;2414;7937
260790;201609;112814;283095;101553;264876;20904;55115;57977;149725;78881;204840
260795;201609;3112;9155;2717;8524;225;778;1990;6247;2215;7025
260800;201609;4971;13183;4588;12630;138;500;4111;11004;4249;11504
260805;201609;3863;11322;3174;10105;354;1288;2189;6803;2543;8091
260810;201609;6889;19058;6554;18599;302;916;5715;16114;6017;17030
260820;201609;4173;11674;3560;10631;760;2302;1879;5518;2639;7820
260825;201609;2922;9271;2564;8659;162;617;1957;6612;2119;7229
260830;201609;3753;11956;3298;11028;516;1679;2109;7183;2625;8862
260840;201609;4294;12170;3743;11328;237;833;3058;9123;3295;9956
260845;201609;4235;12190;3940;11633;450;1367;2882;8541;3332;9908
260850;201609;4985;16195;4268;14535;800;2910;1995;6675;2795;9585
260860;201609;3572;10858;3040;9759;148;532;2369;7503;2517;8035
260870;201609;4324;11476;3669;10556;323;922;2910;8327;3233;9249
260875;201609;6566;18192;5673;16660;822;2378;3759;11115;4581;13493
260880;201609;9859;29508;8806;27698;575;1880;7057;22284;7632;24164
260890;201609;13299;37801;12071;35691;732;2419;9345;27306;10077;29725
260900;201609;5925;18023;4931;16016;383;1541;3212;10188;3595;11729
260910;201609;3075;9133;2690;8475;159;584;2077;6450;2236;7034
260915;201609;4605;15274;4308;14851;84;420;3967;13598;4051;14018
260920;201609;3204;9737;2912;9310;170;628;2357;7614;2527;8242
260930;201609;3916;12583;3353;11560;356;1248;2347;8074;2703;9322
260940;201609;14115;37194;12464;34305;1519;4658;8439;22495;9958;27153
260950;201609;6369;19506;5516;17686;820;2974;2884;8733;3704;11707
260960;201609;56641;155532;50135;144268;9908;29670;26206;74193;36114;103863
260970;201609;5023;14948;4501;14217;294;1073;3529;11128;3823;12201
260980;201609;4028;13007;3738;12612;117;487;3337;11214;3454;11701
260990;201609;17662;53543;15775;50781;1070;3824;12579;40492;13649;44316
261000;201609;16185;43557;12774;38054;2288;7114;6725;20504;9013;27618
261010;201609;2561;7021;2325;6732;131;287;2049;6082;2180;6369
261020;201609;6299;18138;5422;16542;555;1675;3980;11950;4535;13625
261030;201609;3672;11410;3210;10578;186;735;2573;8319;2759;9054
261040;201609;5161;16499;4325;14710;391;1507;3110;10406;3501;11913
261050;201609;7941;23031;7263;21719;925;2753;4864;14558;5789;17311
261060;201609;12451;36100;11303;33982;933;3208;8457;24827;9390;28035
261070;201609;53639;129620;45868;117867;6059;15769;30774;78461;36833;94230
261080;201609;5806;16591;5404;15967;329;878;4634;13903;4963;14781
261090;201609;16717;45355;15027;42856;1199;3324;12002;34413;13201;37737
261100;201609;8247;25585;7132;23533;1254;4306;4158;13823;5412;18129
261110;201609;62426;182860;53482;168342;13128;43395;25061;80209;38189;123604
261120;201609;3835;10032;3275;9296;77;266;2953;8372;3030;8638
261130;201609;7160;18152;6517;17363;148;463;5961;15800;6109;16263
261140;201609;3284;9059;2901;8431;375;1220;1851;5241;2226;6461
261150;201609;5433;15459;4937;14655;314;1157;4104;12041;4418;13198
261153;201609;2171;6259;1754;5596;82;328;1301;4125;1383;4453
261160;201609;199847;520299;178863;486894;45656;127832;80708;220975;126364;348807
261170;201609;5971;16072;5326;15100;437;1291;4180;11874;4617;13165
261180;201609;9679;26683;8739;25185;971;3037;5984;16918;6955;19955
261190;201609;5240;15980;4807;15398;461;1897;3458;10675;3919;12572
261200;201609;3632;9035;3229;8532;361;951;2543;6764;2904;7715
261210;201609;1917;5034;1758;4824;135;356;1522;4202;1657;4558
261220;201609;13399;41172;10839;35565;1546;5533;5977;19254;7523;24787
261230;201609;4666;14498;4223;13904;124;527;3716;12291;3840;12818
261240;201609;4997;14464;4499;13585;577;1616;3151;9647;3728;11263
261245;201609;3628;11024;3041;9917;145;639;2402;7612;2547;8251
261247;201609;3290;9987;2702;8855;228;850;1921;6344;2149;7194
261250;201609;19618;51784;18007;49456;3394;8930;11954;33784;15348;42714
261255;201609;4078;12525;3518;11470;223;958;2793;8801;3016;9759
261260;201609;12510;34679;10949;32605;515;1614;9354;27932;9869;29546
261270;201609;3682;10892;3255;10148;314;1107;2301;6989;2615;8096
261280;201609;2585;7796;2341;7399;126;482;1922;5966;2048;6448
261290;201609;2959;8402;2625;7932;149;538;2135;6443;2284;6981
261300;201609;10683;34070;8999;30808;1252;4817;5634;18842;6886;23659
261310;201609;7358;22509;6782;21401;1693;5436;3582;11306;5275;16742
261320;201609;5857;17940;5258;16808;210;789;4251;13415;4461;14204
261330;201609;5717;15951;5329;15405;356;1215;4436;12559;4792;13774
261340;201609;3962;13132;3671;12608;350;1485;2534;8571;2884;10056
261350;201609;8158;26518;7499;25309;247;1283;6162;20146;6409;21429
261360;201609;8231;21494;7115;19813;616;1773;5553;15128;6169;16901
261370;201609;19899;58178;18048;54980;3733;11715;9935;30213;13668;41928
261380;201609;4188;14123;3797;13255;552;2119;2430;8418;2982;10537
261390;201609;16515;49763;14463;46085;2045;6856;8860;28269;10905;35125
261400;201609;4704;16017;4080;14654;301;1305;2927;10371;3228;11676
261410;201609;8915;24484;7845;22761;697;2117;6083;17556;6780;19673
261420;201609;7543;25088;7120;24461;1547;6003;4206;14097;5753;20100
261430;201609;3467;10590;2962;9799;235;806;2290;7681;2525;8487
261440;201609;1582;4937;1389;4601;47;250;1089;3502;1136;3752
261450;201609;14390;40523;13669;39545;316;1183;12437;35690;12753;36873
261460;201609;7281;21085;6726;20315;418;1209;5764;17592;6182;18801
261470;201609;4106;11121;3720;10607;86;271;3349;9679;3435;9950
261480;201609;3773;13297;3394;12570;269;1097;2526;9182;2795;10279
261485;201609;5003;15266;4369;14073;622;2258;2712;8512;3334;10770
261500;201609;5688;15769;4958;14714;505;1396;3634;11100;4139;12496
261510;201609;1897;6023;1678;5642;117;426;1251;4209;1368;4635
261520;201609;2693;8667;2434;8161;131;526;1665;5738;1796;6264
261530;201609;11505;36794;9964;33541;2079;7602;4254;14142;6333;21744
261540;201609;7105;22887;6553;21852;1625;5333;3594;12323;5219;17656
261550;201609;3496;9754;3233;9338;243;842;2538;7151;2781;7993
261560;201609;7156;23288;6413;22231;767;3018;4716;16334;5483;19352
261570;201609;3441;10270;2899;9301;420;1393;1814;5766;2234;7159
261580;201609;6143;18383;5474;17269;304;1270;4640;14421;4944;15691
261590;201609;2467;6924;2072;6271;176;531;1533;4659;1709;5190
261600;201609;5290;14240;4450;12986;311;926;3485;10226;3796;11152
261610;201609;2431;6830;2090;6343;124;469;1690;5083;1814;5552
261618;201609;2542;7028;2256;6627;161;497;1761;5090;1922;5587
261620;201609;4136;12746;3799;12155;735;2315;2393;7829;3128;10144
261630;201609;7717;22416;6258;19535;743;2647;3717;11249;4460;13896
261640;201609;34120;84400;31755;81454;2072;4747;25905;69167;27977;73914
261650;201609;3785;11219;3431;10694;259;948;2635;8218;2894;9166
270010;201609;4503;16597;4026;15623;333;1587;2860;10978;3193;12565
270020;201609;3943;11049;3610;10539;308;1001;2882;8233;3190;9234
270030;201609;39702;117471;36171;111441;8406;26184;19531;60466;27937;86650
270040;201609;10722;32350;9740;30987;1689;5461;6301;20339;7990;25800
270050;201609;4407;12217;3959;11644;351;1141;3199;9365;3550;10506
270060;201609;1904;5555;1738;5332;279;886;1169;3632;1448;4518
270070;201609;4421;13360;3993;12748;175;788;3431;10687;3606;11475
270080;201609;1272;3984;1068;3552;145;514;672;2173;817;2687
270090;201609;2090;6433;1874;5984;66;333;1543;4703;1609;5036
270100;201609;5748;17476;5341;16759;614;2209;3897;11992;4511;14201
270110;201609;3249;8818;2815;8308;349;1037;1912;5989;2261;7026
270120;201609;3166;8800;2726;8214;107;408;2399;7173;2506;7581
270130;201609;5164;15438;4685;14857;646;2123;3455;11151;4101;13274
270135;201609;1789;4742;1590;4476;178;360;1330;3917;1508;4277
270140;201609;10508;24820;8741;22482;895;3017;6791;16405;7686;19422
270150;201609;2727;8749;2631;8627;49;162;2529;8324;2578;8486
270160;201609;5101;16647;4599;15961;173;775;3965;13617;4138;14392
270170;201609;3817;12138;3435;11563;531;2037;2118;6963;2649;9000
270180;201609;2297;7451;2084;7130;85;444;1719;5731;1804;6175
270190;201609;1807;5864;1697;5707;90;346;1436;4848;1526;5194
270200;201609;2612;8605;2409;8312;201;855;1809;6092;2010;6947
270210;201609;4780;14060;4436;13557;262;1048;3749;11220;4011;12268
270220;201609;1336;4372;1210;4135;227;828;685;2288;912;3116
270230;201609;11011;34195;9306;31239;1107;4534;5811;18769;6918;23303
270235;201609;6456;20551;5945;19708;352;1477;4853;15920;5205;17397
270240;201609;9570;28667;7827;26287;1943;6728;3697;12695;5640;19423
270250;201609;3261;8480;2925;8048;458;1230;2188;6035;2646;7265
270255;201609;4978;14885;3782;12652;224;939;2730;8886;2954;9825
270260;201609;5924;18866;5688;18511;388;1656;4770;15131;5158;16787
270270;201609;1187;3354;1062;3153;221;663;613;1794;834;2457
270280;201609;3512;9813;2969;8946;339;866;2122;6464;2461;7330
270290;201609;8220;28243;7565;27063;554;2530;5869;20566;6423;23096
270300;201609;3668;11516;3218;10918;330;1207;2396;8076;2726;9283
270310;201609;7627;22733;6578;21075;239;1214;5523;17205;5762;18419
270320;201609;5913;18355;5522;17664;842;2964;3756;11802;4598;14766
270330;201609;4309;14535;3987;14074;407;1534;3098;11019;3505;12553
270340;201609;1759;5279;1526;4954;150;491;1160;3734;1310;4225
270350;201609;1931;5109;1712;4836;151;465;1258;3551;1409;4016
270360;201609;2013;6163;1917;6053;143;419;1656;5325;1799;5744
270370;201609;1530;5003;1360;4696;101;419;999;3422;1100;3841
270375;201609;2919;7988;2568;7501;92;310;2281;6635;2373;6945
270380;201609;5807;17558;5276;16765;713;2102;3895;12720;4608;14822
270390;201609;1271;3450;1089;3157;52;184;850;2372;902;2556
270400;201609;6420;18937;5599;17653;345;1293;4153;12701;4498;13994
270410;201609;4857;15087;4365;14131;404;1433;3094;9839;3498;11272
270420;201609;5937;18718;5624;18259;238;1083;4642;14699;4880;15782
270430;201609;138457;395608;119350;364900;33988;108885;43753;136462;77741;245347
270440;201609;4702;13982;4190;13195;169;700;3490;10886;3659;11586
270450;201609;6310;19324;5966;18853;322;1309;4930;15300;5252;16609
270460;201609;3470;9066;3063;8529;119;409;2689;7345;2808;7754
270470;201609;10450;32830;9384;31011;1060;3889;6372;20995;7432;24884
270480;201609;2864;8796;2497;8114;277;1070;1709;5317;1986;6387
270490;201609;988;3098;889;2937;41;180;702;2282;743;2462
270500;201609;4873;16471;4546;16036;280;1211;3769;13213;4049;14424
270510;201609;6048;17699;5337;16651;606;2419;4008;11940;4614;14359
270520;201609;3508;11076;3140;10410;994;3584;1004;3420;1998;7004
270530;201609;1379;4238;1255;4034;115;387;867;2832;982;3219
270540;201609;2075;6782;1856;6439;106;559;1530;5112;1636;5671
270550;201609;7244;20877;6194;19476;769;2508;4324;13876;5093;16384
270560;201609;3105;9201;2842;8783;270;961;2108;6370;2378;7331
270570;201609;3797;12151;3422;11474;516;1671;2412;8124;2928;9795
270580;201609;2072;6324;1943;6146;142;455;1591;5102;1733;5557
270590;201609;1393;4544;1320;4427;9;41;1284;4311;1293;4352
270600;201609;2856;9366;2565;8845;132;638;2072;6970;2204;7608
270610;201609;3246;9997;2973;9578;158;578;2487;7916;2645;8494
270620;201609;1411;4679;1308;4501;82;374;1047;3473;1129;3847
270630;201609;16501;47708;14824;44910;2025;6058;10200;31441;12225;37499
270640;201609;5746;17477;5073;16391;316;1326;4061;12791;4377;14117
270642;201609;2296;8084;2119;7821;208;998;1598;5748;1806;6746
270644;201609;2721;7938;2351;7408;242;748;1800;5753;2042;6501
270650;201609;3714;11508;3481;11167;422;1920;2493;7473;2915;9393
270660;201609;2114;5465;1570;4626;109;354;1179;3387;1288;3741
270670;201609;16862;42656;14226;39523;1833;4928;10380;29502;12213;34430
270680;201609;4354;12598;4122;12319;127;361;3828;11504;3955;11865
270690;201609;9227;25287;8079;23906;2572;7115;4207;13323;6779;20438
270700;201609;640;1983;561;1842;84;343;364;1126;448;1469
270710;201609;5975;18916;5597;18388;415;1681;4614;14846;5029;16527
270720;201609;3400;11334;3050;10694;129;739;2524;8619;2653;9358
270730;201609;6447;18476;6017;17993;540;1671;4993;15075;5533;16746
270740;201609;2310;6570;2157;6338;208;691;1693;4895;1901;5586
270750;201609;5194;15800;4735;15037;652;2186;3355;10608;4007;12794
270760;201609;3441;10184;3044;9510;128;496;2472;7625;2600;8121
270770;201609;19158;49585;15382;44843;3240;9292;8622;26402;11862;35694
270780;201609;1832;5842;1714;5631;198;752;1254;4053;1452;4805
270790;201609;1510;4733;1365;4507;319;1129;706;2296;1025;3425
270800;201609;11519;33402;10508;31987;639;2406;8834;26391;9473;28797
270810;201609;3351;10068;2542;8539;272;1013;1584;5342;1856;6355
270820;201609;1813;5840;1593;5458;260;961;980;3338;1240;4299
270830;201609;5844;15276;5119;14359;397;1056;4110;11926;4507;12982
270840;201609;7953;25151;7249;24174;331;1703;6216;20072;6547;21775
270850;201609;7462;22869;7067;22314;915;3615;5054;15017;5969;18632
270860;201609;11071;30829;9177;28290;1119;3944;6158;18468;7277;22412
270870;201609;2172;6531;1790;5728;219;769;1189;3725;1408;4494
270880;201609;8290;26245;7587;25153;417;1744;6240;20384;6657;22128
270890;201609;2450;7424;2253;7048;220;846;1668;5046;1888;5892
270895;201609;2911;10549;2751;10286;128;642;2391;8828;2519;9470
270900;201609;1945;5201;1551;4625;108;329;1125;3280;1233;3609
270910;201609;3589;11626;3251;10985;237;1014;2501;8221;2738;9235
270915;201609;9560;31541;8390;29349;1285;5159;4974;16913;6259;22072
270920;201609;6160;19256;5873;18830;266;1317;5166;16053;5432;17370
270930;201609;17528;45977;14149;41675;3072;8697;8012;24630;11084;33327
270940;201609;5615;18378;5153;17772;470;2178;3658;12072;4128;14250
280010;201609;667;1934;563;1744;47;198;377;1084;424;1282
280020;201609;4885;13909;4054;12435;679;2249;2544;7597;3223;9846
280030;201609;76602;197204;62622;175316;18292;52754;23197;66369;41489;119123
280040;201609;3131;9436;2733;8811;227;821;2038;6482;2265;7303
280050;201609;3825;11981;3455;11325;1054;3612;1466;4862;2520;8474
280060;201609;5039;15554;4218;14047;858;3034;2102;7116;2960;10150
280067;201609;7338;20309;6128;18337;961;2826;3680;11155;4641;13981
280070;201609;1967;6331;1853;6150;229;805;1378;4564;1607;5369
280100;201609;3865;11797;3382;10929;495;1750;2207;7113;2702;8863
280110;201609;1435;4222;1285;3979;55;222;1095;3332;1150;3554
280120;201609;7885;24509;7130;23241;1091;3214;4888;16521;5979;19735
280130;201609;7665;21029;6859;19811;945;2924;4752;13705;5697;16629
280140;201609;5888;15328;5274;14414;397;1147;4270;11692;4667;12839
280150;201609;3517;10377;3197;9813;257;900;2389;7122;2646;8022
280160;201609;1382;3985;1165;3619;172;567;750;2279;922;2846
280170;201609;4873;14244;4320;13371;444;1345;3255;10202;3699;11547
280190;201609;1200;3149;1007;2843;74;242;787;2149;861;2391
280200;201609;1192;3500;1056;3281;103;389;784;2350;887;2739
280210;201609;14047;40657;12085;37625;2437;7923;6706;20988;9143;28911
280220;201609;1618;4880;1484;4659;67;260;1248;3860;1315;4120
280230;201609;3523;10339;3086;9609;350;1170;2038;6359;2388;7529
280240;201609;3504;9980;3129;9367;187;577;2512;7481;2699;8058
280250;201609;824;2160;646;1865;113;376;342;907;455;1283
280260;201609;2145;5560;1978;5347;64;193;1810;4901;1874;5094
280270;201609;2257;6935;1976;6471;113;443;1566;5011;1679;5454
280280;201609;4171;13407;3656;12485;800;2206;2102;7932;2902;10138
280290;201609;17797;52846;15699;49396;2469;8299;9546;30022;12015;38321
280300;201609;9693;28887;8984;27989;721;2468;7050;22640;7771;25108
280310;201609;1404;3884;1185;3493;52;212;876;2508;928;2720
280320;201609;8803;27371;7827;25618;1350;4697;4284;13841;5634;18538
280330;201609;4519;12770;4041;11944;438;1516;2978;8427;3416;9943
280340;201609;3917;10751;3639;10361;299;905;2943;8493;3242;9398
280350;201609;22763;62315;19601;57368;2891;8720;12687;37174;15578;45894
280360;201609;5916;18290;5310;17216;989;3513;2957;9359;3946;12872
280370;201609;1913;5266;1586;4693;182;496;1093;3243;1275;3739
280380;201609;1047;3175;932;2988;90;342;652;2012;742;2354
280390;201609;3200;9272;2640;8197;440;1390;1661;5168;2101;6558
280400;201609;4233;11685;3737;10912;1151;3306;1740;5269;2891;8575
280410;201609;2234;7031;1827;6185;276;1019;1006;3254;1282;4273
280420;201609;4220;12088;3842;11483;210;664;3269;9744;3479;10408
280430;201609;2301;5818;2042;5443;103;354;1603;4157;1706;4511
280440;201609;4743;13681;4244;12985;349;1140;3356;10100;3705;11240
280445;201609;2548;6982;2294;6524;73;256;1850;5143;1923;5399
280450;201609;9288;24318;8500;23264;630;1423;7124;20083;7754;21506
280460;201609;7023;18110;6258;16969;737;2013;4598;12594;5335;14607
280470;201609;1832;5480;1602;5051;154;477;1169;3719;1323;4196
280480;201609;32873;93328;30056;88869;4907;15814;19409;56165;24316;71979
280490;201609;3900;11510;3374;10609;216;799;2521;7770;2737;8569
280500;201609;937;2475;827;2321;47;126;684;1902;731;2028
280510;201609;2698;7700;2282;7112;186;651;1664;5149;1850;5800
280520;201609;1838;4880;1645;4632;143;374;1361;3873;1504;4247
280530;201609;2499;6661;2258;6350;137;396;1887;5318;2024;5714
280540;201609;9528;25712;8671;24454;254;962;7623;21016;7877;21978
280550;201609;7081;18161;5752;16067;563;1549;4068;11346;4631;12895
280560;201609;7683;22420;7176;21644;376;1283;6007;17856;6383;19139
280570;201609;6548;17518;5539;16082;558;1731;3812;10933;4370;12664
280580;201609;5626;17062;4660;15306;785;2472;2786;9423;3571;11895
280590;201609;2553;7252;2220;6785;307;1094;1425;4241;1732;5335
280600;201609;3668;11122;3360;10620;288;1017;2536;7893;2824;8910
280610;201609;2517;6943;2246;6518;183;624;1633;4602;1816;5226
280620;201609;5342;15474;4573;14102;589;1692;3088;9895;3677;11587
280630;201609;3680;11838;3386;11365;307;1028;2677;9161;2984;10189
280640;201609;2247;6668;2123;6524;81;239;1973;6106;2054;6345
280650;201609;1136;3483;1009;3272;97;357;722;2310;819;2667
280660;201609;2778;7575;2610;7354;331;890;2100;5957;2431;6847
280670;201609;16875;43318;15190;40863;2152;6121;10403;27643;12555;33764
280680;201609;2864;7620;2435;6909;180;535;1911;5318;2091;5853
280690;201609;965;2721;835;2527;108;346;585;1752;693;2098
280700;201609;1080;3177;933;2924;68;212;660;2048;728;2260
280710;201609;12295;31563;10995;29960;679;1521;9425;26338;10104;27859
280720;201609;2380;6223;2145;5932;252;685;1479;4265;1731;4950
280730;201609;927;2749;844;2616;75;285;668;2016;743;2301
280740;201609;13495;35761;11171;31910;1516;4171;7257;20986;8773;25157
280750;201609;3549;10637;3173;9962;312;1012;2252;7103;2564;8115
280760;201609;5798;17320;5124;16241;855;2866;3031;9827;3886;12693
290010;201609;3031;6768;2139;5356;44;173;1727;4103;1771;4276
290020;201609;4439;14489;4296;14280;392;997;3555;12127;3947;13124
290030;201609;3225;9785;3010;9451;470;1485;2184;6888;2654;8373
290035;201609;4699;11808;3983;10821;210;661;3086;8641;3296;9302
290040;201609;4276;11115;3533;10232;218;768;2769;7951;2987;8719
290050;201609;2489;8026;2148;7391;153;623;1560;5291;1713;5914
290060;201609;1324;3371;1078;3045;135;458;813;2197;948;2655
290070;201609;34635;84651;28484;76255;5769;15141;14513;40729;20282;55870
290080;201609;6160;18094;5088;16546;714;2362;3472;11487;4186;13849
290090;201609;2188;4704;1687;4156;121;273;1451;3640;1572;3913
290100;201609;9682;27392;8285;25115;1137;3502;5174;16020;6311;19522
290110;201609;4937;14438;4580;13783;711;2259;2924;8597;3635;10856
290115;201609;4903;14544;4303;13739;252;746;3506;11475;3758;12221
290120;201609;6918;17783;5634;16226;230;761;4693;13400;4923;14161
290130;201609;4674;12090;3780;10926;167;611;3061;8598;3228;9209
290135;201609;4704;11531;3816;10084;319;967;2770;6978;3089;7945
290140;201609;4368;13119;3683;12182;228;906;3017;9947;3245;10853
290150;201609;2228;6608;2095;6363;208;675;1645;4925;1853;5600
290160;201609;3512;8797;3308;8524;342;709;2683;7039;3025;7748
290170;201609;2789;8958;2492;8507;148;667;2099;7039;2247;7706
290180;201609;2978;8576;2523;7848;165;591;1940;5969;2105;6560
290190;201609;3842;12590;3604;12205;199;816;2797;9345;2996;10161
290195;201609;2205;5907;1782;5219;56;254;1519;4351;1575;4605
290200;201609;3973;12148;3407;11221;232;804;2695;8842;2927;9646
290205;201609;3318;9438;2887;8714;207;792;2226;6527;2433;7319
290210;201609;15062;42004;13341;39640;2208;5867;9029;28518;11237;34385
290220;201609;2313;6766;2144;6484;125;508;1708;4997;1833;5505
290225;201609;3029;7235;2678;6831;131;355;2425;6168;2556;6523
290230;201609;2287;7303;2133;7097;121;491;1757;5807;1878;6298
290240;201609;3638;9780;3215;9100;233;712;2541;7079;2774;7791
290250;201609;3964;12221;3567;11645;145;414;3010;10278;3155;10692
290260;201609;5236;14512;4270;13011;352;1162;3268;9915;3620;11077
290265;201609;3484;10669;3014;9771;159;682;2351;7490;2510;8172
290270;201609;12181;43697;11420;42367;1372;5513;8275;30738;9647;36251
290280;201609;5387;17204;4829;16172;497;1716;3551;11869;4048;13585
290290;201609;10017;30841;8649;28454;1235;4032;5766;19225;7001;23257
290300;201609;4727;13117;3291;10354;221;709;2258;7232;2479;7941
290310;201609;1466;4342;1238;3953;195;659;718;2287;913;2946
290320;201609;29244;81845;24242;74985;5515;17985;12104;38256;17619;56241
290323;201609;3940;10565;3390;9881;154;445;2822;8198;2976;8643
290327;201609;4506;13430;3774;12028;515;1666;2432;7735;2947;9401
290330;201609;1870;4518;1712;4344;102;277;1512;3858;1614;4135
290340;201609;5132;15351;4668;14752;1304;4196;2605;8300;3909;12496
290350;201609;4478;13589;3789;12482;331;1095;2709;9093;3040;10188
290360;201609;4639;13805;3946;12823;144;565;3318;10846;3462;11411
290370;201609;4868;13159;4094;12094;310;888;3334;9930;3644;10818
290380;201609;5661;16128;4851;14874;281;912;3811;11850;4092;12762
290390;201609;15008;44863;13189;42062;2015;6529;8291;27158;10306;33687
290395;201609;2621;8481;2309;7879;121;559;1751;5947;1872;6506
290400;201609;3673;10594;2997;9491;240;766;2153;6713;2393;7479
290405;201609;4776;14804;3873;13027;519;1711;2404;8256;2923;9967
290410;201609;6034;17567;4758;15439;366;1446;3416;10702;3782;12148
290420;201609;3326;9534;2715;8603;198;666;2130;6729;2328;7395
290430;201609;3185;9798;2736;8935;481;1618;1654;5448;2135;7066
290440;201609;3042;7912;2376;6936;148;499;1847;5432;1995;5931
290450;201609;3338;9582;2745;8632;238;853;1947;6017;2185;6870
290460;201609;12999;37372;11297;34229;3381;10335;4123;12501;7504;22836
290470;201609;4450;12143;3276;10326;691;2343;1516;4909;2207;7252
290475;201609;5651;17815;4867;16268;231;1074;3825;12406;4056;13480
290480;201609;2540;6754;2346;6494;232;644;1691;4948;1923;5592
290485;201609;4851;15202;4161;14131;244;1179;3368;11234;3612;12413
290490;201609;8367;21539;7800;20755;575;1671;6483;16977;7058;18648
290500;201609;4223;13108;3330;11249;504;1826;1778;5960;2282;7786
290510;201609;3425;9487;2911;8740;159;533;2370;7081;2529;7614
290515;201609;3594;9995;2957;9124;218;664;2407;7562;2625;8226
290520;201609;11955;36232;9151;30517;829;3012;5591;18441;6420;21453
290530;201609;5207;15185;4453;13955;310;937;3501;11009;3811;11946
290540;201609;3977;11285;3736;10962;321;956;3066;9054;3387;10010
290550;201609;4694;11974;4034;11188;97;269;3702;10280;3799;10549
290560;201609;6531;18386;5580;16956;1313;3815;3169;9921;4482;13736
290570;201609;43272;117090;38672;110344;3788;10981;28280;80321;32068;91302
290580;201609;7174;23877;6632;22968;683;2492;4946;17365;5629;19857
290590;201609;7396;23248;6243;21132;248;1028;5093;17149;5341;18177
290600;201609;17929;53201;16350;50896;1899;5721;12241;39087;14140;44808
290610;201609;2529;8399;1996;7266;130;593;1420;5031;1550;5624
290620;201609;6563;19542;5860;18390;338;1083;4814;15024;5152;16107
290630;201609;8405;21425;7213;20010;572;1612;6001;16724;6573;18336
290640;201609;2732;7793;2144;6795;128;483;1663;5173;1791;5656
290650;201609;11246;32067;10464;30922;2284;6664;6268;19086;8552;25750
290660;201609;3746;10179;3118;9222;115;363;2359;7238;2474;7601
290670;201609;7017;21108;6063;19421;654;2125;4282;13808;4936;15933
290680;201609;10554;30763;9246;28943;415;1664;7624;23397;8039;25061
290682;201609;4670;13136;4056;12215;123;462;3531;10522;3654;10984
290685;201609;3812;8937;2427;6932;270;799;1535;4471;1805;5270
290687;201609;7624;21326;5779;18381;1315;4209;2730;9105;4045;13314
290689;201609;3229;9206;2778;8493;246;818;2079;6546;2325;7364
290690;201609;5611;15575;4796;14411;707;2091;3219;9716;3926;11807
290700;201609;2404;7312;2226;7028;142;475;1755;5547;1897;6022
290710;201609;7830;24290;7189;23262;507;1587;5878;19148;6385;20735
290720;201609;19105;54626;17237;52095;1380;3739;14091;43621;15471;47360
290730;201609;7380;19834;6474;18563;763;1986;4626;13478;5389;15464
290740;201609;965;2805;736;2382;67;239;528;1692;595;1931
290750;201609;10432;28626;8681;25273;1360;4311;5063;14168;6423;18479
290755;201609;2379;6683;1821;5650;107;381;1316;4008;1423;4389
290760;201609;4303;12832;3363;11028;469;1382;2028;6872;2497;8254
290770;201609;2557;8844;2359;8553;94;446;1928;6988;2022;7434
290780;201609;9139;22809;7740;20740;783;1594;5885;16437;6668;18031
290790;201609;4479;13135;4083;12569;221;665;3489;10768;3710;11433
290800;201609;7316;15345;5614;13448;453;865;4432;11118;4885;11983
290810;201609;5480;16313;4456;14605;175;622;3432;11272;3607;11894
290820;201609;5729;15722;5000;14710;455;1444;3778;11231;4233;12675
290830;201609;4403;11517;3951;10826;191;635;2988;7963;3179;8598
290840;201609;17859;50131;15443;46373;2299;6590;9860;30892;12159;37482
290850;201609;6222;17797;5865;17316;819;2147;4419;13597;5238;15744
290860;201609;5190;17093;4738;16485;436;1531;3723;13255;4159;14786
290870;201609;4827;13940;3795;12180;222;868;2750;8739;2972;9607
290880;201609;1476;3933;1138;3372;96;262;793;2390;889;2652
290890;201609;7314;18420;6177;17119;552;1287;5085;14435;5637;15722
290900;201609;2481;7018;1815;5799;243;800;984;3135;1227;3935
290910;201609;4834;12646;3877;11199;89;340;3310;9395;3399;9735
290920;201609;5023;13462;4555;12801;224;619;3890;10905;4114;11524
290930;201609;8320;24513;7020;22358;302;1341;5589;17409;5891;18750
290940;201609;3571;11113;3043;10246;98;332;2498;8527;2596;8859
290950;201609;1583;4305;1342;3909;135;391;921;2706;1056;3097
290960;201609;5865;16324;5242;15490;164;563;4403;13075;4567;13638
290970;201609;3792;11571;3203;10570;254;850;2204;7300;2458;8150
290980;201609;10767;30289;8677;26257;2473;7565;2431;7380;4904;14945
290990;201609;9194;27028;7768;24568;674;2343;5797;17969;6471;20312
291000;201609;3090;8934;2731;8491;122;429;2435;7551;2557;7980
291005;201609;14693;37689;12715;34973;1389;3888;9261;25702;10650;29590
291010;201609;3323;10151;2532;8440;226;759;1676;5633;1902;6392
291020;201609;1374;3573;1010;2905;97;273;571;1551;668;1824
291030;201609;2289;6138;1589;4728;133;433;1003;2880;1136;3313
291040;201609;5678;16664;4894;15435;296;1187;3869;12049;4165;13236
291050;201609;8034;25596;7145;23886;1668;6042;3726;12146;5394;18188
291060;201609;6056;21964;5611;21179;880;3699;3582;13292;4462;16991
291070;201609;16566;46604;14096;42822;863;2976;11040;33244;11903;36220
291072;201609;23673;68796;18163;57450;4517;15210;6175;19590;10692;34800
291075;201609;5256;14610;4549;13458;283;757;3468;10323;3751;11080
291077;201609;1494;4197;1161;3614;83;273;777;2387;860;2660
291080;201609;79932;246288;68209;222000;24311;79666;13198;42613;37509;122279
291085;201609;5790;14987;4869;13705;371;1087;3964;11173;4335;12260
291090;201609;1670;3830;1465;3576;64;144;1304;3185;1368;3329
291100;201609;2620;6620;2068;5972;106;400;1626;4585;1732;4985
291110;201609;5126;17782;4532;16817;546;2264;3224;11709;3770;13973
291120;201609;7358;19641;6628;18477;782;2178;4727;13215;5509;15393
291125;201609;1965;3858;1483;3336;95;247;1191;2683;1286;2930
291130;201609;2894;8957;2356;7931;93;411;1789;5883;1882;6294
291140;201609;4220;12413;3477;10952;506;1460;2172;6940;2678;8400
291150;201609;2003;5087;1847;4892;80;257;1566;4062;1646;4319
291160;201609;5305;16438;4546;15103;812;2792;2540;8377;3352;11169
291165;201609;2578;7135;1917;5882;38;160;1419;4226;1457;4386
291170;201609;22289;57221;18222;51022;1727;5249;11872;32969;13599;38218
291180;201609;6305;16300;4976;14183;404;1202;3643;10421;4047;11623
291185;201609;3748;10040;3273;9285;166;482;2706;7600;2872;8082
291190;201609;7330;19608;6344;18154;417;1510;5211;14591;5628;16101
291200;201609;2936;8665;2259;7334;137;442;1513;4970;1650;5412
291210;201609;6973;16609;5707;15021;250;796;4451;11634;4701;12430
291220;201609;4284;13096;3834;12315;506;1835;2535;7942;3041;9777
291230;201609;4041;10092;3629;9623;90;169;3394;9131;3484;9300
291240;201609;4693;12536;3953;11179;122;378;3257;9047;3379;9425
291250;201609;3598;10899;2764;9290;261;860;1835;6257;2096;7117
291260;201609;1087;3122;981;2982;53;245;828;2416;881;2661
291270;201609;4641;14488;4023;13274;1281;4320;1933;6393;3214;10713
291280;201609;2112;6129;1661;5310;324;1123;822;2530;1146;3653
291290;201609;5688;15708;4785;14433;733;2165;2987;9163;3720;11328
291300;201609;4412;12376;3265;10360;200;717;2399;7467;2599;8184
291310;201609;5435;15287;4608;13749;264;813;3612;10714;3876;11527
291320;201609;6173;18989;4881;16381;1188;3995;2164;7386;3352;11381
291330;201609;1622;4828;1402;4439;96;333;1011;3154;1107;3487
291340;201609;3965;10849;3171;9663;120;404;2592;7819;2712;8223
291345;201609;3421;10691;3135;10318;207;652;2614;8788;2821;9440
291350;201609;5828;16813;4973;15324;274;909;3873;12018;4147;12927
291360;201609;34487;92216;28965;83943;7209;20960;15064;44700;22273;65660
291370;201609;8393;23646;7777;22809;571;1719;6030;17813;6601;19532
291380;201609;3754;11100;3167;10138;173;632;2432;7819;2605;8451
291390;201609;10391;27541;9426;26295;1086;2957;7226;20222;8312;23179
291400;201609;13973;38125;12010;35043;2264;5998;7508;23126;9772;29124
291410;201609;3347;8688;2388;7095;119;511;1769;5034;1888;5545
291420;201609;2120;5696;1778;5250;79;281;1501;4399;1580;4680
291430;201609;3299;9437;2852;8784;144;649;2318;6868;2462;7517
291440;201609;6800;20074;5552;17877;571;1849;4047;13153;4618;15002
291450;201609;8391;24025;7177;22266;279;815;5848;18890;6127;19705
291460;201609;13444;40138;11862;37533;1546;5275;7637;24237;9183;29512
291465;201609;8140;22871;7002;21497;417;1665;5763;17376;6180;19041
291470;201609;16285;42644;13960;39730;967;2644;10533;30856;11500;33500
291480;201609;36309;91307;28934;80343;4632;13427;16207;44772;20839;58199
291490;201609;4309;13585;3975;13077;570;1841;2782;9313;3352;11154
291500;201609;4391;12277;3568;10972;188;735;2889;8728;3077;9463
291510;201609;3746;11051;3348;10477;72;266;2951;9305;3023;9571
291520;201609;3918;10516;3232;9509;493;1505;2068;6040;2561;7545
291530;201609;2225;5942;1681;5108;406;1229;835;2704;1241;3933
291535;201609;3797;11457;3381;10779;203;670;2644;8496;2847;9166
291540;201609;2138;5029;1769;4646;121;224;1561;4221;1682;4445
291550;201609;5184;13531;4373;12351;772;2015;2614;7551;3386;9566
291560;201609;18960;44126;12858;36702;850;2433;9757;28676;10607;31109
291570;201609;2238;5846;1995;5542;156;298;1688;4898;1844;5196
291580;201609;5562;16516;4787;15321;449;1767;3469;10939;3918;12706
291590;201609;1787;5550;1587;5210;159;556;1186;3919;1345;4475
291600;201609;5200;14235;3807;11826;975;3170;1635;4924;2610;8094
291610;201609;4967;15611;4757;15354;133;436;4376;14265;4509;14701
291620;201609;3105;7163;2232;6189;132;382;1789;5033;1921;5415
291630;201609;3228;7674;2603;6920;237;602;2023;5478;2260;6080
291640;201609;17086;46022;12926;39375;3306;10391;3817;12114;7123;22505
291650;201609;8416;24215;7660;23250;590;1457;6370;19801;6960;21258
291660;201609;2210;5713;1691;4868;127;446;1115;3002;1242;3448
291670;201609;1890;5219;1672;4904;98;269;1336;3998;1434;4267
291680;201609;4117;11783;3480;10667;588;1920;2081;6362;2669;8282
291685;201609;4828;12043;3905;10798;599;1560;2589;7418;3188;8978
291690;201609;3927;10393;2949;8705;217;607;2072;6054;2289;6661
291700;201609;9248;28322;8096;26237;884;2778;5934;19495;6818;22273
291710;201609;5340;13754;4181;12147;298;894;3075;8872;3373;9766
291720;201609;4605;14674;3764;12831;321;1227;2669;8837;2990;10064
291730;201609;6267;18177;5581;17206;478;1544;4398;13707;4876;15251
291733;201609;2763;7739;2153;6822;202;674;1427;4569;1629;5243
291735;201609;2987;8142;2454;7333;112;400;2044;6059;2156;6459
291740;201609;3807;10800;3170;9865;201;711;2552;7892;2753;8603
291750;201609;22744;57735;17079;48664;3688;10678;8338;24333;12026;35011
291760;201609;11077;34842;9414;31816;3802;14172;2227;7404;6029;21576
291770;201609;7767;22175;6317;19444;811;2667;3981;11950;4792;14617
291780;201609;4523;13490;4169;12876;206;659;3516;10839;3722;11498
291790;201609;2744;8135;2552;7851;78;293;2186;6631;2264;6924
291800;201609;31021;83132;26468;76515;4020;11580;16648;49237;20668;60817
291810;201609;10889;28973;8943;26457;384;1325;7358;21626;7742;22951
291820;201609;3829;11187;3338;10421;183;650;2577;8059;2760;8709
291830;201609;4239;11068;3815;10420;332;927;2982;8178;3314;9105
291835;201609;6414;19695;4912;16786;1471;5254;2210;7657;3681;12911
291840;201609;48700;134876;41794;126325;6312;18551;28579;89183;34891;107734
291845;201609;2642;7537;2447;7285;136;330;2197;6711;2333;7041
291850;201609;4607;13046;3709;11569;364;981;2693;8742;3057;9723
291855;201609;1864;4477;1580;4098;128;441;1229;3062;1357;3503
291860;201609;2186;6066;1581;4790;97;342;1062;3094;1159;3436
291870;201609;1431;3812;959;2912;68;258;629;1819;697;2077
291875;201609;2850;8860;2526;8314;90;351;1825;5873;1915;6224
291880;201609;4992;15852;4477;14770;493;1624;3203;10563;3696;12187
291890;201609;1321;3353;1033;2960;191;487;701;2078;892;2565
291900;201609;1292;3401;1009;2918;57;196;762;2161;819;2357
291905;201609;2752;7381;1973;5891;98;326;1482;4275;1580;4601
291910;201609;2802;7429;2304;6808;111;413;1967;5766;2078;6179
291915;201609;7124;21546;5813;19124;388;1366;4422;14622;4810;15988
291920;201609;26045;76339;23481;72448;3278;10714;15106;46536;18384;57250
291930;201609;2654;7717;2277;7066;187;649;1636;4959;1823;5608
291940;201609;3426;9538;2410;7662;303;1030;1418;4376;1721;5406
291950;201609;8953;29258;7847;27063;1357;4665;4407;15657;5764;20322
291955;201609;11336;31954;10200;30350;2538;7550;5299;16626;7837;24176
291960;201609;3197;9182;2550;8176;230;725;1862;6188;2092;6913
291970;201609;3985;11985;3616;11342;353;1221;2442;7681;2795;8902
291980;201609;12136;33964;9091;29437;1027;3330;6031;19913;7058;23243
291990;201609;2213;6616;2008;6348;78;259;1725;5565;1803;5824
291992;201609;2938;8804;2845;8627;417;1211;2108;6436;2525;7647
291995;201609;2110;5944;1780;5465;79;301;1493;4508;1572;4809
292000;201609;2481;6816;2154;6334;185;615;1575;4685;1760;5300
292010;201609;6563;16097;5011;13833;519;1308;3604;10275;4123;11583
292020;201609;4116;13833;3801;13277;513;1900;2761;9584;3274;11484
292030;201609;1988;6173;1721;5721;287;960;902;2948;1189;3908
292040;201609;4511;11856;3772;11036;213;424;3235;9946;3448;10370
292045;201609;3264;10123;2936;9661;117;354;2661;8783;2778;9137
292050;201609;6474;19457;5217;16803;523;1865;3338;10554;3861;12419
292060;201609;12973;31896;11772;30322;872;2012;9783;25123;10655;27135
292070;201609;4845;14620;4465;14131;510;1484;3582;11535;4092;13019
292080;201609;3632;9230;2925;8315;208;639;2442;6953;2650;7592
292090;201609;4072;10353;3374;9510;243;842;2781;7803;3024;8645
292100;201609;11518;30453;9526;27544;2189;6526;4741;14126;6930;20652
292105;201609;3112;9350;2723;8699;103;440;2210;7006;2313;7446
292110;201609;6555;17311;4860;14480;1456;4278;2068;6279;3524;10557
292120;201609;7591;21067;6162;18341;1148;3318;3409;10417;4557;13735
292130;201609;2918;7947;2453;7260;366;982;1584;4879;1950;5861
292140;201609;5077;13155;4089;11675;656;1706;2766;8099;3422;9805
292145;201609;2406;7279;2073;6694;244;756;1424;4748;1668;5504
292150;201609;12792;38321;11648;36431;411;1551;9734;30262;10145;31813
292160;201609;2529;7152;2134;6621;91;367;1870;5719;1961;6086
292170;201609;8932;25080;7165;21948;907;2967;4542;13875;5449;16842
292180;201609;3053;8712;2294;7348;464;1400;1211;4019;1675;5419
292190;201609;3341;9354;2695;8266;504;1638;1459;4459;1963;6097
292200;201609;6899;20839;5657;18552;1614;5581;2037;6716;3651;12297
292205;201609;3918;11621;3416;10818;166;679;2792;8617;2958;9296
292210;201609;6577;17046;5426;15480;260;865;4577;12973;4837;13838
292220;201609;1882;5093;1643;4704;409;1109;847;2434;1256;3543
292225;201609;3272;10005;2923;9446;159;664;2409;7694;2568;8358
292230;201609;6938;19299;6382;18365;258;1080;5175;14322;5433;15402
292240;201609;4840;14447;4127;12928;397;1231;2914;9058;3311;10289
292250;201609;5198;15829;4713;14903;1011;3267;2394;7657;3405;10924
292260;201609;3233;9347;2947;8932;193;556;2454;7493;2647;8049
292265;201609;3221;9605;2700;8681;117;512;2082;6510;2199;7022
292270;201609;4194;10411;3361;9429;177;549;2827;7953;3004;8502
292273;201609;2811;6372;2084;5448;160;359;1598;4345;1758;4704
292275;201609;1608;4373;1404;4067;157;421;1055;3148;1212;3569
292280;201609;2265;6132;1936;5729;191;469;1483;4654;1674;5123
292285;201609;2525;6713;2016;5948;98;333;1592;4662;1690;4995
292290;201609;7032;20893;5768;19121;355;1439;4453;14822;4808;16261
292300;201609;8438;24783;7142;23087;1991;6697;3587;11881;5578;18578
292303;201609;2938;8742;2593;8229;81;316;2230;7000;2311;7316
292305;201609;2931;7882;2733;7587;56;226;2489;6814;2545;7040
292310;201609;5940;17380;5395;16531;148;563;4464;13549;4612;14112
292320;201609;6848;18811;5642;16704;410;1250;4340;12766;4750;14016
292330;201609;2269;5899;2033;5561;155;480;1647;4456;1802;4936
292335;201609;5220;13564;4556;12623;368;972;3690;10332;4058;11304
292340;201609;6565;18037;5384;16024;351;1035;4053;11972;4404;13007
292350;201609;2360;6798;1995;6265;123;470;1618;5058;1741;5528
292360;201609;5350;13690;4922;12933;212;414;4088;11180;4300;11594
292370;201609;8622;24071;7468;22443;654;1597;5947;18243;6601;19840
292380;201609;7359;21458;6554;20098;706;1950;4930;15323;5636;17273
292390;201609;3616;7965;2879;7115;485;645;2221;6035;2706;6680
292400;201609;21048;63779;19122;60438;2897;9159;12695;40184;15592;49343
292405;201609;4635;11342;3659;10017;202;450;2943;8140;3145;8590
292410;201609;2030;5355;1828;5092;148;369;1527;4301;1675;4670
292420;201609;3800;12146;3547;11746;226;956;2859;9361;3085;10317
292430;201609;5605;16252;4064;13929;351;1300;2699;9223;3050;10523
292440;201609;8592;28046;7862;26947;166;712;7138;24618;7304;25330
292450;201609;4050;12020;3224;10560;313;1031;2249;7418;2562;8449
292460;201609;4971;14688;4149;13221;488;1640;2786;8861;3274;10501
292465;201609;2459;7226;1987;6407;187;647;1279;4172;1466;4819
292467;201609;1895;5994;1786;5822;322;1085;1148;3837;1470;4922
292470;201609;2978;7807;2381;6782;110;322;1884;5337;1994;5659
292480;201609;6428;16485;5300;14954;121;419;4813;13469;4934;13888
292490;201609;2437;6545;1947;5791;136;422;1471;4360;1607;4782
292500;201609;6668;19480;5549;17446;661;2092;3674;11661;4335;13753
292510;201609;12879;36495;10676;33017;829;2933;7999;24713;8828;27646
292520;201609;5708;16002;4802;14547;1017;3104;2667;8157;3684;11261
292525;201609;5441;13971;4585;12956;147;443;3920;11121;4067;11564
292530;201609;27548;77830;23430;71738;6066;18896;11131;35049;17197;53945
292540;201609;2999;7964;2604;7463;276;800;2025;5830;2301;6630
292550;201609;6699;20296;5620;18804;637;2261;4188;14225;4825;16486
292560;201609;4112;11318;3500;10367;188;708;2698;7824;2886;8532
292570;201609;4303;11904;3901;11465;69;166;3686;11034;3755;11200
292575;201609;6533;21088;6263;20652;411;1348;5302;17654;5713;19002
292580;201609;6808;20026;6262;19208;305;1007;5349;16367;5654;17374
292590;201609;7643;21704;7051;20795;380;1157;5995;17465;6375;18622
292593;201609;3080;7855;2487;6890;343;889;1706;4693;2049;5582
292595;201609;5906;16155;5120;15094;321;1003;4068;11996;4389;12999
292600;201609;10879;30467;9530;28581;845;2037;7405;22928;8250;24965
292610;201609;4769;13035;3770;11357;269;796;2397;7517;2666;8313
292620;201609;6312;18548;5469;17550;112;367;5093;16484;5205;16851
292630;201609;9421;23617;7590;20689;836;2143;5185;14453;6021;16596
292640;201609;7849;25103;7104;23832;384;1411;5455;18439;5839;19850
292650;201609;4768;12583;4425;12134;361;864;3686;10170;4047;11034
292660;201609;10993;32440;9923;30815;1065;3347;7410;23247;8475;26594
292665;201609;2380;7396;2227;7186;35;93;2055;6705;2090;6798
292670;201609;3792;10508;2837;8727;268;846;1774;5468;2042;6314
292680;201609;3747;10891;3254;9978;391;1112;2305;7069;2696;8181
292690;201609;2900;7775;2035;6360;168;488;1377;4442;1545;4930
292700;201609;9592;27961;8183;25812;1237;3499;5148;17202;6385;20701
292710;201609;2155;7019;2019;6837;60;226;1808;6138;1868;6364
292720;201609;9473;23809;8068;22193;294;940;6918;19265;7212;20205
292730;201609;3704;10897;3499;10554;212;641;2833;8558;3045;9199
292740;201609;337167;893379;307569;844968;56153;161156;185451;502074;241604;663230
292750;201609;6678;17717;5562;16053;271;854;4495;12983;4766;13837
292760;201609;4082;12471;3556;11479;391;1337;2438;7837;2829;9174
292770;201609;6123;17665;5230;16299;948;3093;3132;9991;4080;13084
292780;201609;1909;4347;1405;3682;118;302;1026;2674;1144;2976
292790;201609;3436;8192;3284;8032;59;96;3169;7828;3228;7924
292800;201609;9438;27264;8516;25670;525;1667;6793;20368;7318;22035
292805;201609;3118;8652;2663;7974;253;802;1995;5969;2248;6771
292810;201609;9679;28188;7611;25028;901;2995;5196;17361;6097;20356
292820;201609;7536;21087;5459;17955;340;1353;4285;13920;4625;15273
292830;201609;1765;5152;1564;4839;60;251;1349;4114;1409;4365
292840;201609;8276;24242;7702;23411;309;1105;6827;20485;7136;21590
292850;201609;3153;8317;2467;7199;274;810;1608;4594;1882;5404
292860;201609;15642;39490;14055;37310;1058;2854;11149;29429;12207;32283
292870;201609;19469;52864;16462;47821;1860;6014;9860;27925;11720;33939
292880;201609;12869;35792;11120;33148;840;2923;8129;23598;8969;26521
292890;201609;5575;18296;4888;17011;610;2232;3261;11384;3871;13616
292895;201609;2899;6902;2140;5710;239;616;1488;3977;1727;4593
292900;201609;2810;8532;2635;8238;147;653;2010;6013;2157;6666
292905;201609;4117;12024;3184;10460;344;1086;2147;7146;2491;8232
292910;201609;5065;14801;4446;13635;565;1779;2735;8368;3300;10147
292920;201609;9472;27228;8896;26347;449;1634;7490;21592;7939;23226
292925;201609;5238;15519;4645;14610;316;999;3650;11517;3966;12516
292930;201609;6571;20708;5967;19537;403;1736;4283;13580;4686;15316
292935;201609;2044;5914;1692;5511;76;247;1453;4894;1529;5141
292937;201609;3303;8283;2712;7528;168;471;2201;6139;2369;6610
292940;201609;3340;8910;2576;7822;234;719;1822;5691;2056;6410
292950;201609;8273;23884;7499;22484;443;1607;5670;16576;6113;18183
292960;201609;5380;13587;4537;12399;259;743;3459;9341;3718;10084
292970;201609;4371;12771;3747;11894;142;656;3105;9755;3247;10411
292975;201609;3658;9431;3350;9020;367;875;2782;7618;3149;8493
292980;201609;3352;8616;2539;7416;203;664;1868;5351;2071;6015
292990;201609;12156;33922;10216;30857;422;1343;8434;25344;8856;26687
293000;201609;2904;7338;2600;6957;50;161;2096;5947;2146;6108
293010;201609;18166;49847;14897;44240;2325;7050;8745;25786;11070;32836
293015;201609;7700;25780;6526;23385;721;2923;4316;15307;5037;18230
293020;201609;9210;30116;8570;29157;273;1217;7459;25193;7732;26410
293030;201609;5703;15998;4234;13554;420;1286;2839;9445;3259;10731
293040;201609;3851;12286;3631;11863;210;649;3167;10417;3377;11066
293050;201609;20976;56865;17869;52528;3341;9849;9478;29099;12819;38948
293060;201609;3666;9758;2953;8529;221;689;2184;6216;2405;6905
293070;201609;24922;66293;19432;57949;4614;13674;8728;27205;13342;40879
293075;201609;3298;11024;3000;10551;186;804;2391;8412;2577;9216
293076;201609;3789;10281;3331;9628;167;434;2769;8179;2936;8613
293077;201609;5054;15445;4366;14401;830;2823;2624;8850;3454;11673
293080;201609;4664;14511;4125;13595;175;849;3407;10976;3582;11825
293090;201609;3328;10436;2675;9388;230;822;1943;6945;2173;7767
293100;201609;5928;17153;4775;15069;509;1624;3401;10830;3910;12454
293105;201609;4062;13156;3470;11987;467;1625;2267;7940;2734;9565
293110;201609;2079;5782;1789;5347;74;231;1476;4433;1550;4664
293120;201609;3825;12319;3581;11911;266;864;2863;9623;3129;10487
293130;201609;4112;11419;3444;10648;141;514;3054;9495;3195;10009
293135;201609;30957;77922;22273;64762;4974;15684;8280;24100;13254;39784
293140;201609;1992;5510;1848;5276;124;444;1501;4139;1625;4583
293150;201609;5545;18015;4603;16101;675;2404;2864;10198;3539;12602
293160;201609;3857;9823;3381;9211;477;961;2534;7364;3011;8325
293170;201609;3455;9916;3078;9325;262;869;2226;6795;2488;7664
293180;201609;5406;14901;4217;12933;147;595;3341;10002;3488;10597
293190;201609;13901;41374;12515;39183;469;2064;10635;32617;11104;34681
293200;201609;7305;19841;6176;18277;177;648;4929;14628;5106;15276
293210;201609;5178;14571;4434;13263;296;922;3393;10090;3689;11012
293220;201609;5063;14786;4092;12939;1086;3393;1464;4767;2550;8160
293230;201609;3814;11407;3349;10637;442;1571;2273;7136;2715;8707
293240;201609;4433;12083;3447;10380;134;417;2601;7828;2735;8245
293245;201609;4351;12187;3811;11369;221;660;3056;9160;3277;9820
293250;201609;5758;15460;5048;14334;518;1510;3559;10005;4077;11515
293260;201609;4625;13463;3792;12186;251;832;2777;8924;3028;9756
293270;201609;5774;14895;5129;14160;334;824;4449;12444;4783;13268
293280;201609;5415;14705;4419;13248;259;691;3463;10531;3722;11222
293290;201609;14689;48227;13272;45382;3350;11651;5815;20486;9165;32137
293300;201609;7063;16416;5799;14868;392;925;4420;11532;4812;12457
293305;201609;4902;12062;4026;10825;130;396;3387;9049;3517;9445
293310;201609;2542;6552;1968;5536;206;579;1312;3642;1518;4221
293315;201609;4348;10904;3615;9757;347;796;2723;7510;3070;8306
293317;201609;2526;7126;2186;6473;167;481;1577;4659;1744;5140
293320;201609;7817;25321;7494;24866;1122;3690;5420;18330;6542;22020
293325;201609;1849;5202;1480;4592;188;651;976;2980;1164;3631
293330;201609;51222;163245;44870;151293;10055;35516;20517;69699;30572;105215
293340;201609;2684;7557;2048;6415;266;854;1179;3701;1445;4555
293345;201609;3380;9877;2890;9190;259;651;2222;7426;2481;8077
293350;201609;6608;19223;6180;18702;211;448;5626;17542;5837;17990
293360;201609;13424;39564;12026;37739;670;2382;10567;33083;11237;35465
310010;201609;925;2483;684;2077;107;388;309;858;416;1246
310020;201609;2900;8972;2264;7653;512;1881;305;944;817;2825
310030;201609;2367;7227;1893;6384;395;1462;1017;3359;1412;4821
310040;201609;994;2620;797;2328;63;219;615;1743;678;1962
310050;201609;1880;6323;1689;5898;332;1308;743;2498;1075;3806
310060;201609;3293;10014;2820;9373;259;1027;2235;7345;2494;8372
310070;201609;351;967;247;772;13;60;163;463;176;523
310080;201609;741;2181;581;1886;100;399;218;658;318;1057
310090;201609;4663;13651;3870;12232;470;1585;2539;7992;3009;9577
310100;201609;3511;10473;2877;9390;147;575;2274;7363;2421;7938
310110;201609;4877;13646;3976;12018;631;2120;2160;6263;2791;8383
310120;201609;642;1913;465;1555;129;533;170;440;299;973
310130;201609;402;1219;345;1116;90;352;171;480;261;832
310140;201609;210;690;164;610;54;241;45;133;99;374
310150;201609;4789;14447;3912;12653;949;3313;1292;4005;2241;7318
310160;201609;7203;22494;5579;19138;1743;6398;790;2576;2533;8974
310163;201609;1065;3381;859;2947;293;1051;220;714;513;1765
310170;201609;9242;25481;8036;23697;1006;3131;5561;16486;6567;19617
310180;201609;1719;4868;1432;4397;246;834;812;2395;1058;3229
310190;201609;2847;9287;2375;8330;657;2491;425;1443;1082;3934
310200;201609;1837;5929;1507;5224;304;1155;509;1734;813;2889
310205;201609;1133;3219;829;2721;126;405;454;1537;580;1942
310210;201609;2775;7826;2338;7141;190;572;1763;5359;1953;5931
310220;201609;1062;3151;922;2925;149;530;570;1754;719;2284
310230;201609;2579;7816;2083;6689;286;1079;1178;3551;1464;4630
310240;201609;914;3272;796;3006;110;461;451;1700;561;2161
310250;201609;815;2654;771;2566;136;553;459;1411;595;1964
310260;201609;3195;10038;2250;7938;573;2284;401;1210;974;3494
310270;201609;2602;7196;2041;6349;163;638;1594;4847;1757;5485
310280;201609;2363;6119;1826;5236;271;912;1020;2773;1291;3685
310285;201609;2033;7118;1846;6808;204;869;1358;5081;1562;5950
310290;201609;1144;3426;1049;3253;261;906;539;1510;800;2416
310300;201609;1716;5727;1591;5475;388;1516;774;2524;1162;4040
310310;201609;369;1002;252;776;35;98;121;388;156;486
310320;201609;398;1247;314;1083;40;195;162;520;202;715
310330;201609;526;1307;320;904;32;98;136;339;168;437
310340;201609;8433;24767;6631;21506;1499;4871;2967;10015;4466;14886
310350;201609;13828;36508;9447;28815;2454;8105;2357;6878;4811;14983
310360;201609;447;1293;404;1229;21;88;301;874;322;962
310370;201609;1419;4703;1228;4317;358;1266;529;1886;887;3152
310375;201609;1239;3363;755;2438;118;403;294;936;412;1339
310380;201609;386;997;212;671;65;215;70;197;135;412
310390;201609;455;1565;367;1359;77;297;74;239;151;536
310400;201609;10432;28411;7266;22780;1778;5975;1912;5878;3690;11853
310410;201609;748;2437;495;1956;101;423;97;378;198;801
310420;201609;5637;15660;3303;10564;640;2207;492;1327;1132;3534
310430;201609;1343;4302;952;3466;227;893;145;505;372;1398
310440;201609;571;1633;408;1320;72;260;159;506;231;766
310445;201609;1245;4030;1003;3546;127;482;659;2309;786;2791
310450;201609;4625;12757;3577;11137;349;1104;2489;7839;2838;8943
310460;201609;1603;4694;1248;4112;342;1206;314;1096;656;2302
310470;201609;4091;9150;3450;8373;262;574;2942;7254;3204;7828
310480;201609;1260;3619;909;2901;200;621;384;1169;584;1790
310490;201609;2990;9510;2397;8252;599;2380;945;3051;1544;5431
310500;201609;1325;4413;1123;3948;257;979;438;1483;695;2462
310510;201609;2076;6456;1521;5183;378;1374;246;830;624;2204
310520;201609;1436;3652;1042;3018;79;226;726;2078;805;2304
310530;201609;997;2975;469;1634;64;252;63;184;127;436
310540;201609;3115;9899;2676;9021;713;2481;1091;3612;1804;6093
310550;201609;1208;3339;937;2892;161;606;521;1498;682;2104
310560;201609;15717;47128;12557;40707;3400;12060;3621;10815;7021;22875
310570;201609;1176;3442;978;3092;144;567;657;1994;801;2561
310590;201609;4384;12647;3431;10763;542;1808;1657;5068;2199;6876
310600;201609;1432;4661;1231;4204;263;1009;519;1665;782;2674
310610;201609;473;1582;401;1415;90;388;122;370;212;758
310620;201609;146078;441724;119709;388294;28136;100724;44183;131080;72319;231804
310630;201609;4275;12719;3771;11784;327;1145;2800;8608;3127;9753
310640;201609;1291;3908;989;3330;287;1075;254;782;541;1857
310650;201609;2684;8313;2042;7125;338;1220;1118;3884;1456;5104
310660;201609;1347;4056;1176;3824;118;402;854;2749;972;3151
310665;201609;1288;3775;1127;3539;81;262;915;2942;996;3204
310670;201609;41308;125329;35280;112204;8841;29474;13160;40477;22001;69951
310680;201609;691;1930;596;1778;83;273;411;1196;494;1469
310690;201609;1438;4541;1122;3958;220;915;432;1412;652;2327
310700;201609;545;1324;414;1151;67;217;260;698;327;915
310710;201609;6376;20394;4549;17010;883;3837;569;1883;1452;5720
310720;201609;808;2377;710;2213;67;247;516;1579;583;1826
310730;201609;9428;28851;8159;26585;1361;4788;4730;15230;6091;20018
310740;201609;5120;16078;3748;13112;902;3329;832;2740;1734;6069
310750;201609;1491;3695;1044;3046;203;611;474;1289;677;1900
310760;201609;601;1778;478;1551;84;296;187;594;271;890
310770;201609;922;2880;688;2473;145;582;287;961;432;1543
310780;201609;3822;10344;3088;9032;417;1228;2038;5887;2455;7115
310790;201609;1979;6295;1727;5782;478;1643;724;2515;1202;4158
310800;201609;2846;8873;2039;7198;595;2396;147;450;742;2846
310810;201609;1168;3262;1005;2943;164;556;571;1562;735;2118
310820;201609;1322;3753;865;2817;207;716;209;657;416;1373
310825;201609;2567;8482;1971;7400;116;641;1443;5279;1559;5920
310830;201609;1376;4393;1053;3730;288;1080;346;1175;634;2255
310840;201609;2150;6458;1547;5282;326;1189;409;1285;735;2474
310850;201609;1541;4503;1290;4165;133;481;936;3009;1069;3490
310855;201609;3007;9238;2518;8451;391;1426;1640;5494;2031;6920
310860;201609;7477;22697;6061;19991;747;2567;3597;11998;4344;14565
310870;201609;1068;2851;825;2448;136;422;485;1439;621;1861
310880;201609;1075;3297;817;2768;139;517;424;1415;563;1932
310890;201609;2654;7930;1916;6589;469;1777;392;1170;861;2947
310900;201609;4202;13082;3110;10683;689;2637;1109;3501;1798;6138
310910;201609;1926;5401;1125;3739;201;756;147;391;348;1147
310920;201609;1897;5484;1446;4736;314;1143;654;2089;968;3232
310925;201609;944;3004;821;2779;290;1055;316;1030;606;2085
310930;201609;6243;17317;4788;15052;726;2446;2897;9248;3623;11694
310940;201609;6220;17145;5012;15212;742;2347;2996;8940;3738;11287
310945;201609;1171;3390;1005;3119;142;488;599;1796;741;2284
310950;201609;2135;6634;1462;5131;348;1435;496;1603;844;3038
310960;201609;406;1282;327;1128;88;329;129;455;217;784
310970;201609;1450;4728;984;3616;232;938;146;452;378;1390
310980;201609;442;1066;262;756;36;120;132;338;168;458
310990;201609;1188;3791;910;3142;200;756;289;895;489;1651
311000;201609;3555;11927;3120;11027;981;3717;951;3125;1932;6842
311010;201609;736;2454;664;2307;229;852;277;963;506;1815
311020;201609;959;2755;702;2290;117;440;362;1104;479;1544
311030;201609;1690;4565;1083;3412;290;1047;340;938;630;1985
311040;201609;463;1541;382;1342;83;290;91;300;174;590
311050;201609;2297;6937;1904;6282;473;1731;844;2733;1317;4464
311060;201609;2531;7348;1737;5603;323;1176;581;1713;904;2889
311070;201609;1420;4807;1196;4349;253;1037;497;1768;750;2805
311080;201609;820;2509;674;2212;147;531;262;802;409;1333
311090;201609;1625;5968;1354;5363;442;1889;389;1450;831;3339
311100;201609;2089;6919;1583;5786;524;2066;197;691;721;2757
311110;201609;3530;8417;2457;6858;437;1296;1209;3359;1646;4655
311115;201609;1246;3566;1022;3222;91;371;696;2144;787;2515
311120;201609;7968;22152;5719;17909;1270;4403;1611;4579;2881;8982
311130;201609;2118;6393;1650;5609;312;1266;691;2200;1003;3466
311140;201609;1360;3547;997;3011;80;274;663;1989;743;2263
311150;201609;1758;6033;1585;5723;261;1036;980;3520;1241;4556
311160;201609;4030;13338;3170;11690;1094;4388;716;2605;1810;6993
311170;201609;804;2399;608;2015;82;284;285;978;367;1262
311180;201609;1158;3338;865;2755;260;869;204;619;464;1488
311190;201609;1110;3109;784;2452;176;622;209;599;385;1221
311200;201609;1995;6019;1502;4973;407;1464;257;759;664;2223
311205;201609;1018;3318;836;2922;127;520;390;1351;517;1871
311210;201609;997;3157;907;3028;144;479;640;2195;784;2674
311220;201609;867;2680;678;2267;154;557;234;745;388;1302
311230;201609;8362;26227;6100;21270;1320;4865;2009;7177;3329;12042
311240;201609;1051;3142;788;2678;209;781;260;856;469;1637
311250;201609;800;2563;695;2390;216;803;206;633;422;1436
311260;201609;2420;6376;1722;5166;394;1286;614;1795;1008;3081
311265;201609;1254;3493;972;3015;174;586;529;1649;703;2235
311270;201609;3428;10728;2953;10008;266;1279;2086;6763;2352;8042
311280;201609;1290;3568;749;2395;153;565;187;574;340;1139
311290;201609;2012;6595;1826;6145;356;1195;1065;3615;1421;4810
311300;201609;4446;14458;3871;13394;376;1611;2803;9505;3179;11116
311310;201609;587;1923;472;1669;108;377;133;414;241;791
311320;201609;3828;12608;3299;11382;612;2351;1216;3929;1828;6280
311330;201609;4657;13731;3832;12218;992;3456;1637;5140;2629;8596
311340;201609;12084;37404;10065;33286;3016;10610;2411;7804;5427;18414
311350;201609;2331;6449;1686;5153;257;903;781;2134;1038;3037
311360;201609;1116;3077;849;2711;390;1290;121;408;511;1698
311370;201609;3747;11116;2959;9601;646;2449;1157;3329;1803;5778
311380;201609;440;1456;352;1241;96;375;111;378;207;753
311390;201609;1798;6401;1592;6071;670;2896;401;1359;1071;4255
311400;201609;1500;4656;1155;3951;211;841;477;1463;688;2304
311410;201609;1814;6101;1598;5797;426;1721;763;2795;1189;4516
311420;201609;1903;6118;1189;4294;225;888;134;360;359;1248
311430;201609;3873;11486;2530;8464;492;1759;345;1094;837;2853
311440;201609;2469;7768;1700;6266;543;2270;276;985;819;3255
311450;201609;1953;6692;1559;5762;432;1769;298;997;730;2766
311455;201609;1136;3024;864;2548;211;651;363;970;574;1621
311460;201609;636;2028;460;1645;92;383;104;327;196;710
311470;201609;480;1589;365;1326;101;428;66;199;167;627
311480;201609;802;2109;737;2016;161;429;470;1285;631;1714
311490;201609;225;830;194;737;56;237;71;240;127;477
311500;201609;449;1293;344;1095;78;295;150;456;228;751
311510;201609;3045;9185;2225;7583;687;2707;470;1475;1157;4182
311520;201609;614;1973;550;1828;180;662;217;680;397;1342
311530;201609;11711;29841;7916;23417;1981;6801;1907;5323;3888;12124
311535;201609;811;2321;471;1620;119;465;83;248;202;713
311540;201609;621;2118;560;2000;182;635;241;859;423;1494
311545;201609;2131;6393;1865;6055;160;589;1363;4355;1523;4944
311547;201609;1510;4172;1223;3690;75;229;845;2539;920;2768
311550;201609;2933;9144;2281;7741;409;1563;850;2774;1259;4337
311560;201609;267;699;217;631;27;77;127;350;154;427
311570;201609;2018;5113;1519;4410;91;275;1197;3568;1288;3843
311580;201609;2471;4899;1759;4042;428;890;980;2418;1408;3308
311590;201609;470;1428;384;1276;93;353;165;535;258;888
311600;201609;1235;3710;1021;3404;202;659;615;2106;817;2765
311610;201609;2895;10002;2489;9195;803;2860;954;3740;1757;6600
311615;201609;3175;9679;2557;8633;228;905;1829;6086;2057;6991
311620;201609;423;1275;361;1167;60;221;222;699;282;920
311630;201609;1382;3981;1098;3455;212;655;662;2062;874;2717
311640;201609;766;2444;610;2164;129;485;287;1006;416;1491
311650;201609;2276;6390;1869;5700;211;698;1135;3453;1346;4151
311660;201609;2631;8315;1793;6424;348;1271;202;621;550;1892
311670;201609;1693;4794;1286;4095;392;1352;419;1296;811;2648
311680;201609;2100;6497;1704;5788;367;1297;913;3104;1280;4401
311690;201609;508;1258;420;1150;31;91;348;959;379;1050
311700;201609;2291;5927;1744;5152;106;341;1369;3975;1475;4316
311710;201609;1670;5034;1171;4038;423;1627;281;912;704;2539
311720;201609;401;1317;337;1173;87;318;126;423;213;741
311730;201609;6012;14857;3140;9689;965;3383;611;1451;1576;4834
311740;201609;813;2434;771;2378;161;485;549;1719;710;2204
311750;201609;4091;13013;3397;11785;573;2257;1855;6211;2428;8468
311760;201609;717;2378;599;2068;134;508;144;408;278;916
311770;201609;2259;7087;1800;6153;421;1590;540;1738;961;3328
311780;201609;1196;4147;934;3520;260;1118;212;703;472;1821
311783;201609;2003;6382;1614;5591;70;341;1248;4230;1318;4571
311787;201609;597;2010;419;1482;79;305;110;324;189;629
311790;201609;1557;4561;1117;3691;261;998;372;1166;633;2164
311800;201609;4752;15710;3639;12743;816;3123;436;1353;1252;4476
311810;201609;1062;3424;881;3049;71;335;568;1902;639;2237
311820;201609;637;1931;510;1634;124;450;258;759;382;1209
311830;201609;8452;27627;6353;22460;1868;7093;695;2254;2563;9347
311840;201609;2997;8917;2641;8354;647;2276;1335;4114;1982;6390
311850;201609;282;872;237;784;39;139;132;426;171;565
311860;201609;50506;146344;41239;129197;7769;26319;21062;63443;28831;89762
311870;201609;2143;6212;1472;4817;280;1032;475;1421;755;2453
311880;201609;6850;19326;5916;18081;661;1864;4286;13565;4947;15429
311890;201609;1488;4348;1153;3696;257;894;515;1601;772;2495
311900;201609;748;2222;610;1981;81;299;349;1129;430;1428
311910;201609;4359;12455;3431;11028;795;2678;1425;4531;2220;7209
311920;201609;1907;6175;1623;5631;180;679;1001;3448;1181;4127
311930;201609;3569;10008;2888;8842;1170;3683;690;2069;1860;5752
311940;201609;12689;37512;9438;30526;2175;7464;2544;7650;4719;15114
311950;201609;2233;6466;1751;5684;153;589;1233;3904;1386;4493
311960;201609;392;1199;334;1068;64;255;153;401;217;656
311970;201609;367;1232;277;1020;52;216;65;225;117;441
311980;201609;601;1676;381;1252;64;223;134;446;198;669
311990;201609;452;1290;350;1114;116;400;124;372;240;772
311995;201609;1191;3608;630;2180;40;153;64;153;104;306
312000;201609;610;1816;538;1704;59;201;346;1105;405;1306
312010;201609;894;2861;712;2438;113;428;282;926;395;1354
312015;201609;1390;4406;1213;4063;137;524;794;2615;931;3139
312020;201609;1101;3452;946;3186;208;730;424;1420;632;2150
312030;201609;1846;5224;1630;4943;104;384;1383;4133;1487;4517
312040;201609;754;2681;579;2211;123;506;134;487;257;993
312050;201609;1231;4283;1022;3764;242;977;156;506;398;1483
312060;201609;760;2279;638;2081;180;623;293;917;473;1540
312070;201609;1048;3188;654;2299;141;547;248;828;389;1375
312080;201609;2693;7347;2071;6306;277;1017;1156;3248;1433;4265
312083;201609;923;2572;778;2359;78;261;579;1731;657;1992
312087;201609;2184;6465;1916;6046;198;686;1445;4594;1643;5280
312090;201609;9070;27475;7315;24196;2057;7091;2705;8747;4762;15838
312100;201609;1451;4630;1045;3867;234;986;437;1506;671;2492
312110;201609;1052;3637;883;3237;251;1051;170;543;421;1594
312120;201609;730;2356;594;2067;132;546;216;652;348;1198
312125;201609;1121;3555;971;3265;209;677;550;1941;759;2618
312130;201609;883;2469;632;1941;85;290;254;731;339;1021
312140;201609;817;2586;667;2202;166;593;187;538;353;1131
312150;201609;491;1426;414;1261;35;129;255;722;290;851
312160;201609;7515;24892;6374;22356;1529;5835;2391;8087;3920;13922
312170;201609;916;2598;748;2296;68;215;472;1430;540;1645
312180;201609;1371;4163;1130;3644;231;817;479;1429;710;2246
312190;201609;600;1909;425;1533;143;561;62;223;205;784
312200;201609;4796;13575;3883;11998;707;2164;2194;6823;2901;8987
312210;201609;1116;2941;819;2472;180;622;429;1203;609;1825
312220;201609;1933;6438;1759;6227;177;531;1469;5440;1646;5971
312230;201609;12652;38452;9247;31559;2981;11148;1144;3644;4125;14792
312235;201609;1586;4682;1374;4364;144;536;983;3087;1127;3623
312240;201609;929;3088;722;2633;174;694;175;608;349;1302
312245;201609;2201;6430;1924;6043;87;305;1589;4955;1676;5260
312247;201609;801;2353;597;1994;169;591;244;828;413;1419
312250;201609;1187;3231;860;2662;144;514;351;1004;495;1518
312260;201609;899;2809;717;2486;115;454;438;1453;553;1907
312270;201609;647;1905;488;1567;59;241;260;751;319;992
312280;201609;415;1372;364;1260;129;471;44;144;173;615
312290;201609;787;2574;694;2395;169;676;230;770;399;1446
312300;201609;888;2923;658;2342;169;654;61;160;230;814
312310;201609;867;3193;782;2991;201;859;317;1167;518;2026
312320;201609;2025;5711;1471;4605;401;1368;306;826;707;2194
312330;201609;996;2884;801;2588;137;518;560;1773;697;2291
312340;201609;316;849;257;746;39;138;156;403;195;541
312350;201609;291;735;254;692;25;87;208;540;233;627
312352;201609;1645;5115;1461;4833;282;980;947;3223;1229;4203
312360;201609;3103;9780;2425;8323;550;2025;695;2366;1245;4391
312370;201609;1718;5261;1493;4868;438;1626;561;1690;999;3316
312380;201609;1930;5235;1691;4902;62;174;1444;4283;1506;4457
312385;201609;1331;3845;1114;3483;90;358;805;2437;895;2795
312390;201609;2092;6650;1540;5458;401;1488;305;975;706;2463
312400;201609;3172;10011;2508;8591;964;3409;536;1877;1500;5286
312410;201609;10111;32564;8627;29494;1850;6672;3712;12409;5562;19081
312420;201609;3903;11886;3616;11459;570;1770;2427;7833;2997;9603
312430;201609;8106;23435;6717;20883;896;2743;4403;13768;5299;16511
312440;201609;777;2417;617;2113;237;881;194;698;431;1579
312450;201609;1120;3658;832;3041;264;1006;262;977;526;1983
312460;201609;357;1068;309;1005;70;263;160;520;230;783
312470;201609;661;1788;398;1261;76;282;122;350;198;632
312480;201609;1215;3134;892;2760;176;624;506;1465;682;2089
312490;201609;2017;5243;1497;4403;200;650;874;2440;1074;3090
312500;201609;700;2074;584;1884;108;386;229;709;337;1095
312510;201609;3554;10301;2702;8453;404;1414;1382;4041;1786;5455
312520;201609;265;863;206;754;62;232;61;236;123;468
312530;201609;618;1779;521;1620;58;230;346;1037;404;1267
312540;201609;1428;4437;1032;3596;224;831;460;1595;684;2426
312550;201609;689;2059;569;1779;99;321;277;813;376;1134
312560;201609;2087;5441;1686;4905;71;273;1409;4030;1480;4303
312570;201609;2392;6986;1939;6164;527;1784;639;2020;1166;3804
312580;201609;527;1710;421;1467;53;209;169;568;222;777
312590;201609;1684;5492;1379;4814;308;1202;570;1849;878;3051
312595;201609;1946;6456;1717;5914;335;1167;919;3210;1254;4377
312600;201609;806;2568;601;2149;96;427;289;959;385;1386
312610;201609;7095;19779;4830;15354;1149;3929;990;2958;2139;6887
312620;201609;2195;6264;1633;5440;116;432;1231;4191;1347;4623
312630;201609;334;1058;271;935;76;298;90;287;166;585
312640;201609;543;1727;420;1465;84;297;128;414;212;711
312650;201609;2165;6199;1501;4844;173;642;874;2717;1047;3359
312660;201609;1424;3704;1113;3234;106;356;771;2183;877;2539
312670;201609;5580;16282;4579;14803;1267;4483;1577;4937;2844;9420
312675;201609;1285;4044;1052;3534;143;535;682;2251;825;2786
312680;201609;1471;4418;1236;4086;174;692;763;2404;937;3096
312690;201609;2170;5689;1698;4973;263;825;1091;3074;1354;3899
312695;201609;826;2862;772;2778;147;492;510;1915;657;2407
312700;201609;1893;5660;1393;4579;172;623;740;2362;912;2985
312705;201609;1268;3592;996;3078;73;258;722;2161;795;2419
312707;201609;1542;4830;1149;4025;148;614;603;2019;751;2633
312710;201609;6941;17339;4223;12784;1262;4191;826;2379;2088;6570
312720;201609;759;2549;643;2304;147;591;245;825;392;1416
312730;201609;1892;4446;1283;3689;143;470;784;2234;927;2704
312733;201609;1627;4301;1153;3419;53;162;752;2158;805;2320
312735;201609;825;2222;707;2054;156;522;398;1077;554;1599
312737;201609;848;2100;581;1702;177;512;202;599;379;1111
312738;201609;518;1587;352;1231;81;321;121;383;202;704
312740;201609;347;807;191;617;51;172;43;132;94;304
312750;201609;1268;4453;1170;4272;226;983;576;2005;802;2988
312760;201609;1982;6285;1440;5099;338;1284;361;1256;699;2540
312770;201609;42344;113997;29897;91854;7588;24694;8125;23822;15713;48516
312780;201609;2690;9132;2339;8493;375;1525;1290;4721;1665;6246
312790;201609;328;830;184;570;28;104;64;156;92;260
312800;201609;5008;16086;3846;13571;1157;4399;859;2988;2016;7387
312810;201609;2082;6310;1385;4865;333;1267;261;830;594;2097
312820;201609;1923;5413;1588;4793;75;259;1137;3316;1212;3575
312825;201609;1340;3608;1146;3346;83;262;893;2605;976;2867
312830;201609;2511;7667;1598;5720;420;1579;274;943;694;2522
312840;201609;1232;3891;949;3311;138;540;331;1035;469;1575
312850;201609;707;2185;512;1766;98;391;152;495;250;886
312860;201609;1178;3461;831;2766;230;859;252;752;482;1611
312870;201609;5669;17326;3664;12873;685;2577;779;2596;1464;5173
312880;201609;1302;3792;1119;3495;125;424;725;2298;850;2722
312890;201609;1699;5079;980;3393;221;795;362;1259;583;2054
312900;201609;1224;3554;1036;3281;124;420;734;2366;858;2786
312910;201609;1686;3347;909;2275;160;438;437;994;597;1432
312920;201609;882;2776;702;2419;162;638;278;885;440;1523
312930;201609;2171;6145;1814;5565;440;1375;802;2458;1242;3833
312940;201609;911;2921;750;2610;193;752;203;651;396;1403
312950;201609;3117;8679;2289;7373;829;2812;477;1529;1306;4341
312960;201609;1959;5546;1649;5102;172;500;1283;4077;1455;4577
312965;201609;1803;5625;1492;5015;162;619;921;3087;1083;3706
312970;201609;1016;3348;816;2983;218;888;211;753;429;1641
312980;201609;17636;58031;15896;54061;4633;17050;5967;19354;10600;36404
312990;201609;479;1391;323;1108;95;373;103;352;198;725
313000;201609;500;1625;391;1399;90;426;156;467;246;893
313005;201609;2615;8255;2261;7571;413;1347;1313;4451;1726;5798
313010;201609;3726;11776;3070;10569;793;2951;1356;4524;2149;7475
313020;201609;967;3164;682;2387;134;528;126;348;260;876
313030;201609;1502;3967;1038;3254;210;778;491;1485;701;2263
313040;201609;834;2717;695;2370;94;394;303;947;397;1341
313050;201609;1819;5585;1295;4720;287;1169;327;1065;614;2234
313055;201609;1639;5052;1477;4816;64;226;1231;4048;1295;4274
313060;201609;751;2379;555;1898;150;527;63;195;213;722
313065;201609;1927;6153;1598;5571;262;988;1045;3643;1307;4631
313070;201609;1043;3002;809;2574;169;603;361;1091;530;1694
313080;201609;455;1389;320;1096;67;266;91;256;158;522
313090;201609;5241;15010;4440;13657;1082;3552;2205;6751;3287;10303
313100;201609;1132;3386;1008;3179;81;255;804;2568;885;2823
313110;201609;1767;4974;1240;3897;184;654;562;1636;746;2290
313115;201609;2468;8189;2239;7683;501;1910;1005;3224;1506;5134
313120;201609;3579;9329;2928;8429;683;2192;1607;4501;2290;6693
313130;201609;26026;77650;21403;67803;4449;15313;8869;26332;13318;41645
313140;201609;580;1484;434;1260;28;95;310;880;338;975
313150;201609;1397;4340;1097;3735;478;1716;203;688;681;2404
313160;201609;953;2885;801;2569;135;496;418;1264;553;1760
313170;201609;9195;30393;6387;23272;1344;5109;1558;5386;2902;10495
313180;201609;2400;6416;1832;5559;388;1299;745;2142;1133;3441
313190;201609;3616;11994;2696;9632;581;2217;717;2382;1298;4599
313200;201609;1151;3669;981;3339;97;358;696;2338;793;2696
313210;201609;4224;12894;3424;11582;735;2619;1572;5134;2307;7753
313220;201609;1529;4495;1038;3419;237;863;240;649;477;1512
313230;201609;2305;8068;2107;7774;315;1247;1449;5301;1764;6548
313240;201609;8318;24932;6126;20638;1141;4332;2468;7831;3609;12163
313250;201609;6910;21381;5588;18892;705;2445;3159;10548;3864;12993
313260;201609;632;1860;416;1384;63;237;112;354;175;591
313270;201609;5434;16027;4353;14059;784;2709;2335;7439;3119;10148
313280;201609;383;1242;268;981;52;210;62;207;114;417
313290;201609;821;2879;643;2530;237;1039;90;306;327;1345
313300;201609;1820;5955;1406;4936;397;1508;179;522;576;2030
313310;201609;1061;3631;890;3236;202;830;175;548;377;1378
313320;201609;2353;6677;1655;5492;315;1131;683;2255;998;3386
313330;201609;4029;12219;3270;10816;337;1375;2003;6368;2340;7743
313340;201609;1921;4709;1445;3971;271;739;792;2179;1063;2918
313350;201609;2891;8896;2113;7097;443;1618;441;1348;884;2966
313360;201609;1325;3746;938;3064;215;855;494;1473;709;2328
313370;201609;1173;3936;1058;3620;159;642;558;1775;717;2417
313375;201609;2375;6095;1522;4744;288;1080;515;1501;803;2581
313380;201609;5069;15523;4057;13351;1080;3870;1321;4012;2401;7882
313390;201609;879;2955;814;2838;88;357;537;1818;625;2175
313400;201609;3718;9974;3166;9297;316;854;2602;7844;2918;8698
313410;201609;1236;3485;1010;3124;225;759;570;1716;795;2475
313420;201609;18850;44593;10331;29698;2100;6659;1640;4562;3740;11221
313430;201609;1041;3237;760;2617;145;578;278;877;423;1455
313440;201609;6482;14395;4177;11461;236;589;2937;8167;3173;8756
313450;201609;629;1859;483;1548;101;371;148;435;249;806
313460;201609;2159;7242;1825;6614;467;1945;623;2030;1090;3975
313470;201609;3115;8445;2660;7741;368;1100;1817;5211;2185;6311
313480;201609;1034;2907;716;2313;113;410;249;737;362;1147
313490;201609;1529;4403;814;3172;241;1033;77;277;318;1310
313500;201609;412;1347;310;1071;51;192;101;331;152;523
313505;201609;9181;26425;8446;25578;299;600;7837;24237;8136;24837
313507;201609;1388;3767;1167;3444;98;312;791;2343;889;2655
313510;201609;15380;43718;12866;39505;1848;5868;7217;22071;9065;27939
313520;201609;14317;43522;11659;38520;1239;4545;7554;24699;8793;29244
313530;201609;612;1844;481;1582;36;131;190;604;226;735
313535;201609;2545;7403;2218;6783;183;577;1633;4927;1816;5504
313540;201609;1067;3313;745;2468;201;725;183;550;384;1275
313545;201609;1291;4655;1134;4329;182;805;637;2304;819;3109
313550;201609;1823;5786;1555;5240;370;1261;735;2438;1105;3699
313560;201609;2227;5091;1795;4586;215;514;1347;3532;1562;4046
313570;201609;882;3027;745;2753;224;890;245;869;469;1759
313580;201609;5727;16303;4392;14236;775;2663;2400;7857;3175;10520
313590;201609;978;2734;727;2357;336;1186;139;403;475;1589
313600;201609;3857;11431;3263;10442;353;1249;2280;7255;2633;8504
313610;201609;1017;2959;851;2628;200;646;427;1297;627;1943
313620;201609;5516;16775;4594;15003;1246;4262;1626;5226;2872;9488
313630;201609;8333;22798;6045;19425;959;3487;3006;10079;3965;13566
313640;201609;779;2268;564;1921;176;654;155;517;331;1171
313650;201609;1913;6252;1656;5814;252;1015;1060;3622;1312;4637
313652;201609;932;3237;846;3068;147;602;495;1728;642;2330
313655;201609;936;2951;764;2652;100;407;466;1585;566;1992
313657;201609;1346;3898;1067;3446;92;391;793;2397;885;2788
313660;201609;836;2731;710;2480;145;580;342;1117;487;1697
313665;201609;3813;12104;3138;10609;615;2301;1468;4740;2083;7041
313670;201609;46039;132872;31882;104220;7485;26507;9954;31298;17439;57805
313680;201609;1074;3124;906;2835;110;421;580;1742;690;2163
313690;201609;861;3080;739;2779;159;607;287;1105;446;1712
313695;201609;1375;4396;1160;3987;114;448;806;2763;920;3211
313700;201609;3486;11814;3019;11184;460;1728;2153;8155;2613;9883
313710;201609;1354;3583;973;2954;181;592;518;1526;699;2118
313720;201609;5470;17159;4047;13859;765;2862;1402;4381;2167;7243
313730;201609;1297;3363;937;2867;136;463;559;1686;695;2149
313740;201609;2046;7326;1632;6226;431;1833;106;339;537;2172
313750;201609;2233;6727;1787;5786;472;1598;515;1508;987;3106
313753;201609;1908;5349;1419;4461;252;883;669;2046;921;2929
313760;201609;4078;12969;3172;11017;880;3249;885;2876;1765;6125
313770;201609;3407;10699;2843;9795;876;3185;1162;3984;2038;7169
313780;201609;4016;10931;2815;8873;443;1589;1151;3541;1594;5130
313790;201609;490;1666;458;1603;94;338;261;931;355;1269
313800;201609;1280;3353;1062;3012;95;308;746;2142;841;2450
313810;201609;1562;4442;1354;4117;128;395;1014;3135;1142;3530
313820;201609;13049;34590;9952;29298;1744;5781;4337;12073;6081;17854
313830;201609;426;1389;355;1244;89;356;133;462;222;818
313835;201609;900;2969;816;2825;116;467;457;1508;573;1975
313840;201609;7559;21513;5598;18028;1377;4801;1304;4001;2681;8802
313850;201609;1172;3152;990;2811;178;606;525;1337;703;1943
313860;201609;2770;8271;1962;6428;423;1459;543;1680;966;3139
313862;201609;1267;3170;847;2460;105;300;472;1435;577;1735
313865;201609;2282;6907;2031;6517;161;595;1556;4956;1717;5551
313867;201609;1128;3808;944;3385;285;1087;288;1050;573;2137
313868;201609;1650;5445;1359;4807;115;521;940;3217;1055;3738
313870;201609;798;2478;693;2271;194;698;197;566;391;1264
313880;201609;1422;4377;1177;3908;298;1102;452;1309;750;2411
313890;201609;1890;4985;1485;4405;289;840;888;2806;1177;3646
313900;201609;3988;14163;3415;12811;1050;4344;891;3253;1941;7597
313910;201609;735;2449;589;2137;209;815;69;230;278;1045
313920;201609;3291;10866;2770;9848;497;1819;1505;5514;2002;7333
313925;201609;1881;5054;1338;4012;82;258;883;2648;965;2906
313930;201609;6702;24598;5562;22486;703;2529;3607;15760;4310;18289
313940;201609;8636;28149;6700;24722;1937;7885;1900;7286;3837;15171
313950;201609;4161;11673;3018;9711;931;3396;961;2801;1892;6197
313960;201609;5549;14175;3768;11406;1024;3341;1041;2917;2065;6258
313970;201609;1455;4180;1224;3858;139;490;755;2466;894;2956
313980;201609;1275;3867;931;3244;216;837;391;1353;607;2190
313990;201609;1787;6532;1461;5705;468;1999;299;1006;767;3005
314000;201609;8270;25767;7180;23469;1128;4344;4201;13091;5329;17435
314010;201609;1185;3230;944;2887;74;259;645;1902;719;2161
314015;201609;1421;4699;1120;4134;256;1041;454;1601;710;2642
314020;201609;508;1501;306;1038;78;286;74;232;152;518
314030;201609;847;2725;626;2192;90;348;250;848;340;1196
314040;201609;711;2033;554;1726;232;753;158;482;390;1235
314050;201609;1726;5287;1323;4447;278;1086;512;1579;790;2665
314053;201609;1605;4969;1367;4615;211;721;860;3035;1071;3756
314055;201609;2202;6458;1882;5966;71;279;1521;4845;1592;5124
314060;201609;1171;3560;905;3082;57;245;607;2015;664;2260
314070;201609;4212;12964;3131;10659;829;2905;704;2245;1533;5150
314080;201609;1789;5586;1099;3862;190;720;242;717;432;1437
314085;201609;1977;6526;1672;6036;447;1725;602;2155;1049;3880
314090;201609;3317;11298;2806;10223;706;2867;891;3303;1597;6170
314100;201609;3380;8422;2918;7814;166;357;2502;6928;2668;7285
314110;201609;4063;12782;3395;11268;663;2408;1394;4229;2057;6637
314120;201609;1059;2520;479;1540;104;360;116;363;220;723
314130;201609;705;2007;311;1083;47;173;63;197;110;370
314140;201609;4942;15090;3882;12864;829;2934;1745;5725;2574;8659
314150;201609;1586;4284;1217;3627;156;492;648;1905;804;2397
314160;201609;2615;6631;1878;5478;193;619;1144;3452;1337;4071
314170;201609;1096;3231;864;2714;102;340;487;1468;589;1808
314180;201609;5275;16492;4546;15198;1297;4549;1792;6075;3089;10624
314190;201609;727;2045;533;1713;133;508;192;538;325;1046
314200;201609;2973;9098;2525;8252;258;994;1768;5627;2026;6621
314210;201609;2021;5779;1743;5288;219;762;1076;3167;1295;3929
314220;201609;1592;4907;1148;3978;339;1266;220;654;559;1920
314225;201609;1344;3847;1184;3609;94;301;913;2802;1007;3103
314230;201609;671;2123;608;2010;103;395;334;1077;437;1472
314240;201609;1122;3375;886;2964;162;563;469;1635;631;2198
314250;201609;554;1635;397;1291;90;317;112;317;202;634
314260;201609;1036;3644;890;3284;207;861;267;914;474;1775
314270;201609;2881;9260;2338;8247;230;917;1546;5426;1776;6343
314280;201609;3229;8753;2060;6441;490;1754;695;1910;1185;3664
314290;201609;4846;13243;4014;11814;871;2620;2195;6383;3066;9003
314300;201609;1517;4995;1209;4269;361;1321;314;1066;675;2387
314310;201609;5595;16297;4449;14087;1169;3906;1656;4979;2825;8885
314315;201609;820;3176;729;2991;77;375;494;1998;571;2373
314320;201609;3010;8384;2082;7016;505;1815;986;3439;1491;5254
314330;201609;55060;164066;44779;145808;12892;44479;13316;42243;26208;86722
314340;201609;2976;7987;1480;4926;322;1171;130;270;452;1441
314345;201609;1232;4106;1093;3871;236;877;653;2291;889;3168
314350;201609;1291;3700;939;3052;282;970;145;407;427;1377
314360;201609;675;2145;413;1501;84;356;88;326;172;682
314370;201609;559;1838;514;1767;110;433;344;1147;454;1580
314380;201609;1324;3961;864;3003;238;913;118;399;356;1312
314390;201609;13751;39297;9652;31303;2321;8024;2279;6752;4600;14776
314400;201609;4540;13176;3671;11878;1268;4269;1144;3822;2412;8091
314410;201609;2678;8214;1961;6719;548;2082;605;2066;1153;4148
314420;201609;760;2121;573;1820;29;151;403;1212;432;1363
314430;201609;6467;19042;5262;16624;1477;5013;1577;4918;3054;9931
314435;201609;1337;4255;1149;3917;101;432;772;2589;873;3021
314437;201609;1095;2809;872;2448;33;101;695;1932;728;2033
314440;201609;645;1879;485;1624;163;616;98;275;261;891
314450;201609;1629;4675;1309;4157;265;1004;644;1879;909;2883
314460;201609;4119;13671;3155;11478;747;2976;563;1904;1310;4880
314465;201609;2287;7117;2097;6759;100;451;1669;5236;1769;5687
314467;201609;1016;2870;829;2538;54;159;616;1901;670;2060
314470;201609;2341;7242;1870;6222;403;1519;666;2006;1069;3525
314480;201609;6025;19756;3865;13891;651;2505;477;1455;1128;3960
314490;201609;905;2663;674;2181;148;523;305;922;453;1445
314500;201609;2002;5593;1356;4335;305;1038;462;1389;767;2427
314505;201609;1814;5200;1637;4944;203;678;1138;3464;1341;4142
314510;201609;1910;5154;1239;4168;393;1433;295;980;688;2413
314520;201609;3024;10757;2148;8572;458;2027;228;791;686;2818
314530;201609;5975;20827;5507;19910;1026;3528;3292;12383;4318;15911
314535;201609;2768;7615;2266;6865;239;783;1635;4910;1874;5693
314537;201609;1148;3560;892;3077;110;462;543;1811;653;2273
314540;201609;415;1226;306;987;57;198;102;306;159;504
314545;201609;1439;4270;1235;3978;95;333;959;3144;1054;3477
314550;201609;627;1706;434;1401;83;352;172;484;255;836
314560;201609;4409;14995;3535;12789;632;2531;1101;3761;1733;6292
314570;201609;304;891;219;706;57;205;99;297;156;502
314580;201609;530;1732;375;1380;92;394;49;160;141;554
314585;201609;843;2706;592;2148;128;532;158;532;286;1064
314587;201609;2000;6006;1652;5379;349;1084;807;2700;1156;3784
314590;201609;3234;10852;2207;8072;442;1792;363;1207;805;2999
314600;201609;1598;5182;1039;3903;242;987;146;448;388;1435
314610;201609;7077;23685;6124;21387;1333;5175;2546;8290;3879;13465
314620;201609;1636;4813;1434;4509;130;418;1086;3396;1216;3814
314625;201609;1479;4875;1307;4559;168;759;879;2901;1047;3660
314630;201609;4877;14304;4085;12969;275;1130;2984;9254;3259;10384
314640;201609;594;1598;438;1315;114;370;122;299;236;669
314650;201609;1095;3011;725;2331;91;329;282;809;373;1138
314655;201609;1570;4621;1099;3665;294;946;406;1363;700;2309
314660;201609;296;789;200;596;20;60;95;267;115;327
314670;201609;1678;4412;1124;3393;159;509;671;1952;830;2461
314675;201609;1792;5329;1517;4824;145;530;1066;3341;1211;3871
314690;201609;2350;7429;1822;6407;515;2023;375;1247;890;3270
314700;201609;9205;30500;6132;23252;1716;7116;867;3139;2583;10255
314710;201609;7940;23651;4921;16781;833;3143;685;2110;1518;5253
314720;201609;2448;7913;1846;6529;454;1777;496;1741;950;3518
314730;201609;2283;6751;1765;5854;480;1748;630;1946;1110;3694
314740;201609;2904;9174;2431;8213;408;1567;1148;3713;1556;5280
314750;201609;350;1076;263;872;44;154;107;335;151;489
314760;201609;1716;5566;1167;4174;225;918;228;637;453;1555
314770;201609;1068;3306;516;1771;65;246;100;267;165;513
314780;201609;288;766;210;655;51;197;98;280;149;477
314790;201609;11271;33338;7670;26198;2966;11117;657;1742;3623;12859
314795;201609;1686;4799;1411;4352;96;377;1038;3073;1134;3450
314800;201609;11397;32619;7183;23741;1989;6993;768;2316;2757;9309
314810;201609;11819;33855;8563;27765;2498;8782;1691;5408;4189;14190
314820;201609;951;2602;634;2044;156;557;249;775;405;1332
314830;201609;1647;5383;1398;4914;392;1530;589;2068;981;3598
314840;201609;952;3327;755;3008;132;646;433;1649;565;2295
314850;201609;1970;5537;1537;4757;180;709;1056;3131;1236;3840
314860;201609;3302;10755;2809;9770;553;2209;1488;4990;2041;7199
314870;201609;5625;17205;4693;15840;434;1828;3406;11331;3840;13159
314875;201609;1796;5710;1685;5546;194;622;1384;4616;1578;5238
314880;201609;904;2399;715;2132;43;99;539;1706;582;1805
314890;201609;612;1813;407;1350;69;268;153;460;222;728
314900;201609;551;1616;431;1415;83;279;200;644;283;923
314910;201609;1715;5504;1350;4872;399;1615;437;1475;836;3090
314915;201609;2526;7868;2130;7147;162;647;1530;4998;1692;5645
314920;201609;562;1540;380;1242;27;96;211;641;238;737
314930;201609;4757;15788;3960;13906;1052;3970;1037;3418;2089;7388
314940;201609;402;1154;354;1066;57;192;210;591;267;783
314950;201609;338;977;234;807;43;164;68;220;111;384
314960;201609;755;2297;561;1890;136;499;169;516;305;1015
314970;201609;565;1925;461;1707;106;434;131;499;237;933
314980;201609;1500;4593;1187;4023;337;1276;87;259;424;1535
314990;201609;2617;8157;1861;6407;513;2018;368;1055;881;3073
314995;201609;1646;4957;1387;4528;135;538;942;3002;1077;3540
315000;201609;1075;3019;841;2612;80;285;550;1685;630;1970
315010;201609;440;1334;323;1080;68;296;120;339;188;635
315015;201609;2165;6487;1920;6191;251;831;1393;4704;1644;5535
315020;201609;827;2539;563;1933;99;353;223;712;322;1065
315030;201609;692;2048;524;1728;144;503;107;331;251;834
315040;201609;912;2765;841;2634;142;459;527;1631;669;2090
315050;201609;1390;3959;1068;3416;190;699;503;1573;693;2272
315053;201609;1071;3167;898;2819;147;563;447;1384;594;1947
315057;201609;1719;5754;1456;5274;327;1195;720;2620;1047;3815
315060;201609;832;2678;562;2049;115;456;77;271;192;727
315070;201609;758;2241;606;1963;166;566;263;802;429;1368
315080;201609;2891;9450;2417;8371;632;2365;1027;3475;1659;5840
315090;201609;799;2773;607;2304;156;658;138;486;294;1144
315100;201609;1188;3931;821;3039;178;758;211;701;389;1459
315110;201609;1428;4256;1148;3709;266;931;428;1348;694;2279
315120;201609;14533;33667;9313;26454;1495;4248;4640;13896;6135;18144
315130;201609;1411;4620;1225;4222;309;1190;393;1295;702;2485
315140;201609;2823;8774;2194;7436;471;1831;783;2384;1254;4215
315150;201609;4706;12655;3349;10228;633;2133;1308;3931;1941;6064
315160;201609;1298;3739;999;3148;212;694;421;1285;633;1979
315170;201609;1544;4653;1139;3823;254;915;258;905;512;1820
315180;201609;17277;48099;8711;29210;1605;5915;1578;4739;3183;10654
315190;201609;2056;5305;1676;4708;401;1177;926;2572;1327;3749
315200;201609;3902;12957;3083;11129;1003;3921;583;2042;1586;5963
315210;201609;7936;23133;5971;18842;1160;4011;2268;6785;3428;10796
315213;201609;1107;3384;985;3170;39;142;810;2583;849;2725
315217;201609;2468;8334;1961;7354;214;963;1183;4320;1397;5283
315220;201609;9868;27831;7894;24528;2685;8427;2528;8025;5213;16452
315230;201609;2944;7775;2557;7304;148;202;2252;6810;2400;7012
315240;201609;3069;9287;2518;8359;726;2549;1105;3546;1831;6095
315250;201609;10523;31625;7654;25845;1839;6749;2436;8031;4275;14780
315260;201609;1032;3186;638;2248;131;486;91;279;222;765
315270;201609;727;2327;535;1927;108;430;119;383;227;813
315280;201609;3120;8880;1807;5956;396;1357;276;824;672;2181
315290;201609;1373;3781;936;3049;287;1021;191;620;478;1641
315300;201609;534;1374;334;1107;139;473;125;422;264;895
315310;201609;1268;3992;983;3408;150;613;614;2018;764;2631
315320;201609;788;2340;612;2086;102;413;290;976;392;1389
315330;201609;733;2645;418;1749;102;463;53;208;155;671
315340;201609;3601;10149;2751;8701;595;2012;1081;3272;1676;5284
315350;201609;1912;5148;1367;4319;211;709;844;2690;1055;3399
315360;201609;1717;5636;1334;4699;250;970;451;1481;701;2451
315370;201609;508;1566;417;1395;82;288;208;708;290;996
315380;201609;210;706;155;571;38;171;37;105;75;276
315390;201609;1353;4412;915;3357;207;831;169;578;376;1409
315400;201609;4309;12879;3358;10932;671;2355;1516;4808;2187;7163
315410;201609;2161;5521;1752;4937;159;538;1256;3519;1415;4057
315415;201609;1057;3402;899;3142;357;1314;291;1009;648;2323
315420;201609;1248;3955;894;3179;215;782;120;391;335;1173
315430;201609;3706;9968;2598;8050;744;2523;576;1640;1320;4163
315440;201609;959;2890;803;2605;172;656;357;1043;529;1699
315445;201609;2114;5800;1572;4936;200;675;1048;3262;1248;3937
315450;201609;2453;7573;2132;7044;379;1149;1296;4426;1675;5575
315460;201609;33214;107085;28164;96046;9824;35408;5059;16239;14883;51647
315470;201609;474;1413;366;1195;42;169;198;625;240;794
315480;201609;1764;5310;1088;3752;223;819;210;728;433;1547
315490;201609;3146;8305;2210;6873;380;1320;851;2484;1231;3804
315500;201609;486;1415;291;945;43;156;125;347;168;503
315510;201609;1412;3987;1173;3596;103;341;838;2509;941;2850
315520;201609;1029;3079;807;2668;122;437;493;1571;615;2008
315530;201609;648;2160;509;1788;183;690;142;449;325;1139
315540;201609;1076;3351;854;2913;172;693;290;967;462;1660
315550;201609;1772;4959;1285;4149;309;1092;410;1260;719;2352
315560;201609;6529;21525;5765;20359;524;2113;3930;13930;4454;16043
315570;201609;1969;6166;1744;5731;280;1031;949;3032;1229;4063
315580;201609;2536;7307;1896;6110;484;1755;521;1556;1005;3311
315590;201609;872;2534;753;2331;108;378;417;1259;525;1637
315600;201609;2485;8659;1928;7520;390;1530;946;3871;1336;5401
315610;201609;1009;2831;779;2352;135;517;324;824;459;1341
315620;201609;315;1103;291;1056;90;301;151;586;241;887
315630;201609;933;2932;716;2457;163;574;155;500;318;1074
315640;201609;484;1390;369;1185;75;290;163;476;238;766
315645;201609;887;2622;691;2197;251;845;168;500;419;1345
315650;201609;1850;5029;1425;4407;94;386;1051;3188;1145;3574
315660;201609;2590;6610;2011;5637;264;720;1363;3778;1627;4498
315670;201609;10960;35593;9386;32362;2519;9272;3483;11643;6002;20915
315680;201609;3044;9995;2257;8298;709;2756;549;1996;1258;4752
315690;201609;3396;9527;2141;7141;559;1995;398;1386;957;3381
315700;201609;7375;22662;5948;19700;1060;3842;2776;8747;3836;12589
315710;201609;1824;5150;1356;4352;107;443;870;2669;977;3112
315720;201609;3677;11566;3040;10253;335;1374;1876;5933;2211;7307
315725;201609;1524;4743;1344;4463;227;801;925;3097;1152;3898
315727;201609;603;1845;469;1558;100;369;166;505;266;874
315730;201609;797;2465;709;2260;101;368;386;1190;487;1558
315733;201609;1020;3021;853;2700;264;908;282;825;546;1733
315737;201609;1268;3820;939;3191;66;285;622;2113;688;2398
315740;201609;1018;3047;813;2626;147;564;415;1229;562;1793
315750;201609;1138;3469;1000;3208;61;235;721;2299;782;2534
315760;201609;1036;2727;999;2681;13;47;932;2479;945;2526
315765;201609;1531;4663;1339;4394;61;236;1097;3640;1158;3876
315770;201609;1457;4600;1193;4070;323;1208;291;985;614;2193
315780;201609;22883;73677;19855;66788;4648;16678;6841;22294;11489;38972
315790;201609;3675;12009;3120;10858;518;1762;1889;6738;2407;8500
315800;201609;1446;5556;1055;4346;236;1030;160;616;396;1646
315810;201609;1386;3688;1133;3274;190;565;696;1937;886;2502
315820;201609;2463;8190;2087;7474;672;2478;804;2983;1476;5461
315830;201609;1213;3957;960;3402;115;499;325;1014;440;1513
315840;201609;843;2185;514;1560;97;333;147;403;244;736
315850;201609;1010;3538;966;3444;242;959;511;1717;753;2676
315860;201609;525;1762;360;1381;83;374;72;242;155;616
315870;201609;468;1352;376;1203;67;240;185;555;252;795
315880;201609;1214;3091;924;2705;203;717;337;910;540;1627
315890;201609;1511;5078;1301;4693;484;1856;500;1772;984;3628
315895;201609;5440;16866;4425;14474;932;3260;1560;4815;2492;8075
315900;201609;762;2240;718;2161;61;266;573;1600;634;1866
315910;201609;525;1739;480;1660;138;534;268;879;406;1413
315920;201609;1616;4407;833;2702;174;612;163;444;337;1056
315930;201609;1095;2899;758;2287;191;602;200;582;391;1184
315935;201609;952;3134;815;2834;226;875;200;655;426;1530
315940;201609;622;1961;523;1752;107;400;244;793;351;1193
315950;201609;1216;3656;1053;3336;237;714;617;2005;854;2719
315960;201609;3590;11242;2226;8315;767;3265;98;209;865;3474
315970;201609;752;2040;547;1740;44;117;381;1254;425;1371
315980;201609;4063;9882;2379;6964;679;2201;540;1337;1219;3538
315990;201609;4023;11409;3150;9817;544;1974;1541;4596;2085;6570
316000;201609;584;1717;463;1526;131;533;169;509;300;1042
316010;201609;637;2054;489;1752;54;231;235;758;289;989
316020;201609;1051;3284;900;3024;117;448;593;1937;710;2385
316030;201609;3187;9248;2251;7508;204;792;1389;4643;1593;5435
316040;201609;3443;10831;2391;8449;388;1537;485;1445;873;2982
316045;201609;2049;6295;1838;5918;251;792;1269;4181;1520;4973
316050;201609;353;1114;277;983;57;241;128;410;185;651
316060;201609;744;2209;572;1935;70;324;333;1024;403;1348
316070;201609;6204;19179;5141;16807;1139;4122;2121;6564;3260;10686
316080;201609;749;2701;627;2382;132;561;75;277;207;838
316090;201609;543;1636;350;1202;58;233;117;366;175;599
316095;201609;1459;4574;1220;4144;181;609;750;2555;931;3164
316100;201609;2807;9099;1930;6916;488;1907;401;1293;889;3200
316105;201609;942;2660;674;2175;171;575;243;792;414;1367
316110;201609;12338;41173;10694;38235;1426;5240;6847;25125;8273;30365
316120;201609;1145;3642;858;2925;219;783;218;644;437;1427
316130;201609;1534;3461;814;2329;132;425;357;943;489;1368
316140;201609;981;2803;736;2406;107;354;444;1465;551;1819
316150;201609;1553;4143;1313;3718;190;635;780;2149;970;2784
316160;201609;1257;3644;906;2928;173;608;392;1216;565;1824
316165;201609;949;2520;759;2231;144;493;409;1173;553;1666
316170;201609;1373;3858;958;3101;159;558;404;1193;563;1751
316180;201609;1432;4418;925;3236;209;802;176;531;385;1333
316190;201609;2871;8809;1361;4839;282;967;235;732;517;1699
316200;201609;3881;12178;2765;9790;605;2410;661;2203;1266;4613
316210;201609;4779;15196;3824;13129;1348;4829;529;1801;1877;6630
316220;201609;789;2422;513;1827;100;399;57;209;157;608
316225;201609;1220;3334;968;2899;159;539;579;1651;738;2190
316230;201609;427;1217;339;1059;47;162;172;577;219;739
316240;201609;6677;20119;5755;18847;654;2086;4165;13815;4819;15901
316245;201609;3265;11134;2939;10553;204;1063;2275;7869;2479;8932
316250;201609;10802;30908;7779;24680;2077;7063;1809;5363;3886;12426
316255;201609;2633;7762;2243;7256;328;1173;1529;4977;1857;6150
316257;201609;1376;3740;974;2983;187;628;332;947;519;1575
316260;201609;1818;5042;1332;4261;155;535;708;2337;863;2872
316265;201609;1336;3746;943;2960;95;338;572;1748;667;2086
316270;201609;3980;13119;3518;12047;904;3343;1377;4543;2281;7886
316280;201609;3218;10283;2811;9445;437;1626;1571;5116;2008;6742
316290;201609;3486;10699;2790;9255;517;1969;1149;3668;1666;5637
316292;201609;3630;11291;3130;10418;513;1925;1882;6002;2395;7927
316294;201609;898;2813;603;2169;123;518;47;162;170;680
316295;201609;1857;6072;1689;5727;196;826;1149;3725;1345;4551
316300;201609;1016;3114;833;2782;65;235;528;1779;593;2014
316310;201609;718;2041;444;1513;88;346;143;447;231;793
316320;201609;622;1940;468;1638;88;356;93;284;181;640
316330;201609;988;2986;753;2449;78;284;499;1569;577;1853
316340;201609;948;3013;739;2564;151;619;355;1141;506;1760
316350;201609;1319;4127;1129;3780;183;643;648;2156;831;2799
316360;201609;747;1978;577;1724;100;297;372;1125;472;1422
316370;201609;4654;14719;3719;12727;1074;3994;586;1878;1660;5872
316380;201609;1647;4263;1238;3667;71;232;914;2689;985;2921
316390;201609;904;2568;707;2220;166;564;296;949;462;1513
316400;201609;1309;3962;950;3263;210;778;363;1203;573;1981
316410;201609;1081;3554;983;3403;166;600;649;2250;815;2850
316420;201609;1956;6174;1699;5806;138;571;1229;4086;1367;4657
316430;201609;961;2902;651;2237;157;587;143;444;300;1031
316440;201609;673;2197;525;1938;188;793;99;363;287;1156
316443;201609;700;2042;532;1713;111;408;214;635;325;1043
316447;201609;1593;4660;1427;4437;101;326;1196;3736;1297;4062
316450;201609;2182;7219;1768;6345;210;846;1202;4288;1412;5134
316460;201609;755;2320;673;2167;191;643;315;988;506;1631
316470;201609;7392;23364;5588;19482;1506;5915;1458;4805;2964;10720
316480;201609;182;611;148;531;35;130;37;124;72;254
316490;201609;308;948;244;795;44;123;87;265;131;388
316500;201609;1160;4033;698;2658;137;569;35;121;172;690
316510;201609;753;2746;652;2523;232;946;158;601;390;1547
316520;201609;1080;3237;846;2837;145;533;294;891;439;1424
316530;201609;1044;3296;806;2802;171;721;291;841;462;1562
316540;201609;746;2387;634;2153;89;376;229;719;318;1095
316550;201609;1200;3969;1101;3779;207;807;656;2247;863;3054
316553;201609;1988;6865;1496;5621;420;1735;318;1116;738;2851
316555;201609;2837;9619;2481;9137;192;763;1876;7044;2068;7807
316556;201609;650;1628;466;1308;46;143;320;861;366;1004
316557;201609;783;2791;726;2683;284;1111;181;603;465;1714
316560;201609;323;1135;269;1014;63;283;59;209;122;492
316570;201609;1260;3994;1053;3554;130;452;538;1831;668;2283
316580;201609;306;840;185;584;43;143;44;130;87;273
316590;201609;1476;3955;992;3087;212;704;480;1379;692;2083
316600;201609;1059;3413;910;3089;247;900;353;1169;600;2069
316610;201609;582;2089;498;1906;92;430;306;1115;398;1545
316620;201609;2184;6555;1794;5840;237;916;1152;3666;1389;4582
316630;201609;1435;4744;1182;4169;495;1816;285;1025;780;2841
316640;201609;177;553;145;474;31;133;66;183;97;316
316650;201609;910;3271;784;3045;100;382;516;2070;616;2452
316660;201609;197;506;85;261;7;27;19;44;26;71
316670;201609;1942;5364;1455;4464;568;1861;368;1025;936;2886
316680;201609;1996;5355;1535;4649;147;466;1112;3352;1259;3818
316690;201609;1163;3913;1000;3540;288;1142;279;958;567;2100
316695;201609;1092;3403;920;3047;100;361;587;1927;687;2288
316700;201609;369;1085;324;1001;29;127;220;622;249;749
316710;201609;2941;10893;2431;9700;919;3829;526;2235;1445;6064
316720;201609;16913;53547;12938;44525;3384;12127;3267;10815;6651;22942
316730;201609;370;1128;309;1002;80;290;126;375;206;665
316740;201609;670;2221;592;2086;86;357;382;1332;468;1689
316750;201609;406;1365;324;1170;53;227;112;374;165;601
316760;201609;3560;11678;2985;10799;1551;5837;852;3104;2403;8941
316770;201609;1353;3691;1179;3449;72;290;990;2856;1062;3146
316780;201609;596;1954;481;1710;137;553;65;181;202;734
316790;201609;861;2441;614;1996;144;490;191;626;335;1116
316800;201609;5162;16745;4432;15233;833;3170;2233;7199;3066;10369
316805;201609;804;2029;761;1974;49;131;662;1771;711;1902
316810;201609;615;1857;484;1583;125;446;190;563;315;1009
316820;201609;397;1030;206;681;35;138;30;87;65;225
316830;201609;576;1969;540;1894;159;606;223;756;382;1362
316840;201609;2840;8597;2421;7771;506;1881;1093;3309;1599;5190
316850;201609;2086;5966;1651;5213;242;854;938;2899;1180;3753
316860;201609;18064;56328;14832;50007;3401;13014;5915;18882;9316;31896
316870;201609;6232;19877;4733;16294;1368;5099;837;2742;2205;7841
316880;201609;867;2613;722;2354;213;804;217;675;430;1479
316890;201609;1283;3075;924;2555;257;824;490;1234;747;2058
316900;201609;2591;7620;1927;6209;458;1603;562;1612;1020;3215
316905;201609;466;1533;393;1365;134;494;123;426;257;920
316910;201609;861;2648;580;2053;151;584;78;244;229;828
316920;201609;1611;4312;1074;3478;288;1049;374;1135;662;2184
316930;201609;8271;27660;6172;22816;1353;5404;818;2769;2171;8173
316935;201609;5031;14590;3181;10792;865;3146;664;2163;1529;5309
316940;201609;6953;22324;5143;18090;1176;4270;1071;3544;2247;7814
316950;201609;1587;4284;1280;3835;105;367;953;2795;1058;3162
316960;201609;4830;12120;3714;10508;689;2085;2070;5746;2759;7831
316970;201609;3266;10259;2953;9625;667;2475;1173;3496;1840;5971
316980;201609;956;2893;649;2269;203;793;100;327;303;1120
316990;201609;9809;30616;7412;25065;2214;7914;544;1674;2758;9588
317000;201609;2822;9456;2685;9302;279;867;2036;7850;2315;8717
317005;201609;2588;7938;2214;7273;443;1459;1232;4077;1675;5536
317010;201609;30781;75948;17378;53857;4327;14788;3332;10804;7659;25592
317020;201609;65210;175761;34513;111512;7000;24346;6998;20520;13998;44866
317030;201609;723;2094;576;1843;55;224;356;1117;411;1341
317040;201609;10542;30151;7996;25391;2040;6799;2998;9465;5038;16264
317043;201609;717;1913;582;1703;101;276;340;997;441;1273
317047;201609;1145;3002;804;2417;83;263;451;1342;534;1605
317050;201609;1542;5170;1126;4127;242;926;400;1351;642;2277
317052;201609;2302;7394;2080;7016;154;608;1530;5070;1684;5678
317057;201609;1700;4709;1235;3856;111;442;743;2229;854;2671
317060;201609;429;1219;252;817;60;220;60;160;120;380
317065;201609;1298;4036;1130;3726;97;402;820;2630;917;3032
317070;201609;9803;30084;6162;21622;1344;5182;822;2720;2166;7902
317075;201609;1097;3290;815;2648;186;627;189;584;375;1211
317080;201609;6256;16866;5017;14656;1532;4560;1485;4213;3017;8773
317090;201609;4872;15923;4440;15187;540;1784;3086;10737;3626;12521
317100;201609;3079;8284;2137;6617;694;2306;656;1925;1350;4231
317103;201609;1984;6685;1612;5894;220;1033;820;2867;1040;3900
317107;201609;1336;4056;1137;3638;147;575;739;2202;886;2777
317110;201609;686;1709;362;1151;57;211;140;458;197;669
317115;201609;1147;3536;942;3107;99;331;670;2216;769;2547
317120;201609;10658;35109;8315;29397;1852;7144;3171;10791;5023;17935
317130;201609;7582;22219;5966;19146;1353;4712;2325;7323;3678;12035
317140;201609;571;1810;503;1684;67;243;333;1122;400;1365
317150;201609;967;2646;826;2472;87;308;618;1792;705;2100
317160;201609;3523;9158;2511;7679;176;580;1779;5336;1955;5916
317170;201609;1929;5130;1402;4202;193;665;560;1473;753;2138
317180;201609;1800;5992;1380;5036;352;1343;329;1173;681;2516
317190;201609;1402;3903;1053;3369;90;306;721;2262;811;2568
317200;201609;4565;14109;3717;12273;944;3389;1101;3455;2045;6844
317210;201609;1034;3054;849;2783;122;512;509;1609;631;2121
317220;201609;291;987;272;957;70;260;141;481;211;741
320010;201609;5032;15614;4165;13747;810;2807;2112;6828;2922;9635
320013;201609;1900;5739;1243;4254;228;808;507;1763;735;2571
320016;201609;3128;8704;2593;7869;294;839;1876;5717;2170;6556
320020;201609;3877;12031;3131;10421;901;3195;961;3174;1862;6369
320030;201609;1683;5297;1206;4204;381;1389;338;1116;719;2505
320035;201609;1812;5309;1498;4791;521;1807;499;1480;1020;3287
320040;201609;3163;10122;2482;8628;566;2088;851;2904;1417;4992
320050;201609;1755;4723;1444;4127;313;965;637;1719;950;2684
320060;201609;11915;37312;8415;29032;1979;7312;1869;6014;3848;13326
320070;201609;1462;4612;1116;3833;248;908;287;892;535;1800
320080;201609;5737;16400;4123;13061;958;3079;1240;4001;2198;7080
320090;201609;8197;23673;6142;19375;1668;5537;2185;6549;3853;12086
320100;201609;2812;8608;2120;7159;635;2186;647;2174;1282;4360
320110;201609;1308;3868;1078;3394;272;846;304;987;576;1833
320115;201609;1778;6286;1578;5897;851;3306;343;1322;1194;4628
320120;201609;16749;49986;12229;40934;3098;11179;3345;11046;6443;22225
320130;201609;36616;116464;31903;106543;6568;24283;14855;47623;21423;71906
320140;201609;3765;11786;2489;8782;664;2527;326;1116;990;3643
320150;201609;15811;43639;10559;33047;2869;9528;1201;3437;4070;12965
320160;201609;4983;15533;4090;13609;1065;3879;1373;4205;2438;8084
320170;201609;1727;5464;1345;4592;336;1199;495;1662;831;2861
320180;201609;763;2535;651;2312;258;946;139;515;397;1461
320190;201609;3685;12587;2750;10169;747;2870;472;1708;1219;4578
320200;201609;1037;3148;818;2748;231;841;237;831;468;1672
320210;201609;4811;13397;3834;11392;830;2728;1758;4841;2588;7569
320220;201609;2430;7482;1920;6436;510;1836;708;2389;1218;4225
320225;201609;1365;4586;1013;3712;373;1460;112;401;485;1861
320230;201609;4333;13704;3523;12219;1109;4065;1273;4451;2382;8516
320240;201609;12741;37165;9590;31169;2518;8690;2659;8550;5177;17240
320245;201609;3407;11555;3039;10623;1027;3777;712;2394;1739;6171
320250;201609;1933;5829;1270;4267;328;1241;216;616;544;1857
320255;201609;1796;5956;1506;5425;644;2474;466;1754;1110;4228
320260;201609;1076;3261;752;2501;203;716;197;575;400;1291
320265;201609;2455;7742;2063;7069;607;2179;945;3297;1552;5476
320270;201609;2735;7982;1925;6344;453;1613;817;2685;1270;4298
320280;201609;6885;20739;5701;18215;1361;4750;1851;5416;3212;10166
320290;201609;1419;4613;933;3364;306;1146;127;474;433;1620
320300;201609;4271;14148;3641;12684;1170;4306;736;2499;1906;6805
320305;201609;4565;14547;3726;12583;917;3349;1438;4643;2355;7992
320310;201609;1975;5803;1581;4975;401;1317;578;1758;979;3075
320313;201609;2256;6443;1383;4430;340;1232;234;649;574;1881
320316;201609;1745;5226;1351;4368;415;1401;395;1246;810;2647
320320;201609;20749;62009;15428;51651;4188;15145;4975;16129;9163;31274
320330;201609;3012;8887;2407;7772;738;2350;914;3124;1652;5474
320332;201609;5387;17371;4553;15727;1579;5785;1478;5013;3057;10798
320334;201609;1937;6037;1216;4398;333;1321;243;825;576;2146
320335;201609;2368;6952;1384;4591;363;1300;142;380;505;1680
320340;201609;5976;15949;4811;13976;1072;3328;2085;6132;3157;9460
320350;201609;5236;13733;3675;10770;766;2285;1602;4615;2368;6900
320360;201609;1744;4588;1208;3526;206;618;455;1248;661;1866
320370;201609;3023;9808;2335;8175;659;2372;674;2332;1333;4704
320380;201609;2233;6541;1894;5896;408;1375;1006;3027;1414;4402
320390;201609;7423;22132;5789;18564;1649;5632;1586;4830;3235;10462
320400;201609;3578;10889;2998;9762;759;2695;1245;3862;2004;6557
320405;201609;4258;12335;3607;11184;790;2587;1878;5685;2668;8272
320410;201609;5583;14723;3934;12362;948;3160;1778;5562;2726;8722
320420;201609;2325;6962;1739;5850;526;1958;426;1382;952;3340
320425;201609;2037;5307;1549;4441;187;566;979;2743;1166;3309
320430;201609;2510;6971;2080;6077;416;1266;1114;3144;1530;4410
320435;201609;2819;9052;2215;7767;1059;3856;527;1911;1586;5767
320440;201609;1071;3511;898;3062;227;868;296;944;523;1812
320450;201609;2025;6318;1580;5384;429;1585;634;2081;1063;3666
320455;201609;4257;13828;2904;10436;840;3216;603;2060;1443;5276
320460;201609;2734;8647;1916;6697;489;1828;431;1393;920;3221
320465;201609;1625;4998;1172;3963;199;711;555;1862;754;2573
320470;201609;4530;13480;2884;9688;842;3081;477;1448;1319;4529
320480;201609;1793;5542;1465;4838;382;1360;536;1704;918;3064
320490;201609;16385;49604;13064;43115;3788;13649;3837;12387;7625;26036
320495;201609;1366;3910;806;2710;264;934;88;306;352;1240
320500;201609;48915;145777;41038;130747;9373;31961;19277;59621;28650;91582
320501;201609;4431;13710;3540;12192;1177;4448;954;3102;2131;7550
320503;201609;1878;6355;1420;5316;592;2385;363;1185;955;3570
320506;201609;4017;12309;2551;8684;752;2690;58;149;810;2839
320510;201609;8620;26619;7145;23619;1617;5744;3389;10894;5006;16638
320515;201609;1918;5494;1469;4470;404;1268;272;774;676;2042
320517;201609;2200;7013;1679;5878;540;2035;372;1271;912;3306
320520;201609;38102;112890;29636;96379;7651;27121;10247;32396;17898;59517
320530;201609;27870;83363;22130;71835;4270;15828;10738;32468;15008;48296
330010;201609;20664;62454;18026;57172;3998;13497;9326;28981;13324;42478
330015;201609;1675;4635;1381;4068;228;784;636;1804;864;2588
330020;201609;17955;52122;15962;48611;2968;9842;9270;27354;12238;37196
330022;201609;1918;5604;1560;4982;296;1080;829;2539;1125;3619
330023;201609;3264;10022;2763;9109;786;2780;823;2591;1609;5371
330025;201609;4614;12366;3492;10406;814;2607;1805;5267;2619;7874
330030;201609;8278;27173;7025;24526;1456;5501;3262;10805;4718;16306
330040;201609;12536;36682;10777;33277;2375;7818;5534;16503;7909;24321
330045;201609;73648;199326;61741;181167;8123;25279;41639;119653;49762;144932
330050;201609;2586;7858;2117;6933;614;2211;665;1983;1279;4194
330060;201609;5860;16661;4872;15068;1196;4086;2383;7186;3579;11272
330070;201609;21635;65000;18759;59808;4152;14122;8582;27099;12734;41221
330080;201609;8015;22606;7233;21285;763;2243;5048;14832;5811;17075
330090;201609;2718;7256;2355;6649;416;1274;1279;3494;1695;4768
330093;201609;2101;6136;1670;5329;336;1087;737;2467;1073;3554
330095;201609;1042;3505;873;3114;206;840;279;918;485;1758
330100;201609;57814;180487;51326;169001;8347;30614;28871;94026;37218;124640
330110;201609;2393;7452;2035;6754;513;1790;622;2002;1135;3792
330115;201609;1945;5562;1657;5087;310;1061;871;2557;1181;3618
330120;201609;2672;7269;2304;6689;422;1378;1334;3726;1756;5104
330130;201609;3649;11647;3143;10699;789;2869;1398;4634;2187;7503
330140;201609;3141;9606;2772;8987;589;2118;1482;4688;2071;6806
330150;201609;2404;7035;1772;5711;440;1496;414;1338;854;2834
330160;201609;1186;3710;1008;3383;269;1038;449;1388;718;2426
330170;201609;102038;303512;89795;282105;17897;58667;49420;153205;67317;211872
330180;201609;2061;5967;1667;5210;134;517;1062;3125;1196;3642
330185;201609;8295;25372;6969;22678;1455;5116;3661;11561;5116;16677
330187;201609;3901;11022;3239;9860;483;1606;2088;6212;2571;7818
330190;201609;25921;73250;23801;69761;4287;13196;15733;45655;20020;58851
330200;201609;14354;44691;12437;41176;3226;10951;5884;19599;9110;30550
330205;201609;2218;6023;1849;5355;292;917;1083;3042;1375;3959
330210;201609;3246;8992;2464;7371;737;2237;643;1850;1380;4087
330220;201609;10533;31779;8617;27521;2210;7517;2234;6520;4444;14037
330225;201609;3867;11884;3253;10660;395;1560;1910;5953;2305;7513
330227;201609;17158;49035;15154;45940;3630;11242;8250;25230;11880;36472
330230;201609;1394;4088;1219;3778;255;914;594;1740;849;2654
330240;201609;18082;54907;14748;48178;4759;16663;3752;11572;8511;28235
330245;201609;1315;3984;932;3197;254;940;157;484;411;1424
330250;201609;36368;105602;32021;97824;9653;29551;12410;38961;22063;68512
330260;201609;4012;12444;3311;10916;639;2270;1406;4364;2045;6634
330270;201609;19771;45610;12512;35232;3099;9587;4505;12439;7604;22026
330280;201609;2258;6639;1793;5682;317;1087;870;2581;1187;3668
330285;201609;18702;53055;16388;49329;2824;9013;9972;29611;12796;38624
330290;201609;3448;9694;2973;8895;473;1599;1739;4941;2212;6540
330300;201609;3382;10852;2985;10055;453;1738;1783;5771;2236;7509
330310;201609;2312;6500;1906;5780;290;891;1105;3318;1395;4209
330320;201609;13542;40226;12454;38430;1737;5828;9037;27505;10774;33333
330330;201609;28244;77149;23956;70009;4124;13323;14432;40545;18556;53868
330340;201609;14951;43214;11128;35790;2724;9202;3478;10821;6202;20023
330350;201609;88337;258550;78467;242885;11976;38701;53003;163115;64979;201816
330360;201609;5862;17284;5575;16867;414;1417;4660;13943;5074;15360
330370;201609;3521;12350;3064;11281;1073;4042;927;3416;2000;7458
330380;201609;5056;16202;4103;14170;932;3536;1425;4656;2357;8192
330385;201609;4032;13745;3547;12675;1065;4043;1277;4550;2342;8593
330390;201609;23298;75536;19804;68100;4859;18088;8170;27265;13029;45353
330395;201609;3099;8997;2703;8307;256;921;1810;5393;2066;6314
330400;201609;2637;8202;2324;7618;305;1238;1434;4329;1739;5567
330410;201609;2831;8608;2223;7380;459;1656;979;3108;1438;4764
330411;201609;2400;7456;2009;6587;246;925;1174;3672;1420;4597
330412;201609;1400;4669;1123;4082;220;910;498;1670;718;2580
330414;201609;24504;68694;20902;63215;4376;13006;11944;36420;16320;49426
330415;201609;3622;10974;2919;9599;768;2595;1069;3481;1837;6076
330420;201609;10081;28685;6332;21344;1421;5104;1280;4114;2701;9218
330430;201609;7421;21852;6316;19652;1390;4602;2794;8432;4184;13034
330440;201609;1689;5586;1408;4956;440;1708;323;1012;763;2720
330450;201609;1379;4518;1190;4154;260;1081;599;1999;859;3080
330452;201609;14257;41316;10862;34517;2772;9488;4111;12495;6883;21983
330455;201609;515372;1399945;399153;1203129;90256;285632;198414;586478;288670;872110
330460;201609;1213;3908;1043;3581;224;849;461;1534;685;2383
330470;201609;4471;13414;3859;12240;858;2928;1751;5393;2609;8321
330475;201609;7932;24335;6799;22273;2062;7301;2415;7635;4477;14936
330480;201609;5911;17141;5230;16041;916;2990;3083;9195;3999;12185
330490;201609;110992;290889;96195;267373;10489;30250;69177;190600;79666;220850
330500;201609;5557;16958;5230;16329;725;2461;3498;10755;4223;13216
330510;201609;38013;115110;32968;106414;10774;34918;13465;44234;24239;79152
330513;201609;1501;4433;1344;4146;410;1261;532;1689;942;2950
330515;201609;3059;9340;2569;8339;799;2560;691;2209;1490;4769
330520;201609;11574;34549;9951;31447;2094;6892;4602;14256;6696;21148
330530;201609;1529;4444;1270;3917;320;1083;519;1507;839;2590
330540;201609;2974;8751;2363;7566;597;2019;860;2605;1457;4624
330550;201609;7880;26117;6652;23544;2883;10544;943;3308;3826;13852
330555;201609;10444;30443;8983;28171;1786;5645;5266;16842;7052;22487
330560;201609;4343;12927;3761;11743;640;2199;1997;5931;2637;8130
330570;201609;3422;9984;2796;8823;748;2454;1294;4042;2042;6496
330575;201609;5325;15205;4649;13920;672;2286;3031;8673;3703;10959
330580;201609;14105;44082;11517;38538;3143;10932;4290;14310;7433;25242
330590;201609;1612;4898;1473;4656;264;883;935;2931;1199;3814
330600;201609;11088;32044;8464;27258;1383;4947;4197;13078;5580;18025
330610;201609;8989;27831;7884;25695;1302;4791;4522;14233;5824;19024
330615;201609;1684;5875;1492;5449;659;2566;331;1224;990;3790
330620;201609;3546;12137;3020;10963;971;3794;644;2269;1615;6063
330630;201609;23592;68604;18562;59131;3078;11019;10163;30784;13241;41803
350010;201609;2023;5963;1255;4304;314;1131;151;470;465;1601
350020;201609;476;1295;302;931;50;170;157;451;207;621
350030;201609;4482;13990;3318;11535;1105;4112;743;2490;1848;6602
350040;201609;482;1638;339;1293;80;327;90;318;170;645
350050;201609;928;2791;708;2354;166;639;243;690;409;1329
350055;201609;661;1949;554;1766;98;330;318;978;416;1308
350060;201609;117;344;92;303;23;89;41;132;64;221
350070;201609;3823;11348;2224;7748;480;1754;452;1399;932;3153
350075;201609;506;1691;375;1406;143;536;63;220;206;756
350080;201609;631;1817;382;1255;74;262;142;444;216;706
350090;201609;621;1599;376;1136;110;314;127;391;237;705
350100;201609;1896;5865;1287;4553;276;1097;393;1292;669;2389
350110;201609;469;1406;337;1108;34;131;190;607;224;738
350115;201609;1264;3767;1066;3330;198;693;565;1594;763;2287
350120;201609;628;1667;272;893;59;198;46;140;105;338
350130;201609;3353;9924;2805;8749;404;1424;1549;4541;1953;5965
350140;201609;606;1938;488;1706;66;270;253;849;319;1119
350150;201609;421;1384;354;1238;116;430;72;246;188;676
350160;201609;8180;23672;5233;17562;1187;4383;2110;6443;3297;10826
350170;201609;1665;5676;1349;4831;348;1322;278;922;626;2244
350180;201609;1091;3040;670;2081;109;339;323;987;432;1326
350190;201609;3082;9513;2382;7965;538;2078;1066;3079;1604;5157
350200;201609;368;1149;315;1047;30;98;204;682;234;780
350210;201609;5073;13438;3588;10879;1011;3261;1453;4266;2464;7527
350220;201609;2639;8297;2196;7298;492;1918;900;2719;1392;4637
350230;201609;719;2306;623;2112;143;526;260;851;403;1377
350240;201609;495;1502;393;1260;67;223;227;704;294;927
350250;201609;2069;7378;1861;6951;663;2628;555;2041;1218;4669
350260;201609;977;2604;639;1959;108;348;290;850;398;1198
350270;201609;5031;15259;4095;13125;759;2582;1786;5439;2545;8021
350275;201609;1976;6411;1745;5977;492;1786;645;2099;1137;3885
350280;201609;22221;53964;12420;36455;2739;8392;3083;8748;5822;17140
350290;201609;2065;6542;1525;5315;334;1261;472;1532;806;2793
350300;201609;519;1471;376;1162;91;283;192;569;283;852
350310;201609;841;2772;690;2402;97;405;300;994;397;1399
350315;201609;530;1658;374;1285;61;255;88;258;149;513
350320;201609;10407;32341;8772;28989;2520;8679;1299;4347;3819;13026
350330;201609;14376;39671;8898;26987;1976;5760;3080;8764;5056;14524
350335;201609;364;1142;310;1025;26;76;226;754;252;830
350340;201609;1135;3348;730;2496;138;519;238;794;376;1313
350350;201609;724;2231;590;1977;112;412;205;656;317;1068
350360;201609;828;2812;683;2479;170;607;272;1007;442;1614
350370;201609;618;1816;409;1337;88;309;80;243;168;552
350380;201609;4279;12199;2749;9342;744;2754;704;2122;1448;4876
350390;201609;9212;28100;7719;25070;2291;7649;2835;8845;5126;16494
350395;201609;374;1026;173;595;26;96;45;138;71;234
350400;201609;7964;22715;6097;19138;1407;4833;2392;7116;3799;11949
350410;201609;8381;27572;6120;22544;1701;6742;1095;3796;2796;10538
350420;201609;556;1703;383;1369;81;341;26;84;107;425
350430;201609;736;2249;585;1965;100;379;319;1024;419;1403
350440;201609;1271;3939;1062;3441;249;773;487;1578;736;2351
350450;201609;7707;23496;5750;19247;1342;4777;1397;4391;2739;9168
350460;201609;1492;4110;871;2813;162;585;305;896;467;1481
350470;201609;247;666;193;572;28;105;122;330;150;435
350480;201609;811;2434;515;1773;80;303;90;277;170;580
350490;201609;1843;5487;1495;4847;351;1228;536;1569;887;2797
350500;201609;574;1693;483;1528;82;305;254;773;336;1078
350510;201609;1127;3368;794;2621;137;507;327;1004;464;1511
350520;201609;1442;5299;1059;4253;224;960;231;880;455;1840
350530;201609;2436;7072;1881;5884;576;1810;584;1722;1160;3532
350535;201609;1247;4002;1141;3793;166;678;743;2336;909;3014
350540;201609;1777;4994;1325;4145;367;1183;453;1433;820;2616
350550;201609;11084;29320;7212;22582;1481;5184;2555;7453;4036;12637
350560;201609;3391;11036;2867;9787;392;1349;1587;5414;1979;6763
350570;201609;18283;59739;15606;53870;4821;17702;5513;17971;10334;35673
350580;201609;1719;5423;1072;3797;211;795;120;353;331;1148
350590;201609;4102;12581;3034;10302;792;2983;1109;3375;1901;6358
350600;201609;42282;103607;25928;73898;4537;13705;11437;30314;15974;44019
350610;201609;7198;21015;5509;17824;1209;4206;2324;7252;3533;11458
350620;201609;411;1155;293;960;49;188;124;362;173;550
350630;201609;1631;4685;1115;3665;193;754;431;1243;624;1997
350635;201609;6526;19102;4846;15955;1137;4063;1968;6185;3105;10248
350640;201609;797;2467;489;1659;86;300;104;341;190;641
350650;201609;7927;23807;4518;15533;1079;4022;782;2400;1861;6422
350660;201609;4786;13845;3676;11747;757;2589;1840;5680;2597;8269
350670;201609;1606;4940;1419;4554;298;979;780;2448;1078;3427
350680;201609;1079;3226;788;2610;176;638;318;1032;494;1670
350690;201609;897;2914;661;2374;146;564;206;690;352;1254
350700;201609;4310;12665;2721;9538;752;2798;812;2540;1564;5338
350710;201609;2711;8320;2275;7428;342;1228;1330;4228;1672;5456
350715;201609;796;2394;671;2136;169;574;286;844;455;1418
350720;201609;124;349;102;308;31;92;29;88;60;180
350730;201609;400;1463;366;1372;80;336;147;534;227;870
350740;201609;1827;5562;1224;4082;216;796;344;1019;560;1815
350745;201609;502;1562;285;980;42;146;129;410;171;556
350750;201609;10060;30229;7614;25110;1744;6213;1858;5607;3602;11820
350760;201609;13222;38225;9979;32005;2565;8892;2817;8060;5382;16952
350770;201609;729;2050;472;1515;55;186;263;821;318;1007
350775;201609;595;1577;477;1387;64;226;252;706;316;932
350780;201609;1896;5758;1359;4614;420;1530;204;692;624;2222
350790;201609;1937;5927;1321;4604;302;1099;242;715;544;1814
350800;201609;2934;9650;2668;9125;446;1739;1504;4935;1950;6674
350810;201609;2044;5728;1688;5203;460;1488;728;2276;1188;3764
350820;201609;575;1562;388;1184;62;220;175;500;237;720
350830;201609;860;2639;520;1824;77;288;131;411;208;699
350840;201609;2406;8455;1890;7178;613;2408;390;1400;1003;3808
350850;201609;5919;19558;4769;16871;1539;5690;1008;3474;2547;9164
350860;201609;3238;9911;3018;9545;210;849;2351;7299;2561;8148
350870;201609;2742;8611;2167;7568;462;1827;1240;4300;1702;6127
350880;201609;1293;4255;1027;3631;237;883;242;822;479;1705
350890;201609;651;1836;364;1175;43;157;103;264;146;421
350900;201609;4065;13002;2791;9938;837;3195;261;874;1098;4069
350910;201609;847;2478;717;2205;213;709;300;860;513;1569
350920;201609;10585;29863;9123;27107;943;3109;6524;18577;7467;21686
350925;201609;4566;14168;3515;11917;882;3135;1179;3477;2061;6612
350930;201609;1594;4354;1176;3530;143;466;710;2030;853;2496
350940;201609;1830;5919;1623;5553;302;1178;940;3102;1242;4280
350945;201609;963;2967;758;2541;124;499;408;1273;532;1772
350950;201609;74777;222377;57194;183571;12362;42963;25029;75242;37391;118205
350960;201609;4769;15618;3917;13716;753;2986;2079;6857;2832;9843
350970;201609;4301;14659;3411;12460;1118;4350;603;1883;1721;6233
350980;201609;599;1951;520;1805;223;833;148;502;371;1335
350990;201609;1794;5930;1389;5114;386;1535;377;1313;763;2848
350995;201609;763;2570;705;2448;90;408;464;1506;554;1914
351000;201609;3030;8959;2383;7659;393;1364;1014;3026;1407;4390
351010;201609;364;1024;200;650;45;157;69;227;114;384
351015;201609;820;2762;672;2462;143;575;320;1139;463;1714
351020;201609;8254;25250;6857;22827;1708;5906;3142;10495;4850;16401
351030;201609;1827;6349;1498;5491;347;1425;468;1579;815;3004
351040;201609;3500;10376;3097;9624;417;1461;2131;6383;2548;7844
351050;201609;15168;42306;9930;32612;2572;9015;2848;9087;5420;18102
351060;201609;36795;105958;28796;90831;5774;19888;14013;42550;19787;62438
351070;201609;1428;3978;871;2895;225;810;84;226;309;1036
351080;201609;2651;7646;1980;6683;481;1757;875;2789;1356;4546
351090;201609;362;1237;273;1030;63;271;47;173;110;444
351100;201609;2160;6500;1591;5236;422;1432;471;1550;893;2982
351110;201609;7216;18278;3738;12155;863;3093;905;2759;1768;5852
351120;201609;656;1895;482;1513;71;262;222;581;293;843
351130;201609;993;2754;479;1639;86;311;90;269;176;580
351140;201609;1705;5714;1351;4920;436;1702;286;940;722;2642
351150;201609;1533;5267;998;3840;179;712;128;407;307;1119
351160;201609;1279;4419;1082;3920;271;1048;331;1100;602;2148
351170;201609;1422;4482;1124;3791;190;682;526;1664;716;2346
351190;201609;801;2534;581;1966;97;335;179;564;276;899
351200;201609;2016;5879;1596;5004;248;878;627;1801;875;2679
351210;201609;1141;3295;772;2504;145;501;285;824;430;1325
351220;201609;3232;10739;2832;9839;482;1820;1414;4793;1896;6613
351230;201609;1765;5414;1406;4689;283;1095;697;2180;980;3275
351240;201609;1087;3307;758;2557;210;713;235;728;445;1441
351250;201609;999;2884;567;1871;93;305;206;639;299;944
351260;201609;923;2687;750;2320;218;660;249;741;467;1401
351270;201609;336;1129;282;1015;65;253;100;302;165;555
351280;201609;4959;14118;3383;10799;656;2260;1269;3784;1925;6044
351290;201609;1020;2902;693;2220;157;523;277;847;434;1370
351300;201609;13009;41770;9206;33242;2222;8751;2863;9951;5085;18702
351310;201609;3131;9400;2402;7972;450;1670;1107;3385;1557;5055
351320;201609;795;2627;627;2194;127;493;225;719;352;1212
351330;201609;274;759;206;639;75;223;41;117;116;340
351340;201609;5595;18474;4526;16214;1338;5013;1584;5559;2922;10572
351350;201609;7746;24671;6457;21834;1789;6258;2229;7129;4018;13387
351360;201609;4094;12588;3598;11554;856;3042;1153;3311;2009;6353
351370;201609;2293;7028;1711;5729;352;1308;680;2046;1032;3354
351380;201609;38630;111415;33351;100999;6682;21627;14543;42662;21225;64289
351385;201609;264;785;180;600;29;105;77;230;106;335
351390;201609;1196;3781;946;3237;231;933;386;1161;617;2094
351400;201609;938;3069;863;2884;271;976;383;1240;654;2216
351410;201609;2463;7366;2069;6588;336;1100;1209;3755;1545;4855
351420;201609;319;905;206;677;42;140;51;164;93;304
351430;201609;841;2619;773;2499;140;478;527;1695;667;2173
351440;201609;3464;10265;2378;7774;533;1782;330;981;863;2763
351450;201609;1648;4623;1241;3888;320;1034;452;1466;772;2500
351460;201609;729;2149;600;1907;311;987;141;445;452;1432
351470;201609;1018;3020;863;2702;170;607;413;1222;583;1829
351480;201609;2748;8772;2458;8254;379;1603;1413;4477;1792;6080
351490;201609;1828;5940;1552;5295;158;658;940;3024;1098;3682
351492;201609;255;807;191;640;11;43;115;375;126;418
351495;201609;196;629;141;483;32;131;62;194;94;325
351500;201609;27918;78011;19881;62400;5085;17133;7759;22931;12844;40064
351510;201609;9047;27378;7057;23213;1743;6069;3262;10456;5005;16525
351512;201609;484;1386;338;1049;55;166;159;485;214;651
351515;201609;2280;7053;1511;5268;366;1380;384;1168;750;2548
351518;201609;2120;6461;1378;4985;337;1365;451;1466;788;2831
351519;201609;797;2334;533;1733;86;321;156;380;242;701
351520;201609;804;2156;372;1290;59;239;67;212;126;451
351530;201609;394;1210;232;768;30;93;59;156;89;249
351535;201609;2385;6090;1761;5075;137;483;1195;3278;1332;3761
351540;201609;1738;5181;1318;4303;446;1585;184;569;630;2154
351550;201609;5352;15535;3531;11459;656;2348;1365;4200;2021;6548
351560;201609;388;1230;323;1087;70;273;44;139;114;412
351565;201609;174;577;147;507;29;100;60;200;89;300
351570;201609;12638;37773;10135;32440;2143;7415;5458;16750;7601;24165
351580;201609;328;874;167;515;46;127;36;122;82;249
351590;201609;445;1132;265;779;24;74;130;361;154;435
351600;201609;1792;4928;1426;4243;181;615;844;2377;1025;2992
351610;201609;661;1793;468;1437;56;192;225;612;281;804
351620;201609;19001;59931;13940;48988;2881;11185;3770;11690;6651;22875
351630;201609;20674;63548;18115;59073;4106;14045;10105;32288;14211;46333
351640;201609;12906;38182;10219;33068;1754;6159;5974;18819;7728;24978
351650;201609;457;1360;196;676;37;147;36;98;73;245
351660;201609;801;2527;528;1803;112;395;103;307;215;702
351670;201609;4000;12463;3052;10155;559;2059;1400;4331;1959;6390
351680;201609;611;1863;325;1126;70;237;60;201;130;438
351685;201609;412;1273;343;1134;96;290;147;506;243;796
351690;201609;1121;3277;747;2428;121;410;302;901;423;1311
351700;201609;1138;3325;935;2907;236;701;335;1034;571;1735
351710;201609;565;1829;448;1550;74;251;180;594;254;845
351720;201609;1599;4834;1013;3393;198;709;316;995;514;1704
351730;201609;1089;3082;833;2663;194;689;347;1067;541;1756
351740;201609;3939;10724;2925;8629;602;1848;1160;3230;1762;5078
351750;201609;1066;3378;608;2228;130;483;168;617;298;1100
351760;201609;3504;10779;2659;8876;719;2599;808;2442;1527;5041
351770;201609;2198;6870;1800;6080;511;1807;730;2361;1241;4168
351780;201609;1562;4327;781;2505;131;457;181;540;312;997
351790;201609;1119;3145;923;2816;211;610;465;1445;676;2055
351800;201609;461;1020;239;640;37;101;85;222;122;323
351810;201609;1044;2962;861;2631;108;323;600;1801;708;2124
351820;201609;2458;7707;1668;5898;381;1387;156;536;537;1923
351830;201609;4042;12450;2930;9961;522;1966;1439;4629;1961;6595
351840;201609;7110;23474;5893;20868;1475;5549;2101;7178;3576;12727
351850;201609;2012;5357;1295;4073;175;683;663;1848;838;2531
351860;201609;3412;10726;2836;9470;706;2509;1210;3887;1916;6396
351870;201609;28378;83991;22941;73615;6828;22790;8983;28496;15811;51286
351880;201609;115170;355345;92308;306044;27154;94917;24122;74645;51276;169562
351885;201609;641;2190;563;2011;156;555;232;815;388;1370
351890;201609;643;1981;469;1595;109;384;81;256;190;640
351900;201609;1224;3730;978;3279;259;909;302;985;561;1894
351905;201609;483;1514;370;1275;48;176;197;631;245;807
351907;201609;18734;54521;14919;46982;1500;5696;9791;29542;11291;35238
351910;201609;1038;3215;796;2643;181;634;319;1005;500;1639
351920;201609;1006;2726;831;2445;103;346;494;1412;597;1758
351925;201609;922;2836;738;2434;123;450;336;1016;459;1466
351930;201609;2690;8577;2526;8252;528;2006;1667;5136;2195;7142
351940;201609;1002;3012;794;2581;151;527;374;1192;525;1719
351950;201609;1482;4034;977;3047;139;465;477;1452;616;1917
351960;201609;4472;12771;3101;10072;713;2524;1316;4150;2029;6674
351970;201609;5469;19389;4715;17753;1286;5210;1708;6124;2994;11334
351980;201609;921;2707;627;2031;132;467;212;590;344;1057
351990;201609;1528;4240;1097;3374;221;815;240;595;461;1410
352000;201609;2371;7599;2058;6896;411;1475;994;3089;1405;4564
352010;201609;1692;5644;1387;4908;329;1217;252;886;581;2103
352020;201609;1427;4378;1183;3886;298;1040;455;1430;753;2470
352030;201609;4862;14055;3864;12484;877;2978;1989;6373;2866;9351
352040;201609;1981;6397;1457;5163;318;1222;254;825;572;2047
352042;201609;3474;9517;2022;6302;412;1362;901;2722;1313;4084
352044;201609;1708;5199;961;3508;173;652;195;644;368;1296
352050;201609;10569;31870;6610;22699;1547;5796;1263;3791;2810;9587
352060;201609;749;2231;570;1838;117;437;223;627;340;1064
352070;201609;814;2047;612;1695;138;411;214;579;352;990
352080;201609;438;1251;277;894;51;171;108;323;159;494
352090;201609;1185;4088;936;3415;158;602;226;744;384;1346
352100;201609;2841;8588;2094;7117;559;2014;825;2610;1384;4624
352110;201609;506;1738;414;1530;108;420;146;509;254;929
352115;201609;478;1509;402;1359;57;185;226;765;283;950
352120;201609;905;2820;691;2388;113;442;363;1151;476;1593
352130;201609;1810;5206;1113;3686;279;953;238;727;517;1680
352140;201609;1755;5027;959;3241;154;548;361;1164;515;1712
352150;201609;785;2338;586;1939;157;545;273;883;430;1428
352160;201609;1007;2746;728;2210;155;503;244;650;399;1153
352170;201609;2741;8197;2349;7308;437;1444;1235;3598;1672;5042
352180;201609;3273;9284;2613;7906;655;2095;926;2631;1581;4726
352190;201609;1179;3502;897;2877;137;535;315;816;452;1351
352200;201609;365;1248;262;999;46;195;96;339;142;534
352210;201609;16613;44486;13027;38921;2281;7184;7859;23438;10140;30622
352215;201609;544;1666;479;1549;63;235;294;910;357;1145
352220;201609;12538;39575;9908;33962;3280;11945;2369;7968;5649;19913
352230;201609;12496;41527;10275;36943;2883;11190;3487;11835;6370;23025
352240;201609;12306;35247;9118;29328;2634;9449;2777;7863;5411;17312
352250;201609;22770;72177;19016;64113;5794;20569;5926;19579;11720;40148
352260;201609;5286;14918;3196;10385;665;2359;1157;3407;1822;5766
352265;201609;866;2716;713;2429;58;258;477;1552;535;1810
352270;201609;1740;5913;1375;5061;349;1348;346;1235;695;2583
352280;201609;2222;6588;1708;5583;410;1488;669;2036;1079;3524
352290;201609;1150;3591;924;3058;194;755;356;1051;550;1806
352300;201609;991;2857;705;2245;153;547;311;891;464;1438
352310;201609;43360;126714;33316;108069;9227;30847;15520;49915;24747;80762
352320;201609;5528;16858;4522;14741;1227;4195;1429;4177;2656;8372
352330;201609;1972;6200;1608;5621;521;1965;439;1469;960;3434
352340;201609;5321;16716;3758;13445;1041;3960;740;2389;1781;6349
352350;201609;1672;5611;1433;5056;257;1033;532;1739;789;2772
352360;201609;1077;3270;929;2983;184;710;591;1768;775;2478
352370;201609;870;2936;752;2656;117;470;400;1344;517;1814
352380;201609;985;3089;803;2723;233;879;183;575;416;1454
352390;201609;19065;50201;11731;35890;2113;7265;5741;16157;7854;23422
352400;201609;3817;10835;2340;7789;692;2361;555;1702;1247;4063
352410;201609;2873;8631;2339;7670;544;1854;955;3008;1499;4862
352420;201609;899;2479;692;2072;160;494;298;856;458;1350
352430;201609;6377;18828;5068;16538;1728;6058;1526;4817;3254;10875
352440;201609;15580;46907;11959;39378;2827;9862;4525;14333;7352;24195
352450;201609;693;2115;427;1490;98;381;119;368;217;749
352460;201609;2313;7412;1817;6352;500;1902;507;1576;1007;3478
352470;201609;3781;10491;2420;7756;371;1313;1041;3053;1412;4366
352480;201609;4388;11822;3111;9333;671;2267;1169;3086;1840;5353
352490;201609;685;2370;515;1916;89;351;137;498;226;849
352500;201609;8760;24896;7250;22419;3641;11742;1537;3983;5178;15725
352510;201609;2946;9211;2241;7788;672;2501;550;1852;1222;4353
352520;201609;1994;6980;1698;6226;454;1770;653;2334;1107;4104
352530;201609;8469;26690;5818;20241;1504;5558;795;2257;2299;7815
352540;201609;498;1550;317;1102;52;183;98;329;150;512
352550;201609;869;2840;557;2087;132;535;115;374;247;909
352560;201609;650;1921;416;1364;67;212;100;285;167;497
352570;201609;1843;5948;1262;4586;300;1218;183;534;483;1752
352580;201609;864;2535;684;2175;140;473;312;954;452;1427
352585;201609;240;758;181;620;40;149;62;206;102;355
352590;201609;12489;37980;9618;31992;3183;11190;3478;10628;6661;21818
352600;201609;1722;5216;1390;4529;334;1162;574;1749;908;2911
352610;201609;3319;10125;2551;8641;691;2549;741;2353;1432;4902
352620;201609;5264;15898;4593;14764;1083;3607;2260;7085;3343;10692
352630;201609;643;1987;576;1824;122;445;245;706;367;1151
352640;201609;2713;8194;2159;7035;238;868;1292;4093;1530;4961
352650;201609;824;2458;541;1794;101;347;160;489;261;836
352660;201609;1057;3572;789;2930;159;652;209;749;368;1401
352670;201609;11156;32959;6036;21160;1421;5361;513;1652;1934;7013
352680;201609;2851;9445;2072;7569;488;1959;687;2246;1175;4205
352690;201609;31235;85473;21022;64323;3180;10635;10918;31648;14098;42283
352700;201609;609;1808;497;1619;143;517;202;615;345;1132
352710;201609;5356;15423;3715;11923;962;3342;1258;3741;2220;7083
352720;201609;7692;24564;6565;21907;2135;7204;1829;5940;3964;13144
352725;201609;417;1170;218;725;26;109;94;286;120;395
352730;201609;2260;7426;1960;6622;403;1466;737;2181;1140;3647
352740;201609;2175;5848;1618;4890;235;826;941;2658;1176;3484
352750;201609;493;1416;245;827;32;125;52;157;84;282
352760;201609;1219;4100;916;3280;293;1076;225;736;518;1812
352770;201609;779;2408;627;2070;136;487;247;767;383;1254
352780;201609;617;2059;462;1677;91;350;147;513;238;863
352790;201609;633;1813;417;1382;83;283;114;365;197;648
352800;201609;1055;3705;711;2728;160;657;203;697;363;1354
352810;201609;1183;3069;714;2132;138;422;222;618;360;1040
352820;201609;652;1760;430;1371;90;310;100;295;190;605
352830;201609;536;1532;282;917;46;170;42;103;88;273
352840;201609;3833;12810;3286;11570;947;3442;1248;4247;2195;7689
352850;201609;9577;27570;6908;22923;1855;6480;2412;7735;4267;14215
352860;201609;810;2683;720;2479;154;576;263;849;417;1425
352870;201609;954;2385;600;1651;71;255;336;797;407;1052
352880;201609;2346;6472;1586;4864;289;909;580;1631;869;2540
352885;201609;238;788;217;743;21;77;149;499;170;576
352890;201609;674;1751;435;1249;61;213;194;484;255;697
352900;201609;20051;57873;13659;44382;2841;9947;4912;14958;7753;24905
352910;201609;369;1063;192;644;19;67;43;131;62;198
352920;201609;2473;7375;1783;5869;357;1293;767;2312;1124;3605
352930;201609;5700;17532;4222;14168;956;3404;1256;3940;2212;7344
352940;201609;20910;66793;16311;55766;5224;19177;1614;4708;6838;23885
352950;201609;352;1022;203;732;50;210;34;102;84;312
352960;201609;627;1875;335;1165;51;189;83;261;134;450
352965;201609;373;1045;215;674;45;140;32;85;77;225
352970;201609;3241;8038;2533;6947;273;773;1740;4776;2013;5549
352980;201609;1038;3276;858;2964;189;659;479;1707;668;2366
352990;201609;4065;12560;3440;11400;909;3332;1419;4382;2328;7714
353000;201609;445;1258;218;716;28;92;39;115;67;207
353010;201609;2973;8187;2024;6290;475;1641;568;1525;1043;3166
353020;201609;4119;11167;2220;6928;392;1286;782;2131;1174;3417
353030;201609;3793;11142;2893;9349;814;2769;522;1592;1336;4361
353040;201609;561;1540;443;1312;108;349;140;382;248;731
353050;201609;4800;15840;3770;13503;1079;4013;1297;4437;2376;8450
353060;201609;39822;115828;33350;104310;3718;13695;23773;70794;27491;84489
353070;201609;10533;32296;7028;24457;1718;6296;1770;6081;3488;12377
353080;201609;5171;16144;3338;11939;762;2972;819;2690;1581;5662
353090;201609;542;1790;465;1604;44;183;282;898;326;1081
353100;201609;287;806;119;396;18;59;22;61;40;120
353110;201609;7574;22936;6350;20836;1324;4667;3672;11984;4996;16651
353120;201609;673;1999;404;1363;80;297;109;307;189;604
353130;201609;2507;7179;1915;6182;616;2124;596;1853;1212;3977
353140;201609;2363;6418;1720;5098;389;1229;783;2181;1172;3410
353150;201609;1633;4880;1252;4163;341;1151;343;1137;684;2288
353160;201609;653;1817;376;1212;81;269;71;187;152;456
353170;201609;420;1348;370;1269;104;445;172;526;276;971
353180;201609;8490;23779;6514;20164;1102;3661;3726;11201;4828;14862
353190;201609;3712;11073;2901;9239;501;1753;1506;4468;2007;6221
353200;201609;1013;3357;734;2627;215;842;176;572;391;1414
353205;201609;367;1184;313;1071;77;266;129;442;206;708
353210;201609;1002;2508;660;1879;30;102;447;1224;477;1326
353215;201609;388;1200;309;1021;47;177;105;292;152;469
353220;201609;658;2013;495;1642;136;462;110;337;246;799
353230;201609;789;2527;690;2322;167;609;200;619;367;1228
353240;201609;2066;6520;1737;5840;337;1251;912;2929;1249;4180
353250;201609;1076;2889;773;2295;108;354;383;1073;491;1427
353260;201609;890;2432;606;1872;101;356;215;623;316;979
353270;201609;658;1897;535;1648;107;334;217;636;324;970
353280;201609;584;1882;447;1563;113;421;93;305;206;726
353282;201609;1775;5575;1561;5117;244;862;891;2766;1135;3628
353284;201609;358;953;188;581;35;110;45;132;80;242
353286;201609;146;443;101;345;21;65;18;62;39;127
353290;201609;750;2280;578;1937;87;364;329;1012;416;1376
353300;201609;1452;4478;1147;3764;266;981;416;1218;682;2199
353310;201609;203;605;158;529;48;164;55;179;103;343
353320;201609;574;1627;460;1409;74;238;241;699;315;937
353325;201609;612;1991;449;1590;66;246;131;440;197;686
353330;201609;608;1725;398;1233;70;247;189;548;259;795
353340;201609;2770;8005;1753;5979;571;2004;444;1488;1015;3492
353350;201609;3215;9562;2388;7811;711;2458;677;2043;1388;4501
353360;201609;447;1448;396;1338;43;169;267;881;310;1050
353370;201609;638;2071;525;1794;60;235;293;948;353;1183
353380;201609;328;1076;248;897;41;166;86;293;127;459
353390;201609;5680;15418;3723;11725;774;2536;1325;3943;2099;6479
353400;201609;483;1472;369;1207;92;321;83;223;175;544
353410;201609;637;1851;497;1575;103;357;257;777;360;1134
353420;201609;591;1673;356;1091;103;314;91;254;194;568
353430;201609;2250;7507;1504;5577;386;1483;231;792;617;2275
353440;201609;58633;183341;44956;151437;12293;42865;15494;50163;27787;93028
353450;201609;428;1247;319;1002;67;230;122;353;189;583
353460;201609;3307;9354;2451;7639;343;1192;1247;3874;1590;5066
353470;201609;8100;24159;5533;18719;1250;4627;1274;3908;2524;8535
353475;201609;1561;4406;1044;3185;184;613;346;930;530;1543
353480;201609;1440;4351;1271;4008;188;620;798;2458;986;3078
353490;201609;965;2785;701;2202;151;480;250;751;401;1231
353500;201609;1023;2718;823;2373;236;694;403;1133;639;1827
353510;201609;1001;3163;693;2360;152;542;131;398;283;940
353520;201609;1131;3208;815;2627;128;466;361;1085;489;1551
353530;201609;2545;7414;2093;6522;327;1157;1136;3366;1463;4523
353540;201609;1939;5878;1614;5277;434;1483;655;2072;1089;3555
353550;201609;6287;17259;4882;14748;495;1754;3160;8994;3655;10748
353560;201609;2024;6662;1588;5772;454;1799;384;1253;838;3052
353570;201609;462;1414;339;1096;80;264;152;456;232;720
353580;201609;2405;7075;2055;6439;339;1177;1285;3953;1624;5130
353590;201609;731;2111;495;1594;126;430;158;500;284;930
353600;201609;1764;4828;1459;4235;223;696;763;2117;986;2813
353610;201609;557;1872;392;1494;78;338;77;255;155;593
353620;201609;2233;7075;1756;6032;428;1537;494;1558;922;3095
353625;201609;386;1080;230;765;45;160;78;262;123;422
353630;201609;1498;5196;1110;4139;195;786;142;434;337;1220
353640;201609;1323;3908;963;3098;109;371;498;1562;607;1933
353650;201609;8080;23605;5518;17855;1093;3681;2127;6487;3220;10168
353657;201609;301;948;245;827;37;145;94;294;131;439
353660;201609;1065;2771;741;2153;303;942;91;171;394;1113
353670;201609;3580;11412;2940;9988;913;3446;986;3051;1899;6497
353680;201609;723;2289;579;2014;182;713;202;653;384;1366
353690;201609;517;1383;257;839;49;171;50;122;99;293
353700;201609;2018;6099;1666;5371;239;834;848;2569;1087;3403
353710;201609;3187;7627;1355;4432;340;1076;263;825;603;1901
353715;201609;501;1430;304;989;29;105;91;265;120;370
353720;201609;2030;6177;1635;5498;328;1310;835;2578;1163;3888
353730;201609;4531;13604;3305;10770;668;2385;1127;3322;1795;5707
353740;201609;1830;5436;1317;4344;358;1236;324;1016;682;2252
353750;201609;857;2864;607;2243;126;499;127;460;253;959
353760;201609;10092;27320;7939;24070;1153;3999;5068;14848;6221;18847
353770;201609;737;2299;373;1320;50;189;22;43;72;232
353780;201609;4165;14298;3490;12828;1090;4171;969;3511;2059;7682
353790;201609;2173;7368;1685;6289;464;1953;382;1343;846;3296
353800;201609;16196;49024;12176;41136;3220;11667;4452;14483;7672;26150
353810;201609;1004;3183;720;2532;137;540;230;773;367;1313
353820;201609;1393;4609;1173;4058;226;911;611;1936;837;2847
353830;201609;675;1808;509;1524;89;285;273;787;362;1072
353850;201609;1693;5252;1410;4649;356;1223;529;1682;885;2905
353860;201609;2493;8200;1985;6983;550;2038;497;1652;1047;3690
353870;201609;28891;82561;18350;60477;3549;12653;6219;18348;9768;31001
353880;201609;2680;8384;2168;7390;294;1152;1209;4030;1503;5182
353890;201609;2660;6492;1725;4896;288;886;873;2324;1161;3210
353900;201609;962;2946;661;2312;136;524;184;594;320;1118
353910;201609;1215;4178;1095;3935;293;1084;574;2067;867;3151
353920;201609;2269;6624;1417;4716;328;1196;265;752;593;1948
353930;201609;4496;13479;2928;10324;765;2901;529;1795;1294;4696
353940;201609;1214;3827;863;2980;159;575;286;904;445;1479
353950;201609;3237;10219;2746;9139;538;1932;1374;4299;1912;6231
353960;201609;612;1912;428;1478;92;334;90;281;182;615
353970;201609;551;1574;444;1394;49;162;272;844;321;1006
353980;201609;13169;39002;10755;34069;2402;7948;5168;15718;7570;23666
353990;201609;356;1099;305;983;39;154;165;498;204;652
354000;201609;2228;6178;1264;4124;258;894;135;411;393;1305
354010;201609;375;1120;298;978;60;194;168;557;228;751
354020;201609;4220;13228;3442;11395;901;3162;1028;3096;1929;6258
354025;201609;871;2448;610;1943;115;382;222;691;337;1073
354030;201609;477;1316;301;966;49;177;127;378;176;555
354040;201609;783;2114;495;1516;55;175;279;795;334;970
354050;201609;953;2993;725;2498;186;678;147;474;333;1152
354060;201609;4885;15088;3181;11051;848;3046;767;2498;1615;5544
354070;201609;2822;9349;2233;7882;554;2084;420;1390;974;3474
354075;201609;1944;7092;1736;6589;482;1961;703;2585;1185;4546
354080;201609;1537;4654;985;3378;194;675;261;820;455;1495
354085;201609;332;828;293;768;12;46;249;640;261;686
354090;201609;1353;3986;1242;3786;152;514;848;2549;1000;3063
354100;201609;14665;48431;11515;41935;3016;11666;4690;16643;7706;28309
354105;201609;898;2622;763;2401;113;379;519;1614;632;1993
354110;201609;731;1986;542;1705;187;639;98;251;285;890
354120;201609;1897;5216;1358;4145;239;792;584;1658;823;2450
354130;201609;6262;17890;4369;14035;1619;5415;413;1112;2032;6527
354140;201609;26190;65577;14763;43982;3343;10427;4394;11924;7737;22351
354150;201609;3872;10366;2761;8237;486;1564;1314;3740;1800;5304
354160;201609;3438;11092;2638;9160;681;2479;934;3085;1615;5564
354165;201609;488;1642;393;1427;104;409;141;515;245;924
354170;201609;1382;4313;1055;3538;196;731;430;1312;626;2043
354180;201609;477;1434;392;1235;54;196;196;532;250;728
354190;201609;1578;4943;1232;4185;313;1155;400;1270;713;2425
354200;201609;1003;2801;739;2277;102;332;339;956;441;1288
354210;201609;617;1937;495;1690;72;300;258;800;330;1100
354220;201609;2940;8478;2349;7333;508;1665;1086;3281;1594;4946
354230;201609;631;2045;527;1795;89;340;242;786;331;1126
354240;201609;1230;4010;853;3090;163;629;189;654;352;1283
354250;201609;673;1910;428;1460;137;497;110;390;247;887
354260;201609;7306;21717;5809;18889;1598;5466;2006;6358;3604;11824
354270;201609;1151;3813;897;3199;184;704;303;1039;487;1743
354280;201609;699;2073;617;1922;100;399;409;1165;509;1564
354290;201609;917;3179;781;2850;186;725;312;1142;498;1867
354300;201609;3654;11865;3342;11203;995;3426;1530;4966;2525;8392
354310;201609;853;2592;654;2174;134;459;330;1081;464;1540
354320;201609;701;2094;564;1822;135;498;188;549;323;1047
354323;201609;459;1258;313;956;64;207;111;295;175;502
354325;201609;1207;3943;882;3132;184;695;309;1005;493;1700
354330;201609;6610;19562;5025;16267;1085;3882;2288;6813;3373;10695
354340;201609;24484;73916;18979;63700;5425;19433;6933;22364;12358;41797
354350;201609;1033;3041;914;2786;235;800;470;1313;705;2113
354360;201609;448;1410;233;875;32;111;11;41;43;152
354370;201609;1133;3770;922;3299;99;446;539;1843;638;2289
354380;201609;836;2484;628;2084;184;708;108;283;292;991
354390;201609;13298;38428;8219;27863;1721;6158;1594;5116;3315;11274
354400;201609;1563;5370;1198;4424;251;978;358;1298;609;2276
354410;201609;5394;16432;4235;14073;1059;3744;1716;5484;2775;9228
354420;201609;1183;3512;833;2695;208;721;314;982;522;1703
354425;201609;2377;6718;1901;5784;592;1864;459;1378;1051;3242
354430;201609;1350;4335;1156;3908;244;922;485;1566;729;2488
354440;201609;530;1595;357;1191;41;134;146;461;187;595
354450;201609;410;1162;217;714;36;132;43;119;79;251
354460;201609;926;2570;604;1934;152;523;239;746;391;1269
354470;201609;577;1544;414;1200;41;148;217;555;258;703
354480;201609;766;2109;588;1780;76;246;357;1030;433;1276
354490;201609;726;2411;546;1965;62;246;272;944;334;1190
354500;201609;2148;6874;1820;6264;632;2376;365;1247;997;3623
354510;201609;812;2216;710;2036;102;246;456;1328;558;1574
354515;201609;270;887;197;710;38;148;76;262;114;410
354520;201609;7745;24933;4127;14394;844;3292;1674;5342;2518;8634
354530;201609;3071;10443;2607;9375;697;2694;1069;3713;1766;6407
354540;201609;1198;3596;960;3156;322;1130;160;491;482;1621
354550;201609;471;1390;375;1194;77;262;176;522;253;784
354560;201609;1674;4660;894;2849;153;479;416;1230;569;1709
354570;201609;1031;2877;441;1430;72;260;70;196;142;456
354580;201609;10791;30073;7054;22712;1294;4453;2756;8241;4050;12694
354600;201609;1591;5134;1321;4579;253;1043;665;2153;918;3196
354610;201609;399;1140;224;719;26;84;74;214;100;298
354620;201609;395;1260;292;1066;63;281;139;487;202;768
354625;201609;291;902;172;616;26;94;45;136;71;230
354630;201609;2090;6893;1766;6150;713;2637;230;728;943;3365
354640;201609;3374;10990;2403;8656;503;2025;467;1449;970;3474
354650;201609;882;2577;732;2266;89;309;483;1474;572;1783
354660;201609;2406;6722;1685;5395;209;757;1003;3103;1212;3860
354670;201609;1273;3984;933;3155;240;883;212;620;452;1503
354680;201609;4397;14223;3851;13067;1024;3637;1688;5608;2712;9245
354690;201609;754;2407;438;1585;77;291;124;421;201;712
354700;201609;1146;3216;731;2270;150;540;301;802;451;1342
354710;201609;515;1536;367;1181;43;162;167;476;210;638
354720;201609;252;675;132;419;38;117;22;64;60;181
354730;201609;8539;26784;6072;21630;1323;5108;2614;8850;3937;13958
354740;201609;250;766;121;444;18;77;18;64;36;141
354750;201609;2269;7022;1711;5813;447;1675;601;1895;1048;3570
354760;201609;1923;6045;1459;5003;440;1564;191;641;631;2205
354765;201609;298;837;117;399;16;57;15;41;31;98
354770;201609;2340;6462;1668;5235;614;1988;455;1362;1069;3350
354780;201609;52213;144639;41938;122520;6742;21820;23380;63919;30122;85739
354790;201609;812;2658;711;2436;115;417;377;1238;492;1655
354800;201609;2146;6201;1825;5724;427;1488;904;2715;1331;4203
354805;201609;1009;3012;664;2215;67;235;175;500;242;735
354810;201609;568;1821;311;1167;54;234;50;141;104;375
354820;201609;963;3268;764;2796;153;627;177;566;330;1193
354830;201609;416;1147;305;938;89;283;121;337;210;620
354840;201609;673;1925;509;1601;111;343;230;709;341;1052
354850;201609;16734;50701;11644;39939;2455;9271;4950;15468;7405;24739
354860;201609;1363;4241;1122;3789;229;875;416;1293;645;2168
354870;201609;46360;134603;39311;119555;8651;28121;17864;52601;26515;80722
354880;201609;4271;11722;2167;7058;343;1297;708;1895;1051;3192
354890;201609;16315;46879;12916;40391;2882;9616;5452;16244;8334;25860
354900;201609;450;1373;308;1032;67;247;72;220;139;467
354910;201609;6319;18793;3248;11794;599;2359;165;544;764;2903
354920;201609;410;1195;249;866;46;182;63;202;109;384
354925;201609;315;937;173;600;26;95;27;84;53;179
354930;201609;312;774;161;507;24;79;71;213;95;292
354940;201609;1867;6608;1422;5391;490;1960;145;495;635;2455
354950;201609;1464;4578;1183;4056;142;612;667;2177;809;2789
354960;201609;775;2377;654;2164;134;499;282;876;416;1375
354970;201609;3872;12558;3230;11177;557;2193;1749;5758;2306;7951
354980;201609;33302;82671;18564;56729;3283;11076;6927;19254;10210;30330
354990;201609;53284;153045;39635;125278;6890;23338;19928;60285;26818;83623
354995;201609;1740;5251;1420;4698;355;1216;689;2243;1044;3459
355000;201609;1425;4514;1190;4029;325;1264;239;672;564;1936
355010;201609;3600;10981;2644;8713;773;2676;698;2318;1471;4994
355020;201609;2933;9605;2122;7827;804;3217;462;1594;1266;4811
355030;201609;1132732;3054999;902450;2591297;201278;621855;399896;1087408;601174;1709263
355040;201609;2583;7820;2214;7137;460;1550;1280;4033;1740;5583
355050;201609;1142;3449;855;2839;270;897;139;451;409;1348
355060;201609;4436;14632;3427;12397;748;3009;1072;3501;1820;6510
355070;201609;6584;20143;5598;18352;1152;4263;2729;8290;3881;12553
355080;201609;958;3258;631;2451;102;442;41;141;143;583
355090;201609;1112;3755;882;3221;171;647;340;1210;511;1857
355100;201609;18243;55604;14532;48958;3888;14200;6645;21553;10533;35753
355110;201609;1182;3798;962;3346;282;1063;201;649;483;1712
355120;201609;629;1956;484;1651;97;393;184;581;281;974
355130;201609;631;1602;265;790;39;119;90;240;129;359
355140;201609;1128;3721;1044;3554;217;822;576;1981;793;2803
355150;201609;3453;9910;2771;8736;556;1791;1394;4396;1950;6187
355160;201609;1687;5225;1303;4509;402;1493;348;1153;750;2646
355170;201609;8474;23699;6155;19617;2094;7022;1581;5122;3675;12144
355180;201609;2853;8765;2212;7492;558;2207;698;2110;1256;4317
355190;201609;1425;4468;1172;3931;383;1434;341;1200;724;2634
355200;201609;777;2722;686;2508;281;1096;157;524;438;1620
355210;201609;2728;8469;2313;7555;347;1340;1378;4242;1725;5582
355220;201609;35358;105489;27117;88162;9107;31050;6650;19730;15757;50780
355230;201609;1389;3761;688;2182;136;420;180;500;316;920
355240;201609;25153;71539;16116;52138;3638;12246;5206;16159;8844;28405
355250;201609;28157;87695;22527;76166;6410;22907;8002;26199;14412;49106
355255;201609;874;2397;491;1573;101;327;134;413;235;740
355260;201609;1252;3647;1025;3216;219;782;440;1240;659;2022
355270;201609;1630;4808;1398;4322;165;552;917;2739;1082;3291
355280;201609;26219;75557;19874;62543;3739;12897;8721;25863;12460;38760
355290;201609;929;2914;702;2341;148;492;219;672;367;1164
355300;201609;1239;3969;946;3321;210;768;306;1015;516;1783
355310;201609;1064;3116;775;2547;134;475;418;1349;552;1824
355320;201609;598;1814;490;1572;84;331;202;547;286;878
355330;201609;1926;5842;1320;4555;291;1102;565;1837;856;2939
355340;201609;2570;6589;2233;6011;378;1022;1372;3604;1750;4626
355350;201609;1323;4405;1002;3645;245;952;269;932;514;1884
355360;201609;1186;3741;998;3315;187;633;613;2097;800;2730
355365;201609;321;932;195;697;49;174;43;147;92;321
355370;201609;7636;18687;5294;15571;1585;4958;2041;6257;3626;11215
355380;201609;3259;9649;2355;7589;520;1762;545;1509;1065;3271
355385;201609;948;3040;800;2716;262;958;226;684;488;1642
355390;201609;856;2471;597;1903;138;497;218;580;356;1077
355395;201609;1852;5586;1241;4109;198;646;559;1723;757;2369
355400;201609;9016;29403;7447;25935;2233;8320;2060;6733;4293;15053
355410;201609;17407;55460;12919;45834;3974;15256;2423;8452;6397;23708
355420;201609;731;2553;633;2340;192;784;169;616;361;1400
355430;201609;3516;9720;2782;8369;569;1786;1342;3910;1911;5696
355440;201609;937;2860;642;2168;115;393;178;554;293;947
355450;201609;3789;10787;1997;6623;388;1329;621;1904;1009;3233
355460;201609;603;1623;380;1204;80;304;115;285;195;589
355465;201609;344;1101;271;941;60;215;67;220;127;435
355470;201609;790;2359;600;2001;144;514;252;798;396;1312
355475;201609;164;546;150;505;38;136;70;214;108;350
355480;201609;2868;9839;2529;9122;590;2259;1185;4153;1775;6412
355490;201609;994;2828;593;1938;94;308;177;544;271;852
355495;201609;731;2437;612;2174;119;454;175;581;294;1035
355500;201609;7478;21572;4418;14630;800;2819;823;2481;1623;5300
355510;201609;1969;5270;1019;3272;146;552;306;853;452;1405
355520;201609;430;1000;199;541;25;81;92;214;117;295
355530;201609;428;1020;151;480;24;85;37;92;61;177
355535;201609;663;2019;502;1688;159;585;112;310;271;895
355540;201609;8216;25585;7617;24532;1901;6527;3991;12424;5892;18951
355550;201609;737;2248;593;1963;116;429;268;858;384;1287
355560;201609;1226;3656;686;2367;132;513;62;158;194;671
355570;201609;192;601;109;395;18;70;10;38;28;108
355580;201609;1275;3511;787;2506;144;506;313;970;457;1476
355590;201609;226;594;169;488;24;83;94;255;118;338
355600;201609;1169;3537;913;2978;281;967;290;890;571;1857
355610;201609;1649;4526;1171;3568;221;712;534;1565;755;2277
355620;201609;4157;12864;3156;10496;511;1951;1494;4566;2005;6517
355630;201609;3258;9227;1904;6369;401;1402;509;1681;910;3083
355635;201609;928;3010;775;2734;91;350;529;1885;620;2235
355640;201609;3044;9624;2054;7435;414;1637;295;1019;709;2656
355645;201609;3511;11653;3007;10774;499;1982;1767;6209;2266;8191
355650;201609;7652;22566;6369;19996;1179;4296;3836;11130;5015;15426
355660;201609;1263;3962;945;3253;164;676;421;1329;585;2005
355670;201609;2948;9008;1916;6533;347;1316;823;2473;1170;3789
355680;201609;1712;5580;1154;4152;303;1162;167;584;470;1746
355690;201609;479;1500;329;1194;161;604;20;58;181;662
355695;201609;285;886;132;462;10;36;10;23;20;59
355700;201609;5515;17943;4472;15485;1126;3989;1720;5767;2846;9756
355710;201609;10198;25303;5582;16479;1300;4014;1440;3974;2740;7988
355715;201609;313;937;192;654;52;194;33;101;85;295
355720;201609;1539;5066;1186;4193;309;1161;363;1130;672;2291
355730;201609;836;2724;676;2339;218;750;168;574;386;1324
410010;201609;1386;4271;1120;3644;243;843;220;688;463;1531
410020;201609;1148;3706;944;3220;274;956;339;1129;613;2085
410030;201609;1101;3715;845;3076;225;852;154;558;379;1410
410040;201609;9940;32119;8169;28444;1939;7457;2473;8339;4412;15796
410045;201609;1031;2882;665;2127;159;532;139;403;298;935
410050;201609;2554;6979;1432;4656;407;1369;87;200;494;1569
410060;201609;2289;6892;1889;6071;422;1392;791;2545;1213;3937
410070;201609;1759;4919;1236;3844;375;1251;301;883;676;2134
410080;201609;1392;3935;1020;3195;171;597;443;1287;614;1884
410090;201609;995;3048;871;2774;181;634;361;1156;542;1790
410100;201609;2710;8209;1765;5874;390;1416;191;562;581;1978
410105;201609;376;1173;211;752;35;151;32;94;67;245
410110;201609;2853;8248;2090;6669;341;1164;679;2106;1020;3270
410115;201609;528;1423;372;1114;62;208;129;341;191;549
410120;201609;2496;8522;2238;7998;820;3085;652;2316;1472;5401
410130;201609;1061;3308;936;3000;416;1393;213;612;629;2005
410140;201609;17678;45568;10472;31993;2256;7338;2630;7530;4886;14868
410150;201609;16209;40970;7460;22679;1551;4964;1187;3260;2738;8224
410160;201609;3046;9297;2603;8455;685;2479;905;2911;1590;5390
410165;201609;674;1972;506;1566;95;313;226;632;321;945
410170;201609;2316;6586;1576;4897;483;1627;216;614;699;2241
410180;201609;11392;35539;9274;30538;2049;7303;3991;12126;6040;19429
410185;201609;543;1500;376;1162;85;257;74;200;159;457
410190;201609;2096;6127;1518;4783;308;1045;267;750;575;1795
410200;201609;3882;10771;2474;7854;575;2013;354;1038;929;3051
410210;201609;2679;7822;1792;5788;292;1087;398;1034;690;2121
410220;201609;658;1789;430;1351;77;275;152;456;229;731
410230;201609;1453;4520;1178;3919;266;1001;469;1507;735;2508
410240;201609;4394;13151;3721;11746;1204;4246;560;1605;1764;5851
410250;201609;2661;7323;1668;5231;390;1264;321;947;711;2211
410260;201609;1589;4575;1218;3883;274;944;497;1574;771;2518
410270;201609;566;1567;404;1219;46;153;209;607;255;760
410275;201609;862;2564;538;1800;77;274;238;791;315;1065
410280;201609;2256;6460;1495;4825;337;1214;432;1259;769;2473
410290;201609;3407;10123;2702;8719;673;2196;1022;3327;1695;5523
410300;201609;721;2015;571;1691;99;328;252;654;351;982
410302;201609;459;1222;251;818;30;110;130;420;160;530
410304;201609;1247;3905;1083;3533;293;995;388;1304;681;2299
410305;201609;1876;5079;1449;4290;328;1050;732;2134;1060;3184
410310;201609;2313;7294;1949;6576;425;1573;708;2350;1133;3923
410315;201609;654;1845;362;1227;56;199;109;336;165;535
410320;201609;1207;3663;674;2365;103;415;62;186;165;601
410322;201609;548;1593;290;978;46;155;82;268;128;423
410330;201609;1395;3835;1029;3078;225;690;276;804;501;1494
410335;201609;946;2797;776;2447;134;468;295;839;429;1307
410337;201609;817;2155;552;1640;74;251;192;514;266;765
410340;201609;531;1533;324;983;44;147;146;387;190;534
410345;201609;1884;5457;1199;3898;304;1036;276;855;580;1891
410347;201609;709;1917;441;1375;61;221;147;414;208;635
410350;201609;1057;3138;717;2404;145;534;152;435;297;969
410360;201609;3831;10335;2816;8412;386;1300;1478;4202;1864;5502
410370;201609;12143;35381;8122;25589;1478;5104;2386;6465;3864;11569
410380;201609;1345;3873;1169;3498;133;476;588;1721;721;2197
410390;201609;2447;7345;1845;5972;565;1891;403;1182;968;3073
410395;201609;867;2848;749;2590;202;768;305;1034;507;1802
410400;201609;4522;13830;3488;11520;711;2531;1275;3968;1986;6499
410405;201609;861;2457;655;2050;161;571;212;627;373;1198
410410;201609;1263;3884;1196;3780;314;1220;543;1575;857;2795
410420;201609;7010;22530;5332;18463;1312;4882;724;2130;2036;7012
410425;201609;2792;8766;1763;6286;326;1188;208;666;534;1854
410430;201609;14395;38462;9488;28834;1871;6152;2737;7745;4608;13897
410440;201609;2725;8607;2329;7791;607;2202;906;2930;1513;5132
410442;201609;2698;8882;2278;7898;692;2462;619;2123;1311;4585
410445;201609;2334;7584;1897;6696;536;2090;587;2081;1123;4171
410450;201609;2104;5917;1487;4579;384;1211;146;324;530;1535
410460;201609;1839;5374;1323;4268;383;1234;244;749;627;1983
410465;201609;2124;6908;1675;5850;398;1459;574;1880;972;3339
410470;201609;1775;5644;1293;4491;289;1146;264;875;553;2021
410480;201609;31140;87009;16734;54989;3130;10720;1719;4662;4849;15382
410490;201609;11174;34134;7966;26989;1896;7069;2204;6752;4100;13821
410500;201609;1562;4868;1164;3918;438;1622;168;484;606;2106
410510;201609;2509;6587;1572;4607;312;885;582;1592;894;2477
410520;201609;3127;10678;2863;10093;826;3060;1201;4238;2027;7298
410530;201609;1596;4358;966;2946;188;609;238;639;426;1248
410540;201609;3134;9183;2041;6749;400;1349;629;2033;1029;3382
410550;201609;6217;17974;3921;12740;774;2739;531;1542;1305;4281
410560;201609;1279;3760;902;2900;238;855;235;644;473;1499
410570;201609;2654;8260;2213;7415;580;2110;617;2215;1197;4325
410580;201609;21952;65457;16847;54718;4089;14457;5119;15311;9208;29768
410590;201609;1373;4230;742;2479;136;457;168;471;304;928
410600;201609;1863;5360;1408;4420;366;1131;472;1490;838;2621
410610;201609;774;2157;558;1715;66;202;214;634;280;836
410620;201609;1732;5793;1171;4338;271;1070;113;387;384;1457
410630;201609;2487;7295;1558;5118;335;1169;187;478;522;1647
410640;201609;4628;12656;3117;9643;825;2880;478;1331;1303;4211
410645;201609;1127;3875;1028;3693;467;1751;207;782;674;2533
410650;201609;2125;6538;1592;5314;523;1840;226;691;749;2531
410655;201609;850;2372;566;1783;87;323;203;572;290;895
410657;201609;775;2143;511;1575;143;477;151;392;294;869
410660;201609;2979;8386;1459;4843;318;1105;157;454;475;1559
410670;201609;955;2604;584;1805;121;377;188;536;309;913
410680;201609;2929;9437;2185;7550;677;2258;502;1842;1179;4100
410685;201609;656;1873;532;1641;79;274;298;876;377;1150
410690;201609;117367;334366;74997;241158;15320;53290;18116;50299;33436;103589
410700;201609;2235;6641;1961;6078;525;1701;789;2317;1314;4018
410710;201609;922;2672;559;1839;132;436;125;346;257;782
410712;201609;826;2463;697;2209;267;927;155;477;422;1404
410715;201609;906;2870;616;2147;120;445;162;533;282;978
410720;201609;3176;9354;2062;6830;407;1458;388;1116;795;2574
410725;201609;1115;3104;692;2220;112;359;117;333;229;692
410730;201609;521;1458;380;1195;110;364;82;269;192;633
410740;201609;896;2639;589;1987;99;386;252;817;351;1203
410750;201609;1833;5323;1409;4382;285;962;457;1325;742;2287
410752;201609;324;888;152;496;35;128;45;123;80;251
410753;201609;394;1131;215;707;31;120;61;172;92;292
410754;201609;1142;3287;935;2918;73;209;595;2007;668;2216
410755;201609;816;1987;579;1586;75;242;345;880;420;1122
410760;201609;2474;7340;1985;6382;567;1978;570;1759;1137;3737
410765;201609;15183;45270;10347;34974;1653;6119;848;2674;2501;8793
410770;201609;914;2510;584;1817;147;493;101;298;248;791
410773;201609;1353;3833;1165;3525;172;616;808;2359;980;2975
410775;201609;1429;4086;1263;3816;299;990;454;1338;753;2328
410780;201609;555;1511;344;1063;93;277;106;371;199;648
410785;201609;761;2385;586;1954;192;683;150;489;342;1172
410790;201609;432;1409;340;1152;95;329;22;51;117;380
410800;201609;2853;7106;2046;5652;355;1109;724;1819;1079;2928
410810;201609;333;1021;259;855;46;172;96;307;142;479
410820;201609;838;2506;581;1894;138;482;89;275;227;757
410830;201609;30432;85784;22836;71458;6607;22503;7339;21749;13946;44252
410832;201609;1021;2933;835;2555;98;369;480;1359;578;1728
410840;201609;6406;18524;3594;12137;840;2915;289;776;1129;3691
410845;201609;1239;3623;992;3097;207;690;389;1173;596;1863
410850;201609;2691;7998;2278;7225;519;1813;880;2790;1399;4603
410855;201609;599;1640;399;1203;63;201;151;415;214;616
410860;201609;3667;10460;2691;8351;577;1901;830;2421;1407;4322
410865;201609;1498;4980;1394;4782;363;1336;753;2616;1116;3952
410870;201609;1247;3713;1124;3510;156;508;770;2420;926;2928
410880;201609;3808;11929;2857;9807;583;2163;467;1513;1050;3676
410890;201609;916;2968;653;2346;168;664;73;229;241;893
410895;201609;1085;3714;927;3331;336;1294;192;640;528;1934
410900;201609;958;2601;590;1861;93;314;178;515;271;829
410910;201609;409;1064;284;826;34;119;148;403;182;522
410920;201609;840;2327;635;1956;174;605;207;617;381;1222
410930;201609;1639;4835;1275;4065;366;1330;331;982;697;2312
410940;201609;21132;66901;16654;57725;5113;18872;3378;11575;8491;30447
410950;201609;1807;5777;1631;5451;171;606;1219;4057;1390;4663
410960;201609;7542;20597;4343;14304;1333;4738;885;2662;2218;7400
410965;201609;1063;3119;780;2512;216;693;260;797;476;1490
410970;201609;4542;13287;3279;10671;914;3375;523;1605;1437;4980
410975;201609;1622;4555;1199;3711;217;760;437;1261;654;2021
410980;201609;5945;16583;3475;11358;662;2395;935;2841;1597;5236
410990;201609;931;2693;496;1696;175;652;59;145;234;797
411000;201609;484;1451;291;988;53;195;59;156;112;351
411005;201609;487;1431;263;874;46;172;37;107;83;279
411007;201609;2345;7251;1923;6306;529;1837;535;1714;1064;3551
411010;201609;4031;13609;3425;12090;953;3581;400;1355;1353;4936
411020;201609;2539;7703;2113;6928;649;2313;613;1905;1262;4218
411030;201609;667;1779;439;1315;69;233;124;336;193;569
411040;201609;710;2039;284;954;58;209;61;199;119;408
411050;201609;2020;6909;1718;6157;505;1989;242;755;747;2744
411060;201609;1582;4733;1079;3578;224;837;144;417;368;1254
411065;201609;366;1088;272;895;50;156;100;325;150;481
411070;201609;5975;17624;4420;14307;1165;4150;1071;3081;2236;7231
411080;201609;2163;6380;1817;5662;437;1473;488;1496;925;2969
411090;201609;829;2053;531;1565;63;216;99;257;162;473
411095;201609;1376;3855;865;2705;119;430;216;590;335;1020
411100;201609;1313;3775;859;2761;164;622;151;445;315;1067
411110;201609;600;1755;275;943;32;126;27;76;59;202
411120;201609;1638;4910;1134;3733;297;1115;304;867;601;1982
411125;201609;4335;13940;3923;13033;1099;3791;1449;4752;2548;8543
411130;201609;694;2043;487;1573;112;386;129;448;241;834
411140;201609;2201;7415;1783;6371;453;1689;676;2443;1129;4132
411150;201609;4141;11610;2862;8878;655;2185;364;966;1019;3151
411155;201609;966;2643;641;1972;87;296;282;815;369;1111
411160;201609;264;753;185;580;35;115;48;147;83;262
411170;201609;723;2261;562;1874;127;461;179;554;306;1015
411180;201609;5774;17027;4400;14233;968;3409;1438;4558;2406;7967
411190;201609;1437;4113;1123;3470;279;964;235;627;514;1591
411200;201609;4336;12728;3271;10739;864;3067;916;2842;1780;5909
411210;201609;2022;5699;1415;4465;358;1236;175;468;533;1704
411220;201609;1115;3113;839;2576;200;698;319;869;519;1567
411230;201609;1266;3509;756;2456;136;458;271;855;407;1313
411240;201609;1468;3535;733;2170;130;400;269;720;399;1120
411250;201609;2191;6389;1703;5423;474;1633;435;1391;909;3024
411260;201609;324;857;201;631;21;69;90;264;111;333
411270;201609;1799;5544;1496;4906;241;882;691;2138;932;3020
411275;201609;1347;3930;996;3125;234;755;217;618;451;1373
411280;201609;1551;4477;950;3127;170;593;194;603;364;1196
411290;201609;761;2225;540;1730;142;481;140;432;282;913
411295;201609;979;2693;841;2414;136;421;343;995;479;1416
411300;201609;1256;3187;742;2154;69;193;302;795;371;988
411310;201609;869;2333;597;1820;60;205;204;600;264;805
411320;201609;5390;15514;3627;11868;989;3297;630;1876;1619;5173
411325;201609;1528;4739;1287;4212;278;954;600;1989;878;2943
411330;201609;3109;9553;2475;8208;810;2936;549;1848;1359;4784
411340;201609;949;2777;552;1817;53;209;205;635;258;844
411342;201609;743;2073;575;1722;166;521;198;544;364;1065
411345;201609;896;2753;783;2525;193;699;352;1115;545;1814
411350;201609;2777;8219;1870;6252;529;1934;182;561;711;2495
411360;201609;561;1399;328;970;48;169;140;350;188;519
411370;201609;46275;129120;34082;104953;5302;18538;14995;42390;20297;60928
411373;201609;1507;4569;1202;3953;248;925;323;1033;571;1958
411375;201609;1127;3058;749;2275;148;467;218;614;366;1081
411380;201609;1240;3349;642;1932;129;394;177;481;306;875
411390;201609;1782;5200;1295;4063;270;903;320;907;590;1810
411400;201609;2174;6096;1567;4774;327;1081;444;1271;771;2352
411410;201609;2063;6212;1439;4676;335;1186;348;971;683;2157
411420;201609;4099;11512;2490;7942;387;1377;409;1039;796;2416
411430;201609;3310;9775;2637;8571;629;2223;1291;4077;1920;6300
411435;201609;435;1415;348;1180;72;259;135;423;207;682
411440;201609;2731;8643;2248;7549;684;2383;480;1704;1164;4087
411450;201609;2331;7043;2033;6435;420;1347;947;3111;1367;4458
411460;201609;3300;9582;1513;5327;244;939;99;313;343;1252
411470;201609;813;2411;493;1637;81;285;73;203;154;488
411480;201609;4578;13639;3121;10521;781;2884;428;1289;1209;4173
411490;201609;1447;4372;1152;3780;236;822;270;807;506;1629
411500;201609;1851;4892;1213;3704;237;797;353;1050;590;1847
411510;201609;2043;6042;1507;4862;413;1446;260;768;673;2214
411520;201609;27020;73041;14627;46090;2668;8896;3245;9278;5913;18174
411530;201609;1010;2796;664;2125;148;541;135;379;283;920
411535;201609;512;1551;221;801;25;111;19;55;44;166
411540;201609;3014;8102;2002;5967;468;1545;581;1509;1049;3054
411545;201609;988;3199;857;2930;130;459;541;1899;671;2358
411550;201609;802;2152;584;1750;189;616;110;322;299;938
411560;201609;2370;6947;1447;4718;233;814;127;346;360;1160
411570;201609;7029;18525;4812;14735;1161;3941;1047;3201;2208;7142
411573;201609;866;2525;791;2397;120;353;483;1489;603;1842
411575;201609;1614;4964;1280;4231;316;1071;406;1320;722;2391
411580;201609;4012;11425;2329;7740;303;1177;309;825;612;2002
411585;201609;770;2438;351;1237;74;258;57;184;131;442
411590;201609;382;1158;314;1021;47;174;139;416;186;590
411600;201609;313;887;207;704;48;188;78;262;126;450
411605;201609;1703;4642;1085;3293;176;606;403;1176;579;1782
411610;201609;2207;6184;1672;5089;355;1155;703;2068;1058;3223
411620;201609;2813;8677;2463;8075;595;2114;1199;3893;1794;6007
411630;201609;529;1395;319;1063;64;256;52;144;116;400
411640;201609;463;1399;336;1089;43;127;116;341;159;468
411650;201609;203;649;143;519;27;110;26;85;53;195
411660;201609;902;2399;627;1865;93;301;298;863;391;1164
411670;201609;1141;3183;854;2518;179;569;298;822;477;1391
411680;201609;1474;4345;1227;3864;254;878;591;1848;845;2726
411690;201609;3384;9840;2473;8013;682;2244;568;1923;1250;4167
411695;201609;797;2548;585;2053;125;467;188;664;313;1131
411700;201609;1728;4934;1102;3598;228;807;159;452;387;1259
411705;201609;1873;6433;1593;5842;383;1385;767;2975;1150;4360
411710;201609;1726;5039;1246;3974;349;1158;199;630;548;1788
411720;201609;918;2578;637;1975;107;362;184;506;291;868
411721;201609;766;2258;576;1847;147;478;69;205;216;683
411722;201609;672;2023;404;1374;85;322;98;284;183;606
411725;201609;1420;4493;783;2835;181;682;139;499;320;1181
411727;201609;1813;5282;1211;3901;319;1051;223;687;542;1738
411729;201609;609;1564;382;1122;119;353;74;169;193;522
411730;201609;5563;15806;4392;13450;1504;4643;1063;3174;2567;7817
411740;201609;651;1843;360;1173;60;215;92;266;152;481
411745;201609;889;2546;668;2068;128;395;223;678;351;1073
411750;201609;4961;14626;3523;11339;674;2260;1162;3550;1836;5810
411760;201609;7846;22744;6300;19817;2043;6712;1441;4587;3484;11299
411770;201609;3439;11146;2631;9197;760;2818;440;1446;1200;4264
411780;201609;2886;8753;2548;8155;553;1898;1411;4652;1964;6550
411790;201609;3380;9480;2094;6691;538;1858;491;1486;1029;3344
411800;201609;1163;3335;686;2213;110;390;97;257;207;647
411810;201609;1721;4891;1350;4134;279;927;503;1403;782;2330
411820;201609;13778;44019;11005;37917;3829;13536;2426;8477;6255;22013
411830;201609;525;1343;310;939;93;300;14;49;107;349
411840;201609;10594;30042;7168;22911;1679;5768;1362;4271;3041;10039
411845;201609;514;1568;275;927;48;176;34;96;82;272
411850;201609;7301;21523;5548;17753;1402;4799;1500;4596;2902;9395
411860;201609;899;2726;676;2219;144;489;216;661;360;1150
411870;201609;870;2811;550;1924;114;460;105;320;219;780
411880;201609;2320;6616;1651;5330;435;1579;338;953;773;2532
411885;201609;948;2593;717;2153;131;482;255;694;386;1176
411890;201609;1122;3414;664;2261;122;470;54;133;176;603
411900;201609;955;2949;583;1995;135;461;70;238;205;699
411910;201609;1241;4033;877;3115;251;945;202;626;453;1571
411915;201609;17294;46741;9572;30493;1847;6228;2186;6110;4033;12338
411920;201609;871;2911;708;2488;184;743;74;199;258;942
411925;201609;577;1637;361;1194;75;252;83;253;158;505
411930;201609;5935;19371;4976;17352;2326;8652;468;1501;2794;10153
411940;201609;3227;10694;2626;9271;716;2612;520;1748;1236;4360
411950;201609;12029;37693;9798;33047;2236;7998;4391;14367;6627;22365
411960;201609;5520;16103;4811;14679;1052;3550;1962;5692;3014;9242
411965;201609;567;1597;368;1221;69;272;100;327;169;599
411970;201609;778;2152;632;1919;196;607;240;800;436;1407
411980;201609;1669;4925;1343;4198;323;1041;381;1185;704;2226
411990;201609;31845;99346;23544;80869;6053;22648;6535;21169;12588;43817
411995;201609;2566;7701;2066;6725;621;2263;509;1489;1130;3752
412000;201609;2353;5836;1718;4723;246;827;904;2187;1150;3014
412010;201609;718;2409;541;1994;84;321;123;409;207;730
412015;201609;647;1914;493;1574;96;299;232;742;328;1041
412020;201609;388;1133;232;760;42;136;62;182;104;318
412030;201609;710;2197;450;1572;87;341;110;350;197;691
412033;201609;857;2437;513;1624;78;265;139;419;217;684
412035;201609;1006;2751;589;1926;125;425;201;624;326;1049
412040;201609;601;1860;417;1416;82;283;74;245;156;528
412050;201609;1742;4973;1213;3838;207;722;283;854;490;1576
412060;201609;6904;23318;5967;21207;1880;7152;1580;5482;3460;12634
412065;201609;823;2451;596;1950;132;468;163;482;295;950
412070;201609;1376;3657;954;2754;154;468;365;1013;519;1481
412080;201609;1425;4369;723;2647;84;322;23;64;107;386
412085;201609;445;1275;108;380;16;56;14;42;30;98
412090;201609;4637;13993;4201;13170;906;2861;2208;7166;3114;10027
412100;201609;1945;5939;1499;5005;440;1605;324;1056;764;2661
412110;201609;1104;3090;673;2144;161;526;132;429;293;955
412120;201609;1707;5795;1380;4971;367;1460;398;1244;765;2704
412125;201609;662;2132;580;1959;139;497;195;620;334;1117
412130;201609;623;1850;412;1337;108;368;66;200;174;568
412135;201609;502;1417;281;902;61;197;89;272;150;469
412140;201609;1619;4808;1221;3910;285;969;224;655;509;1624
412150;201609;2898;8340;2416;7315;371;1191;1382;4061;1753;5252
412160;201609;1194;3770;662;2380;164;634;73;225;237;859
412170;201609;4598;13969;3565;11806;951;3392;1280;3961;2231;7353
412175;201609;1461;4776;1208;4197;244;926;580;1980;824;2906
412180;201609;1685;5075;1150;3983;268;1049;353;1086;621;2135
412190;201609;3312;9253;2287;7273;474;1624;749;2461;1223;4085
412200;201609;2143;6800;1432;4920;282;1030;427;1459;709;2489
412210;201609;688;1877;345;1117;59;209;43;102;102;311
412215;201609;3642;11013;3195;10173;800;2535;1659;5460;2459;7995
412217;201609;1121;3156;959;2844;98;370;669;1845;767;2215
412220;201609;5756;18470;5225;17372;1569;5217;2246;7615;3815;12832
412230;201609;2854;9320;2297;8064;476;1847;649;2049;1125;3896
412240;201609;8902;22697;4733;14584;899;3069;973;2646;1872;5715
412250;201609;1910;5535;1474;4575;362;1179;193;496;555;1675
412260;201609;1364;3720;786;2406;121;416;301;810;422;1226
412265;201609;1001;3013;845;2728;210;736;320;1020;530;1756
412270;201609;878;2770;550;1930;94;364;173;556;267;920
412280;201609;631;1937;433;1490;146;541;24;54;170;595
412290;201609;1030;2888;731;2315;143;494;227;644;370;1138
412300;201609;1875;5602;1484;4790;380;1297;317;959;697;2256
412310;201609;1023;2951;827;2605;120;434;408;1293;528;1727
412320;201609;895;2357;569;1738;110;412;198;567;308;979
412330;201609;1549;4416;1074;3377;172;584;484;1502;656;2086
412340;201609;965;2983;567;1952;78;275;97;293;175;568
412350;201609;2255;6962;1582;5367;288;990;83;205;371;1195
412360;201609;308;899;164;531;20;81;59;160;79;241
412370;201609;973;2837;650;2195;137;494;118;394;255;888
412380;201609;1554;4876;1198;3990;310;1077;250;806;560;1883
412382;201609;681;1880;421;1308;76;244;93;241;169;485
412385;201609;2384;7300;2015;6439;737;2403;480;1548;1217;3951
412390;201609;2154;6053;1904;5632;477;1545;773;2348;1250;3893
412395;201609;823;2307;608;1900;85;305;332;982;417;1287
412400;201609;932;2912;744;2467;208;734;167;561;375;1295
412402;201609;1882;5533;1366;4418;334;1188;280;798;614;1986
412405;201609;3604;10388;1874;6283;312;1153;99;272;411;1425
412410;201609;5046;15116;3801;12585;1085;4047;734;2227;1819;6274
412420;201609;373;1101;233;753;38;123;72;191;110;314
412430;201609;559;1549;360;1122;62;211;114;327;176;538
412440;201609;3211;9676;2345;7919;560;2062;595;1968;1155;4030
412450;201609;269;893;169;599;27;86;16;43;43;129
412460;201609;745;2316;570;1904;151;528;111;360;262;888
412470;201609;1855;6264;1493;5286;500;1857;287;1063;787;2920
412480;201609;1164;3473;718;2337;121;411;101;252;222;663
412490;201609;927;2725;729;2302;132;432;245;730;377;1162
412500;201609;1978;5651;1492;4627;288;984;346;915;634;1899
412510;201609;2252;7274;1727;5926;563;2096;391;1229;954;3325
412520;201609;1542;4346;1047;3262;306;969;156;433;462;1402
412530;201609;591;1727;400;1255;92;297;82;247;174;544
412535;201609;744;2160;443;1419;84;292;107;309;191;601
412540;201609;1213;3452;817;2580;124;468;244;733;368;1201
412545;201609;772;2205;536;1654;90;319;181;478;271;797
412550;201609;30559;90663;19102;63785;4384;15479;4126;12646;8510;28125
412555;201609;266;783;163;528;28;94;40;106;68;200
412560;201609;5309;16143;3829;12759;755;2931;1047;3273;1802;6204
412570;201609;4283;12418;2564;8555;591;2133;394;1316;985;3449
412575;201609;879;2670;640;2077;138;486;195;579;333;1065
412580;201609;1262;3458;830;2555;151;484;291;824;442;1308
412590;201609;449;1322;263;889;53;187;61;190;114;377
412600;201609;1414;4295;972;3240;203;733;257;787;460;1520
412610;201609;749;2214;441;1417;109;359;121;354;230;713
412620;201609;1233;3847;898;3120;222;887;139;406;361;1293
412625;201609;9768;28017;6701;21492;1351;4575;746;2175;2097;6750
412627;201609;961;2943;628;2153;208;764;85;278;293;1042
412630;201609;3321;10371;2439;8295;490;1655;670;2167;1160;3822
412635;201609;475;1378;288;939;73;236;18;37;91;273
412640;201609;899;2675;510;1721;86;298;42;128;128;426
412650;201609;1737;5150;1378;4417;272;985;403;1171;675;2156
412660;201609;2766;7919;2010;6283;422;1472;422;1139;844;2611
412665;201609;634;1646;318;1006;80;258;70;206;150;464
412667;201609;1685;4796;1226;3821;300;951;288;850;588;1801
412670;201609;566;1723;411;1369;102;383;72;225;174;608
412680;201609;1364;4056;766;2652;125;464;178;538;303;1002
412690;201609;789;2347;548;1794;152;527;102;332;254;859
412700;201609;1848;5554;1505;5000;500;1880;370;1149;870;3029
412710;201609;6935;21710;5415;18256;1181;4356;1287;3918;2468;8274
412720;201609;1394;4263;879;2911;147;517;163;426;310;943
412730;201609;2182;6501;1179;4053;242;884;128;383;370;1267
412740;201609;1455;4604;974;3464;226;868;127;484;353;1352
412750;201609;4058;12201;3497;11180;434;1636;2211;6895;2645;8531
412760;201609;2440;7655;2225;7233;349;1299;1349;4212;1698;5511
412770;201609;11327;31034;5503;17939;816;2838;1026;2884;1842;5722
412780;201609;1320;3994;1051;3422;218;762;399;1217;617;1979
412785;201609;2354;6561;1698;5236;443;1405;738;2299;1181;3704
412788;201609;1413;4456;1159;3900;288;1112;335;963;623;2075
412790;201609;1155;3460;796;2632;163;587;153;410;316;997
412795;201609;993;2702;680;2062;136;416;237;702;373;1118
412796;201609;2737;8310;2385;7548;578;1999;913;2701;1491;4700
412800;201609;3094;8796;2224;6858;363;1220;808;2339;1171;3559
412810;201609;11368;30841;5920;18697;831;2913;1443;3714;2274;6627
412820;201609;7427;21532;5020;16536;1199;4103;1223;3983;2422;8086
412830;201609;370;1130;246;823;42;153;68;205;110;358
412840;201609;1851;5224;1359;4146;254;820;300;897;554;1717
412850;201609;2783;8120;2078;6740;427;1533;642;1899;1069;3432
412853;201609;1740;4986;1462;4376;148;497;798;2228;946;2725
412855;201609;1486;4252;1043;3199;224;746;229;573;453;1319
412860;201609;1191;3382;898;2796;244;829;331;977;575;1806
412862;201609;771;1986;459;1381;72;226;133;402;205;628
412863;201609;1190;3997;1145;3912;170;634;796;2666;966;3300
412865;201609;721;2185;494;1656;109;381;155;545;264;926
412870;201609;952;2683;681;2183;270;951;102;292;372;1243
412880;201609;881;2543;609;1968;131;462;59;143;190;605
420005;201609;543;1615;299;1026;56;201;96;314;152;515
420010;201609;3225;8982;2493;7895;342;1116;1700;5461;2042;6577
420020;201609;754;2424;378;1393;43;189;47;158;90;347
420030;201609;504;1305;235;785;48;188;30;94;78;282
420040;201609;723;2285;384;1473;74;310;24;77;98;387
420050;201609;711;2046;441;1465;113;390;168;553;281;943
420055;201609;206;627;104;375;20;77;14;45;34;122
420060;201609;241;778;147;536;23;102;27;77;50;179
420070;201609;1358;4282;979;3341;175;673;382;1286;557;1959
420075;201609;175;465;76;237;15;47;13;32;28;79
420080;201609;604;1885;464;1591;140;509;117;399;257;908
420090;201609;497;1626;317;1200;76;308;50;196;126;504
420100;201609;1211;3746;1070;3546;240;819;601;2003;841;2822
420110;201609;330;1109;284;992;65;236;99;344;164;580
420120;201609;284;963;220;810;65;274;48;150;113;424
420125;201609;289;1048;256;972;71;288;101;367;172;655
420127;201609;551;1600;184;685;44;178;16;54;60;232
420130;201609;1907;6386;1432;5302;360;1471;301;992;661;2463
420140;201609;4585;13408;2998;10143;696;2567;464;1375;1160;3942
420150;201609;747;2096;427;1428;76;277;174;555;250;832
420160;201609;280;768;158;516;25;86;44;136;69;222
420165;201609;221;682;118;406;24;91;24;76;48;167
420170;201609;214;658;133;490;43;177;17;58;60;235
420180;201609;405;1224;199;726;31;121;44;146;75;267
420190;201609;462;1308;189;669;34;127;15;47;49;174
420195;201609;1402;4048;1053;3402;277;965;264;799;541;1764
420200;201609;2670;8293;1442;5348;290;1221;205;688;495;1909
420205;201609;1051;3376;838;2965;196;757;431;1515;627;2272
420207;201609;1575;4570;1008;3366;283;1035;194;608;477;1643
420208;201609;584;1583;293;1056;94;361;62;240;156;601
420209;201609;324;988;189;655;29;114;82;268;111;382
420210;201609;1853;5548;1124;4227;313;1369;368;1266;681;2635
420213;201609;788;2809;723;2651;175;675;373;1379;548;2054
420215;201609;323;1037;199;714;52;194;12;47;64;241
420220;201609;172;615;137;538;35;147;42;153;77;300
420230;201609;4320;12415;2987;9933;578;2220;1163;3653;1741;5873
420240;201609;11215;31111;6681;22140;1067;4167;2860;8441;3927;12608
420243;201609;606;1829;466;1543;101;361;162;523;263;884
420245;201609;1211;3609;778;2662;120;465;275;838;395;1303
420250;201609;532;1692;462;1544;118;478;192;594;310;1072
420253;201609;501;1299;365;1103;46;132;220;690;266;822
420257;201609;308;846;181;605;35;118;85;284;120;402
420260;201609;1223;3836;974;3347;205;782;364;1231;569;2013
420270;201609;624;1862;181;640;29;110;54;164;83;274
420280;201609;2205;6003;1286;4274;257;936;435;1367;692;2303
420285;201609;148;425;55;203;9;33;1;1;10;34
420287;201609;538;1577;421;1376;140;483;127;418;267;901
420290;201609;6321;18677;3912;12949;756;2616;1175;3593;1931;6209
420300;201609;6928;20579;3929;13785;869;3274;655;2085;1524;5359
420310;201609;788;2106;671;1909;107;334;472;1304;579;1638
420315;201609;971;3043;716;2495;236;873;209;694;445;1567
420320;201609;4770;14585;3701;12538;1143;4196;1220;4014;2363;8210
420325;201609;236;789;205;717;39;149;75;251;114;400
420330;201609;999;3396;679;2565;149;609;176;608;325;1217
420340;201609;1447;4428;991;3322;172;659;108;312;280;971
420350;201609;1488;4372;1015;3407;285;999;351;1127;636;2126
420360;201609;3100;9360;1759;6295;374;1502;150;441;524;1943
420370;201609;1838;5211;1391;4411;171;574;974;3026;1145;3600
420380;201609;5200;15687;3213;11040;769;2828;775;2514;1544;5342
420390;201609;1460;4027;688;2322;120;448;127;326;247;774
420395;201609;1396;4262;843;2941;109;425;105;306;214;731
420400;201609;1296;3759;818;2748;192;719;178;520;370;1239
420410;201609;764;2034;514;1608;100;348;307;943;407;1291
420415;201609;469;1459;317;1086;93;338;90;294;183;632
420417;201609;732;2331;570;1915;108;363;254;850;362;1213
420419;201609;370;1111;214;779;74;291;15;59;89;350
420420;201609;10957;32670;8206;27067;2923;10374;1805;5456;4728;15830
420425;201609;1238;3330;756;2355;88;339;348;990;436;1329
420430;201609;3418;10301;2010;6870;444;1622;611;2066;1055;3688
420435;201609;299;873;169;576;38;142;70;222;108;364
420440;201609;910;2795;475;1644;200;741;83;261;283;1002
420445;201609;389;1134;244;784;54;180;79;244;133;424
420450;201609;831;2492;502;1740;93;347;113;351;206;698
420455;201609;1968;5777;1602;5111;273;1062;764;2274;1037;3336
420460;201609;8988;25946;6350;20989;1407;5283;2447;7507;3854;12790
420470;201609;1114;2932;610;1941;121;428;183;524;304;952
420475;201609;123;353;56;188;17;50;5;15;22;65
420480;201609;5036;14363;3415;11189;940;3263;759;2438;1699;5701
420490;201609;657;1705;324;1114;77;291;73;253;150;544
420500;201609;1549;4859;1093;3920;347;1371;343;1199;690;2570
420510;201609;107;401;81;337;19;92;43;172;62;264
420515;201609;106;351;82;302;12;52;16;57;28;109
420517;201609;838;2584;716;2337;130;481;409;1268;539;1749
420519;201609;555;1450;369;1111;62;189;106;300;168;489
420520;201609;647;1645;354;1160;68;232;92;248;160;480
420530;201609;1066;3505;722;2683;172;734;171;553;343;1287
420535;201609;262;758;110;399;29;95;9;42;38;137
420540;201609;22335;62494;14367;45013;3443;11637;3832;10073;7275;21710
420543;201609;393;1018;287;836;25;82;184;567;209;649
420545;201609;1554;4844;1171;3970;270;1011;355;1125;625;2136
420550;201609;4192;13067;2826;10130;756;3146;509;1663;1265;4809
420555;201609;361;1082;254;851;58;219;86;259;144;478
420560;201609;541;1539;390;1260;68;228;179;566;247;794
420570;201609;2201;6900;1558;5370;413;1606;490;1514;903;3120
420580;201609;1534;4635;1162;3968;278;1066;470;1552;748;2618
420590;201609;3339;9923;1963;6634;396;1445;339;963;735;2408
420600;201609;930;2999;823;2767;130;455;475;1641;605;2096
420610;201609;529;1586;262;963;59;248;58;213;117;461
420620;201609;577;1780;483;1573;122;419;138;448;260;867
420630;201609;1024;3130;686;2321;151;536;244;764;395;1300
420640;201609;797;2377;338;1260;89;365;26;86;115;451
420650;201609;2600;7540;1452;4995;246;891;359;1128;605;2019
420660;201609;476;1378;311;1019;70;255;91;276;161;531
420665;201609;709;1977;430;1423;67;236;139;410;206;646
420670;201609;1711;5003;1086;3642;221;852;275;822;496;1674
420675;201609;207;662;139;496;28;108;39;131;67;239
420680;201609;529;1253;289;875;50;171;102;289;152;460
420690;201609;878;2980;573;2109;94;340;94;289;188;629
420700;201609;3268;9544;2319;7518;480;1690;780;2353;1260;4043
420710;201609;629;2065;439;1630;118;488;140;480;258;968
420720;201609;1772;4947;1305;4281;369;1274;604;1955;973;3229
420730;201609;3342;9890;2602;8524;622;2214;1057;3324;1679;5538
420740;201609;829;2549;638;2146;221;804;216;660;437;1464
420750;201609;2421;7621;1598;5634;256;1024;512;1582;768;2606
420757;201609;106;252;43;151;6;25;20;72;26;97
420760;201609;377;1162;175;586;40;145;27;70;67;215
420765;201609;587;1844;276;1037;59;243;53;183;112;426
420768;201609;1215;4151;934;3543;394;1503;283;1133;677;2636
420770;201609;647;1880;317;1172;70;302;65;239;135;541
420775;201609;649;1918;337;1133;79;281;57;165;136;446
420780;201609;1521;4583;820;2805;171;590;132;433;303;1023
420785;201609;287;860;194;625;32;107;47;137;79;244
420790;201609;1278;4327;946;3516;293;1186;316;1098;609;2284
420800;201609;894;2494;397;1332;98;347;102;326;200;673
420810;201609;2052;6894;1542;5716;473;1978;325;1079;798;3057
420820;201609;8457;25079;5523;19677;1401;5573;1403;4780;2804;10353
420830;201609;2794;8664;2188;7455;631;2326;734;2433;1365;4759
420840;201609;1010;2956;429;1576;94;386;72;230;166;616
420845;201609;1384;4103;890;3165;250;1009;198;653;448;1662
420850;201609;1644;5108;904;3437;196;831;57;199;253;1030
420860;201609;448;1248;255;872;68;271;71;232;139;503
420870;201609;1149;3191;847;2666;291;1048;226;618;517;1666
420880;201609;1014;3357;720;2561;151;582;128;420;279;1002
420890;201609;10215;26889;4607;15165;764;2700;1138;3197;1902;5897
420895;201609;251;682;113;371;33;109;12;35;45;144
420900;201609;1861;5198;1089;3636;214;808;288;859;502;1667
420910;201609;24926;73061;15428;52977;2909;11108;4739;14801;7648;25909
420915;201609;556;2169;390;1661;82;364;158;620;240;984
420917;201609;483;1483;192;643;38;146;75;219;113;365
420920;201609;185;524;70;252;15;62;12;47;27;109
420930;201609;18406;52408;13356;43113;2925;10249;5168;15815;8093;26064
420940;201609;2888;8596;2030;6756;535;1950;161;425;696;2375
420945;201609;201;610;121;419;24;99;32;94;56;193
420950;201609;644;1774;264;983;32;160;51;172;83;332
420960;201609;958;2690;691;2182;142;482;286;839;428;1321
420970;201609;2541;7897;1967;6780;636;2386;500;1630;1136;4016
420980;201609;465;1349;334;1125;114;420;114;420;228;840
420985;201609;502;1419;214;766;39;174;52;159;91;333
420990;201609;896;2417;450;1533;69;252;83;227;152;479
421000;201609;574;1925;336;1293;69;286;56;171;125;457
421003;201609;734;1974;226;770;24;90;37;86;61;176
421005;201609;156;478;115;408;22;87;57;207;79;294
421010;201609;5326;15022;3424;11422;842;3093;701;2055;1543;5148
421020;201609;488;1487;350;1226;41;153;195;695;236;848
421030;201609;747;2680;645;2407;192;791;89;309;281;1100
421040;201609;919;2301;540;1668;90;326;276;804;366;1130
421050;201609;1667;4737;888;2999;179;652;195;562;374;1214
421055;201609;194;545;91;287;21;72;18;35;39;107
421060;201609;526;1751;327;1197;73;292;104;376;177;668
421070;201609;696;2213;393;1432;89;344;57;188;146;532
421080;201609;537;1629;450;1492;89;287;290;973;379;1260
421085;201609;561;1482;253;870;52;199;69;207;121;406
421090;201609;431;1192;187;622;23;92;65;193;88;285
421100;201609;962;2584;443;1433;129;428;42;123;171;551
421105;201609;1500;4496;1158;3871;263;937;369;1278;632;2215
421110;201609;1000;3554;888;3280;318;1248;183;600;501;1848
421120;201609;1361;4354;821;2952;120;517;224;697;344;1214
421125;201609;410;1126;286;905;87;305;81;220;168;525
421130;201609;3381;10972;2755;9705;912;3469;863;3026;1775;6495
421140;201609;356;1017;246;783;51;158;87;262;138;420
421145;201609;571;1787;319;1106;49;168;100;339;149;507
421150;201609;604;1748;414;1411;81;306;169;554;250;860
421160;201609;1237;3380;552;1827;113;414;181;546;294;960
421165;201609;286;965;203;724;30;101;87;318;117;419
421170;201609;1339;3825;1025;3292;203;704;585;1840;788;2544
421175;201609;1260;3493;807;2673;163;644;289;855;452;1499
421180;201609;578;1591;272;921;60;237;42;122;102;359
421185;201609;409;1133;274;863;44;121;137;458;181;579
421187;201609;290;846;205;669;43;147;86;253;129;400
421189;201609;419;1282;317;1055;63;228;89;271;152;499
421190;201609;11791;33473;6431;22317;1370;5189;954;2971;2324;8160
421200;201609;948;3070;760;2645;168;603;218;715;386;1318
421205;201609;264;809;185;641;41;168;43;126;84;294
421210;201609;1515;4590;1061;3489;286;959;281;916;567;1875
421220;201609;1956;6553;1623;5776;470;1857;269;808;739;2665
421223;201609;535;1678;372;1322;99;369;119;419;218;788
421225;201609;1142;3599;918;3115;196;735;366;1230;562;1965
421227;201609;810;2567;695;2367;151;564;386;1264;537;1828
421230;201609;455;1474;380;1323;88;339;170;569;258;908
421240;201609;419;1317;193;711;23;100;36;112;59;212
421250;201609;1749;4977;1025;3616;283;1053;207;724;490;1777
421260;201609;360;1021;85;312;20;71;18;60;38;131
421265;201609;771;2332;667;2156;110;399;409;1281;519;1680
421270;201609;857;2259;384;1273;75;252;75;269;150;521
421280;201609;1657;5175;1237;4396;364;1467;417;1373;781;2840
421290;201609;1005;2799;528;1733;100;342;94;274;194;616
421300;201609;308;930;222;737;63;251;86;251;149;502
421310;201609;243;748;176;586;33;120;61;190;94;310
421315;201609;362;1043;175;628;29;103;19;69;48;172
421320;201609;670;2012;357;1218;60;217;64;154;124;371
421330;201609;569;1840;414;1523;125;499;80;308;205;807
421335;201609;509;1681;393;1429;90;375;80;297;170;672
421340;201609;1768;4996;1336;4270;191;753;743;2290;934;3043
421350;201609;1013;3299;824;2884;147;607;423;1400;570;2007
421360;201609;3005;8568;1709;5917;392;1512;489;1493;881;3005
421370;201609;691;2292;506;1876;137;560;143;513;280;1073
421380;201609;974;2729;767;2308;115;387;386;1121;501;1508
421390;201609;177;503;68;237;25;96;23;69;48;165
421400;201609;279;934;183;739;49;218;58;213;107;431
421410;201609;336;957;194;655;25;86;88;294;113;380
421415;201609;368;1199;150;562;35;135;27;93;62;228
421420;201609;879;2625;606;1987;96;339;220;666;316;1005
421430;201609;237;733;170;597;27;103;37;134;64;237
421440;201609;854;2460;546;1880;124;489;226;747;350;1236
421450;201609;471;1431;245;902;43;172;27;105;70;277
421460;201609;645;1760;311;1104;59;238;69;242;128;480
421470;201609;435;1443;326;1185;93;371;88;299;181;670
421480;201609;3163;8875;1826;6319;603;2411;252;615;855;3026
421490;201609;279;841;112;436;22;103;19;62;41;165
421500;201609;2214;7455;1726;6347;548;2255;214;742;762;2997
421505;201609;359;1191;309;1077;70;243;140;491;210;734
421507;201609;529;1592;309;1094;65;241;91;331;156;572
421510;201609;179;587;144;523;24;115;70;199;94;314
421520;201609;899;2394;541;1628;66;243;232;601;298;844
421530;201609;418;1285;233;861;39;176;54;184;93;360
421535;201609;686;1977;347;1243;55;226;142;456;197;682
421540;201609;328;875;235;710;49;159;84;220;133;379
421545;201609;845;2648;568;2074;136;551;151;516;287;1067
421550;201609;2043;6433;1654;5718;496;1901;506;1628;1002;3529
421555;201609;328;956;97;349;18;70;14;45;32;115
421560;201609;210;642;81;284;17;60;15;54;32;114
421565;201609;851;2453;726;2271;248;867;295;925;543;1792
421567;201609;638;2332;542;2099;277;1092;109;424;386;1516
421568;201609;515;1574;310;1069;68;245;87;294;155;539
421569;201609;231;696;93;344;14;51;15;56;29;107
421570;201609;1402;4203;715;2502;186;700;115;364;301;1064
421575;201609;446;1450;363;1259;68;240;190;669;258;909
421580;201609;3066;9627;2122;7442;537;2083;537;1638;1074;3721
421590;201609;220;678;171;579;23;82;92;302;115;384
421600;201609;542;1628;365;1214;84;300;81;227;165;527
421605;201609;641;1937;435;1532;84;328;122;398;206;726
421610;201609;1426;3846;953;2940;147;507;421;1200;568;1707
421620;201609;4573;13663;2845;9962;794;2945;794;2715;1588;5660
421625;201609;383;1056;132;453;28;90;13;46;41;136
421630;201609;3062;9017;1500;5210;344;1280;230;728;574;2008
421635;201609;243;725;117;387;15;58;35;93;50;151
421640;201609;1074;3158;723;2447;159;543;275;915;434;1458
421650;201609;2151;6861;1479;5231;367;1478;188;535;555;2013
421660;201609;7852;25175;6074;21358;1383;5372;1873;6011;3256;11383
421670;201609;1102;3315;704;2389;182;696;210;652;392;1348
421680;201609;1149;3655;903;3113;292;1044;175;575;467;1619
421690;201609;1645;5312;1133;4066;240;946;113;342;353;1288
421700;201609;505;1609;252;938;47;187;61;194;108;381
421710;201609;214;713;101;372;22;85;28;90;50;175
421715;201609;262;695;130;415;32;111;36;98;68;209
421720;201609;1878;5487;1046;3693;267;1022;156;443;423;1465
421725;201609;134;420;102;348;28;101;23;69;51;170
421730;201609;600;1722;259;883;42;150;60;177;102;327
421740;201609;776;2473;496;1769;115;462;94;283;209;745
421750;201609;1033;2743;595;1849;113;381;234;659;347;1040
421755;201609;320;928;172;561;38;139;53;171;91;310
421760;201609;855;2559;383;1389;73;283;89;281;162;564
421770;201609;3056;9097;2152;7212;579;2019;688;2344;1267;4363
421775;201609;506;1472;334;1140;59;230;117;368;176;598
421780;201609;1210;4038;852;3146;212;881;225;741;437;1622
421790;201609;816;2173;446;1543;121;456;110;329;231;785
421795;201609;355;1035;207;668;34;122;60;188;94;310
421800;201609;2787;8232;1970;6592;462;1739;737;2281;1199;4020
421810;201609;619;1903;411;1456;109;425;56;178;165;603
421820;201609;1039;3012;580;1987;96;335;100;292;196;627
421825;201609;1466;4620;1350;4357;158;599;972;3049;1130;3648
421830;201609;2493;8437;2111;7598;512;2040;762;2550;1274;4590
421835;201609;161;472;115;403;19;85;73;244;92;329
421840;201609;298;948;199;715;46;191;65;202;111;393
421850;201609;411;1328;222;818;37;159;45;155;82;314
421860;201609;321;982;188;683;34;136;43;127;77;263
421870;201609;3985;11168;2509;8042;773;2678;477;1436;1250;4114
421875;201609;412;1236;161;612;35;151;17;58;52;209
421880;201609;880;2682;604;2060;126;486;129;400;255;886
421885;201609;311;983;237;832;77;286;75;252;152;538
421890;201609;879;2972;737;2672;255;1080;221;717;476;1797
421895;201609;374;1182;327;1098;67;241;186;625;253;866
421900;201609;976;2713;562;1823;153;519;156;471;309;990
421910;201609;487;1541;303;1113;71;308;43;113;114;421
421915;201609;510;1515;284;954;56;177;59;189;115;366
421917;201609;598;1690;398;1366;152;587;118;386;270;973
421920;201609;767;2132;475;1720;255;962;98;356;353;1318
421930;201609;3218;8420;1617;5461;385;1385;217;641;602;2026
421935;201609;674;2182;472;1720;97;422;166;555;263;977
421940;201609;283;950;135;511;17;73;29;88;46;161
421950;201609;3715;10031;1583;5412;384;1402;203;666;587;2068
421960;201609;202;601;138;475;30;112;31;98;61;210
421970;201609;2334;6401;1331;4266;397;1318;389;1140;786;2458
421985;201609;499;1291;244;760;38;142;78;242;116;384
422000;201609;1207;3624;950;3097;267;956;362;1161;629;2117
430003;201609;800;2322;586;1937;154;580;157;492;311;1072
430005;201609;335;993;232;786;49;178;97;310;146;488
430010;201609;2182;5859;1572;4781;401;1279;636;1946;1037;3225
430020;201609;726;1802;579;1576;89;278;351;905;440;1183
430030;201609;1059;2741;726;2110;248;768;122;313;370;1081
430040;201609;11291;29390;7678;22517;2114;6715;1145;3057;3259;9772
430045;201609;708;1896;494;1458;96;289;202;575;298;864
430047;201609;297;695;132;391;18;50;52;153;70;203
430050;201609;1052;2849;540;1722;112;358;141;428;253;786
430055;201609;312;828;153;479;24;85;65;191;89;276
430057;201609;76;177;31;89;4;9;5;6;9;15
430060;201609;16854;53060;13978;47703;4037;14752;5443;18574;9480;33326
430063;201609;1011;2940;763;2404;205;656;359;1158;564;1814
430064;201609;1350;3962;1040;3367;267;865;343;1133;610;1998
430066;201609;170;401;114;307;10;33;64;169;74;202
430070;201609;628;1658;151;499;27;102;21;50;48;152
430080;201609;711;1990;398;1344;95;350;110;320;205;670
430085;201609;935;2415;545;1686;103;347;174;549;277;896
430087;201609;935;2834;833;2627;141;519;482;1381;623;1900
430090;201609;844;2202;277;903;36;127;52;175;88;302
430100;201609;862;2268;416;1319;102;349;110;289;212;638
430105;201609;1033;2975;650;2228;154;593;211;692;365;1285
430107;201609;262;861;178;623;34;131;46;146;80;277
430110;201609;1959;5566;1531;4857;377;1241;702;2130;1079;3371
430120;201609;1785;5240;1250;4069;271;905;557;1778;828;2683
430130;201609;3912;10010;3135;8721;825;2397;1198;3223;2023;5620
430140;201609;1214;3667;770;2638;222;779;229;768;451;1547
430150;201609;779;2065;471;1445;110;360;121;371;231;731
430155;201609;407;1117;188;629;32;120;45;137;77;257
430160;201609;17364;49545;14335;44077;3547;11710;5673;17369;9220;29079
430163;201609;2004;5808;1540;4966;227;821;830;2610;1057;3431
430165;201609;473;1166;111;375;14;47;17;52;31;99
430170;201609;967;2715;321;1170;44;165;33;97;77;262
430175;201609;929;2867;731;2392;207;636;278;987;485;1623
430180;201609;856;2331;659;1978;150;498;331;953;481;1451
430185;201609;603;1555;312;958;55;176;102;265;157;441
430187;201609;669;1951;483;1544;118;417;156;460;274;877
430190;201609;1722;5076;1437;4503;289;978;771;2370;1060;3348
430192;201609;201;609;75;243;6;18;16;47;22;65
430195;201609;392;1189;73;252;9;33;2;7;11;40
430200;201609;1437;4523;1171;3927;355;1258;285;913;640;2171
430205;201609;596;1685;429;1364;44;164;297;932;341;1096
430210;201609;6563;17183;3533;10666;577;1906;1004;2520;1581;4426
430215;201609;366;1009;235;716;43;135;99;285;142;420
430220;201609;749;1889;234;817;37;156;37;123;74;279
430222;201609;282;854;211;692;29;112;99;305;128;417
430223;201609;365;1024;287;876;71;204;133;421;204;625
430225;201609;36;88;16;45;4;12;5;12;9;24
430230;201609;1671;4900;1583;4799;217;527;1311;4158;1528;4685
430235;201609;292;945;221;767;52;196;68;217;120;413
430237;201609;543;1388;373;1083;39;132;236;647;275;779
430240;201609;1049;2691;654;2006;82;301;348;1004;430;1305
430245;201609;871;2663;637;2159;182;626;246;869;428;1495
430250;201609;1212;3446;1010;3078;357;1126;137;411;494;1537
430258;201609;164;461;116;374;10;34;51;174;61;208
430260;201609;810;2261;539;1699;69;223;283;926;352;1149
430265;201609;297;914;226;768;55;175;29;100;84;275
430270;201609;2999;8239;2489;7345;376;1248;1465;4125;1841;5373
430280;201609;4826;12823;3694;10765;879;2623;1627;4726;2506;7349
430290;201609;2517;6509;2270;6141;153;431;1964;5290;2117;5721
430300;201609;9442;27429;7421;23381;1771;5978;3235;10232;5006;16210
430310;201609;6856;20361;4961;16531;1190;4297;1868;5764;3058;10061
430320;201609;872;2506;506;1690;106;311;229;793;335;1104
430330;201609;691;1822;506;1457;140;392;213;581;353;973
430340;201609;712;1773;349;1139;74;243;178;572;252;815
430350;201609;6355;19167;5095;16386;2011;6607;1400;4350;3411;10957
430355;201609;391;974;128;393;25;89;20;55;45;144
430360;201609;1072;2796;807;2288;172;539;340;882;512;1421
430367;201609;289;761;162;507;40;148;54;159;94;307
430370;201609;572;1572;333;1068;86;297;69;189;155;486
430380;201609;869;2234;436;1421;144;505;112;356;256;861
430390;201609;4002;11174;2380;7700;451;1562;369;1103;820;2665
430400;201609;1437;3391;989;2647;322;895;356;890;678;1785
430410;201609;636;1693;425;1305;78;252;205;620;283;872
430420;201609;3685;10573;2732;8414;778;2448;942;2814;1720;5262
430430;201609;763;2026;426;1377;129;442;102;331;231;773
430435;201609;2083;5589;1470;4433;395;1258;519;1550;914;2808
430440;201609;4077;12679;3025;10208;631;2214;1386;4794;2017;7008
430450;201609;7630;20924;5673;17024;1915;5957;1361;4101;3276;10058
430460;201609;29072;85087;21092;69958;5857;21158;6025;19135;11882;40293
430461;201609;512;1356;145;462;22;70;39;119;61;189
430462;201609;278;792;163;575;32;123;27;99;59;222
430463;201609;4330;13599;3591;12154;803;2911;1622;5528;2425;8439
430465;201609;654;1757;528;1525;146;459;272;763;418;1222
430466;201609;3674;9995;3113;9066;703;2187;1613;4519;2316;6706
430467;201609;512;1504;414;1300;89;303;171;500;260;803
430468;201609;1481;4094;1202;3640;306;968;460;1336;766;2304
430469;201609;484;1308;55;193;8;26;7;18;15;44
430470;201609;7875;20851;5133;15965;1544;5090;869;2622;2413;7712
430471;201609;583;1894;490;1675;143;502;112;397;255;899
430480;201609;1021;2692;472;1540;77;269;107;309;184;578
430485;201609;216;592;85;272;16;57;13;30;29;87
430490;201609;324;929;201;659;42;143;86;281;128;424
430495;201609;380;1142;234;812;50;186;65;206;115;392
430500;201609;1213;3313;944;2855;235;793;434;1264;669;2057
430510;201609;22005;63538;16517;52389;5362;18350;4589;13417;9951;31767
430511;201609;402;1234;156;546;25;93;16;39;41;132
430512;201609;1175;2991;946;2567;255;733;285;785;540;1518
430513;201609;818;2102;428;1251;107;334;162;435;269;769
430515;201609;488;1389;327;1045;50;162;150;490;200;652
430517;201609;1199;3749;956;3230;195;674;493;1686;688;2360
430520;201609;1592;4391;945;2969;229;789;247;665;476;1454
430530;201609;1118;2978;476;1524;74;267;119;323;193;590
430535;201609;2471;7390;1760;5922;390;1415;659;2125;1049;3540
430537;201609;486;1543;409;1380;36;118;298;1011;334;1129
430540;201609;750;1655;487;1290;90;246;275;723;365;969
430543;201609;499;1275;430;1195;85;246;296;843;381;1089
430544;201609;686;2176;544;1844;124;457;249;802;373;1259
430545;201609;1359;4300;1146;4020;385;1437;471;1663;856;3100
430550;201609;645;1852;354;1167;80;289;68;201;148;490
430558;201609;104;282;50;153;12;42;11;23;23;65
430560;201609;392;945;150;480;17;65;59;166;76;231
430570;201609;1138;2901;675;1968;151;508;272;671;423;1179
430580;201609;1296;3234;751;2308;128;437;362;1110;490;1547
430583;201609;170;466;44;143;3;9;8;24;11;33
430585;201609;342;892;204;592;46;161;85;214;131;375
430587;201609;190;603;153;507;45;152;39;137;84;289
430590;201609;1269;3467;1136;3226;127;404;834;2304;961;2708
430593;201609;24;88;20;74;5;20;9;31;14;51
430595;201609;308;862;78;263;7;34;9;20;16;54
430597;201609;350;1015;209;667;26;87;57;148;83;235
430600;201609;2110;5597;991;3016;196;602;292;815;488;1417
430605;201609;1377;4096;1013;3327;199;732;398;1285;597;2017
430607;201609;776;1849;551;1497;70;193;357;992;427;1185
430610;201609;8287;22021;6019;18194;1733;5621;1477;4348;3210;9969
430613;201609;274;666;96;283;16;41;19;46;35;87
430620;201609;764;2143;577;1760;138;437;231;666;369;1103
430630;201609;444;1373;195;659;36;117;27;82;63;199
430632;201609;704;1957;316;1011;58;196;101;281;159;477
430635;201609;608;1732;446;1386;108;381;222;650;330;1031
430637;201609;484;1365;414;1224;59;201;239;663;298;864
430640;201609;1683;4485;647;2152;92;285;36;82;128;367
430642;201609;489;1266;287;881;53;159;128;391;181;550
430645;201609;276;638;89;256;14;39;24;71;38;110
430650;201609;1842;5893;1515;5210;328;1161;806;2797;1134;3958
430655;201609;167;427;142;378;28;100;73;156;101;256
430660;201609;5858;16305;4431;13647;1107;3650;1791;5427;2898;9077
430670;201609;517;1474;461;1365;38;112;357;1091;395;1203
430673;201609;760;1787;314;951;73;222;92;266;165;488
430675;201609;270;788;87;298;10;47;31;94;41;141
430676;201609;3726;10994;2898;9359;735;2516;923;2993;1658;5509
430680;201609;1154;3285;642;2121;135;447;145;412;280;859
430690;201609;4363;12249;3264;9989;1079;3366;725;2208;1804;5574
430692;201609;271;872;197;728;19;82;131;461;150;543
430693;201609;1301;3557;760;2413;158;565;168;487;326;1052
430695;201609;581;1577;356;1094;67;216;135;373;202;589
430697;201609;492;1366;336;1067;91;298;117;370;208;668
430700;201609;10390;26473;4510;14793;856;3130;286;816;1142;3946
430705;201609;287;855;218;694;76;260;53;142;129;402
430710;201609;1812;4542;1279;3613;258;812;518;1468;776;2280
430720;201609;890;2150;524;1590;130;404;156;467;286;871
430730;201609;1649;4244;1009;3120;227;705;410;1309;637;2014
430740;201609;592;1637;297;1000;71;242;55;192;126;434
430745;201609;508;1425;201;640;27;91;33;106;60;197
430750;201609;1602;4352;1225;3689;235;788;652;1898;887;2686
430755;201609;515;1386;289;892;30;104;132;378;162;482
430760;201609;3098;7501;2043;5920;438;1482;776;2325;1214;3807
430770;201609;6469;18533;4884;15478;957;3237;2523;7804;3480;11041
430780;201609;2501;6610;1396;4436;284;958;427;1303;711;2261
430781;201609;541;1543;327;1079;70;233;80;263;150;496
430783;201609;550;1337;306;898;55;174;144;389;199;563
430786;201609;75;250;45;169;6;27;9;27;15;54
430790;201609;4862;13197;3096;9528;700;2313;1143;3241;1843;5554
430800;201609;918;2561;577;1774;128;420;193;568;321;988
430805;201609;569;1585;340;1082;38;109;172;542;210;651
430807;201609;456;1282;283;888;60;217;83;234;143;451
430810;201609;707;1913;228;783;50;182;49;163;99;345
430820;201609;1382;4025;755;2586;166;590;154;496;320;1086
430825;201609;406;1050;122;365;25;63;21;44;46;107
430830;201609;1761;5395;1584;5112;262;918;986;3123;1248;4041
430840;201609;1012;2997;864;2709;230;712;401;1285;631;1997
430843;201609;87;223;38;115;4;15;15;39;19;54
430845;201609;269;801;207;662;95;318;18;42;113;360
430850;201609;2537;7394;2036;6391;551;1889;747;2243;1298;4132
430860;201609;1061;2812;496;1615;117;445;159;461;276;906
430865;201609;638;1671;554;1531;184;525;243;644;427;1169
430870;201609;731;2004;333;1096;83;285;65;171;148;456
430880;201609;1216;3382;807;2550;211;701;219;723;430;1424
430885;201609;257;616;140;437;20;66;94;293;114;359
430890;201609;1789;4703;1018;3103;141;516;258;663;399;1179
430900;201609;2900;7552;2179;6245;448;1503;993;2612;1441;4115
430905;201609;1080;3045;629;2070;158;539;129;388;287;927
430910;201609;1607;4665;1014;3348;231;862;360;1018;591;1880
430912;201609;466;1319;340;1084;44;147;217;686;261;833
430915;201609;593;1833;395;1443;134;514;84;336;218;850
430920;201609;17269;51729;14691;46662;2843;9896;8322;25519;11165;35415
430925;201609;142;316;53;155;10;30;18;53;28;83
430930;201609;10109;28234;6396;21007;1825;6301;1414;4812;3239;11113
430940;201609;1296;3906;681;2363;169;621;93;271;262;892
430950;201609;999;2724;623;1923;154;524;214;579;368;1103
430955;201609;170;496;71;234;13;52;20;57;33;109
430957;201609;268;862;209;748;45;158;92;339;137;497
430960;201609;1405;3719;1074;3120;262;841;499;1442;761;2283
430965;201609;1565;4314;1284;3810;76;277;1013;2930;1089;3207
430970;201609;528;1422;279;879;57;184;75;213;132;397
430975;201609;604;1931;438;1520;98;359;180;631;278;990
430980;201609;447;1093;241;763;56;173;84;258;140;431
430990;201609;590;1851;354;1214;67;243;99;328;166;571
430995;201609;625;1770;452;1403;126;402;164;483;290;885
431000;201609;1642;4162;690;2147;118;385;56;155;174;540
431010;201609;2758;7677;1439;4948;267;984;195;579;462;1563
431020;201609;11501;27849;6742;19163;1758;5133;1692;4615;3450;9748
431030;201609;326;938;133;486;28;108;18;62;46;170
431033;201609;2488;7203;2125;6613;596;1959;941;2961;1537;4920
431036;201609;223;571;87;286;15;48;19;48;34;96
431040;201609;960;2707;729;2278;149;549;349;1007;498;1556
431041;201609;539;1400;447;1259;138;403;170;487;308;890
431043;201609;508;1423;268;943;114;415;55;179;169;594
431046;201609;117;333;77;243;7;26;24;72;31;98
431050;201609;1685;4235;1164;3312;298;870;544;1522;842;2392
431053;201609;613;1934;469;1606;146;544;101;336;247;880
431055;201609;682;1811;624;1715;77;195;458;1277;535;1472
431057;201609;380;1105;222;751;48;174;56;173;104;347
431060;201609;5626;16560;4791;15103;1527;4959;1552;4959;3079;9918
431065;201609;566;1617;385;1228;65;237;133;378;198;615
431070;201609;723;2029;361;1159;87;275;59;150;146;425
431075;201609;298;892;201;678;35;125;62;224;97;349
431080;201609;655;1987;426;1430;95;327;111;347;206;674
431085;201609;855;2312;652;1882;108;325;378;1073;486;1398
431087;201609;594;1660;493;1456;52;146;334;1001;386;1147
431090;201609;551;1342;210;664;49;160;40;112;89;272
431100;201609;3717;10233;2869;8704;748;2442;892;2582;1640;5024
431110;201609;1572;4113;1086;3110;251;746;370;984;621;1730
431112;201609;573;1838;512;1706;126;429;246;781;372;1210
431113;201609;526;1489;390;1210;104;336;100;322;204;658
431115;201609;1395;3980;1181;3596;216;653;647;1978;863;2631
431120;201609;2752;8304;2002;6710;653;2469;597;1776;1250;4245
431123;201609;464;1336;282;958;66;215;141;485;207;700
431125;201609;1384;4124;912;3066;297;1009;182;674;479;1683
431127;201609;260;705;51;166;8;22;8;20;16;42
431130;201609;3472;9862;2321;7551;482;1680;751;2414;1233;4094
431140;201609;5011;12232;2497;7729;395;1301;730;1989;1125;3290
431142;201609;473;1369;392;1218;51;167;251;791;302;958
431150;201609;1126;3312;818;2668;179;640;277;879;456;1519
431160;201609;912;2634;734;2282;132;385;352;1196;484;1581
431162;201609;528;1310;174;595;26;89;23;58;49;147
431164;201609;171;474;44;158;10;39;3;12;13;51
431170;201609;733;2006;489;1545;144;471;132;400;276;871
431171;201609;802;2323;668;2046;194;624;229;671;423;1295
431173;201609;487;1398;371;1187;141;488;90;265;231;753
431175;201609;1050;2925;835;2537;245;786;227;652;472;1438
431177;201609;818;2635;609;2208;198;791;229;802;427;1593
431179;201609;376;817;90;260;18;58;20;45;38;103
431180;201609;2394;6748;1499;4887;360;1252;277;834;637;2086
431190;201609;644;1781;321;1041;49;171;62;170;111;341
431198;201609;368;1206;320;1111;116;413;89;329;205;742
431200;201609;409;1153;93;325;11;36;4;10;15;46
431205;201609;295;883;131;456;30;92;36;131;66;223
431210;201609;786;2070;613;1778;171;488;306;914;477;1402
431213;201609;232;706;172;583;23;90;89;298;112;388
431215;201609;306;886;149;516;28;94;9;25;37;119
431217;201609;165;506;116;393;33;115;41;140;74;255
431220;201609;872;2362;463;1452;43;147;208;590;251;737
431225;201609;1373;3780;999;3060;237;729;375;1134;612;1863
431230;201609;857;2480;615;1971;100;341;269;842;369;1183
431235;201609;115;317;30;90;7;21;4;7;11;28
431237;201609;500;1454;383;1264;80;316;200;628;280;944
431238;201609;41;131;31;107;7;29;8;28;15;57
431240;201609;3224;9472;2652;8420;778;2644;1026;3133;1804;5777
431242;201609;390;1175;320;1044;99;327;109;369;208;696
431244;201609;405;925;218;599;26;82;106;263;132;345
431245;201609;1236;3197;780;2307;128;385;371;1076;499;1461
431247;201609;205;581;134;427;33;110;31;92;64;202
431250;201609;1523;4849;1275;4431;345;1297;469;1598;814;2895
431260;201609;352;982;161;566;21;90;48;151;69;241
431261;201609;254;860;205;740;39;173;88;288;127;461
431262;201609;425;1160;176;585;21;81;91;306;112;387
431265;201609;1476;3731;701;2103;139;442;189;460;328;902
431267;201609;251;711;152;460;27;100;93;256;120;356
431270;201609;2843;7016;1656;4937;422;1369;527;1548;949;2917
431275;201609;229;691;117;427;34;126;13;45;47;171
431280;201609;334;927;115;382;14;51;22;50;36;101
431290;201609;331;1009;223;752;44;177;32;74;76;251
431295;201609;93;260;40;125;1;4;14;41;15;45
431300;201609;390;980;47;182;4;17;2;7;6;24
431301;201609;284;867;90;303;15;49;15;42;30;91
431303;201609;775;2042;410;1263;57;200;140;397;197;597
431306;201609;2391;6119;1369;4187;166;591;420;1095;586;1686
431308;201609;39;131;34;114;20;73;8;25;28;98
431310;201609;756;2234;428;1453;82;283;121;417;203;700
431320;201609;795;2174;374;1248;66;234;68;200;134;434
431330;201609;2940;7183;1297;4106;367;1264;95;241;462;1505
431333;201609;426;1142;153;474;24;76;28;71;52;147
431335;201609;54;162;36;122;12;44;6;13;18;57
431337;201609;2571;7683;1733;5910;396;1458;275;889;671;2347
431339;201609;618;1657;406;1219;86;258;187;560;273;818
431340;201609;24842;65644;16655;50537;3963;12837;4174;12123;8137;24960
431342;201609;565;1395;420;1159;128;409;223;553;351;962
431344;201609;370;997;242;753;11;30;182;574;193;604
431346;201609;301;760;96;298;18;59;14;42;32;101
431349;201609;749;2076;413;1264;76;243;151;424;227;667
431350;201609;4240;12300;3235;10324;730;2606;1141;3372;1871;5978
431360;201609;676;1709;405;1213;98;300;115;338;213;638
431365;201609;1411;4119;1141;3632;226;774;613;1963;839;2737
431370;201609;4989;13842;3714;11545;1013;3354;1192;3787;2205;7141
431380;201609;941;2907;831;2660;120;439;489;1525;609;1964
431390;201609;3190;8312;1723;5399;334;1147;481;1330;815;2477
431395;201609;1289;3813;1036;3333;253;853;459;1467;712;2320
431400;201609;387;1194;161;542;35;128;28;88;63;216
431402;201609;1301;3042;725;2030;151;446;333;884;484;1330
431403;201609;261;732;181;588;58;216;43;121;101;337
431405;201609;4193;11626;3250;10100;624;2133;1673;5046;2297;7179
431406;201609;752;2259;522;1759;135;477;245;807;380;1284
431407;201609;555;1570;344;1144;75;253;105;318;180;571
431410;201609;14688;41601;9147;30243;2699;9841;1251;3860;3950;13701
431413;201609;231;577;82;273;8;29;21;63;29;92
431415;201609;728;2048;483;1563;99;370;144;393;243;763
431417;201609;576;1442;466;1274;59;178;290;777;349;955
431420;201609;1380;3747;1172;3406;252;759;512;1565;764;2324
431430;201609;583;1506;314;967;54;172;120;323;174;495
431440;201609;23524;64756;18118;55516;5433;17486;5407;17423;10840;34909
431442;201609;130;382;69;223;9;30;5;13;14;43
431445;201609;526;1481;189;609;27;86;58;176;85;262
431446;201609;446;1296;287;927;76;250;79;231;155;481
431447;201609;587;1666;431;1329;89;273;195;607;284;880
431449;201609;805;2195;589;1797;55;161;344;1056;399;1217
431450;201609;2243;5419;1913;4908;249;730;1392;3432;1641;4162
431454;201609;63;219;54;196;11;40;22;86;33;126
431455;201609;734;1831;352;989;91;262;108;274;199;536
431460;201609;3375;9215;2717;7895;744;2195;820;2487;1564;4682
431470;201609;1738;5042;1187;3797;267;837;423;1374;690;2211
431475;201609;203;597;30;117;5;28;1;1;6;29
431477;201609;744;1932;456;1325;59;185;230;629;289;814
431478;201609;284;712;80;231;10;30;13;26;23;56
431480;201609;3081;8477;2205;6838;482;1604;965;2877;1447;4481
431490;201609;112344;299667;93161;269422;11436;38421;63956;179232;75392;217653
431500;201609;606;1675;460;1383;82;244;254;752;336;996
431505;201609;508;1225;324;933;26;70;202;587;228;657
431507;201609;363;883;200;558;43;119;99;268;142;387
431510;201609;1900;5292;1393;4238;323;1023;457;1290;780;2313
431513;201609;313;839;144;446;22;64;69;215;91;279
431514;201609;111;296;41;142;3;12;9;31;12;43
431515;201609;677;1915;437;1355;103;356;158;436;261;792
431517;201609;82;269;58;204;10;38;14;43;24;81
431520;201609;529;1329;209;674;45;167;28;79;73;246
431530;201609;4372;10157;2980;8287;980;2871;796;2259;1776;5130
431531;201609;277;799;176;577;25;80;62;192;87;272
431532;201609;511;1393;387;1118;80;233;146;408;226;641
431535;201609;348;902;146;447;24;81;44;111;68;192
431540;201609;2096;6805;1808;6340;170;634;1193;4320;1363;4954
431545;201609;342;953;46;161;4;14;9;36;13;50
431550;201609;2262;6569;1912;5904;405;1383;803;2337;1208;3720
431555;201609;699;1716;474;1323;68;190;284;800;352;990
431560;201609;20802;60882;13645;46525;3425;12788;3007;10623;6432;23411
431570;201609;6030;15322;4609;13289;1330;3888;1947;5734;3277;9622
431575;201609;422;1088;284;834;44;136;65;171;109;307
431580;201609;642;1797;345;1120;69;249;100;305;169;554
431590;201609;985;2635;538;1683;127;400;172;544;299;944
431595;201609;443;1239;326;983;41;120;185;560;226;680
431600;201609;2076;5651;1378;4341;316;1113;314;943;630;2056
431610;201609;1500;4230;1015;3226;166;530;429;1377;595;1907
431620;201609;488;1428;228;724;57;181;83;238;140;419
431630;201609;1440;3862;825;2526;242;761;227;659;469;1420
431640;201609;6339;17545;5546;16339;1140;3520;3241;9585;4381;13105
431642;201609;521;1387;372;1108;48;149;171;496;219;645
431643;201609;332;863;153;435;28;82;49;113;77;195
431645;201609;1760;4949;1445;4384;250;832;851;2537;1101;3369
431647;201609;157;452;88;287;13;45;16;45;29;90
431650;201609;354;1053;230;769;30;113;67;194;97;307
431660;201609;1170;3288;653;2163;135;486;127;350;262;836
431670;201609;1296;3395;908;2669;193;651;373;989;566;1640
431673;201609;232;644;99;326;24;81;12;32;36;113
431675;201609;704;1800;131;442;17;58;31;91;48;149
431680;201609;9859;26686;6999;21137;1982;6278;1707;5152;3689;11430
431690;201609;23900;65969;17694;54907;4864;15781;5633;17931;10497;33712
431695;201609;143;441;95;319;20;67;24;59;44;126
431697;201609;459;1298;393;1171;105;323;181;548;286;871
431700;201609;1574;4437;1293;3880;214;653;710;2087;924;2740
431710;201609;12695;36216;9935;31541;3310;11143;2372;8095;5682;19238
431720;201609;7306;20062;5149;15629;1180;3814;1678;4899;2858;8713
431725;201609;28;82;15;54;3;13;4;12;7;25
431730;201609;3987;11480;2999;9633;824;2888;793;2649;1617;5537
431740;201609;5306;14608;3984;12102;1333;4396;643;1731;1976;6127
431750;201609;9155;25709;7582;22946;1858;5981;3277;9918;5135;15899
431755;201609;332;912;62;212;14;47;12;37;26;84
431760;201609;4185;11692;3173;9768;581;1950;1468;4269;2049;6219
431770;201609;2050;5392;1622;4693;294;866;941;2698;1235;3564
431775;201609;209;554;112;345;23;68;11;29;34;97
431780;201609;2472;6644;1735;5178;445;1401;377;1026;822;2427
431790;201609;1189;3512;877;2812;155;544;340;1056;495;1600
431795;201609;381;1020;211;637;38;120;65;187;103;307
431800;201609;8736;25440;6502;20956;2046;7046;883;2698;2929;9744
431805;201609;340;830;92;315;17;65;19;65;36;130
431810;201609;3261;8865;2360;7015;444;1436;1065;3050;1509;4486
431820;201609;2577;7916;2117;6984;462;1643;880;2770;1342;4413
431830;201609;11043;26651;8161;22195;2238;6488;3140;8527;5378;15015
431840;201609;2704;8040;2248;7208;551;1888;1013;3264;1564;5152
431842;201609;808;2035;273;854;33;108;66;177;99;285
431843;201609;353;1028;276;871;42;151;133;401;175;552
431844;201609;291;802;75;257;19;72;14;36;33;108
431845;201609;520;1500;358;1134;27;88;233;740;260;828
431846;201609;331;997;282;919;25;99;201;648;226;747
431848;201609;260;702;131;420;12;42;27;80;39;122
431849;201609;479;1170;82;246;13;34;15;35;28;69
431850;201609;4844;14085;4013;12340;939;3045;1388;4181;2327;7226
431860;201609;795;2080;537;1585;92;305;269;737;361;1042
431861;201609;104;302;46;158;7;25;10;27;17;52
431862;201609;490;1587;380;1369;83;346;143;490;226;836
431870;201609;18760;53918;14205;45214;3482;11851;4916;15416;8398;27267
431880;201609;4340;12797;3234;10388;825;2866;1089;3261;1914;6127
431890;201609;5141;13839;3503;10738;1086;3509;729;2302;1815;5811
431900;201609;1114;3085;682;2185;187;682;271;780;458;1462
431910;201609;1022;2443;419;1223;64;175;121;335;185;510
431912;201609;503;1455;397;1250;115;340;156;515;271;855
431915;201609;1299;3499;955;2867;231;723;345;1035;576;1758
431920;201609;1309;3632;1096;3273;129;387;779;2295;908;2682
431930;201609;1260;3402;812;2607;221;685;364;1216;585;1901
431935;201609;55;177;42;149;9;32;11;31;20;63
431936;201609;386;1115;267;839;60;206;106;330;166;536
431937;201609;333;859;168;512;41;131;25;65;66;196
431940;201609;2593;7001;1541;4820;347;1155;421;1264;768;2419
431950;201609;1657;4994;1411;4527;264;959;687;2096;951;3055
431960;201609;2935;8338;2372;7144;631;1957;729;2178;1360;4135
431970;201609;495;1362;212;701;40;142;42;123;82;265
431971;201609;99;292;55;197;9;32;8;27;17;59
431973;201609;473;1603;403;1453;51;184;253;935;304;1119
431975;201609;108;253;23;87;4;17;6;20;10;37
431980;201609;1394;4032;1072;3348;242;783;346;1037;588;1820
431990;201609;7566;20691;5246;16624;986;3446;1694;5108;2680;8554
432000;201609;10300;28497;7805;23959;2522;7914;2568;7808;5090;15722
432010;201609;2269;6297;1730;5266;352;1143;802;2348;1154;3491
432020;201609;2342;5551;1627;4484;317;968;923;2418;1240;3386
432023;201609;530;1476;319;996;56;188;117;305;173;493
432026;201609;1187;3556;835;2793;128;396;424;1430;552;1826
432030;201609;422;1203;294;916;56;166;142;423;198;589
432032;201609;604;1537;376;1113;68;222;163;436;231;658
432035;201609;840;2493;727;2280;282;964;190;603;472;1567
432040;201609;990;2318;394;1275;69;231;147;453;216;684
432045;201609;256;709;134;454;26;90;39;135;65;225
432050;201609;648;1767;527;1539;94;281;291;872;385;1153
432055;201609;953;2673;632;2048;133;446;310;993;443;1439
432057;201609;413;997;289;780;46;114;162;418;208;532
432060;201609;558;1478;179;614;33;133;45;134;78;267
432065;201609;225;640;161;525;47;167;57;167;104;334
432067;201609;984;2983;687;2318;140;462;301;1035;441;1497
432070;201609;2381;6557;1394;4459;308;1041;290;861;598;1902
432080;201609;3889;10794;3095;9347;956;3086;1091;3235;2047;6321
432085;201609;322;890;207;695;49;171;95;307;144;478
432090;201609;1537;4358;1148;3573;316;1057;474;1415;790;2472
432100;201609;1375;3949;566;1961;92;339;41;105;133;444
432110;201609;2735;8128;1865;6255;442;1693;185;542;627;2235
432120;201609;4751;13915;3800;12123;1431;4785;914;2855;2345;7640
432130;201609;2757;7484;2139;6633;724;2419;798;2440;1522;4859
432132;201609;391;1095;162;558;26;97;40;130;66;227
432135;201609;750;2197;604;1899;102;331;386;1184;488;1515
432140;201609;1923;6101;1449;5152;335;1230;568;2124;903;3354
432143;201609;1412;4112;1146;3638;212;700;553;1802;765;2502
432145;201609;1298;3918;704;2462;119;460;116;370;235;830
432146;201609;181;577;115;413;31;113;25;93;56;206
432147;201609;652;2044;469;1632;122;450;110;397;232;847
432149;201609;367;1012;219;659;46;135;82;245;128;380
432150;201609;3813;10536;2658;8354;588;2020;792;2376;1380;4396
432160;201609;4591;14254;3845;12837;1163;4065;1291;4387;2454;8452
432162;201609;412;990;59;181;12;42;9;23;21;65
432163;201609;367;977;78;248;3;12;2;3;5;15
432166;201609;697;2032;532;1685;77;277;233;693;310;970
432170;201609;1177;3591;755;2641;175;625;146;486;321;1111
432180;201609;2794;7438;1602;4957;359;1158;303;806;662;1964
432183;201609;418;1288;312;1057;114;418;52;167;166;585
432185;201609;935;2418;570;1721;85;271;286;846;371;1117
432190;201609;3401;9113;1975;5955;427;1346;547;1525;974;2871
432195;201609;1135;3009;777;2383;151;443;333;995;484;1438
432200;201609;3133;9289;2419;7999;596;2128;1024;3379;1620;5507
432210;201609;424;1152;285;908;67;243;98;291;165;534
432215;201609;854;2560;709;2319;164;497;379;1325;543;1822
432218;201609;278;704;159;459;31;81;52;135;83;216
432220;201609;4265;11159;3306;9522;436;1444;1949;5377;2385;6821
432225;201609;103;315;78;262;31;114;18;58;49;172
432230;201609;1043;2787;577;1747;127;407;146;367;273;774
432232;201609;536;1496;405;1238;75;253;178;518;253;771
432234;201609;376;1025;217;666;44;134;59;170;103;304
432235;201609;110;316;35;124;5;16;1;1;6;17
432237;201609;473;1266;407;1145;20;74;297;808;317;882
432240;201609;14202;43608;11449;39673;1719;6944;6902;24469;8621;31413
432250;201609;4813;16184;4176;14827;1301;4923;1321;4732;2622;9655
432252;201609;437;1146;285;903;49;164;158;509;207;673
432253;201609;1314;4114;678;2379;151;588;48;141;199;729
432254;201609;870;2330;194;634;42;146;22;54;64;200
432255;201609;220;566;113;372;21;75;37;111;58;186
432260;201609;7803;19238;5149;14762;1203;3467;2088;6264;3291;9731
432270;201609;2629;7689;2076;6637;605;2006;582;1857;1187;3863
432280;201609;1420;3831;681;2179;94;306;166;466;260;772
432285;201609;196;613;21;75;4;16;2;4;6;20
432290;201609;566;1636;330;1078;89;293;81;256;170;549
432300;201609;24208;70919;20448;64122;3849;12996;11491;35341;15340;48337
432310;201609;821;2369;618;2006;155;533;295;928;450;1461
432320;201609;238;610;100;312;21;62;17;44;38;106
432330;201609;336;877;113;369;13;41;13;35;26;76
432335;201609;156;442;54;192;11;39;10;26;21;65
432340;201609;316;768;155;472;29;103;52;144;81;247
432345;201609;653;1789;585;1669;78;281;366;952;444;1233
432350;201609;395;1067;190;624;30;90;59;183;89;273
432360;201609;196;599;37;135;5;20;9;25;14;45
432370;201609;424;1173;299;906;37;109;186;573;223;682
432375;201609;772;1923;564;1583;72;197;322;907;394;1104
432377;201609;218;717;33;125;5;18;8;25;13;43
432380;201609;953;3040;760;2640;249;957;289;960;538;1917
500020;201609;2391;6882;1725;5670;356;1350;727;2270;1083;3620
500025;201609;1407;3281;801;2205;79;207;473;1272;552;1479
500060;201609;7090;20816;5405;17837;748;2432;3403;11676;4151;14108
500070;201609;4469;12659;3312;10507;736;2575;1279;4005;2015;6580
500080;201609;1510;4392;1065;3508;280;1005;363;1178;643;2183
500085;201609;2332;5915;1552;4697;142;434;972;2874;1114;3308
500090;201609;2394;6763;1649;5350;331;1097;688;2333;1019;3430
500100;201609;2836;8031;2166;6802;495;1717;845;2474;1340;4191
500110;201609;8470;24604;6354;21135;1124;4002;2856;10003;3980;14005
500124;201609;2083;6598;1732;5985;414;1365;845;3249;1259;4614
500150;201609;1425;3596;890;2629;180;600;333;835;513;1435
500190;201609;5036;12796;3688;10846;788;2419;1918;5739;2706;8158
500200;201609;2487;6193;1760;4869;409;1186;691;1775;1100;2961
500210;201609;4834;14261;3864;12645;922;3148;1710;5660;2632;8808
500215;201609;1530;4641;1064;3644;197;707;387;1306;584;2013
500220;201609;3111;9542;2454;8346;494;1760;1077;3709;1571;5469
500230;201609;2863;7233;1927;5685;385;1208;948;2832;1333;4040
500240;201609;4637;14439;3102;11098;528;2071;931;3457;1459;5528
500260;201609;2814;7055;1882;5550;290;921;962;2719;1252;3640
500270;201609;127911;325797;74381;228321;17492;56998;17084;50988;34576;107986
500280;201609;1378;3469;1094;3062;76;225;860;2435;936;2660
500290;201609;4655;10440;2415;7030;511;1581;849;2384;1360;3965
500295;201609;2738;7832;1473;4854;233;842;377;1038;610;1880
500310;201609;807;2090;629;1815;134;444;318;867;452;1311
500315;201609;3196;9836;2536;8696;354;1237;1562;5552;1916;6789
500320;201609;17573;55564;12989;46550;3865;14895;3304;12314;7169;27209
500325;201609;4189;10625;2928;8586;553;1741;1600;4703;2153;6444
500330;201609;6944;17938;4396;13067;829;2676;1940;5603;2769;8279
500345;201609;2218;5728;1644;4819;396;1246;744;2151;1140;3397
500348;201609;2319;6682;1969;6108;144;534;1393;4240;1537;4774
500350;201609;1281;3727;624;2131;69;235;215;729;284;964
500370;201609;24252;71792;17041;57898;3762;14222;4976;16721;8738;30943
500375;201609;2933;7967;2050;6230;408;1269;581;1734;989;3003
500380;201609;3380;9140;2431;7388;560;1756;975;2938;1535;4694
500390;201609;605;1342;322;888;51;165;167;422;218;587
500400;201609;1384;4145;953;3102;220;747;231;698;451;1445
500410;201609;2243;6292;1743;5524;368;1211;894;2911;1262;4122
500430;201609;2747;7464;1906;6187;402;1458;760;2532;1162;3990
500440;201609;1498;3905;944;2905;169;556;407;1240;576;1796
500450;201609;1708;4986;1107;3731;223;808;173;483;396;1291
500460;201609;4033;11782;2675;8960;704;2587;537;1694;1241;4281
500470;201609;3097;8973;1975;6470;510;1815;333;983;843;2798
500480;201609;2333;6894;2103;6603;192;512;1627;5517;1819;6029
500490;201609;987;2692;687;2146;211;746;131;414;342;1160
500500;201609;3972;11815;2896;10123;1057;4168;903;3162;1960;7330
500510;201609;861;2199;511;1545;65;215;223;610;288;825
500515;201609;1949;5114;1533;4532;206;615;949;3007;1155;3622
500520;201609;3246;10958;2762;10011;403;1665;1722;6178;2125;7843
500525;201609;1209;3749;925;3190;159;622;428;1510;587;2132
500540;201609;6396;17245;3397;11395;926;3559;440;1244;1366;4803
500560;201609;4775;15416;4232;14516;533;1976;3003;10339;3536;12315
500568;201609;4414;10675;2715;7974;638;2221;817;2097;1455;4318
500570;201609;7966;20818;4691;14469;1239;4066;879;2579;2118;6645
500580;201609;3775;10428;2914;8979;260;804;2108;6579;2368;7383
500600;201609;4018;10536;2367;7390;596;1992;618;1853;1214;3845
500620;201609;7996;22571;5544;17666;1046;3509;2359;7532;3405;11041
500625;201609;751;2156;381;1286;67;237;131;438;198;675
500627;201609;669;1805;395;1267;88;281;94;296;182;577
500630;201609;6188;16675;4133;13010;1063;3555;1230;3775;2293;7330
500635;201609;2788;10134;2241;9259;272;1085;1560;6914;1832;7999
500640;201609;1688;4008;1244;3363;75;228;921;2448;996;2676
500660;201609;19618;55447;14338;46445;4290;15518;3968;12511;8258;28029
500690;201609;2583;7549;2018;6723;948;3320;489;1715;1437;5035
500710;201609;3534;10304;2815;9021;639;2301;1132;3544;1771;5845
500720;201609;6308;16551;3608;11592;935;3248;722;2200;1657;5448
500730;201609;1013;2767;628;1978;158;526;198;589;356;1115
500740;201609;4433;11861;3112;9384;383;1312;1584;4734;1967;6046
500750;201609;990;2696;779;2316;136;440;403;1143;539;1583
500755;201609;1209;3491;752;2506;155;529;145;378;300;907
500769;201609;5569;14569;2763;8637;472;1581;591;1552;1063;3133
500770;201609;1755;5037;1141;3806;275;959;283;941;558;1900
500780;201609;1165;3316;829;2653;224;699;221;689;445;1388
500790;201609;10017;26903;7863;23163;1490;4959;4153;11761;5643;16720
500793;201609;2270;6416;1602;5143;478;1608;304;835;782;2443
500795;201609;2411;7039;2001;6444;259;688;1387;4816;1646;5504
500797;201609;848;2276;544;1736;102;359;206;618;308;977
500800;201609;2990;7856;2123;6543;815;2808;448;1413;1263;4221
500830;201609;20180;53063;13024;39279;2566;8327;4621;13107;7187;21434
500840;201609;1383;3779;827;2612;93;309;337;1011;430;1320
510010;201609;1275;3716;999;3237;247;787;511;1695;758;2482
510020;201609;3462;9655;1901;6358;417;1452;401;1213;818;2665
510025;201609;7678;22087;5203;17046;1175;4089;1434;4338;2609;8427
510030;201609;1719;4594;1333;3963;253;827;675;1940;928;2767
510035;201609;856;2409;599;1999;131;451;310;1047;441;1498
510040;201609;1828;4871;1319;4042;196;634;735;2243;931;2877
510050;201609;1885;5400;1281;4189;326;1167;377;1190;703;2357
510060;201609;1625;4585;1150;3638;205;676;487;1492;692;2168
510080;201609;1036;3278;771;2708;221;825;112;336;333;1161
510100;201609;691;1784;438;1262;44;138;219;582;263;720
510120;201609;312;669;199;526;12;41;138;362;150;403
510125;201609;3207;8315;2271;6592;402;1343;900;2381;1302;3724
510130;201609;1778;4903;1370;4163;379;1226;437;1293;816;2519
510140;201609;2913;9071;2143;7782;934;3763;391;1147;1325;4910
510160;201609;1319;4383;1174;4152;201;778;718;2517;919;3295
510170;201609;5305;15810;4054;13541;789;2829;1814;5845;2603;8674
510180;201609;12552;32231;8076;24816;2357;7525;2245;7752;4602;15277
510185;201609;1379;4058;1080;3638;164;521;688;2548;852;3069
510190;201609;2478;6706;1643;5414;279;973;906;3054;1185;4027
510250;201609;14148;42063;11725;38190;3598;12442;4339;14494;7937;26936
510260;201609;2198;8955;1775;8067;343;1482;936;4901;1279;6383
510263;201609;4179;11090;2881;8888;728;2366;698;2024;1426;4390
510267;201609;5829;16794;3714;12101;780;2732;886;2716;1666;5448
510268;201609;909;2604;756;2373;147;510;443;1367;590;1877
510269;201609;1005;3070;675;2368;235;860;151;510;386;1370
510270;201609;2723;8777;2091;7358;463;1640;771;2668;1234;4308
510279;201609;1844;5597;1383;4543;369;1286;433;1282;802;2568
510285;201609;1244;3601;906;2989;256;924;281;871;537;1795
510300;201609;3440;9838;2738;8802;196;703;2063;6702;2259;7405
510305;201609;1533;4700;1113;3873;281;1047;343;1205;624;2252
510310;201609;801;2397;637;2081;218;739;177;558;395;1297
510320;201609;3785;10688;2589;8351;604;2198;805;2374;1409;4572
510325;201609;5213;16150;4269;14824;1175;4232;2442;8754;3617;12986
510330;201609;2792;8742;2122;7480;527;1926;727;2638;1254;4564
510335;201609;4935;14608;3861;13180;513;1722;2612;9375;3125;11097
510336;201609;599;1822;424;1472;85;305;194;671;279;976
510337;201609;2050;6614;1546;5582;610;2316;237;863;847;3179
510340;201609;78606;207462;50420;160393;16880;58943;8858;28381;25738;87324
510343;201609;1132;3224;830;2627;105;342;486;1527;591;1869
510345;201609;1641;4809;1246;4052;315;1104;438;1359;753;2463
510350;201609;3274;8726;2348;7340;588;1932;1027;3319;1615;5251
510360;201609;1784;4332;1090;3438;106;417;773;2389;879;2806
510370;201609;1363;4350;1046;3810;235;883;546;2070;781;2953
510380;201609;529;1531;286;998;84;311;22;72;106;383
510385;201609;968;3618;655;2869;80;384;316;1492;396;1876
510390;201609;1096;3457;910;3075;246;770;458;1647;704;2417
510395;201609;778;1869;519;1482;77;252;223;703;300;955
510410;201609;3881;12397;3234;11126;809;2881;1511;5304;2320;8185
510420;201609;2445;6077;1724;4839;229;716;875;2425;1104;3141
510450;201609;671;1747;428;1334;98;339;128;375;226;714
510452;201609;677;2134;479;1661;74;253;262;908;336;1161
510454;201609;875;2695;707;2364;93;311;462;1588;555;1899
510455;201609;981;2991;674;2294;122;476;241;761;363;1237
510460;201609;2315;5982;1648;4957;200;721;952;2726;1152;3447
510480;201609;4635;11918;3033;8892;614;1859;978;2663;1592;4522
510490;201609;1627;4994;1333;4527;301;1147;700;2281;1001;3428
510500;201609;1528;4485;981;3367;201;810;447;1449;648;2259
510510;201609;2729;9257;2178;8141;657;2599;572;2170;1229;4769
510515;201609;6367;18975;4206;14022;901;3262;926;2836;1827;6098
510517;201609;1618;4801;1225;3996;354;1198;275;861;629;2059
510520;201609;2155;4905;1432;3956;58;167;1005;2949;1063;3116
510523;201609;1000;2906;861;2666;117;350;608;1950;725;2300
510525;201609;8235;21395;5240;16309;1047;3312;1864;5692;2911;9004
510530;201609;533;1508;435;1357;44;200;296;866;340;1066
510550;201609;2808;9031;2092;7572;574;2223;660;2357;1234;4580
510558;201609;1918;5453;1535;4843;196;667;938;3048;1134;3715
510560;201609;1725;5141;1015;3868;294;1200;210;815;504;2015
510562;201609;5432;15717;3761;12251;1081;3719;905;3038;1986;6757
510590;201609;3320;8377;2469;7272;484;1372;1459;4460;1943;5832
510600;201609;1624;4112;977;2972;203;624;373;1093;576;1717
510610;201609;2944;8288;2295;7261;201;713;1518;4728;1719;5441
510615;201609;2077;6267;1698;5622;515;1763;687;2344;1202;4107
510617;201609;636;1852;515;1648;36;92;413;1382;449;1474
510618;201609;1504;4264;1015;3281;211;805;472;1422;683;2227
510619;201609;806;2207;424;1418;43;163;56;149;99;312
510620;201609;1441;3567;713;2333;192;688;103;274;295;962
510621;201609;851;2900;727;2626;196;798;197;660;393;1458
510622;201609;3950;11878;2627;8937;708;2569;431;1313;1139;3882
510623;201609;3402;9414;2444;7680;623;2138;848;2464;1471;4602
510624;201609;1509;4350;838;2860;160;607;167;509;327;1116
510625;201609;2105;5900;1501;4857;422;1484;255;792;677;2276
510626;201609;1588;4203;967;3262;302;1134;206;672;508;1806
510627;201609;729;2078;463;1499;131;457;97;307;228;764
510628;201609;1569;3861;1057;3124;183;541;646;1922;829;2463
510629;201609;1808;5822;1386;4859;422;1609;381;1310;803;2919
510630;201609;2500;8336;1644;6377;388;1642;268;1041;656;2683
510631;201609;390;1089;328;979;17;39;269;814;286;853
510637;201609;2771;8016;2265;7164;814;2780;694;2127;1508;4907
510642;201609;4824;15725;4002;14462;1264;5027;1610;5984;2874;11011
510645;201609;973;2186;594;1656;203;538;158;475;361;1013
510650;201609;6363;20701;5637;19798;1467;5347;3388;12316;4855;17663
510665;201609;1746;4524;974;3038;174;551;402;1292;576;1843
510670;201609;402;907;216;638;20;71;110;321;130;392
510675;201609;6459;19982;4818;16611;1426;5354;1001;3354;2427;8708
510677;201609;1910;5180;1542;4688;172;526;1153;3646;1325;4172
510680;201609;722;2162;481;1644;113;401;83;246;196;647
510682;201609;2119;6699;1540;5520;432;1717;284;966;716;2683
510685;201609;948;2519;717;2136;87;289;445;1279;532;1568
510700;201609;4340;11165;2791;8859;648;2078;1281;4200;1929;6278
510704;201609;9993;26164;7041;20768;1389;4494;3006;8296;4395;12790
510706;201609;1933;5758;1283;4735;275;1037;645;2530;920;3567
510710;201609;3397;9287;2228;6844;503;1578;638;1769;1141;3347
510715;201609;735;1772;450;1258;78;227;178;522;256;749
510718;201609;2360;5840;1471;4740;681;2213;321;1221;1002;3434
510719;201609;428;965;232;686;28;103;119;336;147;439
510720;201609;1180;2826;770;2216;201;635;261;634;462;1269
510724;201609;735;2200;518;1744;105;389;199;620;304;1009
510726;201609;643;1568;461;1275;70;197;258;679;328;876
510729;201609;726;1814;373;1144;90;318;121;359;211;677
510730;201609;2803;7925;1871;6106;546;1901;469;1455;1015;3356
510735;201609;994;3235;745;2829;157;667;357;1360;514;2027
510740;201609;1152;2756;750;2130;153;414;383;1151;536;1565
510757;201609;727;2370;582;2079;259;949;143;479;402;1428
510760;201609;32872;83110;19902;60574;5895;19294;4099;11542;9994;30836
510770;201609;4492;11093;3607;9999;365;951;2379;7291;2744;8242
510774;201609;361;1005;304;903;53;183;158;493;211;676
510775;201609;721;2113;564;1812;174;631;148;419;322;1050
510776;201609;551;1514;396;1182;99;327;151;441;250;768
510777;201609;1596;4615;1154;3980;153;548;898;3133;1051;3681
510779;201609;633;1892;460;1556;68;229;224;781;292;1010
510780;201609;3800;11065;2946;9686;765;2582;1178;4125;1943;6707
510785;201609;1772;5099;1199;4021;349;1195;209;730;558;1925
510787;201609;2340;6976;1747;5856;752;2653;260;806;1012;3459
510788;201609;571;1451;384;1165;144;440;107;377;251;817
510790;201609;16422;46986;9866;33801;2119;8127;1075;3652;3194;11779
510792;201609;8541;24588;5197;17852;1065;3991;855;2718;1920;6709
510794;201609;1244;3817;911;3152;287;1090;251;796;538;1886
510795;201609;8224;24297;5599;19138;1506;5633;1088;3869;2594;9502
510800;201609;1645;4557;1220;3857;262;891;522;1529;784;2420
510805;201609;2020;5538;1420;4483;311;1093;643;1894;954;2987
510810;201609;665;1620;493;1365;140;389;221;590;361;979
510820;201609;765;1754;452;1264;83;279;177;425;260;704
510830;201609;705;2068;552;1816;114;376;279;984;393;1360
510835;201609;654;1915;457;1527;94;341;192;599;286;940
510840;201609;47747;118591;36361;102802;9029;26473;16598;48017;25627;74490
510850;201609;1671;4581;955;3185;254;891;135;400;389;1291
510860;201609;2715;8264;1798;6435;594;2356;114;363;708;2719
510880;201609;623;2052;514;1848;163;626;191;688;354;1314
510885;201609;653;1821;504;1606;93;313;205;647;298;960
510890;201609;857;2654;680;2380;159;622;337;1164;496;1786
510895;201609;1121;3404;897;2936;210;777;339;1012;549;1789
520005;201609;1505;4718;1293;4392;395;1329;574;2046;969;3375
520010;201609;1763;5868;1341;4925;496;2048;215;675;711;2723
520013;201609;3390;9448;2356;7414;582;1886;712;2255;1294;4141
520015;201609;481;1367;373;1186;85;300;133;435;218;735
520017;201609;1083;3170;863;2777;223;795;328;965;551;1760
520020;201609;461;1181;338;997;68;210;153;438;221;648
520025;201609;28267;85690;26039;82688;3169;10680;20172;63829;23341;74509
520030;201609;4740;14530;3766;12766;684;2541;1922;6489;2606;9030
520050;201609;430;1085;260;777;16;41;180;556;196;597
520055;201609;773;2312;652;2058;117;353;362;1167;479;1520
520060;201609;1362;4238;1109;3716;261;964;381;1215;642;2179
520080;201609;1851;5305;1505;4820;294;867;835;2884;1129;3751
520082;201609;1098;2920;936;2649;149;355;610;1796;759;2151
520085;201609;841;2514;711;2268;162;513;237;748;399;1261
520090;201609;987;2276;690;1887;151;356;350;1062;501;1418
520110;201609;42356;121268;30844;102569;11354;42248;4234;13294;15588;55542
520120;201609;197;513;107;352;20;77;26;82;46;159
520130;201609;3424;9532;2969;8824;673;2169;1555;4645;2228;6814
520140;201609;36980;118771;29628;103822;10798;40572;4528;15333;15326;55905
520145;201609;379;1021;249;772;50;166;71;209;121;375
520150;201609;501;1309;398;1180;64;218;225;648;289;866
520160;201609;899;2382;698;2066;194;572;207;627;401;1199
520170;201609;4502;10178;3423;8909;250;671;2852;7515;3102;8186
520180;201609;2123;6145;1686;5425;280;1058;880;2764;1160;3822
520215;201609;2005;5083;1564;4351;190;535;1013;2836;1203;3371
520235;201609;717;1836;502;1500;96;327;200;567;296;894
520250;201609;1568;4392;1044;3447;292;1062;234;733;526;1795
520260;201609;800;2014;471;1386;89;278;173;471;262;749
520280;201609;568;1634;489;1522;156;499;186;647;342;1146
520310;201609;1223;2898;790;2182;222;659;263;778;485;1437
520320;201609;1912;5877;1500;5051;135;464;987;3392;1122;3856
520330;201609;2723;8302;1952;6900;526;1992;285;964;811;2956
520340;201609;1893;4728;1404;4046;215;540;906;2791;1121;3331
520350;201609;3353;9000;2380;7142;687;2216;885;2538;1572;4754
520355;201609;1110;3594;956;3335;271;1019;431;1462;702;2481
520357;201609;866;2314;690;2015;63;196;475;1381;538;1577
520360;201609;715;2033;572;1776;159;510;222;703;381;1213
520380;201609;1307;3494;805;2489;116;385;366;1079;482;1464
520390;201609;1104;2604;615;1939;182;656;188;522;370;1178
520393;201609;535;1280;397;1070;51;138;241;632;292;770
520396;201609;698;2233;563;1961;60;246;367;1245;427;1491
520400;201609;1670;4756;1391;4328;258;860;827;2531;1085;3391
520410;201609;1563;3716;1082;3016;219;683;586;1587;805;2270
520420;201609;329;910;230;697;40;130;87;242;127;372
520425;201609;1268;3456;958;2851;280;840;413;1266;693;2106
520430;201609;1932;5096;1066;3397;241;746;177;495;418;1241
520440;201609;3773;9649;2342;6986;697;2257;470;1370;1167;3627
520450;201609;10746;29223;6356;20806;1492;5141;403;1203;1895;6344
520455;201609;703;2052;528;1737;163;556;185;611;348;1167
520460;201609;906;2532;731;2236;107;381;417;1230;524;1611
520465;201609;857;2275;725;2096;78;263;502;1407;580;1670
520470;201609;1769;5659;1562;5315;359;1260;945;3339;1304;4599
520480;201609;966;2759;608;2024;106;362;187;539;293;901
520485;201609;1332;4162;1129;3819;243;899;674;2281;917;3180
520490;201609;4138;12635;3158;11033;931;3236;1384;5036;2315;8272
520495;201609;1411;3657;1126;3261;91;280;900;2658;991;2938
520500;201609;1331;3695;1065;3289;278;933;434;1309;712;2242
520505;201609;746;2104;618;1885;132;403;323;984;455;1387
520510;201609;9310;25747;6204;20492;1487;5321;1953;6469;3440;11790
520520;201609;1091;3000;839;2618;270;875;237;763;507;1638
520530;201609;1996;6504;1570;5735;573;2094;406;1625;979;3719
520540;201609;2882;8026;1956;6209;530;1734;331;1052;861;2786
520545;201609;1103;3284;853;2770;170;594;265;806;435;1400
520547;201609;666;2070;551;1846;184;615;168;536;352;1151
520549;201609;9739;28475;7903;25804;2318;7876;3562;11757;5880;19633
520551;201609;3717;11203;3356;10652;822;2877;2020;6290;2842;9167
520552;201609;767;2268;680;2152;101;332;473;1521;574;1853
520570;201609;586;1620;391;1258;142;490;132;400;274;890
520580;201609;3217;7788;2145;6247;512;1683;1047;2964;1559;4647
520590;201609;1433;4045;1011;3258;236;772;206;642;442;1414
520620;201609;7882;23416;6816;21869;1680;5534;3666;11904;5346;17438
520630;201609;935;2387;609;1851;114;356;271;801;385;1157
520640;201609;2826;7686;2204;6587;580;1735;864;2641;1444;4376
520650;201609;861;2275;610;1804;115;388;331;953;446;1341
520660;201609;359;1007;263;867;97;349;85;280;182;629
520670;201609;975;2829;854;2646;59;184;681;2087;740;2271
520680;201609;785;2056;578;1709;144;416;242;724;386;1140
520690;201609;325;857;239;718;58;151;107;329;165;480
520710;201609;556;1435;329;981;7;18;212;630;219;648
520725;201609;1626;4135;1156;3330;168;527;727;2042;895;2569
520735;201609;829;2265;551;1735;118;416;191;582;309;998
520740;201609;1846;4836;1406;4231;237;776;785;2315;1022;3091
520750;201609;625;1673;473;1435;107;314;221;705;328;1019
520753;201609;1493;3979;1302;3702;171;478;874;2642;1045;3120
520760;201609;830;2185;710;2020;82;220;513;1536;595;1756
520780;201609;1947;4720;1439;3966;160;437;947;2579;1107;3016
520790;201609;2831;7160;2088;6012;198;519;1528;4574;1726;5093
520800;201609;16649;46163;13930;42796;2978;8656;8261;27185;11239;35841
520810;201609;1093;2658;818;2317;87;237;629;1881;716;2118
520815;201609;593;1861;403;1441;171;668;17;57;188;725
520830;201609;1667;4213;1323;3819;42;113;1137;3276;1179;3389
520840;201609;1718;5481;1399;4898;554;2077;262;970;816;3047
520850;201609;603;1832;429;1519;109;419;122;429;231;848
520860;201609;6676;19526;4820;16236;1198;4293;1650;5653;2848;9946
520870;201609;103403;273213;67488;211845;20026;67867;14585;43307;34611;111174
520880;201609;7069;20012;5029;16844;1899;7065;467;1446;2366;8511
520890;201609;3921;10867;2997;9260;619;2106;1411;4283;2030;6389
520910;201609;3916;11154;2636;8606;943;3280;477;1462;1420;4742
520915;201609;652;1907;476;1548;115;390;221;701;336;1091
520920;201609;3522;9340;2384;7479;449;1482;937;3014;1386;4496
520929;201609;623;1628;444;1330;108;302;225;716;333;1018
520940;201609;1084;3077;845;2712;90;327;614;1935;704;2262
520945;201609;662;1585;505;1306;126;290;256;661;382;951
520960;201609;1036;3004;778;2497;67;209;408;1348;475;1557
520970;201609;2912;8755;2381;7730;622;2167;609;1909;1231;4076
520980;201609;769;2207;657;2032;208;684;339;1043;547;1727
520990;201609;2991;9485;2753;9149;348;1170;1908;6621;2256;7791
520993;201609;965;2440;753;2125;48;139;562;1607;610;1746
520995;201609;2337;6206;1977;5708;384;1023;1226;3657;1610;4680
521000;201609;7316;21762;5590;18325;1954;6853;1293;3965;3247;10818
521010;201609;4071;11707;3033;9702;711;2245;1245;3979;1956;6224
521015;201609;696;1891;578;1695;112;308;354;1050;466;1358
521020;201609;2849;8134;1749;5738;517;1789;175;535;692;2324
521030;201609;672;1683;487;1364;104;284;191;549;295;833
521040;201609;6281;16779;4995;14704;1745;5269;1567;4825;3312;10094
521056;201609;871;2613;690;2294;250;893;188;667;438;1560
521060;201609;1125;2908;859;2487;219;608;374;1159;593;1767
521080;201609;1151;2740;640;1874;64;224;265;675;329;899
521090;201609;2998;8012;2256;6961;739;2360;666;2100;1405;4460
521100;201609;2051;4650;1480;3871;246;598;948;2587;1194;3185
521120;201609;4856;12420;3605;10755;857;2709;1440;4631;2297;7340
521130;201609;1043;2810;740;2218;103;373;434;1273;537;1646
521140;201609;1053;3177;814;2679;209;718;269;892;478;1610
521150;201609;12133;30124;7104;21148;2774;8568;1570;4735;4344;13303
521160;201609;852;2001;513;1414;104;292;227;615;331;907
521170;201609;1170;2848;841;2333;165;483;484;1305;649;1788
521180;201609;6507;20783;5679;19244;1565;5608;1903;6477;3468;12085
521190;201609;9456;26928;5841;19834;1480;5446;1183;3906;2663;9352
521200;201609;769;2071;582;1733;67;227;353;1031;420;1258
521205;201609;614;1724;457;1436;50;160;268;837;318;997
521210;201609;941;2610;552;1765;154;568;104;270;258;838
521220;201609;4452;11184;3133;9311;695;2216;1478;4408;2173;6624
521225;201609;404;980;322;886;37;98;232;670;269;768
521230;201609;1256;3892;1082;3530;331;1157;492;1557;823;2714
521250;201609;30115;92436;24832;83827;11006;38828;5992;20671;16998;59499
521260;201609;698;1684;552;1469;92;273;306;780;398;1053
521270;201609;1898;5380;1676;5042;164;428;1246;3901;1410;4329
521280;201609;1859;5597;1473;4831;417;1416;439;1414;856;2830
521290;201609;494;1357;360;1152;87;319;165;497;252;816
521295;201609;1213;2911;968;2561;147;357;675;1871;822;2228
521300;201609;1936;5420;1598;4838;190;537;1007;3079;1197;3616
521305;201609;749;2098;592;1833;119;342;312;1009;431;1351
521308;201609;4455;13096;3393;10934;863;2805;1413;4548;2276;7353
521310;201609;8206;23864;5468;18255;1374;4928;1160;3604;2534;8532
521340;201609;330;851;306;820;17;44;265;703;282;747
521350;201609;2001;5435;1545;4666;246;715;976;3022;1222;3737
521370;201609;966;2799;660;2219;227;814;109;345;336;1159
521375;201609;1343;3803;1132;3407;290;1001;532;1411;822;2412
521377;201609;1105;2784;983;2636;62;109;845;2317;907;2426
521380;201609;5584;15689;3733;12041;504;1716;1159;3816;1663;5532
521385;201609;535;1409;448;1298;131;392;194;585;325;977
521390;201609;799;2199;592;1894;184;666;179;538;363;1204
521400;201609;2119;5992;1909;5718;299;1002;1386;4126;1685;5128
521405;201609;1402;3900;1052;3241;313;1027;421;1299;734;2326
521410;201609;734;2214;669;2103;220;644;295;1009;515;1653
521440;201609;1395;4021;1068;3299;181;605;406;1087;587;1692
521450;201609;3950;12603;3009;10604;961;3548;569;1919;1530;5467
521460;201609;6794;19355;5370;16771;1444;4821;2220;6717;3664;11538
521470;201609;701;1996;483;1543;114;377;75;234;189;611
521480;201609;379;1130;242;811;52;187;76;248;128;435
521483;201609;2855;7396;2027;5898;536;1558;587;1662;1123;3220
521486;201609;1650;4170;1294;3623;110;291;960;2701;1070;2992
521487;201609;577;1484;386;1154;121;406;70;185;191;591
521490;201609;801;2249;612;1930;40;169;421;1274;461;1443
521500;201609;1374;4264;939;3252;181;714;223;659;404;1373
521520;201609;895;2086;657;1762;159;444;316;898;475;1342
521523;201609;13363;47189;12184;44961;4328;17136;1707;6975;6035;24111
521525;201609;1069;2745;869;2425;107;351;551;1480;658;1831
521530;201609;1756;4981;1005;3367;243;844;147;477;390;1321
521540;201609;953;2565;617;1957;119;450;224;671;343;1121
521550;201609;1559;3946;937;2657;194;578;437;1213;631;1791
521560;201609;3791;12182;3050;11063;1219;4790;974;3498;2193;8288
521565;201609;610;1574;509;1441;90;217;320;930;410;1147
521570;201609;4614;12667;2708;8775;613;2129;473;1550;1086;3679
521580;201609;566;1294;305;887;77;220;58;154;135;374
521590;201609;666;1814;509;1540;144;470;157;448;301;918
521600;201609;499;1377;315;1013;70;227;71;222;141;449
521630;201609;1418;3525;946;2810;228;812;203;505;431;1317
521640;201609;2130;5347;1571;4536;423;1220;659;1958;1082;3178
521645;201609;580;1697;401;1300;75;248;143;440;218;688
521680;201609;1370;4389;1109;3860;498;1827;140;462;638;2289
521690;201609;577;1665;500;1532;123;430;226;637;349;1067
521710;201609;2926;8510;2209;7144;461;1551;716;2321;1177;3872
521720;201609;1948;5465;1434;4464;286;875;738;2219;1024;3094
521730;201609;3734;12066;3099;10723;1108;4213;576;1697;1684;5910
521740;201609;3696;10158;2762;8704;640;2182;1265;4140;1905;6322
521760;201609;13797;43871;11548;39721;3211;11860;4434;15284;7645;27144
521770;201609;2638;7602;2009;6359;765;2585;515;1526;1280;4111
521800;201609;6992;21020;5811;18943;1834;6262;2001;6779;3835;13041
521805;201609;919;2056;629;1624;164;385;301;852;465;1237
521810;201609;812;1999;565;1631;105;326;257;771;362;1097
521830;201609;5251;16470;4606;15464;716;2638;3078;10258;3794;12896
521839;201609;739;2007;513;1566;100;311;199;576;299;887
521850;201609;7031;18650;5002;14944;1178;3704;1446;3983;2624;7687
521860;201609;2047;5473;1486;4546;344;1159;436;1312;780;2471
521870;201609;517;1712;407;1472;104;389;135;473;239;862
521878;201609;791;2241;527;1686;76;269;215;640;291;909
521880;201609;23099;58980;14532;44474;4008;12895;4323;13549;8331;26444
521890;201609;3470;10161;2424;7985;680;2352;425;1327;1105;3679
521900;201609;1466;3812;977;3041;239;784;331;964;570;1748
521910;201609;936;2514;807;2352;132;395;465;1432;597;1827
521920;201609;299;946;240;828;90;337;47;153;137;490
521925;201609;682;2054;525;1724;108;377;179;547;287;924
521930;201609;3629;11505;2938;10072;1025;3647;483;1670;1508;5317
521935;201609;626;1745;509;1521;129;384;237;681;366;1065
521940;201609;1018;2761;801;2423;165;539;416;1233;581;1772
521945;201609;679;2092;559;1876;112;386;287;1019;399;1405
521950;201609;657;1679;519;1469;60;182;354;1003;414;1185
521960;201609;666;1981;508;1652;106;369;223;705;329;1074
521970;201609;2709;6957;2190;6320;183;502;1763;5257;1946;5759
521971;201609;1034;2733;648;1982;116;345;166;484;282;829
521973;201609;962;2944;785;2619;157;533;384;1285;541;1818
521975;201609;12683;34556;11193;32558;2045;6239;7506;21630;9551;27869
521980;201609;2062;5621;1733;5204;254;644;1324;4153;1578;4797
521990;201609;1180;3319;924;2892;112;373;611;1947;723;2320
522000;201609;2305;6219;1614;5309;195;690;914;3134;1109;3824
522005;201609;403;978;262;751;79;216;93;273;172;489
522010;201609;3487;9875;2792;8643;993;3118;616;1916;1609;5034
522015;201609;917;2678;734;2354;172;554;344;1102;516;1656
522020;201609;5223;13405;3826;11129;932;2781;1854;5320;2786;8101
522026;201609;651;1804;455;1541;103;369;158;571;261;940
522028;201609;550;1534;423;1247;53;148;255;752;308;900
522040;201609;2469;5932;1894;5195;376;1029;1204;3355;1580;4384
522045;201609;15512;49944;12004;42306;3304;12575;2089;7149;5393;19724
522050;201609;1173;3310;771;2481;174;573;199;554;373;1127
522060;201609;2451;7383;1946;6538;518;1862;936;3131;1454;4993
522068;201609;1742;5317;1507;5006;190;579;1135;3933;1325;4512
522070;201609;702;2071;614;1921;68;256;416;1283;484;1539
522100;201609;514;1536;435;1418;158;572;172;534;330;1106
522108;201609;869;2632;707;2355;62;248;535;1742;597;1990
522119;201609;1409;4239;1142;3776;267;917;521;1765;788;2682
522130;201609;360;1002;291;919;82;262;164;534;246;796
522140;201609;17815;49508;13644;41926;4064;13206;3266;9411;7330;22617
522145;201609;834;2294;698;2083;245;739;276;888;521;1627
522150;201609;999;2623;773;2242;215;611;295;887;510;1498
522155;201609;833;2344;706;2133;139;382;427;1366;566;1748
522157;201609;665;1810;550;1638;36;125;426;1261;462;1386
522160;201609;6188;17376;4096;13317;1164;4090;397;1260;1561;5350
522170;201609;2347;6794;1771;5689;581;1961;385;1192;966;3153
522180;201609;349;1006;253;837;83;301;60;204;143;505
522185;201609;15702;44219;12369;39647;3574;11937;6078;19697;9652;31634
522190;201609;903;2230;665;1880;117;334;318;942;435;1276
522200;201609;1721;5495;1308;4541;335;1220;302;989;637;2209
522205;201609;1423;3925;1104;3389;193;635;580;1738;773;2373
522220;201609;1400;3642;1083;3240;226;661;603;1901;829;2562
522230;201609;1250;3474;1024;3106;114;412;647;1929;761;2341
530010;201609;227767;700822;193524;637253;51152;184362;67974;215980;119126;400342
110001;201608;3371;11106;2969;10464;679;2522;1413;5043;2092;7565
110002;201608;13278;38463;10223;33135;3071;10807;2920;9265;5991;20072
110003;201608;766;2449;660;2254;191;687;145;476;336;1163
110004;201608;10106;31334;8157;27443;2388;8649;1389;4864;3777;13513
110005;201608;1841;5802;1584;5329;516;1787;597;2018;1113;3805
110006;201608;1941;5804;1287;4530;346;1306;138;427;484;1733
110007;201608;1357;4096;1221;3831;362;1228;461;1617;823;2845
110008;201608;2354;7975;2202;7771;367;1207;1589;5878;1956;7085
110009;201608;4640;13920;3576;12202;1032;3780;1002;3451;2034;7231
110010;201608;7524;22705;6562;21370;1825;6042;3055;10856;4880;16898
110011;201608;7495;23085;6356;20883;2166;7483;1862;6070;4028;13553
110012;201608;15754;44859;12331;39030;3277;10879;2996;9701;6273;20580
110013;201608;5346;16843;4578;15455;1829;6412;1048;3743;2877;10155
110014;201608;4080;11863;3488;10920;922;2955;1663;5248;2585;8203
110015;201608;4931;14636;3425;11682;887;3255;523;1757;1410;5012
110018;201608;4132;11577;3018;9867;743;2738;997;3102;1740;5840
110020;201608;64152;174760;47493;152029;10474;35632;20248;66982;30722;102614
110025;201608;4282;12202;3454;10730;554;1833;2053;6278;2607;8111
110026;201608;634;1937;582;1856;144;435;314;1058;458;1493
110028;201608;6784;20359;5332;17538;1433;5127;683;2212;2116;7339
110029;201608;1386;3957;1100;3503;309;1027;436;1400;745;2427
110030;201608;10411;28163;7897;24676;2108;7253;2728;8677;4836;15930
110032;201608;3885;12056;3303;10927;1044;3514;839;2748;1883;6262
110033;201608;5202;16516;4627;15522;1524;5161;1538;5489;3062;10650
110034;201608;3407;9123;2737;8195;832;2577;1384;4124;2216;6701
110037;201608;1984;6669;1677;6055;440;1678;692;2504;1132;4182
110040;201608;3432;10639;2887;9629;838;3014;988;3206;1826;6220
110045;201608;5021;16136;4335;15236;1419;5448;1798;6272;3217;11720
110050;201608;1651;5256;1385;4762;470;1684;514;1779;984;3463
110060;201608;841;2741;671;2385;207;814;128;450;335;1264
110070;201608;1964;6566;1796;6218;561;2108;672;2215;1233;4323
110080;201608;4434;11996;3794;11264;619;1740;2651;8318;3270;10058
110090;201608;732;2169;577;1896;136;495;245;771;381;1266
110092;201608;1296;4304;1178;4135;209;790;731;2626;940;3416
110094;201608;3599;10678;3058;9906;1023;3532;1106;3578;2129;7110
110100;201608;2168;6825;1953;6437;545;1908;936;3093;1481;5001
110110;201608;1620;5178;1427;4910;580;2044;318;1170;898;3214
110120;201608;1772;5543;1363;4645;365;1304;254;846;619;2150
110130;201608;2432;6973;1770;5805;544;1912;348;1126;892;3038
110140;201608;2367;7641;1920;6731;497;1876;458;1466;955;3342
110143;201608;1225;3786;923;3262;296;1088;344;1245;640;2333
110145;201608;1011;2862;797;2520;207;711;355;1109;562;1820
110146;201608;440;1348;369;1239;72;232;192;672;264;904
110147;201608;730;2136;569;1830;137;463;182;554;319;1017
110148;201608;1228;3716;836;2804;142;497;73;215;215;712
110149;201608;3335;9939;2655;8834;908;3016;1005;3546;1913;6562
110150;201608;2425;7025;2006;6417;578;1972;682;2253;1260;4225
110155;201608;861;2630;745;2376;175;600;325;994;500;1594
110160;201608;1915;6166;1600;5550;566;1989;489;1736;1055;3725
110170;201608;2843;7923;2037;6441;447;1490;934;2940;1381;4430
110175;201608;1619;4934;1292;4475;214;772;685;2496;899;3268
110180;201608;1277;3715;1056;3385;277;854;531;1760;808;2614
120001;201608;2767;9398;2541;9042;514;1900;1512;5546;2026;7446
120005;201608;1569;6532;1469;6328;169;812;1038;4625;1207;5437
120010;201608;4567;15487;4365;15190;540;1887;3327;11857;3867;13744
120013;201608;1943;7754;1852;7619;434;1786;1065;4690;1499;6476
120017;201608;1973;7134;1840;6891;529;2032;768;3200;1297;5232
120020;201608;14208;62865;13686;61833;1990;9394;9419;43944;11409;53338
120025;201608;2421;8438;2326;8300;454;1709;1443;5232;1897;6941
120030;201608;6451;24949;6275;24744;218;1109;5647;22302;5865;23411
120032;201608;1468;7188;1405;7032;146;924;1043;5203;1189;6127
120033;201608;3569;14230;3476;14064;236;1051;3027;12310;3263;13361
120034;201608;2123;9045;2030;8855;155;942;1619;6958;1774;7900
120035;201608;3134;14013;3052;13853;223;1158;2564;11755;2787;12913
120038;201608;2652;9533;2501;9248;650;2477;1288;4899;1938;7376
120039;201608;1754;8465;1709;8370;160;976;1295;6386;1455;7362
120040;201608;44640;159048;40815;151946;9422;38015;20136;76267;29558;114282
120042;201608;2999;12529;2846;12185;279;1384;2113;9132;2392;10516
120043;201608;900;4165;868;4113;80;392;689;3383;769;3775
120045;201608;4369;14800;4252;14662;475;1800;3561;12267;4036;14067
120050;201608;8095;33004;7696;32160;995;4483;5254;22722;6249;27205
120060;201608;7727;34154;7544;33823;683;3612;5949;26929;6632;30541
120070;201608;2694;10019;2606;9830;447;1679;1664;6472;2111;8151
120080;201608;3592;13547;3431;13272;613;2509;2357;9279;2970;11788
130002;201608;3100;12759;2913;12475;176;921;2501;10735;2677;11656
130006;201608;1978;8434;1726;7971;229;1195;1211;5640;1440;6835
130008;201608;2221;8690;2054;8389;136;630;1667;6856;1803;7486
130010;201608;3073;10031;2805;9726;155;549;2485;8675;2640;9224
130014;201608;3190;10378;2784;9720;494;1841;1722;6093;2216;7934
130020;201608;2684;10031;2582;9850;86;470;2222;8356;2308;8826
130030;201608;7672;28753;7357;28390;289;942;6730;26541;7019;27483
130040;201608;3773;11567;3323;10957;296;1025;2633;8850;2929;9875
130050;201608;6114;24959;5743;24451;363;1578;4873;21348;5236;22926
130060;201608;5848;27065;5591;26645;528;3077;4348;20666;4876;23743
130063;201608;3785;16714;3631;16527;272;1369;3166;14532;3438;15901
130068;201608;3212;13320;2882;12621;277;1390;2021;8922;2298;10312
130070;201608;7225;23154;6374;22163;529;1767;5134;18340;5663;20107
130080;201608;5500;23949;5142;23426;647;3418;3717;17075;4364;20493
130083;201608;2179;8538;2039;8325;266;1228;1443;5893;1709;7121
130090;201608;2692;9595;2578;9425;85;397;2306;8441;2391;8838
130100;201608;5820;21171;5656;20973;135;550;5349;19916;5484;20466
130110;201608;6784;21671;6357;21174;644;1990;5178;17770;5822;19760
130115;201608;4569;16015;4325;15632;162;662;3745;13568;3907;14230
130120;201608;14825;55803;13843;54543;1356;5528;11166;45018;12522;50546
130130;201608;3973;16031;3903;15906;204;1044;3422;13912;3626;14956
130140;201608;6269;24399;6154;24269;225;931;5774;22835;5999;23766
130150;201608;3437;13532;3347;13422;136;758;3005;11969;3141;12727
130160;201608;4236;17465;4055;17227;438;2153;3267;13886;3705;16039
130165;201608;2890;11871;2748;11634;199;1032;2250;9534;2449;10566
130170;201608;9495;33097;8271;31614;929;3830;6351;24742;7280;28572
130180;201608;3481;11477;3410;11380;115;281;3182;10772;3297;11053
130185;201608;11662;36777;10377;35328;825;2401;8560;30693;9385;33094
130190;201608;16977;58263;14805;55451;2555;9711;9677;37779;12232;47490
130195;201608;1976;8285;1905;8189;104;454;1672;7325;1776;7779
130200;201608;2060;7063;1866;6761;419;1520;1142;4302;1561;5822
130210;201608;1267;4994;1185;4888;123;646;938;3818;1061;4464
130220;201608;2021;8216;1845;7880;274;1329;1127;4821;1401;6150
130230;201608;3696;16901;3454;16501;360;1865;2622;12889;2982;14754
130240;201608;8858;32763;8030;31630;364;1939;6943;27414;7307;29353
130250;201608;19934;69103;18686;67520;2776;9741;13495;51066;16271;60807
130255;201608;4347;14778;4028;14284;184;720;3516;12589;3700;13309
130260;201608;247562;806612;221469;762402;63288;233059;92483;320093;155771;553152
130270;201608;7461;30645;6917;29806;924;3996;5032;22535;5956;26531
130280;201608;3325;13763;3208;13625;101;464;2977;12802;3078;13266
130290;201608;11473;40308;10940;39695;214;552;10346;38380;10560;38932
130300;201608;4508;17224;4263;16857;246;1183;3649;14472;3895;15655
130310;201608;5007;19123;4618;18607;347;1541;3810;15564;4157;17105
130320;201608;2989;10689;2720;10315;369;1489;1859;7258;2228;8747
130330;201608;3626;13248;3296;12829;181;876;2778;10836;2959;11712
130340;201608;18226;69034;16873;67382;2438;9641;12897;53329;15335;62970
130350;201608;3318;13745;3230;13614;253;1462;2692;11183;2945;12645
130353;201608;6089;18609;5314;17639;1104;3610;3267;11675;4371;15285
130356;201608;4594;16549;4291;16089;505;1918;3130;12107;3635;14025
130360;201608;3257;9293;2866;8877;102;268;2643;8366;2745;8634
130370;201608;5647;21278;4881;20303;181;1016;4205;17584;4386;18600
130380;201608;8000;33024;7691;32583;498;2456;6531;27775;7029;30231
130390;201608;5191;22701;4860;22075;560;2944;3507;15898;4067;18842
130395;201608;2197;7690;1957;7238;235;941;1351;4956;1586;5897
130400;201608;2170;8114;2047;7937;129;624;1776;6898;1905;7522
130406;201608;10775;40728;9801;39355;2445;10255;5895;24069;8340;34324
130410;201608;3908;14815;3497;14099;1046;4554;1510;6281;2556;10835
130420;201608;10619;44557;10148;43880;2014;8715;7052;31629;9066;40344
130423;201608;3347;12955;3111;12636;258;1271;2575;10407;2833;11678
130426;201608;2341;9977;2259;9848;168;817;1902;8405;2070;9222
130430;201608;3494;12221;3334;11985;297;1084;2721;9951;3018;11035
130440;201608;3569;12883;3350;12625;216;922;2914;11019;3130;11941
140002;201608;1661;5481;1520;5283;117;500;1131;3891;1248;4391
140005;201608;3370;9382;3249;9247;63;150;3122;8952;3185;9102
140010;201608;55845;161365;45878;146647;11063;37327;18761;63249;29824;100576
140015;201608;2913;9257;2720;9025;206;533;2319;7984;2525;8517
140017;201608;3112;9898;2804;9497;269;872;2101;7427;2370;8299
140020;201608;4434;14995;3986;14376;527;2071;2756;9997;3283;12068
140023;201608;2154;7212;1868;6790;187;744;1333;4925;1520;5669
140028;201608;2101;5799;1929;5572;221;738;1421;3938;1642;4676
140030;201608;3768;11739;3489;11376;562;1515;2421;8393;2983;9908
140040;201608;1745;8024;1685;7940;119;717;1466;6830;1585;7547
140045;201608;2465;9118;2242;8810;434;1630;1461;6156;1895;7786
140047;201608;5541;16798;4854;15713;1240;4082;2182;7610;3422;11692
140050;201608;1383;4368;1231;4161;247;863;741;2549;988;3412
140060;201608;1467;4445;1301;4190;232;817;840;2694;1072;3511
140070;201608;1591;8679;1536;8517;123;845;1201;6661;1324;7506
150010;201608;36343;107956;34096;104945;2290;7475;27529;85102;29819;92577
150013;201608;1752;5060;1567;4844;185;532;1175;3744;1360;4276
150020;201608;12580;41877;12123;41246;1476;4569;9625;33788;11101;38357
150030;201608;7221;30599;6984;30245;708;2790;5725;25612;6433;28402
150034;201608;4263;11761;4016;11455;166;508;3601;10308;3767;10816
150040;201608;13074;41173;11277;39022;1597;4819;8360;30993;9957;35812
150050;201608;5686;22297;5405;21818;270;1363;4636;18718;4906;20081
150060;201608;18006;55846;16285;53145;3285;10728;9775;33028;13060;43756
150070;201608;6061;24488;5418;23809;249;1250;4889;21706;5138;22956
150080;201608;74743;192465;63272;177480;12747;35501;33124;98229;45871;133730
150085;201608;5498;18501;5221;18156;439;1303;4422;15914;4861;17217
150090;201608;10255;39090;9676;38230;822;3368;7582;30594;8404;33962
150095;201608;5325;17297;4832;16595;366;1204;3817;13570;4183;14774
150100;201608;3268;12167;3049;11776;171;799;2424;9209;2595;10008
150110;201608;3435;16722;3421;16697;214;1054;3012;14925;3226;15979
150120;201608;6543;23900;6379;23647;472;1626;5269;20205;5741;21831
150125;201608;711;2088;621;1982;109;392;395;1255;504;1647
150130;201608;22357;67609;20593;65169;2438;7436;15045;48955;17483;56391
150140;201608;165603;459816;154066;444759;18594;52548;114642;337513;133236;390061
150145;201608;4589;14509;4158;13947;520;1892;3192;10834;3712;12726
150150;201608;12197;36671;11171;35161;1865;6161;7235;23086;9100;29247
150157;201608;3145;9414;2732;8827;342;1256;1894;6213;2236;7469
150160;201608;3122;9891;2929;9608;893;2998;1517;5140;2410;8138
150170;201608;21757;79891;20538;77941;2920;11315;14501;56156;17421;67471
150172;201608;3076;10427;2693;9790;391;1471;1858;6916;2249;8387
150175;201608;1904;5760;1773;5610;150;469;1436;4727;1586;5196
150178;201608;10220;31392;8934;29925;1001;3567;6497;22476;7498;26043
150180;201608;18773;74642;18037;73689;1249;5708;15304;63056;16553;68764
150190;201608;7017;24066;6739;23688;229;863;6113;21690;6342;22553
150195;201608;5294;17268;4951;16723;192;668;4370;14918;4562;15586
150200;201608;5349;16835;5086;16533;111;375;4771;15631;4882;16006
150210;201608;25184;93589;24306;92379;1931;7378;20031;78248;21962;85626
150215;201608;7254;22811;6377;21432;1961;6863;2491;8588;4452;15451
150220;201608;12019;37212;10754;35244;2500;8357;5343;17989;7843;26346
150230;201608;11995;37230;10442;35056;1451;5102;6802;23318;8253;28420
150240;201608;35689;105666;30962;97411;10105;32912;8286;27236;18391;60148
150250;201608;4018;16767;3870;16553;724;3107;2621;11693;3345;14800
150260;201608;2048;8090;1951;7921;367;1487;1182;4962;1549;6449
150270;201608;8535;26066;6715;23721;1740;6379;3509;12863;5249;19242
150275;201608;5960;21571;5637;21062;669;2423;4135;15860;4804;18283
150276;201608;2164;6434;1919;6110;347;1175;1353;4344;1700;5519
150277;201608;4841;14816;4175;13988;849;3003;2689;9223;3538;12226
150280;201608;5992;26641;5801;26231;918;4278;4087;18905;5005;23183
150285;201608;2956;11338;2758;11005;375;1594;1887;7696;2262;9290
150290;201608;10064;28595;9595;28068;636;1534;8246;24921;8882;26455
150293;201608;9665;26118;7250;22813;2104;7000;2427;8441;4531;15441
150295;201608;7605;22040;6243;20444;1492;4927;3360;12175;4852;17102
150300;201608;1971;6507;1841;6332;108;489;1482;5042;1590;5531
150304;201608;4166;13116;3585;12192;611;2080;2236;7897;2847;9977
150307;201608;6647;21889;6175;21221;396;1277;5133;17846;5529;19123
150309;201608;6147;21090;5514;20147;1273;4609;3055;11816;4328;16425
150310;201608;6368;27128;6132;26774;529;2531;4963;21924;5492;24455
150320;201608;9517;23701;8727;22818;635;1495;7263;19347;7898;20842
150330;201608;14058;47501;13155;46180;1910;6753;9367;33895;11277;40648
150340;201608;2492;7914;2292;7598;242;815;1704;5691;1946;6506
150345;201608;6750;22190;6291;21565;578;1970;4930;17283;5508;19253
150350;201608;8155;24629;7545;23847;1281;3390;5390;17967;6671;21357
150360;201608;21345;65741;18567;62214;3120;10417;12117;42448;15237;52865
150370;201608;9991;36031;9232;35001;1192;4398;6836;27035;8028;31433
150375;201608;2888;12677;2792;12548;260;1197;2332;10638;2592;11835
150380;201608;10062;28742;8852;27067;524;1590;7366;22872;7890;24462
150390;201608;7936;34129;7403;33157;1271;5492;4770;22356;6041;27848
150400;201608;5931;23057;5685;22572;441;1694;4501;18292;4942;19986
150405;201608;8323;24890;7365;23695;1131;2866;5142;18138;6273;21004
150410;201608;1603;6069;1478;5815;202;900;891;3504;1093;4404
150420;201608;36885;122571;30920;112906;9683;38615;9052;35116;18735;73731
150430;201608;7428;24821;7056;24252;945;3021;5142;18297;6087;21318
150440;201608;5481;18734;5254;18422;656;2230;4010;14439;4666;16669
150442;201608;21983;62927;19348;58979;3500;10611;11410;36209;14910;46820
150445;201608;5332;18352;4926;17683;595;2117;3616;13335;4211;15452
150450;201608;4236;20471;4083;20226;453;2255;3215;16320;3668;18575
150460;201608;7069;26077;6516;25402;300;1486;5488;22148;5788;23634
150470;201608;17594;53969;16903;53159;438;1175;15848;50391;16286;51566
150475;201608;3362;11580;3091;11215;270;1020;2487;9167;2757;10187
150480;201608;14034;47551;12892;45779;1322;4855;9971;36045;11293;40900
150490;201608;7139;27249;6967;26999;266;1161;6154;24065;6420;25226
150495;201608;5004;18344;4845;18141;180;697;4439;16760;4619;17457
150497;201608;2695;9878;2417;9337;786;3163;1011;4012;1797;7175
150500;201608;3176;8724;2932;8381;225;635;2339;6663;2564;7298
150503;201608;3662;11177;3085;10431;1040;3641;1526;5405;2566;9046
150506;201608;11024;38259;10031;36848;2412;8492;5967;23618;8379;32110
150510;201608;9765;37967;8894;36197;1454;5989;5671;24058;7125;30047
150520;201608;6722;26430;6598;26269;251;966;6108;24616;6359;25582
150530;201608;12476;42427;11224;40494;1176;3921;8515;31527;9691;35448
150540;201608;4706;14225;4172;13480;261;849;3408;11054;3669;11903
150543;201608;5841;17909;5159;16937;1090;3662;3005;10231;4095;13893
150548;201608;9292;29689;8659;28892;440;1354;7816;26506;8256;27860
150549;201608;2051;6602;1877;6405;67;240;1702;5872;1769;6112
150550;201608;20341;64127;17721;59752;5304;18314;6489;22984;11793;41298
150553;201608;23053;79043;19186;71230;6841;27193;4342;16634;11183;43827
150555;201608;1762;5192;1470;4721;103;355;1060;3415;1163;3770
150560;201608;1959;6388;1835;6128;285;937;1102;3719;1387;4656
150563;201608;2708;8970;2506;8626;617;2307;1289;4419;1906;6726
150565;201608;3909;13406;3564;12868;152;716;2942;10680;3094;11396
150570;201608;5904;21243;5721;20932;508;2013;4393;16199;4901;18212
150580;201608;9735;40525;9461;40200;635;2640;8231;35785;8866;38425
150590;201608;5726;22741;5497;22452;164;760;5058;20724;5222;21484
150600;201608;7964;30591;7608;30084;338;1493;6753;26968;7091;28461
150610;201608;2430;8150;2211;7712;211;805;1555;5367;1766;6172
150611;201608;2765;9389;2590;9077;149;569;2120;7474;2269;8043
150613;201608;12366;36769;10130;33421;3148;10976;3941;13393;7089;24369
150616;201608;3062;9308;2360;8142;566;2156;751;2465;1317;4621
150618;201608;6407;21724;5760;20569;1559;5683;2857;10520;4416;16203
150619;201608;5189;17648;4762;16969;544;2129;3370;12002;3914;14131
150620;201608;6373;22725;5802;21999;736;2825;4396;17113;5132;19938
150630;201608;5870;17577;5539;17188;524;1653;4549;14401;5073;16054
150635;201608;4028;13006;3594;12150;909;3186;1490;5201;2399;8387
150640;201608;1899;5655;1816;5555;203;584;1494;4774;1697;5358
150650;201608;12397;37175;11011;34805;2959;9455;4518;14962;7477;24417
150655;201608;5180;16897;4852;16308;593;2049;3517;11954;4110;14003
150658;201608;4507;13519;3912;12698;838;2988;2331;7793;3169;10781
150660;201608;5617;17466;5092;16696;1230;4015;2582;8764;3812;12779
150670;201608;7471;19539;6126;17887;661;2049;4710;14109;5371;16158
150680;201608;59409;203419;51190;189873;15074;58036;19733;79732;34807;137768
150690;201608;2066;6307;1860;5992;237;723;1275;4204;1512;4927
150700;201608;6194;19314;5657;18595;953;3185;3676;12443;4629;15628
150710;201608;4259;14309;3812;13585;431;1589;2683;9764;3114;11353
150715;201608;4997;15610;4339;14614;447;1677;3192;10832;3639;12509
150720;201608;6483;26040;6119;25387;716;3186;4442;18903;5158;22089
150730;201608;10133;34052;9349;32773;1148;4147;7036;25308;8184;29455
150740;201608;3705;11784;3306;11060;677;2353;1719;5769;2396;8122
150745;201608;5122;16239;4619;15544;1213;4345;2592;8706;3805;13051
150746;201608;1378;4462;1312;4347;129;416;948;3179;1077;3595
150747;201608;5310;16407;4697;15641;392;1157;3536;12704;3928;13861
150750;201608;3356;10778;3065;10381;198;786;2474;8405;2672;9191
150760;201608;11179;35705;10370;34663;1778;6108;7027;24006;8805;30114
150770;201608;5978;22471;5710;22033;326;1149;4910;19920;5236;21069
150775;201608;1139;3463;984;3190;191;741;519;1648;710;2389
150780;201608;3364;10873;3257;10755;114;414;2982;9882;3096;10296
150790;201608;5007;16316;4668;15915;382;1362;3688;13398;4070;14760
150795;201608;15203;48310;13691;46000;3075;10135;7895;27801;10970;37936
150796;201608;3121;9063;2823;8712;339;1093;2135;6735;2474;7828
150797;201608;3745;12755;3424;12191;114;481;2851;10145;2965;10626
150800;201608;13947;45476;12814;44078;2681;8621;8383;30692;11064;39313
150803;201608;6752;24194;6332;23521;686;2694;4662;17517;5348;20211
150805;201608;2655;9505;2462;9188;328;1202;1744;6649;2072;7851
150808;201608;5790;19122;4724;17057;1751;6922;574;2063;2325;8985
150810;201608;19211;58634;16004;54717;2598;8703;10098;36766;12696;45469
150812;201608;5242;16467;4820;15753;521;1952;3377;10735;3898;12687
150815;201608;8583;28211;7678;27074;845;2921;5932;21559;6777;24480
150820;201608;11508;33053;10264;31669;857;2077;8180;26254;9037;28331
150830;201608;12946;48440;12165;47422;605;2973;9965;40015;10570;42988
150835;201608;2175;7636;2023;7351;442;1607;1075;4046;1517;5653
150840;201608;7364;22368;6121;20265;1344;4848;2872;9470;4216;14318
160005;201608;805;2745;764;2665;64;266;615;2113;679;2379
160010;201608;1288;4310;1284;4305;48;95;1225;4186;1273;4281
160015;201608;1731;6444;1690;6382;64;205;1562;6010;1626;6215
160020;201608;1915;6875;1785;6698;230;911;1304;4988;1534;5899
160021;201608;1083;4655;1038;4579;121;658;756;3348;877;4006
160023;201608;994;4064;983;4047;101;412;808;3375;909;3787
160025;201608;1404;4254;1388;4238;19;74;1353;4123;1372;4197
160027;201608;8282;24472;7647;23771;1721;5291;5050;16312;6771;21603
160030;201608;48895;167861;43131;158407;10507;38811;21793;85754;32300;124565
160040;201608;4255;16680;4154;16540;175;1014;3772;14798;3947;15812
160050;201608;3030;11503;2706;11043;1400;5621;759;3507;2159;9128
160053;201608;2892;10949;2825;10853;673;2550;1753;6975;2426;9525
160055;201608;555;2196;548;2187;29;128;483;1927;512;2055
160060;201608;15666;53132;14597;51856;2018;6840;10895;39823;12913;46663
160070;201608;2587;10224;2431;9958;191;918;2018;8248;2209;9166
160080;201608;2586;9707;2534;9645;75;361;2373;8996;2448;9357
170025;201608;521;1690;467;1619;126;435;238;844;364;1279
170030;201608;1176;3869;1025;3600;254;913;407;1460;661;2373
170035;201608;1437;4142;1181;3684;193;651;559;1754;752;2405
170040;201608;1892;5927;1657;5630;272;1015;902;3293;1174;4308
170070;201608;1679;4504;1306;4008;267;882;683;2067;950;2949
170100;201608;2372;7083;2047;6583;224;727;1549;5059;1773;5786
170105;201608;757;2336;595;2018;118;448;279;913;397;1361
170110;201608;952;3109;821;2868;175;652;346;1220;521;1872
170130;201608;1351;4246;1100;3759;280;1021;461;1621;741;2642
170190;201608;1536;4521;1153;3900;409;1322;216;884;625;2206
170200;201608;1601;4444;1024;3349;283;990;206;639;489;1629
170210;201608;31511;89245;25174;79114;7700;26314;5232;17250;12932;43564
170215;201608;1213;3728;1025;3439;107;408;705;2360;812;2768
170220;201608;5605;19210;5155;18331;1242;4584;2585;9326;3827;13910
170230;201608;1380;4408;1129;3926;236;921;458;1546;694;2467
170240;201608;2756;8170;2232;7350;251;977;1501;4905;1752;5882
170255;201608;3383;10706;2798;9682;877;3111;1047;3734;1924;6845
170270;201608;1027;2510;701;2068;65;187;460;1347;525;1534
170290;201608;2770;8071;2469;7724;278;612;1962;6642;2240;7254
170300;201608;1936;5875;1583;5299;176;646;1006;3417;1182;4063
170305;201608;736;2203;598;1951;94;346;311;1015;405;1361
170307;201608;1037;3626;874;3326;171;713;410;1641;581;2354
170310;201608;1602;4427;1193;3730;304;1002;506;1612;810;2614
170320;201608;1134;3248;819;2708;183;644;310;1050;493;1694
170330;201608;805;2605;729;2485;70;264;563;1896;633;2160
170360;201608;462;1445;378;1295;71;248;171;580;242;828
170370;201608;1341;3787;1022;3272;167;611;531;1674;698;2285
170380;201608;1737;5564;1400;4997;217;862;690;2486;907;3348
170382;201608;567;1881;470;1710;69;273;311;1161;380;1434
170384;201608;1569;6295;1427;6024;339;1523;725;3104;1064;4627
170386;201608;917;2714;788;2517;231;853;298;901;529;1754
170388;201608;639;1914;520;1723;103;383;188;603;291;986
170389;201608;922;3112;835;2966;67;269;628;2216;695;2485
170390;201608;1275;3640;1069;3382;94;325;824;2643;918;2968
170410;201608;546;1728;453;1564;36;149;281;961;317;1110
170460;201608;487;1325;325;1034;62;231;111;343;173;574
170510;201608;759;2507;595;2181;88;373;291;1029;379;1402
170550;201608;6858;19370;5016;16152;1553;5514;571;1805;2124;7319
170555;201608;1351;3851;1080;3435;204;701;518;1713;722;2414
170560;201608;1065;3428;834;3121;169;685;455;1796;624;2481
170600;201608;1326;3878;1166;3656;338;1022;632;2074;970;3096
170610;201608;1697;5074;1352;4511;148;552;840;2795;988;3347
170625;201608;416;1244;308;1026;46;152;97;319;143;471
170650;201608;1219;3909;1006;3522;251;909;329;1264;580;2173
170700;201608;4176;12901;3357;11537;701;2607;1426;5092;2127;7699
170710;201608;1792;5261;1426;4599;248;853;774;2501;1022;3354
170720;201608;1885;5058;1602;4616;208;505;1174;3596;1382;4101
170730;201608;979;2866;783;2555;196;660;303;1022;499;1682
170740;201608;2171;7694;1881;7157;293;1171;1180;4562;1473;5733
170755;201608;776;2433;614;2074;102;394;244;809;346;1203
170765;201608;1308;3555;973;3011;253;815;372;1211;625;2026
170770;201608;1677;5672;1526;5413;307;1089;872;3173;1179;4262
170820;201608;3513;11351;3149;10748;661;2401;1509;5210;2170;7611
170825;201608;740;2187;611;1951;91;297;306;967;397;1264
170830;201608;1409;4096;1213;3804;81;194;1031;3348;1112;3542
170900;201608;2504;8899;2356;8666;209;822;1883;7010;2092;7832
170930;201608;3763;11224;3250;10421;808;2752;1422;4736;2230;7488
170950;201608;13776;39883;10176;33513;2921;10943;1433;4677;4354;15620
170980;201608;498;1440;365;1222;65;215;142;478;207;693
171050;201608;1498;4998;1340;4699;87;399;1039;3600;1126;3999
171070;201608;1445;4529;1318;4347;322;1049;721;2479;1043;3528
171090;201608;1073;2861;882;2601;67;177;637;1891;704;2068
171110;201608;592;1729;434;1435;124;468;165;481;289;949
171150;201608;1042;2824;672;2173;116;404;386;1273;502;1677
171180;201608;696;2086;474;1625;116;409;169;632;285;1041
171190;201608;1632;6055;1440;5649;287;1200;658;2717;945;3917
171195;201608;848;2943;724;2721;103;433;424;1616;527;2049
171200;201608;684;2144;540;1870;166;622;163;537;329;1159
171215;201608;466;1362;358;1150;53;191;168;546;221;737
171240;201608;700;2545;646;2441;68;319;421;1636;489;1955
171245;201608;618;2066;503;1793;108;429;159;553;267;982
171250;201608;1029;2993;817;2643;180;637;374;1162;554;1799
171270;201608;398;1626;372;1571;126;495;132;641;258;1136
171280;201608;876;2687;720;2411;167;563;312;1125;479;1688
171320;201608;3802;11446;3187;10381;910;2947;1254;4277;2164;7224
171330;201608;2811;8114;2260;7247;605;2070;982;3133;1587;5203
171360;201608;1411;4571;1274;4359;117;433;956;3302;1073;3735
171370;201608;648;1868;553;1734;112;404;307;948;419;1352
171380;201608;1276;4098;1055;3695;416;1490;230;878;646;2368
171395;201608;887;2691;681;2288;119;475;306;981;425;1456
171420;201608;2059;6276;1567;5321;365;1313;558;1895;923;3208
171430;201608;1072;3262;889;2963;172;580;478;1590;650;2170
171488;201608;2501;7609;2130;7076;468;1542;1129;3932;1597;5474
171500;201608;850;2482;685;2219;83;271;470;1556;553;1827
171510;201608;877;3046;779;2869;66;282;539;2014;605;2296
171515;201608;502;1428;386;1222;54;166;213;672;267;838
171525;201608;641;2032;544;1876;71;267;322;1076;393;1343
171550;201608;327;1101;250;952;80;337;58;227;138;564
171570;201608;1243;3916;1075;3581;226;729;660;2269;886;2998
171575;201608;1930;5375;1430;4476;286;951;646;2014;932;2965
171610;201608;5316;16856;4427;15298;1125;4309;1353;4725;2478;9034
171620;201608;2678;7729;2288;7212;116;453;1857;5877;1973;6330
171630;201608;892;2716;733;2466;213;762;335;1130;548;1892
171650;201608;2159;6718;1680;5744;434;1576;541;1864;975;3440
171660;201608;2403;6690;1840;5685;263;872;970;2989;1233;3861
171665;201608;1467;4266;1166;3799;199;692;623;2133;822;2825
171670;201608;1922;5389;1576;4836;420;1420;633;1874;1053;3294
171700;201608;1093;3479;922;3163;136;504;529;1810;665;2314
171720;201608;720;2131;611;1955;179;594;262;858;441;1452
171750;201608;1153;3571;883;3034;246;830;240;868;486;1698
171780;201608;1144;3115;843;2685;98;348;436;1369;534;1717
171790;201608;1377;4842;1217;4536;313;1168;628;2499;941;3667
171800;201608;679;2118;588;1977;71;246;389;1360;460;1606
171820;201608;10252;30359;8476;27653;1660;5781;4199;13964;5859;19745
171830;201608;1383;5111;1227;4766;359;1350;464;1932;823;3282
171840;201608;776;2139;655;1974;42;128;515;1549;557;1677
171845;201608;712;1947;552;1681;82;272;291;907;373;1179
171850;201608;911;3235;801;3018;85;382;502;1898;587;2280
171855;201608;1122;3571;1026;3394;67;258;765;2509;832;2767
171865;201608;450;1491;389;1393;79;290;191;691;270;981
171870;201608;727;2172;577;1895;141;491;203;724;344;1215
171875;201608;1259;4023;1046;3678;91;373;693;2427;784;2800
171880;201608;817;3048;796;3019;86;327;625;2447;711;2774
171884;201608;894;2458;660;2099;159;568;144;535;303;1103
171886;201608;1392;4520;1113;3960;312;1218;231;834;543;2052
171888;201608;721;2140;531;1759;58;197;292;975;350;1172
171889;201608;505;1575;452;1488;94;316;218;770;312;1086
171890;201608;1195;3659;986;3358;154;548;551;1884;705;2432
171900;201608;488;1773;396;1544;102;430;156;609;258;1039
172000;201608;563;1833;483;1676;77;279;263;899;340;1178
172010;201608;1183;4089;1096;3941;115;496;797;2848;912;3344
172015;201608;337;1299;271;1161;59;217;129;595;188;812
172020;201608;2305;7628;2139;7364;264;965;1479;5163;1743;6128
172025;201608;701;2026;500;1675;74;267;263;913;337;1180
172030;201608;1134;3642;997;3417;55;242;768;2621;823;2863
172049;201608;1330;3431;964;2806;479;1526;313;830;792;2356
172065;201608;1361;3571;1115;3293;70;177;995;3019;1065;3196
172080;201608;2396;7525;2041;6899;205;808;1314;4405;1519;5213
172085;201608;512;1413;364;1117;57;163;105;332;162;495
172090;201608;3766;10348;3100;9377;134;444;2596;7920;2730;8364
172093;201608;606;1811;470;1574;96;365;210;701;306;1066
172097;201608;593;1782;475;1588;105;362;167;563;272;925
172100;201608;34392;100233;26105;85943;7041;25837;6498;21581;13539;47418
172110;201608;1655;6215;1463;5904;170;782;1043;4297;1213;5079
172120;201608;5100;15801;4207;14539;782;2717;2531;9085;3313;11802
172125;201608;244;773;202;695;39;155;93;324;132;479
172130;201608;551;1515;423;1307;37;144;267;818;304;962
172208;201608;2133;6232;1893;5898;265;854;1163;3665;1428;4519
172210;201608;2538;7664;2211;7196;462;1646;1253;4040;1715;5686
210005;201608;21867;67647;18412;62336;6165;22208;5939;20582;12104;42790
210010;201608;1752;6554;1585;6266;99;439;1275;5145;1374;5584
210015;201608;3435;10755;3041;10150;190;479;2554;8852;2744;9331
210020;201608;7160;17133;6693;16596;211;512;6088;15066;6299;15578
210030;201608;5505;18256;5160;17780;329;1493;4221;14398;4550;15891
210040;201608;1904;5186;1756;5015;77;207;1568;4523;1645;4730
210043;201608;6861;19028;5855;17777;660;1837;4133;13419;4793;15256
210047;201608;6639;24453;6022;23521;538;2409;4599;18033;5137;20442
210050;201608;2299;8451;1922;7724;699;2880;638;2784;1337;5664
210055;201608;1762;6049;1599;5795;117;469;1228;4473;1345;4942
210060;201608;7250;28045;6703;27031;990;4139;4331;17979;5321;22118
210070;201608;7208;21116;6652;20441;111;369;6082;18854;6193;19223
210080;201608;3706;12689;3608;12567;31;138;3438;12024;3469;12162
210083;201608;4477;15579;4080;15154;129;567;3801;14155;3930;14722
210087;201608;2991;8747;2712;8388;267;803;2150;6797;2417;7600
210090;201608;10102;32562;9552;31699;416;1485;8325;27750;8741;29235
210095;201608;6018;21539;5755;21174;314;1265;4879;18155;5193;19420
210100;201608;7334;21765;6680;20940;401;1516;5492;17023;5893;18539
210110;201608;2851;9906;2739;9758;106;492;2455;8713;2561;9205
210120;201608;26428;71892;22901;67774;2905;7315;16160;51358;19065;58673
210125;201608;3614;11385;3487;11252;176;412;3121;10373;3297;10785
210130;201608;4192;12386;3865;11931;255;812;3188;9845;3443;10657
210135;201608;1672;4905;1444;4579;94;298;1149;3688;1243;3986
210140;201608;17168;54401;14806;51194;2693;9867;8924;31825;11617;41692
210150;201608;4677;11424;4172;10808;74;201;3871;10010;3945;10211
210160;201608;17727;55565;16611;53954;1554;4573;13183;44284;14737;48857
210170;201608;14098;49601;13664;49038;742;2748;12027;43722;12769;46470
210173;201608;2040;8144;1935;7976;86;490;1713;7019;1799;7509
210177;201608;3068;9396;2908;9209;139;449;2622;8389;2761;8838
210180;201608;1484;4523;1383;4375;55;214;1166;3662;1221;3876
210190;201608;4917;15504;4495;14729;192;823;3499;11262;3691;12085
210193;201608;1396;4381;1255;4150;73;254;1030;3469;1103;3723
210197;201608;2087;6959;1920;6760;247;859;1454;5301;1701;6160
210200;201608;8375;28139;7733;27220;1010;3326;5787;21242;6797;24568
210203;201608;6869;21336;6454;20806;433;1181;5524;18288;5957;19469
210207;201608;3034;9746;2839;9401;283;871;2071;7064;2354;7935
210210;201608;8401;28342;7980;27783;74;337;7327;26047;7401;26384
210215;201608;1154;4785;1098;4696;90;461;861;3725;951;4186
210220;201608;6232;24332;5915;23821;331;1587;4956;20153;5287;21740
210230;201608;5272;16990;4895;16413;263;888;4206;14240;4469;15128
210232;201608;13099;41797;10941;39037;1582;5943;6978;26851;8560;32794
210235;201608;3681;11447;3272;10936;165;648;2767;9292;2932;9940
210237;201608;2351;8980;2282;8882;33;162;2168;8492;2201;8654
210240;201608;3026;9439;2816;9143;155;488;2338;7639;2493;8127
210250;201608;5279;16974;4944;16541;125;627;4488;14885;4613;15512
210255;201608;2623;8387;2388;7976;284;1008;1713;5740;1997;6748
210260;201608;5179;16854;4749;16208;518;1692;3585;12592;4103;14284
210270;201608;5415;15167;4734;14220;125;572;4124;12277;4249;12849
210275;201608;3645;8766;3431;8529;202;412;3085;7879;3287;8291
210280;201608;5637;16923;4830;15829;276;1191;3622;11661;3898;12852
210290;201608;5729;18789;5251;18220;309;1072;4439;15647;4748;16719
210300;201608;38346;105871;31627;97568;2357;7576;23377;75346;25734;82922
210310;201608;2942;8217;2671;7848;86;183;2343;6996;2429;7179
210312;201608;2235;6988;2105;6815;58;279;1868;6026;1926;6305
210315;201608;2664;8680;2433;8373;139;490;2092;7328;2231;7818
210317;201608;4232;13071;4032;12829;152;551;3694;11807;3846;12358
210320;201608;19417;62731;17819;60794;875;3149;15202;52818;16077;55967
210325;201608;3691;11311;3264;10667;225;824;2575;8524;2800;9348
210330;201608;35818;88090;28246;79866;4742;12006;17291;56228;22033;68234
210340;201608;11916;35353;10784;33878;1603;4667;7380;25036;8983;29703
210350;201608;10076;30660;8971;29130;567;1864;7197;23687;7764;25551
210355;201608;3957;14381;3609;13860;187;812;3055;11958;3242;12770
210360;201608;16191;48679;14561;46428;1109;3838;11260;36101;12369;39939
210370;201608;9379;22537;7844;20895;291;549;6898;19146;7189;19695
210375;201608;3189;9577;2665;8897;802;2766;1232;4257;2034;7023
210380;201608;6172;16955;5481;16017;465;1197;4413;13231;4878;14428
210390;201608;2921;10300;2652;9870;153;791;2202;8135;2355;8926
210400;201608;4872;15269;4661;15033;102;278;4436;14460;4538;14738
210405;201608;8346;22686;6667;20326;2158;6719;2285;7789;4443;14508
210407;201608;2036;7221;1748;6711;213;830;1201;4680;1414;5510
210408;201608;2427;9387;2266;9182;144;666;1900;7933;2044;8599
210409;201608;3739;13522;3521;13206;209;1007;2884;10830;3093;11837
210410;201608;3674;12086;3537;11909;346;1003;2866;10125;3212;11128
210420;201608;4130;13545;3763;12916;230;771;3041;10615;3271;11386
210430;201608;2167;6703;2088;6612;104;332;1814;5766;1918;6098
210440;201608;3995;12393;3846;12204;206;584;3442;11083;3648;11667
210450;201608;2822;8797;2495;8313;140;470;1950;6472;2090;6942
210455;201608;3943;11469;3528;10868;529;1577;2481;8003;3010;9580
210460;201608;3607;11821;3340;11408;188;749;2715;9284;2903;10033
210462;201608;1458;5249;1352;5054;86;396;1064;3975;1150;4371
210465;201608;2582;8456;2398;8202;208;598;1990;7030;2198;7628
210467;201608;6294;20717;5861;20221;381;1266;4968;17499;5349;18765
210470;201608;2059;5582;1508;4771;82;224;1132;3657;1214;3881
210480;201608;14970;47536;13003;45028;2282;7709;8636;32139;10918;39848
210490;201608;3661;10033;3169;9363;110;377;2670;7880;2780;8257
210500;201608;6352;26081;6096;25621;651;2849;4663;20025;5314;22874
210510;201608;6539;22204;6165;21761;345;1009;5241;19143;5586;20152
210515;201608;3717;11681;3553;11495;73;197;3341;10995;3414;11192
210520;201608;2664;8008;2408;7651;187;571;1961;6385;2148;6956
210530;201608;40127;120716;32459;109077;7504;28891;12562;44353;20066;73244
210535;201608;3249;11127;3099;10934;111;379;2762;9905;2873;10284
210540;201608;13514;44036;11835;41685;2269;7921;6943;26201;9212;34122
210542;201608;5895;16871;5351;16281;310;713;4628;14544;4938;15257
210545;201608;2352;7588;2231;7387;49;255;1964;6427;2013;6682
210547;201608;3750;13327;3497;12901;329;1112;2629;10010;2958;11122
210550;201608;6082;17926;5518;17341;271;598;5032;16340;5303;16938
210560;201608;4090;12749;3651;12038;170;630;3051;10055;3221;10685
210565;201608;1480;5317;1262;4962;92;480;940;3723;1032;4203
210570;201608;12501;35137;11308;33778;717;1630;9759;30092;10476;31722
210580;201608;3228;9479;2885;9047;284;637;2241;7630;2525;8267
210590;201608;4086;12860;3772;12457;267;946;3204;10637;3471;11583
210592;201608;2527;7879;2424;7707;38;167;2148;6836;2186;7003
210594;201608;2689;7534;2139;6718;121;278;1616;5326;1737;5604
210596;201608;2736;10110;2587;9828;252;1037;1913;7395;2165;8432
210598;201608;1900;5856;1738;5655;95;351;1503;4868;1598;5219
210600;201608;3291;9369;2818;8735;156;510;2231;6918;2387;7428
210610;201608;2539;8306;2367;8085;127;561;2039;6861;2166;7422
210620;201608;1960;6381;1809;6198;52;138;1646;5778;1698;5916
210630;201608;3660;12793;3272;12168;329;1446;2279;8489;2608;9935
210632;201608;4588;15801;4233;15276;459;1761;3212;11664;3671;13425
210635;201608;1884;6572;1783;6419;96;326;1539;5656;1635;5982
210637;201608;2691;9167;2474;8870;151;601;2010;7275;2161;7876
210640;201608;4259;15982;4177;15890;4;17;4075;15658;4079;15675
210650;201608;6907;20991;6694;20730;187;562;6341;19748;6528;20310
210660;201608;8423;24503;7592;23303;292;947;6798;20852;7090;21799
210663;201608;2748;8261;2588;8077;163;547;2199;6946;2362;7493
210667;201608;1874;6442;1759;6263;80;341;1521;5445;1601;5786
210670;201608;4551;16646;4317;16269;217;969;3586;13612;3803;14581
210675;201608;5157;14213;4712;13669;442;1116;3797;11389;4239;12505
210680;201608;4098;11156;3595;10551;179;456;3082;9175;3261;9631
210690;201608;7436;24989;7133;24664;284;909;6252;22371;6536;23280
210700;201608;2667;7848;2446;7604;496;1274;1584;5661;2080;6935
210710;201608;4897;15994;4592;15523;202;855;3878;13038;4080;13893
210720;201608;2624;9442;2468;9221;136;634;2175;8070;2311;8704
210725;201608;1093;4143;956;3862;113;464;599;2516;712;2980
210730;201608;1158;3529;1013;3316;85;244;790;2628;875;2872
210735;201608;4205;14382;3816;13743;535;2015;2715;10015;3250;12030
210740;201608;4997;14927;4693;14612;202;852;4219;12920;4421;13772
210745;201608;4010;11755;3753;11431;242;651;3173;9785;3415;10436
210750;201608;20595;55505;18084;52663;2035;5845;13521;40482;15556;46327
210760;201608;5933;16992;5487;16521;33;100;5331;16136;5364;16236
210770;201608;6018;16370;5187;15416;118;462;4658;13842;4776;14304
210780;201608;8178;27173;7468;25981;885;3022;5180;18611;6065;21633
210790;201608;4708;14662;4285;14178;276;694;3468;12192;3744;12886
210800;201608;4877;13597;4358;12986;128;416;3895;11653;4023;12069
210805;201608;3838;15706;3685;15444;173;904;3168;13340;3341;14244
210810;201608;5482;16560;5039;15992;338;674;4335;14391;4673;15065
210820;201608;7773;22475;7027;21377;1044;3068;4763;14893;5807;17961
210825;201608;5754;19723;5474;19345;621;2063;4291;15698;4912;17761
210830;201608;8426;24674;7982;24136;871;2231;6326;19980;7197;22211
210840;201608;3689;10017;3286;9424;120;312;2751;7893;2871;8205
210845;201608;5840;17621;5642;17406;77;178;5439;16982;5516;17160
210850;201608;6333;22213;5691;21162;603;2566;4045;15061;4648;17627
210860;201608;17978;52851;16074;50244;1230;3897;12643;40119;13873;44016
210870;201608;5852;19553;5319;18883;584;2016;4030;14670;4614;16686
210880;201608;4291;13911;4080;13635;306;1107;3381;11324;3687;12431
210890;201608;5215;15319;4725;14748;389;1089;3887;12684;4276;13773
210900;201608;5025;14934;4116;13468;1594;5507;980;3450;2574;8957
210905;201608;1852;5792;1642;5481;121;310;1283;4456;1404;4766
210910;201608;8642;27352;7721;25841;1078;3804;5162;17416;6240;21220
210920;201608;2899;10493;2768;10273;160;763;2257;8373;2417;9136
210923;201608;1511;5128;1398;4960;143;568;935;3429;1078;3997
210927;201608;4846;15400;4567;15105;73;235;4350;14513;4423;14748
210930;201608;2527;9165;2366;8926;106;594;1989;7392;2095;7986
210940;201608;2951;11077;2867;10924;193;879;2406;9100;2599;9979
210945;201608;5918;17903;5695;17655;292;460;5225;16610;5517;17070
210950;201608;5302;16279;4537;15084;432;1449;3318;11245;3750;12694
210955;201608;1900;6094;1672;5751;160;550;1175;4195;1335;4745
210960;201608;9398;29644;8645;28677;2044;6459;4942;17740;6986;24199
210970;201608;1362;4782;1197;4514;151;624;824;3112;975;3736
210975;201608;1797;5989;1706;5834;108;405;1345;4604;1453;5009
210980;201608;10386;24208;9985;23798;685;1271;8842;21685;9527;22956
210990;201608;16812;51225;13601;46729;3214;11627;6444;23092;9658;34719
211000;201608;15602;49788;13811;47666;780;3286;11452;40094;12232;43380
211003;201608;4869;17597;4405;16977;295;1345;3353;13356;3648;14701
211010;201608;6513;23812;6196;23422;83;418;5878;22360;5961;22778
211020;201608;7473;24137;7210;23749;622;2230;5807;19111;6429;21341
211023;201608;2233;7544;2149;7410;179;682;1732;5979;1911;6661
211027;201608;2884;11109;2805;10988;291;1172;2237;8873;2528;10045
211030;201608;3899;11846;3635;11569;640;1463;2682;9395;3322;10858
211040;201608;4456;16588;4244;16271;156;886;3688;14148;3844;15034
211050;201608;10373;26558;9903;26048;249;595;9319;24580;9568;25175
211060;201608;6171;21732;5980;21466;467;1762;5080;18445;5547;20207
211065;201608;1980;6351;1801;6101;75;259;1621;5532;1696;5791
211070;201608;8150;27919;7476;26821;402;1528;6148;22398;6550;23926
211080;201608;1354;4070;1149;3759;71;334;889;2798;960;3132
211085;201608;1965;6644;1792;6360;251;915;1244;4517;1495;5432
211090;201608;3542;10290;3294;9954;122;468;2824;8438;2946;8906
211100;201608;6724;17389;6548;17192;37;124;6365;16733;6402;16857
211102;201608;2976;11348;2797;11089;240;991;2324;9381;2564;10372
211105;201608;2664;8557;2272;7954;209;824;1669;5796;1878;6620
211107;201608;4508;14336;4055;13758;220;777;3320;11584;3540;12361
211110;201608;6437;19001;5172;17130;922;2968;3165;10992;4087;13960
211120;201608;36170;100337;32589;96132;5365;15183;22474;69076;27839;84259
211125;201608;2083;6606;1835;6209;113;439;1506;5098;1619;5537
211130;201608;157115;423793;145169;409009;24328;70780;75511;227066;99839;297846
211140;201608;5450;17770;5064;17188;180;736;4301;14596;4481;15332
211150;201608;9900;28402;8881;27135;413;1421;7499;22995;7912;24416
211153;201608;2875;8798;2602;8441;636;2087;1641;5506;2277;7593
211157;201608;1215;3887;1045;3634;82;374;692;2454;774;2828
211160;201608;4176;13582;3521;12487;241;1139;2420;8374;2661;9513
211163;201608;1701;5582;1595;5433;37;126;1435;4990;1472;5116
211167;201608;1523;5057;1459;4973;38;173;1359;4631;1397;4804
211170;201608;6394;16840;6118;16520;93;278;5699;15348;5792;15626
211172;201608;2484;7229;2242;6896;108;455;1905;5790;2013;6245
211174;201608;2834;8211;2548;7854;67;329;2308;7025;2375;7354
211176;201608;4336;13487;3690;12639;359;1403;2694;9322;3053;10725
211178;201608;4062;10469;3735;10088;56;153;3530;9494;3586;9647
211180;201608;4278;14827;4022;14450;292;1143;3318;12044;3610;13187
211190;201608;2866;9471;2641;9135;69;330;2282;7876;2351;8206
211195;201608;1489;4468;1242;4162;59;165;1049;3635;1108;3800
211200;201608;2171;7141;1904;6778;342;1149;1160;4403;1502;5552
211210;201608;6846;21028;6472;20522;425;1327;5429;17356;5854;18683
211220;201608;35145;100002;30081;93614;5510;17518;18858;60502;24368;78020
211223;201608;5249;16190;4792;15487;516;1599;3511;11636;4027;13235
211227;201608;1630;5736;1484;5508;109;445;1207;4529;1316;4974
211230;201608;8418;27221;7588;25856;772;2702;5672;19626;6444;22328
211240;201608;8084;27754;7645;27215;268;1229;6826;24113;7094;25342
211245;201608;5579;16433;5536;16388;113;186;5364;16088;5477;16274
211250;201608;13451;43339;12665;42416;1259;3614;10222;35854;11481;39468
211260;201608;8644;26724;8195;26116;454;1535;7281;23264;7735;24799
211270;201608;10420;35481;9326;34108;486;2228;7375;27501;7861;29729
211280;201608;13125;38935;12120;37686;1048;2666;9734;31555;10782;34221
211285;201608;1751;6389;1527;5913;271;1145;761;3060;1032;4205
211290;201608;7268;23741;6958;23343;426;1326;5962;20384;6388;21710
211300;201608;8387;24938;7782;24123;191;521;7116;22255;7307;22776
211400;201608;11983;37086;10452;34944;2743;9308;4966;18337;7709;27645
220005;201608;1861;5295;1675;5014;67;241;1356;3963;1423;4204
220010;201608;1406;4100;1245;3858;41;158;1009;3081;1050;3239
220020;201608;3334;10526;3144;10210;556;1809;1976;6456;2532;8265
220025;201608;2287;5617;2057;5275;27;81;1753;4432;1780;4513
220027;201608;1386;3724;1233;3530;66;201;996;2856;1062;3057
220030;201608;3269;8911;3197;8803;150;509;2812;7619;2962;8128
220040;201608;7724;23944;7111;22834;1434;4593;4332;13968;5766;18561
220045;201608;1397;4603;1274;4372;59;273;965;3240;1024;3513
220050;201608;4494;13530;3905;12542;191;782;3114;9906;3305;10688
220060;201608;2092;5133;1906;4913;48;94;1717;4445;1765;4539
220070;201608;2465;7149;2238;6790;149;426;1777;5418;1926;5844
220080;201608;716;2144;662;2062;47;202;556;1674;603;1876
220090;201608;1840;4627;1528;4206;50;173;1326;3594;1376;3767
220095;201608;728;1956;680;1892;12;51;630;1729;642;1780
220100;201608;1356;4080;1120;3662;77;316;839;2698;916;3014
220105;201608;2275;7172;2027;6707;156;503;1477;4938;1633;5441
220110;201608;3430;9899;3221;9566;105;407;2812;8225;2917;8632
220115;201608;2533;8540;2428;8370;124;509;2154;7379;2278;7888
220117;201608;1315;3475;1083;3124;52;152;895;2576;947;2728
220120;201608;12356;35694;11396;34514;152;675;10626;32113;10778;32788
220130;201608;862;2933;775;2794;37;210;658;2325;695;2535
220140;201608;1704;4506;1494;4249;172;382;1208;3559;1380;3941
220150;201608;7120;21505;6703;20922;170;688;5864;18113;6034;18801
220155;201608;1124;3410;899;2988;41;151;592;1948;633;2099
220157;201608;1081;2705;949;2507;22;70;814;2119;836;2189
220160;201608;2637;7945;2345;7420;85;378;1877;5856;1962;6234
220170;201608;1390;4176;1193;3860;38;182;972;3102;1010;3284
220173;201608;2072;6204;1715;5516;44;219;1365;4299;1409;4518
220177;201608;1783;5284;1746;5235;46;183;1641;4890;1687;5073
220180;201608;1137;3088;953;2751;21;70;681;1882;702;1952
220190;201608;4653;15001;4269;14496;513;1806;3216;10946;3729;12752
220191;201608;1425;4708;1337;4559;136;511;979;3270;1115;3781
220192;201608;1807;5114;1450;4484;81;273;1075;3323;1156;3596
220194;201608;1722;5149;1545;4855;105;385;1204;3697;1309;4082
220196;201608;2044;5908;1866;5598;138;483;1485;4414;1623;4897
220198;201608;1352;3834;1033;3411;15;54;958;3213;973;3267
220200;201608;4529;14896;4206;14456;383;1368;3317;11493;3700;12861
220202;201608;2197;6545;1928;6083;43;205;1659;5116;1702;5321
220205;201608;2787;7317;2489;6906;45;176;2214;6064;2259;6240
220207;201608;907;2740;767;2491;74;273;531;1711;605;1984
220208;201608;1850;5900;1586;5437;249;928;948;3230;1197;4158
220209;201608;1564;4691;1373;4358;44;185;1128;3538;1172;3723
220210;201608;1681;4502;1464;4160;34;150;1166;3199;1200;3349
220211;201608;1597;4455;1514;4356;48;201;1326;3752;1374;3953
220213;201608;1767;4981;1618;4702;36;135;1305;3690;1341;3825
220217;201608;2021;6363;1930;6260;40;142;1782;5856;1822;5998
220220;201608;10873;29938;9711;28200;731;1814;7021;20961;7752;22775
220225;201608;1098;3157;907;2891;35;129;753;2380;788;2509
220230;201608;5425;14763;4913;14057;185;485;4303;12406;4488;12891
220240;201608;2938;9018;2704;8595;121;453;2188;6916;2309;7369
220245;201608;1505;4028;1279;3719;20;63;1138;3369;1158;3432
220250;201608;3192;9143;2900;8712;83;316;2528;7594;2611;7910
220253;201608;1616;4841;1378;4407;191;677;925;2921;1116;3598
220255;201608;1770;4915;1532;4515;37;137;1252;3547;1289;3684
220260;201608;4657;14871;4097;13854;306;1059;3018;10286;3324;11345
220265;201608;1337;4606;1218;4412;112;449;798;2933;910;3382
220270;201608;6919;22399;6623;21873;405;1695;5420;17434;5825;19129
220271;201608;1492;4159;1331;3909;70;184;1094;3274;1164;3458
220272;201608;1806;5397;1638;5110;51;209;1280;3906;1331;4115
220273;201608;1230;3547;1081;3288;80;244;790;2402;870;2646
220275;201608;2125;5368;1743;4910;26;119;1564;4327;1590;4446
220277;201608;2242;6205;1963;5766;68;225;1557;4494;1625;4719
220280;201608;1566;4196;1376;3877;80;277;1100;3012;1180;3289
220285;201608;1641;4328;1354;3938;25;96;1221;3567;1246;3663
220290;201608;6037;20126;5230;18993;519;2100;3720;13594;4239;15694
220300;201608;1826;6114;1656;5862;77;413;1346;4668;1423;5081
220310;201608;2472;8279;2252;8028;82;361;1890;6807;1972;7168
220320;201608;3038;9250;2584;8418;256;940;1797;5822;2053;6762
220323;201608;1507;5272;1316;4995;137;562;1009;3854;1146;4416
220325;201608;1170;3726;983;3347;74;306;692;2319;766;2625
220327;201608;1315;4202;1196;3991;37;203;971;3145;1008;3348
220330;201608;3686;9855;3318;9404;102;251;3003;8611;3105;8862
220335;201608;1844;5725;1664;5520;27;77;1569;5274;1596;5351
220340;201608;1859;5089;1566;4636;97;323;1131;3270;1228;3593
220342;201608;1132;3729;1064;3625;63;275;852;2894;915;3169
220345;201608;2890;7351;2547;6846;56;124;2318;6248;2374;6372
220350;201608;3978;10452;3376;9517;180;552;2591;7219;2771;7771
220360;201608;1304;3588;1119;3303;85;270;861;2497;946;2767
220370;201608;9343;26643;8448;25504;310;1089;7514;22623;7824;23712
220375;201608;1491;4716;1391;4593;16;45;1335;4459;1351;4504
220380;201608;1406;3757;1177;3438;35;124;983;2814;1018;2938
220385;201608;842;2158;681;1901;15;56;546;1491;561;1547
220390;201608;9603;29095;8418;27026;2138;7001;3194;10560;5332;17561
220400;201608;1500;3740;1188;3249;65;154;915;2464;980;2618
220410;201608;1214;3539;1043;3268;65;244;808;2487;873;2731
220415;201608;879;2386;771;2239;50;153;553;1577;603;1730
220420;201608;2170;6234;1817;5539;81;233;1408;4286;1489;4519
220430;201608;2607;7312;2537;7220;117;380;2242;6321;2359;6701
220435;201608;1648;4884;1505;4648;32;131;1229;3768;1261;3899
220440;201608;2370;7827;2205;7588;162;554;1771;6030;1933;6584
220450;201608;2094;6454;1754;5965;396;1450;983;3354;1379;4804
220455;201608;1363;4185;1270;4045;49;168;1114;3558;1163;3726
220460;201608;894;2458;821;2375;45;129;703;2021;748;2150
220465;201608;2383;7833;2164;7500;345;1256;1479;5184;1824;6440
220470;201608;3859;11321;3510;10775;150;466;2749;8344;2899;8810
220480;201608;2525;7160;2216;6694;135;364;1702;5159;1837;5523
220490;201608;2300;6530;2119;6303;55;194;1876;5538;1931;5732
220500;201608;3239;8695;2733;7833;86;385;2152;5978;2238;6363
220510;201608;2796;8026;2259;7113;76;270;1696;5339;1772;5609
220515;201608;1891;4624;1682;4350;125;289;1375;3587;1500;3876
220520;201608;5189;14124;4710;13493;110;319;4215;12141;4325;12460
220525;201608;1279;3634;1213;3536;40;139;1032;2992;1072;3131
220527;201608;1385;4228;1222;3904;114;361;875;2865;989;3226
220530;201608;1283;3643;1122;3401;45;180;973;2877;1018;3057
220535;201608;871;2627;827;2569;69;225;633;1959;702;2184
220540;201608;3524;11217;3356;10956;112;519;2929;9446;3041;9965
220545;201608;1394;4629;1321;4488;131;513;999;3346;1130;3859
220550;201608;9296;29613;8523;28302;716;2557;6313;20927;7029;23484
220551;201608;1481;4642;1337;4409;66;293;1038;3330;1104;3623
220552;201608;1635;5031;1407;4602;56;295;1091;3432;1147;3727
220553;201608;1611;4674;1343;4265;52;207;1046;3392;1098;3599
220554;201608;815;2343;721;2201;49;146;570;1744;619;1890
220555;201608;2233;6856;2058;6617;51;252;1821;5766;1872;6018
220556;201608;1443;4433;1278;4117;50;212;963;3008;1013;3220
220557;201608;1574;5080;1410;4764;123;439;975;3288;1098;3727
220558;201608;1089;3310;971;3120;48;215;753;2353;801;2568
220559;201608;1587;4474;1414;4185;32;105;1196;3549;1228;3654
220560;201608;1674;4168;1394;3786;39;108;1190;3175;1229;3283
220570;201608;7347;23556;6876;22729;1134;3768;4450;15038;5584;18806
220580;201608;6591;20557;6429;20320;242;809;5830;18377;6072;19186
220585;201608;2104;7126;1938;6826;145;570;1534;5378;1679;5948
220590;201608;1344;3966;1191;3745;146;495;840;2692;986;3187
220595;201608;2400;6989;2231;6769;30;143;2047;6149;2077;6292
220600;201608;1312;3161;1083;2872;146;235;802;2280;948;2515
220605;201608;1953;5689;1685;5257;63;222;1349;4155;1412;4377
220610;201608;2730;8263;2602;8089;56;230;2361;7305;2417;7535
220620;201608;7676;25450;7381;25046;291;1382;6522;21883;6813;23265
220630;201608;398;1225;330;1098;52;186;168;567;220;753
220635;201608;1688;5805;1500;5400;69;342;1089;3835;1158;4177
220640;201608;2654;7758;2369;7359;100;354;1979;6101;2079;6455
220650;201608;2207;6417;1942;5936;113;388;1454;4424;1567;4812
220660;201608;2822;8415;2530;8024;117;578;2188;6705;2305;7283
220665;201608;1194;4004;1098;3839;21;110;947;3295;968;3405
220667;201608;1698;5581;1570;5365;79;289;1291;4406;1370;4695
220669;201608;1857;6031;1758;5861;243;993;1206;3925;1449;4918
220670;201608;1991;5840;1748;5527;120;313;1444;4684;1564;4997
220672;201608;2525;7244;2349;7030;172;538;1983;5986;2155;6524
220675;201608;1283;3667;1198;3510;73;176;935;2775;1008;2951
220680;201608;2459;7527;2319;7344;140;452;1963;6256;2103;6708
220690;201608;1739;4790;1487;4384;117;329;1132;3399;1249;3728
220695;201608;950;2690;867;2543;32;95;688;2011;720;2106
220700;201608;8623;24394;7460;22621;503;1678;5640;16994;6143;18672
220710;201608;822;2420;660;2106;44;115;485;1557;529;1672
220720;201608;2096;5403;1965;5226;51;150;1736;4594;1787;4744
220730;201608;1389;3911;1171;3577;32;128;981;2950;1013;3078
220735;201608;1029;2617;824;2264;40;112;658;1784;698;1896
220740;201608;1411;4368;1220;4113;60;206;1016;3488;1076;3694
220750;201608;4010;11240;3668;10727;279;730;2989;8859;3268;9589
220755;201608;1204;3366;1068;3154;48;166;826;2380;874;2546
220760;201608;2741;9148;2489;8816;122;570;2103;7388;2225;7958
220770;201608;22297;73623;19883;69013;6685;24350;5751;20835;12436;45185
220775;201608;1264;3486;1212;3428;18;61;1177;3329;1195;3390
220777;201608;1618;4385;1355;3974;73;162;1032;3049;1105;3211
220779;201608;1415;3615;1338;3518;43;145;1186;3077;1229;3222
220780;201608;5903;15798;5179;14710;407;1180;4110;11678;4517;12858
220785;201608;1315;3352;1239;3234;40;100;1135;2944;1175;3044
220790;201608;10325;31102;9494;29844;657;2346;7622;23783;8279;26129
220793;201608;829;2345;740;2212;36;135;600;1768;636;1903
220795;201608;1453;4145;1378;4046;64;205;1235;3621;1299;3826
220800;201608;16395;44474;14683;42027;1208;3768;10583;29767;11791;33535
220810;201608;3370;9647;2909;8873;110;433;2295;6873;2405;7306
220820;201608;5530;14858;4977;14085;273;678;4232;11986;4505;12664
220830;201608;7580;21184;7017;20299;555;1631;5515;15999;6070;17630
220840;201608;14176;44440;12539;41220;2667;8865;6102;20439;8769;29304
220850;201608;2894;9806;2722;9587;94;402;2457;8704;2551;9106
220855;201608;616;1884;537;1746;30;128;404;1283;434;1411
220860;201608;955;2533;842;2355;35;119;704;1942;739;2061
220865;201608;2625;7171;2092;6242;65;315;1643;4728;1708;5043
220870;201608;2265;7519;2007;7185;45;208;1825;6543;1870;6751
220880;201608;4766;12849;4411;12440;76;223;4116;11650;4192;11873
220885;201608;1279;4597;1122;4306;76;348;848;3248;924;3596
220887;201608;1377;3425;1211;3192;13;56;1124;2947;1137;3003
220890;201608;1651;5641;1459;5276;115;383;1099;4074;1214;4457
220900;201608;1929;5292;1704;4961;43;121;1468;4240;1511;4361
220910;201608;1547;4667;1346;4365;55;163;1166;3849;1221;4012
220915;201608;1028;2871;881;2593;26;105;673;1919;699;2024
220920;201608;1365;4871;1229;4672;87;458;922;3397;1009;3855
220930;201608;1426;4632;1338;4495;47;212;1142;3827;1189;4039
220935;201608;1091;3284;928;2937;45;172;619;1885;664;2057
220937;201608;1505;4113;1269;3722;53;195;963;2752;1016;2947
220940;201608;1351;4257;1255;4081;75;326;893;2836;968;3162
220945;201608;432;1602;390;1513;33;155;271;1029;304;1184
220950;201608;1332;3269;926;2593;20;81;714;1932;734;2013
220955;201608;1478;4217;1297;3906;74;202;985;2989;1059;3191
220960;201608;925;2389;731;2070;22;65;568;1598;590;1663
220965;201608;1660;4912;1561;4764;49;246;1330;3923;1379;4169
220970;201608;2187;5742;1614;4814;114;368;1156;3465;1270;3833
220975;201608;703;2250;647;2179;26;155;586;1909;612;2064
220980;201608;1306;3882;1141;3613;62;216;857;2715;919;2931
220985;201608;1211;3568;1140;3467;75;270;874;2592;949;2862
220987;201608;1492;4719;1338;4463;74;327;1029;3359;1103;3686
220990;201608;1833;5291;1572;4846;44;218;1218;3651;1262;3869
220995;201608;1267;3714;962;3232;81;286;664;2304;745;2590
220997;201608;2304;6982;2198;6830;43;200;2051;6316;2094;6516
221000;201608;4250;12916;3965;12431;278;1074;3103;9552;3381;10626
221005;201608;1468;4544;1340;4306;493;1443;563;1954;1056;3397
221010;201608;1188;3060;1013;2844;41;128;875;2427;916;2555
221020;201608;1773;5497;1642;5255;61;263;1211;3809;1272;4072
221030;201608;1527;4489;1354;4198;52;211;1097;3361;1149;3572
221035;201608;1480;4050;1378;3919;65;146;1252;3640;1317;3786
221037;201608;629;1855;555;1734;14;58;398;1191;412;1249
221038;201608;602;1698;486;1500;26;83;313;972;339;1055
221039;201608;950;2623;850;2475;29;120;695;1953;724;2073
221040;201608;4582;14176;4263;13651;218;744;3354;10795;3572;11539
221050;201608;3512;10604;3270;10282;125;438;2819;8834;2944;9272
221060;201608;8238;23986;7098;22109;473;1550;5418;16898;5891;18448
221062;201608;1285;4491;1160;4240;42;215;944;3420;986;3635
221063;201608;1088;3526;987;3350;160;513;641;2247;801;2760
221065;201608;2823;7554;2505;7055;87;241;2092;5824;2179;6065
221070;201608;3780;11916;3298;11051;156;616;2571;8632;2727;9248
221080;201608;3523;8904;2926;8080;93;286;2450;6765;2543;7051
221090;201608;1441;3901;1212;3532;34;151;1011;2877;1045;3028
221093;201608;1646;4872;1548;4672;222;699;924;2726;1146;3425
221095;201608;969;2568;845;2382;13;36;728;2036;741;2072
221097;201608;809;2253;652;1966;24;92;476;1398;500;1490
221100;201608;113011;329348;103080;312935;20307;64535;58016;173689;78323;238224
221110;201608;10436;32644;9664;31686;365;1535;8170;26564;8535;28099
221120;201608;4100;13178;3884;12809;661;2277;2580;8544;3241;10821
221130;201608;4710;13438;3897;11763;1185;3504;1537;4753;2722;8257
221135;201608;1523;4627;1406;4474;100;377;1161;3651;1261;4028
221140;201608;1360;3309;1224;3126;38;85;1059;2687;1097;2772
221150;201608;1232;3112;983;2680;26;102;774;2057;800;2159
221160;201608;827;2179;770;2099;31;83;606;1660;637;1743
221170;201608;1180;3548;1081;3386;48;141;865;2726;913;2867
230010;201608;3412;9179;2732;8008;208;692;2056;5930;2264;6622
230015;201608;2956;10055;2751;9617;335;1316;1724;5970;2059;7286
230020;201608;13791;44777;13360;44085;675;2602;11235;36937;11910;39539
230030;201608;12122;34564;10838;32570;452;1609;8821;26253;9273;27862
230040;201608;4553;12412;3805;11140;276;957;2743;7900;3019;8857
230050;201608;2659;8935;2014;7194;481;1695;548;2037;1029;3732
230060;201608;2269;6451;1924;5839;72;299;1464;4337;1536;4636
230070;201608;4237;11670;3604;10610;304;1038;2373;7019;2677;8057
230075;201608;8963;31414;8336;30182;567;2831;6393;22570;6960;25401
230080;201608;2458;6337;1991;5659;92;339;1617;4513;1709;4852
230090;201608;3960;11280;3481;10469;340;1138;2469;7408;2809;8546
230100;201608;16923;49933;15612;47622;2544;8372;9216;28259;11760;36631
230110;201608;13169;41564;12006;39129;2287;7670;6143;19917;8430;27587
230120;201608;7987;22049;6874;20409;794;2232;4531;14178;5325;16410
230125;201608;3079;8770;2519;7779;158;570;1799;5499;1957;6069
230130;201608;5758;18777;4872;16849;500;1885;3171;10835;3671;12720
230140;201608;3577;11241;3014;10202;269;1003;2050;6986;2319;7989
230150;201608;1724;5317;1489;4831;292;1016;771;2473;1063;3489
230160;201608;6380;18607;5668;17563;276;1085;4542;13941;4818;15026
230170;201608;6391;19830;5520;18198;313;1185;3946;12906;4259;14091
230180;201608;1726;5053;1507;4613;70;308;1098;3201;1168;3509
230185;201608;3940;12782;3523;12023;570;1991;2141;7504;2711;9495
230190;201608;12787;40491;11273;37464;2262;8003;5227;17320;7489;25323
230195;201608;5374;16224;4681;15039;319;1195;3567;11241;3886;12436
230200;201608;5187;14813;4658;13788;398;1235;3431;10018;3829;11253
230205;201608;4187;13492;3771;12763;240;1034;2653;8872;2893;9906
230210;201608;9073;25700;7894;23831;1283;3930;4791;14711;6074;18641
230220;201608;13437;37799;12059;35414;945;3114;8760;25334;9705;28448
230230;201608;7421;23499;6788;22286;753;2522;4622;15260;5375;17782
230240;201608;13954;38591;12170;35660;554;1778;9307;26974;9861;28752
230250;201608;9845;30229;9759;30083;545;2022;7463;22573;8008;24595
230260;201608;14433;47617;13316;45365;2031;7219;7419;25729;9450;32948
230270;201608;7615;22116;6429;19981;743;2526;4061;12687;4804;15213
230280;201608;20108;58511;17713;54434;1386;4537;13089;39876;14475;44413
230290;201608;4856;14559;4130;13098;541;1606;2705;8654;3246;10260
230300;201608;4463;13242;4240;12931;248;901;3419;10287;3667;11188
230310;201608;4892;14577;4228;13410;186;752;3048;9514;3234;10266
230320;201608;7187;22076;6488;20849;416;1634;4802;15206;5218;16840
230330;201608;4863;14088;4086;12572;303;984;2848;8649;3151;9633
230340;201608;3449;11463;3116;10765;325;1245;2001;6795;2326;8040
230350;201608;18436;55274;16692;52267;1697;6114;9956;31675;11653;37789
230360;201608;3278;9246;2594;7985;200;684;1689;5121;1889;5805
230365;201608;3073;8160;2665;7470;103;372;2143;5936;2246;6308
230370;201608;55537;175051;49838;165352;13168;45608;20532;70925;33700;116533
230380;201608;6604;19097;5461;16968;236;789;3888;11997;4124;12786
230390;201608;3516;11000;3100;10299;211;917;2181;7108;2392;8025
230393;201608;3227;10450;2747;9499;159;782;1949;6479;2108;7261
230395;201608;5792;16690;5161;15609;778;2308;3001;9395;3779;11703
230400;201608;5594;16653;4923;15591;244;1065;3800;11802;4044;12867
230410;201608;14651;46111;12590;41833;1683;5843;7393;24606;9076;30449
230420;201608;24615;78059;22190;73284;4508;15787;10152;33473;14660;49260
230423;201608;4270;13868;3909;13149;244;989;2927;9773;3171;10762
230425;201608;5611;18488;5112;17432;699;2439;3181;10918;3880;13357
230426;201608;2694;7478;2116;6397;66;289;1573;4639;1639;4928
230427;201608;1867;5527;1404;4515;151;492;789;2447;940;2939
230428;201608;8854;27261;8369;26358;1385;4699;4575;14232;5960;18931
230430;201608;4607;14439;4214;13720;301;1172;2992;9497;3293;10669
230435;201608;5058;15781;4507;14768;699;2592;2453;7910;3152;10502
230440;201608;365635;1061778;330620;1002397;72588;230424;152441;465327;225029;695751
230445;201608;4617;12376;3894;11275;273;785;2711;7873;2984;8658
230450;201608;3671;11403;3193;10543;302;1271;2138;6935;2440;8206
230460;201608;1982;6403;1695;5867;149;598;1154;3964;1303;4562
230465;201608;4017;11874;3351;10644;218;850;2194;6785;2412;7635
230470;201608;11050;39764;10198;38005;1227;5057;6906;25663;8133;30720
230480;201608;1495;4610;1248;4130;154;606;808;2600;962;3206
230490;201608;2320;7030;2005;6412;288;958;972;3018;1260;3976
230495;201608;5834;18936;5199;17777;770;3025;2724;9249;3494;12274
230500;201608;9071;31878;8621;30992;583;2571;6431;23025;7014;25596
230510;201608;1515;5305;1143;4339;283;1131;332;1258;615;2389
230520;201608;4880;14712;4384;13833;420;1476;2806;8758;3226;10234
230523;201608;15128;48307;13099;43702;2933;10509;3168;10854;6101;21363
230526;201608;4108;12185;3510;11125;197;870;2672;8272;2869;9142
230530;201608;5464;17358;4890;16578;906;3304;3103;10808;4009;14112
230533;201608;4082;11249;3506;10166;406;1088;2420;7134;2826;8222
230535;201608;5597;16317;4861;14998;595;1789;2992;9575;3587;11364
230540;201608;17629;51077;15845;48271;521;2134;13158;39598;13679;41732
230550;201608;19789;58086;17440;53696;3019;10056;8992;27054;12011;37110
230560;201608;6910;19680;5920;17870;165;685;4531;13457;4696;14142
230565;201608;3520;9632;2840;8391;94;340;2099;6161;2193;6501
230570;201608;3702;9967;3254;9391;101;379;2687;7663;2788;8042
230580;201608;10154;30229;9355;29081;639;2166;7742;24034;8381;26200
230590;201608;9222;28090;7853;25540;584;2296;5435;17198;6019;19494
230600;201608;3876;10505;2896;8561;186;539;1810;5410;1996;5949
230610;201608;6269;19646;5712;18733;717;2340;3908;13032;4625;15372
230620;201608;2197;6186;1734;5209;202;653;956;2773;1158;3426
230625;201608;7949;25483;7127;23632;2035;7221;1927;6428;3962;13649
230630;201608;11033;34654;10067;32848;2650;8171;4447;15651;7097;23822
230640;201608;26483;84754;24179;81276;2489;9256;17725;59364;20214;68620
230650;201608;4907;14915;4402;13940;307;1177;3245;10033;3552;11210
230655;201608;9311;34658;8932;33948;758;3222;6846;26195;7604;29417
230660;201608;6186;19057;5276;17319;306;1395;4001;12803;4307;14198
230670;201608;6111;16153;4848;13976;142;474;3734;10485;3876;10959
230680;201608;2680;7841;2302;7116;320;982;1360;4201;1680;5183
230690;201608;6374;20385;6123;19853;666;2379;3761;11934;4427;14313
230700;201608;9758;26989;8569;24830;580;2024;6035;16897;6615;18921
230710;201608;7591;24322;6569;22414;724;2523;4410;15105;5134;17628
230720;201608;1872;5869;1596;5276;210;720;926;3044;1136;3764
230725;201608;3737;12552;3250;11370;740;2640;1049;3663;1789;6303
230730;201608;57460;172188;48234;156819;13098;47751;9864;33572;22962;81323
230740;201608;6197;18247;5565;17182;193;790;4447;13533;4640;14323
230750;201608;8502;24295;7239;22218;366;1353;5424;16389;5790;17742
230760;201608;11138;32616;10217;30787;1074;3680;6885;20017;7959;23697
230763;201608;4335;13039;3811;12035;181;755;2848;8630;3029;9385
230765;201608;39623;123606;35261;115140;8861;30761;10038;33944;18899;64705
230770;201608;25223;69134;22502;65128;2912;8781;14378;41559;17290;50340
230780;201608;5977;22769;5719;22192;1329;5269;2768;11256;4097;16525
230790;201608;2836;8924;2609;8540;218;809;1944;6364;2162;7173
230800;201608;7600;26520;6902;24998;1402;5459;3089;11021;4491;16480
230810;201608;12365;39477;11562;38109;867;3101;8715;28602;9582;31703
230820;201608;3353;11440;2928;10521;401;1651;1592;5618;1993;7269
230830;201608;7580;22662;6659;20959;387;1483;4948;15357;5335;16840
230835;201608;4028;10486;3246;9283;173;548;2483;7076;2656;7624
230837;201608;3242;10784;2763;9803;250;1044;1881;6534;2131;7578
230840;201608;9263;29733;8450;28358;646;2419;6395;21589;7041;24008
230850;201608;9631;29868;8898;28595;1054;3443;5987;19437;7041;22880
230860;201608;5164;14531;4568;13656;207;715;3701;11000;3908;11715
230870;201608;18862;49180;16157;45135;676;2058;12308;34255;12984;36313
230880;201608;1997;6704;1891;6483;119;543;1332;4471;1451;5014
230890;201608;4004;14350;3703;13713;408;1887;2322;8312;2730;10199
230900;201608;2915;9628;2418;8539;508;1687;1046;3845;1554;5532
230910;201608;3171;9150;2596;8127;186;817;1894;5740;2080;6557
230920;201608;4744;13568;4413;13151;187;675;3754;11264;3941;11939
230930;201608;7171;21432;6283;19772;537;1785;4220;13281;4757;15066
230940;201608;8002;22445;7008;20888;261;904;5687;16960;5948;17864
230945;201608;6115;18365;5394;17219;400;1415;3667;11912;4067;13327
230950;201608;6504;17392;5879;16576;197;517;5081;14631;5278;15148
230960;201608;14452;44082;13174;41651;2491;8144;5940;19078;8431;27222
230970;201608;13983;41972;12210;38772;2345;8167;5316;16555;7661;24722
230980;201608;2966;9151;2577;8449;667;2151;1222;4233;1889;6384
230990;201608;1780;5215;1464;4599;115;475;937;2833;1052;3308
231000;201608;2734;7413;2176;6324;122;418;1412;4000;1534;4418
231010;201608;3151;8592;2552;7593;264;839;1673;4864;1937;5703
231020;201608;7920;26384;7462;25410;1267;4269;4329;15041;5596;19310
231025;201608;8012;24329;7256;23014;1022;3340;4541;14673;5563;18013
231030;201608;7598;24349;6344;21775;1102;3969;3317;11443;4419;15412
231040;201608;3157;9874;2805;9180;127;564;2056;6528;2183;7092
231050;201608;11985;33761;10135;30490;722;2341;7306;21899;8028;24240
231060;201608;2449;7871;2262;7528;126;633;1653;5346;1779;5979
231070;201608;8701;27281;7769;25396;1430;4812;4007;13302;5437;18114
231080;201608;3899;12105;3547;11485;140;743;2727;8489;2867;9232
231085;201608;4928;15087;4723;14795;612;1970;3290;10610;3902;12580
231090;201608;4204;11665;3335;9938;177;594;2285;6717;2462;7311
231095;201608;2217;7131;1920;6525;202;773;1242;4230;1444;5003
231100;201608;3220;9895;2674;8853;201;744;1864;6129;2065;6873
231110;201608;3554;11660;3512;11584;337;1229;2386;7803;2723;9032
231120;201608;1988;6727;1872;6489;278;1018;1142;3990;1420;5008
231123;201608;2075;5657;1783;5157;134;373;1333;3833;1467;4206
231126;201608;6347;17876;5216;15896;239;894;3770;11294;4009;12188
231130;201608;19413;58611;17471;55459;3093;10205;10131;33540;13224;43745
231135;201608;4217;12488;3566;11311;244;862;2486;7835;2730;8697
231140;201608;17278;53444;15062;49276;1129;4888;9926;31383;11055;36271
231150;201608;5828;16710;5018;15242;799;2506;2420;7475;3219;9981
231160;201608;5871;19259;5453;18424;924;3152;3124;10661;4048;13813
231170;201608;4344;13802;3847;12770;289;1126;2648;8583;2937;9709
231180;201608;14440;42448;12727;38932;2419;7661;6494;19672;8913;27333
231190;201608;4589;12835;3839;11688;247;898;2853;8447;3100;9345
231195;201608;4671;15380;4020;14100;378;1645;2699;9299;3077;10944
231200;201608;7871;26456;6860;24358;360;1833;4879;16835;5239;18668
231210;201608;4993;15551;4318;14584;256;1198;3278;10913;3534;12111
231220;201608;11956;34060;10463;31326;553;1973;7595;22278;8148;24251
231230;201608;9362;30808;8447;29420;744;3072;6163;21478;6907;24550
231240;201608;12306;37986;11058;35469;2214;7262;5358;17341;7572;24603
231250;201608;1950;5564;1323;4036;382;1179;307;892;689;2071
231260;201608;3494;10383;3130;9788;525;1633;1842;5910;2367;7543
231270;201608;7341;19954;6431;18538;272;1105;4888;13825;5160;14930
231280;201608;1772;5747;1651;5526;179;628;1101;3714;1280;4342
231290;201608;34238;114123;30821;106424;6184;23389;12791;43223;18975;66612
231300;201608;4539;13046;3665;11330;252;905;2413;7271;2665;8176
231310;201608;7513;21239;6179;18469;840;2539;3428;10121;4268;12660
231320;201608;7079;21256;5859;18810;261;1063;4187;13283;4448;14346
231325;201608;2789;8068;2418;7497;372;1343;1427;4326;1799;5669
231330;201608;12206;38073;10367;34456;1932;6430;5369;18096;7301;24526
231335;201608;5494;15371;4728;13985;154;625;3761;10902;3915;11527
231340;201608;17875;58264;16386;55903;1212;4138;12581;43881;13793;48019
231350;201608;14353;42379;13517;41245;819;2348;11644;36127;12463;38475
231355;201608;4590;14404;4185;13708;218;889;3077;9975;3295;10864
231360;201608;7762;24574;6869;23017;1191;4051;4122;14186;5313;18237
231370;201608;2442;6764;1891;5846;72;241;1407;4331;1479;4572
231375;201608;4277;14389;3979;13843;212;965;3099;10660;3311;11625
231380;201608;5532;16663;5228;16274;301;969;4171;13311;4472;14280
231390;201608;3483;10743;3178;10208;252;884;2240;7114;2492;7998
231395;201608;3891;12657;3525;11968;614;2060;1968;6797;2582;8857
231400;201608;9090;27851;8405;26501;503;1935;6188;19211;6691;21146
231410;201608;14506;48615;13268;46694;1115;4140;9905;35077;11020;39217
240010;201608;2484;7370;2052;6507;309;1106;1053;3226;1362;4332
240020;201608;10763;33435;9602;31254;1868;6440;4745;15580;6613;22020
240030;201608;2559;7205;2470;7071;134;423;2107;5990;2241;6413
240040;201608;853;2495;707;2200;20;99;500;1479;520;1578
240050;201608;3485;9385;2945;8449;96;329;2351;6622;2447;6951
240060;201608;1420;4025;1256;3718;52;194;989;2808;1041;3002
240070;201608;2567;7599;2390;7260;322;1013;1583;4737;1905;5750
240080;201608;3087;8203;2653;7602;155;463;2028;5794;2183;6257
240090;201608;2304;6138;1884;5392;44;161;1460;4088;1504;4249
240100;201608;7896;22722;7010;20915;553;1831;4957;14376;5510;16207
240110;201608;4838;15086;4302;13995;643;2324;2291;7202;2934;9526
240120;201608;2733;9325;2607;9075;345;1353;1651;5686;1996;7039
240130;201608;2792;7486;2439;6930;85;295;1993;5578;2078;5873
240140;201608;2245;6707;1904;6077;256;964;1100;3395;1356;4359
240145;201608;5822;18178;5220;17089;1372;4654;2502;8450;3874;13104
240150;201608;995;3018;822;2652;69;280;536;1652;605;1932
240160;201608;1460;4596;1252;4233;131;524;794;2703;925;3227
240165;201608;899;2812;786;2576;122;361;453;1567;575;1928
240170;201608;2340;7058;2040;6500;463;1595;958;3026;1421;4621
240180;201608;2710;8494;2386;7830;391;1375;1404;4674;1795;6049
240185;201608;1421;4692;1319;4526;82;317;1044;3593;1126;3910
240190;201608;967;3047;859;2857;35;160;650;2155;685;2315
240200;201608;13516;35383;11268;32167;2521;7481;4500;13158;7021;20639
240210;201608;2960;8152;2660;7705;148;535;2179;6174;2327;6709
240220;201608;7400;24540;6839;23702;681;2891;4956;17013;5637;19904
240230;201608;5697;15058;4907;13831;141;446;4150;11679;4291;12125
240240;201608;1829;5509;1202;3969;223;796;195;553;418;1349
240250;201608;2705;7885;2543;7661;107;342;2200;6621;2307;6963
240260;201608;12389;41450;11738;40385;1732;6554;7506;25859;9238;32413
240270;201608;2266;7243;2075;6915;183;663;1547;5207;1730;5870
240280;201608;1595;4480;1421;4226;72;237;1123;3329;1195;3566
240290;201608;1273;3978;1120;3688;51;264;716;2206;767;2470
240300;201608;2295;6265;1697;5014;222;705;764;2193;986;2898
240310;201608;9615;27171;8628;25607;1283;4121;4531;13550;5814;17671
240320;201608;2052;6038;1606;5115;52;205;1134;3479;1186;3684
240325;201608;34794;95626;27911;84699;8108;26210;6518;20758;14626;46968
240330;201608;1525;4601;1284;4091;62;239;802;2472;864;2711
240340;201608;2079;5379;1750;4860;154;458;1292;3548;1446;4006
240350;201608;2050;5801;1909;5632;90;321;1695;4977;1785;5298
240360;201608;7228;21838;6448;20668;1540;5054;3128;10455;4668;15509
240370;201608;2053;5633;1638;4858;172;472;1035;3086;1207;3558
240375;201608;866;2312;755;2117;54;197;537;1409;591;1606
240380;201608;2439;7236;1860;5935;261;857;924;2925;1185;3782
240390;201608;936;2590;783;2300;37;126;559;1592;596;1718
240400;201608;1341;3629;1069;3111;66;221;727;2044;793;2265
240410;201608;492;1630;440;1525;77;326;252;845;329;1171
240420;201608;4690;17907;4395;17246;820;3641;2335;9147;3155;12788
240430;201608;3314;9337;3017;8798;125;510;2372;6671;2497;7181
240440;201608;2504;6490;2238;6097;441;1266;1265;3395;1706;4661
240450;201608;3862;11447;3305;10365;353;1382;1917;5689;2270;7071
240460;201608;2896;8910;2733;8689;171;752;2204;6830;2375;7582
240470;201608;3586;11190;2820;9512;818;2624;1159;4038;1977;6662
240480;201608;524;1403;406;1178;27;87;203;572;230;659
240485;201608;1991;6269;1752;5783;250;896;1071;3553;1321;4449
240490;201608;1743;4393;1441;3921;34;120;1219;3272;1253;3392
240500;201608;2168;6178;1956;5864;116;399;1542;4583;1658;4982
240510;201608;1813;5326;1698;5152;148;436;1347;4117;1495;4553
240520;201608;1252;3613;1113;3383;100;363;837;2458;937;2821
240530;201608;2007;6478;1838;6211;320;1113;1203;4079;1523;5192
240540;201608;1763;5241;1681;5111;105;343;1390;4200;1495;4543
240550;201608;798;2278;684;2078;48;148;489;1475;537;1623
240560;201608;3252;9343;3024;9006;343;928;2282;6901;2625;7829
240570;201608;3092;8584;2282;6780;466;1479;788;2067;1254;3546
240580;201608;7771;23982;7199;22983;682;2462;5526;17394;6208;19856
240590;201608;786;2185;680;1992;24;87;511;1471;535;1558
240600;201608;1624;4734;1258;3959;122;439;698;2091;820;2530
240610;201608;4654;13340;4051;12189;407;1331;2573;7567;2980;8898
240615;201608;1050;3057;842;2655;154;513;451;1369;605;1882
240620;201608;1831;5552;1623;5200;159;505;1216;3901;1375;4406
240630;201608;2088;6274;1900;5956;161;421;1315;4247;1476;4668
240640;201608;930;2624;782;2388;44;188;560;1664;604;1852
240650;201608;3948;11635;3511;10982;174;614;2765;8599;2939;9213
240660;201608;2396;7619;2246;7394;183;672;1738;5689;1921;6361
240670;201608;2649;7899;2202;6959;263;865;1216;3782;1479;4647
240680;201608;1522;4430;1226;3897;92;315;803;2512;895;2827
240690;201608;964;2620;822;2376;45;165;653;1826;698;1991
240700;201608;2607;7773;2190;7015;71;302;1671;5255;1742;5557
240710;201608;18859;49093;16232;45084;3193;8720;8582;24473;11775;33193
240720;201608;5259;14988;4760;14068;1362;4175;2124;6071;3486;10246
240725;201608;1073;3216;860;2755;69;232;499;1551;568;1783
240730;201608;2147;6458;1858;5915;117;382;1346;4278;1463;4660
240740;201608;2003;5835;1778;5423;146;554;1250;3687;1396;4241
240750;201608;2174;8052;2008;7734;454;1903;924;3594;1378;5497
240760;201608;1346;3631;1116;3316;106;285;803;2518;909;2803
240770;201608;3178;9071;2837;8597;140;588;2326;6893;2466;7481
240780;201608;6154;16886;4961;14984;683;2095;2838;8723;3521;10818
240790;201608;909;2738;753;2447;33;133;527;1717;560;1850
240800;201608;35535;101386;31471;94575;7224;22433;12663;38612;19887;61045
240810;201608;86611;248317;79716;236555;21306;63831;34417;104732;55723;168563
240820;201608;6404;19532;5606;18257;1314;4585;2289;7791;3603;12376
240830;201608;8773;26988;8167;26106;338;1495;6845;21582;7183;23077
240840;201608;1220;3364;1026;3043;93;279;622;1795;715;2074
240850;201608;1319;3850;975;3060;135;436;472;1476;607;1912
240860;201608;1327;3743;1072;3288;44;158;803;2379;847;2537
240870;201608;1192;3228;972;2826;108;329;582;1597;690;1926
240880;201608;1188;3933;1117;3814;84;387;892;2950;976;3337
240890;201608;5033;14252;4234;12744;868;2702;1722;5083;2590;7785
240895;201608;2681;9180;2471;8815;255;986;1765;6356;2020;7342
240910;201608;2915;8679;2571;8026;135;500;1974;6102;2109;6602
240920;201608;768;2479;668;2262;117;433;333;1118;450;1551
240930;201608;3523;9039;3092;8516;127;350;2519;7033;2646;7383
240933;201608;1469;4014;1288;3720;50;206;1011;2818;1061;3024
240940;201608;6694;17671;5335;15405;703;1994;3226;9232;3929;11226
240950;201608;963;3144;886;3003;52;236;654;2149;706;2385
240960;201608;800;2481;708;2307;57;202;505;1659;562;1861
240970;201608;1917;5304;1614;4791;81;307;1237;3554;1318;3861
240980;201608;2982;9823;2761;9418;500;1788;1609;5504;2109;7292
240990;201608;2815;8304;2643;7981;421;1373;1636;4843;2057;6216
241000;201608;1067;2957;900;2659;43;154;626;1819;669;1973
241010;201608;2796;9460;2612;9103;333;1422;1785;5951;2118;7373
241020;201608;2064;5714;1653;4885;228;646;954;2788;1182;3434
241025;201608;1646;4992;1455;4649;63;270;1025;3227;1088;3497
241030;201608;2421;7985;2154;7438;205;834;1484;5084;1689;5918
241040;201608;2210;7521;2011;7166;145;608;1441;5162;1586;5770
241050;201608;1286;3787;1117;3492;59;236;827;2524;886;2760
241060;201608;875;2513;786;2368;60;189;555;1648;615;1837
241070;201608;776;2250;696;2108;64;241;492;1401;556;1642
241080;201608;1165;3418;950;2996;35;167;676;2065;711;2232
241090;201608;2138;6342;1784;5727;94;428;1345;4252;1439;4680
241100;201608;1191;3530;1029;3162;87;286;669;2028;756;2314
241105;201608;1208;3628;1048;3339;252;795;466;1564;718;2359
241110;201608;854;2634;700;2305;54;214;440;1399;494;1613
241120;201608;7344;22353;6663;21226;1565;4884;3436;11556;5001;16440
241140;201608;3457;9389;2978;8453;270;741;2063;5745;2333;6486
241142;201608;724;2155;543;1769;121;441;218;671;339;1112
241150;201608;5486;16082;4881;15040;549;1743;3213;9930;3762;11673
241160;201608;975;2861;868;2678;142;437;517;1579;659;2016
241170;201608;1170;3417;1085;3265;84;273;853;2539;937;2812
241180;201608;961;2668;768;2289;94;296;402;1161;496;1457
241190;201608;1205;3309;950;2782;49;183;613;1717;662;1900
241200;201608;19345;55851;17102;52408;4153;13360;7032;22094;11185;35454
241210;201608;1464;4094;1166;3484;154;543;647;1851;801;2394
241220;201608;8015;26107;7405;24977;2012;6935;3363;11680;5375;18615
241230;201608;3034;8835;2792;8441;156;563;2282;6764;2438;7327
241240;201608;1230;3611;843;2712;89;320;353;1120;442;1440
241250;201608;6079;18622;5060;16646;200;1055;3830;12183;4030;13238
241255;201608;1713;6497;1564;6144;332;1428;757;2974;1089;4402
241260;201608;5196;13989;4153;12342;175;712;3068;8953;3243;9665
241270;201608;1917;5816;1672;5319;110;435;1152;3583;1262;4018
241280;201608;1871;5391;1693;5050;159;481;1198;3565;1357;4046
241290;201608;3045;8460;2589;7681;181;607;1824;5324;2005;5931
241300;201608;1462;4174;1251;3789;55;171;857;2583;912;2754
241310;201608;1644;4844;1505;4611;102;370;1163;3529;1265;3899
241320;201608;924;3174;842;3003;96;411;534;1875;630;2286
241330;201608;1444;4486;1362;4378;92;380;1137;3591;1229;3971
241335;201608;2798;8424;2562;8001;135;474;2083;6440;2218;6914
241340;201608;1845;5687;1571;5084;339;1179;675;2096;1014;3275
241350;201608;1941;6128;1760;5780;131;558;1291;4113;1422;4671
241355;201608;1439;3984;1155;3488;50;178;910;2722;960;2900
241360;201608;2109;5677;1733;4943;71;209;1243;3437;1314;3646
241370;201608;1364;4068;1124;3581;112;399;672;2100;784;2499
241380;201608;657;1860;561;1678;70;227;329;957;399;1184
241390;201608;2796;9090;2601;8759;250;985;1935;6471;2185;7456
241400;201608;3696;10620;3347;10115;372;1198;2451;7446;2823;8644
241410;201608;2499;7599;2243;7230;375;1298;1377;4417;1752;5715
241415;201608;1665;4984;1497;4719;99;361;1151;3547;1250;3908
241420;201608;2297;7912;2018;7418;596;2365;463;1681;1059;4046
241430;201608;576;1700;447;1409;45;156;240;719;285;875
241440;201608;6358;22694;5945;22037;842;3452;4165;15505;5007;18957
241445;201608;1002;2905;955;2850;73;179;776;2456;849;2635
241450;201608;3019;8189;2643;7663;334;1031;1750;5032;2084;6063
241460;201608;3434;9911;3027;9109;233;805;2133;6250;2366;7055
241470;201608;1419;3910;1161;3570;114;394;838;2563;952;2957
241475;201608;1271;3789;1052;3365;42;216;764;2322;806;2538
241480;201608;2796;9235;2569;8835;1008;3617;547;2087;1555;5704
241490;201608;688;1820;590;1686;32;91;374;1028;406;1119
241500;201608;718;2276;619;2135;20;82;508;1742;528;1824
250010;201608;2805;8665;2379;7747;96;411;1773;5647;1869;6058
250020;201608;1684;4776;1273;4006;59;232;869;2636;928;2868
250030;201608;6986;20221;6465;19491;419;1334;5246;15701;5665;17035
250040;201608;4153;13901;3827;13195;559;1978;2330;8070;2889;10048
250050;201608;3455;10829;3198;10416;488;1648;2011;6424;2499;8072
250053;201608;1252;3740;1145;3582;141;458;777;2454;918;2912
250057;201608;619;2628;607;2614;9;14;574;2556;583;2570
250060;201608;5208;15431;4867;14937;429;1445;3780;11507;4209;12952
250070;201608;4040;12436;3729;11894;124;594;2881;8881;3005;9475
250073;201608;807;2359;695;2167;29;105;561;1711;590;1816
250077;201608;2176;6305;1792;5683;118;399;1235;3934;1353;4333
250080;201608;4202;12200;4001;11861;300;921;3117;9108;3417;10029
250090;201608;2583;7381;2424;7126;132;343;1948;5682;2080;6025
250100;201608;3868;12600;3644;12194;290;1086;2794;9196;3084;10282
250110;201608;5113;15152;4814;14723;402;1470;3789;11377;4191;12847
250115;201608;535;1702;477;1585;23;126;326;1019;349;1145
250120;201608;1988;6052;1706;5511;97;354;1294;4158;1391;4512
250130;201608;5331;16616;4885;15849;207;918;3997;12817;4204;13735
250135;201608;1079;3219;986;3062;32;120;792;2453;824;2573
250140;201608;2041;6767;1951;6627;162;678;1499;5063;1661;5741
250150;201608;5073;16940;4599;16058;244;1106;3401;11688;3645;12794
250153;201608;1462;3977;1268;3706;47;210;1071;3059;1118;3269
250157;201608;1718;5586;1577;5317;203;708;1075;3659;1278;4367
250160;201608;3305;9712;3142;9458;105;388;2852;8562;2957;8950
250170;201608;1619;4720;1473;4501;137;468;1102;3364;1239;3832
250180;201608;16036;46661;15024;45138;1594;5298;10657;31380;12251;36678
250190;201608;4251;12127;3854;11501;576;1688;2370;7035;2946;8723
250200;201608;2025;5913;1690;5416;90;336;1371;4377;1461;4713
250205;201608;883;3021;815;2873;37;179;585;2052;622;2231
250210;201608;1471;4806;1377;4665;88;373;1080;3579;1168;3952
250215;201608;1370;4450;1294;4332;96;380;858;2858;954;3238
250220;201608;754;2278;655;2144;32;135;527;1728;559;1863
250230;201608;1542;3878;1263;3424;47;169;991;2556;1038;2725
250240;201608;2326;7711;2195;7470;110;430;1764;6000;1874;6430
250250;201608;4374;13084;4011;12594;177;589;3401;10723;3578;11312
250260;201608;1720;5200;1484;4817;78;262;1141;3724;1219;3986
250270;201608;1297;4040;1173;3885;93;305;876;3020;969;3325
250280;201608;3637;10711;3194;10021;317;1020;2364;7427;2681;8447
250290;201608;1919;5117;1608;4708;32;126;1408;4130;1440;4256
250300;201608;5581;16278;5283;15927;470;1840;4348;12785;4818;14625
250310;201608;1163;3543;1038;3343;83;305;784;2488;867;2793
250320;201608;8150;24300;7678;23548;842;2864;5404;16206;6246;19070
250330;201608;2429;7561;2093;7059;141;537;1578;5283;1719;5820
250340;201608;1102;3245;984;3039;33;128;825;2501;858;2629
250350;201608;4167;11579;3740;11061;125;451;3222;9550;3347;10001
250355;201608;1905;6091;1750;5876;53;261;1504;4978;1557;5239
250360;201608;1858;5429;1722;5220;52;146;1450;4415;1502;4561
250370;201608;11698;33733;10534;32424;756;2360;9031;27986;9787;30346
250375;201608;1087;3305;1003;3186;28;110;869;2771;897;2881
250380;201608;1690;4823;1599;4707;83;317;1347;3872;1430;4189
250390;201608;1865;5063;1499;4438;183;524;941;2798;1124;3322
250400;201608;73675;195031;58335;170851;14872;45873;21163;63177;36035;109050
250403;201608;1521;4961;1403;4803;204;874;924;3054;1128;3928
250407;201608;1212;3376;1033;3097;84;226;740;2188;824;2414
250410;201608;549;1782;510;1712;22;111;398;1297;420;1408
250415;201608;1862;5551;1680;5234;106;323;1256;3889;1362;4212
250420;201608;1289;3779;1168;3598;27;110;1031;3155;1058;3265
250430;201608;6130;16610;5626;15862;265;856;4643;12829;4908;13685
250435;201608;1374;4189;1232;3933;110;412;859;2722;969;3134
250440;201608;4481;12826;4091;12291;133;444;3460;10359;3593;10803
250450;201608;1955;5527;1735;5236;60;217;1455;4322;1515;4539
250460;201608;6544;19574;6100;18979;495;1592;4864;15364;5359;16956
250470;201608;1597;4302;1348;3962;118;416;926;2611;1044;3027
250480;201608;3782;11387;3501;11002;88;389;3065;9631;3153;10020
250485;201608;665;1680;552;1510;29;96;442;1176;471;1272
250490;201608;3835;11932;3736;11789;716;2184;2605;8342;3321;10526
250500;201608;1780;5358;1600;5067;154;480;1174;3779;1328;4259
250510;201608;4944;13929;4393;13130;163;512;3823;11468;3986;11980
250520;201608;1780;5345;1657;5160;227;743;1003;3090;1230;3833
250523;201608;1661;5097;1611;5027;152;541;1303;4019;1455;4560
250527;201608;1423;4254;1352;4169;26;137;1235;3735;1261;3872
250530;201608;621;1887;538;1786;30;104;469;1558;499;1662
250535;201608;1327;4134;1243;3968;46;209;995;3088;1041;3297
250540;201608;2428;6844;2249;6639;53;225;1933;5591;1986;5816
250550;201608;917;3022;837;2901;46;229;664;2245;710;2474
250560;201608;1672;5230;1600;5125;76;329;1379;4309;1455;4638
250570;201608;2628;8285;2298;7646;109;488;1765;5705;1874;6193
250580;201608;1135;3021;975;2776;68;247;776;2130;844;2377
250590;201608;856;2636;791;2545;55;208;653;2061;708;2269
250600;201608;7381;21471;6897;20755;709;2037;5255;15974;5964;18011
250610;201608;3160;9103;2924;8751;228;715;2223;6620;2451;7335
250620;201608;702;2056;619;1885;82;274;399;1195;481;1469
250625;201608;2422;7770;2369;7697;60;139;2251;7410;2311;7549
250630;201608;9490;29411;8666;27743;1929;6244;4363;13998;6292;20242
250640;201608;3455;10604;3277;10374;178;770;2779;8630;2957;9400
250650;201608;857;2372;743;2209;39;146;553;1544;592;1690
250660;201608;1853;4927;1688;4710;24;49;1594;4491;1618;4540
250670;201608;2401;8058;2279;7843;121;570;1883;6340;2004;6910
250680;201608;4904;13793;4657;13499;186;608;4171;12099;4357;12707
250690;201608;6097;15878;5811;15544;392;1033;5145;13765;5537;14798
250700;201608;4737;13960;4337;13365;675;2162;2820;8609;3495;10771
250710;201608;4430;13693;3996;13116;453;1567;2767;9229;3220;10796
250720;201608;2718;7835;2537;7563;74;324;2239;6600;2313;6924
250730;201608;3531;10632;3280;10291;236;823;2528;7776;2764;8599
250740;201608;1919;5556;1663;5165;160;599;1242;3716;1402;4315
250750;201608;100999;283748;92502;271378;12050;38103;61084;176926;73134;215029
250760;201608;2259;6407;2015;6050;138;523;1624;4804;1762;5327
250770;201608;3926;13003;3697;12701;439;1723;2584;8793;3023;10516
250780;201608;1842;5332;1584;4867;158;585;1020;3030;1178;3615
250790;201608;2405;7796;2274;7574;486;1580;1315;4552;1801;6132
250800;201608;2697;7527;2374;7013;91;275;1944;5650;2035;5925
250810;201608;1301;3810;1138;3560;68;286;891;2740;959;3026
250820;201608;1864;5843;1789;5750;78;337;1605;5109;1683;5446
250830;201608;5641;18113;5200;17232;490;1844;3575;11616;4065;13460
250840;201608;904;2945;765;2647;51;217;512;1782;563;1999
250850;201608;1998;6141;1813;5840;86;397;1424;4501;1510;4898
250855;201608;1092;3207;972;3030;51;216;713;2144;764;2360
250860;201608;3199;10340;2743;9489;640;2360;985;3446;1625;5806
250870;201608;1064;3085;945;2847;29;105;733;2170;762;2275
250880;201608;1489;4044;1262;3730;139;425;937;2796;1076;3221
250890;201608;9386;28068;8833;27310;1111;3994;6218;18687;7329;22681
250900;201608;2837;9142;2480;8444;213;709;1803;6168;2016;6877
250905;201608;2041;6447;1956;6338;226;786;1507;4890;1733;5676
250910;201608;4946;14367;4652;13927;210;723;3840;11419;4050;12142
250915;201608;1402;4305;1377;4270;101;226;1191;3823;1292;4049
250920;201608;3288;9322;3080;9010;271;763;2261;6626;2532;7389
250930;201608;2034;6217;1907;6014;157;617;1418;4365;1575;4982
250933;201608;1132;3697;1053;3545;82;300;699;2318;781;2618
250937;201608;675;2076;605;1941;46;174;435;1361;481;1535
250939;201608;1545;4696;1442;4530;149;515;994;3072;1143;3587
250940;201608;3812;11243;3563;10844;101;372;3065;9360;3166;9732
250950;201608;1293;3928;1139;3723;46;192;893;2929;939;3121
250960;201608;1083;3493;1028;3408;60;228;826;2711;886;2939
250970;201608;8524;23456;7436;21768;623;1905;5439;15792;6062;17697
250980;201608;2576;7562;2341;7143;84;353;1753;5146;1837;5499
250990;201608;1970;6636;1756;6169;240;976;1096;3706;1336;4682
251000;201608;2123;6259;1899;5913;55;244;1584;4868;1639;5112
251010;201608;2776;8123;2486;7663;77;260;2133;6590;2210;6850
251020;201608;1650;4675;1508;4492;71;214;1361;4059;1432;4273
251030;201608;1083;3058;992;2904;59;209;720;2050;779;2259
251040;201608;1796;5614;1614;5310;73;346;1209;3843;1282;4189
251050;201608;1083;3131;912;2804;131;406;539;1631;670;2037
251060;201608;1042;2375;780;2036;35;112;613;1581;648;1693
251065;201608;475;1420;416;1330;27;92;282;851;309;943
251070;201608;631;1775;567;1683;33;117;449;1287;482;1404
251080;201608;19484;54502;17492;51295;4558;13986;7479;22581;12037;36567
251090;201608;2997;9199;2644;8538;193;705;1908;6046;2101;6751
251100;201608;989;3104;892;2939;76;311;592;1875;668;2186
251110;201608;1944;5653;1689;5159;133;374;1154;3520;1287;3894
251120;201608;6148;20685;5848;20145;572;2348;4339;14684;4911;17032
251130;201608;3986;10255;3651;9894;94;237;3470;9477;3564;9714
251140;201608;4264;12948;4009;12541;104;459;3377;10509;3481;10968
251150;201608;2606;8310;2422;8028;189;808;1791;5792;1980;6600
251160;201608;1863;5959;1803;5881;53;220;1662;5411;1715;5631
251170;201608;1430;4336;1352;4236;78;312;1155;3556;1233;3868
251180;201608;2551;7677;2314;7313;352;1135;1429;4510;1781;5645
251190;201608;4386;12075;4219;11886;147;447;3911;10965;4058;11412
251200;201608;3822;12353;3644;12132;82;356;3330;11076;3412;11432
251203;201608;1032;3424;1006;3373;48;227;774;2548;822;2775
251207;201608;1109;3414;950;3124;49;233;641;2026;690;2259
251210;201608;7976;22439;6810;20908;681;2059;5155;16249;5836;18308
251220;201608;1183;3112;967;2800;85;247;722;2108;807;2355
251230;201608;4605;13652;4221;13192;226;839;3719;11496;3945;12335
251240;201608;3311;9946;3039;9591;353;1142;2266;7117;2619;8259
251250;201608;10481;30641;9680;29465;754;2670;7277;21675;8031;24345
251260;201608;485;1539;444;1481;24;103;327;1068;351;1171
251270;201608;4266;13747;3919;13315;123;588;3424;11587;3547;12175
251272;201608;1380;3961;1315;3876;87;279;1148;3360;1235;3639
251274;201608;913;2815;820;2652;76;312;544;1706;620;2018
251275;201608;1260;3631;1184;3504;62;277;920;2599;982;2876
251276;201608;1227;3739;1154;3614;67;269;866;2636;933;2905
251278;201608;599;1870;531;1748;58;222;345;1125;403;1347
251280;201608;2360;7019;2201;6756;98;382;1761;5247;1859;5629
251290;201608;5705;15556;5353;15129;556;1951;4168;11419;4724;13370
251300;201608;783;2596;738;2529;35;149;583;1975;618;2124
251310;201608;2985;8908;2740;8560;119;526;2193;6671;2312;7197
251315;201608;1641;5622;1560;5483;146;528;1141;4025;1287;4553
251320;201608;1898;5256;1456;4535;47;160;1055;3276;1102;3436
251330;201608;1793;4789;1520;4435;66;288;1320;3751;1386;4039
251335;201608;1033;3450;946;3299;76;343;673;2289;749;2632
251340;201608;3411;9589;3016;9010;185;714;2271;6566;2456;7280
251350;201608;1284;4081;1195;3922;78;298;916;2934;994;3232
251360;201608;1825;5697;1581;5370;55;236;1371;4686;1426;4922
251365;201608;804;2362;648;2038;17;68;459;1427;476;1495
251370;201608;22497;69799;21747;68761;2021;7423;16756;51774;18777;59197
251380;201608;1364;4208;1173;3884;32;173;984;3136;1016;3309
251385;201608;795;2112;672;1929;64;175;449;1246;513;1421
251390;201608;5897;19939;5277;18748;1410;5132;2359;8469;3769;13601
251392;201608;1058;3122;935;2929;57;201;710;2196;767;2397
251394;201608;618;1934;510;1739;42;159;351;1186;393;1345
251396;201608;832;2346;713;2152;84;251;457;1367;541;1618
251398;201608;980;2822;853;2597;32;124;583;1727;615;1851
251400;201608;1175;3286;999;3032;85;302;724;2125;809;2427
251410;201608;1510;3889;1282;3519;45;180;1065;2822;1110;3002
251420;201608;1999;5716;1752;5424;195;640;1266;3884;1461;4524
251430;201608;1638;5610;1494;5381;64;327;1238;4386;1302;4713
251440;201608;1246;3674;1018;3238;46;187;760;2396;806;2583
251445;201608;1503;4602;1420;4490;108;428;1103;3376;1211;3804
251450;201608;4584;14576;4290;14177;105;488;3600;11894;3705;12382
251455;201608;1085;3473;976;3271;70;271;672;2246;742;2517
251460;201608;810;2517;754;2422;76;236;583;1903;659;2139
251465;201608;440;1403;391;1300;13;66;294;946;307;1012
251470;201608;1179;3435;977;3035;81;293;595;1809;676;2102
251480;201608;945;2657;829;2471;27;125;657;1894;684;2019
251490;201608;1770;5268;1582;4978;139;516;1096;3396;1235;3912
251500;201608;1713;5441;1646;5320;104;428;1356;4273;1460;4701
251510;201608;2599;8463;2354;7979;399;1419;1326;4488;1725;5907
251520;201608;954;2587;836;2395;108;306;531;1499;639;1805
251530;201608;12129;33627;11426;32663;278;1191;9947;27830;10225;29021
251540;201608;2912;9246;2681;8811;170;697;2109;6845;2279;7542
251550;201608;3526;9165;2984;8442;75;273;2492;6988;2567;7261
251560;201608;706;2194;652;2097;87;325;390;1191;477;1516
251570;201608;1014;2991;813;2603;42;177;556;1708;598;1885
251580;201608;1918;5366;1755;5147;349;866;1131;3482;1480;4348
251590;201608;1491;4619;1425;4532;47;171;1175;3714;1222;3885
251593;201608;1000;3105;927;3002;135;456;555;1751;690;2207
251597;201608;1924;5873;1857;5789;50;209;1665;5125;1715;5334
251600;201608;6510;19098;6051;18376;333;1053;4873;14732;5206;15785
251610;201608;3335;9911;3002;9336;270;825;2167;6814;2437;7639
251615;201608;1143;3269;929;2893;75;251;616;1894;691;2145
251620;201608;15436;41775;13778;39791;619;1795;11248;33963;11867;35758
251630;201608;4678;12017;3978;11031;335;971;3006;8200;3341;9171
251640;201608;2554;7421;2160;6770;99;420;1640;5050;1739;5470
251650;201608;3971;11421;3625;10960;227;681;3055;9242;3282;9923
251660;201608;3549;11329;3267;10829;111;541;2721;8793;2832;9334
251670;201608;4441;13231;3836;12451;44;143;3530;11649;3574;11792
251675;201608;730;2302;672;2225;115;431;419;1338;534;1769
251680;201608;2765;7868;2262;7095;84;349;1752;5429;1836;5778
251690;201608;3272;9817;3026;9342;127;448;2255;6816;2382;7264
251700;201608;1949;6282;1826;6126;87;421;1538;5060;1625;5481
251710;201608;900;2358;615;1787;109;352;255;667;364;1019
251720;201608;1428;4366;1239;4032;69;335;945;2960;1014;3295
251740;201608;784;2205;617;1920;60;197;383;1196;443;1393
260005;201608;26008;62631;21930;56918;4546;11540;11487;30301;16033;41841
260010;201608;10087;27128;8348;24846;1197;3639;4821;14931;6018;18570
260020;201608;6137;16832;5163;15390;220;783;4115;12323;4335;13106
260030;201608;6236;17705;5543;16647;371;1227;4267;12787;4638;14014
260040;201608;9959;24042;8203;22001;699;1749;6197;17312;6896;19061
260050;201608;11386;34921;10613;34012;546;1964;9071;29394;9617;31358
260060;201608;3916;10944;3461;10139;323;927;2496;7470;2819;8397
260070;201608;9908;28467;9057;27130;1203;3949;5986;17620;7189;21569
260080;201608;5874;15367;5216;14468;604;1646;3673;10163;4277;11809
260090;201608;5217;14294;4851;13771;663;1847;3475;9970;4138;11817
260100;201608;3390;9289;2924;8642;149;604;2403;7049;2552;7653
260105;201608;5037;13954;4762;13496;189;725;4031;11164;4220;11889
260110;201608;21271;59264;19540;57216;806;2500;17203;50495;18009;52995
260120;201608;12265;36678;10958;34417;2400;7717;5586;18095;7986;25812
260130;201608;3274;9091;3058;8754;398;1171;2157;6142;2555;7313
260140;201608;13296;32663;11381;30351;796;2303;8906;23869;9702;26172
260150;201608;3217;8903;2873;8451;193;711;2242;6544;2435;7255
260160;201608;5618;17524;4880;16547;272;1190;3958;13443;4230;14633
260170;201608;16532;46185;15700;45012;1040;3337;12911;36668;13951;40005
260180;201608;3294;9937;2987;9510;171;543;2495;7996;2666;8539
260190;201608;16393;37836;14843;35934;440;1138;12817;30683;13257;31821
260200;201608;11358;29045;10438;27848;472;1454;8963;23896;9435;25350
260210;201608;11771;35188;10450;33184;529;2039;8487;26972;9016;29011
260220;201608;9594;27438;9233;26975;416;1520;8113;23344;8529;24864
260230;201608;9758;27621;8965;26516;424;1469;7263;21514;7687;22983
260240;201608;3010;8882;2608;8300;321;1120;1816;5802;2137;6922
260250;201608;2305;6291;2043;5936;119;356;1669;4823;1788;5179
260260;201608;12404;34773;11282;33172;1261;4017;8339;24749;9600;28766
260270;201608;3679;10585;3375;10127;238;984;2519;7236;2757;8220
260280;201608;13044;41837;11889;40116;723;2506;9742;33293;10465;35799
260290;201608;31681;94539;29835;91318;5078;16354;18189;55116;23267;71470
260300;201608;8708;26438;7659;24862;384;1604;5903;19256;6287;20860
260310;201608;4660;13608;4242;12988;1093;3072;2323;7611;3416;10683
260320;201608;7284;23163;6709;22235;381;1423;5472;18190;5853;19613
260330;201608;2662;8468;2450;8077;108;441;1898;6126;2006;6567
260340;201608;1892;5487;1737;5248;45;155;1552;4675;1597;4830
260345;201608;23112;71318;21491;68265;5622;19486;7893;23909;13515;43395
260350;201608;4903;13117;4536;12598;181;606;3867;10636;4048;11242
260360;201608;2375;6791;2159;6427;134;505;1483;4390;1617;4895
260370;201608;5740;17796;5032;16520;403;1596;3544;11558;3947;13154
260380;201608;4873;15913;4415;15185;249;1027;3294;11275;3543;12302
260390;201608;4298;13667;3749;12575;289;1070;2623;8708;2912;9778
260392;201608;3512;11112;3180;10678;216;965;2630;8621;2846;9586
260400;201608;13929;39053;13132;37743;1557;4954;9023;25414;10580;30368
260410;201608;61938;175428;53930;162836;14708;47023;19736;61091;34444;108114
260415;201608;3866;12032;3320;10956;246;1063;2125;6722;2371;7785
260420;201608;12233;27646;10749;26030;215;707;9728;23297;9943;24004
260430;201608;2914;9359;2553;8681;241;884;1658;5637;1899;6521
260440;201608;3345;10022;2945;9215;371;1280;1845;5635;2216;6915
260450;201608;5020;14658;4787;14327;186;625;4221;12675;4407;13300
260460;201608;5654;17782;5132;16787;913;3205;2765;8872;3678;12077
260470;201608;4582;13671;4184;13197;171;511;3651;11844;3822;12355
260480;201608;4151;11741;3643;11030;522;1736;2347;7177;2869;8913
260490;201608;5085;13267;4392;12096;238;741;3524;9500;3762;10241
260500;201608;5958;17015;5284;15929;810;2426;3308;10065;4118;12491
260510;201608;8888;23507;8184;22588;358;1156;7134;19519;7492;20675
260515;201608;4806;14406;3702;12188;235;853;2323;7667;2558;8520
260520;201608;16390;42145;15575;41053;1673;4405;11914;31304;13587;35709
260530;201608;9880;29873;8710;28084;369;1376;7318;23649;7687;25025
260540;201608;6186;15101;5608;14479;872;1546;4224;11761;5096;13307
260545;201608;71;254;48;187;8;33;11;38;19;71
260550;201608;2772;8952;2331;7980;413;1516;979;3364;1392;4880
260560;201608;6225;16437;5574;15511;151;586;4868;13343;5019;13929
260570;201608;6944;22461;6327;21472;562;2159;4616;15623;5178;17782
260580;201608;3756;10422;3470;9950;127;439;2928;8228;3055;8667
260590;201608;6188;15423;5782;14959;318;803;4964;12896;5282;13699
260600;201608;28291;82123;25271;77140;2001;7214;18189;55015;20190;62229
260610;201608;6589;19679;6218;19085;752;2444;4362;13209;5114;15653
260620;201608;15814;47541;15046;46220;2304;7832;9409;28195;11713;36027
260630;201608;2248;6569;1997;6181;103;430;1608;4868;1711;5298
260640;201608;17390;47494;16245;45959;2323;6868;10727;30334;13050;37202
260650;201608;5470;17074;4833;15976;300;1145;3779;12549;4079;13694
260660;201608;7872;21664;7024;20581;331;1091;5897;17187;6228;18278
260670;201608;2409;6371;1963;5747;129;399;1381;4047;1510;4446
260680;201608;21758;61122;19798;57650;3740;11115;9650;28128;13390;39243
260690;201608;3682;9898;3040;8837;220;631;2250;6526;2470;7157
260700;201608;5825;17226;5672;17060;35;67;5548;16867;5583;16934
260710;201608;1344;3926;1253;3808;88;281;936;2902;1024;3183
260720;201608;18072;56695;16931;54554;3541;11732;8996;29092;12537;40824
260730;201608;6814;22503;6359;21756;816;2945;4535;15437;5351;18382
260740;201608;1302;3864;1138;3570;92;328;817;2558;909;2886
260750;201608;6919;20738;6114;19723;305;928;5255;17323;5560;18251
260760;201608;4784;12790;4488;12418;219;716;3719;10311;3938;11027
260765;201608;7834;26242;7426;25553;957;4192;4982;16473;5939;20665
260770;201608;3827;10155;3493;9646;119;383;2820;7704;2939;8087
260775;201608;5001;14620;4704;14176;427;1562;3293;9637;3720;11199
260780;201608;3680;11783;3424;11287;660;2390;1744;5523;2404;7913
260790;201608;112183;281856;103374;268738;20754;54955;57815;149455;78569;204410
260795;201608;3108;9167;2767;8648;223;781;1989;6248;2212;7029
260800;201608;4947;13162;4598;12689;140;508;4088;10976;4228;11484
260805;201608;3854;11306;3300;10408;362;1311;2199;6823;2561;8134
260810;201608;6867;19061;6585;18696;301;907;5714;16186;6015;17093
260820;201608;4161;11678;3685;10934;752;2300;1892;5567;2644;7867
260825;201608;2912;9249;2594;8728;164;629;1957;6611;2121;7240
260830;201608;3734;11915;3335;11145;521;1719;2091;7127;2612;8846
260840;201608;4296;12185;3797;11451;239;843;3057;9125;3296;9968
260845;201608;4224;12170;3979;11738;455;1383;2873;8522;3328;9905
260850;201608;4972;16184;4393;14885;804;2944;2007;6730;2811;9674
260860;201608;3558;10832;3114;9951;159;574;2368;7519;2527;8093
260870;201608;4281;11418;3750;10744;367;1013;2848;8237;3215;9250
260875;201608;6522;18040;5755;16809;808;2325;3767;11139;4575;13464
260880;201608;9785;29369;8909;27954;580;1897;7031;22240;7611;24137
260890;201608;13250;37690;12304;36215;732;2446;9310;27212;10042;29658
260900;201608;5901;17977;5058;16358;388;1555;3188;10133;3576;11688
260910;201608;3061;9123;2756;8638;158;585;2072;6462;2230;7047
260915;201608;4598;15260;4329;14891;82;412;3962;13582;4044;13994
260920;201608;3196;9709;2948;9369;170;632;2353;7585;2523;8217
260930;201608;3897;12553;3419;11753;357;1257;2336;8047;2693;9304
260940;201608;14053;37110;12796;35090;1514;4660;8424;22497;9938;27157
260950;201608;6365;19513;5697;18163;832;3028;2890;8753;3722;11781
260960;201608;56328;154963;51251;146784;9858;29633;26167;74226;36025;103859
260970;201608;5004;14965;4558;14387;287;1062;3538;11197;3825;12259
260980;201608;4022;13111;3767;12789;124;524;3333;11291;3457;11815
260990;201608;17523;53370;15898;51137;1076;3843;12499;40442;13575;44285
261000;201608;16129;43455;13176;38949;2313;7197;6669;20380;8982;27577
261010;201608;2562;7028;2344;6770;131;285;2048;6088;2179;6373
261020;201608;6258;18076;5513;16802;557;1687;3949;11903;4506;13590
261030;201608;3625;11335;3253;10689;183;720;2567;8306;2750;9026
261040;201608;5154;16492;4436;15020;391;1524;3124;10439;3515;11963
261050;201608;7933;23033;7407;22076;933;2794;4876;14611;5809;17405
261060;201608;12408;36043;11429;34319;924;3202;8431;24788;9355;27990
261070;201608;53119;128601;46589;119414;6083;15873;30354;77594;36437;93467
261080;201608;5782;16576;5432;16057;332;893;4625;13912;4957;14805
261090;201608;16674;45303;15232;43315;1215;3380;11960;34338;13175;37718
261100;201608;8224;25569;7324;24008;1239;4289;4155;13829;5394;18118
261110;201608;62125;182122;54785;171140;12929;42735;25395;81386;38324;124121
261120;201608;3823;10018;3332;9441;81;291;2944;8350;3025;8641
261130;201608;7140;18125;6582;17499;153;480;5942;15774;6095;16254
261140;201608;3265;9051;2950;8570;367;1220;1841;5223;2208;6443
261150;201608;5409;15490;4964;14794;323;1189;4083;12060;4406;13249
261153;201608;2158;6229;1776;5649;83;334;1293;4111;1376;4445
261160;201608;198742;518051;183083;495335;45027;126527;81291;222598;126318;349125
261170;201608;5958;16052;5394;15237;449;1326;4161;11838;4610;13164
261180;201608;9654;26683;8938;25660;964;3054;5963;16896;6927;19950
261190;201608;5224;15930;4848;15466;461;1880;3437;10619;3898;12499
261200;201608;3612;8989;3242;8555;363;955;2525;6729;2888;7684
261210;201608;1912;5020;1773;4844;134;355;1529;4206;1663;4561
261220;201608;13366;41123;11257;36693;1547;5572;5941;19145;7488;24717
261230;201608;4649;14487;4257;13999;121;535;3708;12280;3829;12815
261240;201608;4986;14461;4562;13749;575;1618;3150;9662;3725;11280
261245;201608;3614;11013;3099;10084;141;636;2408;7643;2549;8279
261247;201608;3281;9963;2788;9068;219;828;1932;6369;2151;7197
261250;201608;19565;51714;18263;49961;3370;8886;11988;33895;15358;42781
261255;201608;4078;12534;3610;11695;225;962;2794;8808;3019;9770
261260;201608;12422;34572;11092;32934;514;1603;9302;27883;9816;29486
261270;201608;3657;10833;3291;10237;318;1116;2275;6930;2593;8046
261280;201608;2568;7756;2371;7461;125;476;1913;5944;2038;6420
261290;201608;2955;8395;2666;8014;146;529;2143;6466;2289;6995
261300;201608;10745;34341;9327;31753;1295;4981;5651;18967;6946;23948
261310;201608;7344;22505;6880;21658;1693;5436;3581;11327;5274;16763
261320;201608;5829;17903;5327;17003;207;776;4245;13444;4452;14220
261330;201608;5650;15895;5320;15452;364;1239;4366;12481;4730;13720
261340;201608;3944;13120;3713;12743;359;1528;2510;8510;2869;10038
261350;201608;8133;26495;7616;25615;250;1300;6141;20111;6391;21411
261360;201608;8197;21471;7245;20125;606;1765;5552;15150;6158;16915
261370;201608;19821;57994;18357;55668;3727;11700;9932;30219;13659;41919
261380;201608;4160;14095;3837;13413;554;2132;2416;8412;2970;10544
261390;201608;16460;49702;14814;46984;2053;6918;8822;28164;10875;35082
261400;201608;4697;16004;4170;14912;307;1313;2919;10356;3226;11669
261410;201608;8902;24492;7954;23034;703;2129;6073;17554;6776;19683
261420;201608;7512;25027;7167;24553;1557;6031;4194;14069;5751;20100
261430;201608;3455;10570;3005;9909;235;808;2300;7720;2535;8528
261440;201608;1564;4895;1401;4635;48;251;1071;3460;1119;3711
261450;201608;14311;40273;13724;39561;313;1161;12392;35527;12705;36688
261460;201608;7259;21048;6748;20361;423;1216;5739;17537;6162;18753
261470;201608;4077;11074;3716;10611;90;291;3328;9630;3418;9921
261480;201608;3761;13248;3441;12660;274;1119;2522;9147;2796;10266
261485;201608;4986;15211;4467;14308;634;2309;2687;8407;3321;10716
261500;201608;5673;15740;5042;14903;487;1343;3647;11141;4134;12484
261510;201608;1896;6021;1714;5723;116;423;1255;4220;1371;4643
261520;201608;2689;8665;2511;8326;133;526;1660;5731;1793;6257
261530;201608;11464;36754;10235;34282;2033;7508;4283;14249;6316;21757
261540;201608;7095;22895;6663;22136;1593;5259;3645;12478;5238;17737
261550;201608;3485;9748;3268;9442;237;835;2544;7177;2781;8012
261560;201608;7103;23191;6436;22283;774;3048;4667;16221;5441;19269
261570;201608;3420;10232;2977;9498;433;1446;1802;5725;2235;7171
261580;201608;6095;18325;5497;17382;307;1284;4593;14358;4900;15642
261590;201608;2465;6923;2123;6391;180;540;1531;4657;1711;5197
261600;201608;5294;14253;4530;13167;312;922;3502;10282;3814;11204
261610;201608;2425;6841;2117;6424;113;451;1700;5119;1813;5570
261618;201608;2533;7000;2289;6692;165;501;1748;5057;1913;5558
261620;201608;4120;12706;3837;12235;676;2148;2442;7968;3118;10116
261630;201608;7713;22430;6499;20163;753;2698;3703;11222;4456;13920
261640;201608;33953;84185;31815;81641;2059;4754;25753;68944;27812;73698
261650;201608;3770;11236;3504;10882;272;997;2621;8218;2893;9215
270010;201608;4490;16602;4088;15830;341;1629;2846;10951;3187;12580
270020;201608;3906;10999;3625;10592;312;1009;2852;8192;3164;9201
270030;201608;39555;117330;36758;112848;8432;26296;19565;60770;27997;87066
270040;201608;10689;32334;9821;31189;1716;5531;6239;20218;7955;25749
270050;201608;4410;12258;4004;11758;358;1176;3195;9348;3553;10524
270060;201608;1888;5522;1752;5352;280;887;1160;3608;1440;4495
270070;201608;4414;13357;4035;12855;171;779;3429;10684;3600;11463
270080;201608;1263;3962;1092;3630;143;514;669;2167;812;2681
270090;201608;2090;6434;1906;6073;59;304;1558;4767;1617;5071
270100;201608;5716;17463;5371;16883;630;2246;3843;11889;4473;14135
270110;201608;3236;8812;2848;8387;343;1026;1907;5984;2250;7010
270120;201608;3148;8788;2754;8307;104;396;2395;7194;2499;7590
270130;201608;5131;15376;4711;14900;642;2111;3445;11148;4087;13259
270135;201608;1781;4720;1605;4504;181;362;1326;3906;1507;4268
270140;201608;10423;24758;8847;22777;825;2909;6822;16501;7647;19410
270150;201608;2724;8766;2637;8660;49;162;2529;8344;2578;8506
270160;201608;5083;16639;4620;16042;175;783;3948;13596;4123;14379
270170;201608;3810;12138;3493;11712;533;2043;2114;6975;2647;9018
270180;201608;2288;7441;2096;7167;90;473;1711;5713;1801;6186
270190;201608;1798;5848;1702;5722;90;354;1427;4824;1517;5178
270200;201608;2595;8575;2415;8322;208;905;1806;6060;2014;6965
270210;201608;4732;14016;4431;13606;261;1044;3706;11178;3967;12222
270220;201608;1334;4375;1227;4187;232;842;682;2291;914;3133
270230;201608;10974;34170;9582;31996;1121;4637;5805;18752;6926;23389
270235;201608;6435;20554;5971;19826;356;1502;4840;15919;5196;17421
270240;201608;9515;28590;7957;26591;1928;6686;3682;12660;5610;19346
270250;201608;3260;8485;2946;8097;450;1212;2203;6073;2653;7285
270255;201608;4974;14869;3890;12928;225;941;2738;8901;2963;9842
270260;201608;5908;18844;5697;18546;396;1689;4760;15122;5156;16811
270270;201608;1182;3343;1076;3190;219;664;610;1786;829;2450
270280;201608;3500;9810;3071;9195;340;879;2120;6480;2460;7359
270290;201608;8212;28243;7654;27283;557;2534;5868;20585;6425;23119
270300;201608;3641;11449;3261;11002;336;1225;2363;7987;2699;9212
270310;201608;7598;22694;6653;21293;239;1219;5524;17246;5763;18465
270320;201608;5890;18333;5563;17797;813;2905;3772;11849;4585;14754
270330;201608;4294;14495;4006;14099;409;1529;3091;11003;3500;12532
270340;201608;1757;5278;1542;4990;140;467;1170;3757;1310;4224
270350;201608;1924;5111;1727;4879;143;448;1261;3571;1404;4019
270360;201608;1993;6126;1904;6026;140;415;1637;5283;1777;5698
270370;201608;1524;5000;1383;4764;105;446;1004;3440;1109;3886
270375;201608;2921;7978;2596;7551;95;318;2273;6591;2368;6909
270380;201608;5725;17419;5306;16847;673;2018;3870;12673;4543;14691
270390;201608;1273;3456;1118;3232;56;205;851;2368;907;2573
270400;201608;6387;18904;5666;17857;348;1303;4130;12669;4478;13972
270410;201608;4841;15055;4430;14314;409;1440;3095;9851;3504;11291
270420;201608;5887;18654;5635;18314;243;1102;4621;14693;4864;15795
270430;201608;137174;393157;121964;370422;33700;108345;43935;137163;77635;245508
270440;201608;4693;13970;4313;13459;174;712;3498;10911;3672;11623
270450;201608;6264;19242;5971;18869;317;1315;4910;15247;5227;16562
270460;201608;3443;9041;3079;8599;122;420;2665;7320;2787;7740
270470;201608;10444;32834;9562;31426;1075;3923;6354;20948;7429;24871
270480;201608;2853;8796;2521;8203;273;1075;1701;5297;1974;6372
270490;201608;986;3090;903;2972;38;165;711;2311;749;2476
270500;201608;4858;16463;4567;16099;275;1207;3767;13215;4042;14422
270510;201608;6008;17668;5373;16777;607;2447;3988;11907;4595;14354
270520;201608;3510;11098;3211;10585;989;3570;1014;3456;2003;7026
270530;201608;1370;4213;1265;4059;111;378;867;2829;978;3207
270540;201608;2063;6781;1879;6515;105;548;1522;5113;1627;5661
270550;201608;7210;20805;6255;19603;774;2552;4304;13804;5078;16356
270560;201608;3096;9195;2869;8846;268;986;2099;6330;2367;7316
270570;201608;3776;12148;3454;11585;429;1490;2510;8401;2939;9891
270580;201608;2061;6386;1954;6247;145;485;1580;5115;1725;5600
270590;201608;1390;4553;1326;4450;10;45;1284;4320;1294;4365
270600;201608;2841;9357;2581;8923;131;638;2058;6950;2189;7588
270610;201608;3241;9998;3001;9654;164;595;2480;7900;2644;8495
270620;201608;1405;4672;1319;4535;81;375;1050;3485;1131;3860
270630;201608;16439;47619;14967;45260;2051;6126;10151;31379;12202;37505
270640;201608;5740;17478;5153;16576;316;1328;4081;12854;4397;14182
270642;201608;2288;8061;2133;7844;206;984;1598;5755;1804;6739
270644;201608;2720;7948;2394;7504;245;753;1800;5769;2045;6522
270650;201608;3691;11485;3498;11222;431;1951;2470;7438;2901;9389
270660;201608;2103;5461;1654;4822;94;346;1204;3421;1298;3767
270670;201608;16742;42510;14400;39864;1852;4985;10289;29391;12141;34376
270680;201608;4347;12600;4138;12365;127;357;3824;11509;3951;11866
270690;201608;9186;25226;8176;24098;2548;7048;4261;13469;6809;20517
270700;201608;638;1977;573;1870;85;351;365;1121;450;1472
270710;201608;5968;18902;5638;18475;405;1640;4628;14908;5033;16548
270720;201608;3385;11295;3066;10728;129;739;2507;8570;2636;9309
270730;201608;6447;18515;6075;18119;553;1721;4996;15087;5549;16808
270740;201608;2297;6538;2161;6340;215;721;1672;4824;1887;5545
270750;201608;5168;15785;4771;15162;653;2198;3329;10566;3982;12764
270760;201608;3425;10165;3056;9563;134;520;2450;7584;2584;8104
270770;201608;19067;49373;15629;45226;3279;9428;8484;25983;11763;35411
270780;201608;1830;5849;1726;5678;198;757;1250;4047;1448;4804
270790;201608;1510;4733;1382;4550;319;1129;706;2296;1025;3425
270800;201608;11494;33370;10628;32239;647;2433;8825;26366;9472;28799
270810;201608;3334;10061;2605;8743;254;994;1598;5383;1852;6377
270820;201608;1810;5847;1614;5524;253;955;988;3371;1241;4326
270830;201608;5835;15288;5188;14513;395;1055;4107;11939;4502;12994
270840;201608;7906;25104;7289;24299;336;1740;6189;20032;6525;21772
270850;201608;7424;22849;7100;22436;934;3709;5016;14970;5950;18679
270860;201608;11048;30822;9327;28625;1089;3877;6166;18507;7255;22384
270870;201608;2165;6518;1819;5809;220;769;1180;3705;1400;4474
270880;201608;8273;26244;7641;25319;430;1786;6218;20341;6648;22127
270890;201608;2414;7340;2248;7040;216;835;1647;5004;1863;5839
270895;201608;2912;10567;2780;10378;137;677;2390;8839;2527;9516
270900;201608;1940;5200;1576;4693;104;317;1128;3296;1232;3613
270910;201608;3580;11610;3290;11093;235;1010;2507;8234;2742;9244
270915;201608;9537;31520;8543;29770;1292;5247;4961;16859;6253;22106
270920;201608;6144;19229;5895;18877;262;1315;5167;16051;5429;17366
270930;201608;17481;45910;14431;42290;2985;8489;8080;24823;11065;33312
270940;201608;5611;18387;5273;18025;482;2259;3645;12022;4127;14281
280010;201608;657;1919;569;1770;47;205;372;1071;419;1276
280020;201608;4855;13857;4170;12719;679;2271;2533;7579;3212;9850
280030;201608;76276;196689;64768;179690;18176;52570;23291;66644;41467;119214
280040;201608;3118;9435;2762;8908;222;822;2038;6503;2260;7325
280050;201608;3813;11982;3506;11467;1056;3628;1451;4832;2507;8460
280060;201608;4926;15349;4291;14224;850;3046;2091;7088;2941;10134
280067;201608;7297;20331;6241;18719;950;2818;3719;11336;4669;14154
280070;201608;1913;6228;1816;6085;220;816;1337;4453;1557;5269
280100;201608;3845;11782;3447;11095;495;1763;2195;7086;2690;8849
280110;201608;1428;4218;1295;4009;56;228;1093;3335;1149;3563
280120;201608;7867;24495;7194;23399;1094;3244;4874;16502;5968;19746
280130;201608;7616;20958;6945;19982;958;2992;4695;13578;5653;16570
280140;201608;5859;15319;5322;14554;397;1149;4249;11681;4646;12830
280150;201608;3483;10300;3234;9890;260;916;2348;6997;2608;7913
280160;201608;1375;3970;1185;3666;173;571;747;2268;920;2839
280170;201608;4808;14161;4339;13467;429;1344;3229;10152;3658;11496
280190;201608;1142;3071;1012;2863;62;214;783;2146;845;2360
280200;201608;1186;3489;1074;3324;100;377;786;2367;886;2744
280210;201608;13854;40354;12371;38292;2382;7814;6687;21005;9069;28819
280220;201608;1606;4869;1490;4686;70;275;1239;3843;1309;4118
280230;201608;3509;10303;3132;9722;344;1144;2035;6350;2379;7494
280240;201608;3492;9978;3158;9450;191;587;2499;7474;2690;8061
280250;201608;824;2163;660;1897;109;364;338;894;447;1258
280260;201608;2135;5547;1987;5366;64;194;1799;4880;1863;5074
280270;201608;2252;6937;2004;6565;114;451;1563;5022;1677;5473
280280;201608;4151;13374;3739;12693;777;2133;2114;8007;2891;10140
280290;201608;17733;52717;15989;50052;2327;7937;9661;30361;11988;38298
280300;201608;9556;28751;8961;28034;738;2524;7022;22609;7760;25133
280310;201608;1402;3882;1219;3572;51;210;880;2519;931;2729
280320;201608;8740;27279;7972;26006;1356;4749;4219;13682;5575;18431
280330;201608;4505;12737;4096;12072;432;1508;2997;8469;3429;9977
280340;201608;3898;10746;3644;10400;294;911;2929;8469;3223;9380
280350;201608;22557;62077;19946;58203;2866;8693;12596;37104;15462;45797
280360;201608;5889;18262;5407;17467;983;3503;2953;9390;3936;12893
280370;201608;1910;5257;1638;4806;183;491;1091;3238;1274;3729
280380;201608;1045;3168;939;2999;92;343;649;2005;741;2348
280390;201608;3185;9273;2721;8421;402;1284;1690;5279;2092;6563
280400;201608;4230;11665;3824;11073;1165;3361;1724;5203;2889;8564
280410;201608;2221;7000;1886;6345;263;980;1014;3281;1277;4261
280420;201608;4196;12071;3865;11558;206;662;3260;9746;3466;10408
280430;201608;2299;5827;2065;5506;102;348;1606;4188;1708;4536
280440;201608;4702;13686;4288;13157;351;1168;3292;9972;3643;11140
280445;201608;2536;6978;2336;6642;79;282;1836;5128;1915;5410
280450;201608;9229;24250;8545;23387;619;1406;7092;20045;7711;21451
280460;201608;6991;18075;6319;17120;726;2003;4595;12609;5321;14612
280470;201608;1828;5481;1651;5172;159;500;1167;3711;1326;4211
280480;201608;32552;92819;30330;89596;4894;15928;19243;55861;24137;71789
280490;201608;3881;11476;3410;10695;215;792;2512;7758;2727;8550
280500;201608;937;2477;842;2356;48;130;686;1907;734;2037
280510;201608;2677;7664;2313;7186;184;664;1665;5155;1849;5819
280520;201608;1831;4886;1660;4680;143;379;1355;3874;1498;4253
280530;201608;2486;6633;2290;6394;135;383;1876;5292;2011;5675
280540;201608;9495;25672;8754;24647;240;929;7627;21047;7867;21976
280550;201608;7052;18159;5865;16365;564;1550;4065;11392;4629;12942
280560;201608;7633;22317;7185;21673;369;1246;5980;17835;6349;19081
280570;201608;6530;17497;5650;16315;555;1746;3808;10919;4363;12665
280580;201608;5606;17071;4756;15583;767;2445;2799;9490;3566;11935
280590;201608;2521;7225;2250;6867;278;1041;1439;4291;1717;5332
280600;201608;3665;11122;3405;10736;287;1007;2540;7910;2827;8917
280610;201608;2510;6931;2271;6578;181;628;1634;4602;1815;5230
280620;201608;5305;15437;4644;14299;566;1656;3081;9884;3647;11540
280630;201608;3672;11827;3425;11450;310;1034;2674;9155;2984;10189
280640;201608;2241;6657;2127;6529;84;245;1967;6090;2051;6335
280650;201608;1134;3482;1022;3305;96;357;725;2321;821;2678
280660;201608;2774;7570;2627;7395;336;904;2091;5935;2427;6839
280670;201608;16750;43136;15364;41276;2224;6340;10239;27277;12463;33617
280680;201608;2848;7581;2478;7005;178;540;1913;5320;2091;5860
280690;201608;961;2715;848;2555;108;348;583;1750;691;2098
280700;201608;1072;3172;947;2969;67;210;668;2084;735;2294
280710;201608;12214;31463;11037;30108;664;1518;9373;26260;10037;27778
280720;201608;2373;6231;2157;5976;250;683;1474;4275;1724;4958
280730;201608;926;2753;861;2656;75;280;671;2031;746;2311
280740;201608;13446;35691;11558;32823;1519;4192;7281;21074;8800;25266
280750;201608;3539;10629;3241;10133;302;998;2261;7127;2563;8125
280760;201608;5753;17263;5207;16452;830;2812;3038;9858;3868;12670
290010;201608;3022;6757;2192;5483;46;175;1721;4099;1767;4274
290020;201608;4428;14462;4314;14314;393;999;3564;12157;3957;13156
290030;201608;3208;9774;3021;9498;473;1498;2171;6866;2644;8364
290035;201608;4687;11801;4042;10948;208;661;3080;8635;3288;9296
290040;201608;4262;11101;3603;10353;220;772;2769;7948;2989;8720
290050;201608;2486;8041;2210;7570;155;633;1580;5384;1735;6017
290060;201608;1322;3373;1107;3117;135;468;817;2211;952;2679
290070;201608;34430;84285;29388;77958;5785;15217;14368;40440;20153;55657
290080;201608;6138;18062;5194;16793;708;2346;3490;11587;4198;13933
290090;201608;2170;4707;1697;4205;119;269;1442;3656;1561;3925
290100;201608;9641;27350;8449;25499;1113;3461;5194;16110;6307;19571
290110;201608;4918;14418;4653;13968;709;2265;2926;8614;3635;10879
290115;201608;4880;14559;4307;13820;248;748;3491;11504;3739;12252
290120;201608;6861;17726;5629;16262;226;764;4658;13357;4884;14121
290130;201608;4661;12078;3827;11047;170;626;3051;8579;3221;9205
290135;201608;4691;11528;3932;10363;302;910;2815;7124;3117;8034
290140;201608;4304;13042;3675;12191;237;940;2975;9880;3212;10820
290150;201608;2223;6603;2113;6450;212;683;1642;4928;1854;5611
290160;201608;3472;8804;3300;8588;327;680;2678;7092;3005;7772
290170;201608;2776;8974;2508;8591;152;684;2082;7036;2234;7720
290180;201608;2976;8580;2560;7933;163;577;1949;6010;2112;6587
290190;201608;3838;12570;3643;12284;191;807;2823;9419;3014;10226
290195;201608;2199;5896;1832;5343;57;256;1522;4365;1579;4621
290200;201608;3960;12115;3463;11363;243;837;2686;8815;2929;9652
290205;201608;3302;9408;2948;8852;207;797;2214;6504;2421;7301
290210;201608;15053;41958;13530;39991;2246;5936;8970;28384;11216;34320
290220;201608;2313;6777;2176;6564;123;507;1707;4995;1830;5502
290225;201608;3022;7236;2686;6860;136;374;2420;6159;2556;6533
290230;201608;2270;7291;2141;7137;122;503;1762;5856;1884;6359
290240;201608;3633;9749;3282;9229;235;709;2542;7066;2777;7775
290250;201608;3934;12163;3580;11670;149;428;2984;10212;3133;10640
290260;201608;5200;14473;4314;13141;344;1134;3259;9935;3603;11069
290265;201608;3459;10652;3054;9922;157;662;2343;7534;2500;8196
290270;201608;12137;43598;11509;42605;1394;5587;8241;30687;9635;36274
290280;201608;5357;17155;4952;16494;485;1693;3550;11905;4035;13598
290290;201608;9960;30795;8795;28871;1237;4053;5751;19276;6988;23329
290300;201608;4715;13108;3393;10645;221;703;2248;7226;2469;7929
290310;201608;1469;4359;1266;4032;200;675;715;2291;915;2966
290320;201608;29133;81771;24675;76001;5463;17876;12087;38369;17550;56245
290323;201608;3927;10524;3429;9950;155;444;2813;8182;2968;8626
290327;201608;4496;13422;3849;12255;516;1653;2430;7766;2946;9419
290330;201608;1854;4498;1704;4338;103;285;1495;3827;1598;4112
290340;201608;5113;15354;4700;14852;1317;4257;2581;8246;3898;12503
290350;201608;4451;13546;3856;12650;327;1084;2710;9109;3037;10193
290360;201608;4624;13800;3984;12929;144;563;3318;10881;3462;11444
290370;201608;4844;13125;4155;12233;312;899;3324;9916;3636;10815
290380;201608;5659;16131;4895;14979;290;934;3804;11841;4094;12775
290390;201608;14924;44740;13410;42551;2054;6673;8279;27233;10333;33906
290395;201608;2607;8453;2319;7911;121;556;1742;5935;1863;6491
290400;201608;3658;10579;3074;9688;241;773;2160;6750;2401;7523
290405;201608;4766;14790;4017;13426;525;1729;2417;8326;2942;10055
290410;201608;6015;17537;4861;15717;368;1447;3413;10711;3781;12158
290420;201608;3316;9526;2756;8715;196;669;2139;6767;2335;7436
290430;201608;3165;9767;2791;9094;479;1603;1641;5431;2120;7034
290440;201608;3035;7912;2414;7030;149;508;1844;5431;1993;5939
290450;201608;3333;9586;2809;8801;244;867;1929;5988;2173;6855
290460;201608;12985;37357;11619;35013;3368;10303;4186;12722;7554;23025
290470;201608;4432;12093;3378;10538;709;2397;1501;4858;2210;7255
290475;201608;5598;17732;4964;16572;235;1083;3801;12393;4036;13476
290480;201608;2532;6744;2347;6506;236;656;1679;4922;1915;5578
290485;201608;4835;15165;4183;14191;247;1200;3354;11193;3601;12393
290490;201608;8296;21430;7807;20807;566;1649;6432;16907;6998;18556
290500;201608;4211;13083;3434;11539;502;1813;1789;6006;2291;7819
290510;201608;3415;9469;2959;8850;159;533;2370;7099;2529;7632
290515;201608;3575;9939;2993;9183;224;679;2401;7532;2625;8211
290520;201608;11982;36384;9617;31848;814;3013;5728;18900;6542;21913
290530;201608;5175;15131;4496;14069;308;932;3495;11019;3803;11951
290540;201608;3961;11251;3757;11006;327;968;3086;9137;3413;10105
290550;201608;4682;11972;4075;11282;108;313;3699;10275;3807;10588
290560;201608;6504;18381;5683;17231;1299;3799;3159;9920;4458;13719
290570;201608;43043;116695;39184;111447;3747;10998;28159;80088;31906;91086
290580;201608;7142;23843;6684;23121;693;2544;4912;17294;5605;19838
290590;201608;7360;23184;6317;21337;254;1062;5072;17097;5326;18159
290600;201608;17881;53166;16536;51277;1914;5761;12216;39080;14130;44841
290610;201608;2522;8396;2074;7512;127;578;1426;5062;1553;5640
290620;201608;6558;19532;5940;18582;341;1104;4827;15067;5168;16171
290630;201608;8356;21369;7281;20180;585;1665;5967;16673;6552;18338
290640;201608;2724;7786;2193;6934;129;491;1658;5162;1787;5653
290650;201608;11124;31793;10463;30898;2257;6617;6208;18949;8465;25566
290660;201608;3737;10187;3183;9391;118;371;2366;7288;2484;7659
290670;201608;6993;21095;6182;19734;672;2193;4262;13765;4934;15958
290680;201608;10520;30695;9395;29268;417;1661;7621;23401;8038;25062
290682;201608;4648;13107;4091;12312;122;461;3517;10501;3639;10962
290685;201608;3795;8906;2495;7093;266;791;1527;4459;1793;5250
290687;201608;7609;21290;5923;18713;1322;4258;2741;9135;4063;13393
290689;201608;3226;9192;2832;8599;238;798;2093;6571;2331;7369
290690;201608;5589;15538;4893;14623;711;2128;3206;9669;3917;11797
290700;201608;2400;7296;2249;7073;140;479;1762;5570;1902;6049
290710;201608;7795;24225;7261;23434;486;1533;5874;19143;6360;20676
290720;201608;18983;54520;17351;52462;1342;3711;14054;43608;15396;47319
290730;201608;7367;19838;6572;18799;798;2108;4596;13413;5394;15521
290740;201608;961;2801;760;2447;66;240;523;1679;589;1919
290750;201608;10404;28687;8915;25982;1360;4350;5052;14248;6412;18598
290755;201608;2374;6675;1915;5912;94;343;1385;4216;1479;4559
290760;201608;4299;12834;3475;11312;472;1401;2034;6886;2506;8287
290770;201608;2552;8852;2383;8625;97;462;1920;6969;2017;7431
290780;201608;9130;22817;7863;20999;788;1605;5890;16475;6678;18080
290790;201608;4467;13108;4101;12604;218;658;3482;10746;3700;11404
290800;201608;7306;15357;5723;13663;460;877;4428;11129;4888;12006
290810;201608;5422;16235;4534;14812;174;627;3430;11287;3604;11914
290820;201608;5726;15728;5064;14861;455;1454;3789;11259;4244;12713
290830;201608;4403;11538;4032;11016;193;644;2993;7995;3186;8639
290840;201608;17819;50055;15695;46892;2298;6610;9872;30943;12170;37553
290850;201608;6212;17733;5941;17399;813;2116;4450;13673;5263;15789
290860;201608;5147;17029;4784;16591;405;1463;3730;13294;4135;14757
290870;201608;4819;13916;3856;12311;221;863;2751;8737;2972;9600
290880;201608;1467;3918;1166;3455;96;258;789;2384;885;2642
290890;201608;7279;18375;6185;17157;560;1301;5046;14379;5606;15680
290900;201608;2471;6994;1849;5895;241;794;981;3133;1222;3927
290910;201608;4808;12623;3945;11370;90;346;3314;9434;3404;9780
290920;201608;4999;13465;4567;12879;228;636;3871;10911;4099;11547
290930;201608;8271;24441;7107;22584;309;1366;5569;17383;5878;18749
290940;201608;3559;11108;3155;10521;96;333;2503;8557;2599;8890
290950;201608;1574;4292;1365;3971;137;392;917;2705;1054;3097
290960;201608;5843;16284;5279;15576;164;566;4395;13054;4559;13620
290970;201608;3760;11542;3249;10709;261;884;2195;7321;2456;8205
290980;201608;10731;30218;9070;27158;2440;7473;2461;7465;4901;14938
290990;201608;9177;27041;7886;24912;679;2350;5790;18013;6469;20363
291000;201608;3086;8929;2758;8553;122;428;2445;7599;2567;8027
291005;201608;14597;37559;12854;35295;1425;4017;9137;25426;10562;29443
291010;201608;3306;10123;2585;8613;225;758;1667;5619;1892;6377
291020;201608;1370;3561;1056;3027;96;270;572;1558;668;1828
291030;201608;2275;6114;1651;4896;141;464;991;2863;1132;3327
291040;201608;5636;16582;4974;15608;294;1171;3859;12049;4153;13220
291050;201608;8002;25548;7244;24186;1652;6025;3727;12148;5379;18173
291060;201608;6055;21984;5682;21390;883;3722;3600;13384;4483;17106
291070;201608;16505;46525;14351;43405;887;3034;11009;33231;11896;36265
291072;201608;23573;68608;18936;59472;4510;15203;6171;19626;10681;34829
291075;201608;5222;14540;4625;13637;264;704;3485;10402;3749;11106
291077;201608;1489;4196;1199;3717;84;279;774;2389;858;2668
291080;201608;79407;244931;71073;229174;24234;79509;13380;43244;37614;122753
291085;201608;5779;14978;4931;13849;371;1089;3961;11189;4332;12278
291090;201608;1661;3809;1480;3596;65;151;1298;3159;1363;3310
291100;201608;2618;6616;2100;6043;107;417;1627;4589;1734;5006
291110;201608;5084;17730;4572;16964;537;2205;3210;11727;3747;13932
291120;201608;7340;19633;6734;18727;787;2207;4708;13176;5495;15383
291125;201608;1959;3851;1496;3356;96;246;1191;2695;1287;2941
291130;201608;2884;8933;2416;8112;97;429;1795;5896;1892;6325
291140;201608;4201;12374;3605;11269;493;1419;2195;7024;2688;8443
291150;201608;1998;5117;1865;4962;80;256;1560;4081;1640;4337
291160;201608;5296;16425;4619;15305;826;2836;2523;8327;3349;11163
291165;201608;2558;7094;1947;5966;40;168;1399;4180;1439;4348
291170;201608;22203;57115;18839;52443;1723;5240;11892;33118;13615;38358
291180;201608;6266;16236;5051;14390;397;1212;3619;10360;4016;11572
291185;201608;3740;10029;3314;9385;165;483;2711;7614;2876;8097
291190;201608;7268;19564;6379;18329;434;1563;5145;14512;5579;16075
291200;201608;2930;8664;2332;7538;137;455;1523;5006;1660;5461
291210;201608;6918;16514;5799;15238;250;795;4407;11549;4657;12344
291220;201608;4262;13045;3868;12402;493;1789;2528;7953;3021;9742
291230;201608;4001;10046;3621;9633;90;169;3371;9107;3461;9276
291240;201608;4685;12524;4033;11387;122;376;3256;9049;3378;9425
291250;201608;3593;10922;2866;9581;266;890;1873;6390;2139;7280
291260;201608;1087;3130;986;3001;52;234;830;2436;882;2670
291270;201608;4647;14507;4126;13523;1265;4291;1936;6389;3201;10680
291280;201608;2094;6085;1695;5395;326;1132;810;2496;1136;3628
291290;201608;5659;15669;4881;14648;742;2189;2963;9104;3705;11293
291300;201608;4404;12367;3369;10628;200;731;2423;7528;2623;8259
291310;201608;5430;15298;4689;13960;268;821;3618;10754;3886;11575
291320;201608;6156;18970;5005;16755;1183;3996;2176;7441;3359;11437
291330;201608;1620;4811;1438;4510;98;339;1009;3134;1107;3473
291340;201608;3949;10845;3218;9793;114;385;2594;7858;2708;8243
291345;201608;3406;10649;3153;10340;203;646;2606;8756;2809;9402
291350;201608;5801;16761;5051;15501;266;886;3864;12010;4130;12896
291360;201608;34233;91866;29824;85768;7060;20604;15160;45049;22220;65653
291370;201608;8359;23622;7822;22945;548;1664;6039;17887;6587;19551
291380;201608;3720;11072;3173;10188;174;636;2387;7747;2561;8383
291390;201608;10279;27390;9478;26449;1136;3100;7101;19987;8237;23087
291400;201608;13896;38135;12162;35519;2268;6007;7465;23188;9733;29195
291410;201608;3335;8674;2455;7269;113;492;1778;5071;1891;5563
291420;201608;2118;5696;1797;5295;78;279;1503;4402;1581;4681
291430;201608;3285;9442;2882;8890;138;633;2326;6925;2464;7558
291440;201608;6768;20056;5655;18185;564;1855;4029;13122;4593;14977
291450;201608;8362;24024;7252;22493;285;843;5825;18881;6110;19724
291460;201608;13382;40039;12017;37929;1539;5275;7633;24266;9172;29541
291465;201608;8128;22852;7092;21670;413;1639;5781;17432;6194;19071
291470;201608;16148;42523;14166;40181;989;2696;10502;30876;11491;33572
291480;201608;36042;90878;30168;82945;4496;13179;16349;45190;20845;58369
291490;201608;4302;13580;4042;13224;539;1751;2823;9449;3362;11200
291500;201608;4356;12233;3634;11157;190;742;2866;8684;3056;9426
291510;201608;3731;11010;3393;10549;71;263;2965;9336;3036;9599
291520;201608;3906;10487;3342;9727;430;1337;2138;6221;2568;7558
291530;201608;2214;5932;1735;5221;387;1178;849;2746;1236;3924
291535;201608;3781;11427;3411;10852;194;652;2646;8503;2840;9155
291540;201608;2136;5035;1779;4668;123;232;1555;4212;1678;4444
291550;201608;5158;13548;4432;12542;756;1982;2610;7612;3366;9594
291560;201608;18944;44085;13446;37676;860;2444;9779;28731;10639;31175
291570;201608;2231;5858;2019;5611;153;297;1692;4922;1845;5219
291580;201608;5528;16489;4856;15529;451;1784;3434;10880;3885;12664
291590;201608;1784;5560;1606;5266;151;534;1196;3960;1347;4494
291600;201608;5172;14208;3919;12159;967;3160;1648;4974;2615;8134
291610;201608;4935;15602;4749;15395;130;424;4346;14258;4476;14682
291620;201608;3053;7098;2318;6325;135;394;1810;5087;1945;5481
291630;201608;3223;7661;2650;6990;231;587;2026;5480;2257;6067
291640;201608;17052;46002;13529;40732;3292;10345;3885;12333;7177;22678
291650;201608;8352;24173;7666;23340;574;1440;6349;19829;6923;21269
291660;201608;2206;5714;1762;5028;121;432;1126;3032;1247;3464
291670;201608;1882;5196;1691;4938;100;272;1328;3977;1428;4249
291680;201608;4090;11758;3528;10831;581;1930;2079;6384;2660;8314
291685;201608;4823;12041;3984;10958;599;1551;2591;7432;3190;8983
291690;201608;3908;10374;3045;8949;218;615;2076;6088;2294;6703
291700;201608;9215;28300;8190;26519;888;2790;5929;19520;6817;22310
291710;201608;5305;13664;4270;12327;297;869;3060;8852;3357;9721
291720;201608;4580;14642;3865;13146;313;1216;2676;8875;2989;10091
291730;201608;6231;18132;5643;17354;476;1528;4380;13710;4856;15238
291733;201608;2748;7716;2284;7077;193;649;1460;4672;1653;5321
291735;201608;2965;8109;2471;7393;116;420;2026;6022;2142;6442
291740;201608;3781;10769;3216;9983;205;734;2553;7912;2758;8646
291750;201608;22673;57631;17621;49897;3685;10711;8321;24291;12006;35002
291760;201608;11060;34824;9731;32555;3829;14291;2220;7384;6049;21675
291770;201608;7737;22140;6472;19866;786;2603;4020;12084;4806;14687
291780;201608;4512;13474;4200;12954;212;690;3513;10824;3725;11514
291790;201608;2731;8112;2577;7907;80;309;2190;6640;2270;6949
291800;201608;30868;82937;26946;77553;4015;11580;16622;49264;20637;60844
291810;201608;10840;28958;9070;26783;363;1284;7359;21708;7722;22992
291820;201608;3807;11114;3368;10456;183;655;2561;8002;2744;8657
291830;201608;4210;11014;3868;10533;340;950;2943;8094;3283;9044
291835;201608;6402;19676;5115;17363;1446;5184;2250;7780;3696;12964
291840;201608;48423;134319;42397;127375;6314;18577;28485;89020;34799;107597
291845;201608;2640;7528;2458;7298;135;329;2200;6709;2335;7038
291850;201608;4599;13050;3767;11720;360;982;2697;8755;3057;9737
291855;201608;1864;4493;1602;4162;130;445;1226;3068;1356;3513
291860;201608;2188;6075;1686;5089;65;237;1133;3325;1198;3562
291870;201608;1431;3809;1010;3048;66;248;635;1837;701;2085
291875;201608;2838;8847;2552;8390;91;358;1836;5928;1927;6286
291880;201608;4984;15834;4575;15021;489;1616;3222;10622;3711;12238
291890;201608;1316;3362;1059;3036;188;501;705;2089;893;2590
291900;201608;1280;3385;1022;2962;58;200;754;2156;812;2356
291905;201608;2748;7378;2046;6091;104;346;1470;4241;1574;4587
291910;201608;2794;7407;2325;6840;111;412;1961;5750;2072;6162
291915;201608;7097;21466;5903;19320;319;1121;4487;14837;4806;15958
291920;201608;25919;76106;23740;73041;3297;10801;15025;46363;18322;57164
291930;201608;2646;7702;2323;7186;185;647;1634;4958;1819;5605
291940;201608;3405;9511;2480;7875;290;1000;1440;4459;1730;5459
291950;201608;8911;29184;7991;27465;1312;4517;4484;15961;5796;20478
291955;201608;11279;31833;10381;30687;2538;7518;5325;16734;7863;24252
291960;201608;3194;9195;2602;8303;227;713;1876;6251;2103;6964
291970;201608;3925;11932;3607;11405;348;1237;2390;7589;2738;8826
291980;201608;12111;33942;9260;29872;1032;3348;5998;19843;7030;23191
291990;201608;2205;6601;2008;6347;78;259;1716;5548;1794;5807
291992;201608;2893;8689;2824;8572;407;1189;2086;6370;2493;7559
291995;201608;2105;5936;1800;5505;80;303;1503;4536;1583;4839
292000;201608;2471;6797;2217;6467;191;643;1568;4661;1759;5304
292010;201608;6552;16092;5115;14087;515;1294;3607;10291;4122;11585
292020;201608;4057;13731;3812;13330;522;1949;2736;9558;3258;11507
292030;201608;2000;6208;1780;5881;252;857;948;3090;1200;3947
292040;201608;4481;11824;3835;11140;215;424;3224;9940;3439;10364
292045;201608;3266;10149;2960;9735;121;369;2663;8800;2784;9169
292050;201608;6464;19456;5450;17408;510;1836;3373;10669;3883;12505
292060;201608;12895;31873;11851;30610;859;1993;9735;25108;10594;27101
292070;201608;4765;14485;4451;14115;456;1362;3584;11572;4040;12934
292080;201608;3619;9215;2940;8350;204;632;2439;6949;2643;7581
292090;201608;4036;10306;3403;9570;199;717;2822;7936;3021;8653
292100;201608;11468;30371;9795;28103;2175;6489;4785;14272;6960;20761
292105;201608;3102;9328;2750;8758;105;449;2209;7004;2314;7453
292110;201608;6524;17267;5048;14936;1430;4240;2124;6459;3554;10699
292120;201608;7572;21048;6301;18693;1151;3336;3391;10379;4542;13715
292130;201608;2910;7931;2493;7353;378;1022;1569;4833;1947;5855
292140;201608;5015;13109;4139;11861;651;1734;2742;8102;3393;9836
292145;201608;2394;7266;2107;6787;249;775;1420;4744;1669;5519
292150;201608;12669;38203;11663;36618;432;1632;9597;30074;10029;31706
292160;201608;2521;7152;2144;6663;90;364;1867;5735;1957;6099
292170;201608;8913;25035;7333;22361;917;3014;4530;13844;5447;16858
292180;201608;3043;8708;2372;7551;451;1361;1222;4061;1673;5422
292190;201608;3322;9329;2779;8479;510;1662;1467;4502;1977;6164
292200;201608;6866;20798;5818;18978;1612;5602;2022;6693;3634;12295
292205;201608;3906;11632;3496;11036;168;680;2787;8645;2955;9325
292210;201608;6555;17063;5468;15630;263;889;4555;12960;4818;13849
292220;201608;1872;5085;1669;4783;415;1125;826;2394;1241;3519
292225;201608;3252;9969;2945;9502;158;660;2396;7669;2554;8329
292230;201608;6887;19245;6449;18569;271;1146;5117;14182;5388;15328
292240;201608;4841;14463;4266;13295;404;1255;2907;9049;3311;10304
292250;201608;5170;15791;4818;15190;1015;3297;2368;7593;3383;10890
292260;201608;3215;9331;2969;8996;197;570;2435;7464;2632;8034
292265;201608;3204;9571;2747;8807;113;511;2082;6516;2195;7027
292270;201608;4187;10414;3385;9478;164;530;2837;7978;3001;8508
292273;201608;2804;6366;2136;5548;159;361;1591;4333;1750;4694
292275;201608;1602;4354;1417;4089;150;419;1064;3163;1214;3582
292280;201608;2251;6103;1962;5771;185;465;1479;4635;1664;5100
292285;201608;2527;6728;2057;6047;99;338;1598;4680;1697;5018
292290;201608;7008;20901;5831;19318;352;1413;4446;14891;4798;16304
292300;201608;8326;24565;7191;23170;1957;6635;3562;11849;5519;18484
292303;201608;2925;8721;2619;8299;83;323;2228;7010;2311;7333
292305;201608;2925;7868;2750;7623;56;224;2495;6835;2551;7059
292310;201608;5925;17364;5442;16642;154;584;4461;13566;4615;14150
292320;201608;6829;18803;5738;16966;403;1221;4355;12840;4758;14061
292330;201608;2254;5887;2048;5620;149;462;1641;4458;1790;4920
292335;201608;5212;13544;4617;12749;364;964;3685;10319;4049;11283
292340;201608;6538;18029;5543;16413;353;1049;4028;11943;4381;12992
292350;201608;2346;6785;2012;6321;121;460;1616;5071;1737;5531
292360;201608;5340;13705;5014;13167;200;382;4101;11241;4301;11623
292370;201608;8546;23999;7542;22661;651;1613;5919;18230;6570;19843
292380;201608;7337;21428;6643;20313;696;1939;4927;15315;5623;17254
292390;201608;3590;7937;2956;7243;331;489;2378;6190;2709;6679
292400;201608;20967;63603;19447;61170;2814;8897;12777;40503;15591;49400
292405;201608;4627;11343;3717;10156;197;443;2952;8188;3149;8631
292410;201608;2018;5332;1853;5142;149;370;1524;4291;1673;4661
292420;201608;3799;12151;3576;11828;227;951;2863;9385;3090;10336
292430;201608;5599;16307;4199;14324;339;1266;2732;9404;3071;10670
292440;201608;8537;27987;7852;26973;175;754;7079;24508;7254;25262
292450;201608;4034;11971;3289;10708;312;1030;2258;7447;2570;8477
292460;201608;4962;14708;4249;13514;482;1637;2805;8939;3287;10576
292465;201608;2443;7194;2033;6523;188;650;1271;4155;1459;4805
292467;201608;1874;5966;1784;5830;309;1060;1145;3843;1454;4903
292470;201608;2967;7796;2431;6913;112;327;1879;5330;1991;5657
292480;201608;6383;16448;5334;15054;123;406;4813;13511;4936;13917
292490;201608;2429;6531;1972;5864;138;430;1464;4339;1602;4769
292500;201608;6666;19496;5680;17792;663;2110;3685;11709;4348;13819
292510;201608;12836;36422;10934;33613;811;2878;8050;24908;8861;27786
292520;201608;5650;15938;4914;14849;1009;3094;2663;8177;3672;11271
292525;201608;5426;13947;4605;12993;150;452;3905;11091;4055;11543
292530;201608;27354;77414;23911;72745;6069;18987;10972;34650;17041;53637
292540;201608;2977;7940;2613;7508;269;797;2021;5827;2290;6624
292550;201608;6655;20202;5714;18979;613;2188;4227;14370;4840;16558
292560;201608;4098;11313;3541;10475;187;705;2690;7823;2877;8528
292570;201608;4281;11905;3926;11530;70;169;3684;11073;3754;11242
292575;201608;6477;20981;6258;20651;409;1346;5240;17520;5649;18866
292580;201608;6814;20052;6335;19382;309;1017;5360;16412;5669;17429
292590;201608;7622;21689;7087;20922;385;1176;5972;17445;6357;18621
292593;201608;3072;7848;2527;6991;346;901;1707;4703;2053;5604
292595;201608;5886;16141;5191;15255;324;1014;4063;12004;4387;13018
292600;201608;10836;30372;9640;28813;836;2017;7422;22990;8258;25007
292610;201608;4737;13005;3847;11575;265;794;2382;7503;2647;8297
292620;201608;6297;18575;5488;17643;106;347;5108;16596;5214;16943
292630;201608;9389;23573;7750;21070;762;1990;5269;14660;6031;16650
292640;201608;7837;25109;7232;24171;390;1441;5478;18544;5868;19985
292650;201608;4756;12568;4432;12154;362;871;3676;10156;4038;11027
292660;201608;10938;32399;9990;31027;1051;3351;7406;23298;8457;26649
292665;201608;2389;7417;2254;7238;36;95;2062;6718;2098;6813
292670;201608;3784;10493;2925;8962;251;801;1789;5505;2040;6306
292680;201608;3727;10871;3317;10162;394;1123;2307;7094;2701;8217
292690;201608;2892;7773;2054;6429;174;513;1377;4461;1551;4974
292700;201608;9531;27889;8301;26092;1229;3498;5131;17196;6360;20694
292710;201608;2138;6982;2012;6816;57;215;1797;6115;1854;6330
292720;201608;9450;23786;8144;22341;296;948;6911;19265;7207;20213
292730;201608;3688;10879;3528;10641;212;658;2832;8564;3044;9222
292740;201608;334788;887722;311856;853142;55448;159465;185572;502920;241020;662385
292750;201608;6642;17678;5683;16357;274;863;4487;13005;4761;13868
292760;201608;4065;12445;3640;11699;392;1336;2419;7797;2811;9133
292770;201608;6089;17597;5316;16476;937;3064;3129;9990;4066;13054
292780;201608;1890;4321;1422;3725;99;290;1029;2663;1128;2953
292790;201608;3427;8195;3277;8037;58;93;3157;7825;3215;7918
292800;201608;9376;27162;8588;25875;500;1616;6805;20441;7305;22057
292805;201608;3093;8591;2685;8011;254;817;1976;5911;2230;6728
292810;201608;9660;28212;7832;25582;906;3034;5230;17491;6136;20525
292820;201608;7501;21027;5594;18258;323;1289;4300;13980;4623;15269
292830;201608;1768;5181;1592;4931;60;248;1356;4159;1416;4407
292840;201608;8236;24195;7724;23504;315;1141;6798;20430;7113;21571
292850;201608;3142;8283;2544;7367;273;800;1606;4585;1879;5385
292860;201608;15563;39393;14185;37618;1057;2852;11081;29339;12138;32191
292870;201608;19455;52811;16946;48928;1831;5962;9987;28300;11818;34262
292880;201608;12829;35764;11323;33681;856;2965;8121;23657;8977;26622
292890;201608;5534;18222;4956;17201;611;2245;3233;11335;3844;13580
292895;201608;2880;6873;2201;5836;233;601;1497;3992;1730;4593
292900;201608;2797;8514;2649;8285;147;654;1991;5966;2138;6620
292905;201608;4110;12041;3305;10776;340;1093;2152;7164;2492;8257
292910;201608;5044;14791;4545;13906;550;1759;2731;8376;3281;10135
292920;201608;9441;27198;8965;26530;448;1645;7465;21550;7913;23195
292925;201608;5216;15509;4683;14733;311;998;3656;11576;3967;12574
292930;201608;6555;20703;6120;19926;406;1755;4286;13608;4692;15363
292935;201608;2037;5899;1712;5546;74;233;1453;4902;1527;5135
292937;201608;3291;8269;2733;7573;170;476;2191;6119;2361;6595
292940;201608;3333;8900;2641;7975;236;724;1814;5676;2050;6400
292950;201608;8248;23836;7628;22813;454;1640;5654;16536;6108;18176
292960;201608;5360;13566;4600;12549;258;738;3444;9319;3702;10057
292970;201608;4347;12738;3786;11989;138;640;3096;9757;3234;10397
292975;201608;3617;9404;3355;9073;375;911;2765;7620;3140;8531
292980;201608;3343;8657;2595;7587;203;678;1867;5385;2070;6063
292990;201608;12049;33870;10374;31383;422;1400;8385;25357;8807;26757
293000;201608;2878;7307;2636;7020;45;136;2092;5980;2137;6116
293010;201608;18144;49857;15352;45395;2302;7030;8800;25961;11102;32991
293015;201608;7680;25749;6678;23794;714;2907;4341;15390;5055;18297
293020;201608;9143;29999;8570;29190;279;1247;7400;25066;7679;26313
293030;201608;5681;15968;4462;14066;373;1148;2891;9608;3264;10756
293040;201608;3823;12246;3634;11896;201;631;3156;10411;3357;11042
293050;201608;20901;56763;18301;53417;3328;9893;9423;28990;12751;38883
293060;201608;3656;9735;3013;8674;222;691;2184;6221;2406;6912
293070;201608;24803;66075;20176;59450;4606;13669;8689;27139;13295;40808
293075;201608;3290;11037;3020;10626;195;839;2379;8399;2574;9238
293076;201608;3789;10293;3384;9756;173;456;2786;8240;2959;8696
293077;201608;4999;15375;4453;14627;828;2826;2624;8866;3452;11692
293080;201608;4645;14497;4187;13787;175;842;3415;11053;3590;11895
293090;201608;3321;10424;2721;9504;233;832;1947;6956;2180;7788
293100;201608;5910;17135;4851;15273;495;1598;3404;10853;3899;12451
293105;201608;4050;13135;3511;12103;470;1635;2256;7912;2726;9547
293110;201608;2070;5776;1804;5398;71;227;1472;4433;1543;4660
293120;201608;3793;12275;3579;11937;272;881;2833;9581;3105;10462
293130;201608;4090;11374;3500;10717;143;508;3032;9451;3175;9959
293135;201608;30821;77764;23357;67110;4895;15570;8373;24375;13268;39945
293140;201608;1988;5502;1881;5348;129;455;1506;4163;1635;4618
293150;201608;5522;17983;4701;16390;681;2419;2845;10170;3526;12589
293160;201608;3845;9798;3440;9324;483;968;2515;7337;2998;8305
293170;201608;3450;9943;3148;9511;263;880;2220;6797;2483;7677
293180;201608;5381;14896;4267;13107;148;593;3327;10008;3475;10601
293190;201608;13887;41417;12665;39586;464;2058;10682;32804;11146;34862
293200;201608;7272;19772;6358;18641;176;653;4910;14572;5086;15225
293210;201608;5163;14538;4519;13454;290;904;3399;10107;3689;11011
293220;201608;5053;14760;4258;13343;1095;3420;1446;4711;2541;8131
293230;201608;3798;11398;3389;10747;429;1530;2296;7226;2725;8756
293240;201608;4429;12089;3534;10604;131;420;2605;7840;2736;8260
293245;201608;4332;12161;3873;11516;224;668;3043;9134;3267;9802
293250;201608;5718;15388;5106;14482;523;1530;3531;9943;4054;11473
293260;201608;4608;13444;3859;12338;254;855;2774;8927;3028;9782
293270;201608;5739;14845;5153;14210;346;854;4411;12375;4757;13229
293280;201608;5379;14683;4507;13499;248;676;3470;10580;3718;11256
293290;201608;14654;48139;13561;46072;3350;11690;5813;20455;9163;32145
293300;201608;7026;16369;5860;15006;375;877;4430;11602;4805;12479
293305;201608;4901;12069;4102;10999;132;403;3404;9099;3536;9502
293310;201608;2531;6546;2015;5660;204;577;1308;3647;1512;4224
293315;201608;4322;10861;3658;9873;343;790;2712;7485;3055;8275
293317;201608;2513;7107;2246;6621;166;474;1566;4639;1732;5113
293320;201608;7793;25308;7529;24971;1070;3542;5469;18505;6539;22047
293325;201608;1838;5172;1504;4652;184;635;974;2984;1158;3619
293330;201608;51075;162862;45810;153619;10004;35379;20539;69846;30543;105225
293340;201608;2680;7550;2099;6556;264;853;1176;3687;1440;4540
293345;201608;3370;9868;2921;9265;258;645;2219;7437;2477;8082
293350;201608;6576;19098;6198;18659;217;468;5592;17402;5809;17870
293360;201608;13329;39548;12029;37915;709;2534;10453;32931;11162;35465
310010;201608;924;2480;716;2156;107;386;310;867;417;1253
310020;201608;2908;8998;2387;8012;520;1926;310;963;830;2889
310030;201608;2356;7211;1925;6476;396;1470;1008;3343;1404;4813
310040;201608;986;2604;813;2367;62;218;615;1747;677;1965
310050;201608;1869;6308;1700;5941;329;1307;741;2506;1070;3813
310060;201608;3269;9992;2837;9435;271;1065;2206;7292;2477;8357
310070;201608;349;964;257;797;14;62;164;470;178;532
310080;201608;735;2166;605;1942;103;411;214;646;317;1057
310090;201608;4646;13655;3964;12479;466;1573;2550;8052;3016;9625
310100;201608;3497;10443;2927;9507;156;625;2257;7294;2413;7919
310110;201608;4846;13615;4085;12319;617;2093;2180;6360;2797;8453
310120;201608;639;1909;479;1601;128;533;170;441;298;974
310130;201608;401;1219;361;1159;92;359;178;508;270;867
310140;201608;210;692;171;629;58;256;45;130;103;386
310150;201608;4763;14413;4084;13116;949;3328;1283;3989;2232;7317
310160;201608;7191;22465;5902;20017;1744;6399;795;2587;2539;8986
310163;201608;1057;3359;886;3020;293;1049;217;709;510;1758
310170;201608;9211;25445;8164;23993;1010;3172;5527;16394;6537;19566
310180;201608;1709;4850;1460;4468;251;858;798;2348;1049;3206
310190;201608;2841;9281;2523;8699;650;2470;422;1437;1072;3907
310200;201608;1839;5941;1555;5373;305;1163;529;1816;834;2979
310205;201608;1132;3215;862;2802;123;395;459;1544;582;1939
310210;201608;2763;7823;2402;7295;184;572;1781;5417;1965;5989
310220;201608;1058;3144;928;2940;146;518;570;1760;716;2278
310230;201608;2567;7808;2154;6901;296;1124;1164;3510;1460;4634
310240;201608;903;3256;815;3072;119;501;433;1654;552;2155
310250;201608;814;2658;779;2599;139;565;451;1389;590;1954
310260;201608;3179;10010;2395;8393;571;2284;416;1262;987;3546
310270;201608;2566;7170;2091;6491;166;648;1596;4884;1762;5532
310280;201608;2343;6092;1894;5420;236;832;1044;2836;1280;3668
310285;201608;2035;7124;1872;6874;197;843;1370;5121;1567;5964
310290;201608;1145;3437;1074;3321;264;918;536;1501;800;2419
310300;201608;1719;5740;1629;5577;395;1545;781;2541;1176;4086
310310;201608;367;993;262;800;35;98;120;379;155;477
310320;201608;400;1252;326;1117;40;196;164;524;204;720
310330;201608;525;1302;341;960;32;98;137;341;169;439
310340;201608;8415;24781;6864;22118;1465;4768;3009;10200;4474;14968
310350;201608;13778;36362;9985;30067;2444;8077;2389;6982;4833;15059
310360;201608;443;1291;407;1241;23;97;298;869;321;966
310370;201608;1417;4696;1266;4418;360;1274;544;1939;904;3213
310375;201608;1225;3346;803;2570;111;389;300;958;411;1347
310380;201608;382;988;228;716;64;214;71;195;135;409
310390;201608;458;1572;390;1433;80;309;74;236;154;545
310400;201608;10398;28386;7730;23955;1793;6039;1871;5794;3664;11833
310410;201608;737;2424;514;2034;100;425;96;380;196;805
310420;201608;5621;15631;3664;11586;649;2246;487;1318;1136;3564
310430;201608;1336;4294;1006;3636;231;918;151;528;382;1446
310440;201608;564;1616;426;1354;70;249;157;501;227;750
310445;201608;1244;4033;1035;3647;126;481;661;2316;787;2797
310450;201608;4610;12740;3692;11412;350;1109;2488;7852;2838;8961
310460;201608;1592;4679;1313;4257;349;1233;302;1066;651;2299
310470;201608;4095;9161;3481;8427;257;569;2955;7270;3212;7839
310480;201608;1255;3613;941;2992;205;634;374;1152;579;1786
310490;201608;2935;9425;2527;8639;599;2383;937;3058;1536;5441
310500;201608;1319;4400;1154;4049;262;1010;440;1488;702;2498
310510;201608;2062;6408;1603;5406;380;1374;244;826;624;2200
310520;201608;1427;3631;1074;3086;79;226;718;2059;797;2285
310530;201608;998;2979;526;1806;64;252;63;183;127;435
310540;201608;3082;9822;2740;9196;702;2446;1096;3650;1798;6096
310550;201608;1201;3326;949;2927;163;613;514;1486;677;2099
310560;201608;15665;47070;13167;42339;3397;12081;3628;10864;7025;22945
310570;201608;1169;3427;990;3126;145;561;657;2010;802;2571
310590;201608;4363;12600;3576;11138;543;1802;1641;5035;2184;6837
310600;201608;1423;4640;1267;4316;270;1045;509;1630;779;2675
310610;201608;467;1562;409;1436;86;381;118;354;204;735
310620;201608;144865;438775;123518;398384;28031;100506;44145;131557;72176;232063
310630;201608;4253;12675;3858;12011;324;1149;2809;8633;3133;9782
310640;201608;1288;3901;1049;3500;289;1079;258;806;547;1885
310650;201608;2677;8300;2087;7247;330;1197;1135;3952;1465;5149
310660;201608;1339;4037;1179;3832;121;408;847;2731;968;3139
310665;201608;1287;3773;1143;3572;86;283;912;2928;998;3211
310670;201608;40949;124450;36258;114765;8820;29452;13033;40226;21853;69678
310680;201608;685;1922;612;1819;81;268;408;1195;489;1463
310690;201608;1439;4562;1164;4084;223;928;432;1419;655;2347
310700;201608;543;1316;425;1170;67;214;261;699;328;913
310710;201608;6354;20356;4817;17793;882;3830;574;1905;1456;5735
310720;201608;790;2352;718;2233;69;250;508;1568;577;1818
310730;201608;9407;28827;8347;27060;1365;4806;4742;15301;6107;20107
310740;201608;5091;15988;3986;13766;899;3334;836;2751;1735;6085
310750;201608;1492;3698;1105;3172;205;615;488;1327;693;1942
310760;201608;600;1773;496;1598;85;300;186;588;271;888
310770;201608;914;2865;701;2524;147;595;287;969;434;1564
310780;201608;3805;10326;3178;9240;428;1262;2019;5840;2447;7102
310790;201608;1971;6280;1789;5951;476;1643;727;2532;1203;4175
310800;201608;2843;8874;2158;7539;599;2419;148;454;747;2873
310810;201608;1157;3242;1022;2991;165;559;568;1560;733;2119
310820;201608;1310;3729;917;2982;204;707;205;655;409;1362
310825;201608;2558;8473;2006;7511;119;657;1439;5278;1558;5935
310830;201608;1366;4373;1105;3877;291;1094;339;1157;630;2251
310840;201608;2134;6438;1632;5538;329;1221;418;1310;747;2531
310850;201608;1539;4505;1303;4199;133;473;938;3029;1071;3502
310855;201608;3000;9235;2565;8564;396;1449;1643;5509;2039;6958
310860;201608;7460;22663;6228;20428;743;2576;3604;12013;4347;14589
310870;201608;1061;2838;825;2451;137;428;476;1419;613;1847
310880;201608;1078;3299;863;2889;142;527;425;1412;567;1939
310890;201608;2630;7874;2020;6830;468;1778;387;1159;855;2937
310900;201608;4176;13008;3256;11106;686;2624;1097;3472;1783;6096
310910;201608;1923;5391;1249;4083;206;774;147;391;353;1165
310920;201608;1886;5468;1482;4831;313;1152;648;2066;961;3218
310925;201608;932;2993;826;2807;293;1088;317;1042;610;2130
310930;201608;6223;17279;4948;15404;737;2485;2881;9217;3618;11702
310940;201608;6199;17116;5157;15546;760;2387;2944;8822;3704;11209
310945;201608;1168;3384;1025;3169;137;473;604;1812;741;2285
310950;201608;2125;6615;1539;5371;355;1465;487;1584;842;3049
310960;201608;407;1288;331;1141;87;327;128;453;215;780
310970;201608;1452;4740;1062;3852;230;930;150;467;380;1397
310980;201608;442;1074;276;797;37;123;133;343;170;466
310990;201608;1189;3790;961;3284;200;753;288;885;488;1638
311000;201608;3566;11967;3238;11356;952;3627;993;3277;1945;6904
311010;201608;729;2448;675;2350;229;855;278;975;507;1830
311020;201608;950;2730;733;2355;118;441;355;1085;473;1526
311030;201608;1684;4564;1146;3573;288;1034;341;946;629;1980
311040;201608;464;1546;395;1385;83;291;91;299;174;590
311050;201608;2278;6901;1956;6401;471;1718;845;2749;1316;4467
311060;201608;2502;7291;1848;5915;322;1181;562;1657;884;2838
311070;201608;1415;4791;1234;4452;250;1026;497;1772;747;2798
311080;201608;812;2490;682;2237;143;517;264;813;407;1330
311090;201608;1599;5930;1404;5537;448;1921;370;1397;818;3318
311100;201608;2070;6878;1660;6001;524;2060;204;722;728;2782
311110;201608;3508;8383;2530;7020;427;1269;1226;3409;1653;4678
311115;201608;1242;3553;1030;3239;89;361;695;2142;784;2503
311120;201608;7978;22179;6091;18848;1278;4435;1620;4624;2898;9059
311130;201608;2113;6378;1719;5776;313;1273;685;2185;998;3458
311140;201608;1359;3543;1052;3135;84;288;676;2021;760;2309
311150;201608;1756;6027;1608;5778;266;1052;980;3516;1246;4568
311160;201608;4024;13344;3263;11961;1089;4364;723;2644;1812;7008
311170;201608;801;2391;630;2074;69;246;295;1012;364;1258
311180;201608;1175;3371;917;2885;259;873;210;627;469;1500
311190;201608;1108;3100;837;2583;172;606;212;606;384;1212
311200;201608;1987;6005;1582;5172;403;1446;265;793;668;2239
311205;201608;1015;3315;867;3021;122;504;394;1368;516;1872
311210;201608;973;3114;894;3008;155;526;603;2101;758;2627
311220;201608;865;2677;705;2345;156;566;231;731;387;1297
311230;201608;8310;26078;6456;22261;1314;4814;2014;7235;3328;12049
311240;201608;1038;3103;811;2733;208;783;247;813;455;1596
311250;201608;783;2524;696;2389;211;788;205;625;416;1413
311260;201608;2419;6375;1812;5382;395;1288;614;1791;1009;3079
311265;201608;1254;3495;987;3058;173;583;530;1653;703;2236
311270;201608;3413;10719;2977;10110;270;1293;2086;6796;2356;8089
311280;201608;1285;3560;818;2595;155;575;189;573;344;1148
311290;201608;2001;6587;1860;6265;360;1212;1063;3628;1423;4840
311300;201608;4404;14395;3899;13497;384;1637;2763;9427;3147;11064
311310;201608;578;1905;513;1776;108;378;134;418;242;796
311320;201608;3830;12635;3432;11781;624;2406;1222;3946;1846;6352
311330;201608;4646;13704;3966;12547;1004;3505;1635;5138;2639;8643
311340;201608;12046;37350;10393;34198;3025;10656;2438;7894;5463;18550
311350;201608;2326;6442;1781;5416;262;925;780;2140;1042;3065
311360;201608;1113;3069;869;2759;390;1289;119;402;509;1691
311370;201608;3721;11068;3076;9912;644;2447;1153;3339;1797;5786
311380;201608;429;1410;363;1273;97;369;113;390;210;759
311390;201608;1789;6394;1619;6156;669;2900;402;1378;1071;4278
311400;201608;1487;4628;1205;4089;211;842;485;1500;696;2342
311410;201608;1810;6080;1619;5836;428;1725;761;2789;1189;4514
311420;201608;1906;6124;1306;4664;230;909;134;359;364;1268
311430;201608;3856;11467;2670;8892;494;1779;331;1063;825;2842
311440;201608;2452;7715;1790;6517;546;2276;270;969;816;3245
311450;201608;1949;6683;1630;5992;433;1772;297;993;730;2765
311455;201608;1129;3010;886;2609;210;651;362;969;572;1620
311460;201608;633;2022;481;1714;92;384;107;335;199;719
311470;201608;479;1585;380;1375;102;432;69;208;171;640
311480;201608;802;2110;746;2033;163;433;470;1285;633;1718
311490;201608;225;825;201;756;55;230;71;241;126;471
311500;201608;447;1289;356;1123;78;297;153;463;231;760
311510;201608;3023;9158;2374;7981;686;2697;476;1525;1162;4222
311520;201608;613;1981;567;1889;180;656;216;686;396;1342
311530;201608;11694;29807;8337;24423;1962;6753;1952;5462;3914;12215
311535;201608;809;2321;520;1750;113;440;89;276;202;716
311540;201608;617;2118;572;2044;183;638;242;875;425;1513
311545;201608;2126;6374;1879;6068;162;593;1357;4337;1519;4930
311547;201608;1503;4161;1256;3775;79;245;839;2520;918;2765
311550;201608;2917;9116;2405;8087;397;1517;849;2781;1246;4298
311560;201608;267;699;223;647;27;77;127;350;154;427
311570;201608;2010;5106;1560;4497;93;282;1180;3519;1273;3801
311580;201608;2463;4886;1814;4138;431;899;976;2407;1407;3306
311590;201608;470;1428;397;1311;92;346;167;544;259;890
311600;201608;1229;3693;1037;3437;194;628;622;2130;816;2758
311610;201608;2895;10031;2571;9458;807;2871;967;3812;1774;6683
311615;201608;3169;9671;2621;8798;234;928;1831;6094;2065;7022
311620;201608;421;1278;371;1194;61;223;220;699;281;922
311630;201608;1379;3981;1126;3539;217;666;654;2047;871;2713
311640;201608;768;2447;633;2225;127;481;292;1020;419;1501
311650;201608;2268;6390;1919;5847;221;737;1115;3408;1336;4145
311660;201608;2613;8256;1939;6828;345;1248;192;591;537;1839
311670;201608;1685;4783;1353;4232;392;1359;424;1315;816;2674
311680;201608;2098;6497;1747;5905;367;1296;912;3109;1279;4405
311690;201608;506;1260;430;1169;33;96;347;959;380;1055
311700;201608;2250;5888;1786;5269;109;355;1365;3974;1474;4329
311710;201608;1659;5005;1217;4176;426;1639;283;925;709;2564
311720;201608;398;1315;358;1238;68;254;143;487;211;741
311730;201608;5993;14820;3413;10399;952;3337;614;1470;1566;4807
311740;201608;810;2425;770;2374;161;486;546;1709;707;2195
311750;201608;4066;12955;3479;12017;578;2296;1850;6209;2428;8505
311760;201608;715;2381;628;2181;135;516;150;431;285;947
311770;201608;2248;7061;1859;6326;419;1581;539;1746;958;3327
311780;201608;1180;4108;984;3680;265;1147;213;717;478;1864
311783;201608;1982;6382;1654;5745;82;406;1236;4231;1318;4637
311787;201608;598;2018;440;1572;79;308;108;317;187;625
311790;201608;1548;4542;1162;3814;266;1012;362;1135;628;2147
311800;201608;4699;15591;3980;13819;819;3138;414;1270;1233;4408
311810;201608;1066;3435;923;3155;71;336;571;1914;642;2250
311820;201608;629;1912;514;1655;126;461;250;736;376;1197
311830;201608;8450;27658;6797;23759;1887;7193;697;2261;2584;9454
311840;201608;2994;8922;2680;8449;653;2298;1328;4100;1981;6398
311850;201608;280;865;246;807;38;137;134;429;172;566
311860;201608;50019;145260;42343;131876;7811;26577;20788;62799;28599;89376
311870;201608;2137;6196;1547;5037;285;1046;473;1416;758;2462
311880;201608;6841;19318;6010;18269;659;1861;4291;13591;4950;15452
311890;201608;1484;4337;1195;3810;252;882;519;1613;771;2495
311900;201608;747;2221;638;2046;80;293;361;1174;441;1467
311910;201608;4327;12404;3501;11216;788;2666;1408;4510;2196;7176
311920;201608;1903;6177;1660;5736;182;687;1003;3456;1185;4143
311930;201608;3558;9987;2979;9073;1169;3674;697;2099;1866;5773
311940;201608;12656;37473;10094;32271;2192;7539;2454;7401;4646;14940
311950;201608;2229;6454;1798;5790;153;580;1243;3938;1396;4518
311960;201608;389;1190;349;1109;63;248;148;391;211;639
311970;201608;356;1214;288;1062;53;217;66;226;119;443
311980;201608;603;1679;404;1313;64;222;134;446;198;668
311990;201608;447;1276;360;1140;115;399;122;367;237;766
311995;201608;1192;3611;722;2481;40;149;67;164;107;313
312000;201608;612;1825;549;1731;60;206;347;1112;407;1318
312010;201608;891;2863;741;2537;115;435;280;922;395;1357
312015;201608;1381;4395;1227;4114;131;513;797;2627;928;3140
312020;201608;1098;3438;964;3220;207;725;426;1425;633;2150
312030;201608;1844;5222;1644;4971;105;387;1385;4138;1490;4525
312040;201608;748;2669;609;2309;125;517;132;483;257;1000
312050;201608;1225;4266;1047;3844;243;986;151;490;394;1476
312060;201608;759;2278;653;2117;176;614;296;929;472;1543
312070;201608;1043;3177;684;2389;141;543;246;823;387;1366
312080;201608;2676;7315;2130;6475;279;1027;1155;3246;1434;4273
312083;201608;916;2572;781;2379;81;274;572;1723;653;1997
312087;201608;2173;6461;1959;6157;205;713;1436;4574;1641;5287
312090;201608;9031;27417;7603;24959;2070;7178;2723;8807;4793;15985
312100;201608;1447;4630;1122;4084;234;997;443;1542;677;2539
312110;201608;1050;3628;921;3356;254;1062;171;552;425;1614
312120;201608;727;2355;607;2116;131;542;216;665;347;1207
312125;201608;1123;3572;990;3322;215;702;546;1932;761;2634
312130;201608;876;2440;666;2037;84;287;250;716;334;1003
312140;201608;817;2581;705;2318;169;604;185;532;354;1136
312150;201608;490;1425;429;1302;33;124;255;722;288;846
312160;201608;7457;24740;6578;22950;1554;5955;2390;8109;3944;14064
312170;201608;914;2601;766;2358;66;215;475;1442;541;1657
312180;201608;1366;4150;1180;3783;232;819;475;1424;707;2243
312190;201608;593;1884;446;1588;139;547;61;217;200;764
312200;201608;4766;13542;3962;12244;709;2166;2184;6819;2893;8985
312210;201608;1107;2912;837;2512;188;642;414;1158;602;1800
312220;201608;1924;6406;1764;6228;162;480;1480;5480;1642;5960
312230;201608;12569;38221;9705;32776;2989;11189;1155;3681;4144;14870
312235;201608;1573;4652;1382;4372;143;535;977;3068;1120;3603
312240;201608;927;3081;743;2694;172;680;177;619;349;1299
312245;201608;2198;6440;1959;6132;91;319;1585;4957;1676;5276
312247;201608;797;2353;608;2029;166;597;245;831;411;1428
312250;201608;1186;3228;886;2717;145;517;351;1003;496;1520
312260;201608;899;2809;740;2540;118;467;446;1477;564;1944
312270;201608;641;1902;529;1683;60;247;257;749;317;996
312280;201608;413;1368;368;1270;127;467;45;148;172;615
312290;201608;783;2559;715;2456;165;658;233;785;398;1443
312300;201608;889;2923;698;2473;170;660;62;161;232;821
312310;201608;865;3186;808;3070;203;865;314;1158;517;2023
312320;201608;2012;5692;1564;4855;403;1382;301;810;704;2192
312330;201608;994;2882;823;2643;137;519;564;1784;701;2303
312340;201608;314;845;263;762;40;142;152;392;192;534
312350;201608;290;733;255;693;26;89;206;534;232;623
312352;201608;1636;5099;1466;4851;281;979;943;3214;1224;4193
312360;201608;3091;9762;2565;8705;550;2031;689;2344;1239;4375
312370;201608;1689;5233;1534;4989;455;1693;546;1658;1001;3351
312380;201608;1922;5213;1707;4923;60;166;1440;4276;1500;4442
312385;201608;1328;3841;1138;3541;89;360;817;2465;906;2825
312390;201608;2076;6613;1654;5783;401;1487;301;967;702;2454
312400;201608;3161;10004;2624;8924;958;3390;561;1965;1519;5355
312410;201608;10016;32307;8863;30087;1859;6753;3702;12400;5561;19153
312420;201608;3891;11871;3669;11579;555;1727;2456;7942;3011;9669
312430;201608;8065;23394;6884;21338;908;2794;4391;13779;5299;16573
312440;201608;776;2413;642;2175;237;874;200;722;437;1596
312450;201608;1119;3660;860;3131;266;1017;258;966;524;1983
312460;201608;355;1065;314;1017;70;260;160;525;230;785
312470;201608;659;1782;423;1327;78;284;120;347;198;631
312480;201608;1209;3129;907;2801;183;651;501;1454;684;2105
312490;201608;2003;5231;1558;4561;209;673;879;2476;1088;3149
312500;201608;697;2061;605;1920;104;371;226;702;330;1073
312510;201608;3519;10180;2830;8772;403;1412;1373;3985;1776;5397
312520;201608;264;867;212;779;61;232;60;236;121;468
312530;201608;610;1764;535;1657;63;250;339;1018;402;1268
312540;201608;1433;4459;1084;3766;216;801;480;1673;696;2474
312550;201608;687;2065;588;1842;102;337;277;812;379;1149
312560;201608;2076;5418;1702;4939;71;273;1403;4019;1474;4292
312570;201608;2374;6967;1982;6303;524;1786;633;2001;1157;3787
312580;201608;525;1711;438;1522;59;231;166;563;225;794
312590;201608;1683;5506;1452;5021;290;1165;589;1907;879;3072
312595;201608;1941;6443;1740;5983;331;1152;920;3215;1251;4367
312600;201608;799;2556;618;2200;94;416;287;956;381;1372
312610;201608;7091;19779;5217;16369;1155;3959;998;2980;2153;6939
312620;201608;2186;6242;1676;5532;117;436;1222;4168;1339;4604
312630;201608;330;1050;280;961;78;306;91;291;169;597
312640;201608;542;1723;437;1507;86;305;126;407;212;712
312650;201608;2160;6215;1574;5063;168;628;882;2763;1050;3391
312660;201608;1415;3701;1139;3300;95;322;776;2209;871;2531
312670;201608;5585;16318;4684;15087;1266;4507;1593;4989;2859;9496
312675;201608;1280;4036;1079;3606;144;539;676;2238;820;2777
312680;201608;1468;4407;1251;4112;177;701;758;2382;935;3083
312690;201608;2164;5683;1748;5097;265;837;1084;3055;1349;3892
312695;201608;821;2854;779;2793;140;484;512;1921;652;2405
312700;201608;1880;5628;1480;4823;176;644;732;2331;908;2975
312705;201608;1262;3576;1042;3181;71;249;726;2163;797;2412
312707;201608;1539;4838;1186;4148;150;631;601;2019;751;2650
312710;201608;6900;17273;4526;13481;1246;4130;830;2400;2076;6530
312720;201608;759;2550;657;2342;146;586;246;828;392;1414
312730;201608;1886;4435;1309;3751;146;480;769;2192;915;2672
312733;201608;1634;4316;1224;3583;55;174;758;2162;813;2336
312735;201608;823;2224;712;2073;135;456;424;1168;559;1624
312737;201608;842;2088;602;1746;176;513;198;583;374;1096
312738;201608;514;1565;376;1291;81;310;123;389;204;699
312740;201608;347;811;199;639;52;180;42;128;94;308
312750;201608;1269;4458;1192;4330;232;1005;577;2006;809;3011
312760;201608;1977;6283;1520;5352;344;1321;356;1242;700;2563
312770;201608;42057;113371;31469;95573;7585;24779;8112;23801;15697;48580
312780;201608;2680;9115;2376;8592;374;1518;1292;4754;1666;6272
312790;201608;328;828;195;601;28;104;62;150;90;254
312800;201608;4989;16046;4027;14108;1168;4450;879;3054;2047;7504
312810;201608;2074;6279;1448;5045;328;1244;255;812;583;2056
312820;201608;1899;5355;1648;4951;76;263;1143;3341;1219;3604
312825;201608;1336;3593;1155;3357;84;269;889;2588;973;2857
312830;201608;2524;7704;1749;6138;424;1595;280;967;704;2562
312840;201608;1230;3879;1008;3457;141;554;329;1017;470;1571
312850;201608;701;2162;546;1857;95;390;150;486;245;876
312860;201608;1173;3450;898;2958;238;880;248;740;486;1620
312870;201608;5634;17255;3955;13722;677;2561;758;2520;1435;5081
312880;201608;1293;3771;1147;3554;122;423;719;2280;841;2703
312890;201608;1683;5050;1060;3630;225;810;357;1240;582;2050
312900;201608;1224;3558;1059;3330;127;431;739;2381;866;2812
312910;201608;1682;3349;984;2439;157;430;442;1011;599;1441
312920;201608;881;2767;721;2470;165;649;276;878;441;1527
312930;201608;2160;6141;1865;5706;430;1341;809;2503;1239;3844
312940;201608;909;2923;784;2716;194;756;201;651;395;1407
312950;201608;3109;8656;2388;7583;825;2798;481;1536;1306;4334
312960;201608;1955;5547;1686;5195;173;493;1282;4096;1455;4589
312965;201608;1802;5621;1530;5123;168;640;915;3067;1083;3707
312970;201608;1005;3320;830;3020;217;886;206;734;423;1620
312980;201608;17405;57434;16242;55001;4651;17146;5884;19158;10535;36304
312990;201608;476;1388;335;1143;96;374;102;353;198;727
313000;201608;501;1633;403;1438;90;425;156;473;246;898
313005;201608;2606;8242;2302;7693;413;1374;1310;4428;1723;5802
313010;201608;3693;11668;3109;10653;788;2932;1345;4492;2133;7424
313020;201608;966;3147;734;2550;138;547;129;362;267;909
313030;201608;1509;3998;1109;3443;211;783;495;1510;706;2293
313040;201608;833;2716;721;2453;96;402;304;948;400;1350
313050;201608;1818;5581;1353;4863;289;1177;335;1093;624;2270
313055;201608;1630;5046;1480;4837;63;225;1222;4042;1285;4267
313060;201608;750;2378;590;2012;150;525;63;188;213;713
313065;201608;1924;6149;1643;5697;274;1034;1049;3664;1323;4698
313070;201608;1038;2995;847;2669;171;615;359;1085;530;1700
313080;201608;451;1384;336;1146;67;264;97;283;164;547
313090;201608;5234;14985;4517;13828;1066;3496;2219;6795;3285;10291
313100;201608;1129;3375;1021;3206;85;264;796;2545;881;2809
313110;201608;1758;4969;1309;4109;190;681;567;1659;757;2340
313115;201608;2437;8090;2275;7753;508;1962;993;3167;1501;5129
313120;201608;3537;9246;2985;8529;655;2116;1607;4507;2262;6623
313130;201608;25909;77376;22295;70081;4492;15504;8808;26151;13300;41655
313140;201608;581;1492;442;1286;27;93;312;890;339;983
313150;201608;1367;4267;1133;3838;480;1727;204;687;684;2414
313160;201608;947;2862;817;2604;132;483;426;1298;558;1781
313170;201608;8899;29423;6667;24056;1340;5111;1440;5023;2780;10134
313180;201608;2389;6399;1896;5704;390;1305;740;2134;1130;3439
313190;201608;3554;11827;2817;10012;582;2231;712;2362;1294;4593
313200;201608;1143;3655;988;3361;101;372;688;2323;789;2695
313210;201608;4206;12896;3491;11790;711;2572;1582;5173;2293;7745
313220;201608;1526;4476;1094;3589;240;873;245;664;485;1537
313230;201608;2303;8063;2131;7832;313;1238;1463;5352;1776;6590
313240;201608;8259;24793;6374;21258;1144;4367;2436;7727;3580;12094
313250;201608;6888;21372;5871;19604;704;2456;3240;10821;3944;13277
313260;201608;626;1841;438;1433;65;246;107;343;172;589
313270;201608;5416;15991;4472;14365;798;2732;2307;7362;3105;10094
313280;201608;381;1245;276;1016;51;208;61;206;112;414
313290;201608;819;2870;672;2608;238;1037;90;308;328;1345
313300;201608;1816;5947;1496;5208;400;1524;181;528;581;2052
313310;201608;1059;3632;946;3393;201;833;178;565;379;1398
313320;201608;2337;6641;1721;5652;305;1093;686;2269;991;3362
313330;201608;4014;12214;3335;11033;339;1371;1993;6398;2332;7769
313340;201608;1922;4707;1503;4090;276;753;795;2174;1071;2927
313350;201608;2884;8894;2250;7498;443;1631;438;1336;881;2967
313360;201608;1305;3691;974;3139;222;878;485;1455;707;2333
313370;201608;1170;3917;1090;3712;162;657;559;1779;721;2436
313375;201608;2367;6081;1626;4992;284;1064;515;1502;799;2566
313380;201608;5034;15432;4208;13763;1075;3853;1311;3991;2386;7844
313390;201608;872;2954;818;2868;86;352;541;1857;627;2209
313400;201608;3699;9957;3196;9373;308;830;2628;7928;2936;8758
313410;201608;1228;3471;1027;3164;224;766;567;1706;791;2472
313420;201608;18823;44558;11466;32362;2101;6681;1642;4563;3743;11244
313430;201608;1042;3236;792;2718;144;578;280;886;424;1464
313440;201608;6426;14296;4384;11902;240;604;2906;8100;3146;8704
313450;201608;625;1856;504;1620;103;380;149;443;252;823
313460;201608;2150;7217;1851;6699;466;1947;617;2011;1083;3958
313470;201608;3104;8444;2729;7918;360;1079;1819;5226;2179;6305
313480;201608;1034;2915;770;2485;115;427;250;740;365;1167
313490;201608;1518;4388;866;3328;241;1034;79;288;320;1322
313500;201608;407;1335;333;1145;51;195;105;349;156;544
313505;201608;9144;26350;8422;25534;310;635;7771;24099;8081;24734
313507;201608;1387;3770;1186;3474;97;312;792;2338;889;2650
313510;201608;15336;43639;13278;40499;1848;5871;7253;22244;9101;28115
313520;201608;14292;43494;11927;39269;1250;4594;7540;24682;8790;29276
313530;201608;605;1823;498;1627;34;126;187;590;221;716
313535;201608;2533;7393;2269;6918;179;578;1629;4926;1808;5504
313540;201608;1066;3321;789;2612;202;730;185;561;387;1291
313545;201608;1289;4659;1146;4378;177;798;642;2325;819;3123
313550;201608;1813;5766;1592;5339;375;1282;729;2416;1104;3698
313560;201608;2215;5077;1810;4618;215;515;1338;3519;1553;4034
313570;201608;879;3016;757;2780;227;904;241;855;468;1759
313580;201608;5719;16281;4519;14526;763;2629;2422;7919;3185;10548
313590;201608;971;2715;752;2409;335;1183;140;402;475;1585
313600;201608;3844;11409;3295;10532;366;1298;2258;7196;2624;8494
313610;201608;1007;2932;863;2662;189;608;429;1312;618;1920
313620;201608;5483;16702;4745;15373;1247;4302;1610;5176;2857;9478
313630;201608;8233;22616;6186;19724;989;3604;2893;9741;3882;13345
313640;201608;777;2260;577;1952;174;647;156;517;330;1164
313650;201608;1916;6263;1686;5881;253;1017;1058;3617;1311;4634
313652;201608;928;3225;847;3071;143;587;497;1748;640;2335
313655;201608;930;2951;776;2693;102;413;461;1577;563;1990
313657;201608;1343;3901;1091;3524;93;401;793;2398;886;2799
313660;201608;830;2717;732;2533;151;607;341;1114;492;1721
313665;201608;3770;11964;3220;10801;608;2286;1456;4686;2064;6972
313670;201608;45712;132099;33496;108549;7504;26614;9884;31160;17388;57774
313680;201608;1071;3116;931;2889;114;436;581;1750;695;2186
313690;201608;859;3074;754;2829;160;610;285;1100;445;1710
313695;201608;1366;4388;1174;4029;113;449;803;2762;916;3211
313700;201608;3470;11795;3038;11244;461;1735;2138;8130;2599;9865
313710;201608;1346;3566;1012;3041;185;609;506;1481;691;2090
313720;201608;5409;16993;4277;14551;759;2844;1392;4377;2151;7221
313730;201608;1289;3353;972;2951;145;488;548;1667;693;2155
313740;201608;2036;7307;1722;6523;447;1901;108;346;555;2247
313750;201608;2220;6699;1841;5938;468;1594;522;1540;990;3134
313753;201608;1899;5334;1471;4598;256;898;656;2014;912;2912
313760;201608;4181;13367;3422;11854;907;3360;905;2961;1812;6321
313770;201608;3389;10667;2904;9951;860;3144;1161;3994;2021;7138
313780;201608;3992;10856;3074;9460;443;1607;1155;3549;1598;5156
313790;201608;487;1665;460;1618;91;332;260;930;351;1262
313800;201608;1274;3362;1087;3086;96;313;738;2131;834;2444
313810;201608;1560;4433;1389;4189;117;346;1042;3232;1159;3578
313820;201608;12972;34355;10410;30296;1740;5765;4359;12145;6099;17910
313830;201608;422;1377;357;1248;88;358;130;453;218;811
313835;201608;898;2970;824;2849;121;485;455;1508;576;1993
313840;201608;7528;21460;5909;18742;1390;4854;1306;4005;2696;8859
313850;201608;1168;3143;1014;2871;184;632;520;1321;704;1953
313860;201608;2752;8227;2080;6797;427;1482;537;1664;964;3146
313862;201608;1254;3141;872;2515;112;315;449;1378;561;1693
313865;201608;2274;6914;2044;6572;161;596;1547;4954;1708;5550
313867;201608;1124;3803;968;3466;283;1084;285;1049;568;2133
313868;201608;1644;5422;1391;4902;115;521;935;3201;1050;3722
313870;201608;793;2461;712;2321;195;710;197;561;392;1271
313880;201608;1422;4374;1214;4019;301;1110;452;1310;753;2420
313890;201608;1885;4989;1537;4526;282;802;897;2850;1179;3652
313900;201608;3977;14138;3530;13133;1048;4332;903;3304;1951;7636
313910;201608;735;2449;610;2195;210;811;71;242;281;1053
313920;201608;3290;10880;2844;10052;481;1755;1527;5598;2008;7353
313925;201608;1871;5041;1406;4189;71;232;888;2660;959;2892
313930;201608;6676;24504;5662;22689;707;2561;3598;15683;4305;18244
313940;201608;8601;28042;7047;25537;1904;7743;1989;7639;3893;15382
313950;201608;4148;11644;3149;10041;934;3407;964;2795;1898;6202
313960;201608;5510;14086;3954;11836;1020;3332;1029;2891;2049;6223
313970;201608;1447;4150;1261;3933;137;478;759;2481;896;2959
313980;201608;1267;3848;966;3331;218;851;389;1346;607;2197
313990;201608;1771;6503;1513;5885;465;1994;294;993;759;2987
314000;201608;8203;25612;7322;23861;1143;4409;4153;12971;5296;17380
314010;201608;1178;3214;968;2935;76;265;639;1884;715;2149
314015;201608;1384;4607;1142;4166;252;1038;432;1526;684;2564
314020;201608;505;1500;341;1144;78;290;73;232;151;522
314030;201608;849;2736;674;2340;94;361;248;839;342;1200
314040;201608;714;2055;600;1857;236;770;154;470;390;1240
314050;201608;1709;5239;1364;4550;274;1081;507;1565;781;2646
314053;201608;1599;4958;1394;4676;209;712;864;3056;1073;3768
314055;201608;2195;6444;1903;6013;71;276;1518;4833;1589;5109
314060;201608;1164;3552;918;3130;56;251;607;2025;663;2276
314070;201608;4175;12867;3285;11107;819;2896;681;2181;1500;5077
314080;201608;1805;5638;1242;4287;195;740;241;721;436;1461
314085;201608;1971;6516;1720;6156;444;1714;602;2154;1046;3868
314090;201608;3305;11278;2896;10473;677;2773;930;3448;1607;6221
314100;201608;3360;8414;2942;7871;164;348;2489;6929;2653;7277
314110;201608;4043;12748;3542;11713;656;2397;1378;4194;2034;6591
314120;201608;1060;2521;508;1616;103;355;118;373;221;728
314130;201608;703;2011;359;1230;48;178;65;203;113;381
314140;201608;4932;15102;4043;13360;828;2943;1753;5774;2581;8717
314150;201608;1585;4287;1253;3721;158;503;645;1891;803;2394
314160;201608;2599;6570;1942;5611;186;596;1158;3499;1344;4095
314170;201608;1091;3221;899;2817;103;339;485;1466;588;1805
314180;201608;5256;16502;4637;15479;1289;4559;1787;6086;3076;10645
314190;201608;723;2046;551;1768;133;516;198;563;331;1079
314200;201608;2969;9102;2580;8406;256;987;1766;5634;2022;6621
314210;201608;2009;5763;1784;5393;213;753;1077;3172;1290;3925
314220;201608;1583;4884;1206;4148;342;1280;220;655;562;1935
314225;201608;1343;3857;1209;3679;97;318;916;2820;1013;3138
314230;201608;665;2111;615;2031;107;406;323;1050;430;1456
314240;201608;1121;3372;931;3077;160;556;475;1653;635;2209
314250;201608;553;1626;422;1357;92;323;114;321;206;644
314260;201608;1032;3630;917;3370;206;854;264;904;470;1758
314270;201608;2875;9252;2385;8372;225;909;1548;5438;1773;6347
314280;201608;3198;8707;2167;6763;484;1742;696;1919;1180;3661
314290;201608;4823;13212;4108;12042;899;2717;2176;6329;3075;9046
314300;201608;1514;4987;1275;4445;365;1326;321;1095;686;2421
314310;201608;5553;16214;4675;14644;1162;3888;1644;4980;2806;8868
314315;201608;817;3169;741;3020;76;373;494;1997;570;2370
314320;201608;3007;8376;2137;7145;514;1859;990;3438;1504;5297
314330;201608;54855;163605;46400;149750;12839;44358;13507;42898;26346;87256
314340;201608;2954;7927;1677;5456;319;1166;128;266;447;1432
314345;201608;1221;4094;1096;3887;234;871;651;2303;885;3174
314350;201608;1291;3705;992;3206;287;990;151;427;438;1417
314360;201608;675;2145;456;1635;89;378;88;324;177;702
314370;201608;556;1829;515;1771;115;445;336;1125;451;1570
314380;201608;1309;3919;915;3142;233;886;119;410;352;1296
314390;201608;13707;39237;10189;32741;2326;8072;2286;6795;4612;14867
314400;201608;4505;13117;3752;12063;1270;4280;1145;3848;2415;8128
314410;201608;2661;8177;2085;7063;543;2062;613;2099;1156;4161
314420;201608;760;2124;584;1859;28;147;402;1210;430;1357
314430;201608;6436;19021;5504;17248;1479;5066;1585;4968;3064;10034
314435;201608;1325;4238;1162;3954;103;444;760;2560;863;3004
314437;201608;1092;2804;897;2507;32;98;697;1942;729;2040
314440;201608;642;1865;502;1664;164;620;96;264;260;884
314450;201608;1614;4638;1336;4234;270;1025;632;1845;902;2870
314460;201608;4110;13660;3296;11904;751;3012;562;1902;1313;4914
314465;201608;2283;7113;2126;6835;103;482;1672;5230;1775;5712
314467;201608;1015;2868;846;2577;56;164;614;1896;670;2060
314470;201608;2331;7221;1955;6469;402;1518;670;2035;1072;3553
314480;201608;5988;19633;4280;15216;632;2429;486;1498;1118;3927
314490;201608;901;2653;694;2238;147;520;304;918;451;1438
314500;201608;1996;5585;1459;4627;307;1045;463;1396;770;2441
314505;201608;1806;5191;1655;4985;213;718;1127;3429;1340;4147
314510;201608;1905;5150;1291;4282;396;1451;296;987;692;2438
314520;201608;3020;10758;2292;9027;464;2053;226;778;690;2831
314530;201608;5973;20855;5616;20212;1026;3534;3294;12404;4320;15938
314535;201608;2765;7602;2316;6968;238;783;1646;4941;1884;5724
314537;201608;1144;3563;914;3145;110;461;542;1819;652;2280
314540;201608;415;1228;334;1066;60;210;103;306;163;516
314545;201608;1435;4272;1248;4005;98;343;951;3130;1049;3473
314550;201608;629;1714;462;1467;83;351;175;495;258;846
314560;201608;4399;14967;3724;13388;643;2582;1111;3785;1754;6367
314570;201608;300;879;229;741;57;207;96;287;153;494
314580;201608;529;1737;414;1493;94;403;47;150;141;553
314585;201608;838;2693;613;2217;124;513;158;538;282;1051
314587;201608;1985;5970;1687;5459;346;1077;810;2710;1156;3787
314590;201608;3226;10827;2394;8695;439;1793;347;1149;786;2942
314600;201608;1626;5304;1160;4299;254;1032;148;454;402;1486
314610;201608;7037;23594;6285;21853;1348;5220;2530;8277;3878;13497
314620;201608;1617;4791;1442;4535;128;412;1081;3404;1209;3816
314625;201608;1474;4872;1334;4641;170;770;878;2910;1048;3680
314630;201608;4866;14300;4195;13230;274;1112;2987;9278;3261;10390
314640;201608;592;1595;456;1367;114;371;124;304;238;675
314650;201608;1093;3014;778;2482;91;333;286;826;377;1159
314655;201608;1567;4622;1163;3844;296;944;411;1393;707;2337
314660;201608;296;790;210;618;20;60;96;268;116;328
314670;201608;1677;4417;1189;3564;164;536;668;1949;832;2485
314675;201608;1785;5334;1534;4884;145;531;1062;3356;1207;3887
314690;201608;2344;7419;1900;6632;526;2062;383;1280;909;3342
314700;201608;9146;30407;6563;24602;1719;7160;853;3107;2572;10267
314710;201608;8092;24019;5539;18504;871;3285;681;2041;1552;5326
314720;201608;2436;7887;1937;6807;461;1804;498;1759;959;3563
314730;201608;2265;6712;1830;6022;481;1761;624;1924;1105;3685
314740;201608;2883;9114;2472;8312;405;1557;1141;3694;1546;5251
314750;201608;350;1075;279;913;42;150;109;343;151;493
314760;201608;1713;5589;1279;4555;216;885;227;648;443;1533
314770;201608;1079;3335;614;2070;67;252;99;262;166;514
314780;201608;285;761;214;661;52;197;98;283;150;480
314790;201608;11247;33302;8341;27859;3083;11554;675;1785;3758;13339
314795;201608;1676;4776;1417;4371;95;371;1033;3067;1128;3438
314800;201608;11295;32404;7837;25488;1994;7014;779;2359;2773;9373
314810;201608;11753;33777;9003;28970;2491;8769;1703;5465;4194;14234
314820;201608;946;2595;664;2125;157;561;245;765;402;1326
314830;201608;1649;5395;1447;5063;404;1580;592;2081;996;3661
314840;201608;952;3322;770;3050;135;663;433;1644;568;2307
314850;201608;1947;5508;1554;4818;178;708;1045;3122;1223;3830
314860;201608;3288;10741;2869;9951;566;2256;1461;4920;2027;7176
314870;201608;5614;17209;4768;16054;427;1796;3409;11381;3836;13177
314875;201608;1790;5698;1696;5571;193;619;1379;4605;1572;5224
314880;201608;900;2394;737;2180;40;95;545;1723;585;1818
314890;201608;612;1814;426;1408;69;268;152;457;221;725
314900;201608;546;1601;441;1439;84;281;201;647;285;928
314910;201608;1713;5511;1374;4947;405;1638;432;1456;837;3094
314915;201608;2519;7843;2181;7275;160;646;1548;5057;1708;5703
314920;201608;561;1539;398;1289;29;107;209;633;238;740
314930;201608;4697;15628;4069;14274;1031;3905;1015;3365;2046;7270
314940;201608;403;1162;366;1103;59;198;211;596;270;794
314950;201608;335;970;248;843;43;162;68;219;111;381
314960;201608;748;2280;582;1942;136;501;166;504;302;1005
314970;201608;559;1915;470;1737;106;435;133;507;239;942
314980;201608;1501;4596;1242;4166;335;1269;88;263;423;1532
314990;201608;2606;8137;1986;6797;512;2013;367;1056;879;3069
314995;201608;1640;4942;1426;4618;136;546;940;2992;1076;3538
315000;201608;1067;3002;866;2680;84;300;543;1666;627;1966
315010;201608;439;1326;339;1125;70;301;117;333;187;634
315015;201608;2156;6464;1942;6216;251;824;1385;4688;1636;5512
315020;201608;825;2535;597;2033;97;349;228;721;325;1070
315030;201608;694;2049;547;1797;144;506;110;337;254;843
315040;201608;910;2767;851;2665;141;454;531;1653;672;2107
315050;201608;1385;3951;1110;3525;195;708;500;1574;695;2282
315053;201608;1067;3154;943;2920;151;577;440;1367;591;1944
315057;201608;1713;5747;1497;5389;312;1140;734;2687;1046;3827
315060;201608;834;2693;600;2179;117;463;83;296;200;759
315070;201608;756;2240;623;2008;168;577;268;813;436;1390
315080;201608;2881;9429;2473;8533;620;2316;1031;3502;1651;5818
315090;201608;795;2768;649;2417;153;648;137;484;290;1132
315100;201608;1185;3924;857;3158;180;766;208;697;388;1463
315110;201608;1425;4255;1199;3840;275;962;422;1332;697;2294
315120;201608;14497;33655;9891;27678;1470;4213;4681;14023;6151;18236
315130;201608;1402;4599;1267;4338;311;1198;395;1297;706;2495
315140;201608;2800;8731;2266;7652;477;1869;773;2362;1250;4231
315150;201608;4680;12603;3534;10702;639;2171;1297;3899;1936;6070
315160;201608;1286;3708;1030;3217;210;685;418;1277;628;1962
315170;201608;1546;4664;1202;4014;253;912;274;967;527;1879
315180;201608;17211;47980;9781;32301;1607;5939;1584;4800;3191;10739
315190;201608;2051;5304;1702;4772;404;1185;920;2566;1324;3751
315200;201608;3896;12947;3219;11516;1003;3910;591;2088;1594;5998
315210;201608;7905;23073;6303;19771;1168;4067;2272;6801;3440;10868
315213;201608;1103;3384;1012;3247;40;143;814;2608;854;2751
315217;201608;2459;8319;2012;7497;214;966;1173;4287;1387;5253
315220;201608;9857;27838;8227;25214;2649;8241;2621;8372;5270;16613
315230;201608;2945;7804;2609;7414;150;216;2260;6848;2410;7064
315240;201608;3049;9241;2566;8473;713;2516;1121;3597;1834;6113
315250;201608;10450;31448;8055;26933;1838;6788;2400;7907;4238;14695
315260;201608;1027;3168;700;2446;134;489;89;276;223;765
315270;201608;722;2316;561;2004;109;436;118;381;227;817
315280;201608;3106;8833;1954;6355;401;1374;276;823;677;2197
315290;201608;1372;3792;977;3153;289;1031;192;620;481;1651
315300;201608;531;1370;346;1136;143;491;123;419;266;910
315310;201608;1255;3962;1022;3533;147;608;620;2040;767;2648
315320;201608;787;2337;628;2128;104;425;291;971;395;1396
315330;201608;728;2623;461;1901;106;475;53;211;159;686
315340;201608;3588;10123;2872;9033;596;2018;1094;3322;1690;5340
315350;201608;1906;5149;1419;4440;214;721;842;2693;1056;3414
315360;201608;1713;5634;1395;4896;257;1000;450;1479;707;2479
315370;201608;503;1538;431;1423;78;275;214;724;292;999
315380;201608;206;692;161;585;37;166;36;101;73;267
315390;201608;1346;4402;995;3586;210;842;171;583;381;1425
315400;201608;4292;12849;3470;11264;685;2420;1503;4772;2188;7192
315410;201608;2152;5520;1794;5037;160;542;1289;3629;1449;4171
315415;201608;1044;3368;919;3176;358;1312;291;1014;649;2326
315420;201608;1245;3957;964;3390;221;809;120;388;341;1197
315430;201608;3696;9944;2760;8426;742;2518;582;1664;1324;4182
315440;201608;951;2879;822;2660;157;594;368;1103;525;1697
315445;201608;2111;5822;1620;5069;197;676;1061;3317;1258;3993
315450;201608;2442;7559;2165;7126;383;1161;1288;4411;1671;5572
315460;201608;33087;106804;29257;98966;9739;35145;5088;16354;14827;51499
315470;201608;475;1414;385;1245;41;163;201;636;242;799
315480;201608;1749;5275;1173;3977;219;805;203;704;422;1509
315490;201608;3116;8263;2351;7223;366;1270;859;2528;1225;3798
315500;201608;489;1420;319;1029;44;157;127;356;171;513
315510;201608;1400;3968;1180;3623;110;362;827;2482;937;2844
315520;201608;1026;3072;831;2746;122;440;495;1580;617;2020
315530;201608;643;2143;519;1820;179;674;141;448;320;1122
315540;201608;1074;3370;880;2998;171;690;291;987;462;1677
315550;201608;1766;4939;1364;4318;310;1094;408;1251;718;2345
315560;201608;6533;21547;5863;20596;526;2116;3930;13942;4456;16058
315570;201608;1967;6159;1798;5871;277;1026;966;3079;1243;4105
315580;201608;2529;7293;1974;6304;484;1770;520;1553;1004;3323
315590;201608;871;2534;769;2379;112;390;419;1265;531;1655
315600;201608;2476;8651;1976;7685;365;1449;972;3971;1337;5420
315610;201608;1005;2820;809;2428;138;526;321;814;459;1340
315620;201608;317;1105;298;1072;92;308;152;588;244;896
315630;201608;913;2873;739;2515;159;566;151;482;310;1048
315640;201608;485;1392;394;1246;76;293;168;489;244;782
315645;201608;882;2609;705;2239;248;835;167;502;415;1337
315650;201608;1844;5028;1451;4467;92;391;1054;3210;1146;3601
315660;201608;2584;6606;2090;5829;258;710;1377;3817;1635;4527
315670;201608;10766;35095;9511;32670;2491;9222;3398;11389;5889;20611
315680;201608;3033;9974;2345;8573;705;2744;545;1978;1250;4722
315690;201608;3380;9508;2311;7584;550;1977;402;1410;952;3387
315700;201608;7315;22525;6148;20222;1043;3818;2781;8751;3824;12569
315710;201608;1822;5147;1411;4486;104;425;877;2692;981;3117
315720;201608;3678;11566;3255;10780;345;1398;1861;5884;2206;7282
315725;201608;1509;4708;1343;4462;238;837;894;3007;1132;3844
315727;201608;600;1842;489;1614;101;373;169;521;270;894
315730;201608;794;2446;725;2303;104;373;385;1183;489;1556
315733;201608;1011;3015;889;2799;266;928;279;815;545;1743
315737;201608;1262;3811;977;3300;66;284;619;2110;685;2394
315740;201608;1013;3046;840;2704;150;581;424;1256;574;1837
315750;201608;1132;3455;1012;3236;58;217;726;2313;784;2530
315760;201608;1038;2725;1001;2679;14;51;934;2476;948;2527
315765;201608;1507;4638;1342;4420;58;230;1089;3649;1147;3879
315770;201608;1444;4570;1240;4217;318;1194;294;999;612;2193
315780;201608;22636;73011;20337;68029;4633;16647;6669;21853;11302;38500
315790;201608;3655;11954;3192;11037;426;1455;1970;7009;2396;8464
315800;201608;1446;5557;1131;4624;235;1026;164;640;399;1666
315810;201608;1379;3674;1150;3315;192;563;687;1924;879;2487
315820;201608;2461;8197;2129;7604;672;2487;800;2974;1472;5461
315830;201608;1210;3953;1009;3550;117;508;317;985;434;1493
315840;201608;846;2196;563;1691;97;335;150;412;247;747
315850;201608;1008;3530;978;3474;239;950;519;1747;758;2697
315860;201608;522;1756;383;1451;83;374;70;230;153;604
315870;201608;465;1347;379;1210;70;249;177;533;247;782
315880;201608;1210;3081;953;2758;199;711;332;883;531;1594
315890;201608;1502;5065;1318;4747;488;1873;495;1758;983;3631
315895;201608;5380;16707;4608;14969;947;3322;1528;4715;2475;8037
315900;201608;749;2221;714;2162;59;256;562;1589;621;1845
315910;201608;520;1726;478;1655;143;554;268;884;411;1438
315920;201608;1600;4389;912;2920;174;613;162;436;336;1049
315930;201608;1089;2902;805;2409;197;625;196;571;393;1196
315935;201608;947;3125;839;2897;224;870;202;659;426;1529
315940;201608;620;1959;533;1780;109;410;245;799;354;1209
315950;201608;1205;3627;1067;3368;231;688;613;2005;844;2693
315960;201608;3556;11137;2412;8810;779;3304;100;217;879;3521
315970;201608;751;2043;564;1783;46;126;381;1256;427;1382
315980;201608;4045;9837;2504;7276;647;2112;561;1392;1208;3504
315990;201608;4015;11440;3276;10193;542;2002;1547;4632;2089;6634
316000;201608;575;1695;477;1561;133;536;175;536;308;1072
316010;201608;633;2053;511;1821;58;254;231;756;289;1010
316020;201608;1049;3284;915;3071;116;446;597;1952;713;2398
316030;201608;3170;9234;2323;7712;193;763;1394;4686;1587;5449
316040;201608;3445;10828;2619;9092;392;1561;491;1460;883;3021
316045;201608;2049;6295;1875;6003;251;797;1272;4181;1523;4978
316050;201608;352;1112;282;1002;56;236;127;408;183;644
316060;201608;742;2206;587;1978;72;335;333;1020;405;1355
316070;201608;6184;19168;5314;17287;1142;4155;2124;6574;3266;10729
316080;201608;746;2693;654;2467;134;574;77;287;211;861
316090;201608;534;1608;373;1258;55;218;112;345;167;563
316095;201608;1460;4585;1246;4210;184;621;756;2583;940;3204
316100;201608;2803;9098;2108;7462;493;1933;398;1282;891;3215
316105;201608;935;2636;699;2233;168;567;247;798;415;1365
316110;201608;12286;41128;10866;38717;1316;4913;6967;25603;8283;30516
316120;201608;1141;3634;909;3093;217;775;219;645;436;1420
316130;201608;1537;3466;913;2563;131;416;367;974;498;1390
316140;201608;973;2798;762;2482;103;344;442;1465;545;1809
316150;201608;1538;4113;1341;3773;188;636;781;2161;969;2797
316160;201608;1256;3654;962;3099;171;604;397;1253;568;1857
316165;201608;944;2504;784;2276;142;481;415;1202;557;1683
316170;201608;1367;3856;1004;3238;156;547;406;1204;562;1751
316180;201608;1419;4377;1007;3462;208;806;181;544;389;1350
316190;201608;2856;8791;1498;5270;280;972;233;716;513;1688
316200;201608;3882;12187;2959;10360;603;2404;663;2224;1266;4628
316210;201608;4754;15112;3992;13606;1361;4861;521;1777;1882;6638
316220;201608;796;2438;561;1973;100;401;58;213;158;614
316225;201608;1214;3329;1005;2997;160;554;579;1645;739;2199
316230;201608;419;1194;346;1069;51;179;164;548;215;727
316240;201608;6664;20148;5793;18982;649;2085;4167;13867;4816;15952
316245;201608;3256;11112;2980;10660;207;1075;2276;7865;2483;8940
316250;201608;10758;30798;8293;25972;2081;7094;1837;5453;3918;12547
316255;201608;2623;7756;2278;7332;330;1175;1529;4992;1859;6167
316257;201608;1367;3733;1020;3104;179;606;338;969;517;1575
316260;201608;1813;5043;1426;4466;138;489;727;2398;865;2887
316265;201608;1331;3732;979;3052;97;351;573;1743;670;2094
316270;201608;3981;13148;3629;12417;915;3399;1382;4558;2297;7957
316280;201608;3206;10272;2899;9697;438;1632;1574;5134;2012;6766
316290;201608;3455;10624;2916;9583;529;2023;1141;3642;1670;5665
316292;201608;3572;11144;3149;10462;516;1923;1844;5910;2360;7833
316294;201608;893;2801;655;2317;120;501;46;164;166;665
316295;201608;1846;6041;1717;5795;194;814;1142;3712;1336;4526
316300;201608;1013;3108;859;2854;67;242;531;1798;598;2040
316310;201608;719;2040;481;1606;89;349;143;438;232;787
316320;201608;619;1935;492;1697;87;357;89;271;176;628
316330;201608;976;2961;765;2481;75;278;493;1560;568;1838
316340;201608;941;2998;761;2625;147;608;356;1141;503;1749
316350;201608;1316;4116;1166;3868;183;641;650;2159;833;2800
316360;201608;740;1959;586;1738;100;300;369;1113;469;1413
316370;201608;4612;14641;3929;13288;1064;3974;582;1874;1646;5848
316380;201608;1640;4253;1278;3749;73;235;908;2687;981;2922
316390;201608;900;2570;743;2323;166;567;300;967;466;1534
316400;201608;1302;3952;980;3375;212;788;365;1221;577;2009
316410;201608;1078;3534;990;3406;168;606;645;2231;813;2837
316420;201608;1947;6160;1714;5856;136;563;1228;4099;1364;4662
316430;201608;956;2895;681;2335;158;598;144;448;302;1046
316440;201608;676;2205;557;2026;191;803;100;366;291;1169
316443;201608;695;2025;564;1785;113;414;215;638;328;1052
316447;201608;1590;4671;1434;4467;97;315;1201;3765;1298;4080
316450;201608;2175;7198;1817;6490;207;837;1200;4286;1407;5123
316460;201608;749;2301;676;2173;188;634;320;1004;508;1638
316470;201608;7358;23289;5852;20192;1500;5904;1451;4803;2951;10707
316480;201608;182;612;155;548;36;135;38;127;74;262
316490;201608;305;941;246;802;45;133;88;268;133;401
316500;201608;1152;4009;765;2883;137;570;33;115;170;685
316510;201608;757;2763;674;2594;236;964;160;604;396;1568
316520;201608;1074;3215;863;2889;144;530;287;867;431;1397
316530;201608;1033;3274;850;2938;172;728;287;824;459;1552
316540;201608;740;2363;659;2220;91;380;226;711;317;1091
316550;201608;1190;3951;1105;3808;208;822;650;2236;858;3058
316553;201608;1951;6759;1533;5732;420;1750;319;1119;739;2869
316555;201608;2830;9612;2513;9214;183;719;1889;7115;2072;7834
316556;201608;646;1626;494;1385;45;137;323;879;368;1016
316557;201608;780;2784;735;2711;283;1107;185;613;468;1720
316560;201608;323;1137;276;1037;63;284;59;209;122;493
316570;201608;1255;3979;1096;3675;130;454;541;1839;671;2293
316580;201608;303;831;205;638;42;140;46;135;88;275
316590;201608;1472;3948;1042;3234;209;689;478;1375;687;2064
316600;201608;1056;3405;936;3170;251;908;351;1169;602;2077
316610;201608;583;2093;507;1929;91;427;309;1123;400;1550
316620;201608;2168;6529;1849;5994;241;937;1137;3620;1378;4557
316630;201608;1429;4732;1224;4285;487;1793;286;1026;773;2819
316640;201608;176;551;154;506;31;132;66;183;97;315
316650;201608;908;3265;798;3085;103;392;512;2062;615;2454
316660;201608;196;506;92;283;6;24;19;44;25;68
316670;201608;1932;5351;1543;4683;568;1868;354;1001;922;2869
316680;201608;1993;5352;1583;4766;152;486;1116;3357;1268;3843
316690;201608;1158;3903;1024;3600;286;1128;285;982;571;2110
316695;201608;1093;3404;947;3121;101;362;587;1927;688;2289
316700;201608;369;1085;331;1022;29;127;220;621;249;748
316710;201608;2938;10894;2506;9955;920;3827;534;2288;1454;6115
316720;201608;16722;52987;13630;46358;3379;12130;3191;10588;6570;22718
316730;201608;366;1121;316;1024;78;285;127;378;205;663
316740;201608;673;2238;611;2134;87;360;384;1346;471;1706
316750;201608;403;1348;338;1203;50;218;113;364;163;582
316760;201608;3526;11583;3032;10887;1561;5861;818;2998;2379;8859
316770;201608;1336;3666;1191;3479;76;301;978;2830;1054;3131
316780;201608;590;1936;508;1771;137;553;66;188;203;741
316790;201608;861;2442;643;2074;146;497;190;622;336;1119
316800;201608;5161;16766;4555;15587;835;3189;2255;7282;3090;10471
316805;201608;800;2034;769;1993;49;132;657;1773;706;1905
316810;201608;611;1856;502;1640;129;464;190;571;319;1035
316820;201608;396;1029;224;731;33;134;29;86;62;220
316830;201608;572;1951;544;1902;160;612;222;754;382;1366
316840;201608;2831;8596;2480;7952;514;1902;1095;3329;1609;5231
316850;201608;2068;5940;1687;5310;243;856;923;2876;1166;3732
316860;201608;17951;56048;15278;51127;3396;13008;5902;18876;9298;31884
316870;201608;6173;19701;4950;16901;1372;5121;812;2659;2184;7780
316880;201608;868;2617;749;2420;211;798;223;696;434;1494
316890;201608;1285;3084;969;2653;260;820;495;1250;755;2070
316900;201608;2583;7619;2038;6523;449;1581;580;1672;1029;3253
316905;201608;466;1535;401;1386;135;499;122;423;257;922
316910;201608;855;2649;619;2174;157;609;81;263;238;872
316920;201608;1611;4313;1134;3649;296;1078;381;1162;677;2240
316930;201608;8433;28269;6692;24496;1430;5713;862;2920;2292;8633
316935;201608;5005;14522;3399;11344;865;3144;655;2143;1520;5287
316940;201608;6938;22305;5508;19183;1169;4231;1069;3557;2238;7788
316950;201608;1574;4276;1304;3900;108;379;942;2776;1050;3155
316960;201608;4802;12058;3773;10642;681;2068;2054;5713;2735;7781
316970;201608;3256;10247;3054;9890;652;2437;1186;3534;1838;5971
316980;201608;958;2902;686;2378;204;795;99;324;303;1119
316990;201608;9761;30478;8042;26662;2246;8028;561;1740;2807;9768
317000;201608;2814;9439;2690;9299;293;906;2016;7800;2309;8706
317005;201608;2574;7896;2257;7374;440;1445;1234;4087;1674;5532
317010;201608;30611;75542;18783;57149;4298;14702;3355;10857;7653;25559
317020;201608;64620;174283;37921;120581;6991;24359;6925;20292;13916;44651
317030;201608;717;2079;594;1886;52;210;355;1118;407;1328
317040;201608;10495;30057;8311;26194;2045;6827;2991;9453;5036;16280
317043;201608;720;1929;608;1777;102;282;346;1021;448;1303
317047;201608;1138;2993;836;2497;82;266;448;1339;530;1605
317050;201608;1534;5157;1184;4327;237;910;404;1367;641;2277
317052;201608;2292;7369;2094;7051;158;622;1521;5048;1679;5670
317057;201608;1695;4703;1274;3963;112;449;744;2225;856;2674
317060;201608;425;1216;269;868;60;219;61;173;121;392
317065;201608;1288;4025;1155;3808;93;395;837;2690;930;3085
317070;201608;9761;29998;6732;23237;1355;5238;823;2736;2178;7974
317075;201608;1091;3279;855;2773;185;625;188;586;373;1211
317080;201608;6216;16829;5188;15101;1522;4557;1487;4248;3009;8805
317090;201608;4845;15886;4490;15325;528;1770;3091;10774;3619;12544
317100;201608;3060;8246;2235;6850;690;2296;656;1921;1346;4217
317103;201608;1982;6677;1679;6098;222;1044;824;2883;1046;3927
317107;201608;1334;4049;1157;3693;149;581;739;2201;888;2782
317110;201608;670;1684;385;1201;55;203;139;461;194;664
317115;201608;1145;3536;964;3164;102;340;673;2232;775;2572
317120;201608;10679;35161;8674;30466;1866;7209;3148;10708;5014;17917
317130;201608;7505;22040;6197;19682;1345;4721;2330;7337;3675;12058
317140;201608;570;1810;519;1730;68;248;335;1127;403;1375
317150;201608;958;2635;830;2484;86;306;611;1778;697;2084
317160;201608;3506;9136;2608;7914;175;579;1772;5317;1947;5896
317170;201608;1923;5137;1476;4391;164;576;589;1571;753;2147
317180;201608;1794;5988;1452;5251;348;1327;334;1193;682;2520
317190;201608;1398;3898;1097;3466;98;327;716;2248;814;2575
317200;201608;4550;14082;3894;12741;949;3430;1109;3489;2058;6919
317210;201608;1036;3053;865;2821;125;526;503;1583;628;2109
317220;201608;292;993;277;970;70;260;141;481;211;741
320010;201608;5008;15544;4296;14097;795;2757;2124;6875;2919;9632
320013;201608;1894;5744;1315;4466;220;773;517;1813;737;2586
320016;201608;3113;8695;2653;8013;301;860;1870;5709;2171;6569
320020;201608;3863;11977;3273;10756;896;3174;967;3187;1863;6361
320030;201608;1697;5355;1296;4486;381;1395;347;1140;728;2535
320035;201608;1796;5267;1534;4867;513;1776;504;1506;1017;3282
320040;201608;3142;10070;2611;8992;562;2081;840;2877;1402;4958
320050;201608;1747;4708;1490;4242;313;966;638;1728;951;2694
320060;201608;11897;37256;8956;30601;1996;7389;1910;6138;3906;13527
320070;201608;1453;4606;1170;3989;252;927;278;861;530;1788
320080;201608;5723;16391;4368;13693;968;3123;1244;4020;2212;7143
320090;201608;8149;23560;6435;20118;1668;5544;2165;6500;3833;12044
320100;201608;2805;8626;2219;7430;634;2200;653;2201;1287;4401
320110;201608;1303;3850;1124;3503;278;868;301;975;579;1843
320115;201608;1768;6258;1597;5945;861;3357;342;1318;1203;4675
320120;201608;16674;49846;12849;42558;3082;11166;3361;11108;6443;22274
320130;201608;36358;115780;32611;108292;6541;24151;14742;47336;21283;71487
320140;201608;3755;11771;2670;9319;663;2541;324;1110;987;3651
320150;201608;15881;43843;11550;35595;2861;9534;1239;3578;4100;13112
320160;201608;4931;15413;4214;13948;1046;3859;1365;4168;2411;8027
320170;201608;1723;5450;1397;4734;340;1213;493;1655;833;2868
320180;201608;753;2501;658;2327;259;945;139;514;398;1459
320190;201608;3678;12572;2888;10635;745;2858;468;1704;1213;4562
320200;201608;1035;3145;848;2824;230;839;237;835;467;1674
320210;201608;4798;13392;4005;11843;831;2735;1765;4858;2596;7593
320220;201608;2414;7425;1962;6533;505;1820;706;2372;1211;4192
320225;201608;1364;4590;1070;3887;372;1457;121;432;493;1889
320230;201608;4293;13613;3639;12494;1108;4068;1268;4466;2376;8534
320240;201608;12647;36914;10086;32313;2508;8680;2611;8394;5119;17074
320245;201608;3404;11553;3135;10908;1033;3804;714;2397;1747;6201
320250;201608;1915;5790;1344;4469;333;1266;212;607;545;1873
320255;201608;1790;5938;1554;5530;642;2467;469;1766;1111;4233
320260;201608;1061;3222;794;2631;199;709;195;575;394;1284
320265;201608;2438;7696;2103;7165;566;2002;998;3512;1564;5514
320270;201608;2718;7934;2013;6584;454;1617;813;2664;1267;4281
320280;201608;6832;20637;5912;18803;1361;4773;1850;5419;3211;10192
320290;201608;1419;4619;1033;3687;305;1143;128;476;433;1619
320300;201608;4250;14091;3733;12925;1175;4327;741;2518;1916;6845
320305;201608;4532;14486;3860;12959;916;3344;1433;4626;2349;7970
320310;201608;1971;5802;1643;5141;396;1304;581;1762;977;3066
320313;201608;2229;6395;1528;4819;337;1243;243;674;580;1917
320316;201608;1745;5241;1403;4528;427;1444;384;1218;811;2662
320320;201608;20637;61774;16099;53393;4164;15117;4974;16139;9138;31256
320330;201608;3008;8874;2486;7974;724;2306;940;3207;1664;5513
320332;201608;5344;17260;4623;15887;1563;5739;1460;4956;3023;10695
320334;201608;1953;6114;1330;4732;337;1331;245;837;582;2168
320335;201608;2368;6946;1485;4873;364;1301;145;391;509;1692
320340;201608;5956;15943;4953;14305;1059;3296;2094;6186;3153;9482
320350;201608;5220;13709;3895;11311;768;2301;1593;4587;2361;6888
320360;201608;1737;4588;1264;3684;206;632;449;1236;655;1868
320370;201608;3018;9790;2423;8432;670;2408;674;2331;1344;4739
320380;201608;2226;6520;1947;6024;406;1371;1018;3058;1424;4429
320390;201608;7409;22119;6006;19182;1672;5737;1574;4789;3246;10526
320400;201608;3565;10886;3145;10144;778;2765;1250;3873;2028;6638
320405;201608;4210;12219;3649;11272;797;2615;1833;5566;2630;8181
320410;201608;5569;14673;4077;12658;956;3190;1756;5503;2712;8693
320420;201608;2303;6889;1811;5995;520;1935;424;1374;944;3309
320425;201608;2021;5280;1630;4636;184;556;991;2776;1175;3332
320430;201608;2487;6903;2131;6186;419;1276;1102;3104;1521;4380
320435;201608;2822;9098;2312;8055;1066;3876;535;1961;1601;5837
320440;201608;1063;3491;934;3169;222;855;291;925;513;1780
320450;201608;2015;6281;1629;5517;430;1592;626;2050;1056;3642
320455;201608;4202;13692;3083;10999;842;3223;605;2076;1447;5299
320460;201608;2701;8576;2008;6993;481;1802;446;1458;927;3260
320465;201608;1622;5002;1227;4134;202;729;553;1856;755;2585
320470;201608;4497;13402;3083;10236;844;3106;461;1400;1305;4506
320480;201608;1788;5535;1546;5064;384;1376;539;1706;923;3082
320490;201608;16271;49336;13593;44482;3812;13713;3840;12476;7652;26189
320495;201608;1368;3919;888;2933;269;957;92;321;361;1278
320500;201608;48384;144573;41861;132800;9335;31956;19051;59039;28386;90995
320501;201608;4360;13556;3643;12443;1161;4415;968;3186;2129;7601
320503;201608;1869;6306;1502;5508;591;2370;357;1165;948;3535
320506;201608;3994;12249;2792;9410;749;2680;86;236;835;2916
320510;201608;8545;26422;7375;24175;1622;5777;3353;10795;4975;16572
320515;201608;1904;5458;1537;4647;392;1234;262;742;654;1976
320517;201608;2192;7007;1758;6125;539;2044;363;1236;902;3280
320520;201608;38059;112929;30999;100016;7688;27272;10279;32567;17967;59839
320530;201608;27609;82753;22742;73493;4292;15953;10576;32061;14868;48014
330010;201608;20521;62101;18408;58076;3927;13295;9356;29092;13283;42387
330015;201608;1673;4631;1429;4180;226;778;639;1811;865;2589
330020;201608;17868;51899;16230;49196;2942;9755;9254;27348;12196;37103
330022;201608;1915;5608;1602;5088;299;1084;825;2536;1124;3620
330023;201608;3239;9954;2823;9273;781;2767;822;2587;1603;5354
330025;201608;4602;12344;3602;10650;819;2635;1796;5240;2615;7875
330030;201608;8238;27062;7209;25021;1459;5534;3250;10779;4709;16313
330040;201608;12486;36561;11022;33885;2395;7880;5484;16354;7879;24234
330045;201608;73077;198221;62843;183709;8098;25260;41386;119169;49484;144429
330050;201608;2556;7817;2172;7084;613;2215;658;1974;1271;4189
330060;201608;5834;16602;4992;15366;1189;4081;2404;7266;3593;11347
330070;201608;21636;65046;19267;61043;4160;14155;8577;27094;12737;41249
330080;201608;8021;22657;7383;21664;771;2279;5070;14914;5841;17193
330090;201608;2704;7242;2409;6791;423;1298;1269;3479;1692;4777
330093;201608;2104;6143;1744;5508;342;1105;728;2428;1070;3533
330095;201608;1032;3469;887;3147;208;854;269;883;477;1737
330100;201608;57437;179741;52123;171077;8366;30807;28553;93280;36919;124087
330110;201608;2386;7427;2102;6916;512;1808;621;1993;1133;3801
330115;201608;1940;5549;1692;5172;316;1084;864;2536;1180;3620
330120;201608;2662;7258;2327;6748;432;1415;1310;3659;1742;5074
330130;201608;3626;11570;3204;10832;798;2903;1387;4596;2185;7499
330140;201608;3114;9540;2818;9092;591;2133;1471;4658;2062;6791
330150;201608;2394;7016;1872;5971;434;1484;416;1354;850;2838
330160;201608;1177;3701;1028;3442;265;1022;455;1418;720;2440
330170;201608;101544;302419;91723;286708;17670;58121;49665;154053;67335;212174
330180;201608;2056;5968;1702;5317;134;514;1057;3120;1191;3634
330185;201608;8227;25231;7105;23079;1454;5110;3625;11489;5079;16599
330187;201608;3882;10999;3313;10048;473;1591;2112;6282;2585;7873
330190;201608;25758;72889;23948;70057;4295;13226;15601;45317;19896;58543
330200;201608;14287;44552;12650;41751;3204;10917;5867;19574;9071;30491
330205;201608;2214;6019;1913;5511;302;949;1071;3008;1373;3957
330210;201608;3281;9075;2695;7931;744;2264;649;1871;1393;4135
330220;201608;10487;31703;8990;28527;2232;7596;2255;6617;4487;14213
330225;201608;3868;11910;3391;11030;402;1590;1935;6053;2337;7643
330227;201608;17118;48976;15399;46485;3662;11367;8187;25050;11849;36417
330230;201608;1387;4074;1243;3848;257;927;590;1730;847;2657
330240;201608;17908;54519;15192;49339;4720;16564;3640;11263;8360;27827
330245;201608;1311;3986;1001;3405;255;952;160;499;415;1451
330250;201608;36249;105294;32866;99738;9706;29709;12433;39082;22139;68791
330260;201608;3941;12256;3414;11182;634;2275;1390;4339;2024;6614
330270;201608;19619;45339;13126;36453;3082;9547;4458;12354;7540;21901
330280;201608;2255;6632;1871;5877;318;1090;872;2595;1190;3685
330285;201608;18560;52728;16602;49794;2804;8956;9948;29599;12752;38555
330290;201608;3441;9672;3034;9060;477;1610;1741;4965;2218;6575
330300;201608;3362;10826;3042;10215;448;1729;1776;5775;2224;7504
330310;201608;2331;6573;1979;5978;297;916;1113;3352;1410;4268
330320;201608;13389;39865;12495;38493;1747;5865;8940;27292;10687;33157
330330;201608;28019;76708;24340;70936;4083;13216;14350;40436;18433;53652
330340;201608;14838;42889;11634;37029;2727;9219;3439;10732;6166;19951
330350;201608;87491;256778;79350;244838;11905;38548;52779;162824;64684;201372
330360;201608;5843;17247;5600;16915;418;1439;4651;13928;5069;15367
330370;201608;3514;12324;3161;11540;1069;4029;940;3458;2009;7487
330380;201608;5031;16158;4233;14542;933;3539;1428;4691;2361;8230
330385;201608;4020;13730;3656;12997;1072;4077;1281;4569;2353;8646
330390;201608;23140;75102;20302;69421;4844;18057;8201;27425;13045;45482
330395;201608;3083;8961;2780;8461;255;911;1794;5351;2049;6262
330400;201608;2616;8178;2350;7731;304;1230;1418;4306;1722;5536
330410;201608;2831;8616;2305;7602;467;1699;977;3096;1444;4795
330411;201608;2404;7475;2070;6766;248;936;1181;3694;1429;4630
330412;201608;1391;4630;1162;4174;221;921;505;1689;726;2610
330414;201608;24466;68693;21339;64273;4380;13077;11926;36402;16306;49479
330415;201608;3592;10910;3066;9986;767;2587;1075;3514;1842;6101
330420;201608;10018;28544;6800;22596;1433;5156;1252;4010;2685;9166
330430;201608;7407;21825;6508;20135;1381;4567;2813;8480;4194;13047
330440;201608;1681;5577;1463;5124;442;1721;317;992;759;2713
330450;201608;1377;4516;1225;4246;259;1079;599;2000;858;3079
330452;201608;14200;41171;11270;35533;2764;9478;4096;12437;6860;21915
330455;201608;510816;1387694;412099;1229399;90193;285731;196979;581233;287172;866964
330460;201608;1209;3913;1068;3658;223;845;459;1540;682;2385
330470;201608;4462;13395;3962;12486;861;2937;1754;5404;2615;8341
330475;201608;7910;24311;6944;22689;2059;7316;2414;7661;4473;14977
330480;201608;5896;17123;5344;16309;913;2991;3093;9228;4006;12219
330490;201608;110065;289150;98023;271382;10292;29736;69274;191339;79566;221075
330500;201608;5562;16986;5294;16505;722;2445;3503;10786;4225;13231
330510;201608;37834;114674;33696;108098;10719;34726;13520;44505;24239;79231
330513;201608;1502;4446;1365;4202;409;1270;536;1700;945;2970
330515;201608;3053;9339;2645;8541;800;2575;705;2266;1505;4841
330520;201608;11572;34556;10270;32257;2098;6913;4629;14356;6727;21269
330530;201608;1521;4442;1329;4080;320;1076;516;1526;836;2602
330540;201608;2967;8756;2447;7795;592;2011;868;2646;1460;4657
330550;201608;7907;26230;6927;24325;2901;10622;962;3376;3863;13998
330555;201608;10377;30281;9149;28506;1778;5617;5247;16802;7025;22419
330560;201608;4328;12894;3883;12056;649;2243;2014;5991;2663;8234
330570;201608;3410;9964;2907;9108;748;2463;1306;4088;2054;6551
330575;201608;5303;15185;4727;14141;672;2291;3021;8677;3693;10968
330580;201608;14066;44019;11901;39609;3138;10906;4313;14402;7451;25308
330590;201608;1610;4894;1490;4701;269;905;929;2909;1198;3814
330600;201608;11045;31912;8879;28257;1370;4891;4196;13081;5566;17972
330610;201608;8945;27727;8069;26170;1307;4809;4532;14281;5839;19090
330615;201608;1678;5850;1515;5512;652;2542;332;1224;984;3766
330620;201608;3493;11971;3089;11120;968;3785;643;2281;1611;6066
330630;201608;23448;68250;19156;60609;3095;11113;10093;30585;13188;41698
350010;201608;2017;5955;1349;4598;315;1142;151;475;466;1617
350020;201608;466;1270;321;986;47;156;157;453;204;609
350030;201608;4449;13871;3453;11906;1132;4217;735;2452;1867;6669
350040;201608;482;1647;361;1367;81;333;90;321;171;654
350050;201608;925;2781;747;2454;162;619;254;724;416;1343
350055;201608;667;1959;565;1791;96;318;320;985;416;1303
350060;201608;115;338;91;301;24;93;41;132;65;225
350070;201608;3789;11279;2424;8372;481;1784;452;1399;933;3183
350075;201608;504;1670;395;1457;140;519;64;221;204;740
350080;201608;624;1791;408;1318;76;269;142;443;218;712
350090;201608;616;1595;399;1204;107;305;130;406;237;711
350100;201608;1890;5846;1362;4788;280;1113;391;1286;671;2399
350110;201608;471;1411;360;1174;36;140;190;603;226;743
350115;201608;1274;3799;1124;3495;194;691;594;1682;788;2373
350120;201608;617;1634;324;1017;58;196;46;134;104;330
350130;201608;3332;9863;2900;8994;411;1453;1553;4553;1964;6006
350140;201608;597;1914;501;1745;65;266;244;825;309;1091
350150;201608;407;1355;351;1236;115;428;70;241;185;669
350160;201608;8073;23399;5506;18288;1198;4432;2065;6302;3263;10734
350170;201608;1664;5681;1411;5053;352;1335;276;928;628;2263
350180;201608;1072;3003;702;2158;97;301;326;993;423;1294
350190;201608;3058;9433;2486;8263;540;2105;1081;3135;1621;5240
350200;201608;367;1149;322;1068;30;98;202;676;232;774
350210;201608;5004;13301;3721;11188;1027;3312;1444;4235;2471;7547
350220;201608;2630;8274;2276;7517;487;1899;899;2720;1386;4619
350230;201608;705;2261;628;2117;142;522;254;833;396;1355
350240;201608;495;1502;412;1311;68;230;226;697;294;927
350250;201608;2054;7338;1907;7061;661;2613;562;2074;1223;4687
350260;201608;968;2585;667;2026;108;347;293;863;401;1210
350270;201608;4995;15198;4210;13481;753;2579;1758;5374;2511;7953
350275;201608;1973;6425;1777;6082;490;1784;642;2099;1132;3883
350280;201608;22115;53759;13598;39295;2736;8440;3043;8660;5779;17100
350290;201608;1981;6290;1546;5358;324;1222;460;1505;784;2727
350300;201608;484;1372;378;1157;87;267;190;569;277;836
350310;201608;831;2741;722;2503;95;396;299;1001;394;1397
350315;201608;521;1630;399;1356;57;237;91;265;148;502
350320;201608;10363;32220;9163;29978;2527;8758;1293;4345;3820;13103
350330;201608;14290;39498;9572;28825;1934;5655;3066;8737;5000;14392
350335;201608;363;1138;318;1042;26;75;225;751;251;826
350340;201608;1128;3321;782;2628;137;515;238;785;375;1300
350350;201608;720;2227;614;2050;110;413;207;662;317;1075
350360;201608;819;2780;703;2524;167;601;272;1010;439;1611
350370;201608;617;1817;452;1456;87;306;82;253;169;559
350380;201608;4256;12143;2892;9748;739;2737;692;2085;1431;4822
350390;201608;9131;27900;7983;25712;2288;7668;2836;8894;5124;16562
350395;201608;371;1019;188;637;24;88;44;135;68;223
350400;201608;7812;22260;6297;19571;1396;4817;2400;7165;3796;11982
350410;201608;8330;27433;6491;23628;1684;6695;1078;3732;2762;10427
350420;201608;545;1664;393;1390;76;324;28;92;104;416
350430;201608;722;2209;596;1983;104;399;308;985;412;1384
350440;201608;1265;3927;1099;3557;249;783;483;1570;732;2353
350450;201608;7632;23266;6049;20009;1339;4771;1375;4313;2714;9084
350460;201608;1469;4042;924;2956;157;565;294;872;451;1437
350470;201608;244;661;200;586;29;112;121;328;150;440
350480;201608;814;2448;570;1917;79;301;89;266;168;567
350490;201608;1836;5472;1547;4984;356;1244;537;1579;893;2823
350500;201608;563;1668;490;1546;83;307;257;788;340;1095
350510;201608;1113;3327;846;2760;139;515;316;963;455;1478
350520;201608;1408;5181;1117;4426;225;960;220;852;445;1812
350530;201608;2427;7063;1978;6142;581;1832;596;1755;1177;3587
350535;201608;1243;3985;1158;3837;163;669;743;2335;906;3004
350540;201608;1766;4963;1373;4258;365;1187;450;1421;815;2608
350550;201608;11050;29284;7610;23622;1491;5238;2527;7383;4018;12621
350560;201608;3353;10926;2960;10044;395;1378;1597;5458;1992;6836
350570;201608;18131;59394;16095;55256;4756;17562;5520;17999;10276;35561
350580;201608;1652;5185;1164;4060;225;847;121;358;346;1205
350590;201608;4087;12567;3168;10710;795;2977;1095;3360;1890;6337
350600;201608;41844;102737;27388;77621;4497;13650;11305;30104;15802;43754
350610;201608;7123;20773;5658;18183;1187;4143;2326;7286;3513;11429
350620;201608;404;1142;299;976;50;193;123;363;173;556
350630;201608;1622;4676;1184;3845;199;777;428;1238;627;2015
350635;201608;6467;18950;5046;16449;1136;4059;1950;6160;3086;10219
350640;201608;761;2338;527;1768;85;296;94;312;179;608
350650;201608;7802;23408;4886;16540;1056;3956;746;2280;1802;6236
350660;201608;4774;13834;3900;12314;763;2598;1872;5798;2635;8396
350670;201608;1609;4953;1466;4684;298;979;782;2456;1080;3435
350680;201608;1074;3214;823;2720;177;640;321;1050;498;1690
350690;201608;885;2874;700;2488;142;541;206;692;348;1233
350700;201608;4288;12603;2923;10112;743;2775;800;2492;1543;5267
350710;201608;2682;8254;2323;7554;341;1232;1341;4260;1682;5492
350715;201608;790;2372;686;2167;168;560;285;839;453;1399
350720;201608;124;350;109;326;32;98;30;88;62;186
350730;201608;398;1465;379;1420;82;349;148;539;230;888
350740;201608;1828;5578;1314;4380;220;813;352;1046;572;1859
350745;201608;489;1532;300;1030;40;143;129;407;169;550
350750;201608;10008;30091;8000;26160;1746;6233;1827;5526;3573;11759
350760;201608;13115;37921;10408;33054;2545;8855;2844;8155;5389;17010
350770;201608;710;1991;493;1579;60;212;252;787;312;999
350775;201608;588;1572;493;1430;65;239;256;722;321;961
350780;201608;1895;5760;1466;4894;413;1508;210;721;623;2229
350790;201608;1924;5890;1408;4860;310;1123;241;731;551;1854
350800;201608;2896;9588;2697;9234;425;1692;1567;5187;1992;6879
350810;201608;2032;5693;1694;5214;450;1463;726;2276;1176;3739
350820;201608;567;1525;417;1244;65;231;181;501;246;732
350830;201608;861;2637;567;1976;76;275;130;405;206;680
350840;201608;2402;8468;1985;7511;612;2407;392;1412;1004;3819
350850;201608;5870;19426;4954;17430;1526;5649;1020;3521;2546;9170
350860;201608;3224;9874;3064;9639;213;857;2352;7313;2565;8170
350870;201608;2729;8566;2231;7716;472;1864;1237;4285;1709;6149
350880;201608;1271;4187;1056;3720;234;881;242;829;476;1710
350890;201608;647;1829;414;1319;41;146;104;268;145;414
350900;201608;3994;12804;2966;10438;821;3137;259;869;1080;4006
350910;201608;847;2476;738;2255;222;739;294;837;516;1576
350920;201608;10462;29595;9284;27542;957;3144;6415;18309;7372;21453
350925;201608;4546;14110;3684;12365;886;3143;1173;3466;2059;6609
350930;201608;1579;4309;1217;3631;140;451;719;2057;859;2508
350940;201608;1808;5855;1646;5600;294;1154;929;3069;1223;4223
350945;201608;954;2950;796;2646;121;495;404;1261;525;1756
350950;201608;73586;219153;58934;188211;12264;42786;24499;73849;36763;116635
350960;201608;4710;15479;4020;14043;730;2897;2094;6956;2824;9853
350970;201608;4281;14604;3584;12931;1108;4322;614;1916;1722;6238
350980;201608;589;1916;527;1814;216;802;154;528;370;1330
350990;201608;1780;5898;1438;5268;388;1542;373;1309;761;2851
350995;201608;761;2570;723;2498;91;414;468;1522;559;1936
351000;201608;3018;8943;2484;7945;386;1353;1035;3103;1421;4456
351010;201608;363;1020;211;683;45;157;67;220;112;377
351015;201608;818;2758;684;2505;144;581;316;1119;460;1700
351020;201608;8221;25222;7036;23333;1711;5933;3128;10486;4839;16419
351030;201608;1814;6323;1558;5690;345;1421;463;1567;808;2988
351040;201608;3473;10301;3140;9724;416;1467;2116;6326;2532;7793
351050;201608;14946;41814;10490;34014;2534;8930;2797;8948;5331;17878
351060;201608;36430;105123;29487;92614;5787;19966;13828;42102;19615;62068
351070;201608;1436;3984;929;3047;231;818;90;250;321;1068
351080;201608;2637;7579;2030;6792;488;1787;862;2731;1350;4518
351090;201608;356;1213;286;1065;64;271;47;173;111;444
351100;201608;2140;6478;1715;5580;442;1510;473;1564;915;3074
351110;201608;7277;18381;4110;13135;870;3129;892;2693;1762;5822
351120;201608;650;1872;510;1592;67;246;231;609;298;855
351130;201608;989;2755;518;1764;88;315;88;272;176;587
351140;201608;1679;5625;1385;5022;424;1664;285;954;709;2618
351150;201608;1530;5279;1097;4169;189;757;133;429;322;1186
351160;201608;1271;4406;1116;4038;271;1048;329;1098;600;2146
351170;201608;1415;4457;1183;3954;192;695;524;1653;716;2348
351190;201608;798;2536;618;2076;96;333;176;554;272;887
351200;201608;2016;5890;1681;5265;248;875;620;1791;868;2666
351210;201608;1132;3270;821;2630;146;504;285;833;431;1337
351220;201608;3226;10730;2923;10106;486;1844;1416;4795;1902;6639
351230;201608;1742;5352;1449;4792;277;1065;694;2191;971;3256
351240;201608;1060;3237;779;2628;207;710;220;690;427;1400
351250;201608;996;2870;620;2012;93;303;204;631;297;934
351260;201608;921;2688;790;2418;218;657;253;755;471;1412
351270;201608;330;1110;284;1016;60;244;106;326;166;570
351280;201608;5179;14750;3839;12061;710;2456;1333;3948;2043;6404
351290;201608;972;2749;706;2241;161;539;269;823;430;1362
351300;201608;12919;41517;9699;34628;2214;8705;2824;9823;5038;18528
351310;201608;3117;9381;2491;8244;453;1688;1107;3396;1560;5084
351320;201608;823;2717;688;2383;132;515;229;730;361;1245
351330;201608;272;752;220;669;76;228;42;122;118;350
351340;201608;5531;18299;4660;16576;1309;4929;1580;5577;2889;10506
351350;201608;7671;24417;6599;22209;1786;6254;2188;6995;3974;13249
351360;201608;4072;12564;3693;11841;863;3076;1180;3445;2043;6521
351370;201608;2287;7014;1795;5967;359;1334;687;2084;1046;3418
351380;201608;38225;110610;34000;102816;6615;21541;14453;42536;21068;64077
351385;201608;253;751;196;634;30;105;77;230;107;335
351390;201608;1191;3788;984;3357;235;955;383;1161;618;2116
351400;201608;925;3026;871;2902;273;991;359;1162;632;2153
351410;201608;2488;7441;2156;6844;343;1120;1230;3821;1573;4941
351420;201608;319;905;217;708;42;140;50;162;92;302
351430;201608;834;2605;780;2516;130;454;537;1719;667;2173
351440;201608;3432;10165;2568;8292;538;1791;333;992;871;2783
351450;201608;1651;4632;1324;4095;317;1028;462;1493;779;2521
351460;201608;726;2143;616;1947;316;1000;136;431;452;1431
351470;201608;1015;3014;889;2767;169;602;413;1223;582;1825
351480;201608;2735;8751;2505;8371;376;1598;1410;4480;1786;6078
351490;201608;1808;5895;1592;5423;164;676;920;2974;1084;3650
351492;201608;226;701;180;588;9;36;110;357;119;393
351495;201608;194;622;151;511;31;129;62;194;93;323
351500;201608;27334;76628;20600;64198;5030;17051;7643;22597;12673;39648
351510;201608;8964;27171;7263;23723;1730;6043;3235;10362;4965;16405
351512;201608;480;1378;356;1105;56;170;160;491;216;661
351515;201608;2267;7031;1621;5587;369;1394;389;1194;758;2588
351518;201608;2104;6440;1442;5201;340;1388;444;1453;784;2841
351519;201608;792;2319;572;1836;88;328;153;374;241;702
351520;201608;793;2121;396;1359;58;234;61;194;119;428
351530;201608;395;1209;262;865;29;86;60;162;89;248
351535;201608;2375;6080;1822;5252;136;479;1189;3275;1325;3754
351540;201608;1729;5170;1375;4478;436;1564;193;610;629;2174
351550;201608;5302;15376;3719;11952;663;2366;1356;4179;2019;6545
351560;201608;373;1182;328;1098;69;274;44;138;113;412
351565;201608;169;565;153;523;27;93;59;197;86;290
351570;201608;12499;37429;10355;33072;2140;7404;5396;16615;7536;24019
351580;201608;325;857;188;567;45;125;35;115;80;240
351590;201608;439;1125;279;818;24;76;129;356;153;432
351600;201608;1766;4872;1456;4319;183;618;825;2330;1008;2948
351610;201608;659;1792;495;1512;56;196;226;617;282;813
351620;201608;18776;59336;14543;50755;2861;11142;3694;11481;6555;22623
351630;201608;20367;62827;18254;59417;4077;14007;9948;31961;14025;45968
351640;201608;12752;37722;10405;33488;1743;6129;5880;18527;7623;24656
351650;201608;457;1358;228;764;39;151;36;98;75;249
351660;201608;793;2508;571;1934;114;401;100;307;214;708
351670;201608;3986;12460;3228;10691;563;2082;1404;4346;1967;6428
351680;201608;615;1888;365;1269;71;243;61;200;132;443
351685;201608;392;1212;340;1116;92;275;150;515;242;790
351690;201608;1120;3280;800;2594;125;427;302;900;427;1327
351700;201608;1131;3313;958;2973;236;704;337;1045;573;1749
351710;201608;559;1827;471;1631;74;252;171;569;245;821
351720;201608;1584;4789;1085;3595;190;678;309;969;499;1647
351730;201608;1082;3063;880;2759;200;708;352;1091;552;1799
351740;201608;3948;10737;3113;9080;605;1844;1168;3267;1773;5111
351750;201608;1131;3588;743;2679;163;610;176;633;339;1243
351760;201608;3501;10794;2786;9236;713;2576;828;2513;1541;5089
351770;201608;2200;6872;1853;6220;513;1811;736;2381;1249;4192
351780;201608;1538;4287;878;2800;136;470;184;555;320;1025
351790;201608;1098;3107;934;2844;226;658;446;1397;672;2055
351800;201608;456;1010;255;679;35;98;91;234;126;332
351810;201608;1035;2945;882;2691;108;322;601;1814;709;2136
351820;201608;2467;7725;1811;6325;412;1489;162;553;574;2042
351830;201608;4009;12347;3041;10232;515;1949;1421;4567;1936;6516
351840;201608;6995;23079;6023;21136;1465;5551;2059;7018;3524;12569
351850;201608;2004;5346;1389;4296;178;687;663;1851;841;2538
351860;201608;3381;10668;2909;9692;704;2516;1179;3795;1883;6311
351870;201608;28228;83643;23532;75171;6789;22722;9016;28620;15805;51342
351880;201608;114114;352998;96019;316164;26856;94127;23850;74097;50706;168224
351885;201608;636;2177;576;2053;153;546;229;805;382;1351
351890;201608;637;1956;497;1677;113;409;81;252;194;661
351900;201608;1222;3723;1018;3382;259;911;303;990;562;1901
351905;201608;482;1507;389;1327;48;176;201;644;249;820
351907;201608;18511;53973;15230;47791;1532;5809;9591;29048;11123;34857
351910;201608;1032;3211;844;2782;179;632;320;1010;499;1642
351920;201608;988;2689;851;2493;103;350;495;1412;598;1762
351925;201608;914;2811;761;2506;123;456;336;1007;459;1463
351930;201608;2656;8482;2520;8229;494;1912;1673;5164;2167;7076
351940;201608;994;2990;824;2651;154;544;368;1160;522;1704
351950;201608;1474;4021;1037;3206;140;462;477;1463;617;1925
351960;201608;4410;12583;3227;10383;692;2468;1293;4083;1985;6551
351970;201608;5380;19120;4769;17896;1274;5161;1667;6022;2941;11183
351980;201608;901;2659;655;2115;129;465;209;581;338;1046
351990;201608;1525;4239;1195;3624;222;827;243;607;465;1434
352000;201608;2301;7338;2062;6850;417;1500;983;3055;1400;4555
352010;201608;1672;5587;1450;5087;339;1264;257;902;596;2166
352020;201608;1403;4301;1196;3925;290;1018;445;1400;735;2418
352030;201608;4869;14089;3999;12799;878;2988;1995;6394;2873;9382
352040;201608;1969;6360;1561;5477;313;1202;259;843;572;2045
352042;201608;3441;9470;2118;6593;409;1356;898;2725;1307;4081
352044;201608;1710;5208;1081;3856;179;686;198;644;377;1330
352050;201608;10482;31634;7150;24221;1556;5869;1272;3834;2828;9703
352060;201608;741;2216;590;1901;116;433;219;628;335;1061
352070;201608;807;2047;643;1776;137;413;212;575;349;988
352080;201608;431;1233;306;994;54;184;107;322;161;506
352090;201608;1196;4113;991;3575;160;613;223;746;383;1359
352100;201608;2811;8513;2182;7350;548;1986;813;2585;1361;4571
352110;201608;501;1730;422;1575;106;413;151;529;257;942
352115;201608;472;1502;409;1389;58;191;218;744;276;935
352120;201608;906;2816;738;2498;115;457;363;1137;478;1594
352130;201608;1775;5076;1173;3836;280;948;234;720;514;1668
352140;201608;1752;5015;1043;3501;157;556;357;1154;514;1710
352150;201608;778;2329;610;2011;159;553;267;869;426;1422
352160;201608;1003;2741;765;2309;158;511;237;630;395;1141
352170;201608;2718;8121;2419;7492;430;1419;1238;3600;1668;5019
352180;201608;3269;9302;2726;8230;644;2072;933;2663;1577;4735
352190;201608;1176;3495;943;3008;136;529;324;850;460;1379
352200;201608;364;1249;278;1057;49;207;103;372;152;579
352210;201608;16467;44204;13388;39708;2268;7144;7809;23364;10077;30508
352215;201608;545;1677;495;1599;64;241;293;915;357;1156
352220;201608;12477;39451;10243;34884;3284;11964;2358;7951;5642;19915
352230;201608;12351;41087;10592;37737;2882;11223;3500;11913;6382;23136
352240;201608;12255;35104;9507;30324;2627;9455;2774;7841;5401;17296
352250;201608;22421;71281;19398;65092;5711;20302;5815;19350;11526;39652
352260;201608;5255;14858;3417;11042;648;2318;1149;3378;1797;5696
352265;201608;868;2728;738;2502;53;242;481;1569;534;1811
352270;201608;1734;5902;1444;5261;354;1356;347;1248;701;2604
352280;201608;2209;6566;1812;5871;411;1489;675;2064;1086;3553
352290;201608;1139;3564;955;3153;192;748;355;1048;547;1796
352300;201608;962;2796;744;2367;160;574;305;880;465;1454
352310;201608;42801;125432;34302;110560;9036;30324;15564;50226;24600;80550
352320;201608;5501;16796;4689;15207;1229;4226;1413;4137;2642;8363
352330;201608;1964;6172;1648;5717;518;1937;439;1477;957;3414
352340;201608;5302;16674;4006;14138;1038;3973;737;2369;1775;6342
352350;201608;1665;5593;1480;5195;261;1041;527;1736;788;2777
352360;201608;1071;3261;934;3004;182;702;588;1769;770;2471
352370;201608;854;2902;767;2702;110;440;399;1358;509;1798
352380;201608;984;3094;838;2820;237;908;184;579;421;1487
352390;201608;18809;49739;12399;37742;2090;7222;5698;16121;7788;23343
352400;201608;3795;10762;2497;8232;688;2358;567;1733;1255;4091
352410;201608;2886;8679;2442;7950;546;1877;970;3056;1516;4933
352420;201608;889;2465;745;2187;161;507;296;840;457;1347
352430;201608;6352;18776;5270;17035;1717;6045;1561;4945;3278;10990
352440;201608;15386;46399;12386;40506;2811;9811;4436;14128;7247;23939
352450;201608;681;2085;455;1587;100;393;112;346;212;739
352460;201608;2302;7407;1903;6597;500;1905;507;1582;1007;3487
352470;201608;3951;10869;2673;8465;387;1364;1033;3015;1420;4379
352480;201608;4364;11780;3291;9795;670;2270;1156;3057;1826;5327
352490;201608;681;2358;541;1997;90;358;127;453;217;811
352500;201608;8724;24876;7462;22943;3674;11945;1570;4120;5244;16065
352510;201608;2923;9139;2311;7986;661;2467;545;1839;1206;4306
352520;201608;1984;6945;1741;6350;451;1763;655;2343;1106;4106
352530;201608;8397;26469;6254;21551;1510;5605;804;2289;2314;7894
352540;201608;486;1518;345;1174;52;184;93;305;145;489
352550;201608;865;2843;612;2248;138;562;113;370;251;932
352560;201608;636;1870;453;1465;71;223;103;290;174;513
352570;201608;1810;5894;1349;4843;302;1224;190;564;492;1788
352580;201608;862;2524;728;2292;148;501;342;1052;490;1553
352585;201608;236;748;196;668;45;171;61;202;106;373
352590;201608;12410;37746;9954;32929;3119;10969;3479;10680;6598;21649
352600;201608;1674;5070;1429;4598;333;1159;571;1742;904;2901
352610;201608;3301;10064;2692;9012;727;2714;751;2379;1478;5093
352620;201608;5234;15812;4691;14971;1061;3564;2297;7180;3358;10744
352630;201608;635;1970;595;1875;122;446;244;709;366;1155
352640;201608;2695;8172;2226;7236;235;864;1273;4044;1508;4908
352650;201608;814;2412;601;1951;109;365;168;521;277;886
352660;201608;1044;3532;830;3053;159;650;203;737;362;1387
352670;201608;11115;32849;6685;23014;1433;5407;525;1703;1958;7110
352680;201608;2844;9440;2180;7929;495;2005;683;2248;1178;4253
352690;201608;31056;85026;22094;67189;3211;10766;10811;31383;14022;42149
352700;201608;606;1805;506;1648;146;533;202;617;348;1150
352710;201608;5340;15371;3948;12539;957;3333;1267;3762;2224;7095
352720;201608;7617;24386;6757;22474;2073;6986;1867;6115;3940;13101
352725;201608;409;1143;234;769;28;114;95;289;123;403
352730;201608;2230;7382;2011;6813;405;1473;720;2159;1125;3632
352740;201608;2147;5763;1694;5044;227;803;942;2663;1169;3466
352750;201608;496;1421;254;873;30;113;50;151;80;264
352760;201608;1208;4068;971;3460;291;1068;233;769;524;1837
352770;201608;780;2419;659;2162;140;508;251;780;391;1288
352780;201608;617;2058;487;1755;92;353;145;507;237;860
352790;201608;633;1819;455;1492;81;277;119;390;200;667
352800;201608;1033;3631;746;2853;153;630;201;696;354;1326
352810;201608;1173;3047;765;2251;138;431;222;611;360;1042
352820;201608;643;1742;459;1443;91;315;99;305;190;620
352830;201608;533;1525;317;1021;49;181;42;103;91;284
352840;201608;3780;12652;3356;11749;945;3454;1209;4127;2154;7581
352850;201608;9453;27335;7180;23587;1843;6446;2399;7710;4242;14156
352860;201608;807;2685;741;2546;158;592;266;868;424;1460
352870;201608;946;2374;640;1749;69;247;342;818;411;1065
352880;201608;2325;6419;1687;5179;289;916;575;1636;864;2552
352885;201608;234;775;218;741;20;72;150;503;170;575
352890;201608;671;1757;465;1341;62;219;198;500;260;719
352900;201608;19925;57538;14433;46509;2826;9902;4930;15100;7756;25002
352910;201608;367;1056;207;691;17;60;42;129;59;189
352920;201608;2453;7321;1863;6087;358;1299;752;2271;1110;3570
352930;201608;5700;17550;4457;14837;975;3471;1213;3830;2188;7301
352940;201608;20935;66945;17316;58691;5308;19445;1650;4857;6958;24302
352950;201608;337;989;212;755;49;205;37;109;86;314
352960;201608;621;1859;377;1297;50;187;80;255;130;442
352965;201608;373;1043;231;720;47;148;32;84;79;232
352970;201608;3204;7984;2569;7049;274;784;1728;4759;2002;5543
352980;201608;1063;3338;898;3056;193;653;491;1758;684;2411
352990;201608;4041;12527;3543;11669;907;3343;1413;4383;2320;7726
353000;201608;441;1245;239;779;24;80;38;114;62;194
353010;201608;2967;8174;2154;6601;480;1663;588;1571;1068;3234
353020;201608;4111;11180;2505;7702;386;1279;825;2255;1211;3534
353030;201608;3769;11083;3037;9706;823;2799;528;1614;1351;4413
353040;201608;550;1508;461;1364;115;378;141;383;256;761
353050;201608;4777;15797;3953;14032;1074;4005;1308;4486;2382;8491
353060;201608;39378;114885;34305;106578;3658;13555;23638;70639;27296;84194
353070;201608;10470;32099;7466;25687;1718;6304;1746;5993;3464;12297
353080;201608;5162;16115;3574;12653;763;2973;800;2624;1563;5597
353090;201608;536;1776;480;1655;44;185;282;904;326;1089
353100;201608;285;799;136;455;18;59;23;65;41;124
353110;201608;7522;22840;6457;21115;1349;4794;3619;11839;4968;16633
353120;201608;675;2006;435;1452;84;313;106;299;190;612
353130;201608;2488;7136;1993;6372;617;2126;600;1854;1217;3980
353140;201608;2344;6366;1816;5357;390;1234;793;2220;1183;3454
353150;201608;1624;4854;1298;4280;346;1167;339;1121;685;2288
353160;201608;650;1806;409;1311;81;262;65;170;146;432
353170;201608;415;1334;375;1272;106;451;167;508;273;959
353180;201608;8414;23591;6708;20631;1107;3668;3625;10914;4732;14582
353190;201608;3694;11035;3006;9552;498;1742;1507;4487;2005;6229
353200;201608;1016;3370;783;2768;216;845;177;576;393;1421
353205;201608;365;1184;320;1097;77;269;128;443;205;712
353210;201608;996;2500;699;1969;37;129;458;1249;495;1378
353215;201608;384;1189;328;1069;46;162;104;306;150;468
353220;201608;655;2010;530;1747;131;445;110;340;241;785
353230;201608;781;2510;711;2384;173;643;191;586;364;1229
353240;201608;2029;6439;1772;5927;345;1298;902;2903;1247;4201
353250;201608;1073;2870;809;2393;106;350;387;1079;493;1429
353260;201608;882;2418;632;1955;100;351;216;627;316;978
353270;201608;654;1891;559;1710;108;345;213;630;321;975
353280;201608;585;1888;475;1638;113;421;93;307;206;728
353282;201608;1768;5555;1607;5226;243;857;882;2740;1125;3597
353284;201608;354;950;203;630;32;102;50;152;82;254
353286;201608;144;439;103;352;19;60;18;62;37;122
353290;201608;723;2207;583;1952;83;349;322;1005;405;1354
353300;201608;1421;4379;1187;3883;264;975;413;1215;677;2190
353310;201608;189;581;161;532;47;159;55;177;102;336
353320;201608;552;1574;467;1426;81;262;234;688;315;950
353325;201608;596;1929;480;1676;70;256;123;412;193;668
353330;201608;606;1735;413;1289;69;245;188;548;257;793
353340;201608;2737;7882;1857;6223;557;1952;439;1476;996;3428
353350;201608;3202;9546;2527;8193;721;2493;687;2072;1408;4565
353360;201608;444;1443;399;1348;41;162;265;878;306;1040
353370;201608;627;2039;539;1830;61;242;284;912;345;1154
353380;201608;321;1058;262;932;43;182;83;273;126;455
353390;201608;5640;15338;3941;12298;762;2530;1340;3993;2102;6523
353400;201608;479;1453;411;1321;92;315;85;229;177;544
353410;201608;621;1801;516;1617;102;359;267;819;369;1178
353420;201608;584;1639;385;1181;102;310;92;258;194;568
353430;201608;2237;7459;1610;5900;381;1465;229;789;610;2254
353440;201608;58185;182186;46771;156646;12249;42751;15455;50085;27704;92836
353450;201608;421;1224;344;1062;66;225;123;358;189;583
353460;201608;3278;9237;2617;7991;325;1120;1268;3935;1593;5055
353470;201608;8079;24094;5889;19694;1251;4622;1278;3933;2529;8555
353475;201608;1550;4374;1118;3414;190;631;339;926;529;1557
353480;201608;1411;4251;1258;3949;189;628;763;2337;952;2965
353490;201608;963;2785;748;2350;152;490;253;755;405;1245
353500;201608;1006;2672;826;2382;238;700;386;1081;624;1781
353510;201608;990;3137;729;2475;153;545;131;397;284;942
353520;201608;1130;3210;864;2753;132;480;358;1076;490;1556
353530;201608;2550;7439;2191;6778;330;1169;1157;3425;1487;4594
353540;201608;1936;5871;1653;5373;434;1486;652;2063;1086;3549
353550;201608;6222;17091;5071;15194;502;1778;3146;8965;3648;10743
353560;201608;2019;6651;1663;5985;448;1773;388;1265;836;3038
353570;201608;453;1379;355;1149;80;268;158;469;238;737
353580;201608;2360;6951;2062;6441;322;1130;1295;3995;1617;5125
353590;201608;722;2091;524;1678;129;447;157;502;286;949
353600;201608;1750;4808;1536;4430;227;710;760;2131;987;2841
353610;201608;552;1856;417;1564;74;321;76;248;150;569
353620;201608;2179;6949;1808;6194;429;1562;497;1569;926;3131
353625;201608;376;1048;233;766;44;154;76;257;120;411
353630;201608;1487;5156;1186;4384;199;809;142;442;341;1251
353640;201608;1305;3867;1004;3201;109;372;493;1541;602;1913
353650;201608;7908;23154;5849;18767;1065;3603;2098;6425;3163;10028
353657;201608;303;955;259;865;39;150;93;292;132;442
353660;201608;1064;2763;790;2288;292;917;101;196;393;1113
353670;201608;3537;11319;3008;10209;912;3449;964;2978;1876;6427
353680;201608;714;2272;592;2056;183;729;200;649;383;1378
353690;201608;511;1362;280;911;51;178;50;120;101;298
353700;201608;1973;5982;1694;5432;244;855;820;2494;1064;3349
353710;201608;3055;7386;1519;4890;331;1052;250;787;581;1839
353715;201608;500;1444;354;1134;31;111;90;274;121;385
353720;201608;2011;6129;1691;5637;328;1316;823;2540;1151;3856
353730;201608;4376;13119;3448;11203;664;2356;1111;3301;1775;5657
353740;201608;1803;5357;1375;4511;357;1228;324;1021;681;2249
353750;201608;851;2834;650;2364;127;511;133;481;260;992
353760;201608;9995;27094;8091;24426;1163;4023;4997;14678;6160;18701
353770;201608;731;2282;446;1570;53;203;25;48;78;251
353780;201608;4122;14184;3584;13074;1088;4161;985;3576;2073;7737
353790;201608;2150;7301;1775;6525;463;1949;376;1334;839;3283
353800;201608;16094;48797;12769;42780;3215;11732;4414;14368;7629;26100
353810;201608;995;3160;759;2643;138;544;234;794;372;1338
353820;201608;1375;4546;1224;4185;225;909;617;1950;842;2859
353830;201608;672;1798;527;1565;88;281;273;787;361;1068
353850;201608;1687;5234;1466;4793;350;1191;540;1741;890;2932
353860;201608;2486;8194;2095;7298;547;2028;510;1707;1057;3735
353870;201608;28985;82864;19898;64836;3621;12929;6182;18250;9803;31179
353880;201608;2663;8337;2238;7570;299;1176;1185;3973;1484;5149
353890;201608;2640;6443;1832;5126;290;889;866;2296;1156;3185
353900;201608;975;2986;716;2473;142;543;186;600;328;1143
353910;201608;1202;4153;1113;3978;292;1085;562;2035;854;3120
353920;201608;2210;6476;1530;5034;320;1174;259;736;579;1910
353930;201608;4487;13431;3150;10964;775;2922;542;1857;1317;4779
353940;201608;1189;3769;923;3152;154;573;279;882;433;1455
353950;201608;3242;10243;2851;9462;530;1911;1432;4519;1962;6430
353960;201608;608;1904;445;1540;92;330;90;287;182;617
353970;201608;542;1550;453;1412;50;166;267;832;317;998
353980;201608;13048;38719;11059;34881;2377;7911;5151;15681;7528;23592
353990;201608;344;1073;308;997;41;159;158;482;199;641
354000;201608;2215;6161;1430;4575;255;882;139;425;394;1307
354010;201608;371;1112;300;982;62;202;166;556;228;758
354020;201608;4217;13219;3624;11911;907;3166;1042;3148;1949;6314
354025;201608;875;2446;642;2018;120;396;220;685;340;1081
354030;201608;473;1305;322;1027;50;178;129;385;179;563
354040;201608;779;2120;526;1626;54;172;275;800;329;972
354050;201608;938;2955;751;2567;187;690;148;487;335;1177
354060;201608;4861;14995;3386;11652;854;3083;770;2505;1624;5588
354070;201608;2790;9246;2331;8162;555;2087;417;1386;972;3473
354075;201608;1915;7012;1749;6617;447;1842;720;2651;1167;4493
354080;201608;1536;4679;1082;3671;200;690;256;804;456;1494
354085;201608;330;825;295;774;12;46;247;637;259;683
354090;201608;1346;3964;1278;3844;147;500;851;2556;998;3056
354100;201608;14550;48109;11904;43118;2986;11572;4648;16523;7634;28095
354105;201608;882;2594;765;2417;112;389;504;1569;616;1958
354110;201608;730;1978;564;1747;189;650;98;248;287;898
354120;201608;1885;5172;1411;4268;240;796;585;1659;825;2455
354130;201608;6218;17789;4640;14737;1643;5489;416;1119;2059;6608
354140;201608;26105;65359;16050;47262;3310;10326;4423;12017;7733;22343
354150;201608;3860;10345;2912;8615;475;1532;1324;3772;1799;5304
354160;201608;3371;10897;2732;9422;683;2498;927;3077;1610;5575
354165;201608;480;1622;405;1466;105;410;141;514;246;924
354170;201608;1368;4263;1099;3652;200;749;423;1277;623;2026
354180;201608;476;1429;411;1290;50;180;199;545;249;725
354190;201608;1571;4941;1302;4390;311;1156;406;1292;717;2448
354200;201608;1000;2797;784;2404;100;327;337;956;437;1283
354210;201608;614;1928;507;1722;70;292;256;789;326;1081
354220;201608;2914;8458;2456;7625;497;1641;1099;3342;1596;4983
354230;201608;618;2011;551;1868;93;352;231;759;324;1111
354240;201608;1216;3965;910;3250;162;627;189;655;351;1282
354250;201608;669;1898;440;1489;139;505;107;384;246;889
354260;201608;6917;20876;5772;18881;1577;5425;1764;5852;3341;11277
354270;201608;1134;3775;931;3303;183;697;299;1037;482;1734
354280;201608;688;2041;624;1931;91;363;411;1176;502;1539
354290;201608;908;3151;803;2913;180;701;318;1165;498;1866
354300;201608;3613;11758;3399;11335;986;3389;1539;5019;2525;8408
354310;201608;844;2574;672;2230;129;442;328;1083;457;1525
354320;201608;702;2100;581;1868;138;512;182;528;320;1040
354323;201608;455;1245;329;1000;67;222;110;291;177;513
354325;201608;1217;3991;930;3295;187;710;314;1031;501;1741
354330;201608;6574;19497;5234;16857;1066;3838;2299;6851;3365;10689
354340;201608;24248;73397;19504;65067;5405;19391;6865;22248;12270;41639
354350;201608;1029;3034;943;2872;240;827;468;1307;708;2134
354360;201608;445;1406;262;954;32;113;11;41;43;154
354370;201608;1132;3770;960;3419;104;462;539;1836;643;2298
354380;201608;838;2489;663;2171;184;708;109;286;293;994
354390;201608;13155;38087;8941;29807;1721;6177;1621;5210;3342;11387
354400;201608;1564;5380;1267;4650;257;995;356;1293;613;2288
354410;201608;5353;16313;4405;14487;1053;3724;1712;5500;2765;9224
354420;201608;1174;3499;866;2808;213;747;300;933;513;1680
354425;201608;2363;6690;1986;5989;595;1883;450;1358;1045;3241
354430;201608;1337;4292;1199;4012;246;919;481;1560;727;2479
354440;201608;529;1594;378;1249;40;128;146;467;186;595
354450;201608;406;1153;242;798;36;136;42;117;78;253
354460;201608;919;2540;649;2038;150;519;238;738;388;1257
354470;201608;564;1522;439;1269;42;158;218;561;260;719
354480;201608;750;2065;612;1837;76;251;352;1016;428;1267
354490;201608;723;2406;573;2049;63;251;270;939;333;1190
354500;201608;2140;6864;1879;6413;623;2361;356;1215;979;3576
354510;201608;789;2172;711;2040;104;251;451;1341;555;1592
354515;201608;268;893;209;757;39;156;70;237;109;393
354520;201608;7689;24755;4366;15117;839;3266;1654;5289;2493;8555
354530;201608;3042;10360;2687;9564;691;2680;1052;3659;1743;6339
354540;201608;1199;3601;981;3213;322;1132;162;494;484;1626
354550;201608;463;1375;378;1203;74;253;166;494;240;747
354560;201608;1645;4592;985;3086;155;485;414;1222;569;1707
354570;201608;1009;2816;512;1634;70;254;70;201;140;455
354580;201608;10705;29859;7530;23977;1305;4517;2745;8200;4050;12717
354600;201608;1585;5132;1368;4704;256;1060;667;2167;923;3227
354610;201608;395;1132;234;749;25;79;71;208;96;287
354620;201608;386;1226;302;1079;61;274;144;496;205;770
354625;201608;288;898;191;673;27;98;47;145;74;243
354630;201608;2089;6904;1834;6360;716;2660;237;751;953;3411
354640;201608;3382;11010;2612;9250;510;2052;471;1468;981;3520
354650;201608;873;2553;752;2314;89;310;482;1472;571;1782
354660;201608;2382;6663;1755;5562;205;746;994;3078;1199;3824
354670;201608;1270;3990;977;3278;242;892;204;600;446;1492
354680;201608;4378;14202;3962;13392;1024;3668;1673;5562;2697;9230
354690;201608;754;2402;501;1779;82;308;123;418;205;726
354700;201608;1149;3222;799;2473;145;525;314;833;459;1358
354710;201608;518;1547;405;1297;43;162;174;492;217;654
354720;201608;245;655;141;445;36;109;21;59;57;168
354730;201608;8438;26557;6301;22279;1307;5066;2586;8776;3893;13842
354740;201608;247;759;142;505;18;77;17;59;35;136
354750;201608;2256;6990;1791;6048;444;1675;605;1917;1049;3592
354760;201608;1910;6004;1544;5229;444;1585;190;632;634;2217
354765;201608;294;821;143;477;15;55;14;36;29;91
354770;201608;2328;6443;1753;5452;605;1965;463;1394;1068;3359
354780;201608;51819;143658;43351;126206;6722;21803;23410;64076;30132;85879
354790;201608;797;2605;711;2423;114;409;366;1202;480;1611
354800;201608;2125;6159;1853;5793;428;1500;894;2689;1322;4189
354805;201608;1004;3003;727;2395;69;243;168;481;237;724
354810;201608;569;1818;350;1286;57;262;54;156;111;418
354820;201608;950;3223;801;2890;158;654;183;586;341;1240
354830;201608;408;1129;317;966;87;278;123;347;210;625
354840;201608;656;1874;511;1596;107;335;226;697;333;1032
354850;201608;16604;50326;12196;41451;2469;9336;4888;15226;7357;24562
354860;201608;1358;4236;1153;3880;224;857;426;1339;650;2196
354870;201608;45435;132570;39897;121248;8601;28077;17562;51872;26163;79949
354880;201608;4272;11728;2381;7688;346;1309;709;1898;1055;3207
354890;201608;16209;46637;13422;41643;2872;9604;5363;16009;8235;25613
354900;201608;439;1345;332;1110;65;239;69;211;134;450
354910;201608;6303;18768;3689;13099;604;2387;165;547;769;2934
354920;201608;406;1182;266;910;45;175;64;204;109;379
354925;201608;313;933;190;653;26;103;26;81;52;184
354930;201608;311;771;172;533;24;79;69;206;93;285
354940;201608;1871;6619;1544;5757;506;2030;153;528;659;2558
354950;201608;1458;4575;1228;4180;149;639;669;2195;818;2834
354960;201608;770;2359;666;2189;136;508;277;857;413;1365
354970;201608;3843;12476;3333;11441;556;2179;1751;5789;2307;7968
354980;201608;33217;82521;20207;60920;3326;11224;6821;18961;10147;30185
354990;201608;52511;151240;41104;129028;6888;23347;19671;59678;26559;83025
354995;201608;1719;5207;1436;4733;347;1188;690;2256;1037;3444
355000;201608;1416;4494;1239;4151;326;1270;236;664;562;1934
355010;201608;3544;10842;2721;8947;758;2625;718;2394;1476;5019
355020;201608;2899;9517;2210;8090;793;3185;459;1583;1252;4768
355030;201608;1117998;3022434;930483;2660101;199869;619092;396090;1080683;595959;1699775
355040;201608;2557;7748;2253;7218;475;1614;1258;3965;1733;5579
355050;201608;1119;3375;883;2915;269;892;137;448;406;1340
355060;201608;4335;14292;3503;12549;741;2993;1019;3302;1760;6295
355070;201608;6480;19894;5673;18546;1158;4304;2691;8203;3849;12507
355080;201608;956;3249;673;2593;101;441;42;145;143;586
355090;201608;1105;3728;929;3349;169;641;343;1225;512;1866
355100;201608;17912;54827;14788;49571;3832;14037;6520;21240;10352;35277
355110;201608;1189;3817;1008;3473;287;1077;206;666;493;1743
355120;201608;629;1962;516;1742;102;411;183;578;285;989
355130;201608;632;1607;299;886;41;125;90;240;131;365
355140;201608;1123;3716;1065;3613;217;822;574;1984;791;2806
355150;201608;3453;9904;2873;8965;562;1816;1407;4430;1969;6246
355160;201608;1676;5195;1379;4694;404;1505;349;1158;753;2663
355170;201608;8419;23524;6406;20194;2083;6983;1550;5027;3633;12010
355180;201608;2839;8730;2297;7733;564;2233;694;2112;1258;4345
355190;201608;1404;4401;1203;4009;388;1458;335;1173;723;2631
355200;201608;767;2693;696;2537;278;1100;156;517;434;1617
355210;201608;2699;8397;2360;7695;353;1364;1342;4142;1695;5506
355220;201608;34638;103755;28129;90703;9023;30757;6517;19455;15540;50212
355230;201608;1374;3737;765;2410;136;431;173;477;309;908
355240;201608;25122;71477;17290;55329;3633;12198;5183;16126;8816;28324
355250;201608;28027;87351;23458;78552;6410;22950;8045;26368;14455;49318
355255;201608;873;2398;538;1708;99;326;137;419;236;745
355260;201608;1235;3586;1043;3251;218;773;431;1213;649;1986
355270;201608;1621;4750;1437;4404;153;507;966;2883;1119;3390
355280;201608;26019;75117;20695;64803;3718;12902;8784;26134;12502;39036
355290;201608;927;2915;736;2455;146;486;220;676;366;1162
355300;201608;1222;3920;1014;3486;202;733;313;1042;515;1775
355310;201608;1051;3108;837;2704;137;483;417;1351;554;1834
355320;201608;591;1784;508;1611;84;333;198;527;282;860
355330;201608;1906;5804;1388;4761;288;1101;552;1809;840;2910
355340;201608;2538;6539;2262;6093;372;1012;1369;3622;1741;4634
355350;201608;1317;4401;1048;3794;243;954;271;951;514;1905
355360;201608;1140;3593;1004;3310;175;594;613;2095;788;2689
355365;201608;321;932;214;749;50;177;44;152;94;329
355370;201608;7614;18622;5545;16036;1566;4883;2060;6316;3626;11199
355380;201608;3236;9615;2521;8057;527;1800;540;1500;1067;3300
355385;201608;916;2928;820;2730;252;920;231;704;483;1624
355390;201608;846;2433;627;1979;135;480;219;582;354;1062
355395;201608;1870;5641;1352;4426;195;651;564;1739;759;2390
355400;201608;8912;29130;7693;26588;2227;8338;2047;6724;4274;15062
355410;201608;17077;54578;13543;47493;3946;15193;2403;8409;6349;23602
355420;201608;729;2549;664;2419;193;793;168;608;361;1401
355430;201608;3492;9674;2875;8614;556;1756;1358;3958;1914;5714
355440;201608;930;2835;681;2280;114;391;182;568;296;959
355450;201608;3765;10741;2182;7200;385;1310;618;1902;1003;3212
355460;201608;596;1608;393;1238;82;313;112;280;194;593
355465;201608;340;1085;285;975;57;201;70;235;127;436
355470;201608;787;2351;619;2047;141;505;249;786;390;1291
355475;201608;161;538;152;512;38;136;67;206;105;342
355480;201608;2841;9775;2573;9234;586;2240;1186;4176;1772;6416
355490;201608;991;2819;632;2058;97;325;171;523;268;848
355495;201608;722;2408;632;2211;119;453;179;597;298;1050
355500;201608;7430;21433;4908;15976;798;2812;811;2461;1609;5273
355510;201608;1976;5291;1105;3534;154;586;309;867;463;1453
355520;201608;428;996;213;583;28;89;92;213;120;302
355530;201608;431;1035;176;548;23;82;37;92;60;174
355535;201608;664;2030;528;1772;159;587;112;314;271;901
355540;201608;8165;25498;7681;24723;1887;6479;3963;12379;5850;18858
355550;201608;725;2209;611;2004;114;430;265;846;379;1276
355560;201608;1225;3652;772;2623;135;518;65;168;200;686
355570;201608;190;592;123;440;18;70;10;33;28;103
355580;201608;1274;3513;851;2668;142;502;312;968;454;1470
355590;201608;226;593;179;511;26;85;93;252;119;337
355600;201608;1156;3499;953;3078;285;986;285;878;570;1864
355610;201608;1613;4444;1229;3715;221;715;532;1555;753;2270
355620;201608;4097;12684;3286;10869;504;1932;1484;4540;1988;6472
355630;201608;3259;9246;2066;6850;398;1411;518;1717;916;3128
355635;201608;915;2977;788;2768;86;337;529;1880;615;2217
355640;201608;3004;9506;2201;7882;379;1526;277;959;656;2485
355645;201608;3464;11542;3074;10928;499;1993;1758;6190;2257;8183
355650;201608;7532;22245;6441;20209;1130;4138;3788;11020;4918;15158
355660;201608;1254;3932;994;3397;168;691;419;1341;587;2032
355670;201608;2899;8853;2056;6939;347;1319;812;2426;1159;3745
355680;201608;1702;5565;1245;4448;316;1209;170;581;486;1790
355690;201608;467;1452;349;1241;174;648;26;75;200;723
355695;201608;283;882;160;553;7;23;10;23;17;46
355700;201608;5417;17685;4587;15818;1104;3951;1683;5652;2787;9603
355710;201608;10153;25207;6026;17616;1340;4147;1441;4012;2781;8159
355715;201608;311;926;204;681;51;187;34;103;85;290
355720;201608;1536;5061;1257;4420;310;1174;368;1156;678;2330
355730;201608;828;2693;694;2385;214;740;168;575;382;1315
410010;201608;1370;4227;1167;3778;241;838;219;686;460;1524
410020;201608;1142;3698;976;3307;268;935;349;1163;617;2098
410030;201608;1113;3763;916;3282;219;840;154;556;373;1396
410040;201608;9818;31787;8487;29226;1945;7477;2445;8292;4390;15769
410045;201608;1023;2867;716;2275;154;511;142;421;296;932
410050;201608;2541;6972;1589;5107;402;1359;90;211;492;1570
410060;201608;2279;6867;1969;6255;414;1373;803;2581;1217;3954
410070;201608;1748;4902;1311;4031;376;1258;287;847;663;2105
410080;201608;1379;3896;1066;3313;171;603;442;1280;613;1883
410090;201608;992;3045;911;2879;181;640;357;1143;538;1783
410100;201608;2687;8176;2003;6553;393;1435;197;580;590;2015
410105;201608;375;1173;247;853;38;158;32;96;70;254
410110;201608;2826;8170;2240;7036;335;1146;681;2111;1016;3257
410115;201608;525;1412;401;1188;62;208;131;340;193;548
410120;201608;2476;8473;2296;8132;811;3063;661;2336;1472;5399
410130;201608;1054;3290;982;3111;420;1404;212;611;632;2015
410140;201608;17496;45222;11393;34289;2254;7347;2652;7626;4906;14973
410150;201608;16145;40771;8452;25265;1571;5032;1197;3297;2768;8329
410160;201608;3037;9292;2719;8736;686;2490;908;2927;1594;5417
410165;201608;680;1982;542;1658;99;315;230;646;329;961
410170;201608;2298;6552;1721;5280;483;1630;218;625;701;2255
410180;201608;11217;35057;9582;31435;2052;7307;3913;11925;5965;19232
410185;201608;543;1503;401;1225;84;256;78;213;162;469
410190;201608;2082;6101;1642;5115;303;1036;255;715;558;1751
410200;201608;3837;10677;2778;8602;582;2033;356;1042;938;3075
410210;201608;2662;7779;1922;6150;288;1074;407;1059;695;2133
410220;201608;659;1800;484;1482;78;277;153;463;231;740
410230;201608;1425;4450;1212;4022;265;1009;454;1481;719;2490
410240;201608;4365;13105;3924;12201;1210;4280;568;1638;1778;5918
410250;201608;2659;7316;1842;5637;392;1276;316;922;708;2198
410260;201608;1577;4556;1269;4030;276;951;500;1588;776;2539
410270;201608;563;1556;433;1291;52;174;202;579;254;753
410275;201608;858;2553;562;1875;71;250;239;801;310;1051
410280;201608;2250;6429;1638;5196;335;1201;442;1299;777;2500
410290;201608;3398;10091;2816;8970;667;2167;1028;3356;1695;5523
410300;201608;721;2009;599;1758;98;324;254;653;352;977
410302;201608;411;1112;265;844;28;100;130;421;158;521
410304;201608;1234;3879;1110;3618;294;1008;383;1286;677;2294
410305;201608;1869;5065;1505;4435;319;1026;744;2171;1063;3197
410310;201608;2300;7279;2036;6811;430;1596;710;2369;1140;3965
410315;201608;656;1864;404;1362;69;251;110;345;179;596
410320;201608;1207;3662;769;2635;104;417;64;190;168;607
410322;201608;540;1565;334;1105;48;158;81;265;129;423
410330;201608;1381;3802;1098;3246;228;701;269;778;497;1479
410335;201608;940;2772;804;2512;135;466;293;832;428;1298
410337;201608;811;2143;590;1736;76;260;191;512;267;772
410340;201608;523;1518;354;1082;44;149;136;360;180;509
410345;201608;1876;5438;1305;4189;303;1028;293;910;596;1938
410347;201608;721;1932;509;1520;61;219;148;405;209;624
410350;201608;1049;3124;765;2551;144;547;154;441;298;988
410360;201608;3805;10320;2965;8805;392;1331;1461;4181;1853;5512
410370;201608;12045;35111;8779;27434;1486;5138;2380;6479;3866;11617
410380;201608;1325;3842;1198;3580;133;482;585;1716;718;2198
410390;201608;2466;7341;1970;6278;563;1897;428;1225;991;3122
410395;201608;865;2839;759;2614;202;769;304;1028;506;1797
410400;201608;4518;13812;3724;12150;733;2605;1307;4076;2040;6681
410405;201608;860;2469;692;2162;159;573;216;643;375;1216
410410;201608;1263;3885;1217;3820;316;1226;542;1571;858;2797
410420;201608;6957;22382;5669;19465;1323;4934;703;2059;2026;6993
410425;201608;2769;8703;1955;6865;324;1192;198;640;522;1832
410430;201608;14337;38316;10270;30749;1879;6137;2731;7775;4610;13912
410440;201608;2721;8621;2405;8000;622;2274;900;2891;1522;5165
410442;201608;2680;8850;2350;8110;692;2471;619;2142;1311;4613
410445;201608;2327;7581;1998;6979;522;2047;594;2131;1116;4178
410450;201608;2089;5883;1609;4933;390;1238;148;341;538;1579
410460;201608;1852;5424;1433;4600;378;1231;249;769;627;2000
410465;201608;2102;6842;1756;6089;391;1436;577;1892;968;3328
410470;201608;1732;5546;1387;4767;284;1132;271;902;555;2034
410480;201608;30680;86028;19048;61387;3188;10951;1756;4803;4944;15754
410490;201608;11076;33953;8492;28496;1901;7117;2203;6766;4104;13883
410500;201608;1554;4860;1236;4129;446;1666;181;530;627;2196
410510;201608;2497;6554;1733;5046;318;914;586;1603;904;2517
410520;201608;3109;10628;2908;10216;828;3087;1188;4189;2016;7276
410530;201608;1586;4338;1086;3266;192;621;249;684;441;1305
410540;201608;3110;9127;2180;7137;400;1346;615;1993;1015;3339
410550;201608;6158;17803;4299;13751;765;2701;524;1517;1289;4218
410560;201608;1266;3727;974;3133;229;828;236;658;465;1486
410570;201608;2630;8213;2325;7693;582;2101;630;2287;1212;4388
410580;201608;21873;65301;17788;57197;4123;14608;5094;15213;9217;29821
410590;201608;1370;4212;860;2849;134;449;163;465;297;914
410600;201608;1849;5331;1468;4580;366;1141;473;1499;839;2640
410610;201608;771;2150;597;1810;65;200;215;636;280;836
410620;201608;1729;5779;1276;4660;270;1071;113;387;383;1458
410630;201608;2475;7260;1698;5510;344;1206;188;488;532;1694
410640;201608;4603;12597;3381;10259;835;2922;481;1341;1316;4263
410645;201608;1124;3871;1042;3733;465;1742;208;787;673;2529
410650;201608;2117;6516;1690;5605;528;1854;228;703;756;2557
410655;201608;844;2355;612;1890;87;323;203;571;290;894
410657;201608;761;2113;540;1661;140;481;147;380;287;861
410660;201608;2953;8337;1631;5362;314;1090;157;460;471;1550
410670;201608;949;2587;632;1919;120;374;180;508;300;882
410680;201608;2908;9378;2316;7926;681;2284;511;1874;1192;4158
410685;201608;652;1862;556;1695;79;273;299;879;378;1152
410690;201608;116514;332377;81030;257983;15375;53627;18031;50096;33406;103723
410700;201608;2231;6657;2026;6261;526;1713;795;2347;1321;4060
410710;201608;917;2667;619;2015;133;445;131;366;264;811
410712;201608;824;2466;712;2250;261;912;153;472;414;1384
410715;201608;908;2868;663;2276;121;445;172;557;293;1002
410720;201608;3210;9445;2360;7653;433;1577;428;1239;861;2816
410725;201608;1091;3055;757;2407;108;347;112;321;220;668
410730;201608;521;1455;410;1265;109;362;84;269;193;631
410740;201608;899;2643;642;2125;95;371;259;834;354;1205
410750;201608;1831;5320;1493;4600;288;973;453;1307;741;2280
410752;201608;313;859;162;528;33;123;45;123;78;246
410753;201608;389;1118;235;760;32;122;60;167;92;289
410754;201608;1131;3275;948;2961;73;216;593;2005;666;2221
410755;201608;812;1986;603;1653;77;253;344;880;421;1133
410760;201608;2448;7293;2095;6651;559;1954;573;1773;1132;3727
410765;201608;15126;45092;11413;37752;1663;6151;808;2562;2471;8713
410770;201608;910;2493;640;1948;152;499;105;308;257;807
410773;201608;1344;3810;1176;3549;161;569;805;2351;966;2920
410775;201608;1414;4053;1295;3882;304;1011;457;1352;761;2363
410780;201608;545;1481;371;1136;92;271;102;361;194;632
410785;201608;749;2352;628;2079;181;649;153;493;334;1142
410790;201608;429;1393;365;1218;94;324;22;49;116;373
410800;201608;2846;7093;2214;6016;361;1141;731;1831;1092;2972
410810;201608;338;1038;284;927;48;179;97;313;145;492
410820;201608;831;2489;611;1986;137;475;87;270;224;745
410830;201608;30236;85401;24054;74578;6569;22499;7437;22053;14006;44552
410832;201608;1023;2951;880;2676;96;364;487;1392;583;1756
410840;201608;6408;18552;4155;13717;848;2959;281;751;1129;3710
410845;201608;1240;3625;1040;3218;211;706;387;1167;598;1873
410850;201608;2692;8007;2384;7484;530;1837;882;2820;1412;4657
410855;201608;595;1636;425;1277;59;189;153;424;212;613
410860;201608;3641;10399;2890;8841;573;1885;819;2399;1392;4284
410865;201608;1489;4960;1415;4819;360;1336;752;2618;1112;3954
410870;201608;1241;3708;1148;3564;161;529;766;2405;927;2934
410880;201608;3790;11878;3136;10511;601;2233;483;1564;1084;3797
410890;201608;909;2940;703;2491;161;632;72;224;233;856
410895;201608;1076;3704;957;3431;337;1308;193;650;530;1958
410900;201608;953;2599;624;1952;96;327;178;518;274;845
410910;201608;408;1067;306;889;33;114;155;428;188;542
410920;201608;834;2320;663;2033;172;599;207;624;379;1223
410930;201608;1629;4802;1343;4218;359;1311;343;1021;702;2332
410940;201608;20991;66557;17617;60183;5121;18914;3438;11791;8559;30705
410950;201608;1790;5752;1645;5495;174;619;1207;4035;1381;4654
410960;201608;7461;20424;4654;15112;1340;4784;862;2599;2202;7383
410965;201608;1059;3112;839;2672;216;697;279;859;495;1556
410970;201608;4525;13263;3525;11295;914;3381;533;1633;1447;5014
410975;201608;1618;4559;1269;3889;218;768;436;1261;654;2029
410980;201608;5870;16401;3775;12207;673;2442;897;2729;1570;5171
410990;201608;918;2667;566;1891;170;637;57;145;227;782
411000;201608;490;1474;328;1097;56;210;58;155;114;365
411005;201608;481;1414;292;961;47;175;32;88;79;263
411007;201608;2324;7189;1995;6497;525;1827;535;1727;1060;3554
411010;201608;3995;13501;3579;12557;950;3580;406;1373;1356;4953
411020;201608;2535;7698;2179;7091;661;2368;611;1900;1272;4268
411030;201608;664;1772;472;1399;72;242;119;319;191;561
411040;201608;686;1972;327;1077;58;209;59;192;117;401
411050;201608;2007;6874;1792;6394;505;1993;249;773;754;2766
411060;201608;1570;4708;1181;3846;220;827;140;402;360;1229
411065;201608;365;1083;284;924;49;152;99;320;148;472
411070;201608;5937;17547;4695;15041;1176;4208;1049;3021;2225;7229
411080;201608;2157;6382;1907;5910;433;1469;485;1475;918;2944
411090;201608;825;2043;567;1640;63;216;100;258;163;474
411095;201608;1520;4256;1105;3386;146;523;254;685;400;1208
411100;201608;1312;3776;926;2952;161;616;157;464;318;1080
411110;201608;597;1756;313;1069;34;135;27;76;61;211
411120;201608;1635;4908;1220;3983;299;1130;313;897;612;2027
411125;201608;4291;13837;4044;13338;1099;3798;1439;4732;2538;8530
411130;201608;687;2040;514;1670;109;383;125;443;234;826
411140;201608;2189;7392;1858;6597;460;1715;668;2427;1128;4142
411150;201608;4128;11566;3111;9521;659;2204;372;980;1031;3184
411155;201608;956;2609;693;2126;90;308;285;830;375;1138
411160;201608;258;736;200;626;34;114;44;138;78;252
411170;201608;719;2261;588;1953;130;475;178;557;308;1032
411180;201608;5742;16951;4621;14793;973;3443;1433;4553;2406;7996
411190;201608;1416;4043;1173;3570;281;968;234;628;515;1596
411200;201608;4303;12623;3411;11058;859;3070;931;2868;1790;5938
411210;201608;2001;5645;1574;4871;358;1240;174;465;532;1705
411220;201608;1113;3104;892;2708;202;703;317;860;519;1563
411230;201608;1264;3509;818;2629;141;472;266;844;407;1316
411240;201608;1457;3508;798;2327;131;401;263;701;394;1102
411250;201608;2183;6378;1799;5678;474;1645;435;1398;909;3043
411260;201608;317;843;210;656;23;73;91;270;114;343
411270;201608;1779;5491;1556;5059;242;894;684;2118;926;3012
411275;201608;1334;3892;1057;3269;236;759;225;640;461;1399
411280;201608;1544;4460;1049;3403;173;602;195;604;368;1206
411290;201608;755;2207;567;1808;136;466;136;414;272;880
411295;201608;976;2686;872;2482;137;425;341;992;478;1417
411300;201608;1247;3166;831;2375;73;209;300;795;373;1004
411310;201608;863;2321;669;1995;64;225;206;607;270;832
411320;201608;5390;15507;3950;12765;989;3294;630;1869;1619;5163
411325;201608;1525;4741;1322;4311;280;964;598;1995;878;2959
411330;201608;3092;9505;2572;8469;805;2929;562;1889;1367;4818
411340;201608;942;2765;598;1954;55;217;203;629;258;846
411342;201608;737;2070;606;1799;166;525;193;536;359;1061
411345;201608;895;2755;797;2573;195;706;351;1115;546;1821
411350;201608;2753;8188;2019;6663;524;1922;188;588;712;2510
411360;201608;555;1386;367;1059;48;169;135;334;183;503
411370;201608;45894;128293;35864;109622;5334;18633;14783;41881;20117;60514
411373;201608;1505;4576;1296;4201;250;934;323;1044;573;1978
411375;201608;1123;3064;812;2454;151;479;215;607;366;1086
411380;201608;1234;3338;717;2142;125;384;179;485;304;869
411390;201608;1791;5229;1411;4393;270;910;330;926;600;1836
411400;201608;2154;6043;1655;5013;322;1063;436;1254;758;2317
411410;201608;2062;6197;1590;5110;334;1183;359;1012;693;2195
411420;201608;4090;11491;2783;8756;392;1383;413;1053;805;2436
411430;201608;3257;9658;2701;8750;628;2222;1277;4060;1905;6282
411435;201608;434;1412;365;1235;75;269;138;437;213;706
411440;201608;2716;8600;2384;7906;696;2425;495;1757;1191;4182
411450;201608;2311;6995;2083;6560;415;1325;951;3140;1366;4465
411460;201608;3283;9522;1765;6033;242;925;98;303;340;1228
411470;201608;816;2420;550;1797;83;293;73;200;156;493
411480;201608;4531;13519;3373;11259;789;2930;425;1294;1214;4224
411490;201608;1451;4378;1219;3949;239;839;272;806;511;1645
411500;201608;1848;4879;1280;3862;239;800;349;1038;588;1838
411510;201608;2033;6035;1650;5242;416;1452;261;774;677;2226
411520;201608;26886;72781;16291;50646;2700;9010;3263;9416;5963;18426
411530;201608;1007;2789;719;2276;147;542;131;369;278;911
411535;201608;510;1548;276;977;27;118;17;48;44;166
411540;201608;2997;8063;2161;6341;471;1554;575;1499;1046;3053
411545;201608;984;3204;882;3003;134;481;546;1917;680;2398
411550;201608;804;2153;636;1884;192;627;110;322;302;949
411560;201608;2360;6933;1664;5359;246;872;134;367;380;1239
411570;201608;6949;18368;5142;15457;1157;3920;1034;3186;2191;7106
411573;201608;861;2520;804;2428;119;359;484;1497;603;1856
411575;201608;1589;4880;1334;4338;308;1044;401;1307;709;2351
411580;201608;3991;11368;2673;8689;304;1189;319;862;623;2051
411585;201608;766;2430;393;1384;80;277;57;188;137;465
411590;201608;378;1151;325;1060;49;187;134;408;183;595
411600;201608;309;877;212;718;50;194;76;259;126;453
411605;201608;1698;4647;1163;3532;182;626;403;1187;585;1813
411610;201608;2196;6147;1748;5267;353;1149;721;2114;1074;3263
411620;201608;2785;8598;2504;8144;596;2119;1174;3833;1770;5952
411630;201608;526;1387;337;1103;61;246;53;148;114;394
411640;201608;458;1380;349;1126;48;151;112;326;160;477
411650;201608;195;627;155;545;26;106;26;87;52;193
411660;201608;895;2382;666;1972;92;294;301;875;393;1169
411670;201608;1131;3147;911;2674;181;579;294;810;475;1389
411680;201608;1463;4322;1274;3982;258;890;581;1825;839;2715
411690;201608;3363;9792;2648;8459;671;2215;563;1920;1234;4135
411695;201608;791;2528;620;2151;123;462;189;667;312;1129
411700;201608;1721;4917;1195;3860;223;791;157;446;380;1237
411705;201608;1880;6452;1640;5965;380;1368;779;3020;1159;4388
411710;201608;1706;4990;1366;4292;351;1175;198;622;549;1797
411720;201608;907;2551;705;2140;100;339;189;519;289;858
411721;201608;754;2225;599;1897;149;486;68;201;217;687
411722;201608;677;2036;450;1517;87;333;100;288;187;621
411725;201608;1419;4491;876;3126;180;668;141;518;321;1186
411727;201608;1813;5272;1307;4159;317;1042;223;684;540;1726
411729;201608;603;1560;420;1215;123;366;68;155;191;521
411730;201608;5543;15755;4560;13864;1510;4657;1081;3230;2591;7887
411740;201608;646;1825;398;1280;59;211;96;273;155;484
411745;201608;916;2616;748;2276;129;406;234;704;363;1110
411750;201608;4902;14450;3715;11787;674;2277;1143;3484;1817;5761
411760;201608;7831;22742;6626;20614;2053;6750;1456;4640;3509;11390
411770;201608;3415;11082;2795;9659;763;2846;438;1435;1201;4281
411780;201608;2865;8737;2614;8317;553;1915;1418;4690;1971;6605
411790;201608;3356;9433;2317;7289;555;1920;497;1516;1052;3436
411800;201608;1160;3331;781;2495;114;406;95;254;209;660
411810;201608;1715;4869;1395;4240;273;901;498;1394;771;2295
411820;201608;13673;43718;11398;38971;3820;13518;2422;8452;6242;21970
411830;201608;524;1340;386;1102;95;307;14;49;109;356
411840;201608;10529;29832;7764;24423;1700;5827;1354;4233;3054;10060
411845;201608;508;1555;314;1038;50;182;36;102;86;284
411850;201608;7257;21441;5895;18663;1400;4807;1498;4622;2898;9429
411860;201608;901;2727;724;2350;152;515;222;676;374;1191
411870;201608;869;2804;599;2075;113;453;106;324;219;777
411880;201608;2316;6597;1808;5691;433;1567;341;966;774;2533
411885;201608;948;2588;786;2308;128;458;257;703;385;1161
411890;201608;1112;3382;756;2527;119;461;55;135;174;596
411900;201608;951;2945;650;2208;141;478;77;261;218;739
411910;201608;1228;4017;929;3286;257;972;196;614;453;1586
411915;201608;17072;46189;10673;33424;1862;6289;2180;6126;4042;12415
411920;201608;863;2896;748;2613;182;739;74;204;256;943
411925;201608;574;1637;383;1261;77;259;83;254;160;513
411930;201608;5926;19344;5171;17827;2327;8633;502;1637;2829;10270
411940;201608;3211;10663;2760;9676;707;2601;522;1754;1229;4355
411950;201608;12038;37811;10230;34249;2274;8167;4392;14429;6666;22596
411960;201608;5506;16086;5049;15235;1048;3541;1984;5764;3032;9305
411965;201608;568;1607;399;1314;67;267;105;351;172;618
411970;201608;770;2130;646;1941;188;582;242;806;430;1388
411980;201608;1667;4922;1425;4426;326;1064;380;1183;706;2247
411990;201608;31369;98168;24914;84470;6060;22734;6545;21235;12605;43969
411995;201608;2538;7657;2144;6943;616;2260;506;1485;1122;3745
412000;201608;2330;5793;1801;4913;251;847;900;2190;1151;3037
412010;201608;713;2382;571;2063;87;333;122;401;209;734
412015;201608;644;1889;520;1632;94;297;235;738;329;1035
412020;201608;368;1069;242;782;44;144;62;186;106;330
412030;201608;708;2201;507;1749;85;336;110;352;195;688
412033;201608;852;2428;576;1807;79;271;140;421;219;692
412035;201608;1001;2745;642;2070;129;440;201;632;330;1072
412040;201608;598;1850;463;1546;85;292;82;270;167;562
412050;201608;1741;4966;1324;4147;205;721;290;868;495;1589
412060;201608;6866;23223;6188;21833;1884;7198;1589;5514;3473;12712
412065;201608;818;2449;631;2054;131;470;160;469;291;939
412070;201608;1374;3672;1013;2924;158;482;358;1010;516;1492
412080;201608;1414;4339;844;3018;81;312;23;70;104;382
412085;201608;444;1269;145;498;19;65;14;42;33;107
412090;201608;4593;13904;4260;13313;880;2816;2202;7133;3082;9949
412100;201608;1942;5947;1565;5199;444;1627;333;1093;777;2720
412110;201608;1100;3087;739;2321;160;526;131;426;291;952
412120;201608;1706;5770;1462;5211;367;1452;404;1261;771;2713
412125;201608;653;2106;592;1992;134;480;198;629;332;1109
412130;201608;616;1829;455;1461;102;347;65;197;167;544
412135;201608;493;1392;299;950;66;211;89;272;155;483
412140;201608;1609;4779;1296;4109;284;966;226;665;510;1631
412150;201608;2888;8304;2485;7490;370;1201;1394;4098;1764;5299
412160;201608;1188;3751;742;2590;168;648;80;245;248;893
412170;201608;4558;13859;3714;12205;947;3391;1267;3914;2214;7305
412175;201608;1450;4741;1254;4322;247;950;565;1927;812;2877
412180;201608;1672;5040;1243;4219;267;1040;354;1102;621;2142
412190;201608;3288;9210;2450;7687;476;1648;738;2434;1214;4082
412200;201608;2129;6765;1523;5203;277;1020;433;1473;710;2493
412210;201608;682;1867;391;1238;58;203;36;86;94;289
412215;201608;3635;11006;3252;10320;785;2499;1681;5533;2466;8032
412217;201608;1111;3133;978;2891;101;373;658;1820;759;2193
412220;201608;5675;18322;5362;17716;1572;5254;2272;7692;3844;12946
412230;201608;2833;9262;2441;8455;462;1795;651;2063;1113;3858
412240;201608;8848;22498;5180;15685;890;3045;942;2552;1832;5597
412250;201608;1903;5520;1589;4878;362;1184;194;499;556;1683
412260;201608;1357;3716;872;2666;121;417;299;805;420;1222
412265;201608;996;3001;867;2774;215;760;321;1024;536;1784
412270;201608;880;2774;589;2048;95;367;175;561;270;928
412280;201608;631;1940;470;1588;146;538;25;57;171;595
412290;201608;1031;2906;774;2433;143;494;228;657;371;1151
412300;201608;1874;5608;1572;5026;379;1299;314;958;693;2257
412310;201608;1016;2933;868;2692;121;445;408;1296;529;1741
412320;201608;892;2361;630;1897;109;407;202;590;311;997
412330;201608;1537;4392;1147;3581;176;599;481;1489;657;2088
412340;201608;962;2969;636;2140;80;278;92;273;172;551
412350;201608;2240;6917;1729;5782;285;981;85;216;370;1197
412360;201608;307;903;187;606;20;81;62;171;82;252
412370;201608;966;2813;695;2305;133;478;121;405;254;883
412380;201608;1537;4836;1266;4174;312;1096;250;801;562;1897
412382;201608;673;1871;463;1437;74;236;94;256;168;492
412385;201608;2371;7285;2102;6667;730;2387;479;1553;1209;3940
412390;201608;2147;6049;1921;5686;480;1561;771;2346;1251;3907
412395;201608;819;2291;638;1974;83;287;334;999;417;1286
412400;201608;925;2885;783;2573;208;727;164;556;372;1283
412402;201608;1865;5485;1494;4729;329;1168;280;796;609;1964
412405;201608;3597;10392;2204;7233;313;1169;108;297;421;1466
412410;201608;4989;15021;4024;13147;1082;4053;712;2180;1794;6233
412420;201608;367;1084;248;802;39;130;70;185;109;315
412430;201608;552;1535;388;1207;59;196;124;367;183;563
412440;201608;3201;9683;2499;8362;551;2024;608;2030;1159;4054
412450;201608;265;875;193;672;27;84;15;39;42;123
412460;201608;747;2325;614;2026;149;520;111;359;260;879
412470;201608;1847;6239;1555;5478;510;1891;291;1090;801;2981
412480;201608;1157;3459;786;2525;120;413;94;227;214;640
412490;201608;912;2689;760;2388;132;436;231;706;363;1142
412500;201608;1965;5620;1607;4898;287;982;345;915;632;1897
412510;201608;2241;7236;1811;6178;560;2090;406;1288;966;3378
412520;201608;1534;4316;1126;3475;302;960;158;443;460;1403
412530;201608;608;1783;461;1437;94;302;84;247;178;549
412535;201608;738;2146;494;1571;84;291;107;309;191;600
412540;201608;1211;3444;913;2827;125;468;246;742;371;1210
412545;201608;766;2187;580;1783;93;324;168;439;261;763
412550;201608;30009;89253;20729;68463;4409;15616;4095;12653;8504;28269
412555;201608;262;774;175;569;27;88;38;102;65;190
412560;201608;5267;16042;4070;13425;752;2931;1052;3299;1804;6230
412570;201608;4257;12320;2822;9260;600;2159;399;1327;999;3486
412575;201608;872;2658;683;2195;132;470;203;602;335;1072
412580;201608;1245;3421;883;2711;148;476;287;809;435;1285
412590;201608;441;1289;280;928;53;186;62;195;115;381
412600;201608;1407;4269;1048;3460;206;746;251;771;457;1517
412610;201608;743;2199;471;1504;115;379;115;341;230;720
412620;201608;1223;3829;942;3244;217;872;131;378;348;1250
412625;201608;9721;27860;7256;22936;1362;4612;761;2221;2123;6833
412627;201608;951;2917;667;2253;204;758;79;253;283;1011
412630;201608;3291;10282;2584;8694;493;1654;667;2156;1160;3810
412635;201608;472;1370;320;1031;70;229;17;33;87;262
412640;201608;896;2667;583;1928;84;293;44;128;128;421
412650;201608;1731;5139;1443;4580;275;998;404;1172;679;2170
412660;201608;2736;7836;2141;6629;413;1443;420;1145;833;2588
412665;201608;632;1639;353;1090;81;260;70;205;151;465
412667;201608;1672;4774;1303;4027;275;889;292;859;567;1748
412670;201608;554;1693;426;1426;101;381;71;224;172;605
412680;201608;1357;4049;848;2896;125;465;171;509;296;974
412690;201608;787;2341;599;1928;147;506;103;336;250;842
412700;201608;1846;5554;1546;5097;507;1902;366;1144;873;3046
412710;201608;6908;21637;5786;19312;1173;4335;1269;3873;2442;8208
412720;201608;1382;4236;977;3230;150;536;161;420;311;956
412730;201608;2160;6429;1282;4391;242;884;125;377;367;1261
412740;201608;1453;4611;1081;3756;229;878;129;489;358;1367
412750;201608;4046;12172;3598;11418;438;1649;2212;6891;2650;8540
412760;201608;2415;7597;2258;7312;359;1344;1340;4201;1699;5545
412770;201608;11245;30816;6370;20434;818;2849;1031;2891;1849;5740
412780;201608;1308;3973;1112;3581;228;807;388;1176;616;1983
412785;201608;2343;6553;1755;5368;445;1423;737;2298;1182;3721
412788;201608;1401;4427;1199;4001;286;1090;329;962;615;2052
412790;201608;1142;3420;833;2735;159;571;151;403;310;974
412795;201608;986;2687;736;2208;140;432;245;724;385;1156
412796;201608;2722;8304;2476;7825;571;1981;925;2756;1496;4737
412800;201608;3068;8737;2378;7260;368;1231;803;2331;1171;3562
412810;201608;11316;30711;6643;20718;838;2943;1415;3651;2253;6594
412820;201608;7390;21427;5407;17537;1190;4088;1226;3992;2416;8080
412830;201608;367;1114;270;890;40;146;64;186;104;332
412840;201608;1861;5275;1484;4502;264;863;303;912;567;1775
412850;201608;2766;8077;2224;7116;431;1558;664;1961;1095;3519
412853;201608;1726;4948;1516;4527;153;518;791;2195;944;2713
412855;201608;1480;4241;1131;3450;227;757;244;626;471;1383
412860;201608;1193;3388;956;2938;241;820;342;1005;583;1825
412862;201608;770;1987;512;1519;74;235;133;397;207;632
412863;201608;1186;3995;1151;3930;171;638;794;2666;965;3304
412865;201608;715;2172;531;1760;114;393;159;555;273;948
412870;201608;933;2631;731;2295;274;961;106;309;380;1270
412880;201608;880;2542;673;2119;136;480;68;174;204;654
420005;201608;539;1600;322;1097;59;212;94;309;153;521
420010;201608;3203;8933;2545;8001;340;1102;1692;5440;2032;6542
420020;201608;758;2440;428;1571;42;187;47;162;89;349
420030;201608;502;1299;256;837;47;182;30;94;77;276
420040;201608;721;2283;435;1637;77;322;24;77;101;399
420050;201608;705;2029;469;1544;114;395;167;552;281;947
420055;201608;205;622;114;399;19;72;14;45;33;117
420060;201608;240;778;162;588;22;100;26;71;48;171
420070;201608;1353;4271;1027;3476;178;691;376;1255;554;1946
420075;201608;174;462;88;269;15;48;13;32;28;80
420080;201608;596;1859;478;1626;143;520;116;393;259;913
420090;201608;489;1603;331;1251;76;308;50;195;126;503
420100;201608;1200;3728;1070;3546;240;817;594;1990;834;2807
420110;201608;327;1100;296;1027;66;238;101;352;167;590
420120;201608;278;942;223;818;65;274;42;131;107;405
420125;201608;280;1020;250;953;69;281;94;339;163;620
420127;201608;548;1594;208;756;45;178;18;60;63;238
420130;201608;1892;6340;1516;5551;356;1457;299;986;655;2443
420140;201608;4554;13328;3216;10721;679;2501;447;1330;1126;3831
420150;201608;747;2094;459;1534;75;273;170;541;245;814
420160;201608;275;754;164;535;26;89;45;141;71;230
420165;201608;222;691;131;451;24;91;25;82;49;173
420170;201608;211;652;147;527;46;187;16;52;62;239
420180;201608;408;1231;218;781;32;125;44;145;76;270
420190;201608;462;1310;231;788;34;127;15;47;49;174
420195;201608;1383;4010;1111;3562;275;948;279;863;554;1811
420200;201608;2650;8235;1580;5771;286;1207;203;676;489;1883
420205;201608;1023;3326;850;3003;196;762;425;1506;621;2268
420207;201608;1567;4540;1085;3560;282;1030;201;628;483;1658
420208;201608;577;1578;313;1112;92;354;62;245;154;599
420209;201608;322;982;207;708;28;112;84;275;112;387
420210;201608;1820;5455;1189;4413;310;1351;363;1266;673;2617
420213;201608;784;2802;734;2687;167;650;384;1420;551;2070
420215;201608;323;1033;213;761;51;192;12;47;63;239
420220;201608;167;600;136;531;34;143;40;151;74;294
420230;201608;4275;12297;3134;10285;580;2245;1165;3665;1745;5910
420240;201608;11086;30762;7015;23037;1071;4181;2817;8324;3888;12505
420243;201608;601;1816;475;1566;99;354;163;529;262;883
420245;201608;1196;3568;820;2769;120;465;268;818;388;1283
420250;201608;526;1675;472;1572;122;492;191;593;313;1085
420253;201608;502;1304;377;1134;47;134;222;699;269;833
420257;201608;305;839;189;623;36;122;88;291;124;413
420260;201608;1216;3814;986;3384;202;775;365;1233;567;2008
420270;201608;618;1856;207;727;31;123;50;149;81;272
420280;201608;2207;6021;1354;4476;258;944;434;1368;692;2312
420285;201608;146;427;66;246;10;40;1;6;11;46
420287;201608;534;1582;439;1433;141;490;128;419;269;909
420290;201608;6277;18578;4193;13808;757;2629;1150;3526;1907;6155
420300;201608;6887;20475;4323;14895;857;3219;645;2078;1502;5297
420310;201608;790;2114;680;1937;107;334;474;1314;581;1648
420315;201608;969;3049;752;2613;233;863;214;715;447;1578
420320;201608;4846;14795;3936;13154;1131;4128;1294;4281;2425;8409
420325;201608;237;792;208;725;40;152;75;251;115;403
420330;201608;992;3378;718;2697;148;612;175;603;323;1215
420340;201608;1440;4417;1080;3602;170;653;111;320;281;973
420350;201608;1477;4354;1064;3539;284;1001;348;1120;632;2121
420360;201608;3091;9354;1920;6800;373;1516;152;448;525;1964
420370;201608;1840;5211;1429;4506;166;553;984;3056;1150;3609
420380;201608;5149;15588;3419;11644;760;2794;763;2493;1523;5287
420390;201608;1445;4013;757;2550;114;433;119;319;233;752
420395;201608;1400;4283;950;3242;112;440;111;328;223;768
420400;201608;1277;3688;879;2908;199;750;174;510;373;1260
420410;201608;764;2032;528;1640;99;344;307;944;406;1288
420415;201608;468;1456;339;1150;96;351;90;295;186;646
420417;201608;729;2313;592;1978;103;344;260;867;363;1211
420419;201608;369;1106;236;835;74;291;15;59;89;350
420420;201608;10857;32470;8591;28086;2908;10421;1820;5500;4728;15921
420425;201608;1235;3316;834;2557;87;337;347;986;434;1323
420430;201608;3390;10216;2154;7310;438;1595;608;2074;1046;3669
420435;201608;296;866;177;598;38;142;70;223;108;365
420440;201608;908;2788;511;1762;200;744;83;261;283;1005
420445;201608;381;1120;255;817;51;170;78;244;129;414
420450;201608;829;2494;556;1898;100;371;111;355;211;726
420455;201608;1963;5777;1661;5263;271;1061;761;2274;1032;3335
420460;201608;8891;25671;6665;21709;1398;5242;2396;7351;3794;12593
420470;201608;1116;2933;652;2044;122;432;179;508;301;940
420475;201608;124;356;64;215;17;50;5;15;22;65
420480;201608;5013;14305;3618;11724;944;3292;752;2419;1696;5711
420490;201608;653;1698;352;1186;79;304;74;252;153;556
420500;201608;1544;4858;1160;4091;346;1372;356;1253;702;2625
420510;201608;93;350;82;334;19;92;43;169;62;261
420515;201608;106;351;83;305;12;52;16;57;28;109
420517;201608;833;2572;736;2398;132;482;409;1283;541;1765
420519;201608;553;1445;393;1169;62;193;104;289;166;482
420520;201608;648;1644;381;1233;68;229;98;261;166;490
420530;201608;1053;3453;767;2803;170;723;165;536;335;1259
420535;201608;260;751;126;453;30;102;7;33;37;135
420540;201608;22019;61768;15424;47946;3450;11733;3783;9970;7233;21703
420543;201608;391;1020;303;879;26;91;185;574;211;665
420545;201608;1550;4840;1226;4122;269;1009;356;1133;625;2142
420550;201608;4174;13035;3029;10698;750;3126;508;1662;1258;4788
420555;201608;355;1073;263;880;62;235;77;235;139;470
420560;201608;542;1542;399;1288;69;239;184;581;253;820
420570;201608;2184;6876;1655;5669;410;1605;496;1534;906;3139
420580;201608;1507;4562;1184;4004;271;1052;461;1520;732;2572
420590;201608;3281;9764;2132;7120;390;1421;319;921;709;2342
420600;201608;923;2971;832;2782;125;436;471;1626;596;2062
420610;201608;524;1577;276;1015;58;246;58;212;116;458
420620;201608;573;1768;509;1637;123;422;138;448;261;870
420630;201608;1016;3106;725;2427;153;541;237;748;390;1289
420640;201608;800;2391;383;1405;90;372;26;86;116;458
420650;201608;2573;7458;1602;5449;248;907;363;1154;611;2061
420660;201608;475;1373;336;1083;71;257;92;280;163;537
420665;201608;704;1973;459;1507;71;258;132;387;203;645
420670;201608;1699;4971;1171;3863;217;840;274;822;491;1662
420675;201608;209;668;150;528;27;101;40;135;67;236
420680;201608;519;1224;296;882;46;153;99;282;145;435
420690;201608;871;2962;633;2305;89;318;98;309;187;627
420700;201608;3245;9487;2484;7959;477;1696;778;2345;1255;4041
420710;201608;606;2004;452;1669;116;479;134;467;250;946
420720;201608;1745;4893;1326;4332;364;1270;602;1961;966;3231
420730;201608;3318;9840;2671;8710;623;2224;1043;3287;1666;5511
420740;201608;830;2557;675;2260;227;826;224;684;451;1510
420750;201608;2402;7585;1741;6057;256;1034;506;1582;762;2616
420757;201608;104;245;43;148;6;25;19;66;25;91
420760;201608;366;1132;199;668;39;144;29;75;68;219
420765;201608;588;1851;308;1139;61;257;54;187;115;444
420768;201608;1202;4126;946;3595;386;1482;287;1150;673;2632
420770;201608;644;1872;351;1287;72;304;64;237;136;541
420775;201608;644;1901;369;1233;77;270;59;173;136;443
420780;201608;1518;4569;907;3089;172;592;129;417;301;1009
420785;201608;284;856;204;657;31;106;48;141;79;247
420790;201608;1277;4325;994;3680;289;1168;322;1127;611;2295
420800;201608;876;2465;423;1414;102;363;89;291;191;654
420810;201608;2048;6881;1613;5925;469;1957;321;1070;790;3027
420820;201608;8339;24703;5753;20258;1385;5508;1356;4642;2741;10150
420830;201608;2729;8511;2226;7572;623;2324;724;2410;1347;4734
420840;201608;1007;2950;486;1738;93;389;76;239;169;628
420845;201608;1367;4053;954;3328;246;993;201;668;447;1661
420850;201608;1639;5098;990;3694;198;845;59;205;257;1050
420860;201608;450;1255;272;920;69;276;71;232;140;508
420870;201608;1147;3190;888;2772;288;1040;227;623;515;1663
420880;201608;1010;3342;768;2716;147;555;129;424;276;979
420890;201608;10250;27006;5124;16759;769;2732;1124;3171;1893;5903
420895;201608;250;686;127;419;33;106;13;40;46;146
420900;201608;1858;5187;1173;3866;211;796;286;853;497;1649
420910;201608;24818;72887;16670;56621;2944;11238;4749;14895;7693;26133
420915;201608;551;2165;403;1722;86;381;155;618;241;999
420917;201608;480;1472;215;719;38;146;72;209;110;355
420920;201608;183;517;71;256;13;55;10;40;23;95
420930;201608;18226;51978;14018;44723;2924;10285;5145;15818;8069;26103
420940;201608;2881;8589;2172;7145;544;1981;162;432;706;2413
420945;201608;199;606;128;445;23;98;31;92;54;190
420950;201608;639;1761;289;1046;32;163;48;158;80;321
420960;201608;944;2657;739;2291;140;478;286;834;426;1312
420970;201608;2530;7867;2074;7025;634;2388;503;1651;1137;4039
420980;201608;465;1351;342;1149;115;425;113;418;228;843
420985;201608;500;1416;231;823;40;176;51;155;91;331
420990;201608;896;2408;490;1652;72;262;85;230;157;492
421000;201608;569;1903;361;1370;66;270;56;174;122;444
421003;201608;734;1982;268;908;26;98;37;88;63;186
421005;201608;154;473;116;408;22;87;56;201;78;288
421010;201608;5309;14961;3627;11942;848;3108;697;2046;1545;5154
421020;201608;487;1479;370;1283;42;152;194;691;236;843
421030;201608;743;2684;660;2463;195;797;93;330;288;1127
421040;201608;909;2286;574;1756;86;309;277;813;363;1122
421050;201608;1668;4740;975;3256;180;656;196;564;376;1220
421055;201608;194;547;99;313;22;73;17;34;39;107
421060;201608;521;1745;343;1255;76;311;101;363;177;674
421070;201608;696;2215;430;1536;91;352;56;187;147;539
421080;201608;533;1617;451;1492;88;284;287;964;375;1248
421085;201608;557;1470;284;953;52;196;70;217;122;413
421090;201608;429;1190;203;676;22;88;63;187;85;275
421100;201608;956;2570;495;1576;129;423;41;125;170;548
421105;201608;1488;4471;1196;3963;268;953;372;1290;640;2243
421110;201608;990;3536;898;3322;317;1248;178;589;495;1837
421120;201608;1355;4343;906;3225;123;522;218;687;341;1209
421125;201608;408;1119;299;929;84;302;86;235;170;537
421130;201608;3340;10878;2827;9882;914;3490;853;3011;1767;6501
421140;201608;353;1010;257;817;46;139;87;263;133;402
421145;201608;567;1779;348;1191;50;171;98;336;148;507
421150;201608;607;1758;434;1465;82;309;171;559;253;868
421160;201608;1230;3365;593;1934;113;413;179;539;292;952
421165;201608;281;950;220;780;32;112;83;299;115;411
421170;201608;1334;3826;1064;3409;203;710;589;1861;792;2571
421175;201608;1255;3504;871;2848;169;675;287;851;456;1526
421180;201608;575;1581;296;991;58;229;43;125;101;354
421185;201608;405;1126;286;895;42;114;136;457;178;571
421187;201608;290;850;214;696;40;135;91;278;131;413
421189;201608;419;1280;340;1113;67;239;89;268;156;507
421190;201608;11917;33829;7204;24482;1376;5208;971;3052;2347;8260
421200;201608;943;3066;793;2758;173;628;218;714;391;1342
421205;201608;260;788;192;649;40;163;44;125;84;288
421210;201608;1507;4568;1127;3682;280;943;275;894;555;1837
421220;201608;1944;6532;1678;5941;470;1864;267;815;737;2679
421223;201608;534;1679;393;1386;97;362;117;412;214;774
421225;201608;1125;3547;944;3178;190;711;362;1223;552;1934
421227;201608;805;2556;709;2401;149;559;382;1254;531;1813
421230;201608;448;1456;392;1356;93;361;166;550;259;911
421240;201608;420;1321;229;834;26;111;36;116;62;227
421250;201608;1731;4947;1113;3856;294;1097;204;708;498;1805
421260;201608;360;1025;100;361;21;77;18;60;39;137
421265;201608;762;2296;669;2146;112;405;395;1234;507;1639
421270;201608;848;2239;418;1369;76;259;73;265;149;524
421280;201608;1645;5159;1293;4529;368;1479;406;1354;774;2833
421290;201608;1067;2956;623;2011;102;349;101;289;203;638
421300;201608;308;932;235;774;64;254;86;252;150;506
421310;201608;238;737;183;610;33;119;57;176;90;295
421315;201608;361;1040;191;676;29;103;15;55;44;158
421320;201608;654;1961;396;1357;60;214;61;146;121;360
421330;201608;560;1820;428;1567;129;513;78;297;207;810
421335;201608;507;1670;414;1484;89;365;82;306;171;671
421340;201608;1776;5045;1394;4431;193;764;747;2315;940;3079
421350;201608;994;3237;835;2896;151;621;403;1321;554;1942
421360;201608;2999;8580;1886;6391;390;1509;494;1512;884;3021
421370;201608;689;2295;525;1931;137;564;146;523;283;1087
421380;201608;972;2726;797;2393;117;395;384;1119;501;1514
421390;201608;174;501;69;245;21;83;23;79;44;162
421400;201608;272;899;186;730;49;212;52;187;101;399
421410;201608;335;955;215;720;26;89;89;298;115;387
421415;201608;365;1191;166;617;34;129;29;99;63;228
421420;201608;876;2617;643;2092;98;349;209;636;307;985
421430;201608;237;733;179;617;27;103;37;134;64;237
421440;201608;853;2459;570;1943;124;485;222;741;346;1226
421450;201608;492;1507;289;1044;49;192;27;105;76;297
421460;201608;642;1752;342;1195;60;243;70;246;130;489
421470;201608;433;1431;337;1216;93;364;90;308;183;672
421480;201608;3138;8810;1964;6687;577;2301;265;684;842;2985
421490;201608;278;837;128;491;23;107;19;63;42;170
421500;201608;2208;7447;1813;6622;555;2292;218;768;773;3060
421505;201608;361;1198;314;1090;71;246;142;498;213;744
421507;201608;527;1581;335;1173;63;230;94;346;157;576
421510;201608;178;589;153;546;24;115;72;203;96;318
421520;201608;896;2379;584;1737;68;247;232;600;300;847
421530;201608;417;1290;255;929;40;174;56;201;96;375
421535;201608;690;1991;375;1345;54;218;145;473;199;691
421540;201608;330;885;249;749;49;159;87;232;136;391
421545;201608;839;2638;611;2194;138;561;149;507;287;1068
421550;201608;2021;6402;1692;5828;494;1901;487;1591;981;3492
421555;201608;328;956;115;408;19;74;14;45;33;119
421560;201608;211;646;92;318;18;65;16;53;34;118
421565;201608;851;2451;737;2293;251;876;290;906;541;1782
421567;201608;636;2322;560;2147;279;1099;111;433;390;1532
421568;201608;514;1568;335;1140;67;240;87;292;154;532
421569;201608;231;698;102;375;15;54;15;56;30;110
421570;201608;1387;4163;780;2712;176;669;115;366;291;1035
421575;201608;449;1466;384;1325;68;241;197;697;265;938
421580;201608;3069;9626;2269;7852;543;2114;537;1630;1080;3744
421590;201608;219;676;177;596;23;82;91;299;114;381
421600;201608;542;1624;399;1308;88;313;82;230;170;543
421605;201608;636;1928;461;1603;84;337;120;388;204;725
421610;201608;1420;3832;1023;3116;141;479;445;1284;586;1763
421620;201608;4517;13526;2979;10337;790;2923;800;2760;1590;5683
421625;201608;382;1057;154;528;27;91;13;46;40;137
421630;201608;3043;8974;1693;5792;336;1254;226;719;562;1973
421635;201608;242;724;125;415;15;58;35;93;50;151
421640;201608;1067;3142;752;2517;167;572;280;926;447;1498
421650;201608;2126;6793;1592;5570;371;1489;184;524;555;2013
421660;201608;7812;25065;6328;22057;1389;5402;1866;5990;3255;11392
421670;201608;1088;3283;751;2531;184;706;207;646;391;1352
421680;201608;1149;3656;938;3210;291;1044;175;572;466;1616
421690;201608;1641;5319;1230;4384;241;953;111;339;352;1292
421700;201608;500;1613;283;1062;47;189;62;200;109;389
421710;201608;214;717;109;403;22;85;28;92;50;177
421715;201608;262;695;139;441;32;111;36;98;68;209
421720;201608;1876;5493;1148;3986;275;1051;154;441;429;1492
421725;201608;132;416;103;350;28;101;23;69;51;170
421730;201608;596;1711;293;998;42;152;55;161;97;313
421740;201608;769;2448;533;1881;113;446;95;296;208;742
421750;201608;1024;2705;620;1906;115;391;236;655;351;1046
421755;201608;321;925;185;601;38;136;56;175;94;311
421760;201608;852;2532;429;1519;71;276;93;294;164;570
421770;201608;3025;9037;2269;7536;576;2005;694;2382;1270;4387
421775;201608;506;1475;354;1194;58;227;114;362;172;589
421780;201608;1216;4062;914;3343;216;888;230;758;446;1646
421790;201608;800;2148;461;1587;108;415;127;399;235;814
421795;201608;353;1037;221;710;36;129;59;188;95;317
421800;201608;2770;8201;2064;6872;457;1723;727;2262;1184;3985
421810;201608;614;1894;432;1519;108;423;52;171;160;594
421820;201608;1038;3007;624;2115;97;344;98;290;195;634
421825;201608;1468;4632;1370;4430;158;599;971;3050;1129;3649
421830;201608;2475;8399;2175;7773;494;1961;788;2659;1282;4620
421835;201608;161;472;117;408;19;85;73;244;92;329
421840;201608;297;952;214;765;47;198;65;202;112;400
421850;201608;405;1296;239;861;38;165;43;148;81;313
421860;201608;319;973;203;733;33;132;44;131;77;263
421870;201608;3942;11069;2724;8646;765;2637;466;1415;1231;4052
421875;201608;412;1236;186;693;35;151;17;58;52;209
421880;201608;875;2669;646;2176;126;481;133;416;259;897
421885;201608;307;984;247;875;74;282;75;256;149;538
421890;201608;878;2967;757;2726;246;1036;230;762;476;1798
421895;201608;375;1186;333;1113;72;261;184;617;256;878
421900;201608;967;2683;601;1925;154;520;152;455;306;975
421910;201608;494;1555;329;1174;69;302;42;107;111;409
421915;201608;505;1497;304;1014;54;173;57;176;111;349
421917;201608;589;1668;414;1411;148;580;115;376;263;956
421920;201608;761;2116;481;1735;253;956;96;349;349;1305
421930;201608;3202;8388;1727;5766;382;1367;218;648;600;2015
421935;201608;667;2166;494;1794;96;413;163;547;259;960
421940;201608;274;913;147;540;17;72;28;84;45;156
421950;201608;3689;9964;1738;5827;382;1399;201;656;583;2055
421960;201608;201;594;144;487;30;111;30;92;60;203
421970;201608;2313;6363;1427;4538;399;1327;388;1132;787;2459
421985;201608;496;1287;273;855;38;142;77;242;115;384
422000;201608;1200;3590;988;3182;267;956;357;1140;624;2096
430003;201608;800;2324;613;2007;155;583;156;491;311;1074
430005;201608;333;986;240;810;48;175;99;316;147;491
430010;201608;2170;5830;1623;4906;407;1291;623;1913;1030;3204
430020;201608;723;1798;602;1635;90;278;355;920;445;1198
430030;201608;1052;2722;759;2184;237;739;125;323;362;1062
430040;201608;11286;29379;8290;23989;2141;6785;1165;3143;3306;9928
430045;201608;708;1894;515;1510;97;294;203;577;300;871
430047;201608;295;696;146;437;20;55;53;162;73;217
430050;201608;1109;2983;619;1951;116;372;137;418;253;790
430055;201608;309;830;161;502;26;95;65;195;91;290
430057;201608;76;178;36;103;4;9;5;6;9;15
430060;201608;16800;52975;14429;48896;4039;14772;5404;18461;9443;33233
430063;201608;1009;2942;797;2496;203;651;370;1195;573;1846
430064;201608;1354;3984;1083;3494;270;874;346;1149;616;2023
430066;201608;170;404;119;325;9;30;64;172;73;202
430070;201608;622;1647;173;565;25;95;23;56;48;151
430080;201608;704;1974;420;1403;92;338;112;326;204;664
430085;201608;925;2396;580;1767;105;350;177;561;282;911
430087;201608;937;2843;858;2692;134;499;492;1415;626;1914
430090;201608;850;2217;318;1028;36;127;52;175;88;302
430100;201608;862;2273;437;1386;102;353;112;299;214;652
430105;201608;1016;2939;675;2305;159;615;207;683;366;1298
430107;201608;261;857;187;648;35;132;45;144;80;276
430110;201608;1951;5538;1583;4968;378;1237;698;2126;1076;3363
430120;201608;1782;5238;1302;4231;272;921;554;1768;826;2689
430130;201608;3897;9988;3280;9046;825;2398;1216;3283;2041;5681
430140;201608;1213;3677;808;2751;229;812;223;743;452;1555
430150;201608;769;2046;510;1550;113;368;121;372;234;740
430155;201608;407;1117;217;706;32;120;45;137;77;257
430160;201608;17315;49487;14923;45470;3497;11593;5753;17628;9250;29221
430163;201608;1982;5779;1592;5105;229;826;816;2587;1045;3413
430165;201608;470;1161;128;431;14;47;16;50;30;97
430170;201608;965;2721;376;1338;48;179;32;95;80;274
430175;201608;927;2865;759;2475;207;633;276;987;483;1620
430180;201608;851;2323;688;2060;152;505;330;953;482;1458
430185;201608;599;1544;332;1028;54;173;98;249;152;422
430187;201608;669;1945;515;1629;118;417;157;465;275;882
430190;201608;1723;5069;1486;4610;282;956;783;2405;1065;3361
430192;201608;199;601;93;299;6;18;16;47;22;65
430195;201608;390;1179;93;314;10;37;3;8;13;45
430200;201608;1431;4523;1219;4080;354;1259;285;919;639;2178
430205;201608;593;1672;441;1382;41;155;296;925;337;1080
430210;201608;6497;17059;3845;11639;567;1870;974;2487;1541;4357
430215;201608;365;1009;247;755;43;138;98;284;141;422
430220;201608;749;1889;253;867;37;156;37;123;74;279
430222;201608;283;856;223;730;32;128;101;310;133;438
430223;201608;365;1028;299;910;70;203;134;426;204;629
430225;201608;36;88;16;45;4;12;5;12;9;24
430230;201608;1668;4889;1591;4806;218;531;1314;4157;1532;4688
430235;201608;291;949;234;813;51;193;68;221;119;414
430237;201608;541;1387;388;1133;40;138;236;652;276;790
430240;201608;1043;2682;702;2122;85;317;349;1003;434;1320
430245;201608;864;2638;652;2194;176;605;247;878;423;1483
430250;201608;1210;3438;1052;3178;363;1141;138;415;501;1556
430258;201608;163;459;119;383;10;34;51;175;61;209
430260;201608;806;2257;568;1790;68;220;286;944;354;1164
430265;201608;287;879;226;756;47;157;25;76;72;233
430270;201608;2998;8247;2570;7544;365;1222;1475;4166;1840;5388
430280;201608;4796;12791;3830;11124;877;2621;1634;4761;2511;7382
430290;201608;2503;6489;2289;6188;150;421;1956;5284;2106;5705
430300;201608;9390;27331;7741;24199;1777;6023;3224;10215;5001;16238
430310;201608;6782;20154;5169;17055;1183;4261;1855;5725;3038;9986
430320;201608;870;2509;540;1794;102;302;236;819;338;1121
430330;201608;684;1806;526;1511;138;382;210;577;348;959
430340;201608;711;1776;372;1207;76;254;181;583;257;837
430350;201608;6331;19134;5354;17060;1983;6527;1436;4477;3419;11004
430355;201608;394;983;150;463;25;88;20;57;45;145
430360;201608;1070;2796;861;2429;168;522;350;921;518;1443
430367;201608;291;763;173;540;41;147;55;166;96;313
430370;201608;571;1569;360;1139;85;295;72;196;157;491
430380;201608;869;2232;482;1551;143;502;111;352;254;854
430390;201608;3995;11161;2631;8386;465;1601;384;1148;849;2749
430400;201608;1435;3392;1020;2735;317;885;356;894;673;1779
430410;201608;637;1696;445;1357;77;251;206;621;283;872
430420;201608;3671;10562;2870;8804;775;2445;962;2887;1737;5332
430430;201608;764;2031;476;1506;131;448;103;332;234;780
430435;201608;2064;5564;1538;4615;391;1254;518;1553;909;2807
430440;201608;4042;12598;3154;10577;618;2165;1409;4895;2027;7060
430450;201608;7647;21000;6024;17905;1954;6108;1374;4129;3328;10237
430460;201608;28973;84902;22177;72804;5864;21213;6007;19143;11871;40356
430461;201608;512;1359;162;516;22;70;39;119;61;189
430462;201608;277;791;186;635;32;122;27;99;59;221
430463;201608;4272;13461;3669;12349;801;2908;1607;5499;2408;8407
430465;201608;654;1753;540;1555;146;456;275;773;421;1229
430466;201608;3655;9965;3177;9228;688;2149;1631;4572;2319;6721
430467;201608;510;1503;435;1360;88;298;174;514;262;812
430468;201608;1462;4044;1230;3695;311;986;458;1327;769;2313
430469;201608;480;1299;61;212;8;26;7;18;15;44
430470;201608;7764;20619;5466;16768;1552;5134;857;2583;2409;7717
430471;201608;585;1900;510;1740;144;504;113;401;257;905
430480;201608;1003;2645;516;1657;73;257;107;309;180;566
430485;201608;216;592;99;314;15;51;14;35;29;86
430490;201608;329;940;217;706;47;162;88;289;135;451
430495;201608;376;1124;247;853;46;174;68;214;114;388
430500;201608;1209;3304;970;2912;228;778;443;1292;671;2070
430510;201608;21716;62873;17244;54357;5350;18342;4558;13404;9908;31746
430511;201608;403;1238;175;617;27;102;16;39;43;141
430512;201608;1176;2992;993;2675;254;729;288;791;542;1520
430513;201608;816;2092;467;1354;107;335;159;425;266;760
430515;201608;487;1391;349;1107;51;165;149;489;200;654
430517;201608;1196;3743;988;3317;196;674;492;1694;688;2368
430520;201608;1589;4369;1036;3212;240;818;259;702;499;1520
430530;201608;1116;2988;529;1688;66;246;121;344;187;590
430535;201608;2427;7269;1838;6105;392;1422;636;2039;1028;3461
430537;201608;482;1520;414;1380;37;122;297;997;334;1119
430540;201608;748;1653;494;1306;90;246;275;723;365;969
430543;201608;499;1276;436;1211;85;242;298;853;383;1095
430544;201608;687;2182;565;1905;125;463;250;809;375;1272
430545;201608;1341;4230;1153;4000;381;1422;465;1634;846;3056
430550;201608;643;1854;381;1267;83;298;69;210;152;508
430558;201608;101;274;54;166;9;31;14;35;23;66
430560;201608;391;944;182;557;18;68;57;161;75;229
430570;201608;1130;2891;708;2058;156;526;267;653;423;1179
430580;201608;1292;3223;794;2406;133;452;350;1075;483;1527
430583;201608;171;467;54;171;3;9;8;24;11;33
430585;201608;341;888;216;627;46;159;84;209;130;368
430587;201608;193;606;164;542;44;147;41;143;85;290
430590;201608;1257;3457;1153;3280;124;408;831;2304;955;2712
430593;201608;24;88;22;81;5;20;9;31;14;51
430595;201608;305;855;86;288;7;34;10;23;17;57
430597;201608;347;1012;243;763;26;84;55;144;81;228
430600;201608;2109;5606;1126;3410;204;638;308;871;512;1509
430605;201608;1367;4068;1058;3434;206;767;395;1279;601;2046
430607;201608;775;1848;576;1555;67;185;358;998;425;1183
430610;201608;8285;22032;6337;18972;1744;5657;1513;4460;3257;10117
430613;201608;275;669;113;343;15;38;19;49;34;87
430620;201608;762;2141;606;1829;141;448;226;657;367;1105
430630;201608;442;1367;218;740;36;117;27;82;63;199
430632;201608;702;1953;346;1097;55;191;105;286;160;477
430635;201608;609;1735;459;1417;107;379;223;651;330;1030
430637;201608;482;1363;422;1246;57;195;244;678;301;873
430640;201608;1673;4465;773;2516;84;262;38;89;122;351
430642;201608;487;1262;305;925;53;159;126;387;179;546
430645;201608;273;635;105;305;15;42;24;70;39;112
430650;201608;1844;5905;1551;5312;327;1158;817;2836;1144;3994
430655;201608;169;430;145;382;29;101;74;159;103;260
430660;201608;5845;16292;4614;14115;1109;3682;1800;5442;2909;9124
430670;201608;516;1477;472;1400;36;105;357;1098;393;1203
430673;201608;756;1777;345;1033;74;223;91;269;165;492
430675;201608;267;779;96;330;10;39;34;110;44;149
430676;201608;3684;10887;2987;9584;741;2544;902;2923;1643;5467
430680;201608;1175;3355;719;2357;136;444;142;398;278;842
430690;201608;4363;12214;3443;10418;1092;3412;741;2242;1833;5654
430692;201608;272;877;198;733;20;88;127;444;147;532
430693;201608;1303;3566;825;2588;161;575;168;487;329;1062
430695;201608;582;1583;380;1163;68;222;136;374;204;596
430697;201608;492;1365;354;1111;91;299;118;370;209;669
430700;201608;10342;26372;5135;16458;870;3210;292;849;1162;4059
430705;201608;287;859;235;749;79;272;53;144;132;416
430710;201608;1809;4538;1333;3740;257;815;520;1476;777;2291
430720;201608;893;2154;562;1667;132;415;159;472;291;887
430730;201608;1651;4255;1084;3310;230;703;414;1334;644;2037
430740;201608;585;1617;334;1107;72;246;53;187;125;433
430745;201608;506;1419;234;742;27;91;33;104;60;195
430750;201608;1599;4352;1257;3776;229;767;658;1929;887;2696
430755;201608;512;1376;329;997;30;101;133;384;163;485
430760;201608;3092;7487;2104;6070;448;1517;758;2273;1206;3790
430770;201608;6459;18514;5073;15958;954;3232;2541;7875;3495;11107
430780;201608;2498;6594;1498;4728;280;944;441;1357;721;2301
430781;201608;540;1540;351;1148;71;237;80;262;151;499
430783;201608;550;1334;334;972;54;169;145;390;199;559
430786;201608;74;247;49;185;6;27;9;27;15;54
430790;201608;4818;13107;3308;10128;697;2306;1145;3262;1842;5568
430800;201608;915;2556;610;1873;124;406;194;571;318;977
430805;201608;566;1579;358;1137;39;113;169;534;208;647
430807;201608;455;1282;304;947;61;220;80;221;141;441
430810;201608;726;1963;262;887;50;182;52;170;102;352
430820;201608;1353;3983;810;2766;168;601;156;507;324;1108
430825;201608;405;1051;141;429;22;56;23;48;45;104
430830;201608;1754;5386;1606;5170;260;921;990;3135;1250;4056
430840;201608;1011;2993;882;2760;229;703;404;1301;633;2004
430843;201608;85;219;42;128;4;15;14;38;18;53
430845;201608;280;833;230;723;100;337;19;44;119;381
430850;201608;2531;7392;2113;6598;538;1852;764;2300;1302;4152
430860;201608;1065;2832;529;1705;115;441;167;490;282;931
430865;201608;640;1672;566;1554;186;535;249;662;435;1197
430870;201608;727;2003;381;1249;86;292;65;176;151;468
430880;201608;1213;3402;855;2705;216;722;213;720;429;1442
430885;201608;254;602;140;432;20;66;89;277;109;343
430890;201608;1790;4716;1162;3487;139;514;260;670;399;1184
430900;201608;2890;7530;2290;6504;448;1506;1004;2647;1452;4153
430905;201608;1075;3017;677;2187;156;525;126;382;282;907
430910;201608;1598;4644;1067;3505;224;838;361;1023;585;1861
430912;201608;490;1366;366;1142;47;151;224;705;271;856
430915;201608;592;1832;414;1495;135;516;84;336;219;852
430920;201608;17074;51267;14958;47297;2821;9872;8250;25359;11071;35231
430925;201608;137;305;56;159;10;30;16;46;26;76
430930;201608;10071;28175;6829;22148;1822;6317;1405;4784;3227;11101
430940;201608;1299;3901;745;2530;174;625;101;297;275;922
430950;201608;990;2697;648;1995;154;523;213;577;367;1100
430955;201608;171;499;82;267;13;52;20;57;33;109
430957;201608;268;863;216;766;47;165;92;339;139;504
430960;201608;1415;3754;1137;3265;269;870;514;1484;783;2354
430965;201608;1561;4317;1326;3930;70;259;1020;2959;1090;3218
430970;201608;526;1427;299;943;56;182;75;222;131;404
430975;201608;601;1927;464;1606;94;347;185;651;279;998
430980;201608;449;1099;267;828;58;185;84;252;142;437
430990;201608;583;1836;375;1283;67;246;97;318;164;564
430995;201608;620;1758;471;1461;132;428;165;480;297;908
431000;201608;1647;4176;812;2497;122;402;60;166;182;568
431010;201608;2729;7618;1645;5523;274;1012;204;606;478;1618
431020;201608;11445;27761;7311;20586;1744;5105;1693;4618;3437;9723
431030;201608;327;941;153;548;32;125;18;61;50;186
431033;201608;2472;7162;2159;6691;579;1913;969;3061;1548;4974
431036;201608;223;566;91;295;15;48;19;48;34;96
431040;201608;950;2682;744;2318;146;536;357;1042;503;1578
431041;201608;539;1406;467;1307;140;410;171;491;311;901
431043;201608;505;1419;280;978;118;439;55;176;173;615
431046;201608;116;329;82;256;7;26;24;72;31;98
431050;201608;1686;4233;1234;3463;292;856;551;1532;843;2388
431053;201608;608;1926;489;1665;145;541;101;338;246;879
431055;201608;680;1811;627;1727;75;192;456;1277;531;1469
431057;201608;379;1100;229;771;46;170;57;172;103;342
431060;201608;5626;16571;4958;15516;1521;4925;1572;5050;3093;9975
431065;201608;566;1610;410;1293;66;244;133;373;199;617
431070;201608;717;2022;406;1314;85;271;59;150;144;421
431075;201608;298;892;211;704;36;129;62;223;98;352
431080;201608;649;1973;469;1545;96;335;110;336;206;671
431085;201608;848;2297;665;1918;98;295;381;1091;479;1386
431087;201608;595;1663;506;1489;54;153;338;1013;392;1166
431090;201608;528;1293;239;731;52;167;39;111;91;278
431100;201608;3709;10215;2973;8970;746;2438;892;2584;1638;5022
431110;201608;1569;4105;1152;3290;255;752;382;1024;637;1776
431112;201608;571;1831;523;1733;127;430;247;786;374;1216
431113;201608;526;1490;412;1274;104;333;102;333;206;666
431115;201608;1394;3979;1209;3665;213;650;655;2006;868;2656
431120;201608;2736;8261;2072;6918;647;2452;603;1809;1250;4261
431123;201608;467;1339;302;1006;63;207;148;501;211;708
431125;201608;1386;4134;971;3229;297;1014;184;682;481;1696
431127;201608;266;719;65;216;6;16;9;23;15;39
431130;201608;3422;9736;2442;7867;480;1689;751;2418;1231;4107
431140;201608;4957;12094;2766;8419;391;1295;713;1946;1104;3241
431142;201608;467;1355;396;1225;46;150;257;815;303;965
431150;201608;1124;3304;848;2742;175;624;283;898;458;1522
431160;201608;907;2628;747;2317;133;386;354;1216;487;1602
431162;201608;523;1299;220;726;24;83;27;71;51;154
431164;201608;171;474;52;186;10;39;3;12;13;51
431170;201608;733;2009;520;1624;144;471;133;403;277;874
431171;201608;801;2330;696;2125;197;636;225;661;422;1297
431173;201608;484;1394;387;1227;139;483;95;281;234;764
431175;201608;1045;2900;863;2591;244;781;228;662;472;1443
431177;201608;820;2642;633;2277;201;802;227;794;428;1596
431179;201608;375;813;103;298;18;58;19;44;37;102
431180;201608;2375;6690;1585;5117;366;1265;282;854;648;2119
431190;201608;642;1774;364;1162;50;173;63;173;113;346
431198;201608;369;1212;333;1142;117;417;89;330;206;747
431200;201608;409;1157;117;403;12;37;4;10;16;47
431205;201608;291;878;137;478;31;98;37;136;68;234
431210;201608;782;2067;628;1811;170;485;309;920;479;1405
431213;201608;233;714;180;611;25;95;89;303;114;398
431215;201608;292;850;158;546;25;84;9;25;34;109
431217;201608;162;503;121;411;34;122;43;147;77;269
431220;201608;880;2375;504;1572;45;155;210;594;255;749
431225;201608;1366;3755;1063;3203;233;711;375;1136;608;1847
431230;201608;858;2482;640;2034;98;333;273;858;371;1191
431235;201608;115;317;32;99;7;21;4;7;11;28
431237;201608;501;1451;394;1291;82;323;203;639;285;962
431238;201608;41;131;32;110;7;29;8;28;15;57
431240;201608;3148;9262;2741;8600;784;2667;995;3041;1779;5708
431242;201608;387;1170;326;1061;98;327;108;367;206;694
431244;201608;398;914;233;640;26;88;112;278;138;366
431245;201608;1229;3187;836;2456;128;381;377;1097;505;1478
431247;201608;205;581;139;438;36;116;33;98;69;214
431250;201608;1521;4847;1314;4536;349;1322;475;1621;824;2943
431260;201608;355;995;172;601;21;91;50;157;71;248
431261;201608;252;850;216;770;36;167;89;285;125;452
431262;201608;427;1161;189;615;22;84;93;306;115;390
431265;201608;1477;3739;775;2323;140;445;192;467;332;912
431267;201608;241;678;160;488;29;107;95;264;124;371
431270;201608;2831;6994;1765;5206;425;1369;527;1561;952;2930
431275;201608;228;687;125;453;34;126;13;45;47;171
431280;201608;333;922;134;443;15;59;20;41;35;100
431290;201608;329;1006;236;792;45;180;32;73;77;253
431295;201608;90;248;44;138;2;7;14;40;16;47
431300;201608;390;980;65;248;4;17;2;7;6;24
431301;201608;284;868;112;377;19;63;16;43;35;106
431303;201608;769;2032;444;1361;55;193;134;386;189;579
431306;201608;2389;6116;1488;4502;164;584;414;1085;578;1669
431308;201608;39;130;35;116;21;76;7;21;28;97
431310;201608;757;2242;461;1567;84;298;122;426;206;724
431320;201608;798;2189;410;1358;66;234;69;201;135;435
431330;201608;2934;7169;1454;4530;367;1268;85;216;452;1484
431333;201608;426;1144;170;518;25;81;30;77;55;158
431335;201608;54;162;38;128;13;48;6;13;19;61
431337;201608;2555;7642;1865;6264;395;1456;281;907;676;2363
431339;201608;614;1647;417;1244;84;254;184;549;268;803
431340;201608;24708;65354;17806;53253;3967;12878;4180;12211;8147;25089
431342;201608;560;1386;431;1183;128;412;221;544;349;956
431344;201608;367;988;259;792;10;25;183;578;193;603
431346;201608;301;760;107;331;17;56;13;39;30;95
431349;201608;744;2070;445;1361;74;237;150;419;224;656
431350;201608;4218;12239;3377;10682;728;2604;1151;3397;1879;6001
431360;201608;667;1693;431;1284;101;310;118;348;219;658
431365;201608;1402;4098;1179;3724;224;767;615;1976;839;2743
431370;201608;4963;13789;3845;11866;1017;3390;1175;3728;2192;7118
431380;201608;939;2912;859;2745;125;457;488;1524;613;1981
431390;201608;3179;8289;1885;5827;336;1149;476;1312;812;2461
431395;201608;1280;3790;1067;3407;258;873;459;1461;717;2334
431400;201608;386;1199;181;613;34;126;29;93;63;219
431402;201608;1291;3015;755;2099;154;447;331;884;485;1331
431403;201608;258;733;189;617;58;214;41;126;99;340
431405;201608;4165;11553;3344;10303;625;2124;1681;5085;2306;7209
431406;201608;747;2252;552;1854;137;487;246;810;383;1297
431407;201608;551;1563;362;1196;74;250;103;319;177;569
431410;201608;14556;41243;9812;32046;2705;9904;1196;3698;3901;13602
431413;201608;226;565;92;299;8;29;21;60;29;89
431415;201608;731;2054;510;1631;102;377;144;391;246;768
431417;201608;576;1443;476;1304;59;178;289;775;348;953
431420;201608;1378;3748;1202;3475;251;759;515;1576;766;2335
431430;201608;575;1490;340;1030;54;170;121;324;175;494
431440;201608;23322;64271;18797;57034;5411;17434;5379;17372;10790;34806
431442;201608;130;380;80;260;9;30;5;13;14;43
431445;201608;525;1474;214;689;29;93;63;191;92;284
431446;201608;443;1278;308;985;76;253;79;226;155;479
431447;201608;585;1663;449;1382;88;273;198;620;286;893
431449;201608;802;2199;629;1900;58;173;356;1103;414;1276
431450;201608;2238;5421;1944;4995;256;743;1386;3433;1642;4176
431454;201608;63;220;55;199;12;44;21;83;33;127
431455;201608;734;1833;384;1075;92;267;106;270;198;537
431460;201608;3363;9208;2825;8180;736;2179;825;2509;1561;4688
431470;201608;1775;5166;1305;4129;277;868;427;1385;704;2253
431475;201608;203;588;33;129;4;23;1;1;5;24
431477;201608;739;1921;485;1403;61;191;233;640;294;831
431478;201608;284;712;93;270;10;28;13;26;23;54
431480;201608;3061;8432;2331;7158;492;1641;952;2833;1444;4474
431490;201608;112090;299354;95004;273828;11393;38341;63963;179488;75356;217829
431500;201608;604;1671;472;1408;80;238;254;753;334;991
431505;201608;506;1219;339;973;26;70;204;591;230;661
431507;201608;361;884;205;576;40;109;101;282;141;391
431510;201608;1900;5293;1462;4410;328;1038;461;1301;789;2339
431513;201608;313;832;154;470;24;68;67;206;91;274
431514;201608;112;298;45;155;3;12;10;36;13;48
431515;201608;671;1912;461;1431;104;361;155;429;259;790
431517;201608;82;268;63;218;10;38;14;42;24;80
431520;201608;528;1328;246;789;44;168;29;81;73;249
431530;201608;4362;10146;3176;8706;1026;3031;834;2375;1860;5406
431531;201608;274;792;186;598;25;80;61;191;86;271
431532;201608;507;1382;405;1170;79;233;148;416;227;649
431535;201608;348;902;152;467;24;81;44;111;68;192
431540;201608;2073;6759;1821;6377;174;655;1176;4286;1350;4941
431545;201608;342;956;52;181;4;14;8;32;12;46
431550;201608;2261;6571;1960;6032;405;1385;803;2338;1208;3723
431555;201608;698;1724;505;1406;67;187;295;837;362;1024
431560;201608;20711;60686;14633;49109;3394;12719;3065;10832;6459;23551
431570;201608;5968;15156;4739;13557;1313;3865;1980;5804;3293;9669
431575;201608;418;1068;304;891;46;145;64;170;110;315
431580;201608;633;1782;379;1239;69;249;102;310;171;559
431590;201608;977;2618;598;1869;122;383;174;556;296;939
431595;201608;446;1252;347;1043;41;120;193;588;234;708
431600;201608;2060;5617;1480;4591;316;1116;316;946;632;2062
431610;201608;1496;4228;1075;3408;166;539;425;1365;591;1904
431620;201608;487;1423;242;767;55;175;85;240;140;415
431630;201608;1435;3853;884;2701;242;766;230;668;472;1434
431640;201608;6309;17498;5613;16493;1147;3540;3205;9505;4352;13045
431642;201608;517;1375;387;1140;50;157;166;477;216;634
431643;201608;331;870;172;497;29;90;50;118;79;208
431645;201608;1751;4933;1477;4458;248;832;851;2538;1099;3370
431647;201608;157;452;98;319;13;45;16;45;29;90
431650;201608;353;1052;246;812;29;111;68;196;97;307
431660;201608;1169;3280;722;2369;133;478;128;353;261;831
431670;201608;1283;3371;949;2773;192;651;359;949;551;1600
431673;201608;235;649;114;371;24;81;14;38;38;119
431675;201608;685;1762;142;475;18;65;32;91;50;156
431680;201608;9822;26576;7402;22129;1980;6284;1702;5122;3682;11406
431690;201608;23776;65695;18528;56896;4900;15950;5643;17942;10543;33892
431695;201608;142;438;98;328;20;67;23;56;43;123
431697;201608;458;1293;401;1185;101;308;183;556;284;864
431700;201608;1574;4447;1341;4011;214;657;714;2100;928;2757
431710;201608;12648;36128;10309;32421;3289;11128;2341;8006;5630;19134
431720;201608;7285;19997;5461;16452;1187;3841;1713;5017;2900;8858
431725;201608;27;79;14;51;3;13;4;12;7;25
431730;201608;3979;11459;3141;9988;816;2867;796;2659;1612;5526
431740;201608;5298;14609;4206;12675;1354;4483;646;1751;2000;6234
431750;201608;9136;25693;7866;23638;1827;5898;3344;10149;5171;16047
431755;201608;332;912;76;259;14;47;12;37;26;84
431760;201608;4132;11577;3281;10027;590;1975;1411;4103;2001;6078
431770;201608;2043;5387;1669;4822;293;864;938;2700;1231;3564
431775;201608;211;562;133;410;30;91;12;32;42;123
431780;201608;2464;6631;1830;5438;441;1387;382;1049;823;2436
431790;201608;1185;3512;927;2970;152;533;345;1081;497;1614
431795;201608;381;1020;225;676;38;118;67;197;105;315
431800;201608;8730;25474;6916;22083;2068;7132;905;2780;2973;9912
431805;201608;340;831;104;348;17;65;19;66;36;131
431810;201608;3255;8860;2478;7349;453;1448;1064;3061;1517;4509
431820;201608;2565;7878;2199;7176;459;1622;865;2723;1324;4345
431830;201608;10993;26544;8488;22857;2262;6589;3126;8488;5388;15077
431840;201608;2694;8020;2313;7363;554;1894;1008;3255;1562;5149
431842;201608;805;2025;319;981;35;116;68;182;103;298
431843;201608;355;1033;291;913;44;157;136;410;180;567
431844;201608;289;799;83;283;19;72;14;38;33;110
431845;201608;508;1469;378;1190;24;77;235;748;259;825
431846;201608;330;995;285;927;23;91;201;650;224;741
431848;201608;258;699;146;470;15;53;30;89;45;142
431849;201608;478;1167;95;284;13;31;15;39;28;70
431850;201608;4841;14072;4162;12743;951;3074;1426;4311;2377;7385
431860;201608;792;2072;567;1651;93;310;268;735;361;1045
431861;201608;103;299;55;191;7;26;10;28;17;54
431862;201608;486;1578;393;1407;87;364;137;468;224;832
431870;201608;18607;53474;14785;46579;3470;11836;4844;15221;8314;27057
431880;201608;4323;12776;3444;10954;823;2873;1090;3262;1913;6135
431890;201608;5136;13828;3696;11226;1086;3496;745;2363;1831;5859
431900;201608;1112;3085;726;2299;187;683;273;786;460;1469
431910;201608;1027;2454;495;1425;64;176;128;349;192;525
431912;201608;502;1453;412;1291;115;339;155;513;270;852
431915;201608;1299;3501;999;2966;227;704;350;1053;577;1757
431920;201608;1307;3638;1120;3339;134;404;777;2298;911;2702
431930;201608;1256;3394;857;2716;223;690;368;1238;591;1928
431935;201608;56;179;46;157;9;32;11;31;20;63
431936;201608;391;1124;280;870;62;205;107;339;169;544
431937;201608;335;866;185;559;42;137;25;65;67;202
431940;201608;2590;6990;1691;5204;351;1167;420;1256;771;2423
431950;201608;1644;4963;1443;4595;263;951;682;2093;945;3044
431960;201608;2926;8333;2534;7585;633;1974;756;2267;1389;4241
431970;201608;492;1355;230;763;41;150;42;119;83;269
431971;201608;98;287;60;210;8;28;9;28;17;56
431973;201608;474;1606;416;1488;51;184;255;943;306;1127
431975;201608;108;253;24;90;5;22;6;20;11;42
431980;201608;1393;4039;1116;3487;243;796;346;1035;589;1831
431990;201608;7512;20558;5516;17301;979;3435;1670;5019;2649;8454
432000;201608;10233;28340;8118;24723;2501;7846;2564;7802;5065;15648
432010;201608;2258;6299;1817;5509;359;1168;800;2375;1159;3543
432020;201608;2328;5541;1694;4653;310;960;943;2482;1253;3442
432023;201608;518;1456;337;1053;63;216;115;302;178;518
432026;201608;1187;3557;867;2889;134;421;412;1387;546;1808
432030;201608;423;1205;305;942;58;168;142;427;200;595
432032;201608;604;1537;395;1163;69;225;165;441;234;666
432035;201608;835;2489;738;2320;282;969;196;620;478;1589
432040;201608;991;2317;446;1392;71;234;146;451;217;685
432045;201608;254;709;145;494;24;84;40;138;64;222
432050;201608;647;1772;552;1608;95;284;294;887;389;1171
432055;201608;951;2671;662;2142;126;423;324;1034;450;1457
432057;201608;413;994;297;799;46;115;163;420;209;535
432060;201608;556;1473;204;698;34;136;44;130;78;266
432065;201608;224;638;168;538;45;161;60;175;105;336
432067;201608;981;2979;720;2430;136;449;305;1056;441;1505
432070;201608;2373;6538;1538;4838;312;1051;287;860;599;1911
432080;201608;3875;10766;3220;9631;942;3058;1093;3231;2035;6289
432085;201608;321;885;209;700;48;166;97;317;145;483
432090;201608;1523;4322;1186;3672;309;1038;468;1396;777;2434
432100;201608;1366;3920;654;2223;90;329;42;104;132;433
432110;201608;2685;8027;1983;6604;438;1680;188;561;626;2241
432120;201608;4731;13888;3972;12574;1432;4804;935;2918;2367;7722
432130;201608;2743;7440;2203;6750;730;2446;781;2390;1511;4836
432132;201608;391;1093;182;625;26;97;41;134;67;231
432135;201608;745;2187;631;1962;103;333;387;1192;490;1525
432140;201608;1923;6094;1505;5285;339;1242;584;2186;923;3428
432143;201608;1407;4090;1168;3685;207;680;547;1782;754;2462
432145;201608;1285;3875;791;2731;121;473;116;370;237;843
432146;201608;182;582;128;457;31;113;26;98;57;211
432147;201608;649;2036;484;1675;127;471;114;413;241;884
432149;201608;364;1001;233;697;47;137;79;234;126;371
432150;201608;3802;10517;2817;8752;586;2024;798;2395;1384;4419
432160;201608;4578;14208;3966;13108;1163;4066;1291;4373;2454;8439
432162;201608;412;991;72;223;12;42;10;27;22;69
432163;201608;368;983;95;302;3;12;2;3;5;15
432166;201608;693;2026;552;1741;77;277;233;693;310;970
432170;201608;1161;3546;799;2774;172;610;139;463;311;1073
432180;201608;2800;7449;1757;5367;365;1172;324;868;689;2040
432183;201608;416;1285;319;1081;118;434;57;183;175;617
432185;201608;925;2417;588;1804;87;280;269;817;356;1097
432190;201608;3372;9092;2137;6423;434;1363;557;1564;991;2927
432195;201608;1135;3009;818;2481;150;438;344;1030;494;1468
432200;201608;3110;9211;2469;8117;602;2155;1010;3335;1612;5490
432210;201608;427;1162;305;961;68;245;102;307;170;552
432215;201608;851;2560;723;2357;164;499;376;1318;540;1817
432218;201608;277;701;171;493;33;89;51;129;84;218
432220;201608;4259;11159;3415;9792;429;1438;1981;5478;2410;6916
432225;201608;101;305;80;263;30;104;18;64;48;168
432230;201608;1045;2795;629;1887;130;419;149;378;279;797
432232;201608;529;1469;417;1250;71;243;177;509;248;752
432234;201608;367;1016;240;743;46;143;60;174;106;317
432235;201608;110;316;39;135;6;21;1;1;7;22
432237;201608;472;1266;421;1179;19;73;301;816;320;889
432240;201608;14162;43565;11756;40395;1714;6964;6891;24444;8605;31408
432250;201608;4801;16167;4304;15171;1303;4948;1324;4761;2627;9709
432252;201608;427;1121;287;900;50;171;149;483;199;654
432253;201608;1318;4135;761;2650;154;604;48;146;202;750
432254;201608;868;2335;240;787;47;168;22;54;69;222
432255;201608;196;527;121;394;22;76;37;111;59;187
432260;201608;7788;19238;5424;15406;1191;3434;2119;6367;3310;9801
432270;201608;2620;7672;2172;6875;602;2005;597;1902;1199;3907
432280;201608;1422;3835;759;2404;98;321;163;456;261;777
432285;201608;196;613;27;99;4;16;2;4;6;20
432290;201608;568;1642;353;1152;86;279;84;267;170;546
432300;201608;24085;70604;20891;65124;3832;12932;11464;35283;15296;48215
432310;201608;821;2372;639;2062;159;549;293;921;452;1470
432320;201608;231;585;114;353;20;61;18;46;38;107
432330;201608;337;883;132;432;14;47;13;34;27;81
432335;201608;156;443;63;223;12;41;10;26;22;67
432340;201608;316;768;169;511;29;103;52;144;81;247
432345;201608;648;1773;593;1684;75;271;364;942;439;1213
432350;201608;391;1056;203;666;30;92;57;176;87;268
432360;201608;193;587;40;144;5;23;8;20;13;43
432370;201608;423;1176;328;990;37;109;191;591;228;700
432375;201608;767;1907;573;1592;71;194;319;900;390;1094
432377;201608;206;675;38;145;5;18;8;25;13;43
432380;201608;939;3024;785;2715;252;972;287;956;539;1928
500020;201608;2364;6849;1785;5851;357;1355;703;2221;1060;3576
500025;201608;1404;3260;840;2282;79;205;471;1259;550;1464
500060;201608;7042;20716;5546;18183;736;2415;3405;11679;4141;14094
500070;201608;4457;12639;3477;10895;735;2567;1298;4075;2033;6642
500080;201608;1498;4367;1117;3665;280;1015;360;1175;640;2190
500085;201608;2322;5898;1607;4847;142;434;968;2864;1110;3298
500090;201608;2390;6760;1713;5519;339;1137;687;2317;1026;3454
500100;201608;2765;7889;2274;7044;485;1700;832;2462;1317;4162
500110;201608;8473;24596;6598;21681;1121;3997;2869;10032;3990;14029
500124;201608;2080;6568;1784;6066;418;1377;846;3242;1264;4619
500150;201608;1422;3591;960;2817;188;638;339;851;527;1489
500190;201608;4990;12724;3820;11130;782;2432;1909;5702;2691;8134
500200;201608;2479;6173;1852;5065;409;1189;695;1776;1104;2965
500210;201608;4823;14231;3973;12895;914;3113;1715;5681;2629;8794
500215;201608;1535;4678;1161;3918;196;708;403;1359;599;2067
500220;201608;3086;9495;2536;8547;487;1754;1093;3776;1580;5530
500230;201608;2845;7185;2004;5854;401;1260;936;2801;1337;4061
500240;201608;4612;14348;3305;11645;529;2072;941;3497;1470;5569
500260;201608;2799;7028;1977;5773;302;960;954;2686;1256;3646
500270;201608;127259;324262;80119;242419;17478;57011;16984;50755;34462;107766
500280;201608;1372;3444;1117;3099;76;223;859;2422;935;2645
500290;201608;4625;10394;2618;7499;523;1625;858;2412;1381;4037
500295;201608;2717;7795;1635;5379;237;851;381;1051;618;1902
500310;201608;803;2079;650;1860;134;443;320;866;454;1309
500315;201608;3143;9705;2570;8768;351;1225;1550;5534;1901;6759
500320;201608;17468;55256;13637;48130;3863;14890;3303;12329;7166;27219
500325;201608;4165;10599;3029;8832;551;1739;1590;4692;2141;6431
500330;201608;6910;17868;4710;13835;806;2619;1963;5666;2769;8285
500345;201608;2199;5689;1692;4923;382;1202;749;2170;1131;3372
500348;201608;2303;6647;1995;6165;141;530;1394;4253;1535;4783
500350;201608;1281;3737;699;2372;70;242;217;743;287;985
500370;201608;24169;71658;18102;60669;3768;14283;4941;16643;8709;30926
500375;201608;2925;7967;2159;6515;416;1285;575;1721;991;3006
500380;201608;3186;8747;2477;7508;572;1830;954;2877;1526;4707
500390;201608;601;1334;342;937;52;168;163;414;215;582
500400;201608;1380;4132;1008;3256;221;756;232;697;453;1453
500410;201608;2237;6271;1795;5635;371;1226;882;2875;1253;4101
500430;201608;2718;7396;1998;6365;406;1468;745;2483;1151;3951
500440;201608;1496;3904;995;3036;171;562;412;1259;583;1821
500450;201608;1697;4974;1181;3968;230;847;174;491;404;1338
500460;201608;3917;11528;2825;9383;693;2553;531;1665;1224;4218
500470;201608;3084;8934;2120;6862;508;1816;329;963;837;2779
500480;201608;2329;6891;2139;6663;197;523;1614;5483;1811;6006
500490;201608;984;2682;723;2228;210;744;138;437;348;1181
500500;201608;3937;11742;3022;10407;1023;4039;916;3244;1939;7283
500510;201608;865;2217;547;1652;66;215;226;625;292;840
500515;201608;1933;5086;1587;4635;208;628;937;2966;1145;3594
500520;201608;3232;10932;2835;10219;404;1656;1727;6218;2131;7874
500525;201608;1201;3732;952;3263;159;621;424;1500;583;2121
500540;201608;6377;17197;3737;12278;935;3601;439;1234;1374;4835
500560;201608;4740;15347;4271;14624;530;1965;2977;10288;3507;12253
500568;201608;4401;10623;2934;8445;629;2179;846;2187;1475;4366
500570;201608;7919;20709;5025;15292;1249;4097;884;2597;2133;6694
500580;201608;3770;10422;2997;9183;265;823;2123;6627;2388;7450
500600;201608;3999;10514;2564;7874;595;1994;628;1887;1223;3881
500620;201608;7964;22513;5927;18655;1026;3474;2393;7618;3419;11092
500625;201608;756;2165;416;1390;68;241;133;443;201;684
500627;201608;661;1784;443;1369;86;272;94;297;180;569
500630;201608;6166;16643;4367;13615;1064;3562;1252;3844;2316;7406
500635;201608;2776;10130;2283;9371;285;1133;1541;6875;1826;8008
500640;201608;1679;3990;1262;3401;77;237;916;2429;993;2666
500660;201608;19503;55195;14936;47854;4284;15528;3964;12512;8248;28040
500690;201608;2585;7566;2075;6842;952;3322;489;1728;1441;5050
500710;201608;3532;10303;2912;9260;637;2293;1131;3544;1768;5837
500720;201608;6281;16503;3916;12398;931;3239;740;2286;1671;5525
500730;201608;1011;2766;682;2125;158;528;196;586;354;1114
500740;201608;4400;11780;3359;9913;376;1282;1573;4702;1949;5984
500750;201608;982;2682;813;2411;137;449;406;1157;543;1606
500755;201608;1211;3512;804;2684;160;554;146;381;306;935
500769;201608;5536;14489;3097;9536;477;1602;587;1542;1064;3144
500770;201608;1749;5043;1218;4019;282;990;286;959;568;1949
500780;201608;1159;3294;900;2825;222;701;224;690;446;1391
500790;201608;9985;26867;8171;23849;1472;4900;4141;11765;5613;16665
500793;201608;2262;6409;1698;5420;475;1600;301;833;776;2433
500795;201608;2413;7056;2036;6521;261;696;1389;4828;1650;5524
500797;201608;847;2280;576;1805;99;347;206;622;305;969
500800;201608;2971;7822;2234;6757;813;2796;464;1470;1277;4266
500830;201608;20065;52774;13931;41543;2562;8321;4605;13086;7167;21407
500840;201608;1378;3770;888;2772;96;317;338;1015;434;1332
510010;201608;1267;3701;1020;3298;254;816;500;1663;754;2479
510020;201608;3443;9614;2081;6877;422;1496;422;1289;844;2785
510025;201608;7654;22053;5603;18125;1180;4100;1458;4412;2638;8512
510030;201608;1704;4564;1374;4057;242;796;682;1962;924;2758
510035;201608;852;2406;623;2067;130;449;323;1094;453;1543
510040;201608;1807;4837;1374;4178;198;635;728;2238;926;2873
510050;201608;1872;5376;1338;4347;320;1141;382;1205;702;2346
510060;201608;1617;4563;1218;3810;207;689;485;1484;692;2173
510080;201608;1034;3278;818;2842;222;834;111;329;333;1163
510100;201608;688;1773;479;1353;46;146;225;595;271;741
510120;201608;312;672;200;530;13;44;136;359;149;403
510125;201608;3200;8307;2407;6932;400;1342;904;2399;1304;3741
510130;201608;1779;4908;1448;4342;378;1225;440;1303;818;2528
510140;201608;2890;9033;2252;8072;936;3775;379;1121;1315;4896
510160;201608;1318;4387;1192;4194;198;768;726;2539;924;3307
510170;201608;5279;15749;4238;13957;787;2822;1826;5876;2613;8698
510180;201608;12477;32054;8542;25814;2367;7579;2250;7762;4617;15341
510185;201608;1363;4011;1124;3677;159;516;693;2543;852;3059
510190;201608;2430;6675;1713;5622;295;1065;858;2929;1153;3994
510250;201608;14093;41969;12033;38857;3624;12549;4265;14276;7889;26825
510260;201608;2171;8894;1821;8204;351;1529;927;4850;1278;6379
510263;201608;4165;11044;3030;9240;722;2352;712;2082;1434;4434
510267;201608;5778;16641;3995;12848;781;2737;873;2654;1654;5391
510268;201608;903;2589;770;2404;146;505;440;1359;586;1864
510269;201608;1005;3075;730;2539;236;864;152;511;388;1375
510270;201608;2737;8835;2237;7814;470;1678;786;2707;1256;4385
510279;201608;1836;5587;1465;4820;369;1291;430;1275;799;2566
510285;201608;1246;3611;957;3123;260;938;278;859;538;1797
510300;201608;3417;9788;2785;8895;200;717;2042;6638;2242;7355
510305;201608;1527;4688;1170;4035;281;1047;349;1225;630;2272
510310;201608;795;2394;657;2141;216;734;179;568;395;1302
510320;201608;3738;10562;2836;8918;597;2177;798;2362;1395;4539
510325;201608;5206;16150;4376;15035;1192;4301;2439;8727;3631;13028
510330;201608;2777;8701;2193;7656;529;1954;721;2597;1250;4551
510335;201608;4918;14574;3965;13383;516;1735;2626;9414;3142;11149
510336;201608;598;1826;441;1526;83;299;200;695;283;994
510337;201608;2045;6621;1621;5817;616;2342;235;865;851;3207
510340;201608;78148;206477;53751;167999;16840;58840;8935;28773;25775;87613
510343;201608;1121;3182;865;2712;105;351;497;1565;602;1916
510345;201608;1627;4790;1293;4204;311;1101;436;1360;747;2461
510350;201608;3259;8726;2438;7561;581;1922;1046;3391;1627;5313
510360;201608;1778;4323;1119;3511;106;417;771;2385;877;2802
510370;201608;1342;4297;1067;3856;233;883;541;2068;774;2951
510380;201608;528;1535;304;1056;86;320;24;80;110;400
510385;201608;958;3589;688;2967;79;378;303;1455;382;1833
510390;201608;1096;3457;953;3199;251;782;467;1680;718;2462
510395;201608;774;1866;547;1537;78;253;224;716;302;969
510410;201608;3870;12379;3322;11339;815;2892;1529;5391;2344;8283
510420;201608;2439;6071;1806;5045;205;656;899;2493;1104;3149
510450;201608;658;1717;452;1393;99;340;124;366;223;706
510452;201608;676;2141;507;1750;75;257;263;914;338;1171
510454;201608;876;2724;731;2447;91;313;465;1605;556;1918
510455;201608;987;3014;728;2456;129;500;239;761;368;1261
510460;201608;2308;5959;1716;5118;200;725;946;2699;1146;3424
510480;201608;4621;11915;3237;9434;627;1900;953;2624;1580;4524
510490;201608;1607;4958;1358;4576;305;1155;700;2287;1005;3442
510500;201608;1533;4505;1040;3541;205;828;446;1450;651;2278
510510;201608;2704;9186;2307;8463;663;2632;592;2238;1255;4870
510515;201608;6347;18942;4501;14913;912;3328;928;2842;1840;6170
510517;201608;1620;4807;1308;4221;361;1219;282;887;643;2106
510520;201608;2143;4881;1522;4110;58;167;1009;2956;1067;3123
510523;201608;1001;2914;880;2710;114;341;612;1969;726;2310
510525;201608;8211;21367;5591;17249;1053;3335;1876;5759;2929;9094
510530;201608;533;1505;445;1378;44;199;298;872;342;1071
510550;201608;2781;8943;2159;7728;568;2201;655;2323;1223;4524
510558;201608;1910;5446;1613;5018;201;693;921;2991;1122;3684
510560;201608;1722;5146;1099;4104;301;1235;213;838;514;2073
510562;201608;5411;15701;4059;13016;1082;3730;913;3059;1995;6789
510590;201608;3293;8352;2548;7432;483;1371;1449;4449;1932;5820
510600;201608;1616;4108;1066;3193;195;613;375;1100;570;1713
510610;201608;2946;8291;2353;7393;201;718;1519;4726;1720;5444
510615;201608;2069;6247;1734;5703;509;1745;695;2375;1204;4120
510617;201608;619;1816;517;1643;36;92;404;1355;440;1447
510618;201608;1498;4264;1083;3456;204;777;472;1427;676;2204
510619;201608;799;2199;468;1558;46;172;55;146;101;318
510620;201608;1435;3560;795;2546;193;693;104;277;297;970
510621;201608;847;2894;746;2691;193;785;196;662;389;1447
510622;201608;3914;11792;2778;9390;689;2522;439;1350;1128;3872
510623;201608;3354;9372;2592;8075;616;2112;855;2503;1471;4615
510624;201608;1496;4312;917;3087;167;641;174;529;341;1170
510625;201608;2094;5860;1592;5028;424;1489;255;797;679;2286
510626;201608;1587;4199;1029;3404;311;1169;207;679;518;1848
510627;201608;729;2084;490;1573;128;448;100;319;228;767
510628;201608;1569;3857;1088;3186;176;519;654;1940;830;2459
510629;201608;1794;5770;1438;4989;424;1622;386;1323;810;2945
510630;201608;2495;8337;1777;6815;390;1663;268;1042;658;2705
510631;201608;383;1076;324;966;18;45;263;793;281;838
510637;201608;2746;7978;2334;7318;802;2754;705;2158;1507;4912
510642;201608;4751;15599;4077;14618;1248;4980;1609;6007;2857;10987
510645;201608;974;2192;625;1721;204;543;157;473;361;1016
510650;201608;6342;20692;5702;19944;1468;5363;3385;12357;4853;17720
510665;201608;1743;4510;1054;3250;175;552;392;1263;567;1815
510670;201608;401;906;227;661;19;68;110;318;129;386
510675;201608;6463;19989;5115;17382;1428;5385;1022;3409;2450;8794
510677;201608;1911;5193;1575;4762;172;526;1152;3653;1324;4179
510680;201608;722;2157;527;1763;113;400;84;248;197;648
510682;201608;2116;6706;1606;5703;438;1738;279;942;717;2680
510685;201608;952;2519;749;2209;85;283;453;1304;538;1587
510700;201608;4342;11146;2918;9140;655;2092;1276;4172;1931;6264
510704;201608;9832;25791;7440;21752;1404;4533;3048;8408;4452;12941
510706;201608;1920;5727;1313;4818;275;1033;640;2530;915;3563
510710;201608;3386;9272;2371;7239;501;1582;637;1782;1138;3364
510715;201608;724;1758;473;1325;73;211;181;533;254;744
510718;201608;2352;5811;1525;4836;684;2224;321;1211;1005;3435
510719;201608;423;960;254;738;24;95;121;344;145;439
510720;201608;1165;2828;834;2366;210;665;274;671;484;1336
510724;201608;736;2205;556;1860;108;396;201;629;309;1025
510726;201608;639;1554;471;1290;67;189;256;669;323;858
510729;201608;727;1816;395;1202;90;318;122;363;212;681
510730;201608;2797;7929;2019;6514;543;1898;475;1482;1018;3380
510735;201608;993;3233;763;2877;163;684;360;1375;523;2059
510740;201608;1151;2759;799;2243;150;403;385;1165;535;1568
510757;201608;726;2373;597;2128;262;959;141;478;403;1437
510760;201608;32549;82405;21578;64559;5851;19180;4110;11640;9961;30820
510770;201608;4427;11016;3681;10121;359;944;2362;7260;2721;8204
510774;201608;355;993;315;929;58;198;151;479;209;677
510775;201608;715;2092;582;1860;173;626;148;422;321;1048
510776;201608;551;1510;421;1244;102;339;151;433;253;772
510777;201608;1586;4617;1174;4067;153;552;895;3150;1048;3702
510779;201608;634;1898;479;1607;69;233;222;777;291;1010
510780;201608;3792;11046;3070;9958;753;2536;1185;4161;1938;6697
510785;201608;1758;5082;1280;4245;356;1222;210;733;566;1955
510787;201608;2322;6917;1819;6038;753;2658;262;808;1015;3466
510788;201608;570;1454;408;1220;144;448;107;376;251;824
510790;201608;16319;46760;10908;36487;2095;8052;1072;3672;3167;11724
510792;201608;8417;24290;5645;19023;1052;3927;830;2651;1882;6578
510794;201608;1227;3790;977;3306;296;1122;254;808;550;1930
510795;201608;8169;24148;5934;19971;1511;5638;1077;3844;2588;9482
510800;201608;1631;4535;1267;3994;269;924;522;1529;791;2453
510805;201608;2005;5498;1492;4651;315;1095;663;1966;978;3061
510810;201608;662;1620;504;1400;141;388;224;607;365;995
510820;201608;759;1743;484;1345;87;293;174;422;261;715
510830;201608;704;2069;571;1867;119;398;275;966;394;1364
510835;201608;651;1912;489;1613;95;344;192;601;287;945
510840;201608;47556;118209;37596;105228;8978;26368;16599;48008;25577;74376
510850;201608;1660;4546;1068;3469;262;922;136;396;398;1318
510860;201608;2700;8231;1907;6713;591;2347;115;370;706;2717
510880;201608;623;2047;530;1882;164;627;192;693;356;1320
510885;201608;649;1805;517;1623;90;302;206;647;296;949
510890;201608;849;2636;690;2403;161;634;332;1142;493;1776
510895;201608;1113;3383;925;3013;208;774;341;1022;549;1796
520005;201608;1476;4638;1298;4382;378;1285;582;2062;960;3347
520010;201608;1748;5823;1404;5115;508;2101;222;705;730;2806
520013;201608;3388;9449;2492;7755;580;1889;726;2297;1306;4186
520015;201608;475;1349;383;1216;84;296;135;443;219;739
520017;201608;1073;3141;885;2823;218;772;327;965;545;1737
520020;201608;462;1183;354;1034;69;213;153;438;222;651
520025;201608;27813;84666;25964;82403;3080;10482;19971;63371;23051;73853
520030;201608;4716;14476;3911;13129;691;2573;1943;6564;2634;9137
520050;201608;430;1077;290;854;16;41;184;566;200;607
520055;201608;763;2296;668;2103;113;343;367;1187;480;1530
520060;201608;1356;4229;1150;3824;259;969;383;1213;642;2182
520080;201608;1838;5283;1536;4889;288;863;843;2905;1131;3768
520082;201608;1098;2929;969;2724;141;347;623;1831;764;2178
520085;201608;841;2513;729;2320;163;515;236;745;399;1260
520090;201608;983;2271;709;1929;153;362;353;1072;506;1434
520110;201608;42106;120700;32503;106155;11439;42560;4293;13542;15732;56102
520120;201608;196;512;124;387;22;81;28;90;50;171
520130;201608;3403;9476;3063;8984;657;2123;1562;4673;2219;6796
520140;201608;37808;120766;31825;109712;10843;40751;4689;15913;15532;56664
520145;201608;373;1010;261;810;53;176;70;208;123;384
520150;201608;500;1305;408;1201;61;211;227;652;288;863
520160;201608;893;2384;721;2130;197;584;198;613;395;1197
520170;201608;4448;10105;3457;8977;253;678;2828;7481;3081;8159
520180;201608;2112;6119;1740;5560;287;1092;864;2718;1151;3810
520215;201608;1981;5031;1614;4450;182;517;1018;2851;1200;3368
520235;201608;703;1808;509;1515;93;319;201;570;294;889
520250;201608;1549;4369;1112;3634;287;1055;235;741;522;1796
520260;201608;793;1996;518;1496;91;289;170;457;261;746
520280;201608;564;1619;497;1531;157;503;183;637;340;1140
520310;201608;1216;2885;847;2291;221;653;265;778;486;1431
520320;201608;1873;5761;1537;5132;124;418;985;3385;1109;3803
520330;201608;2721;8309;2067;7188;525;1991;289;977;814;2968
520340;201608;1868;4672;1420;4073;208;524;902;2782;1110;3306
520350;201608;3327;8950;2543;7529;688;2223;883;2535;1571;4758
520355;201608;1101;3576;982;3394;272;1021;424;1439;696;2460
520357;201608;866;2318;718;2075;66;208;477;1386;543;1594
520360;201608;703;2007;590;1819;156;503;221;703;377;1206
520380;201608;1304;3494;870;2652;118;386;362;1072;480;1458
520390;201608;1104;2600;644;1993;182;654;192;536;374;1190
520393;201608;524;1259;412;1100;55;148;239;631;294;779
520396;201608;697;2236;571;1987;71;289;355;1205;426;1494
520400;201608;1670;4764;1413;4388;254;844;831;2556;1085;3400
520410;201608;1537;3678;1097;3055;218;685;572;1563;790;2248
520420;201608;327;903;240;728;41;136;82;221;123;357
520425;201608;1223;3353;993;2938;269;804;415;1272;684;2076
520430;201608;1923;5070;1186;3686;243;749;181;506;424;1255
520440;201608;3734;9546;2496;7327;699;2260;471;1364;1170;3624
520450;201608;10746;29218;7278;22961;1481;5110;413;1224;1894;6334
520455;201608;683;2008;539;1768;150;522;190;628;340;1150
520460;201608;902;2530;737;2254;109;392;410;1213;519;1605
520465;201608;834;2268;719;2124;78;269;476;1375;554;1644
520470;201608;1762;5641;1573;5344;354;1238;948;3354;1302;4592
520480;201608;959;2735;651;2150;105;359;195;567;300;926
520485;201608;1315;4111;1144;3849;255;946;643;2172;898;3118
520490;201608;4107;12578;3239;11231;946;3308;1380;5033;2326;8341
520495;201608;1376;3612;1161;3339;93;288;894;2658;987;2946
520500;201608;1326;3694;1089;3351;281;944;440;1332;721;2276
520505;201608;739;2086;627;1910;133;402;315;963;448;1365
520510;201608;9209;25513;6591;21399;1489;5332;1985;6596;3474;11928
520520;201608;1084;2983;861;2663;269;875;236;759;505;1634
520530;201608;1999;6512;1630;5878;576;2098;414;1659;990;3757
520540;201608;2863;7982;2084;6528;530;1736;333;1066;863;2802
520545;201608;1093;3268;901;2920;168;592;262;798;430;1390
520547;201608;666;2079;566;1893;189;636;170;547;359;1183
520549;201608;9699;28346;8080;26154;2312;7853;3567;11777;5879;19630
520551;201608;3688;11133;3381;10692;827;2883;2012;6286;2839;9169
520552;201608;770;2287;691;2187;101;332;478;1546;579;1878
520570;201608;571;1594;417;1333;141;493;127;383;268;876
520580;201608;3230;7838;2250;6495;516;1702;1058;2993;1574;4695
520590;201608;1417;4001;1087;3437;236;769;210;658;446;1427
520620;201608;7815;23339;6909;22108;1684;5592;3677;11960;5361;17552
520630;201608;930;2375;666;1989;113;346;272;807;385;1153
520640;201608;2802;7646;2282;6779;582;1748;859;2645;1441;4393
520650;201608;857;2265;626;1842;116;391;330;952;446;1343
520660;201608;352;999;274;896;96;348;87;289;183;637
520670;201608;957;2795;858;2659;58;181;669;2061;727;2242
520680;201608;775;2031;596;1753;142;408;250;750;392;1158
520690;201608;325;854;246;732;57;149;108;329;165;478
520710;201608;555;1427;347;1027;7;18;210;621;217;639
520725;201608;1609;4097;1193;3412;172;540;722;2035;894;2575
520735;201608;822;2242;581;1794;117;411;190;578;307;989
520740;201608;1765;4699;1392;4223;249;845;732;2191;981;3036
520750;201608;619;1654;489;1461;105;306;223;712;328;1018
520753;201608;1470;3937;1323;3739;166;464;866;2624;1032;3088
520760;201608;827;2186;725;2053;82;223;509;1528;591;1751
520780;201608;1947;4726;1512;4131;157;425;955;2603;1112;3028
520790;201608;2830;7185;2185;6247;201;536;1540;4617;1741;5153
520800;201608;16418;45786;14049;42993;2955;8627;8182;27035;11137;35662
520810;201608;1083;2642;841;2356;89;243;621;1870;710;2113
520815;201608;587;1853;427;1512;173;679;16;56;189;735
520830;201608;1660;4205;1332;3843;42;118;1136;3276;1178;3394
520840;201608;1689;5413;1427;4971;542;2047;261;965;803;3012
520850;201608;599;1825;448;1562;108;416;126;446;234;862
520860;201608;6642;19409;5008;16711;1193;4291;1636;5599;2829;9890
520870;201608;103359;273384;72441;223821;20073;68211;14671;43589;34744;111800
520880;201608;7080;20148;5331;17612;1908;7089;517;1651;2425;8740
520890;201608;3895;10823;3100;9518;615;2097;1419;4310;2034;6407
520910;201608;3901;11137;2807;9064;949;3306;482;1488;1431;4794
520915;201608;650;1924;501;1625;117;402;219;702;336;1104
520920;201608;3500;9309;2502;7758;443;1481;956;3072;1399;4553
520929;201608;618;1622;481;1409;104;295;226;719;330;1014
520940;201608;1075;3053;864;2747;90;323;609;1918;699;2241
520945;201608;658;1580;525;1366;130;298;249;648;379;946
520960;201608;1034;2998;807;2576;67;208;416;1371;483;1579
520970;201608;2891;8702;2481;7977;624;2178;612;1916;1236;4094
520980;201608;767;2191;670;2051;208;683;338;1039;546;1722
520990;201608;2983;9479;2802;9234;359;1217;1906;6625;2265;7842
520993;201608;944;2395;749;2112;48;137;547;1571;595;1708
520995;201608;2325;6159;2018;5787;384;1017;1268;3783;1652;4800
521000;201608;7177;21439;5807;18852;1881;6673;1293;3963;3174;10636
521010;201608;4054;11688;3168;10085;717;2265;1242;3976;1959;6241
521015;201608;695;1893;589;1725;113;310;354;1050;467;1360
521020;201608;3016;8609;2073;6671;553;1908;190;574;743;2482
521030;201608;666;1669;498;1387;104;288;189;547;293;835
521040;201608;6193;16598;5134;15004;1727;5244;1559;4808;3286;10052
521056;201608;862;2590;713;2344;250;890;191;686;441;1576
521060;201608;1118;2895;896;2563;167;469;431;1312;598;1781
521080;201608;1149;2725;680;1976;62;214;267;677;329;891
521090;201608;2989;7988;2339;7139;736;2362;663;2089;1399;4451
521100;201608;2041;4619;1527;3959;243;586;956;2620;1199;3206
521120;201608;4806;12344;3698;10940;814;2596;1468;4720;2282;7316
521130;201608;1027;2772;764;2272;100;366;430;1259;530;1625
521140;201608;1043;3148;847;2768;212;733;268;888;480;1621
521150;201608;12291;30562;7806;22873;2786;8651;1651;4959;4437;13610
521160;201608;853;1997;539;1470;102;283;228;611;330;894
521170;201608;1158;2816;861;2385;168;491;474;1284;642;1775
521180;201608;6489;20768;5828;19648;1596;5735;1923;6565;3519;12300
521190;201608;9441;26892;6286;21006;1492;5489;1171;3863;2663;9352
521200;201608;760;2059;610;1806;69;231;353;1044;422;1275
521205;201608;608;1712;470;1463;46;155;264;822;310;977
521210;201608;930;2572;604;1918;156;581;109;280;265;861
521220;201608;4416;11115;3297;9652;681;2181;1515;4524;2196;6705
521225;201608;398;966;324;885;37;98;227;652;264;750
521230;201608;1204;3758;1084;3536;329;1151;492;1570;821;2721
521250;201608;29823;91770;25605;85435;10939;38627;6053;20889;16992;59516
521260;201608;698;1686;570;1504;96;293;301;756;397;1049
521270;201608;1898;5381;1714;5125;163;425;1254;3924;1417;4349
521280;201608;1848;5565;1511;4922;416;1421;433;1400;849;2821
521290;201608;495;1362;368;1168;89;331;164;490;253;821
521295;201608;1210;2912;995;2627;145;356;688;1908;833;2264
521300;201608;1937;5420;1653;4969;193;541;1015;3105;1208;3646
521305;201608;751;2107;612;1891;118;339;318;1029;436;1368
521308;201608;4440;13077;3504;11264;882;2878;1375;4439;2257;7317
521310;201608;8134;23708;5752;19063;1376;4964;1118;3468;2494;8432
521340;201608;329;849;308;825;20;51;259;693;279;744
521350;201608;1996;5435;1604;4813;256;737;972;3017;1228;3754
521370;201608;953;2771;698;2303;227;809;110;349;337;1158
521375;201608;1328;3770;1147;3455;282;969;523;1390;805;2359
521377;201608;1094;2769;997;2655;63;113;844;2311;907;2424
521380;201608;5549;15604;3978;12681;530;1801;1096;3615;1626;5416
521385;201608;528;1394;455;1304;131;393;201;607;332;1000
521390;201608;797;2204;637;1993;191;692;184;548;375;1240
521400;201608;2074;5904;1904;5695;282;949;1388;4148;1670;5097
521405;201608;1396;3888;1089;3334;311;1020;421;1304;732;2324
521410;201608;723;2192;676;2118;218;640;293;1012;511;1652
521440;201608;1385;4000;1122;3441;183;604;405;1090;588;1694
521450;201608;3922;12539;3163;11049;962;3551;578;1961;1540;5512
521460;201608;6734;19245;5547;17216;1422;4746;2326;7077;3748;11823
521470;201608;697;1988;514;1634;110;364;78;241;188;605
521480;201608;377;1116;254;849;50;175;80;263;130;438
521483;201608;2842;7368;2129;6142;526;1529;596;1688;1122;3217
521486;201608;1639;4141;1320;3681;114;298;956;2688;1070;2986
521487;201608;577;1482;406;1204;119;396;74;197;193;593
521490;201608;792;2230;623;1954;41;173;414;1250;455;1423
521500;201608;1369;4261;1021;3509;184;723;227;675;411;1398
521520;201608;892;2084;674;1794;160;449;320;908;480;1357
521523;201608;13327;47143;12386;45541;4310;17170;1678;6853;5988;24023
521525;201608;1061;2718;891;2469;108;355;553;1482;661;1837
521530;201608;1745;4958;1095;3619;239;834;151;491;390;1325
521540;201608;948;2553;654;2055;127;477;223;671;350;1148
521550;201608;1506;3847;979;2761;196;585;433;1195;629;1780
521560;201608;3744;12074;3099;11169;1207;4774;965;3451;2172;8225
521565;201608;608;1570;513;1452;91;218;318;927;409;1145
521570;201608;4634;12722;2953;9408;630;2190;492;1608;1122;3798
521580;201608;564;1295;348;990;79;226;62;168;141;394
521590;201608;663;1807;527;1590;140;457;156;449;296;906
521600;201608;501;1376;349;1104;74;241;75;234;149;475
521630;201608;1377;3435;973;2851;223;788;197;494;420;1282
521640;201608;2087;5277;1607;4623;426;1245;654;1948;1080;3193
521645;201608;581;1700;430;1389;78;260;140;426;218;686
521680;201608;1373;4397;1160;3990;505;1856;141;466;646;2322
521690;201608;574;1658;505;1542;123;432;222;622;345;1054
521710;201608;2905;8453;2304;7404;461;1554;723;2355;1184;3909
521720;201608;1923;5418;1509;4676;277;858;751;2261;1028;3119
521730;201608;3702;11990;3202;10996;1116;4246;581;1714;1697;5960
521740;201608;3669;10084;2903;8988;632;2134;1275;4196;1907;6330
521760;201608;13765;43844;11960;40750;3202;11847;4469;15415;7671;27262
521770;201608;2628;7595;2104;6622;761;2568;517;1542;1278;4110
521800;201608;6978;21013;5970;19298;1827;6249;2017;6836;3844;13085
521805;201608;934;2094;673;1719;167;390;332;930;499;1320
521810;201608;808;1992;590;1683;108;339;251;754;359;1093
521830;201608;5248;16486;4682;15647;719;2649;3102;10346;3821;12995
521839;201608;732;1993;539;1640;99;306;194;568;293;874
521850;201608;6975;18508;5283;15620;1163;3643;1455;4023;2618;7666
521860;201608;2040;5457;1572;4740;344;1161;434;1308;778;2469
521870;201608;507;1677;422;1505;100;371;136;470;236;841
521878;201608;790;2241;556;1759;75;265;218;648;293;913
521880;201608;23421;59680;15731;47351;4060;13082;4394;13733;8454;26815
521890;201608;3449;10137;2613;8517;696;2423;423;1325;1119;3748
521900;201608;1461;3812;1009;3135;233;767;337;986;570;1753
521910;201608;921;2480;814;2350;134;405;459;1414;593;1819
521920;201608;298;941;245;841;87;327;48;155;135;482
521925;201608;677;2049;552;1811;111;387;184;572;295;959
521930;201608;3593;11439;3082;10458;1021;3640;482;1666;1503;5306
521935;201608;612;1718;518;1548;131;394;234;679;365;1073
521940;201608;1015;2756;824;2474;167;546;411;1206;578;1752
521945;201608;678;2094;579;1931;110;386;292;1036;402;1422
521950;201608;651;1680;527;1500;61;184;350;1005;411;1189
521960;201608;662;1974;531;1717;107;377;222;707;329;1084
521970;201608;2676;6911;2200;6342;180;499;1738;5215;1918;5714
521971;201608;1029;2718;700;2111;110;326;169;492;279;818
521973;201608;958;2926;800;2645;153;521;380;1271;533;1792
521975;201608;12669;34531;11405;33001;2057;6285;7523;21657;9580;27942
521980;201608;2051;5603;1741;5221;252;643;1321;4153;1573;4796
521990;201608;1177;3308;947;2947;110;370;610;1937;720;2307
522000;201608;2291;6189;1657;5378;191;670;916;3151;1107;3821
522005;201608;398;965;275;779;78;215;94;276;172;491
522010;201608;3464;9836;2887;8884;996;3129;620;1939;1616;5068
522015;201608;906;2649;755;2403;165;527;350;1123;515;1650
522020;201608;5204;13365;3973;11486;937;2782;1885;5417;2822;8199
522026;201608;641;1771;470;1555;102;365;157;559;259;924
522028;201608;541;1521;431;1278;52;148;255;759;307;907
522040;201608;2444;5905;1924;5262;374;1033;1199;3340;1573;4373
522045;201608;15438;49785;12678;44173;3324;12698;2126;7287;5450;19985
522050;201608;1163;3282;817;2621;174;579;202;570;376;1149
522060;201608;2714;7973;2144;7097;561;2019;918;3089;1479;5108
522068;201608;1716;5298;1530;5077;172;518;1148;4023;1320;4541
522070;201608;701;2068;620;1935;70;262;416;1277;486;1539
522100;201608;512;1532;437;1424;158;574;172;534;330;1108
522108;201608;870;2635;724;2400;64;255;537;1747;601;2002
522119;201608;1399;4225;1172;3871;266;923;531;1813;797;2736
522130;201608;357;997;290;917;86;279;163;531;249;810
522140;201608;17744;49349;14150;43157;4057;13191;3291;9503;7348;22694
522145;201608;828;2272;706;2091;250;749;270;868;520;1617
522150;201608;994;2615;803;2305;218;623;286;861;504;1484
522155;201608;828;2327;721;2162;135;368;431;1379;566;1747
522157;201608;661;1816;563;1676;38;132;431;1288;469;1420
522160;201608;6104;17210;4390;14106;1175;4161;393;1244;1568;5405
522170;201608;2338;6792;1851;5891;582;1962;389;1207;971;3169
522180;201608;350;1005;259;856;82;297;61;206;143;503
522185;201608;15563;43937;12746;40331;3522;11749;6175;20054;9697;31803
522190;201608;898;2218;683;1911;116;332;316;939;432;1271
522200;201608;1705;5459;1388;4776;336;1235;308;1009;644;2244
522205;201608;1409;3896;1129;3454;200;656;575;1728;775;2384
522220;201608;1400;3652;1125;3321;232;678;598;1900;830;2578
522230;201608;1234;3433;1036;3122;111;404;646;1926;757;2330
530010;201608;225972;697202;198485;649765;51090;184598;67315;214667;118405;399265
110001;201607;3360;11100;2968;10478;652;2429;1567;5632;2219;8061
110002;201607;13198;38375;10205;33156;3196;11269;3218;10430;6414;21699
110003;201607;758;2437;659;2253;208;755;162;540;370;1295
110004;201607;10053;31201;8123;27352;2614;9540;1560;5529;4174;15069
110005;201607;1823;5781;1572;5318;495;1729;668;2281;1163;4010
110006;201607;1931;5786;1294;4543;402;1520;167;540;569;2060
110007;201607;1326;4041;1219;3826;351;1176;511;1817;862;2993
110008;201607;2337;7938;2187;7736;324;1085;1652;6093;1976;7178
110009;201607;4608;13842;3567;12174;1096;4023;1134;3959;2230;7982
110010;201607;7498;22601;6579;21353;1810;5837;3280;11764;5090;17601
110011;201607;7455;23005;6346;20880;2207;7676;2103;6978;4310;14654
110012;201607;15630;44590;12274;38882;3579;12123;3287;10648;6866;22771
110013;201607;5305;16758;4559;15417;1834;6376;1255;4579;3089;10955
110014;201607;4066;11881;3504;10992;907;2942;1849;5878;2756;8820
110015;201607;4901;14598;3452;11781;999;3683;633;2177;1632;5860
110018;201607;4103;11521;3009;9858;790;2918;1087;3439;1877;6357
110020;201607;63513;173493;47144;151190;10592;36369;21184;70722;31776;107091
110025;201607;4255;12169;3450;10740;536;1823;2130;6550;2666;8373
110026;201607;631;1925;578;1843;133;402;338;1138;471;1540
110028;201607;6719;20197;5286;17405;1603;5825;757;2491;2360;8316
110029;201607;1372;3929;1095;3491;306;1019;480;1557;786;2576
110030;201607;10271;27869;7853;24561;2107;7292;3044;9806;5151;17098
110032;201607;3858;11996;3317;10973;1095;3778;990;3253;2085;7031
110033;201607;5182;16472;4634;15534;1594;5386;1704;6145;3298;11531
110034;201607;3399;9100;2754;8217;759;2363;1539;4613;2298;6976
110037;201607;1971;6626;1677;6050;426;1647;770;2780;1196;4427
110040;201607;3417;10637;2888;9667;891;3210;1097;3643;1988;6853
110045;201607;4999;16154;4323;15281;1369;5181;2035;7298;3404;12479
110050;201607;1642;5241;1387;4780;449;1650;609;2118;1058;3768
110060;201607;839;2729;671;2379;237;934;144;505;381;1439
110070;201607;1956;6523;1797;6195;552;2042;782;2625;1334;4667
110080;201607;4359;11847;3749;11156;550;1535;2722;8574;3272;10109
110090;201607;725;2148;571;1874;142;518;261;828;403;1346
110092;201607;1295;4304;1179;4139;194;737;776;2787;970;3524
110094;201607;3577;10674;3065;9954;1044;3579;1238;4091;2282;7670
110100;201607;2152;6789;1943;6411;504;1773;1018;3405;1522;5178
110110;201607;1599;5111;1411;4857;599;2102;374;1399;973;3501
110120;201607;1773;5554;1368;4671;409;1483;283;954;692;2437
110130;201607;2421;6970;1772;5820;573;2020;394;1317;967;3337
110140;201607;2356;7622;1928;6753;583;2229;507;1637;1090;3866
110143;201607;1221;3777;922;3260;296;1106;384;1393;680;2499
110145;201607;1008;2867;800;2533;210;724;397;1251;607;1975
110146;201607;442;1354;373;1249;71;230;205;711;276;941
110147;201607;727;2120;568;1831;144;502;206;623;350;1125
110148;201607;1223;3698;848;2838;185;660;94;287;279;947
110149;201607;3323;9925;2651;8835;892;2970;1112;3941;2004;6911
110150;201607;2422;7028;2004;6422;563;1941;788;2660;1351;4601
110155;201607;855;2619;746;2376;174;602;358;1099;532;1701
110160;201607;1912;6148;1598;5537;577;2068;571;2027;1148;4095
110170;201607;2825;7889;2033;6430;429;1442;1024;3254;1453;4696
110175;201607;1614;4928;1292;4484;224;823;706;2594;930;3417
110180;201607;1277;3712;1060;3387;271;856;583;1913;854;2769
120001;201607;2753;9389;2539;9052;531;1962;1573;5801;2104;7763
120005;201607;1558;6490;1459;6288;174;834;1060;4714;1234;5548
120010;201607;4554;15461;4351;15161;509;1753;3406;12192;3915;13945
120013;201607;1906;7625;1816;7491;421;1729;1104;4843;1525;6572
120017;201607;1968;7130;1836;6888;547;2046;835;3499;1382;5545
120020;201607;14152;62807;13638;61784;2049;9481;9681;45442;11730;54923
120025;201607;2429;8455;2335;8321;449;1659;1508;5491;1957;7150
120030;201607;6422;24911;6253;24717;245;1166;5687;22562;5932;23728
120032;201607;1461;7157;1401;7013;167;1006;1055;5294;1222;6300
120033;201607;3543;14190;3453;14030;245;1058;3019;12371;3264;13429
120034;201607;2120;9011;2025;8815;177;1031;1627;6991;1804;8022
120035;201607;3106;13975;3025;13816;236;1238;2571;11849;2807;13087
120038;201607;2630;9499;2482;9218;610;2317;1380;5307;1990;7624
120039;201607;1730;8436;1687;8339;173;1024;1302;6499;1475;7523
120040;201607;44522;158870;40734;151854;9949;40031;21109;80557;31058;120588
120042;201607;2991;12524;2843;12188;271;1349;2152;9314;2423;10663
120043;201607;887;4136;855;4085;76;365;692;3436;768;3801
120045;201607;4314;14689;4208;14562;438;1642;3578;12412;4016;14054
120050;201607;8069;32999;7680;32175;1058;4767;5353;23171;6411;27938
120060;201607;7699;34123;7523;33806;741;3825;6016;27370;6757;31195
120070;201607;2672;9972;2589;9793;458;1740;1709;6664;2167;8404
120080;201607;3559;13486;3401;13216;577;2368;2440;9688;3017;12056
130002;201607;3096;12738;2916;12464;197;1010;2510;10754;2707;11764
130006;201607;1960;8372;1713;7916;250;1314;1219;5662;1469;6976
130008;201607;2208;8646;2043;8348;158;733;1663;6842;1821;7575
130010;201607;3041;9965;2777;9668;160;637;2485;8667;2645;9304
130014;201607;3184;10379;2782;9729;466;1772;1801;6381;2267;8153
130020;201607;2651;9902;2560;9741;104;568;2228;8363;2332;8931
130030;201607;7617;28621;7307;28263;308;1040;6703;26482;7011;27522
130040;201607;3760;11566;3314;10961;271;984;2694;9054;2965;10038
130050;201607;6093;24852;5729;24352;370;1625;4899;21410;5269;23035
130060;201607;5817;26974;5569;26575;564;3193;4400;21009;4964;24202
130063;201607;3755;16622;3614;16452;279;1377;3180;14620;3459;15997
130068;201607;3191;13280;2869;12600;324;1605;2009;8917;2333;10522
130070;201607;7180;23088;6344;22112;573;2013;5146;18402;5719;20415
130080;201607;5447;23754;5094;23243;682;3562;3750;17278;4432;20840
130083;201607;2154;8471;2017;8266;286;1337;1464;6011;1750;7348
130090;201607;2671;9550;2559;9383;105;481;2288;8400;2393;8881
130100;201607;5784;21158;5631;20974;152;640;5337;19945;5489;20585
130110;201607;6736;21557;6322;21073;617;1943;5243;17986;5860;19929
130115;201607;4521;15934;4291;15579;182;758;3784;13781;3966;14539
130120;201607;14767;55693;13803;54469;1310;5365;11380;45910;12690;51275
130130;201607;3944;15989;3877;15865;224;1128;3408;13935;3632;15063
130140;201607;6267;24375;6153;24247;204;855;5821;22997;6025;23852
130150;201607;3433;13515;3345;13407;161;859;3014;12004;3175;12863
130160;201607;4210;17422;4046;17209;463;2305;3304;14021;3767;16326
130165;201607;2887;11856;2746;11622;218;1134;2262;9585;2480;10719
130170;201607;9463;33055;8245;31576;909;3703;6482;25411;7391;29114
130180;201607;3483;11488;3412;11391;84;297;3229;10831;3313;11128
130185;201607;11578;36611;10317;35187;779;2289;8656;31026;9435;33315
130190;201607;16799;57737;14667;54983;2491;9472;9924;38839;12415;48311
130195;201607;1976;8273;1905;8177;110;466;1687;7379;1797;7845
130200;201607;2054;7077;1861;6778;398;1421;1187;4533;1585;5954
130210;201607;1260;4974;1181;4872;134;675;946;3874;1080;4549
130220;201607;2009;8180;1834;7848;314;1553;1129;4810;1443;6363
130230;201607;3653;16741;3419;16351;411;2083;2627;12927;3038;15010
130240;201607;8801;32680;7993;31571;422;2202;6941;27495;7363;29697
130250;201607;19649;68516;18445;66987;2593;9109;13756;52314;16349;61423
130255;201607;4347;14787;4035;14306;174;685;3561;12744;3735;13429
130260;201607;245890;802370;220269;758954;62782;230857;99820;350122;162602;580979
130270;201607;7403;30496;6873;29683;905;3975;5147;23028;6052;27003
130280;201607;3309;13724;3195;13589;108;494;2968;12779;3076;13273
130290;201607;11398;39986;10875;39386;192;529;10306;38106;10498;38635
130300;201607;4474;17182;4241;16834;266;1252;3673;14629;3939;15881
130310;201607;5005;19152;4622;18643;362;1627;3860;15777;4222;17404
130320;201607;2974;10646;2707;10275;375;1535;1895;7380;2270;8915
130330;201607;3608;13181;3286;12774;214;1046;2777;10809;2991;11855
130340;201607;18089;68669;16765;67044;2264;9010;13204;54516;15468;63526
130350;201607;3293;13678;3206;13551;284;1561;2686;11222;2970;12783
130353;201607;6052;18517;5289;17558;1065;3447;3373;12064;4438;15511
130356;201607;4579;16519;4288;16084;455;1751;3265;12638;3720;14389
130360;201607;3260;9302;2876;8893;95;251;2658;8401;2753;8652
130370;201607;5595;21185;4840;20223;218;1175;4157;17476;4375;18651
130380;201607;7967;32901;7670;32478;498;2425;6597;28079;7095;30504
130390;201607;5117;22465;4784;21832;666;3440;3425;15648;4091;19088
130395;201607;2174;7655;1934;7195;227;915;1376;5108;1603;6023
130400;201607;2147;8081;2029;7907;123;595;1791;7000;1914;7595
130406;201607;10692;40551;9729;39181;1936;8089;6521;26914;8457;35003
130410;201607;3901;14815;3500;14124;1069;4568;1634;6852;2703;11420
130420;201607;10613;44638;10145;43965;1850;7925;7402;33260;9252;41185
130423;201607;3311;12850;3081;12537;286;1409;2561;10372;2847;11781
130426;201607;2308;9876;2231;9751;181;862;1880;8351;2061;9213
130430;201607;3466;12160;3307;11923;289;1090;2747;10062;3036;11152
130440;201607;3534;12843;3326;12603;222;959;2895;11018;3117;11977
140002;201607;1646;5434;1510;5242;134;547;1136;3934;1270;4481
140005;201607;3300;9273;3184;9145;52;126;3077;8893;3129;9019
140010;201607;55753;161388;45906;146900;11390;38643;20180;68424;31570;107067
140015;201607;2862;9155;2679;8933;169;510;2326;7960;2495;8470
140017;201607;3106;9892;2811;9516;274;939;2146;7565;2420;8504
140020;201607;4389;14906;3959;14311;538;2182;2804;10194;3342;12376
140023;201607;2142;7209;1867;6805;205;826;1362;5054;1567;5880
140028;201607;2090;5776;1925;5558;226;758;1446;4050;1672;4808
140030;201607;3750;11749;3477;11396;492;1403;2538;8724;3030;10127
140040;201607;1687;7863;1647;7801;115;712;1455;6802;1570;7514
140045;201607;2457;9112;2236;8806;419;1550;1500;6357;1919;7907
140047;201607;5521;16711;4847;15668;1228;4052;2341;8163;3569;12215
140050;201607;1371;4354;1222;4148;247;872;773;2693;1020;3565
140060;201607;1463;4447;1301;4196;250;872;874;2854;1124;3726
140070;201607;1572;8586;1519;8427;147;974;1191;6614;1338;7588
150010;201607;36111;107787;33943;104902;2395;8286;27778;86230;30173;94516
150013;201607;1738;5062;1567;4866;172;511;1219;3893;1391;4404
150020;201607;12570;41822;12130;41221;1325;4122;9919;34714;11244;38836
150030;201607;7182;30444;6950;30096;646;2556;5831;26037;6477;28593
150034;201607;4258;11742;4011;11436;159;488;3625;10389;3784;10877
150040;201607;13009;41170;11233;39046;1354;4040;8707;32282;10061;36322
150050;201607;5683;22271;5411;21809;308;1530;4662;18806;4970;20336
150060;201607;17932;55688;16247;53047;3172;10284;10315;34999;13487;45283
150070;201607;6038;24416;5403;23746;274;1387;4890;21683;5164;23070
150080;201607;74202;191310;62948;176654;12311;34504;35042;104051;47353;138555
150085;201607;5472;18475;5199;18135;410;1208;4465;16103;4875;17311
150090;201607;10259;39091;9684;38243;872;3597;7691;31009;8563;34606
150095;201607;5277;17174;4795;16488;360;1216;3862;13722;4222;14938
150100;201607;3248;12131;3044;11782;206;967;2435;9300;2641;10267
150110;201607;3362;16553;3349;16529;227;1094;2968;14893;3195;15987
150120;201607;6511;23810;6352;23567;498;1736;5296;20318;5794;22054
150125;201607;711;2089;620;1982;112;390;409;1326;521;1716
150130;201607;22238;67286;20513;64915;2416;7552;15317;49776;17733;57328
150140;201607;164362;457448;153315;443066;17277;49588;117337;345903;134614;395491
150145;201607;4550;14446;4126;13900;496;1789;3217;11018;3713;12807
150150;201607;12073;36466;11075;34996;1769;5938;7421;23777;9190;29715
150157;201607;3130;9369;2725;8797;354;1293;1936;6347;2290;7640
150160;201607;3110;9900;2919;9622;804;2704;1666;5699;2470;8403
150170;201607;21664;79671;20453;77740;2835;11141;14896;57753;17731;68894
150172;201607;3087;10464;2706;9837;379;1428;1926;7182;2305;8610
150175;201607;1902;5762;1775;5619;146;485;1464;4793;1610;5278
150178;201607;10147;31218;8891;29799;1004;3583;6601;22864;7605;26447
150180;201607;18679;74360;17947;73412;1315;6027;15378;63425;16693;69452
150190;201607;6971;23877;6699;23508;228;932;6117;21595;6345;22527
150195;201607;5248;17193;4905;16650;209;752;4330;14844;4539;15596
150200;201607;5338;16821;5076;16520;108;400;4780;15656;4888;16056
150210;201607;25046;93356;24185;92167;2004;7822;20134;78809;22138;86631
150215;201607;7203;22668;6334;21301;1945;6735;2691;9408;4636;16143
150220;201607;11987;37174;10730;35219;2428;8325;5685;19146;8113;27471
150230;201607;11881;37029;10354;34905;1398;5038;6988;24113;8386;29151
150240;201607;35574;105418;30948;97372;10352;33832;9500;31466;19852;65298
150250;201607;4025;16774;3878;16561;721;3026;2727;12176;3448;15202
150260;201607;2039;8080;1943;7914;387;1592;1224;5159;1611;6751
150270;201607;8516;26074;6729;23779;1711;6283;3785;13959;5496;20242
150275;201607;5925;21482;5609;20982;698;2609;4185;16074;4883;18683
150276;201607;2143;6385;1901;6065;316;1082;1385;4460;1701;5542
150277;201607;4821;14799;4166;13992;687;2464;2903;9997;3590;12461
150280;201607;5940;26491;5753;26090;903;4144;4165;19382;5068;23526
150285;201607;2903;11226;2717;10910;367;1603;1892;7771;2259;9374
150290;201607;9977;28522;9529;28018;623;1630;8308;25106;8931;26736
150293;201607;9643;26126;7257;22865;2092;7045;2654;9273;4746;16318
150295;201607;7553;21934;6222;20386;1457;4762;3559;13014;5016;17776
150300;201607;1966;6512;1839;6341;124;585;1486;5055;1610;5640
150304;201607;4146;13054;3581;12163;601;2022;2331;8249;2932;10271
150307;201607;6614;21863;6150;21211;379;1369;5180;17965;5559;19334
150309;201607;6095;21002;5481;20096;1160;4164;3304;12857;4464;17021
150310;201607;6341;27030;6109;26684;560;2672;4998;22095;5558;24767
150320;201607;9442;23326;8685;22494;520;1262;7457;19568;7977;20830
150330;201607;13982;47358;13094;46060;1831;6490;9629;34954;11460;41444
150340;201607;2485;7911;2291;7605;237;850;1742;5807;1979;6657
150345;201607;6729;22148;6277;21535;596;2096;5014;17547;5610;19643
150350;201607;8103;24584;7501;23815;1119;3091;5634;18696;6753;21787
150360;201607;21221;65552;18510;62109;2983;10006;12585;44143;15568;54149
150370;201607;9941;35977;9216;35012;1112;4087;7125;28190;8237;32277
150375;201607;2880;12644;2785;12517;218;985;2399;10960;2617;11945
150380;201607;10052;28780;8856;27125;512;1648;7446;23130;7958;24778
150390;201607;7908;34018;7384;33067;1267;5578;4949;23112;6216;28690
150400;201607;5904;23059;5671;22598;472;1885;4544;18486;5016;20371
150405;201607;8286;24850;7347;23687;1055;2715;5288;18582;6343;21297
150410;201607;1582;6001;1459;5752;240;1125;906;3562;1146;4687
150420;201607;36586;121988;30788;112617;9989;39419;10082;39811;20071;79230
150430;201607;7427;24825;7058;24256;864;2932;5316;18752;6180;21684
150440;201607;5460;18703;5236;18398;627;2167;4087;14712;4714;16879
150442;201607;21825;62635;19256;58785;3330;10245;11883;37694;15213;47939
150445;201607;5291;18260;4905;17617;575;2075;3686;13565;4261;15640
150450;201607;4220;20424;4070;20187;417;2157;3320;16753;3737;18910
150460;201607;7036;25999;6488;25331;346;1681;5474;22124;5820;23805
150470;201607;17465;53759;16785;52963;407;1207;15842;50429;16249;51636
150475;201607;3319;11444;3055;11089;261;997;2509;9278;2770;10275
150480;201607;13980;47396;12870;45676;1259;4702;10187;36769;11446;41471
150490;201607;7072;27095;6903;26850;282;1281;6140;24067;6422;25348
150495;201607;4979;18295;4829;18102;170;692;4464;16850;4634;17542
150497;201607;2691;9873;2415;9340;762;3071;1099;4371;1861;7442
150500;201607;3164;8705;2930;8378;205;629;2388;6781;2593;7410
150503;201607;3629;11090;3074;10389;992;3413;1653;5918;2645;9331
150506;201607;10992;38225;9998;36812;2230;7666;6359;25292;8589;32958
150510;201607;9721;37899;8876;36182;1427;5852;5884;25050;7311;30902
150520;201607;6704;26364;6581;26204;255;1029;6128;24652;6383;25681
150530;201607;12401;42200;11171;40314;1084;3837;8717;32150;9801;35987
150540;201607;4691;14201;4166;13474;276;968;3435;11131;3711;12099
150543;201607;5805;17848;5142;16910;1014;3393;3179;10891;4193;14284
150548;201607;9164;29399;8567;28643;409;1306;7796;26431;8205;27737
150549;201607;2045;6591;1874;6398;72;268;1704;5879;1776;6147
150550;201607;20212;63820;17643;59552;5245;18219;7101;25339;12346;43558
150553;201607;22954;78762;19136;71051;6986;27521;5061;19827;12047;47348
150555;201607;1740;5162;1457;4707;102;378;1072;3482;1174;3860
150560;201607;1942;6346;1819;6085;291;992;1132;3824;1423;4816
150563;201607;2699;8937;2497;8593;616;2308;1366;4736;1982;7044
150565;201607;3888;13352;3548;12820;165;788;2947;10691;3112;11479
150570;201607;5874;21212;5702;20919;461;2030;4529;16577;4990;18607
150580;201607;9688;40407;9422;40094;615;2588;8276;35984;8891;38572
150590;201607;5719;22758;5491;22470;199;960;5060;20748;5259;21708
150600;201607;7869;30404;7523;29909;362;1592;6712;26940;7074;28532
150610;201607;2421;8140;2202;7701;245;960;1576;5458;1821;6418
150611;201607;2741;9361;2568;9054;169;651;2107;7472;2276;8123
150613;201607;12257;36519;10062;33241;3074;10710;4246;14583;7320;25293
150616;201607;3046;9269;2356;8130;595;2302;807;2675;1402;4977
150618;201607;6375;21693;5737;20552;1438;5254;3103;11544;4541;16798
150619;201607;5166;17610;4751;16953;538;2163;3470;12383;4008;14546
150620;201607;6344;22659;5780;21939;675;2622;4521;17605;5196;20227
150630;201607;5786;17413;5461;17032;512;1666;4526;14386;5038;16052
150635;201607;4024;13006;3595;12155;934;3289;1594;5578;2528;8867
150640;201607;1881;5622;1798;5522;162;451;1524;4907;1686;5358
150650;201607;12344;37083;10993;34778;2938;9485;4928;16357;7866;25842
150655;201607;5134;16831;4811;16250;629;2240;3553;12149;4182;14389
150658;201607;4492;13518;3903;12704;767;2759;2453;8267;3220;11026
150660;201607;5596;17435;5082;16684;1190;3889;2754;9388;3944;13277
150670;201607;7395;19404;6075;17786;629;1912;4774;14411;5403;16323
150680;201607;58288;201668;50571;188851;15094;58115;21348;87127;36442;145242
150690;201607;2059;6287;1854;5975;248;792;1293;4253;1541;5045
150700;201607;6173;19277;5643;18572;879;2889;3823;13007;4702;15896
150710;201607;4253;14293;3808;13571;414;1593;2758;9997;3172;11590
150715;201607;4990;15613;4334;14619;448;1715;3251;11053;3699;12768
150720;201607;6495;26134;6136;25495;771;3486;4533;19323;5304;22809
150730;201607;10028;33828;9263;32577;1054;3826;7194;25973;8248;29799
150740;201607;3693;11782;3297;11066;655;2329;1842;6220;2497;8549
150745;201607;5115;16267;4621;15585;1104;3875;2820;9624;3924;13499
150746;201607;1372;4455;1307;4342;149;546;964;3228;1113;3774
150747;201607;5307;16436;4695;15674;373;1107;3608;12967;3981;14074
150750;201607;3343;10749;3063;10369;210;860;2502;8503;2712;9363
150760;201607;11167;35737;10370;34712;1714;5875;7292;25011;9006;30886
150770;201607;5885;22290;5613;21839;333;1187;4836;19787;5169;20974
150775;201607;1130;3444;977;3172;210;817;530;1697;740;2514
150780;201607;3346;10826;3242;10712;119;442;2988;9911;3107;10353
150790;201607;4980;16255;4649;15862;319;1098;3761;13717;4080;14815
150795;201607;15182;48237;13690;45962;2883;9514;8353;29376;11236;38890
150796;201607;3112;9069;2815;8719;322;1064;2171;6872;2493;7936
150797;201607;3729;12705;3415;12159;130;579;2864;10181;2994;10760
150800;201607;13874;45389;12746;43996;2506;7957;8702;32101;11208;40058
150803;201607;6706;24092;6294;23430;716;2846;4741;17854;5457;20700
150805;201607;2641;9464;2454;9155;311;1185;1800;6834;2111;8019
150808;201607;5761;19083;4704;17033;1944;7630;681;2547;2625;10177
150810;201607;19164;58690;16014;54870;2418;8176;10705;38820;13123;46996
150812;201607;5198;16369;4786;15670;553;2138;3415;10916;3968;13054
150815;201607;8552;28148;7669;27042;778;2725;6102;22098;6880;24823
150820;201607;11476;33013;10250;31652;777;2101;8360;26663;9137;28764
150830;201607;12929;48401;12150;47385;753;3594;9988;40152;10741;43746
150835;201607;2130;7468;1981;7190;443;1641;1118;4184;1561;5825
150840;201607;7337;22300;6124;20265;1334;4854;3078;10174;4412;15028
160005;201607;795;2725;755;2646;71;294;610;2117;681;2411
160010;201607;1289;4320;1285;4315;39;75;1236;4217;1275;4292
160015;201607;1735;6469;1694;6406;58;175;1582;6097;1640;6272
160020;201607;1910;6889;1789;6727;215;875;1361;5229;1576;6104
160021;201607;1078;4646;1033;4568;140;726;756;3370;896;4096
160023;201607;998;4049;990;4039;101;413;828;3421;929;3834
160025;201607;1364;4163;1348;4147;23;90;1310;4020;1333;4110
160027;201607;8256;24427;7625;23730;1689;5097;5152;16821;6841;21918
160030;201607;48081;165711;42453;156428;10034;37032;22985;90836;33019;127868
160040;201607;4272;16715;4171;16575;182;1020;3806;14945;3988;15965
160050;201607;2998;11439;2679;10985;1251;4906;989;4586;2240;9492
160053;201607;2855;10854;2789;10759;631;2427;1845;7357;2476;9784
160055;201607;551;2182;544;2173;33;160;485;1929;518;2089
160060;201607;15601;52956;14532;51681;1842;6426;11200;40872;13042;47298
160070;201607;2573;10203;2420;9942;200;979;2021;8285;2221;9264
160080;201607;2566;9678;2517;9620;84;417;2359;8973;2443;9390
170025;201607;518;1675;465;1605;129;449;251;890;380;1339
170030;201607;1175;3861;1024;3591;248;893;444;1607;692;2500
170035;201607;1435;4147;1180;3692;201;672;578;1848;779;2520
170040;201607;1886;5925;1656;5636;252;930;989;3652;1241;4582
170070;201607;1663;4458;1295;3965;259;869;697;2110;956;2979
170100;201607;2365;7057;2049;6582;219;729;1584;5167;1803;5896
170105;201607;756;2334;594;2016;134;532;284;923;418;1455
170110;201607;946;3095;816;2856;188;706;358;1280;546;1986
170130;201607;1349;4252;1108;3787;280;1006;509;1821;789;2827
170190;201607;1532;4506;1152;3892;383;1226;275;1132;658;2358
170200;201607;1591;4423;1027;3358;297;1051;231;739;528;1790
170210;201607;31372;88963;25142;79045;8054;27611;6099;20400;14153;48011
170215;201607;1209;3717;1022;3429;113;447;718;2418;831;2865
170220;201607;5608;19245;5164;18375;1204;4426;2773;10089;3977;14515
170230;201607;1378;4422;1130;3950;250;981;489;1685;739;2666
170240;201607;2743;8137;2229;7335;260;1029;1539;5050;1799;6079
170255;201607;3350;10662;2774;9651;835;2951;1151;4201;1986;7152
170270;201607;1018;2495;701;2065;62;180;476;1385;538;1565
170290;201607;2773;8132;2478;7796;254;556;2017;6846;2271;7402
170300;201607;1928;5868;1584;5311;198;765;1022;3463;1220;4228
170305;201607;734;2202;596;1950;90;336;320;1052;410;1388
170307;201607;1020;3600;862;3310;195;835;413;1643;608;2478
170310;201607;1595;4407;1198;3730;312;1031;542;1741;854;2772
170320;201607;1128;3234;814;2697;189;679;316;1084;505;1763
170330;201607;802;2591;727;2475;78;304;565;1905;643;2209
170360;201607;454;1432;373;1288;66;246;186;641;252;887
170370;201607;1339;3782;1023;3269;160;567;557;1788;717;2355
170380;201607;1733;5550;1399;4992;225;927;726;2622;951;3549
170382;201607;560;1860;463;1689;71;288;311;1160;382;1448
170384;201607;1565;6287;1425;6021;349;1573;766;3297;1115;4870
170386;201607;907;2686;784;2507;224;838;332;1024;556;1862
170388;201607;640;1922;525;1736;113;432;201;647;314;1079
170389;201607;918;3100;833;2958;63;272;635;2230;698;2502
170390;201607;1271;3631;1069;3379;85;306;847;2713;932;3019
170410;201607;539;1710;450;1554;47;203;279;953;326;1156
170460;201607;487;1330;325;1039;70;263;113;352;183;615
170510;201607;758;2507;597;2189;97;431;301;1071;398;1502
170550;201607;6833;19323;5018;16155;1630;5791;702;2336;2332;8127
170555;201607;1351;3856;1081;3442;201;698;554;1839;755;2537
170560;201607;1060;3425;833;3129;175;713;467;1861;642;2574
170600;201607;1327;3876;1166;3653;304;918;688;2251;992;3169
170610;201607;1678;5042;1337;4490;160;605;844;2847;1004;3452
170625;201607;416;1237;308;1019;51;180;107;344;158;524
170650;201607;1221;3928;1013;3558;281;1010;358;1402;639;2412
170700;201607;4154;12882;3350;11552;759;2898;1493;5384;2252;8282
170710;201607;1782;5254;1426;4611;248;857;813;2671;1061;3528
170720;201607;1885;5061;1602;4619;188;479;1204;3655;1392;4134
170730;201607;976;2856;783;2549;205;713;327;1091;532;1804
170740;201607;2174;7701;1887;7172;294;1173;1230;4749;1524;5922
170755;201607;769;2417;611;2064;107;418;250;835;357;1253
170765;201607;1299;3536;971;3003;260;825;398;1310;658;2135
170770;201607;1668;5672;1519;5418;302;1090;913;3355;1215;4445
170820;201607;3496;11313;3142;10732;685;2503;1600;5592;2285;8095
170825;201607;735;2183;609;1952;95;311;313;1001;408;1312
170830;201607;1399;4064;1206;3781;69;145;1048;3397;1117;3542
170900;201607;2498;8885;2353;8658;204;832;1914;7114;2118;7946
170930;201607;3708;11115;3216;10343;817;2813;1494;4991;2311;7804
170950;201607;13733;39824;10197;33591;3191;11877;1739;5861;4930;17738
170980;201607;498;1442;365;1224;62;214;151;505;213;719
171050;201607;1493;5002;1339;4710;97;440;1043;3630;1140;4070
171070;201607;1441;4526;1315;4345;309;1008;762;2635;1071;3643
171090;201607;1066;2852;878;2596;64;197;651;1925;715;2122
171110;201607;592;1725;434;1431;123;470;184;547;307;1017
171150;201607;1034;2811;671;2172;109;380;398;1319;507;1699
171180;201607;695;2075;474;1616;114;408;188;684;302;1092
171190;201607;1631;6049;1439;5643;306;1266;700;2897;1006;4163
171195;201607;847;2940;725;2721;108;461;434;1643;542;2104
171200;201607;681;2138;540;1871;170;623;184;632;354;1255
171215;201607;463;1359;355;1142;58;215;167;544;225;759
171240;201607;696;2542;641;2435;76;363;423;1647;499;2010
171245;201607;616;2067;502;1795;121;484;169;597;290;1081
171250;201607;1026;2991;814;2641;188;662;397;1261;585;1923
171270;201607;394;1621;369;1567;119;490;155;734;274;1224
171280;201607;873;2665;716;2388;161;542;331;1194;492;1736
171320;201607;3786;11401;3174;10345;888;2925;1372;4694;2260;7619
171330;201607;2800;8099;2256;7245;622;2114;1033;3341;1655;5455
171360;201607;1396;4542;1259;4330;121;455;958;3330;1079;3785
171370;201607;641;1852;550;1728;115;407;313;986;428;1393
171380;201607;1260;4080;1051;3704;409;1458;288;1140;697;2598
171395;201607;882;2685;679;2288;133;559;319;1022;452;1581
171420;201607;2057;6307;1567;5357;399;1486;594;2039;993;3525
171430;201607;1064;3247;885;2956;175;598;491;1651;666;2249
171488;201607;2484;7575;2125;7058;475;1598;1195;4167;1670;5765
171500;201607;819;2428;675;2209;83;276;469;1570;552;1846
171510;201607;871;3042;778;2879;79;343;543;2040;622;2383
171515;201607;502;1434;386;1230;57;185;220;697;277;882
171525;201607;634;2023;540;1870;74;302;332;1111;406;1413
171550;201607;325;1104;248;954;89;369;62;253;151;622
171570;201607;1232;3883;1073;3567;224;728;682;2347;906;3075
171575;201607;1907;5338;1423;4466;282;934;678;2142;960;3076
171610;201607;5284;16810;4415;15299;1204;4648;1460;5157;2664;9805
171620;201607;2667;7697;2286;7191;134;538;1870;5898;2004;6436
171630;201607;878;2690;723;2446;195;702;358;1232;553;1934
171650;201607;2149;6698;1675;5735;458;1682;583;2021;1041;3703
171660;201607;2394;6679;1848;5711;268;883;1009;3123;1277;4006
171665;201607;1468;4276;1168;3812;196;700;653;2237;849;2937
171670;201607;1916;5395;1573;4845;429;1453;671;2031;1100;3484
171700;201607;1095;3497;925;3182;149;562;547;1879;696;2441
171720;201607;702;2083;595;1914;179;602;266;889;445;1491
171750;201607;1149;3575;888;3060;260;903;273;985;533;1888
171780;201607;1140;3110;844;2686;97;341;459;1465;556;1806
171790;201607;1360;4784;1207;4497;272;990;690;2750;962;3740
171800;201607;665;2091;583;1966;74;258;394;1384;468;1642
171820;201607;10173;30208;8429;27580;1718;6045;4413;14784;6131;20829
171830;201607;1382;5096;1226;4752;325;1256;549;2236;874;3492
171840;201607;774;2135;656;1977;49;159;522;1574;571;1733
171845;201607;712;1950;552;1683;84;282;299;935;383;1217
171850;201607;914;3239;808;3030;110;496;514;1913;624;2409
171855;201607;1115;3552;1019;3375;81;307;767;2525;848;2832
171865;201607;448;1483;387;1385;87;336;198;708;285;1044
171870;201607;722;2161;575;1891;143;499;225;808;368;1307
171875;201607;1251;4013;1043;3673;95;397;705;2473;800;2870
171880;201607;814;3051;793;3022;86;326;636;2489;722;2815
171884;201607;899;2466;663;2105;152;548;173;639;325;1187
171886;201607;1385;4504;1111;3951;345;1356;256;945;601;2301
171888;201607;715;2131;531;1761;62;221;297;996;359;1217
171889;201607;504;1583;451;1496;85;275;243;879;328;1154
171890;201607;1188;3674;985;3385;173;675;591;2027;764;2702
171900;201607;488;1787;402;1571;105;443;174;694;279;1137
172000;201607;542;1761;470;1629;82;321;271;919;353;1240
172010;201607;1180;4074;1093;3927;118;517;811;2898;929;3415
172015;201607;336;1299;270;1161;57;234;138;620;195;854
172020;201607;2302;7610;2139;7351;251;910;1533;5355;1784;6265
172025;201607;696;2024;500;1680;85;317;266;922;351;1239
172030;201607;1131;3646;995;3422;74;330;760;2600;834;2930
172049;201607;1332;3429;966;2807;465;1490;342;912;807;2402
172065;201607;1354;3553;1108;3275;61;157;1000;3030;1061;3187
172080;201607;2387;7502;2044;6908;231;934;1340;4504;1571;5438
172085;201607;511;1418;363;1120;58;178;110;345;168;523
172090;201607;3719;10270;3061;9308;144;502;2562;7851;2706;8353
172093;201607;606;1808;473;1581;99;389;236;782;335;1171
172097;201607;593;1790;477;1598;114;406;182;616;296;1022
172100;201607;34000;99362;25853;85292;7454;27433;7037;23770;14491;51203
172110;201607;1650;6204;1463;5900;184;826;1068;4423;1252;5249
172120;201607;5066;15742;4187;14504;779;2717;2593;9383;3372;12100
172125;201607;244;777;203;702;47;185;96;339;143;524
172130;201607;550;1517;426;1315;42;162;273;833;315;995
172208;201607;2123;6208;1888;5883;276;920;1199;3783;1475;4703
172210;201607;2514;7628;2195;7177;460;1655;1288;4206;1748;5861
210005;201607;21776;67527;18357;62287;5964;21731;6842;23961;12806;45692
210010;201607;1727;6474;1560;6186;87;352;1279;5202;1366;5554
210015;201607;3418;10724;3030;10129;196;546;2575;8871;2771;9417
210020;201607;7152;17132;6694;16606;219;625;6115;15102;6334;15727
210030;201607;5484;18226;5144;17757;372;1720;4276;14627;4648;16347
210040;201607;1897;5184;1753;5018;73;217;1576;4541;1649;4758
210043;201607;6822;18967;5823;17729;647;1879;4203;13610;4850;15489
210047;201607;6541;24341;5945;23428;594;2697;4575;18100;5169;20797
210050;201607;2297;8441;1918;7712;633;2579;772;3413;1405;5992
210055;201607;1761;6053;1598;5799;111;462;1244;4526;1355;4988
210060;201607;7218;27976;6684;26992;1042;4432;4494;18652;5536;23084
210070;201607;7201;21084;6649;20412;163;593;6071;18786;6234;19379
210080;201607;3692;12674;3596;12554;45;208;3428;12011;3473;12219
210083;201607;4479;15564;4086;15147;132;605;3827;14208;3959;14813
210087;201607;2979;8723;2703;8369;275;858;2163;6824;2438;7682
210090;201607;10040;32501;9500;31654;513;1922;8283;27703;8796;29625
210095;201607;5989;21483;5736;21131;364;1501;4889;18213;5253;19714
210100;201607;7313;21764;6673;20963;480;1820;5460;16989;5940;18809
210110;201607;2840;9904;2731;9760;127;607;2452;8713;2579;9320
210120;201607;26381;71745;22900;67706;2626;6618;17052;53667;19678;60285
210125;201607;3563;11303;3436;11170;132;332;3120;10395;3252;10727
210130;201607;4152;12315;3827;11859;274;933;3184;9861;3458;10794
210135;201607;1675;4914;1449;4593;106;340;1162;3729;1268;4069
210140;201607;17104;54321;14817;51259;2586;9337;9574;34465;12160;43802
210150;201607;4651;11407;4158;10803;71;216;3884;10070;3955;10286
210160;201607;17638;55408;16554;53851;1326;4012;13596;45533;14922;49545
210170;201607;14018;49551;13602;49021;700;2699;12124;44172;12824;46871
210173;201607;2030;8136;1935;7982;96;540;1711;7028;1807;7568
210177;201607;3064;9422;2906;9237;139;433;2631;8467;2770;8900
210180;201607;1480;4516;1380;4369;65;258;1173;3692;1238;3950
210190;201607;4884;15435;4469;14676;238;1102;3498;11237;3736;12339
210193;201607;1395;4370;1255;4141;72;256;1035;3471;1107;3727
210197;201607;2090;6969;1922;6766;235;825;1497;5442;1732;6267
210200;201607;8382;28179;7739;27258;969;3229;5958;21855;6927;25084
210203;201607;6851;21352;6452;20843;422;1200;5600;18534;6022;19734
210207;201607;3029;9779;2838;9438;280;905;2130;7266;2410;8171
210210;201607;8395;28313;7994;27782;135;518;7348;26079;7483;26597
210215;201607;1151;4771;1095;4682;101;512;869;3751;970;4263
210220;201607;6240;24412;5929;23910;360;1733;5019;20448;5379;22181
210230;201607;5230;16935;4870;16384;276;1020;4219;14288;4495;15308
210232;201607;12962;41509;10850;38813;1502;5651;7213;27853;8715;33504
210235;201607;3669;11442;3274;10945;188;758;2796;9389;2984;10147
210237;201607;2346;8981;2278;8884;33;162;2166;8505;2199;8667
210240;201607;3017;9417;2805;9117;156;566;2365;7698;2521;8264
210250;201607;5253;16940;4926;16519;166;799;4474;14898;4640;15697
210255;201607;2618;8376;2384;7971;280;993;1751;5906;2031;6899
210260;201607;5156;16820;4733;16187;514;1756;3638;12788;4152;14544
210270;201607;5397;15142;4728;14210;144;655;4140;12347;4284;13002
210275;201607;3608;8750;3397;8516;185;400;3081;7893;3266;8293
210280;201607;5614;16878;4827;15816;329;1476;3674;11830;4003;13306
210290;201607;5682;18725;5213;18167;308;1170;4453;15707;4761;16877
210300;201607;38197;105713;31569;97551;2277;7633;23868;76989;26145;84622
210310;201607;2922;8185;2659;7828;90;232;2345;7002;2435;7234
210312;201607;2229;6985;2104;6819;76;357;1861;6018;1937;6375
210315;201607;2655;8689;2439;8398;139;519;2110;7373;2249;7892
210317;201607;4235;13093;4035;12851;152;567;3716;11890;3868;12457
210320;201607;19342;62444;17763;60535;964;3619;15260;52923;16224;56542
210325;201607;3657;11256;3243;10637;241;899;2564;8535;2805;9434
210330;201607;35838;87993;28281;79799;4214;10422;18374;59228;22588;69650
210340;201607;11879;35367;10772;33937;1183;3054;8025;27207;9208;30261
210350;201607;10027;30587;8964;29119;603;2126;7282;23938;7885;26064
210355;201607;3929;14346;3592;13842;187;826;3070;12065;3257;12891
210360;201607;16134;48578;14532;46374;1169;4226;11381;36516;12550;40742
210370;201607;9373;22504;7843;20868;262;549;6997;19279;7259;19828
210375;201607;3147;9486;2644;8838;776;2694;1345;4663;2121;7357
210380;201607;6136;16946;5454;16017;410;1142;4504;13499;4914;14641
210390;201607;2896;10270;2629;9843;158;825;2207;8215;2365;9040
210400;201607;4843;15235;4636;15003;113;319;4414;14429;4527;14748
210405;201607;8336;22718;6667;20381;2020;6290;2708;9079;4728;15369
210407;201607;2040;7239;1751;6728;215;857;1237;4809;1452;5666
210408;201607;2425;9383;2266;9180;139;663;1916;7981;2055;8644
210409;201607;3726;13500;3510;13187;223;1062;2898;10911;3121;11973
210410;201607;3653;12052;3518;11883;319;888;2910;10331;3229;11219
210420;201607;4102;13481;3756;12899;254;889;3073;10735;3327;11624
210430;201607;2168;6714;2089;6623;118;405;1827;5794;1945;6199
210440;201607;3970;12366;3828;12185;164;553;3497;11210;3661;11763
210450;201607;2818;8784;2494;8308;144;580;1995;6573;2139;7153
210455;201607;3918;11455;3512;10862;537;1670;2534;8174;3071;9844
210460;201607;3607;11864;3344;11459;204;841;2756;9457;2960;10298
210462;201607;1453;5251;1350;5061;106;493;1073;4024;1179;4517
210465;201607;2536;8383;2360;8138;158;480;2023;7163;2181;7643
210467;201607;6254;20663;5830;20176;407;1447;4975;17527;5382;18974
210470;201607;2055;5566;1505;4761;93;281;1130;3651;1223;3932
210480;201607;14927;47481;12980;44998;2140;7273;8953;33319;11093;40592
210490;201607;3627;10050;3151;9398;123;476;2663;7898;2786;8374
210500;201607;6317;26009;6069;25568;668;2939;4719;20327;5387;23266
210510;201607;6525;22185;6160;21761;374;1157;5285;19230;5659;20387
210515;201607;3707;11661;3546;11479;80;218;3335;10975;3415;11193
210520;201607;2655;7994;2401;7640;159;524;2014;6504;2173;7028
210530;201607;39017;118522;31448;107018;7593;29316;13406;48014;20999;77330
210535;201607;3237;11090;3091;10903;132;478;2766;9904;2898;10382
210540;201607;13506;44122;11828;41766;2260;7949;7227;27373;9487;35322
210542;201607;5844;16825;5320;16256;321;794;4632;14591;4953;15385
210545;201607;2343;7563;2230;7374;67;325;1972;6457;2039;6782
210547;201607;3727;13305;3478;12888;322;1198;2689;10210;3011;11408
210550;201607;6077;17989;5536;17427;207;530;5130;16533;5337;17063
210560;201607;4082;12780;3654;12086;183;712;3077;10181;3260;10893
210565;201607;1481;5300;1265;4952;119;581;944;3742;1063;4323
210570;201607;12455;35080;11274;33737;682;1662;9845;30288;10527;31950
210580;201607;3223;9498;2884;9074;317;690;2331;7803;2648;8493
210590;201607;4051;12772;3746;12383;250;1016;3229;10627;3479;11643
210592;201607;2525;7880;2423;7710;67;299;2144;6827;2211;7126
210594;201607;2678;7523;2134;6723;119;331;1648;5397;1767;5728
210596;201607;2721;10072;2574;9792;275;1152;1926;7457;2201;8609
210598;201607;1894;5854;1734;5659;110;466;1513;4884;1623;5350
210600;201607;3271;9344;2807;8726;162;574;2244;6960;2406;7534
210610;201607;2529;8299;2361;8084;153;694;2052;6922;2205;7616
210620;201607;1948;6356;1804;6181;56;157;1645;5763;1701;5920
210630;201607;3636;12783;3251;12161;345;1555;2293;8602;2638;10157
210632;201607;4573;15808;4230;15310;469;1894;3273;11872;3742;13766
210635;201607;1873;6549;1773;6399;75;251;1575;5802;1650;6053
210637;201607;2685;9134;2469;8840;167;668;2021;7306;2188;7974
210640;201607;4252;15845;4171;15754;6;24;4068;15519;4074;15543
210650;201607;6857;20950;6647;20694;177;553;6318;19766;6495;20319
210660;201607;8376;24431;7559;23250;234;911;6855;20951;7089;21862
210663;201607;2723;8206;2565;8026;157;560;2206;6961;2363;7521
210667;201607;1872;6442;1760;6268;94;404;1526;5464;1620;5868
210670;201607;4527;16583;4299;16216;259;1193;3604;13670;3863;14863
210675;201607;5137;14189;4715;13676;414;1041;3873;11629;4287;12670
210680;201607;4084;11158;3592;10571;177;504;3111;9261;3288;9765
210690;201607;7399;24925;7100;24605;312;1107;6274;22442;6586;23549
210700;201607;2650;7838;2433;7598;400;1004;1698;6022;2098;7026
210710;201607;4867;15960;4566;15494;227;989;3882;13108;4109;14097
210720;201607;2612;9436;2459;9223;136;645;2185;8140;2321;8785
210725;201607;1090;4129;952;3845;97;420;623;2583;720;3003
210730;201607;1147;3520;1008;3315;70;237;803;2652;873;2889
210735;201607;4181;14357;3799;13730;497;1896;2793;10336;3290;12232
210740;201607;4983;14900;4690;14598;210;967;4249;12969;4459;13936
210745;201607;3990;11737;3738;11418;239;698;3195;9864;3434;10562
210750;201607;20488;55361;18029;52589;1831;5391;13963;41843;15794;47234
210760;201607;5901;16926;5462;16463;42;143;5301;16041;5343;16184
210770;201607;5959;16337;5154;15414;132;537;4649;13905;4781;14442
210780;201607;8160;27170;7459;25996;909;3240;5296;18984;6205;22224
210790;201607;4688;14671;4267;14192;256;701;3521;12332;3777;13033
210800;201607;4852;13582;4344;12985;144;540;3892;11656;4036;12196
210805;201607;3805;15707;3665;15469;209;1073;3166;13447;3375;14520
210810;201607;5458;16521;5029;15974;328;716;4380;14496;4708;15212
210820;201607;7742;22412;7041;21410;964;2871;4975;15579;5939;18450
210825;201607;5741;19709;5462;19334;601;2070;4343;15868;4944;17938
210830;201607;8409;24630;7968;24101;820;2124;6458;20319;7278;22443
210840;201607;3676;10013;3287;9440;120;396;2778;7930;2898;8326
210845;201607;5836;17717;5638;17502;71;171;5460;17120;5531;17291
210850;201607;6308;22130;5678;21109;645;2781;4089;15215;4734;17996
210860;201607;17969;52877;16083;50304;1226;4002;12844;40796;14070;44798
210870;201607;5852;19605;5320;18936;616;2199;4100;14972;4716;17171
210880;201607;4279;13897;4069;13621;318;1203;3401;11399;3719;12602
210890;201607;5205;15286;4718;14723;390;1089;3930;12829;4320;13918
210900;201607;4996;14877;4103;13442;1583;5472;1094;3894;2677;9366
210905;201607;1848;5793;1641;5489;118;336;1315;4532;1433;4868
210910;201607;8612;27303;7719;25846;1074;3904;5320;17952;6394;21856
210920;201607;2894;10459;2769;10251;173;812;2277;8447;2450;9259
210923;201607;1508;5128;1396;4963;164;663;948;3490;1112;4153
210927;201607;4832;15379;4555;15087;75;253;4351;14529;4426;14782
210930;201607;2507;9115;2358;8898;126;691;2006;7471;2132;8162
210940;201607;2875;10950;2798;10808;195;895;2374;9127;2569;10022
210945;201607;5904;17847;5697;17626;198;360;5373;16893;5571;17253
210950;201607;5288;16259;4536;15081;443;1572;3403;11510;3846;13082
210955;201607;1895;6109;1672;5775;183;632;1186;4273;1369;4905
210960;201607;9393;29678;8646;28722;1819;5769;5384;19242;7203;25011
210970;201607;1362;4787;1199;4523;160;680;837;3158;997;3838
210975;201607;1796;5983;1709;5837;119;478;1370;4678;1489;5156
210980;201607;10311;24107;9931;23718;527;1009;8988;21969;9515;22978
210990;201607;16780;51112;13596;46685;3209;11578;6893;24876;10102;36454
211000;201607;15482;49619;13715;47527;843;3638;11442;40216;12285;43854
211003;201607;4843;17508;4390;16896;338;1526;3371;13406;3709;14932
211010;201607;6494;23744;6192;23377;82;389;5890;22402;5972;22791
211020;201607;7448;24095;7201;23736;643;2283;5899;19500;6542;21783
211023;201607;2237;7566;2154;7434;167;687;1772;6102;1939;6789
211027;201607;2888;11135;2809;11014;291;1262;2284;9007;2575;10269
211030;201607;3870;11797;3612;11526;583;1300;2742;9587;3325;10887
211040;201607;4430;16536;4224;16228;180;989;3686;14177;3866;15166
211050;201607;10293;26458;9853;25980;229;631;9306;24547;9535;25178
211060;201607;6175;21778;5984;21514;435;1637;5180;18827;5615;20464
211065;201607;1978;6363;1804;6122;78;286;1634;5583;1712;5869
211070;201607;8136;27917;7469;26838;435;1720;6187;22554;6622;24274
211080;201607;1350;4078;1148;3772;95;457;893;2824;988;3281
211085;201607;1922;6499;1753;6220;235;853;1237;4490;1472;5343
211090;201607;3536;10301;3295;9972;156;638;2836;8476;2992;9114
211100;201607;6658;17254;6514;17104;42;137;6349;16704;6391;16841
211102;201607;2976;11331;2800;11077;224;970;2380;9540;2604;10510
211105;201607;2667;8568;2275;7967;228;933;1714;5951;1942;6884
211107;201607;4489;14260;4046;13699;244;874;3344;11617;3588;12491
211110;201607;6410;18989;5156;17128;883;2881;3295;11456;4178;14337
211120;201607;36003;100037;32451;95875;5064;14500;23129;71173;28193;85673
211125;201607;2077;6587;1830;6191;123;507;1521;5144;1644;5651
211130;201607;154308;417558;142492;403016;23268;68377;79273;238647;102541;307024
211140;201607;5486;18183;5110;17617;220;969;4378;15095;4598;16064
211150;201607;9830;28319;8840;27085;475;1739;7491;22990;7966;24729
211153;201607;2860;8774;2596;8428;605;1990;1698;5697;2303;7687
211157;201607;1205;3874;1041;3628;107;475;690;2455;797;2930
211160;201607;4160;13569;3513;12489;311;1483;2447;8498;2758;9981
211163;201607;1695;5578;1590;5433;43;133;1443;5032;1486;5165
211167;201607;1517;5051;1454;4968;35;158;1360;4656;1395;4814
211170;201607;6390;16834;6117;16517;110;386;5705;15336;5815;15722
211172;201607;2472;7216;2237;6892;123;521;1913;5814;2036;6335
211174;201607;2820;8200;2537;7847;77;387;2303;7020;2380;7407
211176;201607;4309;13459;3682;12640;402;1621;2721;9445;3123;11066
211178;201607;3993;10395;3704;10070;59;184;3519;9521;3578;9705
211180;201607;4255;14782;4003;14411;311;1231;3346;12128;3657;13359
211190;201607;2855;9458;2635;9130;94;444;2289;7911;2383;8355
211195;201607;1481;4456;1235;4152;62;190;1056;3671;1118;3861
211200;201607;2161;7141;1895;6781;350;1212;1218;4651;1568;5863
211210;201607;6822;21006;6459;20517;444;1441;5484;17574;5928;19015
211220;201607;34912;99867;29991;93651;5334;17285;19555;63018;24889;80303
211223;201607;5178;15709;4729;15016;455;1511;3592;11573;4047;13084
211227;201607;1626;5723;1481;5497;128;528;1206;4519;1334;5047
211230;201607;8392;27241;7579;25913;776;2811;5800;20140;6576;22951
211240;201607;8077;27780;7647;27253;309;1499;6876;24274;7185;25773
211245;201607;5560;16369;5522;16329;81;145;5389;16087;5470;16232
211250;201607;13406;43329;12626;42420;1218;3538;10349;36367;11567;39905
211260;201607;8594;26644;8165;26070;431;1616;7328;23367;7759;24983
211270;201607;10401;35473;9315;34106;603;2754;7398;27656;8001;30410
211280;201607;13067;38778;12093;37581;942;2536;9965;32065;10907;34601
211285;201607;1751;6399;1530;5929;285;1209;824;3314;1109;4523
211290;201607;7259;23754;6959;23375;459;1482;5999;20515;6458;21997
211300;201607;8380;24988;7812;24232;175;543;7241;22624;7416;23167
211400;201607;11953;37060;10463;34995;2611;8897;5406;19951;8017;28848
220005;201607;1861;5299;1687;5040;83;332;1386;4047;1469;4379
220010;201607;1391;4091;1236;3859;50;214;1007;3097;1057;3311
220020;201607;3319;10495;3138;10198;551;1862;2043;6680;2594;8542
220025;201607;2278;5597;2058;5271;38;131;1762;4446;1800;4577
220027;201607;1381;3717;1232;3527;79;247;1005;2886;1084;3133
220030;201607;3263;8912;3195;8809;143;521;2846;7723;2989;8244
220040;201607;7639;23769;7041;22685;1328;4428;4538;14645;5866;19073
220045;201607;1382;4562;1262;4337;75;355;963;3239;1038;3594
220050;201607;4483;13512;3906;12552;232;961;3133;9977;3365;10938
220060;201607;2084;5116;1907;4905;35;85;1733;4457;1768;4542
220070;201607;2453;7148;2233;6799;142;428;1797;5492;1939;5920
220080;201607;713;2141;660;2062;54;228;558;1687;612;1915
220090;201607;1830;4608;1519;4191;61;221;1318;3575;1379;3796
220095;201607;725;1953;677;1889;12;51;630;1736;642;1787
220100;201607;1354;4077;1125;3668;84;363;858;2749;942;3112
220105;201607;2270;7157;2023;6693;173;614;1494;4971;1667;5585
220110;201607;3415;9862;3209;9535;128;517;2808;8213;2936;8730
220115;201607;2510;8514;2412;8356;130;540;2155;7420;2285;7960
220117;201607;1311;3468;1086;3132;53;164;901;2602;954;2766
220120;201607;12320;35628;11384;34488;168;727;10646;32198;10814;32925
220130;201607;861;2937;774;2798;35;194;665;2373;700;2567
220140;201607;1700;4511;1494;4260;156;352;1231;3630;1387;3982
220150;201607;7085;21484;6676;20910;235;1029;5864;18160;6099;19189
220155;201607;1122;3408;901;2997;56;230;603;1977;659;2207
220157;201607;1077;2704;948;2513;28;101;822;2144;850;2245
220160;201607;2642;7961;2354;7443;120;530;1890;5891;2010;6421
220170;201607;1390;4177;1194;3863;60;276;976;3123;1036;3399
220173;201607;2070;6213;1714;5527;66;330;1372;4330;1438;4660
220177;201607;1776;5257;1743;5215;48;182;1636;4877;1684;5059
220180;201607;1130;3080;946;2742;35;134;675;1874;710;2008
220190;201607;4628;14997;4255;14508;496;1774;3299;11267;3795;13041
220191;201607;1420;4696;1336;4553;145;591;1004;3340;1149;3931
220192;201607;1775;5033;1426;4416;90;333;1059;3260;1149;3593
220194;201607;1708;5124;1530;4823;120;456;1202;3701;1322;4157
220196;201607;2040;5906;1866;5604;135;508;1511;4482;1646;4990
220198;201607;1340;3824;1026;3409;13;46;959;3233;972;3279
220200;201607;4490;14844;4191;14433;425;1557;3313;11498;3738;13055
220202;201607;2195;6539;1937;6095;53;263;1671;5138;1724;5401
220205;201607;2783;7313;2488;6905;54;220;2216;6074;2270;6294
220207;201607;902;2722;765;2476;76;307;545;1734;621;2041
220208;201607;1831;5856;1570;5404;244;949;978;3372;1222;4321
220209;201607;1556;4682;1374;4371;54;228;1127;3545;1181;3773
220210;201607;1684;4537;1482;4221;55;241;1209;3343;1264;3584
220211;201607;1589;4456;1516;4369;56;215;1339;3807;1395;4022
220213;201607;1759;4964;1618;4708;53;216;1311;3708;1364;3924
220217;201607;2008;6334;1918;6231;36;137;1778;5844;1814;5981
220220;201607;10845;29928;9700;28222;818;2233;7085;21143;7903;23376
220225;201607;1090;3143;900;2878;40;158;744;2352;784;2510
220230;201607;5393;14760;4906;14081;161;468;4357;12577;4518;13045
220240;201607;2933;9010;2705;8602;125;490;2197;6939;2322;7429
220245;201607;1480;4008;1265;3705;31;100;1131;3369;1162;3469
220250;201607;3190;9141;2901;8714;82;331;2546;7643;2628;7974
220253;201607;1613;4840;1377;4411;166;601;976;3107;1142;3708
220255;201607;1748;4896;1514;4501;53;237;1241;3526;1294;3763
220260;201607;4644;14871;4092;13870;321;1168;3052;10425;3373;11593
220265;201607;1335;4607;1216;4413;134;553;807;2972;941;3525
220270;201607;6911;22382;6626;21876;417;1863;5511;17712;5928;19575
220271;201607;1491;4153;1332;3904;69;204;1107;3286;1176;3490
220272;201607;1794;5379;1628;5096;80;343;1284;3941;1364;4284
220273;201607;1226;3540;1078;3284;90;324;809;2444;899;2768
220275;201607;2112;5373;1740;4931;40;190;1561;4346;1601;4536
220277;201607;2232;6194;1960;5768;82;301;1561;4509;1643;4810
220280;201607;1566;4196;1374;3871;86;321;1111;3033;1197;3354
220285;201607;1625;4308;1341;3923;26;105;1213;3564;1239;3669
220290;201607;5990;20096;5203;18994;555;2303;3782;13879;4337;16182
220300;201607;1821;6128;1655;5880;93;480;1351;4715;1444;5195
220310;201607;2458;8282;2253;8051;91;411;1905;6893;1996;7304
220320;201607;3041;9273;2589;8445;281;1094;1848;5999;2129;7093
220323;201607;1479;5201;1292;4929;139;589;1001;3832;1140;4421
220325;201607;1170;3741;993;3387;80;347;720;2427;800;2774
220327;201607;1303;4186;1190;3988;55;288;967;3148;1022;3436
220330;201607;3660;9813;3299;9375;112;303;2990;8589;3102;8892
220335;201607;1857;5747;1678;5545;29;86;1583;5295;1612;5381
220340;201607;1854;5089;1575;4664;102;349;1158;3361;1260;3710
220342;201607;1124;3699;1056;3596;76;336;847;2877;923;3213
220345;201607;2885;7362;2546;6863;54;151;2330;6280;2384;6431
220350;201607;3952;10433;3368;9535;204;686;2609;7313;2813;7999
220360;201607;1299;3587;1116;3304;91;304;868;2532;959;2836
220370;201607;9314;26646;8447;25546;315;1186;7563;22775;7878;23961
220375;201607;1495;4717;1400;4601;17;54;1345;4466;1362;4520
220380;201607;1394;3744;1172;3445;49;206;994;2849;1043;3055
220385;201607;840;2154;681;1900;19;75;550;1503;569;1578
220390;201607;9583;29089;8430;27088;2168;7215;3456;11442;5624;18657
220400;201607;1506;3719;1204;3247;40;138;970;2536;1010;2674
220410;201607;1208;3527;1045;3271;79;311;812;2495;891;2806
220415;201607;881;2395;774;2252;53;176;566;1615;619;1791
220420;201607;2170;6243;1831;5579;94;287;1442;4406;1536;4693
220430;201607;2592;7301;2524;7212;122;433;2247;6354;2369;6787
220435;201607;1647;4882;1513;4662;54;217;1260;3858;1314;4075
220440;201607;2370;7845;2208;7610;162;616;1803;6121;1965;6737
220450;201607;2085;6433;1747;5946;383;1413;1032;3546;1415;4959
220455;201607;1355;4158;1262;4020;46;159;1115;3564;1161;3723
220460;201607;892;2447;819;2364;47;148;703;2013;750;2161
220465;201607;2371;7820;2157;7492;341;1272;1509;5284;1850;6556
220470;201607;3803;11250;3468;10722;201;734;2757;8405;2958;9139
220480;201607;2511;7159;2221;6725;150;440;1733;5265;1883;5705
220490;201607;2299;6551;2119;6326;72;285;1879;5558;1951;5843
220500;201607;3237;8701;2747;7865;106;462;2180;6061;2286;6523
220510;201607;2786;8009;2254;7107;115;435;1698;5341;1813;5776
220515;201607;1885;4622;1684;4357;119;297;1411;3672;1530;3969
220520;201607;5179;14137;4714;13525;107;345;4254;12259;4361;12604
220525;201607;1274;3624;1208;3526;55;205;1034;2998;1089;3203
220527;201607;1381;4226;1221;3905;131;433;879;2870;1010;3303
220530;201607;1276;3642;1118;3405;54;225;973;2891;1027;3116
220535;201607;868;2623;825;2566;69;247;645;1986;714;2233
220540;201607;3504;11198;3342;10947;150;659;2916;9452;3066;10111
220545;201607;1388;4616;1316;4477;136;536;1015;3406;1151;3942
220550;201607;9287;29635;8521;28336;741;2752;6443;21387;7184;24139
220551;201607;1473;4651;1340;4448;82;374;1066;3468;1148;3842
220552;201607;1626;5012;1401;4586;87;427;1087;3430;1174;3857
220553;201607;1602;4666;1335;4259;61;250;1045;3402;1106;3652
220554;201607;812;2344;718;2202;57;186;575;1764;632;1950
220555;201607;2223;6811;2049;6575;59;288;1827;5790;1886;6078
220556;201607;1442;4441;1278;4126;61;266;968;3034;1029;3300
220557;201607;1564;5067;1400;4751;137;539;986;3335;1123;3874
220558;201607;1083;3295;970;3112;60;270;760;2376;820;2646
220559;201607;1584;4469;1415;4185;35;126;1208;3568;1243;3694
220560;201607;1673;4164;1393;3782;46;147;1195;3188;1241;3335
220570;201607;7328;23546;6860;22725;1055;3677;4649;15689;5704;19366
220580;201607;6581;20600;6429;20384;234;884;5898;18613;6132;19497
220585;201607;2089;7120;1932;6841;168;661;1525;5390;1693;6051
220590;201607;1326;3924;1179;3711;142;480;850;2730;992;3210
220595;201607;2372;6936;2207;6720;43;191;2026;6116;2069;6307
220600;201607;1301;3141;1076;2856;116;202;838;2341;954;2543
220605;201607;1952;5695;1687;5269;77;303;1367;4204;1444;4507
220610;201607;2727;8256;2601;8084;64;270;2377;7355;2441;7625
220620;201607;7637;25405;7344;25005;324;1510;6512;21941;6836;23451
220630;201607;394;1216;328;1094;55;199;172;587;227;786
220635;201607;1680;5801;1500;5416;101;462;1091;3862;1192;4324
220640;201607;2654;7755;2371;7360;113;420;2003;6174;2116;6594
220650;201607;2205;6420;1949;5955;108;384;1484;4514;1592;4898
220660;201607;2811;8394;2523;8010;147;713;2178;6683;2325;7396
220665;201607;1184;3984;1092;3824;31;149;944;3297;975;3446
220667;201607;1693;5576;1568;5371;91;362;1300;4438;1391;4800
220669;201607;1858;6055;1759;5885;232;968;1248;4096;1480;5064
220670;201607;1977;5813;1735;5500;127;376;1459;4713;1586;5089
220672;201607;2517;7222;2345;7016;177;571;1998;6020;2175;6591
220675;201607;1281;3671;1199;3523;66;188;958;2830;1024;3018
220680;201607;2439;7499;2300;7319;126;422;1979;6315;2105;6737
220690;201607;1737;4789;1491;4399;119;347;1151;3459;1270;3806
220695;201607;947;2681;865;2537;38;126;690;2013;728;2139
220700;201607;8576;24345;7440;22609;570;2015;5686;17163;6256;19178
220710;201607;819;2412;660;2104;40;110;497;1589;537;1699
220720;201607;2097;5429;1970;5262;65;214;1743;4632;1808;4846
220730;201607;1385;3902;1171;3575;45;184;985;2959;1030;3143
220735;201607;1026;2615;823;2265;37;119;669;1814;706;1933
220740;201607;1390;4336;1206;4089;68;227;1014;3520;1082;3747
220750;201607;3988;11251;3664;10766;252;743;3034;8978;3286;9721
220755;201607;1203;3374;1069;3165;62;226;840;2443;902;2669
220760;201607;2714;9132;2472;8811;143;674;2095;7403;2238;8077
220770;201607;22215;73395;19832;68846;6656;24289;6643;24230;13299;48519
220775;201607;1268;3498;1219;3443;15;59;1189;3355;1204;3414
220777;201607;1614;4383;1364;3999;80;224;1063;3124;1143;3348
220779;201607;1409;3620;1333;3523;49;180;1184;3083;1233;3263
220780;201607;5901;15825;5185;14752;391;1239;4190;11893;4581;13132
220785;201607;1309;3356;1234;3239;35;102;1141;2970;1176;3072
220790;201607;10286;31054;9486;29845;668;2448;7699;24063;8367;26511
220793;201607;827;2333;740;2204;49;184;599;1755;648;1939
220795;201607;1442;4133;1374;4041;66;240;1244;3635;1310;3875
220800;201607;16324;44434;14680;42105;1029;3516;11100;31400;12129;34916
220810;201607;3354;9640;2904;8881;128;518;2307;6937;2435;7455
220820;201607;5503;14850;4979;14125;211;664;4352;12242;4563;12906
220830;201607;7569;21192;7021;20335;581;1819;5592;16206;6173;18025
220840;201607;14130;44424;12520;41246;2678;9112;6414;21508;9092;30620
220850;201607;2885;9794;2721;9587;99;419;2470;8761;2569;9180
220855;201607;616;1885;537;1745;43;169;409;1307;452;1476
220860;201607;952;2528;844;2358;38;137;713;1964;751;2101
220865;201607;2612;7157;2083;6236;87;429;1643;4745;1730;5174
220870;201607;2251;7505;1996;7175;48;223;1821;6557;1869;6780
220880;201607;4746;12792;4398;12390;77;249;4115;11622;4192;11871
220885;201607;1270;4579;1121;4303;97;442;853;3257;950;3699
220887;201607;1373;3422;1209;3191;16;53;1124;2958;1140;3011
220890;201607;1644;5634;1461;5296;126;450;1124;4180;1250;4630
220900;201607;1907;5282;1688;4957;51;157;1455;4237;1506;4394
220910;201607;1544;4686;1346;4390;57;181;1173;3885;1230;4066
220915;201607;1020;2865;874;2587;43;176;668;1917;711;2093
220920;201607;1357;4858;1225;4663;107;524;924;3432;1031;3956
220930;201607;1410;4602;1329;4475;56;262;1134;3802;1190;4064
220935;201607;1091;3286;942;2973;46;203;650;1978;696;2181
220937;201607;1504;4113;1270;3726;64;250;968;2763;1032;3013
220940;201607;1350;4261;1255;4086;91;398;906;2888;997;3286
220945;201607;432;1602;391;1517;36;181;282;1066;318;1247
220950;201607;1328;3260;924;2589;27;113;710;1918;737;2031
220955;201607;1471;4204;1296;3902;80;247;995;3012;1075;3259
220960;201607;921;2382;731;2068;27;86;570;1601;597;1687
220965;201607;1652;4906;1555;4762;68;337;1323;3916;1391;4253
220970;201607;2177;5729;1609;4812;121;413;1166;3519;1287;3932
220975;201607;691;2228;641;2163;29;160;583;1909;612;2069
220980;201607;1296;3872;1136;3613;64;241;871;2768;935;3009
220985;201607;1206;3566;1136;3467;98;389;880;2611;978;3000
220987;201607;1494;4732;1342;4479;97;422;1040;3389;1137;3811
220990;201607;1825;5273;1569;4838;55;266;1228;3689;1283;3955
220995;201607;1261;3704;962;3232;90;338;672;2329;762;2667
220997;201607;2281;6979;2180;6834;45;191;2040;6365;2085;6556
221000;201607;4244;12930;3964;12453;325;1279;3128;9663;3453;10942
221005;201607;1464;4539;1336;4303;381;1082;694;2380;1075;3462
221010;201607;1178;3047;1004;2835;36;132;874;2425;910;2557
221020;201607;1769;5491;1642;5257;86;378;1224;3858;1310;4236
221030;201607;1517;4468;1350;4191;75;302;1100;3373;1175;3675
221035;201607;1473;4033;1374;3905;59;141;1258;3645;1317;3786
221037;201607;628;1851;555;1733;21;87;401;1205;422;1292
221038;201607;602;1698;488;1502;33;115;318;986;351;1101
221039;201607;942;2621;844;2477;45;186;691;1961;736;2147
221040;201607;4568;14142;4266;13655;233;868;3460;11114;3693;11982
221050;201607;3494;10572;3262;10263;137;539;2838;8870;2975;9409
221060;201607;8204;23918;7074;22064;496;1715;5464;17059;5960;18774
221062;201607;1282;4488;1160;4242;53;292;954;3444;1007;3736
221063;201607;1074;3503;974;3328;134;438;674;2378;808;2816
221065;201607;2813;7559;2502;7072;91;288;2103;5869;2194;6157
221070;201607;3757;11842;3297;11039;170;691;2609;8770;2779;9461
221080;201607;3523;8942;2957;8168;100;331;2509;6938;2609;7269
221090;201607;1434;3887;1211;3528;50;222;1015;2886;1065;3108
221093;201607;1643;4874;1548;4683;224;751;963;2826;1187;3577
221095;201607;960;2544;845;2377;15;44;730;2038;745;2082
221097;201607;806;2247;651;1965;34;144;473;1386;507;1530
221100;201607;112538;328297;102754;312169;20338;66167;60548;182081;80886;248248
221110;201607;10426;32633;9668;31692;462;2034;8217;26701;8679;28735
221120;201607;4085;13191;3870;12820;648;2291;2667;8878;3315;11169
221130;201607;4679;13367;3890;11749;1072;3186;1750;5414;2822;8600
221135;201607;1524;4640;1410;4489;91;353;1196;3778;1287;4131
221140;201607;1353;3299;1220;3121;34;97;1069;2704;1103;2801
221150;201607;1221;3101;980;2689;30;120;772;2071;802;2191
221160;201607;827;2183;775;2111;44;139;612;1674;656;1813
221170;201607;1177;3544;1078;3382;42;162;882;2752;924;2914
230010;201607;3414;9177;2741;8026;211;746;2092;6010;2303;6756
230015;201607;2934;10005;2737;9579;352;1407;1735;6011;2087;7418
230020;201607;13783;44785;13360;44109;755;3027;11325;37232;12080;40259
230030;201607;12070;34510;10809;32543;551;2113;8872;26417;9423;28530
230040;201607;4557;12432;3816;11172;292;1029;2800;8091;3092;9120
230050;201607;2652;8946;2023;7249;486;1781;624;2308;1110;4089
230060;201607;2258;6443;1927;5857;109;447;1479;4413;1588;4860
230070;201607;4231;11670;3623;10660;293;1050;2447;7225;2740;8275
230075;201607;8935;31389;8321;30183;642;3276;6451;22783;7093;26059
230080;201607;2454;6344;1989;5668;95;357;1624;4552;1719;4909
230090;201607;3936;11248;3465;10449;369;1254;2479;7456;2848;8710
230100;201607;16829;49782;15529;47492;2460;8243;9586;29554;12046;37797
230110;201607;13139;41498;11993;39088;2342;8137;6479;21016;8821;29153
230120;201607;7965;21992;6866;20379;825;2476;4634;14427;5459;16903
230125;201607;3065;8769;2519;7807;192;715;1801;5526;1993;6241
230130;201607;5818;18930;4924;17002;474;1903;3310;11295;3784;13198
230140;201607;3560;11218;3005;10189;298;1106;2075;7088;2373;8194
230150;201607;1713;5288;1479;4807;315;1100;795;2568;1110;3668
230160;201607;6276;18509;5599;17503;329;1311;4505;13963;4834;15274
230170;201607;6345;19754;5490;18155;381;1513;3944;12943;4325;14456
230180;201607;1725;5053;1511;4626;90;388;1103;3220;1193;3608
230185;201607;3931;12801;3524;12062;561;2029;2225;7806;2786;9835
230190;201607;12699;40355;11224;37415;2146;7820;5584;18601;7730;26421
230195;201607;5354;16224;4662;15044;300;1225;3651;11537;3951;12762
230200;201607;5168;14797;4643;13778;411;1374;3488;10213;3899;11587
230205;201607;4182;13494;3770;12774;322;1445;2685;8955;3007;10400
230210;201607;9012;25655;7863;23836;1286;4145;4939;15257;6225;19402
230220;201607;13397;37708;12027;35338;1008;3467;8878;25699;9886;29166
230230;201607;7392;23479;6763;22278;773;2735;4697;15540;5470;18275
230240;201607;13906;38564;12147;35669;609;2293;9401;27162;10010;29455
230250;201607;9811;30226;9726;30083;643;2435;7550;22970;8193;25405
230260;201607;14371;47556;13298;45411;2091;7719;7689;26819;9780;34538
230270;201607;7580;22111;6430;20067;720;2536;4184;13077;4904;15613
230280;201607;20064;58411;17714;54423;1435;5056;13298;40446;14733;45502
230290;201607;4845;14549;4129;13109;534;1684;2786;8881;3320;10565
230300;201607;4367;13097;4150;12793;309;1163;3350;10196;3659;11359
230310;201607;4873;14566;4231;13439;223;911;3076;9642;3299;10553
230320;201607;7164;22084;6486;20902;504;2028;4836;15395;5340;17423
230330;201607;4857;14101;4087;12599;361;1220;2870;8741;3231;9961
230340;201607;3429;11455;3106;10776;346;1390;2038;6945;2384;8335
230350;201607;18345;55168;16670;52325;1791;6664;10208;32675;11999;39339
230360;201607;3268;9273;2603;8056;241;892;1709;5214;1950;6106
230365;201607;3054;8163;2659;7494;119;455;2134;5947;2253;6402
230370;201607;55137;174312;49559;164847;13302;46509;22058;76557;35360;123066
230380;201607;6572;19047;5443;16943;278;1052;3910;12017;4188;13069
230390;201607;3499;10968;3096;10294;276;1211;2191;7135;2467;8346
230393;201607;3221;10462;2747;9524;219;1066;1955;6529;2174;7595
230395;201607;5780;16706;5160;15648;786;2446;3114;9767;3900;12213
230400;201607;5560;16638;4891;15581;263;1191;3819;11941;4082;13132
230410;201607;14562;45927;12553;41756;1770;6326;7562;25223;9332;31549
230420;201607;24469;77794;22117;73191;4650;16678;10700;35422;15350;52100
230423;201607;4231;13786;3882;13094;295;1242;2928;9808;3223;11050
230425;201607;5585;18424;5098;17389;706;2544;3275;11224;3981;13768
230426;201607;2689;7492;2123;6441;97;413;1572;4655;1669;5068
230427;201607;1852;5479;1396;4479;153;525;805;2501;958;3026
230428;201607;8812;27170;8338;26303;1403;4945;4852;15155;6255;20100
230430;201607;4605;14473;4231;13801;342;1385;3071;9778;3413;11163
230435;201607;5027;15718;4496;14743;724;2774;2547;8272;3271;11046
230440;201607;362865;1057031;328966;999629;74300;240227;159964;492124;234264;732351
230445;201607;4603;12351;3890;11269;279;843;2771;8046;3050;8889
230450;201607;3645;11361;3174;10516;338;1451;2153;7017;2491;8468
230460;201607;1974;6396;1690;5868;173;696;1170;4040;1343;4736
230465;201607;4021;11889;3361;10681;251;1018;2229;6913;2480;7931
230470;201607;10961;39608;10124;37886;1222;5292;7031;26215;8253;31507
230480;201607;1489;4605;1243;4127;174;688;814;2635;988;3323
230490;201607;2307;7013;1995;6402;306;1073;1005;3128;1311;4201
230495;201607;5792;18885;5170;17759;747;3095;2870;9797;3617;12892
230500;201607;9026;31779;8587;30913;711;3150;6475;23225;7186;26375
230510;201607;1511;5301;1144;4350;300;1240;369;1414;669;2654
230520;201607;4863;14710;4377;13852;464;1739;2862;8944;3326;10683
230523;201607;15006;48055;13069;43681;3241;11849;3440;11882;6681;23731
230526;201607;4090;12165;3497;11112;237;1018;2692;8410;2929;9428
230530;201607;5431;17305;4876;16549;752;2748;3314;11604;4066;14352
230533;201607;4057;11226;3490;10154;372;1057;2480;7300;2852;8357
230535;201607;5571;16295;4842;14987;600;1918;3050;9735;3650;11653
230540;201607;17576;51055;15828;48314;639;2697;13169;39689;13808;42386
230550;201607;19688;57897;17400;53632;3100;10745;9387;28368;12487;39113
230560;201607;6888;19645;5916;17877;248;1079;4537;13478;4785;14557
230565;201607;3489;9578;2818;8353;116;445;2097;6178;2213;6623
230570;201607;3698;9960;3261;9408;131;515;2710;7719;2841;8234
230580;201607;10069;30162;9295;29055;543;2103;7910;24559;8453;26662
230590;201607;9199;28108;7853;25609;624;2627;5527;17526;6151;20153
230600;201607;3858;10508;2906;8625;136;421;1854;5540;1990;5961
230610;201607;6226;19583;5681;18690;696;2366;4021;13423;4717;15789
230620;201607;2193;6187;1739;5231;221;736;985;2873;1206;3609
230625;201607;7916;25432;7110;23616;2119;7556;2141;7221;4260;14777
230630;201607;11013;34636;10060;32875;2575;8017;4825;16915;7400;24932
230640;201607;26307;84591;24047;81182;2692;10471;17934;60239;20626;70710
230650;201607;4907;14942;4417;14004;296;1201;3341;10341;3637;11542
230655;201607;9262;34607;8888;33903;793;3431;6943;26688;7736;30119
230660;201607;6159;19043;5259;17328;351;1622;4008;12865;4359;14487
230670;201607;6108;16185;4869;14058;165;630;3760;10553;3925;11183
230680;201607;2665;7806;2292;7087;327;1070;1380;4264;1707;5334
230690;201607;6365;20397;6132;19910;716;2661;3848;12248;4564;14909
230700;201607;9702;26896;8571;24874;686;2515;6112;17173;6798;19688
230710;201607;7547;24287;6547;22433;753;2784;4548;15643;5301;18427
230720;201607;1851;5833;1583;5262;219;802;949;3136;1168;3938
230725;201607;3714;12490;3229;11314;758;2746;1145;4014;1903;6760
230730;201607;57188;171672;48099;156555;14089;51685;11227;38758;25316;90443
230740;201607;6145;18158;5531;17129;248;1048;4431;13521;4679;14569
230750;201607;8468;24284;7220;22237;441;1736;5461;16569;5902;18305
230760;201607;11052;32454;10147;30650;1081;3913;7013;20458;8094;24371
230763;201607;4327;13048;3838;12130;240;1060;2871;8711;3111;9771
230765;201607;39288;122886;35053;114688;9463;33218;10946;37166;20409;70384
230770;201607;25135;69094;22475;65201;2919;9187;14855;43060;17774;52247
230780;201607;5955;22743;5702;22181;1342;5381;2935;11965;4277;17346
230790;201607;2820;8905;2597;8525;240;918;1959;6426;2199;7344
230800;201607;7562;26445;6871;24937;1432;5734;3240;11573;4672;17307
230810;201607;12321;39420;11543;38099;916;3510;8926;29261;9842;32771
230820;201607;3325;11407;2907;10503;436;1809;1627;5806;2063;7615
230830;201607;7561;22662;6660;20997;457;1822;4984;15489;5441;17311
230835;201607;4002;10462;3244;9300;171;602;2512;7155;2683;7757
230837;201607;3232;10779;2757;9808;256;1149;1911;6639;2167;7788
230840;201607;9247;29712;8439;28348;721;2758;6467;21872;7188;24630
230850;201607;9604;29811;8880;28560;1082;3726;6167;20000;7249;23726
230860;201607;5147;14492;4565;13644;238;873;3731;11074;3969;11947
230870;201607;18822;49199;16155;45217;810;2706;12380;34462;13190;37168
230880;201607;1990;6689;1885;6468;152;701;1340;4503;1492;5204
230890;201607;3964;14296;3673;13673;461;2142;2337;8443;2798;10585
230900;201607;2917;9636;2421;8550;494;1690;1137;4138;1631;5828
230910;201607;3159;9149;2595;8150;194;850;1900;5775;2094;6625
230920;201607;4721;13545;4388;13124;217;800;3737;11238;3954;12038
230930;201607;7188;21504;6316;19880;571;1985;4317;13587;4888;15572
230940;201607;7970;22454;6998;20937;283;1014;5719;17121;6002;18135
230945;201607;6084;18319;5383;17209;473;1722;3679;11995;4152;13717
230950;201607;6468;17413;5849;16601;229;636;5075;14690;5304;15326
230960;201607;14414;44018;13170;41657;2550;8585;6306;20302;8856;28887
230970;201607;13938;41926;12192;38767;2415;8674;5650;17750;8065;26424
230980;201607;2957;9126;2575;8442;626;2025;1328;4614;1954;6639
230990;201607;1773;5210;1462;4607;136;549;947;2876;1083;3425
231000;201607;2728;7410;2173;6325;145;490;1414;4023;1559;4513
231010;201607;3148;8589;2555;7607;286;965;1695;4938;1981;5903
231020;201607;7925;26430;7491;25523;1303;4527;4528;15757;5831;20284
231025;201607;8016;24350;7270;23062;1009;3397;4728;15283;5737;18680
231030;201607;7615;24406;6378;21875;1179;4335;3465;11948;4644;16283
231040;201607;3149;9873;2801;9181;161;749;2065;6550;2226;7299
231050;201607;11959;33766;10126;30527;759;2616;7409;22209;8168;24825
231060;201607;2433;7833;2254;7504;168;816;1649;5334;1817;6150
231070;201607;8682;27254;7766;25401;1454;5022;4197;13988;5651;19010
231080;201607;3883;12078;3540;11480;180;942;2736;8519;2916;9461
231085;201607;4898;15045;4703;14776;592;1876;3382;11035;3974;12911
231090;201607;4195;11656;3322;9920;185;665;2296;6736;2481;7401
231095;201607;2212;7108;1916;6506;227;881;1261;4284;1488;5165
231100;201607;3221;9903;2675;8862;202;809;1899;6224;2101;7033
231110;201607;3549;11664;3507;11588;359;1395;2451;8011;2810;9406
231120;201607;1986;6733;1871;6496;290;1100;1179;4134;1469;5234
231123;201607;2071;5651;1784;5160;125;405;1367;3910;1492;4315
231126;201607;6310;17802;5228;15928;291;1142;3813;11420;4104;12562
231130;201607;19321;58556;17417;55450;3120;10521;10483;34745;13603;45266
231135;201607;4196;12471;3561;11327;265;995;2490;7861;2755;8856
231140;201607;17267;53535;15102;49460;1367;6013;10030;31768;11397;37781
231150;201607;5805;16656;4992;15181;801;2600;2533;7833;3334;10433
231160;201607;5854;19219;5443;18398;951;3390;3255;11109;4206;14499
231170;201607;4330;13783;3850;12791;323;1406;2712;8756;3035;10162
231180;201607;14362;42313;12722;38975;2272;7375;6976;21196;9248;28571
231190;201607;4582;12831;3839;11694;256;1047;2906;8563;3162;9610
231195;201607;4650;15372;4008;14117;418;1845;2735;9477;3153;11322
231200;201607;7838;26403;6843;24339;451;2249;4890;16951;5341;19200
231210;201607;4992;15601;4325;14644;292;1360;3318;11085;3610;12445
231220;201607;11887;33987;10428;31308;630;2460;7689;22623;8319;25083
231230;201607;9301;30657;8400;29293;892;3696;6178;21589;7070;25285
231240;201607;12249;37961;11022;35505;2269;7678;5560;18123;7829;25801
231250;201607;1953;5589;1335;4084;346;1066;370;1102;716;2168
231260;201607;3480;10350;3123;9775;524;1692;1915;6129;2439;7821
231270;201607;7287;19828;6391;18436;352;1455;4855;13712;5207;15167
231280;201607;1762;5740;1646;5529;183;660;1125;3810;1308;4470
231290;201607;34081;113899;30723;106320;6474;24943;13543;46099;20017;71042
231300;201607;4521;13026;3656;11332;252;952;2460;7447;2712;8399
231310;201607;7470;21114;6160;18375;874;2725;3518;10379;4392;13104
231320;201607;7055;21281;5884;18941;302;1259;4202;13401;4504;14660
231325;201607;2786;8087;2423;7526;337;1164;1527;4762;1864;5926
231330;201607;12204;38128;10395;34571;1812;6129;5782;19501;7594;25630
231335;201607;5460;15341;4705;13966;193;798;3751;10912;3944;11710
231340;201607;17690;57951;16264;55698;1195;4354;12812;44698;14007;49052
231350;201607;14204;42296;13403;41208;756;2282;11665;36378;12421;38660
231355;201607;4592;14431;4194;13755;288;1203;3091;10052;3379;11255
231360;201607;7730;24502;6844;22954;1079;3767;4441;15271;5520;19038
231370;201607;2439;6766;1893;5856;89;325;1417;4375;1506;4700
231375;201607;4278;14388;3987;13856;260;1174;3131;10782;3391;11956
231380;201607;5513;16638;5212;16251;343;1181;4168;13264;4511;14445
231390;201607;3480;10769;3186;10261;303;1155;2283;7275;2586;8430
231395;201607;3863;12598;3502;11918;581;2066;2090;7168;2671;9234
231400;201607;9060;27802;8385;26474;589;2285;6226;19410;6815;21695
231410;201607;14433;48532;13220;46664;1188;4630;10061;35699;11249;40329
240010;201607;2482;7370;2061;6537;334;1193;1073;3305;1407;4498
240020;201607;10701;33360;9563;31234;1881;6581;4953;16379;6834;22960
240030;201607;2543;7180;2456;7048;143;500;2118;6006;2261;6506
240040;201607;853;2495;711;2211;36;175;500;1474;536;1649
240050;201607;3475;9388;2948;8474;127;460;2356;6655;2483;7115
240060;201607;1418;4016;1257;3714;62;246;998;2834;1060;3080
240070;201607;2559;7588;2382;7247;329;1107;1628;4850;1957;5957
240080;201607;3076;8174;2647;7584;149;513;2056;5841;2205;6354
240090;201607;2297;6141;1886;5407;60;236;1465;4113;1525;4349
240100;201607;7878;22698;7011;20934;601;2108;5049;14640;5650;16748
240110;201607;4819;15046;4291;13971;676;2510;2379;7513;3055;10023
240120;201607;2715;9285;2591;9040;377;1521;1676;5790;2053;7311
240130;201607;2784;7494;2437;6949;97;372;2002;5615;2099;5987
240140;201607;2241;6690;1910;6079;286;1101;1115;3430;1401;4531
240145;201607;5783;18146;5202;17097;1312;4471;2692;9165;4004;13636
240150;201607;989;2988;817;2627;85;350;536;1648;621;1998
240160;201607;1455;4600;1252;4250;138;557;804;2757;942;3314
240165;201607;900;2816;792;2597;128;398;475;1640;603;2038
240170;201607;2332;7035;2037;6487;469;1634;1010;3206;1479;4840
240180;201607;2680;8439;2370;7805;391;1399;1451;4855;1842;6254
240185;201607;1416;4684;1317;4523;94;359;1048;3614;1142;3973
240190;201607;968;3057;864;2877;48;219;652;2165;700;2384
240200;201607;13511;35356;11282;32193;2554;7663;4885;14334;7439;21997
240210;201607;2946;8146;2653;7711;149;567;2189;6227;2338;6794
240220;201607;7382;24572;6831;23748;726;3134;5053;17424;5779;20558
240230;201607;5661;14990;4895;13804;137;500;4189;11768;4326;12268
240240;201607;1827;5533;1222;4060;239;869;218;647;457;1516
240250;201607;2696;7859;2535;7636;132;456;2192;6582;2324;7038
240260;201607;12320;41311;11687;40283;1824;7096;7722;26678;9546;33774
240270;201607;2258;7235;2073;6917;188;668;1582;5355;1770;6023
240280;201607;1584;4451;1412;4200;83;296;1132;3351;1215;3647
240290;201607;1274;3975;1126;3695;90;449;723;2224;813;2673
240300;201607;2289;6263;1701;5033;249;813;784;2257;1033;3070
240310;201607;9581;27168;8650;25721;1206;3994;4818;14536;6024;18530
240320;201607;2043;6031;1611;5145;70;297;1139;3516;1209;3813
240325;201607;34609;95319;27826;84591;8342;27078;7252;23488;15594;50566
240330;201607;1502;4567;1269;4074;94;388;804;2501;898;2889
240340;201607;2074;5353;1756;4853;171;532;1308;3573;1479;4105
240350;201607;1991;5727;1879;5593;100;358;1672;4972;1772;5330
240360;201607;7146;21596;6378;20447;1492;4951;3305;11097;4797;16048
240370;201607;2038;5602;1629;4839;169;506;1044;3120;1213;3626
240375;201607;860;2309;754;2125;59;227;541;1421;600;1648
240380;201607;2430;7233;1860;5959;255;845;971;3103;1226;3948
240390;201607;932;2577;782;2292;45;169;562;1595;607;1764
240400;201607;1334;3617;1071;3115;81;285;730;2053;811;2338
240410;201607;487;1612;435;1507;72;305;264;888;336;1193
240420;201607;4664;17827;4379;17193;857;3779;2455;9688;3312;13467
240430;201607;3309;9334;3016;8805;163;680;2395;6767;2558;7447
240440;201607;2496;6488;2234;6102;459;1342;1284;3456;1743;4798
240450;201607;3842;11419;3296;10363;361;1452;1972;5925;2333;7377
240460;201607;2897;8916;2734;8695;205;922;2226;6907;2431;7829
240470;201607;3577;11205;2823;9554;693;2341;1397;4839;2090;7180
240480;201607;525;1407;408;1184;36;121;203;570;239;691
240485;201607;1981;6258;1744;5777;257;925;1094;3649;1351;4574
240490;201607;1731;4383;1442;3938;44;165;1216;3272;1260;3437
240500;201607;2165;6169;1957;5861;133;501;1564;4634;1697;5135
240510;201607;1802;5307;1691;5141;128;412;1383;4214;1511;4626
240520;201607;1241;3607;1115;3391;96;371;847;2491;943;2862
240530;201607;2003;6477;1836;6214;301;1070;1272;4312;1573;5382
240540;201607;1746;5203;1668;5078;126;447;1385;4180;1511;4627
240550;201607;798;2278;684;2078;51;175;500;1500;551;1675
240560;201607;3228;9311;3006;8980;301;862;2351;7112;2652;7974
240570;201607;3084;8579;2284;6800;471;1521;849;2265;1320;3786
240580;201607;7742;23982;7184;23007;740;2785;5594;17659;6334;20444
240590;201607;777;2163;674;1974;29;113;510;1472;539;1585
240600;201607;1617;4719;1257;3958;145;545;716;2149;861;2694
240610;201607;4638;13341;4055;12238;473;1619;2623;7757;3096;9376
240615;201607;1047;3052;840;2656;148;505;471;1424;619;1929
240620;201607;1811;5525;1604;5176;165;559;1212;3920;1377;4479
240630;201607;2070;6259;1885;5947;192;589;1331;4292;1523;4881
240640;201607;920;2604;777;2374;45;197;558;1652;603;1849
240650;201607;3935;11646;3504;11007;191;724;2781;8669;2972;9393
240660;201607;2392;7613;2245;7393;197;745;1767;5778;1964;6523
240670;201607;2639;7876;2204;6969;288;999;1246;3876;1534;4875
240680;201607;1515;4424;1228;3909;95;373;818;2551;913;2924
240690;201607;959;2611;820;2372;48;184;657;1841;705;2025
240700;201607;2600;7758;2186;7008;108;473;1673;5269;1781;5742
240710;201607;18757;48990;16190;45098;3034;8553;9112;26046;12146;34599
240720;201607;5256;15013;4770;14125;1253;3824;2347;6850;3600;10674
240725;201607;1069;3206;860;2757;80;276;504;1574;584;1850
240730;201607;2137;6456;1853;5920;127;452;1366;4346;1493;4798
240740;201607;1984;5808;1763;5407;169;653;1247;3708;1416;4361
240750;201607;2155;8013;1997;7711;431;1843;1048;4110;1479;5953
240760;201607;1338;3618;1113;3310;107;283;830;2602;937;2885
240770;201607;3163;9049;2826;8581;167;722;2328;6926;2495;7648
240780;201607;6132;16855;4943;14959;714;2282;2894;8905;3608;11187
240790;201607;907;2742;757;2468;47;194;529;1730;576;1924
240800;201607;35394;101048;31407;94408;7506;23868;13597;41569;21103;65437
240810;201607;86011;247050;79301;235665;21163;64403;37104;113143;58267;177546
240820;201607;6353;19367;5563;18117;1366;4798;2440;8342;3806;13140
240830;201607;8732;26979;8143;26122;387;1721;6855;21710;7242;23431
240840;201607;1218;3377;1031;3076;105;353;645;1863;750;2216
240850;201607;1310;3828;969;3047;139;482;491;1539;630;2021
240860;201607;1321;3745;1074;3310;67;266;805;2394;872;2660
240870;201607;1188;3225;970;2824;88;288;624;1725;712;2013
240880;201607;1175;3904;1107;3796;105;482;888;2938;993;3420
240890;201607;5017;14231;4236;12765;950;3088;1814;5377;2764;8465
240895;201607;2656;9134;2448;8770;264;1034;1785;6468;2049;7502
240910;201607;2889;8650;2547;8000;158;593;1967;6131;2125;6724
240920;201607;765;2469;667;2257;115;428;344;1152;459;1580
240930;201607;3513;9055;3091;8542;139;408;2539;7099;2678;7507
240933;201607;1458;4017;1286;3736;51;215;1013;2839;1064;3054
240940;201607;6674;17660;5343;15454;694;2057;3322;9525;4016;11582
240950;201607;963;3142;890;3011;66;308;662;2171;728;2479
240960;201607;799;2474;707;2300;57;202;506;1661;563;1863
240970;201607;1907;5295;1605;4784;103;402;1237;3563;1340;3965
240980;201607;2962;9796;2745;9396;509;1898;1662;5696;2171;7594
240990;201607;2801;8300;2631;7978;440;1476;1658;4935;2098;6411
241000;201607;1065;2957;900;2663;55;212;627;1822;682;2034
241010;201607;2795;9453;2613;9102;321;1404;1859;6221;2180;7625
241020;201607;2057;5710;1656;4902;207;632;1010;2941;1217;3573
241025;201607;1642;4972;1454;4633;65;292;1040;3267;1105;3559
241030;201607;2531;8256;2255;7709;215;937;1582;5326;1797;6263
241040;201607;2204;7513;2010;7167;167;689;1455;5235;1622;5924
241050;201607;1287;3807;1123;3524;85;332;838;2572;923;2904
241060;201607;874;2512;784;2366;70;242;559;1663;629;1905
241070;201607;774;2246;696;2107;65;242;508;1476;573;1718
241080;201607;1160;3418;956;3015;60;263;683;2102;743;2365
241090;201607;2179;6430;1836;5842;115;496;1384;4331;1499;4827
241100;201607;1185;3526;1026;3164;85;312;681;2058;766;2370
241105;201607;1195;3610;1040;3330;255;820;479;1627;734;2447
241110;201607;840;2599;698;2299;64;278;448;1417;512;1695
241120;201607;7317;22337;6653;21251;1467;4628;3733;12512;5200;17140
241140;201607;3425;9333;2953;8412;275;829;2086;5820;2361;6649
241142;201607;725;2157;544;1771;131;477;231;716;362;1193
241150;201607;5446;16026;4860;15023;541;1858;3310;10220;3851;12078
241160;201607;980;2870;874;2689;142;460;559;1709;701;2169
241170;201607;1164;3408;1082;3263;85;292;863;2563;948;2855
241180;201607;955;2655;770;2295;101;330;409;1194;510;1524
241190;201607;1202;3312;954;2806;66;250;619;1750;685;2000
241200;201607;19221;55614;17018;52225;4296;14132;7469;23563;11765;37695
241210;201607;1456;4084;1169;3496;156;554;666;1922;822;2476
241220;201607;7938;25986;7350;24899;1953;6822;3643;12751;5596;19573
241230;201607;3027;8850;2793;8477;166;637;2314;6891;2480;7528
241240;201607;1231;3618;841;2710;106;392;355;1130;461;1522
241250;201607;6066;18599;5056;16640;299;1510;3851;12269;4150;13779
241255;201607;1701;6473;1564;6153;343;1463;799;3158;1142;4621
241260;201607;5177;13973;4162;12380;235;987;3093;9060;3328;10047
241270;201607;1891;5763;1661;5304;134;529;1146;3590;1280;4119
241280;201607;1859;5359;1687;5029;149;478;1229;3647;1378;4125
241290;201607;3033;8445;2582;7676;197;724;1846;5372;2043;6096
241300;201607;1451;4167;1246;3792;63;211;867;2638;930;2849
241310;201607;1624;4814;1487;4588;116;451;1152;3516;1268;3967
241320;201607;921;3158;841;2991;120;501;538;1893;658;2394
241330;201607;1440;4485;1358;4377;108;459;1139;3608;1247;4067
241335;201607;2791;8425;2571;8032;134;502;2121;6543;2255;7045
241340;201607;1840;5685;1574;5103;363;1285;713;2233;1076;3518
241350;201607;1934;6126;1754;5781;150;651;1302;4165;1452;4816
241355;201607;1435;3984;1171;3532;70;257;917;2745;987;3002
241360;201607;2101;5674;1733;4956;87;298;1253;3463;1340;3761
241370;201607;1356;4061;1120;3582;108;403;693;2181;801;2584
241380;201607;656;1862;563;1687;72;256;340;984;412;1240
241390;201607;2782;9074;2592;8751;279;1124;1949;6543;2228;7667
241400;201607;3691;10626;3347;10130;378;1263;2504;7647;2882;8910
241410;201607;2489;7582;2241;7231;397;1419;1420;4577;1817;5996
241415;201607;1658;4975;1493;4719;104;397;1161;3582;1265;3979
241420;201607;2288;7890;2014;7414;663;2685;520;1904;1183;4589
241430;201607;574;1698;445;1407;51;188;243;731;294;919
241440;201607;6331;22669;5925;22023;860;3521;4236;15856;5096;19377
241445;201607;1002;2906;957;2853;68;171;787;2485;855;2656
241450;201607;3025;8217;2650;7692;344;1097;1801;5191;2145;6288
241460;201607;3422;9916;3029;9144;252;931;2163;6376;2415;7307
241470;201607;1414;3904;1159;3569;127;453;841;2575;968;3028
241475;201607;1263;3784;1054;3375;56;277;775;2382;831;2659
241480;201607;2793;9218;2568;8823;1040;3697;671;2574;1711;6271
241490;201607;685;1809;593;1685;38;107;378;1053;416;1160
241500;201607;710;2276;617;2142;28;119;502;1738;530;1857
250010;201607;2794;8631;2382;7748;133;592;1783;5676;1916;6268
250020;201607;1676;4772;1270;4015;88;383;868;2642;956;3025
250030;201607;6979;20235;6480;19535;441;1509;5345;15991;5786;17500
250040;201607;4146;13899;3823;13197;570;2127;2437;8414;3007;10541
250050;201607;3448;10855;3206;10475;483;1674;2132;6878;2615;8552
250053;201607;1239;3708;1134;3556;142;470;793;2525;935;2995
250057;201607;619;2611;607;2597;7;12;579;2546;586;2558
250060;201607;5197;15426;4863;14938;422;1502;3882;11829;4304;13331
250070;201607;4026;12415;3725;11898;172;822;2894;8937;3066;9759
250073;201607;796;2340;691;2159;41;159;563;1726;604;1885
250077;201607;2174;6308;1804;5718;140;494;1264;4030;1404;4524
250080;201607;4182;12148;3987;11818;310;1084;3168;9217;3478;10301
250090;201607;2570;7381;2419;7141;119;364;1984;5794;2103;6158
250100;201607;3846;12579;3626;12179;308;1247;2826;9321;3134;10568
250110;201607;5064;15076;4774;14658;423;1586;3832;11595;4255;13181
250115;201607;532;1696;474;1579;27;138;323;1017;350;1155
250120;201607;1985;6053;1706;5517;115;452;1308;4211;1423;4663
250130;201607;5317;16596;4888;15861;245;1054;4055;13063;4300;14117
250135;201607;1075;3214;983;3063;40;145;790;2461;830;2606
250140;201607;2037;6775;1948;6637;181;777;1511;5122;1692;5899
250150;201607;5046;16893;4581;16035;338;1526;3413;11772;3751;13298
250153;201607;1451;3964;1267;3706;51;230;1079;3081;1130;3311
250157;201607;1714;5595;1580;5340;179;661;1129;3825;1308;4486
250160;201607;3295;9767;3141;9532;117;435;2860;8659;2977;9094
250170;201607;1608;4702;1467;4493;130;448;1118;3425;1248;3873
250180;201607;15971;46553;14981;45056;1575;5665;11026;32447;12601;38112
250190;201607;4218;12071;3833;11469;599;1858;2392;7098;2991;8956
250200;201607;2024;5911;1693;5421;106;417;1393;4445;1499;4862
250205;201607;881;3019;816;2877;52;242;593;2077;645;2319
250210;201607;1462;4793;1373;4664;106;468;1083;3602;1189;4070
250215;201607;1370;4454;1294;4336;122;511;872;2906;994;3417
250220;201607;752;2280;659;2156;38;155;535;1754;573;1909
250230;201607;1536;3875;1260;3427;54;207;995;2576;1049;2783
250240;201607;2312;7688;2181;7446;132;540;1771;6028;1903;6568
250250;201607;4363;13085;4010;12613;194;663;3424;10821;3618;11484
250260;201607;1714;5195;1487;4835;93;343;1153;3761;1246;4104
250270;201607;1278;4020;1164;3882;89;327;893;3060;982;3387
250280;201607;3624;10705;3195;10037;313;1035;2431;7650;2744;8685
250290;201607;1917;5108;1605;4698;33;128;1404;4116;1437;4244
250300;201607;5550;16232;5263;15896;474;1900;4409;13004;4883;14904
250310;201607;1160;3543;1035;3343;82;324;801;2548;883;2872
250320;201607;8146;24549;7690;23810;930;3314;5463;16555;6393;19869
250330;201607;2403;7515;2080;7037;168;705;1584;5307;1752;6012
250340;201607;1097;3239;979;3031;38;158;823;2498;861;2656
250350;201607;4140;11522;3720;11015;148;561;3218;9564;3366;10125
250355;201607;1893;6090;1738;5874;74;352;1491;4970;1565;5322
250360;201607;1856;5430;1726;5235;63;193;1471;4479;1534;4672
250370;201607;11628;33702;10492;32426;747;2398;9090;28287;9837;30685
250375;201607;1085;3297;1002;3180;39;157;873;2781;912;2938
250380;201607;1672;4794;1589;4692;95;369;1366;3960;1461;4329
250390;201607;1861;5060;1500;4444;179;541;978;2907;1157;3448
250400;201607;73028;193867;58042;170240;14681;45880;23167;69918;37848;115798
250403;201607;1517;4943;1400;4786;216;909;931;3094;1147;4003
250407;201607;1210;3376;1033;3098;88;289;763;2232;851;2521
250410;201607;545;1773;509;1710;33;163;399;1298;432;1461
250415;201607;1848;5516;1675;5215;104;352;1264;3887;1368;4239
250420;201607;1278;3772;1161;3596;32;131;1029;3172;1061;3303
250430;201607;6243;16956;5743;16216;271;962;4783;13215;5054;14177
250435;201607;1373;4201;1232;3948;108;391;881;2825;989;3216
250440;201607;4439;12762;4079;12265;146;507;3488;10449;3634;10956
250450;201607;1946;5504;1731;5220;72;285;1457;4322;1529;4607
250460;201607;6475;19458;6043;18886;504;1672;4877;15468;5381;17140
250470;201607;1592;4299;1350;3967;125;462;947;2674;1072;3136
250480;201607;3751;11352;3485;10988;115;514;3047;9590;3162;10104
250485;201607;669;1686;557;1517;33;108;450;1191;483;1299
250490;201607;3828;11928;3736;11797;657;2063;2756;8815;3413;10878
250500;201607;1764;5333;1583;5039;164;528;1173;3798;1337;4326
250510;201607;4898;13886;4370;13121;164;551;3830;11542;3994;12093
250520;201607;1770;5334;1653;5160;271;961;1022;3160;1293;4121
250523;201607;1633;5072;1587;5008;145;558;1294;4023;1439;4581
250527;201607;1409;4227;1338;4142;39;193;1224;3718;1263;3911
250530;201607;619;1881;537;1781;26;83;476;1593;502;1676
250535;201607;1309;4109;1230;3955;69;309;988;3095;1057;3404
250540;201607;2407;6845;2239;6651;69;314;1945;5660;2014;5974
250550;201607;914;3012;833;2889;57;276;662;2239;719;2515
250560;201607;1665;5215;1597;5118;74;324;1398;4393;1472;4717
250570;201607;2633;8304;2311;7681;150;675;1783;5766;1933;6441
250580;201607;1136;3024;977;2780;75;282;790;2174;865;2456
250590;201607;855;2664;796;2587;58;246;665;2106;723;2352
250600;201607;7356;21414;6887;20727;675;2085;5387;16330;6062;18415
250610;201607;3160;9085;2928;8740;253;856;2260;6699;2513;7555
250620;201607;697;2049;615;1881;82;277;400;1202;482;1479
250625;201607;2416;7745;2368;7682;52;122;2264;7441;2316;7563
250630;201607;9452;29376;8659;27788;2003;6703;4607;14863;6610;21566
250640;201607;3443;10589;3272;10367;201;862;2812;8756;3013;9618
250650;201607;851;2373;739;2213;57;230;558;1576;615;1806
250660;201607;1826;4920;1664;4709;24;51;1573;4495;1597;4546
250670;201607;2386;8029;2267;7821;149;698;1877;6343;2026;7041
250680;201607;4874;13756;4628;13463;174;656;4178;12122;4352;12778
250690;201607;6055;15801;5774;15473;348;1027;5195;13844;5543;14871
250700;201607;4739;13974;4343;13387;657;2214;2956;9033;3613;11247
250710;201607;4423;13698;3999;13136;434;1567;2864;9525;3298;11092
250720;201607;2703;7796;2530;7541;84;359;2245;6634;2329;6993
250730;201607;3525;10629;3286;10304;296;1108;2563;7900;2859;9008
250740;201607;1910;5557;1659;5173;167;662;1262;3786;1429;4448
250750;201607;100486;282851;92182;270776;12287;40112;62630;182017;74917;222129
250760;201607;2253;6407;2018;6067;141;554;1645;4869;1786;5423
250770;201607;3905;12989;3684;12702;467;1863;2639;9039;3106;10902
250780;201607;1836;5331;1583;4880;185;704;1031;3078;1216;3782
250790;201607;2400;7795;2275;7589;454;1523;1402;4816;1856;6339
250800;201607;2647;7416;2344;6933;105;355;1926;5603;2031;5958
250810;201607;1298;3800;1134;3547;75;323;891;2739;966;3062
250820;201607;1855;5836;1780;5743;79;332;1608;5149;1687;5481
250830;201607;5638;18138;5205;17277;574;2253;3649;11890;4223;14143
250840;201607;904;2944;768;2652;63;261;522;1811;585;2072
250850;201607;1989;6133;1804;5832;104;480;1419;4501;1523;4981
250855;201607;1084;3196;968;3027;57;243;719;2168;776;2411
250860;201607;3185;10321;2745;9513;693;2620;1048;3714;1741;6334
250870;201607;1064;3102;950;2875;41;166;735;2179;776;2345
250880;201607;1461;3994;1254;3710;144;449;943;2809;1087;3258
250890;201607;9331;28057;8798;27326;1187;4479;6353;19172;7540;23651
250900;201607;2835;9149;2480;8454;194;702;1853;6303;2047;7005
250905;201607;2021;6400;1939;6296;217;775;1536;4979;1753;5754
250910;201607;4942;14412;4656;13987;240;885;3863;11525;4103;12410
250915;201607;1405;4323;1380;4288;78;208;1228;3892;1306;4100
250920;201607;3274;9291;3072;8989;293;921;2294;6693;2587;7614
250930;201607;2017;6188;1891;5988;180;715;1413;4374;1593;5089
250933;201607;1128;3684;1049;3532;113;456;715;2380;828;2836
250937;201607;672;2062;603;1928;62;240;433;1344;495;1584
250939;201607;1541;4697;1441;4537;141;500;1023;3186;1164;3686
250940;201607;3787;11207;3547;10829;110;414;3059;9375;3169;9789
250950;201607;1288;3921;1136;3717;57;243;885;2906;942;3149
250960;201607;1081;3486;1027;3402;68;259;828;2717;896;2976
250970;201607;8466;23374;7423;21761;657;2143;5519;16080;6176;18223
250980;201607;2563;7556;2340;7162;130;562;1758;5188;1888;5750
250990;201607;1953;6604;1748;6163;255;1084;1115;3783;1370;4867
251000;201607;2112;6269;1894;5935;88;389;1580;4886;1668;5275
251010;201607;2763;8092;2476;7637;93;341;2144;6620;2237;6961
251020;201607;1640;4645;1501;4469;59;200;1375;4086;1434;4286
251030;201607;1084;3071;993;2917;70;268;730;2083;800;2351
251040;201607;1787;5595;1608;5297;106;511;1203;3827;1309;4338
251050;201607;1073;3097;912;2799;126;405;564;1703;690;2108
251060;201607;1026;2345;776;2027;40;136;619;1607;659;1743
251065;201607;468;1398;409;1308;32;122;278;833;310;955
251070;201607;623;1753;560;1663;40;154;445;1271;485;1425
251080;201607;19436;54564;17510;51445;4508;13863;8171;24846;12679;38709
251090;201607;2987;9206;2646;8566;210;809;1938;6167;2148;6976
251100;201607;982;3083;888;2923;89;378;594;1879;683;2257
251110;201607;1942;5668;1697;5195;149;482;1175;3581;1324;4063
251120;201607;6125;20654;5835;20136;630;2602;4407;14971;5037;17573
251130;201607;3976;10364;3645;10007;59;147;3514;9685;3573;9832
251140;201607;4250;12914;4002;12518;139;604;3381;10528;3520;11132
251150;201607;2586;8279;2409;8006;188;834;1821;5913;2009;6747
251160;201607;1845;5955;1786;5879;57;237;1646;5420;1703;5657
251170;201607;1416;4270;1339;4170;82;333;1147;3507;1229;3840
251180;201607;2547;7683;2313;7325;350;1183;1492;4709;1842;5892
251190;201607;4366;12059;4204;11876;154;511;3920;11007;4074;11518
251200;201607;3809;12328;3638;12116;95;421;3335;11088;3430;11509
251203;201607;1027;3405;1003;3358;59;269;777;2552;836;2821
251207;201607;1098;3398;949;3131;59;273;637;2030;696;2303
251210;201607;7951;22419;6801;20912;685;2088;5272;16667;5957;18755
251220;201607;1171;3098;961;2795;79;243;733;2151;812;2394
251230;201607;4569;13625;4200;13183;234;909;3743;11636;3977;12545
251240;201607;3298;9929;3029;9579;366;1216;2308;7288;2674;8504
251250;201607;10434;30570;9658;29431;811;3028;7387;22063;8198;25091
251260;201607;486;1543;446;1487;23;96;337;1110;360;1206
251270;201607;4247;13701;3911;13288;145;650;3444;11686;3589;12336
251272;201607;1377;3963;1315;3883;71;229;1181;3478;1252;3707
251274;201607;908;2808;821;2658;84;357;560;1758;644;2115
251275;201607;1257;3630;1184;3510;78;342;929;2634;1007;2976
251276;201607;1229;3747;1157;3623;106;432;871;2663;977;3095
251278;201607;594;1860;527;1743;62;255;348;1134;410;1389
251280;201607;2347;6997;2199;6751;110;483;1779;5279;1889;5762
251290;201607;5653;15524;5315;15119;529;1931;4259;11797;4788;13728
251300;201607;781;2591;734;2522;45;190;587;1993;632;2183
251310;201607;2983;8913;2741;8570;158;683;2211;6755;2369;7438
251315;201607;1635;5623;1556;5489;159;621;1167;4115;1326;4736
251320;201607;1891;5259;1459;4555;80;303;1061;3306;1141;3609
251330;201607;1775;4750;1507;4406;70;282;1322;3805;1392;4087
251335;201607;1026;3449;940;3299;96;428;676;2312;772;2740
251340;201607;3397;9584;3010;9015;198;802;2298;6687;2496;7489
251350;201607;1279;4087;1193;3933;88;360;922;2965;1010;3325
251360;201607;1818;5675;1583;5371;64;268;1372;4689;1436;4957
251365;201607;803;2360;648;2038;30;126;458;1423;488;1549
251370;201607;22335;69517;21632;68550;2060;8049;17160;53107;19220;61156
251380;201607;1357;4197;1167;3874;58;287;978;3129;1036;3416
251385;201607;790;2107;671;1927;57;194;463;1259;520;1453
251390;201607;5861;19908;5260;18756;1396;5168;2599;9383;3995;14551
251392;201607;1049;3112;931;2927;75;279;716;2218;791;2497
251394;201607;617;1933;510;1741;46;192;353;1192;399;1384
251396;201607;824;2337;708;2147;78;235;479;1453;557;1688
251398;201607;969;2809;845;2585;38;152;580;1731;618;1883
251400;201607;1171;3278;998;3029;97;360;735;2171;832;2531
251410;201607;1500;3882;1275;3517;59;239;1060;2828;1119;3067
251420;201607;1996;5723;1755;5437;178;656;1321;4029;1499;4685
251430;201607;1621;5621;1481;5398;72;361;1231;4433;1303;4794
251440;201607;1244;3669;1021;3243;56;216;770;2438;826;2654
251445;201607;1484;4584;1400;4469;129;516;1091;3387;1220;3903
251450;201607;4552;14545;4275;14175;157;703;3599;11937;3756;12640
251455;201607;1076;3464;968;3265;87;363;678;2282;765;2645
251460;201607;811;2523;755;2428;66;229;607;1967;673;2196
251465;201607;437;1398;389;1298;16;77;294;958;310;1035
251470;201607;1177;3421;980;3034;91;345;607;1844;698;2189
251480;201607;944;2646;830;2464;39;177;661;1898;700;2075
251490;201607;1758;5238;1577;4961;167;624;1104;3433;1271;4057
251500;201607;1709;5449;1642;5328;104;434;1364;4332;1468;4766
251510;201607;2597;8479;2356;8003;401;1457;1392;4748;1793;6205
251520;201607;950;2575;834;2389;107;325;549;1553;656;1878
251530;201607;12085;33584;11395;32636;388;1654;9935;27860;10323;29514
251540;201607;2903;9251;2672;8818;185;747;2138;7001;2323;7748
251550;201607;3504;9120;2982;8423;81;327;2512;7025;2593;7352
251560;201607;704;2179;651;2085;98;368;402;1232;500;1600
251570;201607;1013;2993;819;2625;54;239;563;1727;617;1966
251580;201607;1906;5344;1752;5135;333;851;1171;3591;1504;4442
251590;201607;1485;4620;1419;4533;56;230;1176;3738;1232;3968
251593;201607;996;3101;924;3000;143;507;581;1849;724;2356
251597;201607;1913;5863;1846;5779;80;325;1650;5100;1730;5425
251600;201607;6481;19060;6030;18353;355;1288;4913;14847;5268;16135
251610;201607;3320;9895;2994;9326;256;819;2206;6921;2462;7740
251615;201607;1137;3259;927;2892;59;255;641;1941;700;2196
251620;201607;15271;41652;13616;39675;702;2160;11237;34048;11939;36208
251630;201607;4645;11974;3966;11022;293;923;3075;8405;3368;9328
251640;201607;2555;7442;2168;6805;109;461;1655;5115;1764;5576
251650;201607;3940;11399;3618;10978;220;736;3091;9338;3311;10074
251660;201607;3543;11336;3267;10851;156;750;2719;8811;2875;9561
251670;201607;4413;13169;3809;12390;60;202;3507;11593;3567;11795
251675;201607;727;2296;670;2220;122;471;430;1373;552;1844
251680;201607;2748;7853;2254;7090;115;488;1750;5437;1865;5925
251690;201607;3243;9783;3017;9356;168;632;2274;6904;2442;7536
251700;201607;1940;6254;1821;6105;104;497;1536;5047;1640;5544
251710;201607;893;2335;624;1809;106;349;276;732;382;1081
251720;201607;1415;4337;1231;4011;92;433;945;2975;1037;3408
251740;201607;781;2205;615;1922;59;204;391;1224;450;1428
260005;201607;25840;62386;21836;56799;4389;11443;11948;31576;16337;43019
260010;201607;10044;27018;8326;24787;1170;3631;4977;15458;6147;19089
260020;201607;6086;16775;5131;15359;241;882;4125;12406;4366;13288
260030;201607;6198;17646;5522;16622;375;1269;4277;12846;4652;14115
260040;201607;9938;24006;8198;21990;657;1744;6306;17564;6963;19308
260050;201607;11256;34750;10501;33868;551;2075;9048;29448;9599;31523
260060;201607;3896;10922;3453;10133;323;954;2546;7617;2869;8571
260070;201607;9857;28401;9030;27108;1174;3959;6157;18220;7331;22179
260080;201607;5801;15290;5147;14393;529;1639;3768;10415;4297;12054
260090;201607;5176;14255;4821;13741;566;1636;3620;10426;4186;12062
260100;201607;3373;9241;2915;8604;160;631;2407;7085;2567;7716
260105;201607;4998;13911;4731;13464;226;898;3982;11053;4208;11951
260110;201607;21147;59177;19455;57176;810;2701;17305;50935;18115;53636
260120;201607;12029;36252;10789;34099;2313;7549;5778;18885;8091;26434
260130;201607;3257;9088;3046;8762;371;1115;2216;6347;2587;7462
260140;201607;13302;32747;11411;30467;850;2592;9068;24381;9918;26973
260150;201607;3201;8903;2861;8450;199;799;2269;6628;2468;7427
260160;201607;5601;17508;4880;16556;314;1407;3985;13514;4299;14921
260170;201607;16446;46097;15638;44953;1081;3586;13008;37074;14089;40660
260180;201607;3278;9889;2973;9461;163;580;2522;8045;2685;8625
260190;201607;16283;37718;14788;35886;434;1323;12873;30831;13307;32154
260200;201607;11229;28983;10354;27856;481;1620;8968;24074;9449;25694
260210;201607;11734;35154;10427;33176;572;2277;8532;27135;9104;29412
260220;201607;9563;27422;9221;26983;430;1648;8181;23613;8611;25261
260230;201607;9716;27584;8930;26488;459;1702;7300;21644;7759;23346
260240;201607;3008;8901;2611;8327;307;1105;1872;5990;2179;7095
260250;201607;2283;6260;2030;5918;107;349;1682;4862;1789;5211
260260;201607;12331;34609;11231;33045;1113;3682;8565;25476;9678;29158
260270;201607;3665;10564;3378;10143;260;1139;2557;7350;2817;8489
260280;201607;13013;41841;11888;40164;742;2741;9874;33697;10616;36438
260290;201607;31343;93780;29546;90647;5038;16719;18785;57086;23823;73805
260300;201607;8626;26318;7602;24780;412;1769;5895;19274;6307;21043
260310;201607;4632;13562;4226;12969;922;2665;2561;8290;3483;10955
260320;201607;7244;23131;6691;22241;419;1618;5502;18331;5921;19949
260330;201607;2646;8458;2437;8076;161;726;1907;6168;2068;6894
260340;201607;1874;5470;1727;5242;54;198;1543;4668;1597;4866
260345;201607;22993;71079;21435;68179;5563;19604;8640;26588;14203;46192
260350;201607;4860;13078;4510;12583;185;671;3861;10654;4046;11325
260360;201607;2346;6741;2136;6380;128;511;1500;4464;1628;4975
260370;201607;5722;17764;5025;16513;435;1741;3595;11771;4030;13512
260380;201607;4868;15890;4421;15190;322;1398;3338;11390;3660;12788
260390;201607;4295;13688;3753;12611;326;1269;2655;8819;2981;10088
260392;201607;3500;11116;3173;10689;228;1000;2663;8821;2891;9821
260400;201607;13854;38973;13080;37704;1649;5405;9178;25969;10827;31374
260410;201607;61599;174735;53738;162403;14755;47485;21604;67391;36359;114876
260415;201607;3848;12026;3314;10980;319;1386;2131;6803;2450;8189
260420;201607;12203;27621;10757;26051;255;890;9775;23432;10030;24322
260430;201607;2913;9359;2559;8701;252;963;1687;5723;1939;6686
260440;201607;3325;9984;2934;9192;389;1391;1864;5701;2253;7092
260450;201607;4961;14587;4736;14265;189;659;4222;12752;4411;13411
260460;201607;5636;17759;5124;16790;960;3482;2871;9247;3831;12729
260470;201607;4550;13630;4180;13188;177;546;3666;11881;3843;12427
260480;201607;4124;11692;3632;11011;466;1575;2440;7479;2906;9054
260490;201607;5068;13273;4387;12123;274;911;3556;9612;3830;10523
260500;201607;5935;16956;5270;15886;780;2420;3444;10484;4224;12904
260510;201607;8856;23511;8162;22606;362;1240;7151;19602;7513;20842
260515;201607;4787;14402;3707;12253;294;1153;2351;7770;2645;8923
260520;201607;16230;41940;15475;40934;1647;4483;11996;31654;13643;36137
260530;201607;9822;29788;8688;28059;409;1578;7341;23756;7750;25334
260540;201607;6124;15004;5561;14404;718;1308;4385;12055;5103;13363
260545;201607;71;254;48;187;10;40;11;38;21;78
260550;201607;2758;8944;2321;7984;449;1684;1021;3530;1470;5214
260560;201607;6191;16369;5559;15473;165;666;4883;13390;5048;14056
260570;201607;6915;22418;6301;21432;645;2581;4655;15794;5300;18375
260580;201607;3743;10399;3460;9932;151;560;2929;8227;3080;8787
260590;201607;6156;15373;5766;14929;302;826;5000;12972;5302;13798
260600;201607;28152;81964;25185;77069;2107;7860;18434;56018;20541;63878
260610;201607;6574;19665;6211;19084;778;2619;4452;13530;5230;16149
260620;201607;15734;47394;14984;46115;2400;8418;9643;29001;12043;37419
260630;201607;2231;6569;1990;6195;129;544;1611;4914;1740;5458
260640;201607;17297;47346;16179;45853;2296;7028;10965;31102;13261;38130
260650;201607;5436;17026;4816;15966;345;1377;3780;12568;4125;13945
260660;201607;7845;21668;7010;20602;306;1112;5970;17401;6276;18513
260670;201607;2389;6318;1951;5712;139;459;1381;4041;1520;4500
260680;201607;21579;60703;19681;57384;3775;11502;9982;29281;13757;40783
260690;201607;3679;9899;3053;8868;221;661;2296;6655;2517;7316
260700;201607;5786;17105;5641;16953;31;68;5528;16778;5559;16846
260710;201607;1332;3904;1240;3785;112;382;927;2890;1039;3272
260720;201607;17857;56368;16753;54312;3542;12006;9335;30504;12877;42510
260730;201607;6770;22452;6325;21719;777;2975;4669;15935;5446;18910
260740;201607;1299;3852;1138;3567;97;349;820;2558;917;2907
260750;201607;6903;20723;6104;19712;330;1078;5267;17343;5597;18421
260760;201607;4766;12762;4473;12392;226;736;3734;10379;3960;11115
260765;201607;7791;26183;7392;25512;1026;4575;5083;16905;6109;21480
260770;201607;3793;10082;3480;9612;147;514;2828;7719;2975;8233
260775;201607;5003;14621;4708;14182;462;1754;3365;9872;3827;11626
260780;201607;3655;11752;3407;11279;696;2612;1820;5802;2516;8414
260790;201607;111349;280199;102800;267518;20024;54081;60660;157451;80684;211532
260795;201607;3079;9155;2751;8657;237;895;1996;6301;2233;7196
260800;201607;4914;13119;4572;12657;126;554;4098;11011;4224;11565
260805;201607;3841;11256;3299;10381;379;1417;2241;6954;2620;8371
260810;201607;6859;19138;6599;18807;312;1031;5806;16506;6118;17537
260820;201607;4146;11678;3687;10964;742;2370;1985;5871;2727;8241
260825;201607;2901;9228;2592;8722;165;692;1994;6714;2159;7406
260830;201607;3713;11892;3320;11133;522;1773;2144;7331;2666;9104
260840;201607;4280;12169;3788;11447;246;898;3069;9170;3315;10068
260845;201607;4201;12158;3959;11730;457;1414;2919;8697;3376;10111
260850;201607;4955;16157;4393;14904;855;3248;2100;7068;2955;10316
260860;201607;3535;10796;3099;9932;191;724;2378;7584;2569;8308
260870;201607;4238;11405;3739;10773;364;1105;2909;8422;3273;9527
260875;201607;6475;17931;5734;16771;802;2393;3875;11453;4677;13846
260880;201607;9694;29255;8850;27888;589;2002;7068;22457;7657;24459
260890;201607;13160;37549;12234;36104;823;2998;9357;27374;10180;30372
260900;201607;5871;17947;5048;16366;476;1937;3197;10213;3673;12150
260910;201607;3037;9103;2747;8650;171;643;2077;6535;2248;7178
260915;201607;4564;15206;4305;14850;105;522;3938;13537;4043;14059
260920;201607;3203;9750;2960;9418;177;655;2383;7691;2560;8346
260930;201607;3896;12588;3446;11851;369;1358;2413;8304;2782;9662
260940;201607;13967;36988;12741;35016;1537;4935;8561;23008;10098;27943
260950;201607;6324;19437;5675;18146;908;3470;2982;9090;3890;12560
260960;201607;55861;154083;50943;146213;9970;30817;27365;78177;37335;108994
260970;201607;4961;14943;4523;14374;299;1194;3570;11363;3869;12557
260980;201607;3956;12660;3707;12345;136;582;3308;10972;3444;11554
260990;201607;17364;53207;15777;51024;1079;4185;12669;41078;13748;45263
261000;201607;16068;43395;13134;38930;2271;7200;6958;21352;9229;28552
261010;201607;2551;7032;2337;6781;122;284;2066;6143;2188;6427
261020;201607;6234;18045;5504;16804;526;1767;4040;12111;4566;13878
261030;201607;3583;11268;3223;10641;211;878;2553;8298;2764;9176
261040;201607;5150;16518;4447;15078;414;1702;3180;10596;3594;12298
261050;201607;7904;22995;7391;22075;933;2968;5030;15092;5963;18060
261060;201607;12345;35951;11388;34259;1019;3737;8519;25090;9538;28827
261070;201607;52602;127677;46238;118794;5746;15606;31169;79850;36915;95456
261080;201607;5716;16534;5379;16035;305;909;4653;14049;4958;14958
261090;201607;16577;45255;15179;43332;1225;3731;12110;34755;13335;38486
261100;201607;8165;25456;7282;23927;1224;4383;4325;14415;5549;18798
261110;201607;61786;181297;54560;170530;12500;41320;27430;88471;39930;129791
261120;201607;3805;9978;3319;9406;97;369;2956;8367;3053;8736
261130;201607;7091;18070;6559;17475;163;559;5963;15857;6126;16416
261140;201607;3257;9057;2954;8599;375;1310;1885;5381;2260;6691
261150;201607;5382;15545;4961;14887;338;1253;4112;12265;4450;13518
261153;201607;2155;6225;1776;5648;100;419;1308;4153;1408;4572
261160;201607;197469;515608;182282;493674;43974;125114;87631;241522;131605;366636
261170;201607;5914;15997;5367;15207;442;1348;4207;12005;4649;13353
261180;201607;9624;26636;8941;25671;963;3184;6110;17382;7073;20566
261190;201607;5190;15872;4825;15421;560;2357;3456;10723;4016;13080
261200;201607;3597;9005;3235;8578;341;931;2564;6871;2905;7802
261210;201607;1907;5021;1771;4848;111;317;1559;4278;1670;4595
261220;201607;13328;41076;11245;36714;1610;5851;6071;19685;7681;25536
261230;201607;4632;14502;4253;14033;143;623;3730;12389;3873;13012
261240;201607;4942;14409;4523;13713;595;1786;3191;9815;3786;11601
261245;201607;3607;11014;3096;10091;172;786;2415;7692;2587;8478
261247;201607;3269;9959;2791;9101;197;798;1985;6546;2182;7344
261250;201607;19558;51893;18285;50185;3087;8122;12662;35962;15749;44084
261255;201607;4054;12510;3597;11688;229;1043;2822;8930;3051;9973
261260;201607;12331;34344;11030;32751;542;1826;9338;27924;9880;29750
261270;201607;3636;10773;3275;10188;337;1212;2297;7000;2634;8212
261280;201607;2553;7743;2359;7457;149;599;1915;5974;2064;6573
261290;201607;2934;8372;2655;8004;153;575;2154;6515;2307;7090
261300;201607;10741;34449;9347;31903;1355;5367;5836;19695;7191;25062
261310;201607;7312;22457;6860;21633;1650;5357;3857;12247;5507;17604
261320;201607;5784;17838;5297;16964;250;1029;4291;13621;4541;14650
261330;201607;5575;15807;5256;15374;403;1430;4324;12468;4727;13898
261340;201607;3909;13035;3689;12671;384;1647;2530;8605;2914;10252
261350;201607;8098;26545;7600;25703;373;1861;6146;20288;6519;22149
261360;201607;8177;21420;7238;20100;574;1747;5682;15550;6256;17297
261370;201607;19724;57818;18279;55531;3675;11886;10482;31961;14157;43847
261380;201607;4134;14046;3823;13393;536;2110;2492;8702;3028;10812
261390;201607;16319;49380;14719;46752;2097;7309;9015;28826;11112;36135
261400;201607;4685;15998;4171;14930;350;1494;2946;10485;3296;11979
261410;201607;8855;24453;7936;23046;731;2326;6131;17808;6862;20134
261420;201607;7457;24908;7117;24439;1617;6239;4335;14708;5952;20947
261430;201607;3450;10569;3004;9916;250;912;2323;7749;2573;8661
261440;201607;1556;4882;1399;4635;73;355;1073;3487;1146;3842
261450;201607;14220;40068;13670;39412;360;1403;12404;35554;12764;36957
261460;201607;7213;20993;6710;20320;382;1149;5785;17722;6167;18871
261470;201607;4020;10953;3667;10501;82;274;3326;9613;3408;9887
261480;201607;3752;13217;3443;12654;301;1319;2562;9262;2863;10581
261485;201607;4949;15125;4440;14237;670;2496;2747;8667;3417;11163
261500;201607;5652;15697;5028;14869;452;1310;3750;11427;4202;12737
261510;201607;1892;6021;1711;5727;140;536;1270;4267;1410;4803
261520;201607;2678;8668;2501;8333;153;597;1669;5795;1822;6392
261530;201607;11441;36742;10226;34296;2082;7964;4571;15231;6653;23195
261540;201607;7074;22871;6663;22155;1446;4848;3954;13514;5400;18362
261550;201607;3461;9718;3254;9428;233;899;2569;7247;2802;8146
261560;201607;7051;23102;6395;22215;767;3112;4728;16494;5495;19606
261570;201607;3402;10219;2973;9516;377;1337;1899;6025;2276;7362
261580;201607;6054;18266;5467;17345;305;1307;4590;14399;4895;15706
261590;201607;2450;6876;2127;6380;192;606;1554;4702;1746;5308
261600;201607;5294;14262;4543;13199;322;1023;3578;10462;3900;11485
261610;201607;2395;6812;2094;6405;92;398;1718;5224;1810;5622
261618;201607;2524;7003;2288;6709;178;590;1774;5138;1952;5728
261620;201607;4115;12709;3834;12237;643;2073;2571;8383;3214;10456
261630;201607;7685;22430;6478;20181;796;2981;3781;11536;4577;14517
261640;201607;33742;83918;31599;81373;2001;4939;25816;69156;27817;74095
261650;201607;3743;11239;3481;10888;292;1115;2626;8278;2918;9393
270010;201607;4468;16629;4076;15882;397;1886;2869;11150;3266;13036
270020;201607;3852;10896;3579;10501;329;1148;2852;8216;3181;9364
270030;201607;39330;117066;36616;112748;8234;26151;20732;64744;28966;90895
270040;201607;10642;32365;9793;31247;1704;5657;6380;20805;8084;26462
270050;201607;4351;12155;3965;11679;354;1228;3213;9437;3567;10665
270060;201607;1885;5527;1750;5358;270;896;1210;3753;1480;4649
270070;201607;4366;13265;3995;12774;206;991;3422;10681;3628;11672
270080;201607;1262;3955;1093;3627;136;506;692;2249;828;2755
270090;201607;2100;6453;1921;6101;82;429;1582;4826;1664;5255
270100;201607;5666;17406;5335;16846;681;2494;3842;11954;4523;14448
270110;201607;3214;8777;2839;8370;396;1150;1962;6126;2358;7276
270120;201607;3115;8751;2734;8287;104;420;2400;7260;2504;7680
270130;201607;5113;15378;4709;14920;619;2023;3543;11511;4162;13534
270135;201607;1772;4706;1601;4494;160;326;1344;3942;1504;4268
270140;201607;10319;24687;8797;22784;698;2719;6973;16976;7671;19695
270150;201607;2710;8775;2625;8672;55;189;2515;8346;2570;8535
270160;201607;5070;16612;4612;16023;213;970;3964;13648;4177;14618
270170;201607;3790;12139;3487;11739;552;2186;2180;7267;2732;9453
270180;201607;2280;7432;2089;7159;126;640;1704;5698;1830;6338
270190;201607;1790;5851;1697;5731;90;362;1435;4874;1525;5236
270200;201607;2599;8608;2418;8352;242;1067;1831;6154;2073;7221
270210;201607;4692;14009;4402;13610;269;1151;3723;11303;3992;12454
270220;201607;1328;4357;1222;4171;248;924;705;2365;953;3289
270230;201607;10919;34096;9548;31954;1274;5238;5882;19155;7156;24393
270235;201607;6386;20474;5935;19768;373;1650;4858;16001;5231;17651
270240;201607;9476;28474;7940;26510;1990;6983;3930;13572;5920;20555
270250;201607;3256;8490;2950;8115;390;1119;2313;6357;2703;7476
270255;201607;4957;14846;3877;12910;284;1259;2763;8991;3047;10250
270260;201607;5886;18843;5681;18554;449;1933;4760;15182;5209;17115
270270;201607;1179;3344;1073;3191;193;606;652;1913;845;2519
270280;201607;3484;9816;3071;9223;378;1060;2117;6492;2495;7552
270290;201607;8209;28229;7659;27281;681;3114;5931;20804;6612;23918
270300;201607;3640;11438;3258;10989;347;1311;2414;8148;2761;9459
270310;201607;7576;22697;6650;21334;292;1444;5570;17470;5862;18914
270320;201607;5851;18292;5537;17778;793;2947;3921;12362;4714;15309
270330;201607;4290;14503;4004;14112;422;1605;3145;11195;3567;12800
270340;201607;1748;5271;1538;4991;116;469;1216;3879;1332;4348
270350;201607;1903;5083;1708;4852;142;465;1267;3609;1409;4074
270360;201607;1967;6086;1878;5986;131;401;1633;5309;1764;5710
270370;201607;1518;4985;1383;4760;119;519;1018;3489;1137;4008
270375;201607;2909;7963;2588;7543;116;418;2262;6552;2378;6970
270380;201607;5685;17355;5279;16802;428;1402;4153;13487;4581;14889
270390;201607;1260;3435;1108;3216;65;255;845;2363;910;2618
270400;201607;6361;18880;5657;17863;397;1660;4201;12897;4598;14557
270410;201607;4828;15026;4430;14304;420;1598;3167;10045;3587;11643
270420;201607;5842;18565;5600;18237;339;1527;4605;14690;4944;16217
270430;201607;136149;391383;121427;369366;34897;113115;48026;151063;82923;264178
270440;201607;4678;13982;4312;13488;220;918;3539;11041;3759;11959
270450;201607;6260;19238;5969;18868;361;1550;4979;15494;5340;17044
270460;201607;3424;9032;3071;8601;136;484;2676;7376;2812;7860
270470;201607;10384;32705;9507;31300;1182;4417;6389;21132;7571;25549
270480;201607;2836;8773;2508;8183;298;1224;1730;5408;2028;6632
270490;201607;982;3086;904;2976;49;205;719;2348;768;2553
270500;201607;4846;16459;4558;16100;302;1381;3802;13355;4104;14736
270510;201607;5967;17607;5344;16732;604;2491;4058;12257;4662;14748
270520;201607;3579;11284;3264;10751;1064;3818;1143;3943;2207;7761
270530;201607;1363;4208;1260;4056;125;440;872;2847;997;3287
270540;201607;2053;6772;1871;6508;131;660;1521;5138;1652;5798
270550;201607;7201;20826;6252;19629;814;2760;4390;14154;5204;16914
270560;201607;3077;9177;2854;8833;276;1065;2123;6428;2399;7493
270570;201607;3755;12131;3442;11581;289;1246;2709;8920;2998;10166
270580;201607;2044;6411;1944;6278;157;543;1579;5171;1736;5714
270590;201607;1377;4549;1317;4450;11;45;1276;4327;1287;4372
270600;201607;2823;9308;2567;8882;182;901;2053;6922;2235;7823
270610;201607;3222;9992;2983;9652;185;724;2490;7971;2675;8695
270620;201607;1390;4669;1307;4537;106;490;1046;3504;1152;3994
270630;201607;16392;47641;14946;45321;2000;6263;10477;32389;12477;38652
270640;201607;5712;17447;5154;16601;358;1514;4124;13026;4482;14540
270642;201607;2284;8060;2130;7844;249;1152;1608;5814;1857;6966
270644;201607;2699;7899;2386;7482;229;728;1841;5900;2070;6628
270650;201607;3667;11484;3484;11232;496;2238;2470;7495;2966;9733
270660;201607;2088;5457;1666;4849;94;380;1233;3497;1327;3877
270670;201607;16628;42366;14317;39758;1743;4857;10548;30227;12291;35084
270680;201607;4329;12613;4131;12390;121;343;3836;11584;3957;11927
270690;201607;9141;25261;8157;24161;2399;6688;4658;14813;7057;21501
270700;201607;641;1990;577;1885;93;397;384;1186;477;1583
270710;201607;5943;18878;5617;18456;416;1705;4682;15182;5098;16887
270720;201607;3344;11221;3042;10679;173;944;2492;8554;2665;9498
270730;201607;6412;18529;6051;18143;517;1638;5052;15372;5569;17010
270740;201607;2287;6520;2154;6328;229;809;1691;4877;1920;5686
270750;201607;5133;15783;4749;15184;670;2400;3372;10732;4042;13132
270760;201607;3394;10149;3032;9559;169;675;2428;7576;2597;8251
270770;201607;18980;49259;15573;45150;3244;9479;8848;27155;12092;36634
270780;201607;1808;5814;1709;5654;211;805;1252;4085;1463;4890
270790;201607;1510;4737;1382;4554;338;1220;743;2424;1081;3644
270800;201607;11454;33339;10632;32274;694;2667;8891;26594;9585;29261
270810;201607;3321;10049;2593;8733;281;1127;1636;5544;1917;6671
270820;201607;1801;5847;1609;5533;252;992;1028;3515;1280;4507
270830;201607;5801;15268;5173;14517;415;1171;4137;12060;4552;13231
270840;201607;7850;25089;7266;24333;396;1988;6202;20240;6598;22228
270850;201607;7393;22868;7089;22479;959;3964;5133;15423;6092;19387
270860;201607;11039;30818;9322;28624;1123;4153;6325;19055;7448;23208
270870;201607;2148;6486;1803;5778;207;740;1204;3804;1411;4544
270880;201607;8197;26049;7585;25154;479;2038;6196;20265;6675;22303
270890;201607;2401;7319;2242;7034;249;956;1656;5065;1905;6021
270895;201607;2896;10583;2766;10395;155;758;2396;8941;2551;9699
270900;201607;1927;5179;1565;4673;130;453;1132;3311;1262;3764
270910;201607;3575;11615;3292;11107;263;1198;2564;8421;2827;9619
270915;201607;9478;31438;8512;29735;1356;5604;5090;17424;6446;23028
270920;201607;6139;19248;5902;18917;317;1557;5203;16200;5520;17757
270930;201607;17374;45779;14364;42220;2715;8025;8657;26543;11372;34568
270940;201607;5604;18453;5273;18098;554;2605;3599;11885;4153;14490
280010;201607;652;1916;569;1774;54;238;374;1082;428;1320
280020;201607;4817;13858;4156;12751;606;2064;2661;8087;3267;10151
280030;201607;75762;195765;64551;179275;17769;51831;25675;74011;43444;125842
280040;201607;3108;9444;2752;8913;244;943;2051;6550;2295;7493
280050;201607;3800;11984;3498;11474;1053;3653;1563;5264;2616;8917
280060;201607;4883;15308;4282;14238;894;3219;2178;7422;3072;10641
280067;201607;7298;20399;6267;18839;913;2813;3943;12015;4856;14828
280070;201607;1911;6252;1818;6116;202;781;1384;4626;1586;5407
280100;201607;3827;11755;3443;11086;498;1777;2262;7344;2760;9121
280110;201607;1418;4213;1304;4040;61;245;1097;3354;1158;3599
280120;201607;7848;24509;7189;23444;1110;3475;5017;16997;6127;20472
280130;201607;7535;20876;6876;19923;973;3118;4736;13821;5709;16939
280140;201607;5789;15257;5266;14506;387;1161;4275;11821;4662;12982
280150;201607;3457;10257;3210;9850;292;1095;2364;7076;2656;8171
280160;201607;1372;3980;1190;3693;174;616;775;2352;949;2968
280170;201607;4783;14128;4330;13460;436;1433;3273;10298;3709;11731
280190;201607;1119;3035;998;2842;72;277;782;2153;854;2430
280200;201607;1177;3478;1069;3321;116;438;788;2387;904;2825
280210;201607;13781;40320;12321;38301;2206;7457;7161;22678;9367;30135
280220;201607;1577;4834;1473;4670;84;353;1232;3836;1316;4189
280230;201607;3481;10270;3111;9708;370;1304;2049;6406;2419;7710
280240;201607;3476;9985;3151;9473;225;728;2509;7544;2734;8272
280250;201607;823;2157;661;1895;112;379;342;905;454;1284
280260;201607;2111;5497;1966;5320;70;217;1785;4855;1855;5072
280270;201607;2243;6918;1999;6554;119;506;1576;5067;1695;5573
280280;201607;4148;13399;3744;12737;731;2092;2217;8336;2948;10428
280290;201607;17643;52674;15947;50103;2069;7408;10300;32453;12369;39861
280300;201607;9514;28696;8934;27994;748;2700;7101;22857;7849;25557
280310;201607;1386;3850;1215;3571;58;243;884;2540;942;2783
280320;201607;8695;27204;7943;25957;1464;5288;4353;14173;5817;19461
280330;201607;4492;12721;4087;12065;455;1622;3052;8687;3507;10309
280340;201607;3871;10736;3623;10400;300;995;2937;8511;3237;9506
280350;201607;22403;61838;19828;58031;2803;8885;13086;38583;15889;47468
280360;201607;5859;18214;5398;17455;1004;3660;3081;9811;4085;13471
280370;201607;1899;5241;1629;4791;164;481;1132;3343;1296;3824
280380;201607;1036;3152;932;2987;109;429;656;2040;765;2469
280390;201607;3165;9247;2707;8407;290;987;1817;5662;2107;6649
280400;201607;4227;11849;3838;11288;1094;3188;1896;5905;2990;9093
280410;201607;2218;7007;1885;6354;250;971;1101;3591;1351;4562
280420;201607;4161;12035;3846;11550;210;727;3281;9844;3491;10571
280430;201607;2290;5827;2062;5514;123;447;1616;4232;1739;4679
280440;201607;4674;13674;4270;13153;353;1270;3311;10044;3664;11314
280445;201607;2520;6964;2331;6652;93;365;1851;5181;1944;5546
280450;201607;9194;24245;8522;23401;559;1316;7193;20346;7752;21662
280460;201607;6950;18056;6284;17110;700;2032;4690;12904;5390;14936
280470;201607;1810;5453;1641;5164;173;584;1187;3768;1360;4352
280480;201607;32176;92199;30050;89103;4807;16203;19803;57896;24610;74099
280490;201607;3861;11431;3393;10653;261;1016;2518;7776;2779;8792
280500;201607;927;2468;834;2350;47;148;698;1949;745;2097
280510;201607;2666;7678;2308;7211;180;702;1713;5338;1893;6040
280520;201607;1819;4875;1658;4682;118;339;1393;3960;1511;4299
280530;201607;2480;6625;2287;6395;145;456;1892;5338;2037;5794
280540;201607;9454;25630;8737;24635;272;1196;7663;21126;7935;22322
280550;201607;6994;18112;5846;16375;577;1730;4143;11623;4720;13353
280560;201607;7608;22300;7177;21678;378;1432;6078;18138;6456;19570
280570;201607;6505;17446;5646;16297;595;2009;3903;11187;4498;13196
280580;201607;5582;17069;4744;15604;717;2509;2951;9906;3668;12415
280590;201607;2498;7209;2236;6869;241;1025;1524;4558;1765;5583
280600;201607;3657;11126;3402;10750;335;1260;2605;8119;2940;9379
280610;201607;2509;6931;2280;6596;208;740;1659;4672;1867;5412
280620;201607;5260;15386;4615;14278;556;1707;3126;10029;3682;11736
280630;201607;3661;11822;3410;11435;315;1067;2712;9322;3027;10389
280640;201607;2237;6653;2134;6537;77;220;1993;6159;2070;6379
280650;201607;1124;3470;1012;3293;103;408;729;2349;832;2757
280660;201607;2751;7562;2612;7396;301;837;2130;6075;2431;6912
280670;201607;16540;42817;15220;41043;2286;6630;10320;27629;12606;34259
280680;201607;2832;7572;2480;7028;171;560;1951;5421;2122;5981
280690;201607;957;2715;844;2556;112;376;588;1774;700;2150
280700;201607;1073;3182;948;2980;75;245;680;2132;755;2377
280710;201607;12154;31431;11023;30133;646;1637;9465;26406;10111;28043
280720;201607;2355;6248;2142;5996;236;701;1505;4398;1741;5099
280730;201607;919;2738;857;2649;80;316;680;2059;760;2375
280740;201607;13375;35714;11540;32946;1435;4168;7601;22051;9036;26219
280750;201607;3526;10630;3230;10138;312;1119;2310;7272;2622;8391
280760;201607;5725;17233;5197;16459;831;2821;3183;10383;4014;13204
290010;201607;3006;6739;2179;5471;66;256;1709;4082;1775;4338
290020;201607;4402;14464;4292;14321;382;1172;3637;12344;4019;13516
290030;201607;3175;9723;2991;9453;375;1263;2278;7191;2653;8454
290035;201607;4680;11819;4042;10976;245;756;3115;8721;3360;9477
290040;201607;4188;10994;3550;10271;247;934;2760;7963;3007;8897
290050;201607;2482;8038;2219;7602;174;724;1625;5548;1799;6272
290060;201607;1315;3356;1102;3100;133;467;827;2246;960;2713
290070;201607;34215;83967;29236;77743;5634;15400;15056;42410;20690;57810
290080;201607;6118;18048;5189;16805;689;2258;3597;12046;4286;14304
290090;201607;2165;4680;1700;4187;110;251;1456;3667;1566;3918
290100;201607;9622;27364;8452;25547;1082;3479;5419;16790;6501;20269
290110;201607;4887;14360;4629;13919;689;2327;3052;9003;3741;11330
290115;201607;4851;14525;4289;13800;260;823;3510;11600;3770;12423
290120;201607;6822;17712;5605;16268;246;948;4675;13435;4921;14383
290130;201607;4647;12103;3830;11095;198;786;3078;8687;3276;9473
290135;201607;4616;11434;3914;10361;306;975;2858;7286;3164;8261
290140;201607;4265;13007;3666;12193;279;1095;2987;9941;3266;11036
290150;201607;2205;6592;2097;6439;205;700;1666;5037;1871;5737
290160;201607;3446;8820;3287;8623;248;614;2768;7273;3016;7887
290170;201607;2769;8970;2505;8592;177;802;2094;7093;2271;7895
290180;201607;2967;8565;2554;7923;181;693;1986;6127;2167;6820
290190;201607;3817;12538;3629;12268;253;1130;2833;9460;3086;10590
290195;201607;2194;5901;1837;5366;75;333;1527;4385;1602;4718
290200;201607;3929;12051;3451;11324;263;979;2717;8885;2980;9864
290205;201607;3265;9379;2922;8841;201;802;2232;6624;2433;7426
290210;201607;15051;41981;13542;40033;2102;5432;9387;29609;11489;35041
290220;201607;2313;6774;2182;6568;135;572;1735;5072;1870;5644
290225;201607;3008;7240;2687;6881;129;357;2431;6222;2560;6579
290230;201607;2252;7280;2127;7131;136;602;1768;5892;1904;6494
290240;201607;3633;9754;3294;9255;237;740;2582;7180;2819;7920
290250;201607;3910;12141;3561;11652;159;480;2973;10202;3132;10682
290260;201607;5139;14376;4275;13078;327;1153;3299;10083;3626;11236
290265;201607;3427;10608;3034;9909;186;794;2347;7605;2533;8399
290270;201607;12097;43550;11482;42578;1394;5719;8401;31315;9795;37034
290280;201607;5325;17148;4927;16494;426;1570;3643;12245;4069;13815
290290;201607;9887;30714;8749;28834;1197;4145;5955;19939;7152;24084
290300;201607;4696;13090;3387;10659;256;855;2268;7315;2524;8170
290310;201607;1462;4340;1260;4016;222;759;715;2305;937;3064
290320;201607;28979;81567;24561;75842;5328;17635;12974;41307;18302;58942
290323;201607;3915;10510;3429;9951;165;552;2859;8257;3024;8809
290327;201607;4474;13398;3839;12255;499;1678;2538;8122;3037;9800
290330;201607;1846;4491;1701;4338;110;299;1498;3854;1608;4153
290340;201607;5045;15307;4682;14860;1180;3893;2801;9024;3981;12917
290350;201607;4434;13544;3866;12706;356;1260;2775;9335;3131;10595
290360;201607;4609;13787;3976;12933;158;658;3331;10939;3489;11597
290370;201607;4809;13081;4133;12212;263;833;3383;10070;3646;10903
290380;201607;5634;16118;4881;14982;337;1127;3820;11931;4157;13058
290390;201607;14860;44660;13378;42513;2052;6878;8552;28135;10604;35013
290395;201607;2597;8424;2315;7893;138;641;1751;5962;1889;6603
290400;201607;3641;10553;3076;9697;254;901;2202;6870;2456;7771
290405;201607;4733;14735;4008;13413;542;1924;2489;8501;3031;10425
290410;201607;5990;17513;4859;15735;412;1679;3451;10857;3863;12536
290420;201607;3310;9518;2757;8728;217;785;2152;6810;2369;7595
290430;201607;3143;9744;2785;9105;468;1614;1697;5623;2165;7237
290440;201607;3018;7888;2409;7028;166;584;1856;5461;2022;6045
290450;201607;3312;9559;2804;8804;270;961;1935;6038;2205;6999
290460;201607;12954;37314;11605;35023;3363;10503;4628;14157;7991;24660
290470;201607;4430;12109;3379;10557;723;2507;1589;5156;2312;7663
290475;201607;5555;17678;4938;16550;270;1288;3791;12393;4061;13681
290480;201607;2514;6721;2330;6484;243;700;1679;4931;1922;5631
290485;201607;4821;15168;4179;14209;288;1411;3367;11234;3655;12645
290490;201607;8248;21385;7772;20775;566;1783;6477;17046;7043;18829
290500;201607;4203;13082;3439;11569;556;2072;1856;6252;2412;8324
290510;201607;3378;9476;2934;8875;161;618;2415;7283;2576;7901
290515;201607;3554;9898;2985;9161;222;668;2417;7579;2639;8247
290520;201607;11998;36461;9665;32007;831;3297;5936;19518;6767;22815
290530;201607;5143;15062;4485;14039;322;1093;3555;11164;3877;12257
290540;201607;3941;11217;3738;10973;331;1009;3095;9183;3426;10192
290550;201607;4669;11968;4073;11292;120;367;3718;10347;3838;10714
290560;201607;6448;18312;5648;17191;1025;3229;3525;10850;4550;14079
290570;201607;42866;116385;39078;111236;3717;11523;28603;81335;32320;92858
290580;201607;7096;23834;6655;23141;739;2759;4947;17565;5686;20324
290590;201607;7332;23139;6298;21315;304;1301;5075;17151;5379;18452
290600;201607;17797;53101;16489;51263;1832;5745;12576;40199;14408;45944
290610;201607;2500;8355;2063;7492;143;671;1436;5108;1579;5779
290620;201607;6513;19490;5914;18575;360;1266;4872;15256;5232;16522
290630;201607;8278;21259;7240;20118;536;1578;6048;16956;6584;18534
290640;201607;2717;7779;2196;6948;131;547;1682;5225;1813;5772
290650;201607;11053;31573;10399;30691;2130;6269;6518;19854;8648;26123
290660;201607;3729;10224;3190;9452;156;504;2427;7496;2583;8000
290670;201607;6949;21031;6165;19722;713;2371;4324;14047;5037;16418
290680;201607;10485;30658;9386;29280;470;1960;7732;23830;8202;25790
290682;201607;4625;13050;4074;12265;158;603;3503;10454;3661;11057
290685;201607;3782;8898;2486;7090;288;870;1554;4540;1842;5410
290687;201607;7573;21225;5919;18710;1313;4248;2920;9758;4233;14006
290689;201607;3209;9164;2823;8583;223;755;2140;6709;2363;7464
290690;201607;5538;15466;4856;14570;689;2114;3245;9859;3934;11973
290700;201607;2382;7263;2239;7058;151;548;1773;5612;1924;6160
290710;201607;7765;24133;7247;23372;466;1583;5969;19380;6435;20963
290720;201607;18842;54422;17232;52401;1242;3720;14251;44264;15493;47984
290730;201607;7326;19812;6539;18783;803;2344;4667;13592;5470;15936
290740;201607;954;2796;756;2446;76;293;518;1662;594;1955
290750;201607;10359;28595;8886;25929;1394;4535;5161;14683;6555;19218
290755;201607;2365;6654;1919;5915;119;464;1407;4283;1526;4747
290760;201607;4256;12766;3447;11283;459;1435;2104;7128;2563;8563
290770;201607;2546;8858;2381;8640;138;647;1925;7010;2063;7657
290780;201607;9082;22768;7821;20955;685;1460;6051;16871;6736;18331
290790;201607;4430;13089;4069;12589;230;779;3490;10810;3720;11589
290800;201607;7285;15357;5747;13717;430;847;4476;11253;4906;12100
290810;201607;5377;16183;4517;14804;200;808;3466;11390;3666;12198
290820;201607;5707;15729;5061;14886;446;1455;3866;11520;4312;12975
290830;201607;4390;11554;4032;11062;228;854;3023;8102;3251;8956
290840;201607;17740;49942;15642;46830;2139;6268;10365;32429;12504;38697
290850;201607;6200;17757;5942;17443;680;1815;4666;14251;5346;16066
290860;201607;5144;17020;4784;16589;393;1473;3809;13538;4202;15011
290870;201607;4788;13886;3839;12298;262;1089;2770;8827;3032;9916
290880;201607;1453;3897;1157;3439;96;286;798;2413;894;2699
290890;201607;7196;18272;6117;17073;501;1300;5106;14517;5607;15817
290900;201607;2461;6984;1847;5916;246;853;1023;3268;1269;4121
290910;201607;4772;12570;3926;11344;112;468;3316;9453;3428;9921
290920;201607;4967;13464;4539;12884;236;709;3887;11027;4123;11736
290930;201607;8203;24386;7063;22562;364;1603;5569;17502;5933;19105
290940;201607;3541;11096;3158;10541;129;450;2533;8653;2662;9103
290950;201607;1570;4288;1367;3982;131;406;943;2779;1074;3185
290960;201607;5825;16284;5268;15587;228;788;4425;13143;4653;13931
290970;201607;3723;11515;3233;10721;283;1026;2226;7465;2509;8491
290980;201607;10688;30131;9044;27107;2481;7852;2797;8461;5278;16313
290990;201607;9145;27051;7875;24961;697;2646;5889;18310;6586;20956
291000;201607;3078;8938;2752;8566;123;443;2460;7680;2583;8123
291005;201607;14521;37452;12803;35223;1420;4024;9235;25823;10655;29847
291010;201607;3294;10107;2582;8614;240;835;1703;5765;1943;6600
291020;201607;1367;3558;1056;3028;111;327;587;1606;698;1933
291030;201607;2273;6123;1660;4929;152;505;1001;2913;1153;3418
291040;201607;5593;16531;4948;15585;330;1336;3876;12166;4206;13502
291050;201607;7944;25470;7202;24139;1545;5782;3992;13122;5537;18904
291060;201607;6035;21951;5676;21391;914;3956;3742;13964;4656;17920
291070;201607;16408;46434;14303;43404;954;3409;11093;33586;12047;36995
291072;201607;23395;68293;18847;59336;4720;16075;6611;21276;11331;37351
291075;201607;5188;14490;4594;13597;316;840;3503;10503;3819;11343
291077;201607;1486;4196;1198;3722;107;386;780;2403;887;2789
291080;201607;78963;243756;70806;228401;24938;82356;15991;52578;40929;134934
291085;201607;5761;14975;4931;13883;345;1099;4052;11425;4397;12524
291090;201607;1645;3794;1476;3596;49;147;1320;3200;1369;3347
291100;201607;2600;6571;2086;6006;126;504;1630;4615;1756;5119
291110;201607;5013;17608;4515;16868;554;2380;3229;11887;3783;14267
291120;201607;7301;19612;6715;18738;783;2263;4789;13468;5572;15731
291125;201607;1948;3840;1489;3349;81;205;1208;2761;1289;2966
291130;201607;2871;8921;2419;8131;140;636;1808;5938;1948;6574
291140;201607;4183;12339;3601;11262;454;1419;2309;7334;2763;8753
291150;201607;1981;5112;1855;4964;104;354;1554;4104;1658;4458
291160;201607;5294;16454;4617;15327;831;3010;2662;8744;3493;11754
291165;201607;2556;7101;1953;5989;69;293;1404;4206;1473;4499
291170;201607;22099;57011;18829;52559;1783;5625;12155;34055;13938;39680
291180;201607;6246;16204;5056;14414;392;1228;3681;10556;4073;11784
291185;201607;3728;10014;3308;9376;173;550;2731;7656;2904;8206
291190;201607;7196;19462;6321;18247;460;1645;5121;14584;5581;16229
291200;201607;2918;8639;2327;7527;160;581;1556;5088;1716;5669
291210;201607;6900;16490;5792;15232;289;985;4429;11626;4718;12611
291220;201607;4245;13038;3865;12429;503;1870;2617;8307;3120;10177
291230;201607;3975;10016;3607;9616;90;178;3378;9130;3468;9308
291240;201607;4590;12381;3953;11270;163;570;3194;8965;3357;9535
291250;201607;3584;10909;2858;9570;274;982;1911;6497;2185;7479
291260;201607;1083;3125;983;2999;64;282;829;2439;893;2721
291270;201607;4574;14339;4062;13364;937;3215;2285;7601;3222;10816
291280;201607;2077;6045;1683;5360;344;1231;839;2604;1183;3835
291290;201607;5632;15627;4869;14627;738;2318;3101;9516;3839;11834
291300;201607;4406;12368;3383;10659;217;820;2459;7625;2676;8445
291310;201607;5398;15240;4682;13950;295;1021;3667;10854;3962;11875
291320;201607;6140;18974;5005;16807;1179;4136;2374;8122;3553;12258
291330;201607;1616;4793;1434;4491;110;414;1019;3140;1129;3554
291340;201607;3938;10834;3211;9786;140;534;2607;7904;2747;8438
291345;201607;3396;10652;3145;10348;185;648;2650;8905;2835;9553
291350;201607;5765;16697;5026;15451;299;1005;3879;12110;4178;13115
291360;201607;33999;91591;29701;85676;6436;18952;16125;48160;22561;67112
291370;201607;8336;23594;7801;22922;545;1809;6149;18207;6694;20016
291380;201607;3693;11032;3156;10163;190;719;2383;7766;2573;8485
291390;201607;10269;27408;9475;26476;1041;3028;7310;20525;8351;23553
291400;201607;13817;38097;12109;35518;2030;5516;7817;24219;9847;29735
291410;201607;3315;8648;2447;7265;140;602;1777;5083;1917;5685
291420;201607;2104;5705;1793;5327;91;346;1505;4431;1596;4777
291430;201607;3261;9433;2880;8913;177;840;2335;6965;2512;7805
291440;201607;6718;19997;5625;18167;540;1878;4095;13330;4635;15208
291450;201607;8337;24049;7253;22549;328;1006;5849;18964;6177;19970
291460;201607;13319;39964;11983;37898;1430;5102;7988;25390;9418;30492
291465;201607;8087;22789;7066;21624;455;1815;5832;17659;6287;19474
291470;201607;16057;42415;14089;40089;988;2872;10775;31594;11763;34466
291480;201607;35606;90226;30001;82628;4290;13153;17023;47238;21313;60391
291490;201607;4289;13569;4043;13235;500;1681;2958;9906;3458;11587
291500;201607;4347;12253;3643;11208;220;850;2886;8786;3106;9636
291510;201607;3705;10985;3378;10543;84;335;2981;9416;3065;9751
291520;201607;3878;10457;3325;9718;333;1110;2281;6663;2614;7773
291530;201607;2209;5924;1736;5222;373;1159;908;2927;1281;4086
291535;201607;3780;11450;3412;10882;231;825;2678;8628;2909;9453
291540;201607;2137;5040;1782;4675;110;203;1582;4279;1692;4482
291550;201607;5146;13608;4432;12620;755;2117;2714;7947;3469;10064
291560;201607;18905;44072;13458;37737;859;2575;9953;29254;10812;31829
291570;201607;2225;5881;2031;5653;136;263;1729;5024;1865;5287
291580;201607;5502;16492;4848;15561;499;2005;3487;11110;3986;13115
291590;201607;1779;5551;1603;5265;155;578;1208;4002;1363;4580
291600;201607;5413;14665;4017;12457;949;3122;1805;5552;2754;8674
291610;201607;4928;15626;4740;15416;145;496;4351;14323;4496;14819
291620;201607;2973;7038;2342;6377;133;408;1865;5232;1998;5640
291630;201607;3186;7633;2628;6985;184;505;2074;5631;2258;6136
291640;201607;17033;46035;13544;40844;3424;11014;4301;13692;7725;24706
291650;201607;8277;24096;7605;23279;542;1450;6424;20076;6966;21526
291660;201607;2183;5685;1746;5008;146;557;1141;3096;1287;3653
291670;201607;1870;5175;1685;4929;112;321;1339;4003;1451;4324
291680;201607;4071;11753;3518;10840;614;2089;2148;6621;2762;8710
291685;201607;4798;12020;3970;10951;549;1481;2712;7763;3261;9244
291690;201607;3894;10372;3050;8983;211;635;2140;6270;2351;6905
291700;201607;9176;28259;8165;26500;913;2994;6032;19890;6945;22884
291710;201607;5276;13643;4254;12339;315;1004;3103;9012;3418;10016
291720;201607;4555;14610;3861;13168;299;1262;2745;9129;3044;10391
291730;201607;6177;18049;5597;17280;440;1515;4451;13937;4891;15452
291733;201607;2710;7660;2271;7051;203;693;1508;4827;1711;5520
291735;201607;2951;8092;2462;7388;134;509;2018;5994;2152;6503
291740;201607;3747;10731;3199;9972;222;840;2567;7963;2789;8803
291750;201607;22617;57586;17602;49922;3573;10520;8901;26115;12474;36635
291760;201607;11022;34828;9726;32613;3831;14038;2632;9113;6463;23151
291770;201607;7691;22035;6467;19834;821;2933;4180;12536;5001;15469
291780;201607;4490;13441;4185;12934;231;794;3524;10879;3755;11673
291790;201607;2707;8066;2558;7872;109;475;2189;6636;2298;7111
291800;201607;30820;82855;26945;77535;3964;11805;17287;51189;21251;62994
291810;201607;10786;28970;9042;26835;396;1416;7420;22021;7816;23437
291820;201607;3794;11076;3364;10435;208;771;2572;8038;2780;8809
291830;201607;4160;11000;3835;10540;358;1031;2949;8205;3307;9236
291835;201607;6375;19611;5105;17330;1191;4253;2625;9124;3816;13377
291840;201607;48099;133690;42144;126844;5965;17762;29435;92138;35400;109900
291845;201607;2639;7541;2460;7314;104;254;2239;6821;2343;7075
291850;201607;4585;13020;3763;11717;372;1109;2747;8870;3119;9979
291855;201607;1848;4487;1588;4161;136;468;1207;3062;1343;3530
291860;201607;2184;6071;1693;5116;71;272;1152;3383;1223;3655
291870;201607;1426;3805;1017;3065;84;325;641;1854;725;2179
291875;201607;2832;8851;2558;8422;164;676;1846;5970;2010;6646
291880;201607;4969;15812;4587;15069;447;1537;3377;11136;3824;12673
291890;201607;1301;3335;1059;3030;180;493;733;2164;913;2657
291900;201607;1268;3378;1016;2968;57;226;763;2194;820;2420
291905;201607;2743;7381;2045;6107;85;327;1503;4343;1588;4670
291910;201607;2788;7402;2319;6835;124;474;1968;5769;2092;6243
291915;201607;7070;21416;5886;19289;338;1246;4540;15028;4878;16274
291920;201607;25792;75822;23672;72860;3364;11427;15484;47847;18848;59274
291930;201607;2628;7677;2313;7179;197;747;1667;5056;1864;5803
291940;201607;3392;9489;2483;7893;303;1080;1486;4604;1789;5684
291950;201607;8839;29085;7964;27448;1291;4561;4730;16834;6021;21395
291955;201607;11231;31709;10345;30578;2511;7381;5660;17843;8171;25224
291960;201607;3169;9183;2591;8313;235;757;1902;6358;2137;7115
291970;201607;3897;11895;3583;11370;401;1500;2406;7673;2807;9173
291980;201607;12073;33925;9238;29875;920;3103;6250;20631;7170;23734
291990;201607;2197;6591;2001;6338;93;323;1714;5548;1807;5871
291992;201607;2858;8606;2795;8499;380;1135;2118;6487;2498;7622
291995;201607;2097;5921;1795;5498;100;380;1510;4573;1610;4953
292000;201607;2454;6768;2204;6442;206;705;1584;4718;1790;5423
292010;201607;6513;16074;5091;14090;487;1301;3719;10557;4206;11858
292020;201607;4056;13770;3822;13387;538;2061;2807;9813;3345;11874
292030;201607;2005;6205;1786;5882;234;838;1020;3310;1254;4148
292040;201607;4457;11826;3827;11166;202;412;3265;10091;3467;10503
292045;201607;3289;10407;2995;10005;126;426;2712;9088;2838;9514
292050;201607;6423;19380;5447;17417;510;1919;3497;11113;4007;13032
292060;201607;12727;31750;11711;30519;708;1941;9892;25548;10600;27489
292070;201607;4663;14286;4364;13929;371;1206;3653;11776;4024;12982
292080;201607;3594;9223;2928;8376;178;611;2482;7100;2660;7711
292090;201607;3993;10264;3386;9558;202;735;2840;8029;3042;8764
292100;201607;11426;30321;9776;28094;2066;6250;5179;15440;7245;21690
292105;201607;3094;9338;2749;8785;133;581;2225;7078;2358;7659
292110;201607;6508;17278;5042;14966;1276;3849;2415;7384;3691;11233
292120;201607;7553;21040;6297;18710;1155;3409;3570;10901;4725;14310
292130;201607;2902;7908;2485;7331;369;1035;1613;4955;1982;5990
292140;201607;5008;13077;4136;11840;604;1695;2836;8293;3440;9988
292145;201607;2394;7282;2110;6809;270;822;1465;4912;1735;5734
292150;201607;12556;38067;11569;36509;552;2220;9527;29981;10079;32201
292160;201607;2506;7134;2135;6655;92;395;1879;5795;1971;6190
292170;201607;8849;24876;7285;22228;920;3106;4642;14209;5562;17315
292180;201607;3021;8697;2363;7565;439;1349;1284;4281;1723;5630
292190;201607;3307;9306;2775;8484;545;1812;1527;4731;2072;6543
292200;201607;6830;20761;5796;18961;1668;5811;2199;7385;3867;13196
292205;201607;3882;11592;3484;11019;189;839;2806;8691;2995;9530
292210;201607;6524;17075;5444;15655;277;966;4556;13051;4833;14017
292220;201607;1860;5069;1658;4770;300;824;951;2754;1251;3578
292225;201607;3244;9952;2940;9492;167;715;2405;7702;2572;8417
292230;201607;6829;19226;6397;18555;352;1494;5071;14152;5423;15646
292240;201607;4849;14456;4288;13322;411;1322;2980;9242;3391;10564
292250;201607;5124;15722;4774;15124;971;3198;2516;8133;3487;11331
292260;201607;3201;9327;2962;9004;210;629;2449;7527;2659;8156
292265;201607;3189;9557;2749;8827;136;621;2099;6587;2235;7208
292270;201607;4153;10375;3350;9436;159;554;2844;8041;3003;8595
292273;201607;2794;6379;2131;5568;163;377;1619;4422;1782;4799
292275;201607;1598;4350;1414;4087;131;380;1097;3251;1228;3631
292280;201607;2231;6081;1949;5761;155;423;1509;4723;1664;5146
292285;201607;2506;6714;2054;6067;113;407;1602;4721;1715;5128
292290;201607;6988;20882;5818;19309;400;1651;4470;15012;4870;16663
292300;201607;8299;24512;7168;23126;1792;6190;3947;13153;5739;19343
292303;201607;2910;8692;2611;8285;107;432;2232;7023;2339;7455
292305;201607;2923;7871;2749;7629;58;245;2503;6864;2561;7109
292310;201607;5914;17346;5441;16641;215;853;4483;13650;4698;14503
292320;201607;6787;18782;5729;17008;405;1355;4428;13074;4833;14429
292330;201607;2231;5872;2033;5614;139;470;1654;4507;1793;4977
292335;201607;5179;13509;4603;12750;331;914;3735;10483;4066;11397
292340;201607;6493;17988;5532;16434;399;1266;4099;12193;4498;13459
292350;201607;2328;6761;2005;6312;135;536;1624;5109;1759;5645
292360;201607;5332;13711;5018;13190;196;418;4157;11396;4353;11814
292370;201607;8461;23909;7517;22650;606;1765;6051;18460;6657;20225
292380;201607;7304;21370;6620;20267;637;1894;5061;15657;5698;17551
292390;201607;3563;7935;2977;7298;80;199;2682;6639;2762;6838
292400;201607;20911;63482;19428;61128;2678;8773;13376;42430;16054;51203
292405;201607;4613;11341;3709;10168;211;547;2982;8272;3193;8819
292410;201607;2006;5304;1853;5132;126;379;1562;4329;1688;4708
292420;201607;3792;12143;3573;11827;258;1043;2888;9519;3146;10562
292430;201607;5583;16323;4202;14377;388;1549;2788;9622;3176;11171
292440;201607;8477;27853;7805;26858;230;1004;7037;24386;7267;25390
292450;201607;4019;11953;3292;10727;333;1163;2308;7604;2641;8767
292460;201607;4928;14681;4228;13510;513;1838;2865;9163;3378;11001
292465;201607;2441;7186;2036;6525;228;810;1292;4209;1520;5019
292467;201607;1870;5956;1784;5826;273;949;1223;4091;1496;5040
292470;201607;2946;7774;2415;6895;115;405;1893;5363;2008;5768
292480;201607;6329;16430;5328;15124;144;505;4792;13531;4936;14036
292490;201607;2426;6533;1979;5887;155;531;1486;4391;1641;4922
292500;201607;6639;19443;5672;17770;682;2269;3774;11986;4456;14255
292510;201607;12824;36397;10953;33644;817;3013;8242;25492;9059;28505
292520;201607;5610;15834;4885;14766;994;3105;2756;8475;3750;11580
292525;201607;5387;13883;4575;12939;181;596;3887;11059;4068;11655
292530;201607;27176;77096;23775;72491;5989;18993;11584;36770;17573;55763
292540;201607;2940;7892;2599;7486;245;857;2071;5917;2316;6774
292550;201607;6611;20108;5703;18936;564;2082;4380;14847;4944;16929
292560;201607;4075;11280;3521;10445;214;854;2691;7850;2905;8704
292570;201607;4253;11879;3908;11517;74;172;3681;11108;3755;11280
292575;201607;6363;20764;6148;20436;392;1348;5231;17586;5623;18934
292580;201607;6802;20058;6341;19414;325;1138;5422;16609;5747;17747
292590;201607;7575;21679;7052;20930;384;1293;6017;17629;6401;18922
292593;201607;3062;7837;2526;7001;323;868;1766;4874;2089;5742
292595;201607;5848;16081;5160;15203;367;1210;4086;12089;4453;13299
292600;201607;10795;30322;9636;28818;715;1918;7662;23490;8377;25408
292610;201607;4705;12972;3833;11573;290;910;2402;7577;2692;8487
292620;201607;6350;19322;5562;18416;107;362;5203;17447;5310;17809
292630;201607;9355;23526;7743;21063;615;1787;5509;15210;6124;16997
292640;201607;7821;25125;7225;24199;461;1830;5537;18751;5998;20581
292650;201607;4765;12598;4445;12189;370;976;3718;10257;4088;11233
292660;201607;10889;32331;9965;30998;932;3117;7642;24005;8574;27122
292665;201607;2399;7444;2271;7278;36;118;2098;6797;2134;6915
292670;201607;3767;10477;2917;8968;226;806;1872;5755;2098;6561
292680;201607;3719;10878;3312;10175;366;1175;2406;7359;2772;8534
292690;201607;2880;7767;2052;6446;203;653;1393;4536;1596;5189
292700;201607;9451;27781;8260;26039;1049;3223;5487;18163;6536;21386
292710;201607;2135;6979;2010;6814;69;271;1799;6129;1868;6400
292720;201607;9399;23739;8111;22314;331;1085;6945;19426;7276;20511
292730;201607;3678;10880;3524;10658;211;734;2871;8673;3082;9407
292740;201607;332879;884121;310499;850561;53232;156340;194044;528242;247276;684582
292750;201607;6599;17589;5651;16280;289;1004;4501;13008;4790;14012
292760;201607;4049;12469;3632;11735;404;1482;2482;8014;2886;9496
292770;201607;6043;17525;5288;16435;917;3018;3258;10480;4175;13498
292780;201607;1891;4355;1428;3764;110;384;1047;2689;1157;3073
292790;201607;3391;8186;3241;8028;55;99;3131;7832;3186;7931
292800;201607;9265;27002;8500;25758;511;1798;6838;20635;7349;22433
292805;201607;3066;8570;2670;8010;263;869;1994;5999;2257;6868
292810;201607;9602;28169;7834;25651;910;3173;5388;18043;6298;21216
292820;201607;7466;21020;5589;18296;303;1328;4397;14269;4700;15597
292830;201607;1762;5165;1586;4918;64;265;1370;4220;1434;4485
292840;201607;8160;24136;7666;23478;313;1275;6820;20567;7133;21842
292850;201607;3141;8281;2544;7366;276;891;1655;4691;1931;5582
292860;201607;15457;39311;14091;37552;984;2878;11194;29720;12178;32598
292870;201607;19396;52691;16936;48906;1835;6238;10376;29485;12211;35723
292880;201607;12758;35662;11289;33633;907;3298;8251;24097;9158;27395
292890;201607;5483;18145;4922;17153;651;2453;3298;11619;3949;14072
292895;201607;2870;6865;2199;5842;203;545;1558;4149;1761;4694
292900;201607;2787;8510;2642;8286;183;821;2000;6004;2183;6825
292905;201607;4100;12071;3306;10830;305;1059;2229;7401;2534;8460
292910;201607;5027;14760;4532;13882;545;1811;2809;8626;3354;10437
292920;201607;9389;27102;8927;26449;514;2010;7488;21622;8002;23632
292925;201607;5192;15489;4668;14726;345;1167;3672;11641;4017;12808
292930;201607;6520;20656;6108;19927;518;2253;4346;13874;4864;16127
292935;201607;2033;5891;1710;5539;82;264;1459;4908;1541;5172
292937;201607;3281;8243;2723;7547;171;519;2199;6121;2370;6640
292940;201607;3311;8888;2627;7978;234;751;1852;5793;2086;6544
292950;201607;8228;23790;7609;22774;546;2078;5694;16649;6240;18727
292960;201607;5336;13526;4589;12529;288;908;3468;9391;3756;10299
292970;201607;4315;12711;3772;11984;150;700;3102;9815;3252;10515
292975;201607;3588;9384;3345;9080;333;850;2825;7783;3158;8633
292980;201607;3343;8699;2608;7658;225;786;1888;5481;2113;6267
292990;201607;11954;33813;10327;31385;458;1723;8395;25406;8853;27129
293000;201607;2869;7307;2644;7039;49;148;2099;6023;2148;6171
293010;201607;18073;49718;15319;45327;2265;7297;9237;27208;11502;34505
293015;201607;7630;25650;6674;23783;759;3149;4466;15857;5225;19006
293020;201607;9053;29880;8499;29096;372;1677;7367;25083;7739;26760
293030;201607;5659;15962;4461;14092;263;928;3115;10285;3378;11213
293040;201607;3808;12251;3626;11909;200;696;3186;10510;3386;11206
293050;201607;20814;56672;18241;53378;3258;10061;9858;30460;13116;40521
293060;201607;3646;9705;3007;8656;243;817;2207;6279;2450;7096
293070;201607;24585;65575;20004;59035;4574;13842;9223;28828;13797;42670
293075;201607;3273;11001;3008;10595;189;844;2410;8512;2599;9356
293076;201607;3783;10310;3390;9791;173;482;2836;8388;3009;8870
293077;201607;4979;15345;4443;14612;799;2723;2775;9429;3574;12152
293080;201607;4643;14498;4190;13793;202;941;3436;11133;3638;12074
293090;201607;3316;10428;2722;9517;240;898;1984;7077;2224;7975
293100;201607;5889;17100;4844;15268;447;1499;3506;11183;3953;12682
293105;201607;4029;13105;3494;12079;454;1648;2342;8225;2796;9873
293110;201607;2055;5755;1797;5388;80;276;1476;4451;1556;4727
293120;201607;3790;12280;3582;11952;302;988;2864;9712;3166;10700
293130;201607;4078;11359;3494;10713;146;520;3048;9520;3194;10040
293135;201607;30626;77501;23271;67012;5060;16458;8902;26175;13962;42633
293140;201607;1983;5505;1877;5352;142;521;1508;4178;1650;4699
293150;201607;5509;18003;4706;16455;691;2504;2952;10580;3643;13084
293160;201607;3829;9762;3418;9271;461;961;2570;7413;3031;8374
293170;201607;3417;9919;3119;9492;260;911;2248;6931;2508;7842
293180;201607;5324;14819;4232;13053;194;836;3303;9983;3497;10819
293190;201607;13854;41474;12666;39695;549;2473;10778;33208;11327;35681
293200;201607;7234;19710;6331;18591;238;1014;4926;14612;5164;15626
293210;201607;5149;14554;4517;13489;284;984;3470;10316;3754;11300
293220;201607;5039;14747;4265;13372;1129;3560;1601;5262;2730;8822
293230;201607;3790;11419;3397;10796;435;1572;2377;7553;2812;9125
293240;201607;4414;12059;3534;10596;140;488;2621;7881;2761;8369
293245;201607;4318;12158;3875;11537;243;767;3101;9286;3344;10053
293250;201607;5659;15311;5071;14450;544;1673;3538;10013;4082;11686
293260;201607;4584;13468;3849;12390;277;1030;2849;9218;3126;10248
293270;201607;5664;14731;5099;14119;333;852;4402;12387;4735;13239
293280;201607;5359;14714;4513;13580;232;724;3548;10809;3780;11533
293290;201607;14622;48094;13549;46074;3386;11866;6240;22078;9626;33944
293300;201607;6995;16327;5837;14982;376;932;4494;11755;4870;12687
293305;201607;4889;12049;4100;10996;155;523;3430;9147;3585;9670
293310;201607;2526;6545;2012;5665;204;609;1347;3771;1551;4380
293315;201607;4289;10812;3634;9834;279;718;2793;7649;3072;8367
293317;201607;2501;7093;2239;6615;171;510;1592;4713;1763;5223
293320;201607;7777;25331;7524;25008;1063;3621;5614;18976;6677;22597
293325;201607;1831;5162;1497;4640;202;719;994;3060;1196;3779
293330;201607;50947;162520;45742;153397;10441;37482;21855;74561;32296;112043
293340;201607;2679;7556;2098;6562;277;944;1204;3771;1481;4715
293345;201607;3351;9849;2911;9260;265;706;2248;7543;2513;8249
293350;201607;6548;19084;6179;18657;210;477;5609;17440;5819;17917
293360;201607;13186;39421;11920;37833;773;2957;10337;32712;11110;35669
310010;201607;925;2482;716;2157;103;390;328;916;431;1306
310020;201607;2907;9008;2388;8032;612;2305;348;1097;960;3402
310030;201607;2343;7186;1917;6462;401;1533;1061;3540;1462;5073
310040;201607;982;2601;813;2370;73;264;619;1764;692;2028
310050;201607;1866;6326;1697;5957;372;1506;765;2621;1137;4127
310060;201607;3255;10007;2831;9459;271;1067;2230;7441;2501;8508
310070;201607;346;964;257;804;15;68;163;470;178;538
310080;201607;730;2155;602;1935;115;469;231;704;346;1173
310090;201607;4629;13641;3961;12486;483;1699;2634;8332;3117;10031
310100;201607;3474;10348;2916;9433;169;690;2260;7280;2429;7970
310110;201607;4816;13532;4093;12333;667;2286;2268;6658;2935;8944
310120;201607;629;1900;475;1603;141;591;177;481;318;1072
310130;201607;399;1215;364;1163;88;347;194;568;282;915
310140;201607;209;683;171;622;63;274;51;153;114;427
310150;201607;4754;14397;4084;13121;1015;3615;1391;4388;2406;8003
310160;201607;7143;22383;5913;20060;1966;7293;957;3201;2923;10494
310163;201607;1044;3329;878;3002;318;1169;232;776;550;1945
310170;201607;9181;25433;8148;23999;1038;3327;5648;16812;6686;20139
310180;201607;1687;4806;1445;4436;264;920;809;2406;1073;3326
310190;201607;2833;9244;2516;8664;704;2727;516;1762;1220;4489
310200;201607;1839;5944;1555;5376;336;1293;569;1977;905;3270
310205;201607;1122;3193;859;2795;121;377;479;1614;600;1991
310210;201607;2745;7826;2407;7328;140;496;1873;5677;2013;6173
310220;201607;1054;3139;926;2937;154;552;590;1830;744;2382
310230;201607;2548;7794;2145;6911;325;1273;1181;3597;1506;4870
310240;201607;904;3257;816;3073;127;543;465;1751;592;2294
310250;201607;815;2655;783;2599;150;629;466;1427;616;2056
310260;201607;3171;9986;2402;8408;613;2452;473;1499;1086;3951
310270;201607;2568;7194;2108;6544;161;638;1637;5028;1798;5666
310280;201607;2333;6088;1893;5436;210;834;1099;2992;1309;3826
310285;201607;2031;7123;1875;6889;189;826;1409;5243;1598;6069
310290;201607;1146;3438;1076;3325;281;1003;558;1578;839;2581
310300;201607;1704;5696;1616;5538;416;1633;815;2678;1231;4311
310310;201607;366;990;262;801;42;135;127;399;169;534
310320;201607;399;1251;329;1122;45;202;168;553;213;755
310330;201607;524;1299;347;975;40;138;147;363;187;501
310340;201607;8384;24774;6858;22160;1395;4632;3301;11179;4696;15811
310350;201607;13724;36238;9966;30026;2641;8856;2628;7813;5269;16669
310360;201607;437;1283;402;1235;31;133;292;858;323;991
310370;201607;1413;4689;1263;4414;316;1121;635;2256;951;3377
310375;201607;1217;3318;795;2544;116;419;308;984;424;1403
310380;201607;383;993;231;729;66;223;75;210;141;433
310390;201607;462;1580;396;1452;108;420;78;250;186;670
310400;201607;10347;28313;7710;23933;1984;6796;1999;6283;3983;13079
310410;201607;732;2427;513;2043;125;541;97;390;222;931
310420;201607;5605;15594;3673;11603;720;2522;528;1459;1248;3981
310430;201607;1331;4294;1014;3676;278;1123;164;574;442;1697
310440;201607;562;1615;429;1366;91;334;165;537;256;871
310445;201607;1245;4038;1036;3652;88;367;720;2511;808;2878
310450;201607;4585;12719;3688;11421;348;1205;2577;8110;2925;9315
310460;201607;1570;4630;1300;4224;381;1371;315;1122;696;2493
310470;201607;4097;9175;3491;8450;211;520;3033;7410;3244;7930
310480;201607;1255;3624;945;3016;215;720;399;1228;614;1948
310490;201607;2890;9344;2522;8618;599;2381;1021;3402;1620;5783
310500;201607;1314;4393;1152;4048;302;1164;459;1576;761;2740
310510;201607;2050;6387;1598;5405;421;1548;294;1005;715;2553
310520;201607;1425;3622;1071;3077;73;228;731;2075;804;2303
310530;201607;995;2979;527;1812;85;331;67;206;152;537
310540;201607;3056;9760;2724;9160;729;2615;1163;3886;1892;6501
310550;201607;1190;3309;944;2923;198;748;506;1484;704;2232
310560;201607;15576;46903;13119;42236;3558;12812;3983;12175;7541;24987
310570;201607;1167;3440;991;3142;141;548;676;2094;817;2642
310590;201607;4351;12582;3572;11140;597;2039;1688;5193;2285;7232
310600;201607;1420;4647;1268;4333;274;1098;545;1758;819;2856
310610;201607;468;1573;410;1447;99;435;125;396;224;831
310620;201607;143594;435764;122757;396597;29919;108912;47047;142538;76966;251450
310630;201607;4226;12606;3849;11976;360;1310;2834;8723;3194;10033
310640;201607;1284;3888;1048;3492;306;1147;284;891;590;2038
310650;201607;2676;8315;2094;7275;322;1203;1204;4210;1526;5413
310660;201607;1326;4007;1168;3806;120;425;866;2805;986;3230
310665;201607;1280;3766;1139;3574;87;305;924;2958;1011;3263
310670;201607;40587;123540;35998;114081;9219;31257;13762;42979;22981;74236
310680;201607;683;1922;610;1818;89;297;412;1213;501;1510
310690;201607;1435;4558;1162;4081;255;1079;451;1497;706;2576
310700;201607;540;1314;422;1165;68;225;267;725;335;950
310710;201607;6309;20316;4835;17858;1249;5431;629;2136;1878;7567
310720;201607;782;2339;718;2231;78;288;512;1582;590;1870
310730;201607;9361;28754;8317;27020;1400;5055;4902;15916;6302;20971
310740;201607;5055;15884;3966;13705;1014;3832;903;3027;1917;6859
310750;201607;1489;3690;1105;3169;201;617;524;1431;725;2048
310760;201607;600;1783;499;1614;90;314;197;641;287;955
310770;201607;903;2833;694;2506;161;656;301;1042;462;1698
310780;201607;3763;10285;3167;9247;459;1402;2046;5968;2505;7370
310790;201607;1968;6279;1791;5963;414;1416;869;3029;1283;4445
310800;201607;2830;8839;2163;7561;657;2674;185;596;842;3270
310810;201607;1148;3228;1015;2978;176;601;578;1606;754;2207
310820;201607;1307;3729;918;2992;223;794;230;745;453;1539
310825;201607;2555;8485;2007;7531;145;791;1449;5323;1594;6114
310830;201607;1345;4328;1082;3824;295;1138;356;1233;651;2371
310840;201607;2127;6421;1640;5562;368;1372;453;1457;821;2829
310850;201607;1527;4484;1293;4180;143;556;949;3061;1092;3617
310855;201607;2984;9221;2553;8559;403;1475;1691;5738;2094;7213
310860;201607;7445;22657;6225;20452;747;2708;3742;12476;4489;15184
310870;201607;1052;2833;817;2447;138;446;479;1443;617;1889
310880;201607;1077;3295;865;2891;143;554;448;1472;591;2026
310890;201607;2602;7822;2001;6788;543;2113;413;1262;956;3375
310900;201607;4133;12891;3231;11019;756;2918;1133;3634;1889;6552
310910;201607;1918;5385;1256;4111;249;947;173;486;422;1433
310920;201607;1880;5457;1484;4845;319;1168;677;2211;996;3379
310925;201607;923;2985;822;2810;273;1050;359;1193;632;2243
310930;201607;6185;17226;4928;15390;737;2499;2960;9548;3697;12047
310940;201607;6179;17113;5152;15563;775;2588;3028;9104;3803;11692
310945;201607;1167;3378;1027;3172;147;532;622;1870;769;2402
310950;201607;2094;6564;1531;5367;386;1582;503;1662;889;3244
310960;201607;401;1274;327;1129;89;329;129;462;218;791
310970;201607;1451;4741;1065;3864;271;1111;168;541;439;1652
310980;201607;440;1071;274;794;43;148;132;344;175;492
310990;201607;1175;3760;951;3267;214;815;301;959;515;1774
311000;201607;3559;11962;3237;11360;970;3800;1096;3671;2066;7471
311010;201607;727;2445;673;2347;230;844;302;1080;532;1924
311020;201607;944;2722;730;2352;143;533;351;1090;494;1623
311030;201607;1670;4529;1143;3560;297;1069;374;1058;671;2127
311040;201607;465;1551;397;1391;108;388;100;332;208;720
311050;201607;2247;6839;1938;6363;454;1676;915;3004;1369;4680
311060;201607;2483;7242;1840;5887;341;1262;590;1762;931;3024
311070;201607;1412;4789;1234;4459;271;1124;521;1873;792;2997
311080;201607;810;2491;683;2242;159;588;275;856;434;1444
311090;201607;1578;5885;1388;5497;455;1981;392;1500;847;3481
311100;201607;2052;6828;1654;5979;594;2314;257;941;851;3255
311110;201607;3497;8357;2521;7000;420;1282;1299;3645;1719;4927
311115;201607;1236;3550;1027;3240;116;462;698;2166;814;2628
311120;201607;7954;22146;6101;18901;1373;4816;1728;5027;3101;9843
311130;201607;2110;6378;1717;5779;358;1485;709;2270;1067;3755
311140;201607;1344;3525;1054;3146;93;322;703;2119;796;2441
311150;201607;1753;6020;1612;5790;281;1094;1026;3719;1307;4813
311160;201607;4021;13353;3273;11999;1193;4767;804;2978;1997;7745
311170;201607;800;2384;633;2079;88;318;309;1063;397;1381
311180;201607;1182;3390;924;2904;283;976;233;702;516;1678
311190;201607;1107;3091;834;2571;182;660;225;649;407;1309
311200;201607;1974;6000;1588;5202;456;1646;288;878;744;2524
311205;201607;1010;3315;863;3020;133;556;412;1444;545;2000
311210;201607;963;3100;884;2994;135;454;615;2164;750;2618
311220;201607;866;2682;707;2352;159;596;251;805;410;1401
311230;201607;8264;25982;6462;22301;1356;4992;2185;7972;3541;12964
311240;201607;1033;3092;808;2729;219;816;274;923;493;1739
311250;201607;772;2498;687;2366;204;792;246;767;450;1559
311260;201607;2421;6398;1822;5425;406;1362;667;1968;1073;3330
311265;201607;1248;3474;982;3038;176;611;545;1691;721;2302
311270;201607;3405;10709;2972;10104;331;1533;2095;6862;2426;8395
311280;201607;1281;3563;821;2615;173;654;207;639;380;1293
311290;201607;1992;6594;1858;6294;343;1169;1114;3850;1457;5019
311300;201607;4365;14343;3875;13473;413;1816;2778;9533;3191;11349
311310;201607;573;1899;513;1787;106;388;149;474;255;862
311320;201607;3820;12615;3428;11776;692;2718;1270;4126;1962;6844
311330;201607;4620;13684;3974;12591;1014;3568;1761;5624;2775;9192
311340;201607;11992;37307;10395;34281;3272;11692;2808;9208;6080;20900
311350;201607;2324;6447;1791;5461;292;1074;802;2223;1094;3297
311360;201607;1113;3064;869;2754;417;1380;138;489;555;1869
311370;201607;3723;11090;3079;9943;698;2685;1210;3565;1908;6250
311380;201607;412;1357;359;1257;113;433;122;423;235;856
311390;201607;1780;6385;1616;6161;727;3141;442;1557;1169;4698
311400;201607;1473;4599;1199;4077;237;942;494;1541;731;2483
311410;201607;1799;6049;1609;5806;422;1704;799;2928;1221;4632
311420;201607;1906;6128;1318;4705;266;1043;154;427;420;1470
311430;201607;3837;11423;2663;8880;618;2296;375;1237;993;3533
311440;201607;2444;7699;1789;6515;617;2593;293;1059;910;3652
311450;201607;1940;6662;1628;5990;458;1876;331;1139;789;3015
311455;201607;1126;2997;883;2598;222;712;379;1032;601;1744
311460;201607;633;2025;482;1719;113;471;119;388;232;859
311470;201607;479;1589;381;1380;116;480;79;255;195;735
311480;201607;799;2105;745;2032;148;395;491;1340;639;1735
311490;201607;224;821;201;756;60;252;72;248;132;500
311500;201607;440;1267;349;1101;77;294;157;479;234;773
311510;201607;2997;9123;2390;8034;731;2872;554;1838;1285;4710
311520;201607;611;1983;565;1891;179;659;232;750;411;1409
311530;201607;11656;29765;8327;24437;2042;7167;2185;6200;4227;13367
311535;201607;808;2325;520;1756;124;501;101;319;225;820
311540;201607;614;2110;569;2036;163;590;283;1019;446;1609
311545;201607;2115;6353;1871;6050;194;764;1380;4406;1574;5170
311547;201607;1493;4162;1252;3787;97;321;840;2532;937;2853
311550;201607;2915;9143;2429;8183;434;1718;906;2992;1340;4710
311560;201607;267;697;225;647;34;107;128;351;162;458
311570;201607;2004;5079;1553;4467;98;302;1171;3474;1269;3776
311580;201607;2451;4875;1812;4140;359;757;1079;2647;1438;3404
311590;201607;465;1408;394;1295;91;348;178;579;269;927
311600;201607;1216;3665;1028;3415;184;617;655;2236;839;2853
311610;201607;2897;10053;2578;9496;761;2725;1103;4317;1864;7042
311615;201607;3153;9640;2614;8781;256;1030;1856;6171;2112;7201
311620;201607;417;1273;369;1191;64;234;220;706;284;940
311630;201607;1378;3987;1137;3579;165;557;731;2261;896;2818
311640;201607;767;2446;635;2229;123;473;309;1087;432;1560
311650;201607;2264;6395;1917;5861;258;876;1137;3512;1395;4388
311660;201607;2592;8213;1926;6794;394;1446;197;625;591;2071
311670;201607;1678;4775;1350;4228;402;1388;460;1447;862;2835
311680;201607;2083;6473;1740;5898;357;1271;966;3329;1323;4600
311690;201607;508;1265;432;1174;30;84;355;982;385;1066
311700;201607;2203;5831;1784;5271;138;481;1370;4000;1508;4481
311710;201607;1655;4993;1212;4162;417;1582;332;1135;749;2717
311720;201607;397;1312;357;1235;70;276;160;543;230;819
311730;201607;5949;14755;3408;10406;992;3510;682;1705;1674;5215
311740;201607;802;2400;761;2348;146;433;564;1775;710;2208
311750;201607;4045;12931;3477;12020;621;2510;1910;6454;2531;8964
311760;201607;707;2361;623;2168;151;585;161;474;312;1059
311770;201607;2237;7048;1847;6310;475;1828;579;1903;1054;3731
311780;201607;1164;4063;976;3655;290;1253;233;809;523;2062
311783;201607;1959;6377;1637;5749;96;471;1219;4223;1315;4694
311787;201607;597;2014;441;1570;84;339;117;351;201;690
311790;201607;1540;4524;1153;3791;282;1077;379;1201;661;2278
311800;201607;4655;15470;3986;13845;819;3139;433;1388;1252;4527
311810;201607;1064;3429;923;3162;81;368;572;1931;653;2299
311820;201607;620;1892;506;1639;120;441;260;785;380;1226
311830;201607;8347;27426;6772;23717;2135;8197;814;2704;2949;10901
311840;201607;2973;8869;2662;8407;652;2337;1382;4314;2034;6651
311850;201607;280;864;247;808;39;138;139;448;178;586
311860;201607;49421;143930;41922;130856;8040;27929;21432;65292;29472;93221
311870;201607;2127;6162;1557;5067;327;1220;492;1490;819;2710
311880;201607;6826;19322;6005;18289;642;1993;4426;13899;5068;15892
311890;201607;1481;4341;1196;3818;264;932;560;1753;824;2685
311900;201607;746;2226;649;2077;91;326;395;1280;486;1606
311910;201607;4319;12455;3499;11278;809;2848;1614;5256;2423;8104
311920;201607;1899;6172;1660;5740;192;750;1036;3586;1228;4336
311930;201607;3542;9968;2979;9083;1177;3788;830;2499;2007;6287
311940;201607;12555;37243;10033;32128;2389;8430;2591;7920;4980;16350
311950;201607;2219;6456;1798;5819;162;615;1255;4020;1417;4635
311960;201607;385;1188;345;1107;74;291;143;385;217;676
311970;201607;351;1199;288;1059;68;283;72;251;140;534
311980;201607;604;1682;407;1322;75;271;139;462;214;733
311990;201607;442;1264;356;1129;125;438;131;402;256;840
311995;201607;1189;3613;723;2496;60;239;66;170;126;409
312000;201607;609;1816;546;1722;65;228;354;1136;419;1364
312010;201607;891;2865;747;2552;123;464;296;978;419;1442
312015;201607;1378;4400;1227;4126;144;559;812;2693;956;3252
312020;201607;1092;3419;960;3208;192;695;466;1569;658;2264
312030;201607;1828;5207;1632;4961;100;383;1392;4188;1492;4571
312040;201607;741;2658;610;2317;147;611;137;508;284;1119
312050;201607;1224;4262;1051;3854;297;1222;165;545;462;1767
312060;201607;757;2274;656;2124;170;589;323;1028;493;1617
312070;201607;1039;3163;689;2402;147;573;260;879;407;1452
312080;201607;2648;7249;2117;6434;314;1188;1180;3358;1494;4546
312083;201607;907;2552;778;2366;89;311;573;1717;662;2028
312087;201607;2166;6462;1951;6156;219;770;1457;4666;1676;5436
312090;201607;8977;27331;7574;24930;2138;7559;2926;9567;5064;17126
312100;201607;1442;4626;1124;4106;217;956;498;1759;715;2715
312110;201607;1045;3630;916;3357;308;1277;178;595;486;1872
312120;201607;725;2343;608;2113;150;626;222;682;372;1308
312125;201607;1119;3560;990;3324;215;710;563;1988;778;2698
312130;201607;872;2431;667;2041;95;331;258;745;353;1076
312140;201607;804;2544;696;2290;182;656;197;573;379;1229
312150;201607;490;1427;428;1301;26;90;269;778;295;868
312160;201607;7406;24648;6541;22882;1685;6538;2549;8759;4234;15297
312170;201607;913;2604;767;2365;80;294;485;1468;565;1762
312180;201607;1362;4142;1178;3782;240;872;495;1496;735;2368
312190;201607;589;1871;444;1582;158;619;65;235;223;854
312200;201607;4755;13491;3967;12235;711;2232;2275;7080;2986;9312
312210;201607;1097;2895;831;2502;191;649;421;1194;612;1843
312220;201607;1914;6366;1757;6192;168;479;1480;5494;1648;5973
312230;201607;12494;38047;9675;32696;3291;12406;1391;4611;4682;17017
312235;201607;1570;4642;1380;4363;166;628;988;3106;1154;3734
312240;201607;926;3083;743;2697;190;750;205;745;395;1495
312245;201607;2173;6416;1942;6118;107;405;1587;4991;1694;5396
312247;201607;791;2337;604;2016;163;594;266;904;429;1498
312250;201607;1182;3219;884;2711;169;635;368;1059;537;1694
312260;201607;896;2806;740;2546;124;497;464;1556;588;2053
312270;201607;639;1898;528;1680;68;283;262;769;330;1052
312280;201607;411;1363;367;1268;145;540;49;166;194;706
312290;201607;776;2539;709;2441;187;742;247;841;434;1583
312300;201607;884;2918;695;2473;199;794;67;181;266;975
312310;201607;859;3178;804;3065;226;958;339;1269;565;2227
312320;201607;1995;5661;1548;4819;448;1558;327;915;775;2473
312330;201607;992;2878;824;2645;122;464;596;1897;718;2361
312340;201607;314;844;264;763;38;140;161;418;199;558
312350;201607;287;723;252;682;28;100;205;526;233;626
312352;201607;1632;5087;1465;4844;260;881;980;3356;1240;4237
312360;201607;3073;9716;2554;8680;613;2291;749;2563;1362;4854
312370;201607;1681;5235;1527;4990;487;1817;586;1830;1073;3647
312380;201607;1898;5162;1683;4872;78;232;1425;4246;1503;4478
312385;201607;1317;3846;1130;3550;100;420;816;2490;916;2910
312390;201607;2079;6626;1658;5803;446;1675;331;1094;777;2769
312400;201607;3141;9970;2611;8909;979;3451;663;2356;1642;5807
312410;201607;9923;32129;8801;29981;1968;7275;3872;13085;5840;20360
312420;201607;3879;11856;3664;11578;502;1627;2587;8357;3089;9984
312430;201607;8008;23383;6880;21405;918;2976;4499;14161;5417;17137
312440;201607;767;2392;640;2170;177;673;296;1052;473;1725
312450;201607;1119;3661;860;3132;254;971;295;1116;549;2087
312460;201607;352;1058;312;1011;65;254;171;548;236;802
312470;201607;656;1771;424;1324;86;309;132;395;218;704
312480;201607;1198;3112;898;2787;195;698;504;1494;699;2192
312490;201607;1997;5226;1568;4590;226;761;919;2598;1145;3359
312500;201607;688;2047;598;1910;114;430;224;702;338;1132
312510;201607;3501;10123;2823;8748;435;1552;1424;4161;1859;5713
312520;201607;264;870;212;782;67;260;62;243;129;503
312530;201607;604;1765;534;1665;68;263;344;1060;412;1323
312540;201607;1434;4463;1091;3794;194;735;543;1895;737;2630
312550;201607;688;2068;590;1850;121;429;282;827;403;1256
312560;201607;2061;5407;1694;4940;93;369;1392;4009;1485;4378
312570;201607;2366;6953;1978;6300;569;1950;675;2148;1244;4098
312580;201607;524;1723;440;1540;73;304;168;580;241;884
312590;201607;1672;5476;1444;4994;261;1140;654;2109;915;3249
312595;201607;1928;6417;1727;5957;327;1171;965;3370;1292;4541
312600;201607;792;2540;611;2182;114;520;289;954;403;1474
312610;201607;7076;19744;5217;16378;1315;4500;1080;3288;2395;7788
312620;201607;2186;6239;1679;5534;128;491;1235;4197;1363;4688
312630;201607;332;1060;281;968;75;292;106;351;181;643
312640;201607;539;1714;434;1498;92;343;136;438;228;781
312650;201607;2147;6204;1567;5061;166;613;899;2856;1065;3469
312660;201607;1400;3668;1126;3271;105;376;779;2228;884;2604
312670;201607;5552;16281;4682;15098;1394;5051;1723;5483;3117;10534
312675;201607;1269;4030;1073;3607;127;494;697;2327;824;2821
312680;201607;1467;4419;1250;4128;186;753;790;2523;976;3276
312690;201607;2148;5670;1740;5096;287;952;1086;3072;1373;4024
312695;201607;817;2853;779;2803;137;481;538;2016;675;2497
312700;201607;1865;5562;1471;4775;208;759;742;2353;950;3112
312705;201607;1254;3555;1039;3169;75;279;734;2187;809;2466
312707;201607;1538;4836;1189;4159;172;733;608;2036;780;2769
312710;201607;6874;17220;4522;13461;1310;4381;926;2741;2236;7122
312720;201607;751;2536;652;2336;148;598;260;892;408;1490
312730;201607;1890;4457;1314;3774;151;518;787;2248;938;2766
312733;201607;1628;4315;1219;3586;75;261;756;2165;831;2426
312735;201607;823;2225;713;2077;143;497;446;1241;589;1738
312737;201607;842;2099;609;1770;170;495;228;688;398;1183
312738;201607;514;1563;377;1295;95;382;125;393;220;775
312740;201607;347;811;199;639;61;229;47;140;108;369
312750;201607;1261;4435;1186;4310;235;1021;606;2135;841;3156
312760;201607;1973;6275;1528;5382;389;1497;385;1355;774;2852
312770;201607;41761;112802;31430;95533;8284;27529;8807;26342;17091;53871
312780;201607;2667;9101;2371;8600;441;1825;1318;4878;1759;6703
312790;201607;326;822;194;598;39;148;64;155;103;303
312800;201607;4959;15992;4010;14086;1257;4823;1008;3583;2265;8406
312810;201607;2053;6243;1435;5031;387;1473;264;876;651;2349
312820;201607;1879;5332;1637;4935;105;394;1151;3385;1256;3779
312825;201607;1337;3616;1158;3384;87;284;903;2645;990;2929
312830;201607;2520;7676;1745;6112;451;1713;318;1109;769;2822
312840;201607;1226;3865;1007;3451;165;669;336;1045;501;1714
312850;201607;697;2165;546;1868;105;438;162;545;267;983
312860;201607;1166;3417;898;2944;253;929;265;800;518;1729
312870;201607;5601;17180;3944;13691;762;2959;793;2630;1555;5589
312880;201607;1278;3742;1131;3524;137;484;726;2320;863;2804
312890;201607;1684;5065;1072;3673;219;810;394;1371;613;2181
312900;201607;1223;3549;1063;3329;115;390;784;2527;899;2917
312910;201607;1675;3334;984;2437;165;474;459;1059;624;1533
312920;201607;880;2763;720;2466;183;728;285;918;468;1646
312930;201607;2151;6130;1864;5711;409;1293;892;2788;1301;4081
312940;201607;909;2921;788;2726;205;805;221;728;426;1533
312950;201607;3095;8632;2381;7568;866;2989;539;1739;1405;4728
312960;201607;1953;5570;1686;5222;144;451;1324;4208;1468;4659
312965;201607;1799;5623;1533;5143;177;724;936;3125;1113;3849
312970;201607;1005;3320;830;3020;252;1028;223;804;475;1832
312980;201607;17179;56891;16093;54674;4653;17267;6251;20675;10904;37942
312990;201607;470;1377;333;1136;104;394;109;384;213;778
313000;201607;497;1622;400;1429;100;476;162;500;262;976
313005;201607;2589;8237;2290;7695;426;1459;1353;4623;1779;6082
313010;201607;3627;11478;3050;10480;788;2983;1411;4763;2199;7746
313020;201607;962;3129;742;2570;171;684;140;401;311;1085
313030;201607;1509;4001;1109;3446;214;793;516;1593;730;2386
313040;201607;828;2689;719;2435;113;470;318;995;431;1465
313050;201607;1805;5551;1346;4849;352;1445;357;1197;709;2642
313055;201607;1621;5032;1473;4828;67;268;1230;4071;1297;4339
313060;201607;745;2372;589;2014;171;602;74;226;245;828
313065;201607;1925;6162;1648;5724;292;1128;1094;3822;1386;4950
313070;201607;1034;2983;845;2660;173;626;381;1173;554;1799
313080;201607;445;1375;338;1157;82;329;103;304;185;633
313090;201607;5221;14942;4502;13779;1082;3574;2320;7178;3402;10752
313100;201607;1120;3375;1013;3207;82;246;799;2590;881;2836
313110;201607;1749;4941;1303;4085;208;766;581;1707;789;2473
313115;201607;2423;8057;2270;7737;512;2020;1063;3404;1575;5424
313120;201607;3518;9238;2984;8540;610;1965;1737;4940;2347;6905
313130;201607;25740;76967;22229;69928;4685;16477;9175;27455;13860;43932
313140;201607;580;1490;444;1288;30;109;316;898;346;1007
313150;201607;1315;4137;1116;3790;461;1654;276;953;737;2607
313160;201607;947;2861;817;2604;160;584;442;1368;602;1952
313170;201607;8571;28360;6482;23380;1556;6003;1451;5102;3007;11105
313180;201607;2376;6400;1894;5719;436;1485;750;2195;1186;3680
313190;201607;3502;11675;2783;9903;655;2546;732;2465;1387;5011
313200;201607;1139;3678;988;3393;115;448;696;2357;811;2805
313210;201607;4191;12891;3479;11795;740;2761;1678;5545;2418;8306
313220;201607;1512;4439;1090;3572;252;931;270;750;522;1681
313230;201607;2276;8005;2108;7782;290;1201;1522;5598;1812;6799
313240;201607;8151;24517;6316;21093;1291;4993;2485;7972;3776;12965
313250;201607;6889;21418;5889;19680;678;2508;3436;11470;4114;13978
313260;201607;619;1814;433;1413;81;304;107;345;188;649
313270;201607;5398;15955;4468;14365;819;2864;2402;7708;3221;10572
313280;201607;381;1246;277;1019;58;235;69;238;127;473
313290;201607;818;2865;673;2607;249;1079;111;400;360;1479
313300;201607;1807;5932;1488;5194;453;1776;215;653;668;2429
313310;201607;1053;3621;942;3389;230;977;197;639;427;1616
313320;201607;2330;6626;1726;5665;329;1197;744;2465;1073;3662
313330;201607;3995;12195;3319;11024;400;1680;2003;6479;2403;8159
313340;201607;1904;4670;1489;4062;258;709;852;2350;1110;3059
313350;201607;2890;8921;2292;7619;504;1890;483;1497;987;3387
313360;201607;1284;3636;966;3111;219;870;512;1554;731;2424
313370;201607;1166;3909;1093;3718;179;714;580;1865;759;2579
313375;201607;2333;6010;1606;4944;307;1175;518;1532;825;2707
313380;201607;4983;15326;4196;13758;1117;4067;1423;4405;2540;8472
313390;201607;870;2955;820;2882;88;389;572;1971;660;2360
313400;201607;3697;9966;3199;9387;282;762;2680;8093;2962;8855
313410;201607;1221;3449;1023;3148;222;767;592;1782;814;2549
313420;201607;18793;44499;11527;32490;2412;7732;1828;5111;4240;12843
313430;201607;1041;3230;793;2717;169;696;290;921;459;1617
313440;201607;6359;14222;4357;11901;266;730;2910;8185;3176;8915
313450;201607;624;1850;507;1627;110;403;163;493;273;896
313460;201607;2136;7179;1841;6671;532;2208;651;2171;1183;4379
313470;201607;3086;8453;2724;7944;395;1245;1821;5269;2216;6514
313480;201607;1032;2905;777;2495;128;478;263;781;391;1259
313490;201607;1510;4369;867;3329;294;1256;89;327;383;1583
313500;201607;403;1318;334;1142;56;209;113;387;169;596
313505;201607;9119;26349;8395;25530;283;598;7787;24171;8070;24769
313507;201607;1381;3762;1183;3472;122;426;793;2341;915;2767
313510;201607;15291;43581;13271;40546;1930;6297;7540;23205;9470;29502
313520;201607;14258;43447;11925;39288;1391;5259;7691;25230;9082;30489
313530;201607;603;1829;498;1640;38;150;184;589;222;739
313535;201607;2513;7367;2260;6909;186;659;1670;5042;1856;5701
313540;201607;1068;3335;794;2635;215;793;200;620;415;1413
313545;201607;1284;4653;1147;4384;171;809;679;2457;850;3266
313550;201607;1808;5759;1587;5332;362;1278;778;2577;1140;3855
313560;201607;2198;5052;1802;4604;210;499;1349;3561;1559;4060
313570;201607;877;3014;755;2776;234;947;258;920;492;1867
313580;201607;5720;16306;4528;14573;773;2760;2535;8261;3308;11021
313590;201607;965;2711;751;2410;352;1242;159;475;511;1717
313600;201607;3815;11358;3273;10488;396;1448;2284;7339;2680;8787
313610;201607;989;2908;847;2643;179;625;445;1364;624;1989
313620;201607;5443;16590;4710;15276;1299;4524;1725;5590;3024;10114
313630;201607;8187;22540;6163;19673;1043;3791;2965;10053;4008;13844
313640;201607;764;2201;571;1904;178;639;177;600;355;1239
313650;201607;1916;6274;1686;5892;249;1034;1105;3802;1354;4836
313652;201607;931;3244;851;3095;128;551;538;1902;666;2453
313655;201607;931;2958;778;2702;109;447;480;1652;589;2099
313657;201607;1332;3903;1087;3539;116;498;791;2416;907;2914
313660;201607;832;2721;734;2536;159;653;353;1158;512;1811
313665;201607;3734;11876;3190;10729;661;2509;1490;4837;2151;7346
313670;201607;45442;131470;33395;108245;7947;28703;10653;33893;18600;62596
313680;201607;1070;3126;937;2913;125;492;588;1773;713;2265
313690;201607;851;3051;749;2813;169;662;300;1153;469;1815
313695;201607;1345;4345;1154;3989;121;512;813;2812;934;3324
313700;201607;3447;11739;3015;11188;419;1639;2232;8448;2651;10087
313710;201607;1341;3570;1007;3049;194;655;512;1524;706;2179
313720;201607;5356;16857;4256;14502;890;3411;1444;4603;2334;8014
313730;201607;1291;3402;979;3006;151;521;575;1781;726;2302
313740;201607;2026;7280;1723;6543;543;2299;137;472;680;2771
313750;201607;2211;6682;1843;5953;503;1783;577;1710;1080;3493
313753;201607;1849;5263;1460;4594;274;978;681;2137;955;3115
313760;201607;4168;13355;3416;11860;1032;3917;971;3194;2003;7111
313770;201607;3364;10627;2886;9922;824;3008;1312;4564;2136;7572
313780;201607;3955;10782;3073;9449;459;1670;1218;3779;1677;5449
313790;201607;484;1666;457;1619;82;302;276;995;358;1297
313800;201607;1261;3350;1078;3081;116;376;738;2158;854;2534
313810;201607;1548;4417;1383;4184;108;309;1097;3424;1205;3733
313820;201607;12930;34270;10431;30331;1885;6355;4593;12889;6478;19244
313830;201607;417;1368;353;1241;91;361;137;493;228;854
313835;201607;896;2958;827;2850;144;587;460;1515;604;2102
313840;201607;7504;21414;5905;18732;1527;5399;1448;4518;2975;9917
313850;201607;1169;3151;1018;2885;196;682;538;1395;734;2077
313860;201607;2735;8197;2075;6800;471;1660;558;1760;1029;3420
313862;201607;1241;3114;865;2498;127;363;463;1423;590;1786
313865;201607;2264;6906;2037;6567;174;681;1566;5015;1740;5696
313867;201607;1112;3776;962;3451;291;1109;313;1155;604;2264
313868;201607;1633;5407;1388;4905;123;564;940;3241;1063;3805
313870;201607;784;2446;708;2317;195;750;232;677;427;1427
313880;201607;1404;4328;1196;3974;296;1118;489;1453;785;2571
313890;201607;1866;4966;1529;4521;251;724;961;3046;1212;3770
313900;201607;3957;14113;3520;13139;1138;4718;995;3703;2133;8421
313910;201607;736;2451;615;2209;224;877;86;298;310;1175
313920;201607;3290;10899;2849;10081;492;1877;1638;5960;2130;7837
313925;201607;1853;5013;1392;4168;82;270;861;2601;943;2871
313930;201607;6663;24412;5658;22622;759;2866;3676;15851;4435;18717
313940;201607;8555;27961;7041;25544;1992;8065;2200;8560;4192;16625
313950;201607;4124;11586;3139;9998;977;3613;1061;3124;2038;6737
313960;201607;5492;14043;3954;11836;1096;3666;1117;3208;2213;6874
313970;201607;1440;4126;1258;3914;158;552;771;2525;929;3077
313980;201607;1256;3825;962;3317;249;984;404;1389;653;2373
313990;201607;1764;6488;1507;5877;522;2232;326;1151;848;3383
314000;201607;8101;25401;7259;23742;1203;4685;4232;13355;5435;18040
314010;201607;1176;3224;969;2952;101;376;643;1906;744;2282
314015;201607;1367;4558;1123;4115;274;1144;449;1609;723;2753
314020;201607;505;1506;345;1161;78;286;80;266;158;552
314030;201607;844;2726;674;2342;102;398;254;871;356;1269
314040;201607;712;2028;600;1833;205;682;207;608;412;1290
314050;201607;1706;5252;1367;4577;302;1189;535;1679;837;2868
314053;201607;1590;4949;1392;4682;201;673;923;3276;1124;3949
314055;201607;2186;6451;1904;6038;92;378;1523;4868;1615;5246
314060;201607;1161;3562;917;3145;71;329;612;2054;683;2383
314070;201607;4161;12847;3275;11094;876;3194;764;2489;1640;5683
314080;201607;1842;5741;1279;4428;221;879;261;784;482;1663
314085;201607;1967;6502;1718;6142;492;1912;651;2347;1143;4259
314090;201607;3288;11242;2891;10463;663;2693;1074;4070;1737;6763
314100;201607;3334;8393;2923;7859;172;398;2512;6986;2684;7384
314110;201607;4023;12701;3540;11715;698;2626;1467;4511;2165;7137
314120;201607;1055;2506;511;1622;112;400;130;411;242;811
314130;201607;710;2025;365;1243;67;258;67;209;134;467
314140;201607;4898;15052;4043;13394;816;2987;1876;6218;2692;9205
314150;201607;1581;4294;1253;3733;192;640;658;1948;850;2588
314160;201607;2583;6543;1959;5647;186;602;1195;3621;1381;4223
314170;201607;1084;3207;894;2810;115;388;487;1480;602;1868
314180;201607;5250;16535;4648;15550;1272;4551;2000;6870;3272;11421
314190;201607;721;2040;551;1767;131;516;213;617;344;1133
314200;201607;2957;9084;2573;8399;272;1084;1801;5760;2073;6844
314210;201607;1993;5734;1774;5370;196;701;1135;3363;1331;4064
314220;201607;1579;4873;1212;4172;405;1550;241;742;646;2292
314225;201607;1355;3870;1224;3697;70;243;1001;3058;1071;3301
314230;201607;661;2113;611;2031;110;430;327;1070;437;1500
314240;201607;1119;3369;937;3095;148;526;505;1756;653;2282
314250;201607;553;1628;423;1361;92;331;130;380;222;711
314260;201607;1027;3613;913;3356;206;867;295;1030;501;1897
314270;201607;2866;9242;2382;8375;248;1038;1571;5529;1819;6567
314280;201607;3153;8610;2149;6716;511;1875;733;2052;1244;3927
314290;201607;4792;13146;4088;12002;835;2534;2306;6786;3141;9320
314300;201607;1512;4985;1277;4454;385;1394;365;1260;750;2654
314310;201607;5519;16162;4668;14653;1174;3987;1798;5539;2972;9526
314315;201607;817;3171;741;3022;98;485;500;2019;598;2504
314320;201607;2991;8347;2133;7140;528;1920;1041;3625;1569;5545
314330;201607;54562;162796;46319;149429;13372;46835;15150;48707;28522;95542
314340;201607;2947;7905;1679;5456;380;1409;142;334;522;1743
314345;201607;1223;4098;1100;3895;227;857;687;2432;914;3289
314350;201607;1292;3714;1000;3234;312;1106;196;583;508;1689
314360;201607;672;2142;453;1632;102;423;99;380;201;803
314370;201607;550;1822;508;1762;122;476;328;1112;450;1588
314380;201607;1309;3916;915;3142;259;964;147;524;406;1488
314390;201607;13685;39209;10202;32790;2616;9256;2465;7454;5081;16710
314400;201607;4488;13090;3753;12062;1197;4037;1412;4750;2609;8787
314410;201607;2648;8147;2094;7087;568;2160;683;2363;1251;4523
314420;201607;759;2128;584;1864;42;215;403;1211;445;1426
314430;201607;6414;18981;5509;17277;1576;5444;1737;5519;3313;10963
314435;201607;1323;4217;1161;3935;108;466;776;2615;884;3081
314437;201607;1084;2789;891;2494;37;124;692;1920;729;2044
314440;201607;641;1861;502;1664;172;649;107;313;279;962
314450;201607;1611;4648;1342;4262;283;1098;663;1961;946;3059
314460;201607;4096;13620;3298;11903;864;3447;617;2151;1481;5598
314465;201607;2272;7092;2116;6818;106;527;1684;5274;1790;5801
314467;201607;1008;2861;842;2574;55;158;619;1921;674;2079
314470;201607;2311;7163;1943;6428;406;1543;722;2242;1128;3785
314480;201607;5943;19504;4249;15127;723;2800;532;1682;1255;4482
314490;201607;900;2660;697;2252;157;575;325;990;482;1565
314500;201607;1994;5590;1472;4672;342;1193;483;1460;825;2653
314505;201607;1788;5171;1637;4966;207;716;1137;3483;1344;4199
314510;201607;1896;5120;1290;4271;396;1450;332;1116;728;2566
314520;201607;3010;10770;2296;9077;563;2524;250;898;813;3422
314530;201607;5978;20903;5627;20277;928;3350;3571;13279;4499;16629
314535;201607;2763;7612;2319;6985;227;772;1714;5169;1941;5941
314537;201607;1139;3556;911;3143;133;555;543;1831;676;2386
314540;201607;414;1228;335;1068;61;226;112;331;173;557
314545;201607;1422;4258;1235;3991;110;398;947;3135;1057;3533
314550;201607;626;1703;460;1460;91;385;181;509;272;894
314560;201607;4395;14971;3726;13408;791;3212;1157;3974;1948;7186
314570;201607;299;875;230;743;43;166;115;353;158;519
314580;201607;526;1723;411;1482;107;444;53;186;160;630
314585;201607;837;2693;611;2213;144;604;165;567;309;1171
314587;201607;1969;5934;1682;5450;332;1066;874;2919;1206;3985
314590;201607;3215;10795;2384;8669;519;2115;359;1214;878;3329
314600;201607;1651;5378;1188;4388;309;1261;165;526;474;1787
314610;201607;6989;23457;6248;21745;1478;5835;2689;8892;4167;14727
314620;201607;1605;4786;1434;4540;143;467;1089;3460;1232;3927
314625;201607;1466;4873;1334;4657;181;792;899;3027;1080;3819
314630;201607;4844;14269;4195;13240;327;1347;3013;9360;3340;10707
314640;201607;592;1595;458;1369;124;411;138;348;262;759
314650;201607;1089;3007;776;2482;112;424;288;840;400;1264
314655;201607;1565;4625;1165;3858;277;916;478;1606;755;2522
314660;201607;295;786;211;619;22;66;97;270;119;336
314670;201607;1670;4395;1192;3563;180;609;682;1997;862;2606
314675;201607;1781;5339;1530;4888;153;576;1074;3415;1227;3991
314690;201607;2343;7417;1905;6647;578;2283;418;1405;996;3688
314700;201607;9097;30338;6564;24645;1968;8227;965;3610;2933;11837
314710;201607;8472;25297;5950;19880;1215;4611;883;2675;2098;7286
314720;201607;2430;7878;1952;6851;483;1899;568;2026;1051;3925
314730;201607;2256;6686;1826;6015;500;1845;654;2040;1154;3885
314740;201607;2864;9058;2466;8296;445;1738;1175;3812;1620;5550
314750;201607;349;1082;280;925;45;173;119;375;164;548
314760;201607;1705;5585;1275;4553;204;865;256;770;460;1635
314770;201607;1078;3339;610;2063;75;295;101;273;176;568
314780;201607;281;750;212;653;44;172;106;306;150;478
314790;201607;11191;33134;8343;27826;3171;11930;838;2477;4009;14407
314795;201607;1673;4766;1415;4361;111;446;1041;3088;1152;3534
314800;201607;11228;32223;7825;25462;2188;7784;924;2879;3112;10663
314810;201607;11714;33709;8993;28969;2713;9575;1943;6366;4656;15941
314820;201607;938;2578;661;2115;172;606;250;798;422;1404
314830;201607;1645;5399;1448;5073;388;1546;674;2387;1062;3933
314840;201607;938;3300;761;3038;142;685;442;1722;584;2407
314850;201607;1930;5473;1543;4790;181;730;1053;3158;1234;3888
314860;201607;3272;10707;2861;9941;563;2286;1554;5249;2117;7535
314870;201607;5589;17224;4760;16114;465;1996;3467;11669;3932;13665
314875;201607;1790;5715;1699;5594;143;452;1441;4820;1584;5272
314880;201607;896;2385;736;2177;45;112;548;1724;593;1836
314890;201607;613;1816;425;1405;89;343;157;480;246;823
314900;201607;530;1570;432;1421;82;291;219;702;301;993
314910;201607;1706;5496;1370;4937;425;1741;472;1611;897;3352
314915;201607;2515;7849;2183;7295;208;861;1559;5102;1767;5963
314920;201607;559;1532;396;1282;42;161;210;631;252;792
314930;201607;4635;15459;4020;14139;1143;4363;1092;3687;2235;8050
314940;201607;402;1163;368;1108;57;196;220;622;277;818
314950;201607;332;959;246;833;51;198;70;225;121;423
314960;201607;739;2264;579;1938;143;530;179;560;322;1090
314970;201607;555;1907;467;1730;113;471;141;527;254;998
314980;201607;1486;4573;1237;4159;401;1511;107;334;508;1845
314990;201607;2593;8113;1980;6790;561;2212;405;1216;966;3428
314995;201607;1633;4925;1419;4601;150;612;948;3028;1098;3640
315000;201607;1065;3003;866;2684;97;354;554;1711;651;2065
315010;201607;440;1327;343;1137;79;327;123;359;202;686
315015;201607;2146;6427;1933;6180;252;808;1412;4788;1664;5596
315020;201607;811;2515;603;2064;95;347;241;783;336;1130
315030;201607;691;2047;552;1814;164;602;124;380;288;982
315040;201607;900;2745;842;2644;143;476;554;1737;697;2213
315050;201607;1374;3939;1108;3530;205;750;515;1641;720;2391
315053;201607;1067;3158;949;2937;158;610;456;1424;614;2034
315057;201607;1706;5721;1494;5372;281;1079;833;3015;1114;4094
315060;201607;832;2693;601;2182;143;561;89;319;232;880
315070;201607;746;2226;623;2015;164;567;291;903;455;1470
315080;201607;2878;9420;2472;8532;634;2356;1111;3815;1745;6171
315090;201607;793;2766;652;2427;165;682;157;574;322;1256
315100;201607;1176;3899;853;3147;220;940;218;744;438;1684
315110;201607;1422;4253;1202;3853;292;1037;455;1454;747;2491
315120;201607;14419;33579;9862;27681;1462;4308;4930;14895;6392;19203
315130;201607;1393;4573;1260;4316;344;1356;431;1430;775;2786
315140;201607;2779;8704;2257;7654;511;2021;819;2553;1330;4574
315150;201607;4652;12535;3528;10675;674;2309;1352;4074;2026;6383
315160;201607;1270;3677;1018;3194;216;717;433;1335;649;2052
315170;201607;1543;4654;1210;4034;281;1024;325;1147;606;2171
315180;201607;17127;47827;9829;32462;1847;6904;1744;5404;3591;12308
315190;201607;2038;5275;1692;4748;381;1104;991;2808;1372;3912
315200;201607;3878;12896;3205;11480;1065;4158;679;2447;1744;6605
315210;201607;7867;23005;6307;19812;1246;4419;2400;7241;3646;11660
315213;201607;1102;3400;1019;3282;50;183;818;2637;868;2820
315217;201607;2444;8316;2004;7503;253;1155;1189;4381;1442;5536
315220;201607;9837;27891;8237;25320;2501;7789;3100;10047;5601;17836
315230;201607;2936;7810;2626;7448;157;246;2278;6892;2435;7138
315240;201607;3036;9218;2563;8472;683;2408;1245;4079;1928;6487
315250;201607;10329;31178;7966;26721;1963;7339;2517;8446;4480;15785
315260;201607;1021;3153;700;2446;166;626;101;314;267;940
315270;201607;718;2304;559;1994;115;479;132;428;247;907
315280;201607;3097;8830;1966;6402;469;1648;318;963;787;2611
315290;201607;1357;3755;973;3138;315;1118;220;725;535;1843
315300;201607;529;1369;349;1146;133;461;138;468;271;929
315310;201607;1248;3945;1020;3528;136;569;640;2105;776;2674
315320;201607;781;2333;621;2122;121;487;292;1001;413;1488
315330;201607;729;2627;465;1917;112;506;65;259;177;765
315340;201607;3577;10134;2883;9103;591;2031;1192;3682;1783;5713
315350;201607;1892;5130;1413;4432;198;670;876;2820;1074;3490
315360;201607;1705;5632;1406;4951;282;1113;475;1584;757;2697
315370;201607;503;1536;431;1421;83;294;228;768;311;1062
315380;201607;205;693;160;586;42;184;39;115;81;299
315390;201607;1333;4381;991;3583;255;1057;187;637;442;1694
315400;201607;4272;12816;3463;11261;683;2444;1582;5077;2265;7521
315410;201607;2132;5494;1782;5019;163;553;1291;3667;1454;4220
315415;201607;1029;3321;907;3134;345;1246;337;1194;682;2440
315420;201607;1239;3935;967;3392;258;962;148;499;406;1461
315430;201607;3674;9895;2761;8427;806;2766;645;1893;1451;4659
315440;201607;939;2858;811;2640;175;662;360;1100;535;1762
315445;201607;2110;5819;1629;5081;196;719;1117;3472;1313;4191
315450;201607;2428;7553;2160;7133;380;1225;1352;4627;1732;5852
315460;201607;32923;106435;29168;98768;10396;37775;5956;19724;16352;57499
315470;201607;473;1411;385;1250;39;149;208;671;247;820
315480;201607;1729;5232;1159;3935;248;921;211;747;459;1668
315490;201607;3102;8258;2357;7261;402;1435;906;2702;1308;4137
315500;201607;492;1427;322;1040;42;164;130;364;172;528
315510;201607;1390;3945;1170;3601;130;454;833;2509;963;2963
315520;201607;1018;3046;826;2721;117;441;522;1667;639;2108
315530;201607;634;2118;515;1811;179;674;158;520;337;1194
315540;201607;1066;3348;876;2986;184;764;314;1073;498;1837
315550;201607;1746;4880;1356;4290;337;1191;439;1383;776;2574
315560;201607;6545;21608;5877;20658;634;2588;4032;14314;4666;16902
315570;201607;1952;6141;1793;5877;272;1028;1029;3315;1301;4343
315580;201607;2521;7285;1968;6298;544;1995;562;1724;1106;3719
315590;201607;869;2530;770;2383;127;445;426;1296;553;1741
315600;201607;2461;8637;1967;7690;316;1376;1093;4416;1409;5792
315610;201607;998;2815;807;2436;152;595;326;836;478;1431
315620;201607;317;1109;300;1080;86;289;169;648;255;937
315630;201607;902;2841;734;2493;191;668;158;512;349;1180
315640;201607;485;1394;395;1252;81;323;173;500;254;823
315645;201607;879;2607;705;2242;251;849;189;589;440;1438
315650;201607;1836;5024;1444;4465;103;439;1065;3258;1168;3697
315660;201607;2573;6607;2085;5839;220;637;1437;3995;1657;4632
315670;201607;10618;34625;9398;32283;2574;9540;3578;12199;6152;21739
315680;201607;3031;9998;2350;8617;737;2848;651;2386;1388;5234
315690;201607;3371;9508;2315;7609;605;2204;458;1632;1063;3836
315700;201607;7288;22486;6140;20219;1130;4217;2894;9220;4024;13437
315710;201607;1816;5159;1420;4525;131;571;907;2788;1038;3359
315720;201607;3661;11515;3247;10755;368;1509;1887;6005;2255;7514
315725;201607;1490;4649;1326;4405;232;800;921;3115;1153;3915
315727;201607;595;1821;488;1607;100;362;183;575;283;937
315730;201607;795;2453;727;2313;113;418;405;1252;518;1670
315733;201607;1006;3008;887;2802;258;923;322;965;580;1888
315737;201607;1260;3805;978;3299;84;343;622;2119;706;2462
315740;201607;1010;3046;835;2702;145;572;449;1364;594;1936
315750;201607;1124;3448;1019;3258;82;304;738;2351;820;2655
315760;201607;1038;2727;1000;2679;16;58;935;2484;951;2542
315765;201607;1496;4616;1333;4400;66;260;1092;3667;1158;3927
315770;201607;1436;4551;1231;4191;340;1275;334;1142;674;2417
315780;201607;22354;72298;20116;67466;5056;18411;6940;23058;11996;41469
315790;201607;3645;11952;3185;11042;328;1152;2119;7559;2447;8711
315800;201607;1446;5569;1132;4645;275;1219;185;724;460;1943
315810;201607;1373;3665;1155;3332;186;570;709;1992;895;2562
315820;201607;2449;8165;2123;7584;610;2261;932;3455;1542;5716
315830;201607;1210;3963;1011;3565;168;740;318;992;486;1732
315840;201607;850;2210;570;1711;111;370;162;464;273;834
315850;201607;1006;3529;977;3474;240;945;547;1876;787;2821
315860;201607;518;1744;381;1445;99;458;75;249;174;707
315870;201607;462;1343;376;1206;78;284;179;547;257;831
315880;201607;1208;3076;953;2758;221;796;342;924;563;1720
315890;201607;1500;5061;1321;4755;462;1748;578;2080;1040;3828
315895;201607;5324;16520;4564;14813;1013;3591;1609;5007;2622;8598
315900;201607;748;2223;715;2167;67;279;566;1617;633;1896
315910;201607;517;1723;476;1655;114;431;307;1050;421;1481
315920;201607;1593;4370;919;2937;206;736;169;461;375;1197
315930;201607;1084;2904;807;2425;216;725;219;634;435;1359
315935;201607;943;3119;837;2896;249;980;223;734;472;1714
315940;201607;621;1960;538;1792;109;415;261;854;370;1269
315950;201607;1202;3636;1068;3390;213;635;658;2161;871;2796
315960;201607;3518;11024;2399;8762;929;3952;109;250;1038;4202
315970;201607;751;2047;567;1794;46;127;394;1301;440;1428
315980;201607;4031;9796;2498;7253;667;2213;633;1603;1300;3816
315990;201607;4001;11446;3292;10260;529;2002;1654;5046;2183;7048
316000;201607;569;1677;475;1549;132;525;198;625;330;1150
316010;201607;629;2051;508;1822;82;349;229;764;311;1113
316020;201607;1043;3271;910;3060;126;509;616;2016;742;2525
316030;201607;3160;9204;2324;7703;220;864;1426;4820;1646;5684
316040;201607;3453;10859;2637;9150;474;1881;513;1537;987;3418
316045;201607;2046;6314;1875;6026;242;775;1325;4376;1567;5151
316050;201607;351;1111;281;1001;50;209;140;470;190;679
316060;201607;740;2204;586;1977;85;389;345;1068;430;1457
316070;201607;6175;19143;5308;17267;1170;4345;2264;7043;3434;11388
316080;201607;739;2681;652;2466;165;695;82;315;247;1010
316090;201607;552;1647;376;1271;72;285;114;368;186;653
316095;201607;1452;4571;1244;4207;161;579;803;2738;964;3317
316100;201607;2771;9069;2109;7469;542;2152;440;1440;982;3592
316105;201607;933;2632;699;2235;166;571;268;867;434;1438
316110;201607;12232;41119;10839;38768;1414;5593;7160;26342;8574;31935
316120;201607;1135;3626;911;3100;230;839;243;725;473;1564
316130;201607;1531;3461;923;2596;133;418;399;1085;532;1503
316140;201607;962;2784;757;2474;103;361;461;1528;564;1889
316150;201607;1515;4064;1321;3730;192;646;810;2265;1002;2911
316160;201607;1250;3646;959;3093;178;641;410;1309;588;1950
316165;201607;936;2479;778;2255;139;475;438;1283;577;1758
316170;201607;1358;3839;1004;3243;168;601;424;1274;592;1875
316180;201607;1403;4346;992;3433;243;942;187;581;430;1523
316190;201607;2838;8760;1501;5282;314;1111;254;795;568;1906
316200;201607;3859;12141;2959;10369;659;2657;725;2479;1384;5136
316210;201607;4721;15016;3968;13527;1452;5248;610;2112;2062;7360
316220;201607;796;2448;570;2005;128;513;65;245;193;758
316225;201607;1209;3310;1002;2987;159;556;600;1718;759;2274
316230;201607;418;1194;344;1065;55;200;171;562;226;762
316240;201607;6634;20118;5769;18960;658;2269;4274;14181;4932;16450
316245;201607;3243;11084;2975;10644;244;1213;2303;8012;2547;9225
316250;201607;10711;30695;8291;25981;2241;7789;2081;6263;4322;14052
316255;201607;2591;7733;2260;7332;311;1139;1590;5205;1901;6344
316257;201607;1361;3715;1016;3090;180;628;365;1046;545;1674
316260;201607;1801;5036;1422;4470;85;314;800;2664;885;2978
316265;201607;1327;3726;979;3048;101;367;589;1796;690;2163
316270;201607;3970;13139;3635;12454;933;3470;1503;5067;2436;8537
316280;201607;3193;10270;2890;9704;473;1826;1624;5333;2097;7159
316290;201607;3431;10599;2909;9590;633;2467;1186;3801;1819;6268
316292;201607;3514;11006;3101;10341;563;2127;1859;6021;2422;8148
316294;201607;890;2794;651;2307;134;554;57;211;191;765
316295;201607;1802;5943;1682;5715;226;957;1124;3699;1350;4656
316300;201607;1009;3094;854;2840;68;256;550;1866;618;2122
316310;201607;714;2032;479;1603;87;342;156;491;243;833
316320;201607;615;1927;491;1700;115;473;95;306;210;779
316330;201607;964;2937;757;2461;77;298;500;1592;577;1890
316340;201607;942;3015;762;2641;166;701;361;1162;527;1863
316350;201607;1313;4115;1166;3873;189;671;666;2234;855;2905
316360;201607;739;1956;584;1731;62;195;421;1260;483;1455
316370;201607;4573;14571;3904;13248;1189;4483;653;2200;1842;6683
316380;201607;1621;4225;1266;3736;88;311;904;2687;992;2998
316390;201607;898;2580;750;2351;174;604;318;1030;492;1634
316400;201607;1296;3948;982;3394;229;876;392;1329;621;2205
316410;201607;1073;3526;986;3397;176;652;666;2301;842;2953
316420;201607;1940;6149;1710;5849;161;685;1246;4167;1407;4852
316430;201607;955;2894;683;2337;180;696;154;483;334;1179
316440;201607;677;2209;559;2032;208;854;113;425;321;1279
316443;201607;691;2024;567;1803;113;420;232;706;345;1126
316447;201607;1590;4682;1437;4482;101;358;1214;3801;1315;4159
316450;201607;2161;7181;1808;6483;210;851;1216;4381;1426;5232
316460;201607;743;2283;672;2158;186;639;338;1059;524;1698
316470;201607;7303;23207;5825;20155;1580;6314;1615;5418;3195;11732
316480;201607;183;612;156;548;43;163;39;130;82;293
316490;201607;301;929;242;790;52;162;93;286;145;448
316500;201607;1147;4007;763;2889;161;670;34;122;195;792
316510;201607;758;2767;676;2602;248;1025;178;683;426;1708
316520;201607;1070;3208;861;2886;177;673;299;907;476;1580
316530;201607;1038;3319;863;2996;192;820;307;903;499;1723
316540;201607;734;2345;658;2214;94;390;231;739;325;1129
316550;201607;1180;3928;1100;3796;191;742;686;2386;877;3128
316553;201607;1926;6688;1511;5672;451;1911;347;1251;798;3162
316555;201607;2828;9649;2518;9260;207;808;1915;7261;2122;8069
316556;201607;645;1630;496;1393;42;139;337;917;379;1056
316557;201607;772;2763;731;2697;294;1148;204;696;498;1844
316560;201607;319;1121;272;1021;78;344;58;200;136;544
316570;201607;1252;3966;1100;3681;150;540;552;1876;702;2416
316580;201607;299;814;202;625;51;186;47;133;98;319
316590;201607;1465;3937;1037;3224;170;622;538;1540;708;2162
316600;201607;1052;3395;933;3166;246;922;386;1286;632;2208
316610;201607;577;2077;503;1919;98;468;315;1151;413;1619
316620;201607;2159;6517;1843;5986;217;858;1185;3815;1402;4673
316630;201607;1422;4720;1220;4280;447;1606;378;1399;825;3005
316640;201607;177;554;155;509;32;137;72;207;104;344
316650;201607;898;3247;791;3071;119;483;517;2080;636;2563
316660;201607;196;506;92;283;8;31;20;47;28;78
316670;201607;1915;5354;1539;4705;572;1901;392;1158;964;3059
316680;201607;1982;5328;1587;4769;148;482;1143;3434;1291;3916
316690;201607;1152;3892;1026;3606;308;1233;315;1098;623;2331
316695;201607;1093;3405;948;3126;101;391;604;1974;705;2365
316700;201607;366;1082;330;1025;39;172;219;622;258;794
316710;201607;2933;10882;2506;9956;937;3858;646;2785;1583;6643
316720;201607;16450;52217;13457;45819;3637;13242;3402;11416;7039;24658
316730;201607;363;1114;314;1018;80;300;134;402;214;702
316740;201607;676;2253;614;2149;97;401;392;1385;489;1786
316750;201607;401;1334;336;1191;56;237;119;386;175;623
316760;201607;3494;11497;3008;10826;1531;5729;891;3332;2422;9061
316770;201607;1316;3656;1181;3485;81;325;970;2839;1051;3164
316780;201607;584;1921;510;1775;162;658;80;245;242;903
316790;201607;860;2442;644;2080;172;594;207;688;379;1282
316800;201607;5147;16767;4552;15618;878;3448;2334;7595;3212;11043
316805;201607;790;2016;759;1975;38;91;665;1804;703;1895
316810;201607;610;1862;503;1650;141;509;196;595;337;1104
316820;201607;395;1024;223;727;40;171;33;94;73;265
316830;201607;571;1945;543;1896;151;581;251;865;402;1446
316840;201607;2818;8571;2475;7944;561;2057;1143;3526;1704;5583
316850;201607;2044;5916;1676;5310;234;846;947;2983;1181;3829
316860;201607;17833;55812;15222;51011;3594;13903;6217;20140;9811;34043
316870;201607;6093;19476;4914;16781;1493;5523;879;2965;2372;8488
316880;201607;868;2621;752;2427;223;848;238;748;461;1596
316890;201607;1281;3092;972;2673;253;807;521;1336;774;2143
316900;201607;2564;7600;2024;6515;488;1816;629;1813;1117;3629
316905;201607;462;1526;400;1385;133;495;146;507;279;1002
316910;201607;839;2607;608;2144;174;674;104;360;278;1034
316920;201607;1593;4276;1130;3644;273;1014;439;1383;712;2397
316930;201607;8388;28172;6652;24406;1675;6789;948;3323;2623;10112
316935;201607;4975;14468;3391;11338;923;3434;721;2376;1644;5810
316940;201607;6950;22362;5542;19304;1332;4993;1182;3927;2514;8920
316950;201607;1563;4269;1299;3904;118;423;941;2801;1059;3224
316960;201607;4781;12026;3761;10622;653;2013;2161;6071;2814;8084
316970;201607;3244;10222;3050;9886;701;2663;1244;3764;1945;6427
316980;201607;947;2876;683;2366;233;891;112;387;345;1278
316990;201607;9688;30339;8023;26649;2477;8981;695;2243;3172;11224
317000;201607;2806;9426;2685;9290;266;808;2070;8004;2336;8812
317005;201607;2572;7911;2260;7393;411;1396;1330;4407;1741;5803
317010;201607;30403;75084;18679;56871;4625;16011;3735;12205;8360;28216
317020;201607;63777;172157;37640;119759;7814;27679;7448;22151;15262;49830
317030;201607;716;2080;594;1887;61;251;361;1132;422;1383
317040;201607;10418;29867;8295;26174;2063;6994;3252;10379;5315;17373
317043;201607;714;1917;605;1772;101;291;363;1078;464;1369
317047;201607;1134;2980;833;2490;86;285;451;1353;537;1638
317050;201607;1520;5132;1173;4309;245;999;433;1475;678;2474
317052;201607;2287;7353;2091;7040;194;806;1539;5103;1733;5909
317057;201607;1688;4694;1273;3967;122;493;762;2293;884;2786
317060;201607;420;1199;268;862;63;231;71;209;134;440
317065;201607;1278;4026;1154;3830;108;455;865;2824;973;3279
317070;201607;9728;29909;6718;23197;1566;6110;933;3189;2499;9299
317075;201607;1088;3272;856;2776;206;706;207;650;413;1356
317080;201607;6200;16816;5202;15139;1579;4862;1645;4716;3224;9578
317090;201607;4819;15878;4476;15332;507;1844;3181;11073;3688;12917
317100;201607;3050;8230;2234;6860;693;2331;730;2178;1423;4509
317103;201607;1980;6685;1679;6114;269;1206;845;2999;1114;4205
317107;201607;1328;4043;1152;3690;162;653;748;2240;910;2893
317110;201607;654;1652;380;1185;67;252;140;462;207;714
317115;201607;1140;3549;965;3191;97;333;706;2355;803;2688
317120;201607;10677;35167;8702;30558;2068;8028;3313;11408;5381;19436
317130;201607;7470;21975;6190;19675;1396;4989;2517;7982;3913;12971
317140;201607;567;1805;518;1728;72;268;339;1143;411;1411
317150;201607;958;2632;829;2482;94;328;616;1809;710;2137
317160;201607;3512;9152;2618;7942;179;615;1814;5466;1993;6081
317170;201607;1916;5137;1479;4413;184;665;654;1791;838;2456
317180;201607;1789;5976;1449;5244;393;1518;364;1304;757;2822
317190;201607;1389;3883;1092;3457;94;337;732;2300;826;2637
317200;201607;4529;14047;3880;12731;1027;3785;1207;3837;2234;7622
317210;201607;1037;3062;863;2826;145;603;512;1635;657;2238
317220;201607;288;986;273;963;77;298;139;478;216;776
320010;201607;4972;15457;4276;14044;762;2693;2271;7401;3033;10094
320013;201607;1878;5719;1303;4445;228;804;539;1912;767;2716
320016;201607;3102;8699;2650;8028;283;845;1910;5857;2193;6702
320020;201607;3856;11961;3276;10773;960;3421;1043;3482;2003;6903
320030;201607;1689;5332;1300;4504;395;1449;394;1338;789;2787
320035;201607;1796;5273;1535;4874;519;1804;572;1743;1091;3547
320040;201607;3107;9970;2588;8918;613;2299;877;3005;1490;5304
320050;201607;1742;4697;1488;4240;317;979;677;1848;994;2827
320060;201607;11845;37081;8947;30536;2252;8431;2161;7051;4413;15482
320070;201607;1445;4594;1167;3987;293;1116;294;910;587;2026
320080;201607;5696;16343;4364;13703;1030;3385;1336;4335;2366;7720
320090;201607;8092;23407;6394;20018;1726;5807;2306;7040;4032;12847
320100;201607;2789;8595;2215;7420;636;2225;739;2512;1375;4737
320110;201607;1286;3804;1115;3470;303;987;333;1066;636;2053
320115;201607;1760;6244;1589;5933;807;3099;440;1747;1247;4846
320120;201607;16532;49527;12758;42335;3300;12138;3654;12212;6954;24350
320130;201607;36115;115114;32448;107810;6975;26046;15308;49519;22283;75565
320140;201607;3723;11693;2664;9312;713;2763;363;1279;1076;4042
320150;201607;15951;44078;11611;35834;3099;10414;1539;4647;4638;15061
320160;201607;4908;15381;4212;13972;1115;4149;1454;4539;2569;8688
320170;201607;1721;5446;1398;4740;367;1325;525;1780;892;3105
320180;201607;752;2501;658;2328;264;960;174;646;438;1606
320190;201607;3672;12567;2895;10678;857;3307;559;2038;1416;5345
320200;201607;1029;3134;843;2813;250;907;260;914;510;1821
320210;201607;4759;13315;3987;11810;859;2875;1858;5197;2717;8072
320220;201607;2383;7321;1941;6455;533;1950;744;2514;1277;4464
320225;201607;1362;4583;1073;3896;376;1464;170;621;546;2085
320230;201607;4254;13555;3622;12486;1086;3997;1411;5051;2497;9048
320240;201607;12559;36681;10009;32104;2704;9430;2841;9258;5545;18688
320245;201607;3393;11527;3127;10890;1083;3984;846;2889;1929;6873
320250;201607;1890;5725;1334;4435;381;1443;234;694;615;2137
320255;201607;1770;5894;1543;5499;603;2262;565;2171;1168;4433
320260;201607;1066;3245;804;2656;220;773;220;662;440;1435
320265;201607;2418;7637;2088;7120;478;1682;1148;4040;1626;5722
320270;201607;2705;7924;2005;6582;488;1739;846;2814;1334;4553
320280;201607;6786;20515;5877;18698;1520;5338;1971;5882;3491;11220
320290;201607;1407;4583;1025;3661;345;1287;144;535;489;1822
320300;201607;4239;14063;3730;12921;1310;4815;858;2973;2168;7788
320305;201607;4476;14332;3824;12859;975;3548;1536;5058;2511;8606
320310;201607;1958;5774;1637;5127;419;1368;610;1887;1029;3255
320313;201607;2220;6381;1526;4812;371;1381;270;770;641;2151
320316;201607;1741;5235;1409;4550;449;1511;433;1390;882;2901
320320;201607;20532;61481;16046;53228;4403;16118;5370;17656;9773;33774
320330;201607;3009;8876;2500;8009;647;2052;1120;3829;1767;5881
320332;201607;5281;17095;4581;15768;1555;5693;1609;5561;3164;11254
320334;201607;1986;6241;1361;4858;382;1532;274;959;656;2491
320335;201607;2359;6925;1480;4862;395;1437;172;482;567;1919
320340;201607;5937;15915;4934;14278;1060;3326;2248;6692;3308;10018
320350;201607;5196;13655;3883;11280;792;2455;1662;4759;2454;7214
320360;201607;1729;4568;1262;3679;235;745;472;1314;707;2059
320370;201607;3007;9757;2418;8416;717;2564;758;2647;1475;5211
320380;201607;2206;6483;1937;6001;384;1324;1088;3305;1472;4629
320390;201607;7374;22058;5987;19155;1772;6147;1726;5352;3498;11499
320400;201607;3550;10875;3148;10164;825;2965;1339;4198;2164;7163
320405;201607;4179;12165;3623;11228;818;2742;1900;5841;2718;8583
320410;201607;5558;14656;4077;12669;990;3365;1863;5919;2853;9284
320420;201607;2263;6784;1780;5909;542;2020;449;1477;991;3497
320425;201607;2000;5238;1621;4612;187;579;1007;2834;1194;3413
320430;201607;2471;6860;2125;6167;418;1320;1155;3239;1573;4559
320435;201607;2819;9130;2317;8103;1050;3777;618;2329;1668;6106
320440;201607;1058;3482;932;3161;236;878;317;1042;553;1920
320450;201607;2005;6260;1623;5502;450;1653;673;2240;1123;3893
320455;201607;4161;13577;3065;10937;891;3387;684;2401;1575;5788
320460;201607;2676;8519;2006;6984;547;2049;497;1653;1044;3702
320465;201607;1615;4999;1226;4147;230;844;568;1926;798;2770
320470;201607;4486;13406;3084;10260;896;3293;532;1699;1428;4992
320480;201607;1776;5509;1546;5066;378;1369;579;1872;957;3241
320490;201607;16135;48996;13500;44225;4039;14460;4194;13850;8233;28310
320495;201607;1350;3865;877;2898;286;1008;103;361;389;1369
320500;201607;48026;143787;41659;132318;9682;33635;19976;62490;29658;96125
320501;201607;4331;13487;3634;12418;1203;4584;1148;3875;2351;8459
320503;201607;1859;6285;1497;5503;576;2335;401;1357;977;3692
320506;201607;3981;12232;2802;9449;849;3082;152;437;1001;3519
320510;201607;8454;26167;7303;23957;1644;5918;3503;11396;5147;17314
320515;201607;1892;5431;1528;4628;439;1409;285;821;724;2230
320517;201607;2194;7019;1767;6160;562;2110;416;1447;978;3557
320520;201607;37973;112793;30948;99943;8150;29160;10973;35100;19123;64260
320530;201607;27431;82376;22628;73243;4637;17487;10924;33487;15561;50974
330010;201607;20435;61915;18347;57927;3973;13609;9798;30649;13771;44258
330015;201607;1673;4631;1433;4188;228;793;668;1907;896;2700
330020;201607;17772;51678;16153;49021;3022;10088;9578;28601;12600;38689
330022;201607;1893;5577;1587;5069;299;1084;854;2667;1153;3751
330023;201607;3228;9923;2820;9259;808;2877;906;2896;1714;5773
330025;201607;4574;12266;3586;10600;812;2625;1864;5507;2676;8132
330030;201607;8175;26886;7155;24862;1529;5902;3379;11281;4908;17183
330040;201607;12388;36335;10929;33663;2368;7921;5692;17105;8060;25026
330045;201607;72526;197172;62506;182975;8038;25772;42271;122219;50309;147991
330050;201607;2532;7758;2160;7047;650;2335;709;2173;1359;4508
330060;201607;5807;16573;4990;15384;1105;3873;2588;7891;3693;11764
330070;201607;21637;65085;19277;61092;4390;15123;9036;28710;13426;43833
330080;201607;7980;22590;7355;21620;798;2428;5143;15169;5941;17597
330090;201607;2689;7215;2405;6780;414;1309;1337;3671;1751;4980
330093;201607;2091;6124;1743;5512;361;1197;757;2521;1118;3718
330095;201607;1019;3426;877;3108;245;1020;272;908;517;1928
330100;201607;57122;179232;51911;170743;8903;33481;29196;95867;38099;129348
330110;201607;2380;7408;2097;6901;551;1972;660;2137;1211;4109
330115;201607;1929;5520;1687;5155;318;1107;898;2650;1216;3757
330120;201607;2646;7233;2311;6724;446;1502;1323;3724;1769;5226
330130;201607;3609;11530;3188;10792;812;3006;1477;4944;2289;7950
330140;201607;3097;9508;2809;9079;617;2250;1530;4893;2147;7143
330150;201607;2358;6918;1851;5902;456;1576;447;1466;903;3042
330160;201607;1176;3720;1029;3463;282;1107;484;1533;766;2640
330170;201607;101234;301882;91637;286631;17081;57392;52784;164510;69865;221902
330180;201607;2049;5956;1701;5317;165;652;1065;3157;1230;3809
330185;201607;8185;25155;7078;23033;1488;5280;3759;12031;5247;17311
330187;201607;3867;10978;3304;10036;481;1650;2176;6510;2657;8160
330190;201607;25765;72972;23957;70144;4153;12888;16184;47223;20337;60111
330200;201607;14220;44370;12600;41599;3117;10667;6306;21164;9423;31831
330205;201607;2193;5974;1896;5471;301;964;1093;3083;1394;4047
330210;201607;3345;9258;2731;8062;725;2246;750;2198;1475;4444
330220;201607;10407;31504;8953;28428;2411;8380;2439;7218;4850;15598
330225;201607;3852;11909;3408;11094;441;1778;2030;6442;2471;8220
330227;201607;17100;48913;15388;46435;3684;11509;8572;26351;12256;37860
330230;201607;1374;4062;1238;3846;281;1034;600;1778;881;2812
330240;201607;17734;54085;15072;49008;4981;17559;4005;12688;8986;30247
330245;201607;1315;4008;1011;3443;298;1140;190;606;488;1746
330250;201607;36154;105100;32826;99658;9869;30374;13443;42593;23312;72967
330260;201607;3909;12164;3395;11123;722;2621;1429;4474;2151;7095
330270;201607;19427;44998;13030;36253;3203;9942;4704;13242;7907;23184
330280;201607;2246;6617;1865;5873;332;1175;911;2719;1243;3894
330285;201607;18475;52566;16564;49729;2819;9205;10310;30745;13129;39950
330290;201607;3427;9641;3027;9042;493;1695;1793;5140;2286;6835
330300;201607;3331;10761;3030;10194;499;1963;1807;5903;2306;7866
330310;201607;2320;6572;1977;5994;302;978;1154;3475;1456;4453
330320;201607;13309;39688;12432;38346;1645;5599;9193;28204;10838;33803
330330;201607;27747;76082;24147;70452;4216;13936;14722;41724;18938;55660
330340;201607;14727;42615;11577;36870;3000;10323;3620;11404;6620;21727
330350;201607;86757;255623;78969;244229;11514;37788;54426;168797;65940;206585
330360;201607;5809;17200;5573;16880;407;1420;4689;14114;5096;15534
330370;201607;3499;12285;3153;11519;1066;4069;1071;3958;2137;8027
330380;201607;4999;16100;4213;14498;1033;3956;1541;5162;2574;9118
330385;201607;3998;13686;3644;12977;1121;4245;1403;5092;2524;9337
330390;201607;23035;74811;20237;69224;5123;19255;8710;29351;13833;48606
330395;201607;3069;8926;2771;8435;291;1063;1805;5393;2096;6456
330400;201607;2589;8109;2332;7676;337;1369;1436;4394;1773;5763
330410;201607;2828;8603;2315;7618;496;1811;1037;3312;1533;5123
330411;201607;2400;7473;2071;6774;263;1019;1206;3785;1469;4804
330412;201607;1377;4595;1148;4137;230;954;522;1775;752;2729
330414;201607;24426;68690;21330;64309;4259;12981;12491;38200;16750;51181
330415;201607;3560;10845;3066;9976;810;2760;1155;3815;1965;6575
330420;201607;9916;28325;6755;22479;1605;5852;1331;4342;2936;10194
330430;201607;7380;21761;6498;20108;1420;4786;2977;9025;4397;13811
330440;201607;1675;5565;1458;5113;474;1852;343;1108;817;2960
330450;201607;1369;4500;1221;4238;271;1117;612;2065;883;3182
330452;201607;14065;40842;11178;35297;2879;9995;4329;13262;7208;23257
330455;201607;506517;1378620;410172;1224647;89394;286606;207178;616643;296572;903249
330460;201607;1202;3895;1064;3645;232;900;483;1621;715;2521
330470;201607;4434;13342;3949;12463;932;3232;1825;5662;2757;8894
330475;201607;7899;24310;6944;22708;2075;7402;2668;8614;4743;16016
330480;201607;5883;17132;5340;16335;938;3140;3211;9657;4149;12797
330490;201607;109175;287330;97502;270177;10133;29778;70702;195902;80835;225680
330500;201607;5572;17039;5304;16554;787;2704;3591;11113;4378;13817
330510;201607;37585;114045;33540;107652;10343;33729;14908;49317;25251;83046
330513;201607;1496;4439;1360;4195;407;1294;583;1858;990;3152
330515;201607;3045;9340;2654;8586;876;2920;777;2498;1653;5418
330520;201607;11513;34408;10231;32156;2184;7365;4864;15156;7048;22521
330530;201607;1508;4434;1328;4094;356;1199;549;1654;905;2853
330540;201607;2948;8708;2441;7788;639;2200;933;2875;1572;5075
330550;201607;7862;26094;6902;24250;3004;11028;1203;4315;4207;15343
330555;201607;10317;30137;9118;28423;1690;5396;5528;17729;7218;23125
330560;201607;4312;12879;3882;12069;693;2420;2092;6304;2785;8724
330570;201607;3407;9964;2905;9109;743;2454;1393;4388;2136;6842
330575;201607;5264;15109;4695;14079;702;2398;3068;8922;3770;11320
330580;201607;13974;43777;11843;39436;3264;11550;4674;15675;7938;27225
330590;201607;1606;4895;1487;4703;265;931;965;3026;1230;3957
330600;201607;11011;31809;8863;28182;1461;5319;4345;13577;5806;18896
330610;201607;8916;27689;8057;26164;1316;4972;4733;15028;6049;20000
330615;201607;1677;5846;1514;5511;643;2447;426;1648;1069;4095
330620;201607;3469;11918;3068;11072;1046;4065;733;2673;1779;6738
330630;201607;23261;67821;19050;60356;3225;11870;10308;31452;13533;43322
350010;201607;2001;5932;1334;4577;344;1281;182;604;526;1885
350020;201607;459;1257;318;981;53;171;164;489;217;660
350030;201607;4401;13766;3435;11858;1137;4293;849;2892;1986;7185
350040;201607;474;1628;359;1364;91;376;95;351;186;727
350050;201607;922;2773;743;2443;180;699;264;761;444;1460
350055;201607;662;1955;561;1787;95;345;339;1050;434;1395
350060;201607;117;346;93;309;26;103;44;140;70;243
350070;201607;3746;11164;2415;8353;526;1995;495;1572;1021;3567
350075;201607;489;1627;382;1420;146;533;74;266;220;799
350080;201607;620;1778;410;1325;79;292;146;455;225;747
350090;201607;612;1592;397;1205;108;314;138;433;246;747
350100;201607;1881;5821;1355;4769;315;1259;409;1365;724;2624
350110;201607;461;1390;350;1153;43;165;188;611;231;776
350115;201607;1270;3805;1126;3508;196;714;618;1766;814;2480
350120;201607;604;1589;319;993;61;203;51;153;112;356
350130;201607;3293;9774;2878;8942;441;1572;1561;4618;2002;6190
350140;201607;592;1895;498;1731;80;333;248;837;328;1170
350150;201607;399;1328;343;1208;122;465;88;306;210;771
350160;201607;7963;23119;5446;18114;1250;4677;2126;6552;3376;11229
350170;201607;1658;5663;1408;5047;385;1447;311;1082;696;2529
350180;201607;1058;2963;686;2106;98;311;329;1008;427;1319
350190;201607;3032;9384;2480;8253;524;2076;1156;3411;1680;5487
350200;201607;367;1147;322;1066;38;134;203;670;241;804
350210;201607;4945;13149;3681;11079;1008;3285;1526;4530;2534;7815
350220;201607;2611;8226;2262;7480;541;2146;919;2811;1460;4957
350230;201607;661;2136;600;2026;144;529;266;889;410;1418
350240;201607;497;1511;414;1320;69;249;236;722;305;971
350250;201607;2047;7330;1905;7061;665;2643;666;2471;1331;5114
350260;201607;964;2572;673;2042;116;380;303;892;419;1272
350270;201607;4987;15227;4219;13549;813;2875;1830;5627;2643;8502
350275;201607;1965;6402;1773;6066;491;1827;714;2370;1205;4197
350280;201607;22332;54414;13799;39951;3016;9404;3296;9485;6312;18889
350290;201607;1923;6130;1505;5246;332;1291;468;1563;800;2854
350300;201607;473;1352;376;1156;81;253;211;637;292;890
350310;201607;829;2737;723;2506;105;424;318;1078;423;1502
350315;201607;505;1585;400;1358;79;336;99;291;178;627
350320;201607;10308;32026;9108;29785;2686;9384;1489;5068;4175;14452
350330;201607;14165;39252;9525;28768;1997;5964;3231;9344;5228;15308
350335;201607;359;1131;314;1035;24;66;228;768;252;834
350340;201607;1103;3265;771;2597;151;582;241;806;392;1388
350350;201607;719;2230;616;2059;145;555;216;704;361;1259
350360;201607;810;2758;697;2506;167;598;293;1102;460;1700
350370;201607;615;1811;452;1456;102;360;85;264;187;624
350380;201607;4204;11997;2852;9626;798;2990;720;2218;1518;5208
350390;201607;9039;27654;7946;25572;2278;7693;3114;9895;5392;17588
350395;201607;368;1015;188;639;30;115;45;140;75;255
350400;201607;7769;22174;6278;19535;1436;5006;2566;7751;4002;12757
350410;201607;8259;27277;6432;23492;1820;7313;1212;4333;3032;11646
350420;201607;534;1630;387;1366;88;371;30;100;118;471
350430;201607;709;2177;584;1950;114;438;303;978;417;1416
350440;201607;1256;3910;1104;3586;253;833;506;1644;759;2477
350450;201607;7574;23078;6004;19850;1485;5310;1472;4703;2957;10013
350460;201607;1448;3971;915;2911;169;595;298;892;467;1487
350470;201607;237;656;196;585;29;109;120;336;149;445
350480;201607;807;2418;563;1887;93;363;93;273;186;636
350490;201607;1831;5461;1556;5013;383;1384;593;1768;976;3152
350500;201607;562;1653;489;1531;90;314;274;844;364;1158
350510;201607;1114;3337;847;2766;157;593;326;997;483;1590
350520;201607;1376;5066;1092;4335;252;1093;222;864;474;1957
350530;201607;2411;7009;1978;6129;590;1886;675;2022;1265;3908
350535;201607;1241;3992;1159;3850;165;678;760;2417;925;3095
350540;201607;1764;4971;1377;4272;372;1218;490;1574;862;2792
350550;201607;10982;29180;7587;23583;1583;5599;2648;7859;4231;13458
350560;201607;3315;10844;2935;9993;408;1465;1649;5668;2057;7133
350570;201607;17976;58982;15983;54951;4664;17355;6074;20121;10738;37476
350580;201607;1634;5122;1160;4050;265;1023;140;432;405;1455
350590;201607;4072;12546;3164;10713;822;3119;1190;3746;2012;6865
350600;201607;41534;101993;27281;77306;4663;14570;11867;31783;16530;46353
350610;201607;7079;20650;5642;18128;1226;4324;2458;7799;3684;12123
350620;201607;405;1149;301;985;56;218;131;404;187;622
350630;201607;1589;4639;1191;3883;232;925;423;1249;655;2174
350635;201607;6388;18773;4975;16278;1153;4164;2042;6545;3195;10709
350640;201607;748;2300;516;1738;100;359;102;330;202;689
350650;201607;7735;23286;4839;16453;1181;4495;798;2509;1979;7004
350660;201607;4733;13770;3889;12312;760;2647;1966;6106;2726;8753
350670;201607;1614;4966;1471;4697;306;1021;812;2550;1118;3571
350680;201607;1074;3222;827;2738;182;671;343;1125;525;1796
350690;201607;862;2809;683;2444;153;604;213;724;366;1328
350700;201607;4234;12456;2871;9965;728;2773;814;2583;1542;5356
350710;201607;2658;8186;2313;7519;354;1266;1381;4415;1735;5681
350715;201607;781;2363;680;2165;178;599;287;858;465;1457
350720;201607;124;356;109;332;26;91;39;112;65;203
350730;201607;397;1475;378;1430;99;423;158;592;257;1015
350740;201607;1826;5588;1314;4397;252;924;372;1131;624;2055
350745;201607;489;1544;304;1050;47;176;138;442;185;618
350750;201607;9960;29987;7963;26095;1968;7164;1959;6025;3927;13189
350760;201607;13023;37698;10365;32937;2715;9538;3112;9123;5827;18661
350770;201607;706;1993;490;1581;69;253;252;791;321;1044
350775;201607;585;1568;492;1430;68;249;262;744;330;993
350780;201607;1883;5740;1457;4873;444;1651;239;828;683;2479
350790;201607;1905;5840;1398;4831;363;1364;260;781;623;2145
350800;201607;2878;9558;2687;9227;452;1839;1637;5442;2089;7281
350810;201607;2021;5684;1686;5210;455;1496;761;2411;1216;3907
350820;201607;559;1508;413;1234;67;254;192;531;259;785
350830;201607;854;2634;570;1991;81;296;141;451;222;747
350840;201607;2371;8389;1963;7441;639;2557;435;1581;1074;4138
350850;201607;5825;19308;4922;17337;1569;5804;1198;4203;2767;10007
350860;201607;3185;9793;3035;9575;228;910;2332;7295;2560;8205
350870;201607;2710;8487;2227;7713;450;1753;1319;4626;1769;6379
350880;201607;1260;4166;1055;3735;268;1016;264;915;532;1931
350890;201607;636;1813;415;1330;54;191;105;279;159;470
350900;201607;3929;12596;2939;10327;877;3340;333;1144;1210;4484
350910;201607;833;2447;725;2226;212;722;312;914;524;1636
350920;201607;10344;29312;9208;27335;1004;3379;6453;18477;7457;21856
350925;201607;4520;14056;3678;12351;947;3460;1253;3754;2200;7214
350930;201607;1578;4305;1222;3641;146;483;739;2122;885;2605
350940;201607;1798;5828;1638;5578;320;1264;938;3116;1258;4380
350945;201607;947;2948;801;2673;119;501;426;1357;545;1858
350950;201607;72379;216158;58074;186068;12730;45038;25229;77084;37959;122122
350960;201607;4613;15224;3946;13842;727;2920;2170;7316;2897;10236
350970;201607;4261;14586;3574;12947;1196;4731;689;2244;1885;6975
350980;201607;585;1913;527;1819;225;825;175;618;400;1443
350990;201607;1751;5859;1419;5247;411;1641;408;1497;819;3138
350995;201607;755;2561;719;2490;103;467;471;1543;574;2010
351000;201607;3002;8914;2485;7946;381;1389;1127;3404;1508;4793
351010;201607;355;1001;209;682;47;168;68;225;115;393
351015;201607;819;2768;684;2516;156;644;334;1196;490;1840
351020;201607;8150;25095;6997;23277;1679;5970;3299;11097;4978;17067
351030;201607;1793;6262;1545;5645;373;1533;504;1738;877;3271
351040;201607;3432;10198;3110;9645;413;1494;2130;6396;2543;7890
351050;201607;14713;41343;10394;33775;2594;9218;2980;9687;5574;18905
351060;201607;35967;104032;29195;91831;5931;20669;14214;43657;20145;64326
351070;201607;1447;4025;943;3087;286;1020;99;284;385;1304
351080;201607;2610;7497;2012;6731;500;1884;912;2909;1412;4793
351090;201607;355;1212;286;1068;68;287;51;191;119;478
351100;201607;2121;6428;1703;5547;490;1701;502;1671;992;3372
351110;201607;7227;18151;4063;12960;889;3239;952;2918;1841;6157
351120;201607;651;1874;514;1600;75;269;239;637;314;906
351130;201607;1002;2768;532;1793;99;362;108;333;207;695
351140;201607;1665;5587;1371;4983;442;1739;319;1104;761;2843
351150;201607;1517;5249;1095;4164;238;979;154;512;392;1491
351160;201607;1260;4376;1107;4015;293;1138;365;1228;658;2366
351170;201607;1405;4438;1176;3943;204;761;545;1741;749;2502
351190;201607;791;2515;614;2062;107;396;187;594;294;990
351200;201607;2023;5925;1694;5309;234;843;691;2044;925;2887
351210;201607;1122;3238;814;2611;151;537;302;896;453;1433
351220;201607;3232;10740;2936;10135;525;2010;1476;5011;2001;7021
351230;201607;1723;5315;1438;4775;287;1110;715;2296;1002;3406
351240;201607;1062;3259;783;2658;219;779;233;738;452;1517
351250;201607;985;2843;616;2006;99;327;212;665;311;992
351260;201607;922;2685;796;2428;215;661;279;829;494;1490
351270;201607;326;1101;283;1013;76;318;106;332;182;650
351280;201607;4837;14013;3699;11676;765;2633;1364;4141;2129;6774
351290;201607;969;2748;710;2246;170;558;281;869;451;1427
351300;201607;12797;41142;9609;34334;2347;9226;3015;10704;5362;19930
351310;201607;3103;9344;2490;8243;498;1880;1148;3543;1646;5423
351320;201607;816;2700;689;2391;141;554;236;760;377;1314
351330;201607;269;744;219;666;82;249;49;146;131;395
351340;201607;5511;18255;4666;16585;1320;4982;1744;6243;3064;11225
351350;201607;7618;24284;6555;22095;1787;6326;2405;7790;4192;14116
351360;201607;4070;12584;3701;11882;964;3458;1267;3776;2231;7234
351370;201607;2273;6969;1789;5954;374;1403;717;2198;1091;3601
351380;201607;38046;110273;33914;102667;6753;22263;15198;45118;21951;67381
351385;201607;231;699;193;625;35;127;84;255;119;382
351390;201607;1169;3739;973;3332;280;1133;387;1187;667;2320
351400;201607;905;2976;856;2866;290;1069;361;1163;651;2232
351410;201607;2490;7445;2170;6875;340;1131;1297;4044;1637;5175
351420;201607;315;897;214;702;47;161;51;169;98;330
351430;201607;828;2596;775;2509;122;428;549;1762;671;2190
351440;201607;3396;10086;2557;8265;606;2071;394;1197;1000;3268
351450;201607;1633;4582;1318;4061;328;1067;510;1659;838;2726
351460;201607;719;2123;609;1926;316;1007;143;461;459;1468
351470;201607;1006;3001;887;2770;174;630;427;1290;601;1920
351480;201607;2705;8707;2484;8342;418;1774;1434;4621;1852;6395
351490;201607;1793;5867;1586;5419;193;822;940;3065;1133;3887
351492;201607;225;700;180;589;11;43;111;361;122;404
351495;201607;193;617;151;506;34;140;62;195;96;335
351500;201607;26828;75428;20236;63259;5006;17195;7944;23862;12950;41057
351510;201607;8841;26881;7193;23547;1733;6130;3370;10896;5103;17026
351512;201607;472;1356;353;1094;59;178;177;551;236;729
351515;201607;2247;6998;1613;5588;391;1482;430;1347;821;2829
351518;201607;2097;6447;1449;5238;367;1524;465;1530;832;3054
351519;201607;794;2319;575;1841;99;373;161;403;260;776
351520;201607;784;2089;390;1335;65;266;67;219;132;485
351530;201607;394;1207;261;863;43;147;62;166;105;313
351535;201607;2359;6062;1819;5252;152;548;1206;3345;1358;3893
351540;201607;1761;5259;1399;4575;466;1686;211;688;677;2374
351550;201607;5239;15214;3688;11867;719;2597;1388;4302;2107;6899
351560;201607;360;1158;315;1074;70;283;56;189;126;472
351565;201607;170;570;154;528;30;102;61;208;91;310
351570;201607;12359;37103;10255;32835;2137;7425;5605;17491;7742;24916
351580;201607;324;857;189;572;40;126;45;134;85;260
351590;201607;437;1124;284;834;27;95;132;364;159;459
351600;201607;1750;4832;1464;4341;206;698;832;2361;1038;3059
351610;201607;658;1792;499;1522;67;259;237;646;304;905
351620;201607;18620;58891;14405;50335;3178;12554;3898;12340;7076;24894
351630;201607;20078;62177;18018;58864;3933;13718;10315;33444;14248;47162
351640;201607;12529;37190;10243;33069;1771;6327;5947;18898;7718;25225
351650;201607;457;1358;227;760;39;147;40;120;79;267
351660;201607;788;2503;572;1942;128;471;105;319;233;790
351670;201607;3960;12362;3209;10620;573;2167;1464;4563;2037;6730
351680;201607;609;1869;362;1262;78;260;63;218;141;478
351685;201607;386;1188;337;1098;78;237;171;571;249;808
351690;201607;1115;3282;804;2610;135;482;309;926;444;1408
351700;201607;1133;3324;961;2985;237;726;357;1108;594;1834
351710;201607;558;1830;470;1634;81;293;176;588;257;881
351720;201607;1574;4782;1084;3606;205;737;328;1057;533;1794
351730;201607;1079;3066;877;2762;208;769;386;1208;594;1977
351740;201607;3944;10741;3127;9126;651;2014;1227;3463;1878;5477
351750;201607;1116;3544;747;2685;183;704;183;647;366;1351
351760;201607;3514;10836;2815;9316;747;2674;933;2909;1680;5583
351770;201607;2194;6874;1850;6232;476;1708;817;2658;1293;4366
351780;201607;1537;4286;886;2829;149;506;203;621;352;1127
351790;201607;1057;3031;912;2800;217;647;471;1491;688;2138
351800;201607;455;1006;260;692;33;89;101;260;134;349
351810;201607;1023;2905;877;2668;95;302;621;1863;716;2165
351820;201607;2459;7712;1829;6389;464;1743;197;658;661;2401
351830;201607;3979;12260;3013;10144;525;2026;1462;4732;1987;6758
351840;201607;6963;22980;5997;21051;1549;5940;2205;7577;3754;13517
351850;201607;1948;5272;1374;4276;190;740;674;1916;864;2656
351860;201607;3337;10547;2880;9611;719;2575;1233;4010;1952;6585
351870;201607;28066;83293;23452;74983;6671;22577;9885;31585;16556;54162
351880;201607;112682;349689;95019;313669;27922;98587;26075;82739;53997;181326
351885;201607;632;2167;572;2043;143;527;254;887;397;1414
351890;201607;627;1933;496;1677;127;469;88;276;215;745
351900;201607;1218;3720;1016;3383;276;1001;322;1064;598;2065
351905;201607;477;1492;387;1321;50;196;210;672;260;868
351907;201607;18290;53398;15051;47291;1692;6393;9549;29096;11241;35489
351910;201607;1023;3179;836;2754;188;668;334;1068;522;1736
351920;201607;986;2678;858;2496;131;448;515;1464;646;1912
351925;201607;899;2762;752;2471;143;535;339;1031;482;1566
351930;201607;2633;8423;2499;8172;437;1794;1761;5447;2198;7241
351940;201607;981;2957;813;2618;158;550;372;1183;530;1733
351950;201607;1465;4002;1035;3200;140;464;497;1531;637;1995
351960;201607;4360;12443;3187;10259;679;2393;1366;4392;2045;6785
351970;201607;5298;18838;4695;17642;1373;5603;1748;6372;3121;11975
351980;201607;886;2624;658;2126;145;516;219;622;364;1138
351990;201607;1525;4247;1208;3658;261;970;266;689;527;1659
352000;201607;2275;7263;2040;6780;423;1564;1032;3250;1455;4814
352010;201607;1672;5596;1463;5128;382;1445;297;1064;679;2509
352020;201607;1398;4299;1192;3926;318;1147;460;1462;778;2609
352030;201607;4853;14070;3992;12791;814;2815;2136;6892;2950;9707
352040;201607;1959;6320;1564;5471;355;1387;295;965;650;2352
352042;201607;3416;9421;2112;6584;410;1379;945;2897;1355;4276
352044;201607;1685;5177;1092;3898;207;818;208;687;415;1505
352050;201607;10321;31151;7068;23953;1707;6589;1406;4330;3113;10919
352060;201607;740;2217;593;1913;124;463;232;682;356;1145
352070;201607;793;2032;631;1762;147;461;217;598;364;1059
352080;201607;418;1188;294;951;53;177;110;339;163;516
352090;201607;1207;4125;995;3575;172;689;240;788;412;1477
352100;201607;2760;8371;2134;7221;535;1969;846;2736;1381;4705
352110;201607;496;1715;419;1563;118;460;159;559;277;1019
352115;201607;461;1461;398;1348;68;248;205;688;273;936
352120;201607;900;2806;739;2504;123;507;376;1184;499;1691
352130;201607;1771;5068;1180;3864;287;996;273;855;560;1851
352140;201607;1748;5001;1043;3497;171;606;373;1211;544;1817
352150;201607;774;2331;607;2015;153;532;284;943;437;1475
352160;201607;995;2731;764;2313;180;581;252;688;432;1269
352170;201607;2710;8118;2421;7514;436;1474;1301;3843;1737;5317
352180;201607;3249;9272;2717;8226;706;2317;980;2835;1686;5152
352190;201607;1160;3458;921;2960;159;640;318;844;477;1484
352200;201607;364;1250;281;1067;46;190;114;421;160;611
352210;201607;16318;43857;13284;39443;2289;7279;8012;24193;10301;31472
352215;201607;554;1702;504;1624;71;278;307;960;378;1238
352220;201607;12430;39382;10232;34892;3407;12478;2695;9216;6102;21694
352230;201607;12266;40825;10541;37560;2962;11667;3823;13225;6785;24892
352240;201607;12178;34928;9464;30216;2714;9842;3002;8726;5716;18568
352250;201607;22122;70534;19176;64497;5846;20927;6315;21298;12161;42225
352260;201607;5207;14761;3390;10982;652;2379;1206;3616;1858;5995
352265;201607;870;2738;740;2514;48;217;500;1649;548;1866
352270;201607;1734;5910;1449;5283;401;1548;377;1363;778;2911
352280;201607;2204;6570;1817;5898;402;1485;737;2287;1139;3772
352290;201607;1129;3542;951;3149;198;772;374;1134;572;1906
352300;201607;949;2752;746;2363;178;640;316;925;494;1565
352310;201607;42255;124155;34060;109897;8489;28744;16864;54879;25353;83623
352320;201607;5474;16714;4679;15174;1251;4380;1551;4611;2802;8991
352330;201607;1956;6154;1646;5715;536;2018;500;1707;1036;3725
352340;201607;5273;16651;4009;14178;1131;4367;829;2763;1960;7130
352350;201607;1655;5563;1473;5167;305;1207;540;1806;845;3013
352360;201607;1065;3239;928;2982;180;693;592;1791;772;2484
352370;201607;846;2874;761;2680;130;531;402;1374;532;1905
352380;201607;984;3102;840;2833;250;960;213;698;463;1658
352390;201607;18573;49245;12283;37468;2177;7623;5809;16596;7986;24219
352400;201607;3778;10712;2483;8180;714;2509;635;1963;1349;4472
352410;201607;2880;8675;2442;7961;553;1942;1021;3235;1574;5177
352420;201607;890;2477;746;2195;150;495;322;920;472;1415
352430;201607;6307;18690;5237;16969;1633;5773;1821;5897;3454;11670
352440;201607;15277;46023;12321;40266;2910;10209;4706;15113;7616;25322
352450;201607;673;2055;451;1570;103;403;124;400;227;803
352460;201607;2328;7444;1926;6651;551;2134;553;1753;1104;3887
352470;201607;3999;10949;2664;8466;414;1465;1031;3034;1445;4499
352480;201607;4335;11773;3304;9858;711;2450;1225;3301;1936;5751
352490;201607;668;2309;532;1964;106;425;130;461;236;886
352500;201607;8618;24654;7425;22850;3717;12275;1902;5223;5619;17498
352510;201607;2900;9077;2292;7932;710;2704;596;2018;1306;4722
352520;201607;1971;6903;1734;6326;445;1758;711;2560;1156;4318
352530;201607;8327;26318;6231;21544;1672;6228;932;2822;2604;9050
352540;201607;474;1467;337;1135;52;190;94;305;146;495
352550;201607;865;2844;610;2245;144;608;118;390;262;998
352560;201607;633;1863;449;1452;81;256;112;325;193;581
352570;201607;1785;5836;1344;4828;362;1492;220;675;582;2167
352580;201607;856;2510;729;2296;152;518;364;1135;516;1653
352585;201607;235;753;195;673;51;194;66;230;117;424
352590;201607;12313;37502;9869;32718;3018;10690;3785;11857;6803;22547
352600;201607;1619;4931;1403;4529;309;1085;622;1924;931;3009
352610;201607;3289;10032;2696;9014;797;2948;808;2601;1605;5549
352620;201607;5191;15754;4670;14949;1035;3525;2457;7756;3492;11281
352630;201607;632;1967;594;1877;141;519;249;734;390;1253
352640;201607;2682;8150;2219;7225;272;1013;1279;4082;1551;5095
352650;201607;810;2404;602;1953;116;396;173;547;289;943
352660;201607;1040;3522;833;3059;170;698;223;823;393;1521
352670;201607;10989;32515;6664;22973;1658;6279;608;2029;2266;8308
352680;201607;2842;9434;2167;7892;508;2055;698;2321;1206;4376
352690;201607;30814;84468;21968;66936;3390;11550;10976;32118;14366;43668
352700;201607;600;1789;501;1634;150;545;218;684;368;1229
352710;201607;5314;15292;3940;12505;980;3498;1385;4193;2365;7691
352720;201607;7555;24253;6704;22361;2100;7127;2059;6871;4159;13998
352725;201607;410;1150;237;783;29;118;95;298;124;416
352730;201607;2195;7263;1982;6720;461;1718;724;2200;1185;3918
352740;201607;2124;5727;1680;5023;234;845;971;2769;1205;3614
352750;201607;491;1410;253;872;33;125;55;173;88;298
352760;201607;1195;4046;972;3482;296;1121;277;922;573;2043
352770;201607;778;2415;663;2176;162;571;280;892;442;1463
352780;201607;611;2045;483;1740;102;394;148;520;250;914
352790;201607;630;1810;453;1486;77;270;126;421;203;691
352800;201607;1008;3537;730;2791;153;644;214;750;367;1394
352810;201607;1173;3050;771;2263;156;493;240;671;396;1164
352820;201607;638;1734;457;1439;105;362;108;346;213;708
352830;201607;528;1505;319;1020;60;217;45;113;105;330
352840;201607;3713;12462;3296;11569;962;3529;1282;4433;2244;7962
352850;201607;9244;26913;7070;23328;1912;6735;2498;8197;4410;14932
352860;201607;797;2644;732;2508;167;643;279;907;446;1550
352870;201607;943;2371;641;1754;69;247;352;852;421;1099
352880;201607;2283;6328;1672;5145;301;942;597;1731;898;2673
352885;201607;233;777;217;740;25;90;150;509;175;599
352890;201607;672;1762;468;1351;68;242;203;510;271;752
352900;201607;19685;56907;14290;46092;2998;10617;5121;15894;8119;26511
352910;201607;360;1036;208;693;28;100;37;111;65;211
352920;201607;2426;7257;1852;6058;380;1400;780;2356;1160;3756
352930;201607;5658;17425;4439;14779;1043;3704;1264;4071;2307;7775
352940;201607;21115;67784;17541;59619;6084;22292;2148;6743;8232;29035
352950;201607;332;973;211;752;47;203;41;131;88;334
352960;201607;616;1837;375;1285;62;234;80;247;142;481
352965;201607;371;1031;228;710;53;167;33;89;86;256
352970;201607;3185;7937;2562;7022;296;869;1735;4777;2031;5646
352980;201607;1084;3374;914;3084;194;656;522;1857;716;2513
352990;201607;4004;12442;3516;11604;933;3475;1498;4732;2431;8207
353000;201607;443;1253;242;785;33;122;40;119;73;241
353010;201607;2977;8213;2168;6651;535;1892;639;1730;1174;3622
353020;201607;4092;11112;2524;7731;396;1341;885;2452;1281;3793
353030;201607;3755;11053;3033;9695;921;3174;615;1924;1536;5098
353040;201607;544;1485;460;1354;118;386;147;408;265;794
353050;201607;4764;15756;3962;14059;1101;4181;1411;4854;2512;9035
353060;201607;38786;113454;33915;105524;3573;13450;24025;72351;27598;85801
353070;201607;10398;31891;7428;25585;1818;6727;1901;6607;3719;13334
353080;201607;5120;16034;3555;12617;838;3310;834;2770;1672;6080
353090;201607;524;1754;468;1635;50;208;279;913;329;1121
353100;201607;282;785;135;449;22;74;24;70;46;144
353110;201607;7452;22644;6400;20942;1295;4589;3749;12358;5044;16947
353120;201607;670;1983;429;1425;94;352;111;320;205;672
353130;201607;2469;7092;1984;6347;641;2229;638;1992;1279;4221
353140;201607;2308;6262;1791;5282;396;1271;792;2230;1188;3501
353150;201607;1622;4859;1303;4298;351;1188;374;1256;725;2444
353160;201607;652;1820;414;1326;98;330;69;184;167;514
353170;201607;417;1342;380;1284;103;448;186;570;289;1018
353180;201607;8321;23365;6643;20453;1110;3749;3686;11147;4796;14896
353190;201607;3668;10996;3009;9577;521;1866;1579;4728;2100;6594
353200;201607;982;3249;764;2699;233;918;197;642;430;1560
353205;201607;363;1177;320;1095;75;266;138;476;213;742
353210;201607;988;2483;701;1975;49;181;461;1264;510;1445
353215;201607;379;1175;323;1055;55;202;104;308;159;510
353220;201607;650;2005;527;1745;128;439;130;409;258;848
353230;201607;781;2512;711;2387;198;741;199;622;397;1363
353240;201607;1997;6383;1759;5906;361;1374;933;3035;1294;4409
353250;201607;1072;2878;811;2406;111;369;410;1155;521;1524
353260;201607;876;2409;633;1966;110;407;232;683;342;1090
353270;201607;651;1884;559;1710;124;411;215;638;339;1049
353280;201607;589;1890;480;1643;126;473;108;354;234;827
353282;201607;1730;5455;1574;5141;250;922;882;2745;1132;3667
353284;201607;356;959;205;639;41;131;50;155;91;286
353286;201607;143;430;102;343;18;63;22;73;40;136
353290;201607;698;2134;564;1895;87;358;313;994;400;1352
353300;201607;1414;4365;1180;3869;278;1035;435;1299;713;2334
353310;201607;185;567;156;514;50;179;55;176;105;355
353320;201607;544;1556;464;1420;86;279;241;711;327;990
353325;201607;586;1913;480;1692;93;348;115;388;208;736
353330;201607;604;1737;413;1296;67;239;192;566;259;805
353340;201607;2712;7790;1832;6128;552;1932;487;1656;1039;3588
353350;201607;3178;9483;2535;8221;766;2635;774;2409;1540;5044
353360;201607;432;1403;388;1310;47;182;262;869;309;1051
353370;201607;623;2041;539;1844;70;286;285;932;355;1218
353380;201607;318;1054;260;930;55;237;87;289;142;526
353390;201607;5604;15247;3961;12330;819;2745;1426;4273;2245;7018
353400;201607;471;1430;406;1307;99;351;89;242;188;593
353410;201607;620;1804;516;1624;101;351;277;869;378;1220
353420;201607;584;1631;387;1183;103;311;106;311;209;622
353430;201607;2226;7459;1609;5925;435;1691;260;934;695;2625
353440;201607;57737;181049;46699;156433;12591;44438;16801;55068;29392;99506
353450;201607;419;1221;344;1065;75;269;131;383;206;652
353460;201607;3274;9222;2617;7982;337;1182;1311;4048;1648;5230
353470;201607;7992;23919;5839;19576;1398;5229;1354;4275;2752;9504
353475;201607;1564;4392;1116;3415;201;670;349;974;550;1644
353480;201607;1401;4217;1250;3920;194;664;771;2358;965;3022
353490;201607;953;2747;747;2337;156;517;288;861;444;1378
353500;201607;990;2630;814;2351;222;649;402;1145;624;1794
353510;201607;988;3134;733;2492;189;678;147;463;336;1141
353520;201607;1122;3183;865;2748;149;543;377;1143;526;1686
353530;201607;2527;7399;2187;6784;345;1251;1200;3589;1545;4840
353540;201607;1905;5769;1629;5288;423;1454;705;2252;1128;3706
353550;201607;6130;16841;5043;15086;560;2065;3188;9114;3748;11179
353560;201607;1996;6605;1650;5969;470;1880;434;1460;904;3340
353570;201607;451;1380;355;1155;79;268;168;505;247;773
353580;201607;2333;6898;2045;6407;315;1131;1354;4220;1669;5351
353590;201607;721;2084;525;1677;128;446;170;553;298;999
353600;201607;1734;4777;1539;4446;234;760;790;2231;1024;2991
353610;201607;541;1819;407;1532;81;352;78;264;159;616
353620;201607;2155;6888;1803;6170;460;1670;554;1795;1014;3465
353625;201607;365;1012;227;742;39;147;79;255;118;402
353630;201607;1479;5136;1189;4400;266;1088;142;444;408;1532
353640;201607;1296;3843;1000;3192;136;491;497;1551;633;2042
353650;201607;7770;22724;5747;18436;1128;3849;2117;6541;3245;10390
353657;201607;302;947;259;859;43;162;92;287;135;449
353660;201607;1070;2787;796;2311;317;1007;116;252;433;1259
353670;201607;3510;11266;2988;10165;972;3702;1011;3166;1983;6868
353680;201607;701;2235;587;2037;188;726;220;741;408;1467
353690;201607;507;1361;282;921;54;188;56;151;110;339
353700;201607;1957;5958;1682;5419;272;985;825;2535;1097;3520
353710;201607;3019;7282;1496;4821;346;1130;257;833;603;1963
353715;201607;498;1438;361;1152;40;146;93;281;133;427
353720;201607;1995;6121;1686;5645;323;1279;878;2802;1201;4081
353730;201607;4339;13032;3417;11129;730;2618;1153;3475;1883;6093
353740;201607;1794;5335;1376;4511;401;1413;353;1108;754;2521
353750;201607;836;2795;640;2336;139;562;149;552;288;1114
353760;201607;9873;26860;8000;24233;1162;4036;5069;15069;6231;19105
353770;201607;731;2278;453;1592;67;272;30;62;97;334
353780;201607;4081;14079;3554;12992;1150;4453;1104;4061;2254;8514
353790;201607;2122;7205;1757;6454;483;2030;407;1458;890;3488
353800;201607;15985;48508;12700;42585;3202;11792;4771;15752;7973;27544
353810;201607;1008;3207;771;2686;162;642;245;836;407;1478
353820;201607;1360;4503;1213;4153;220;893;643;2064;863;2957
353830;201607;669;1785;527;1556;90;284;281;807;371;1091
353850;201607;1678;5217;1467;4798;375;1277;581;1883;956;3160
353860;201607;2462;8137;2079;7258;567;2119;552;1896;1119;4015
353870;201607;28820;82491;19826;64736;3950;14311;6444;19324;10394;33635
353880;201607;2637;8263;2225;7533;329;1302;1201;4054;1530;5356
353890;201607;2630;6424;1829;5121;321;1010;887;2359;1208;3369
353900;201607;974;2994;716;2482;155;590;197;650;352;1240
353910;201607;1190;4139;1109;3982;275;1031;606;2212;881;3243
353920;201607;2218;6502;1543;5072;336;1222;268;786;604;2008
353930;201607;4472;13408;3139;10962;854;3254;604;2094;1458;5348
353940;201607;1170;3694;910;3095;168;640;284;897;452;1537
353950;201607;3234;10236;2859;9501;513;1911;1537;4883;2050;6794
353960;201607;608;1904;449;1551;106;391;98;313;204;704
353970;201607;540;1540;453;1404;56;189;275;851;331;1040
353980;201607;12901;38343;10967;34624;2320;7835;5405;16628;7725;24463
353990;201607;349;1086;313;1010;50;198;166;504;216;702
354000;201607;2187;6105;1427;4560;296;1031;155;487;451;1518
354010;201607;369;1110;302;990;64;217;174;577;238;794
354020;201607;4195;13180;3622;11925;973;3427;1147;3526;2120;6953
354025;201607;873;2443;643;2020;132;438;233;728;365;1166
354030;201607;468;1291;318;1017;57;200;136;416;193;616
354040;201607;768;2091;527;1626;54;184;278;797;332;981
354050;201607;927;2926;744;2546;209;786;167;555;376;1341
354060;201607;4848;14961;3387;11655;918;3345;869;2860;1787;6205
354070;201607;2755;9170;2325;8172;614;2323;476;1630;1090;3953
354075;201607;1890;6927;1732;6545;444;1870;792;2932;1236;4802
354080;201607;1529;4679;1083;3694;227;831;272;852;499;1683
354085;201607;327;824;293;774;13;51;245;636;258;687
354090;201607;1337;3933;1268;3814;133;458;872;2635;1005;3093
354100;201607;14446;47821;11839;42913;3055;11864;4984;17975;8039;29839
354105;201607;871;2581;760;2412;117;414;516;1616;633;2030
354110;201607;722;1953;559;1734;223;778;101;252;324;1030
354120;201607;1869;5129;1402;4242;258;865;605;1735;863;2600
354130;201607;6199;17747;4648;14753;1798;6037;524;1509;2322;7546
354140;201607;26021;65153;16043;47247;3364;10609;4799;13226;8163;23835
354150;201607;3826;10297;2896;8600;507;1664;1362;3899;1869;5563
354160;201607;3332;10790;2730;9395;702;2575;992;3326;1694;5901
354165;201607;479;1635;406;1482;116;455;151;564;267;1019
354170;201607;1349;4187;1084;3587;209;777;427;1298;636;2075
354180;201607;472;1421;408;1285;60;235;206;566;266;801
354190;201607;1560;4916;1298;4376;322;1210;439;1407;761;2617
354200;201607;987;2763;784;2402;99;344;356;1016;455;1360
354210;201607;608;1905;504;1707;76;313;263;824;339;1137
354220;201607;2881;8355;2440;7560;517;1754;1145;3477;1662;5231
354230;201607;607;1972;543;1842;101;394;238;784;339;1178
354240;201607;1212;3954;906;3239;178;702;197;689;375;1391
354250;201607;667;1890;441;1486;146;530;117;417;263;947
354260;201607;6842;20643;5737;18732;1612;5557;1892;6315;3504;11872
354270;201607;1132;3780;933;3322;202;785;314;1104;516;1889
354280;201607;675;2014;615;1912;86;353;414;1197;500;1550
354290;201607;899;3126;802;2909;182;712;351;1299;533;2011
354300;201607;3555;11644;3357;11256;894;3148;1694;5586;2588;8734
354310;201607;840;2550;668;2207;131;452;341;1133;472;1585
354320;201607;696;2079;576;1848;155;579;185;542;340;1121
354323;201607;450;1241;333;1025;70;242;115;313;185;555
354325;201607;1213;3985;938;3312;195;749;337;1117;532;1866
354330;201607;6501;19309;5195;16747;1090;3989;2381;7221;3471;11210
354340;201607;23945;72617;19305;64480;5443;19865;7329;23923;12772;43788
354350;201607;1020;3019;939;2868;250;857;494;1413;744;2270
354360;201607;444;1411;267;973;51;188;13;48;64;236
354370;201607;1131;3769;967;3446;116;534;558;1910;674;2444
354380;201607;821;2455;652;2147;197;774;120;342;317;1116
354390;201607;12986;37722;8882;29674;1934;7012;1788;5879;3722;12891
354400;201607;1551;5350;1257;4622;299;1177;367;1348;666;2525
354410;201607;5308;16228;4392;14476;1097;3890;1825;5950;2922;9840
354420;201607;1151;3447;847;2768;220;779;320;1026;540;1805
354425;201607;2331;6651;1960;5962;618;1983;485;1508;1103;3491
354430;201607;1326;4274;1201;4019;270;1051;490;1590;760;2641
354440;201607;525;1584;383;1259;49;176;156;491;205;667
354450;201607;404;1159;239;802;39;154;39;108;78;262
354460;201607;910;2512;642;2017;157;542;249;788;406;1330
354470;201607;559;1514;436;1267;42;159;224;594;266;753
354480;201607;721;1984;596;1783;80;276;349;1005;429;1281
354490;201607;719;2400;572;2049;81;319;252;870;333;1189
354500;201607;2131;6849;1873;6400;701;2677;384;1328;1085;4005
354510;201607;764;2130;692;2010;94;249;461;1374;555;1623
354515;201607;267;880;211;754;42;171;80;276;122;447
354520;201607;7564;24383;4306;14912;872;3466;1700;5479;2572;8945
354530;201607;3016;10297;2669;9528;672;2633;1148;4056;1820;6689
354540;201607;1184;3557;966;3167;361;1287;169;519;530;1806
354550;201607;462;1366;378;1199;82;284;169;505;251;789
354560;201607;1634;4560;1011;3163;151;486;436;1294;587;1780
354570;201607;990;2767;516;1645;85;306;81;235;166;541
354580;201607;10664;29807;7568;24096;1395;4907;2916;8795;4311;13702
354600;201607;1576;5111;1361;4689;265;1091;694;2286;959;3377
354610;201607;391;1120;231;738;29;95;71;210;100;305
354620;201607;384;1222;302;1080;68;304;149;517;217;821
354625;201607;283;890;192;688;36;142;50;157;86;299
354630;201607;2060;6821;1819;6308;756;2790;289;947;1045;3737
354640;201607;3363;10943;2625;9297;598;2403;509;1651;1107;4054
354650;201607;860;2534;744;2309;90;315;488;1514;578;1829
354660;201607;2353;6595;1743;5527;218;810;1009;3144;1227;3954
354670;201607;1272;4005;977;3286;274;1023;222;664;496;1687
354680;201607;4353;14129;3942;13326;1042;3766;1750;5878;2792;9644
354690;201607;755;2408;503;1784;93;349;127;436;220;785
354700;201607;1143;3208;793;2460;155;567;327;871;482;1438
354710;201607;516;1540;405;1295;48;182;168;474;216;656
354720;201607;242;648;138;438;41;130;21;60;62;190
354730;201607;8295;26274;6240;22141;1381;5372;2664;9165;4045;14537
354740;201607;248;760;146;521;21;91;20;69;41;160
354750;201607;2310;7041;1795;6066;464;1765;659;2113;1123;3878
354760;201607;1893;5979;1545;5236;513;1859;236;789;749;2648
354765;201607;288;802;143;478;20;72;19;57;39;129
354770;201607;2307;6379;1750;5423;602;1994;510;1531;1112;3525
354780;201607;51305;142401;43134;125606;6924;22896;24057;66448;30981;89344
354790;201607;788;2580;707;2410;131;478;369;1222;500;1700
354800;201607;2099;6110;1839;5760;398;1419;950;2897;1348;4316
354805;201607;996;2975;723;2378;91;338;170;494;261;832
354810;201607;578;1859;352;1299;66;297;57;173;123;470
354820;201607;952;3235;806;2911;194;801;210;702;404;1503
354830;201607;404;1118;313;955;87;290;126;353;213;643
354840;201607;656;1877;514;1607;106;354;247;756;353;1110
354850;201607;16489;50117;12165;41417;2610;9976;5089;16106;7699;26082
354860;201607;1350;4206;1150;3865;257;999;445;1399;702;2398
354870;201607;44808;131111;39486;120206;8739;28921;18242;54383;26981;83304
354880;201607;4269;11727;2390;7733;382;1471;735;1990;1117;3461
354890;201607;16062;46288;13310;41368;2931;9939;5551;16800;8482;26739
354900;201607;435;1339;331;1110;61;216;84;268;145;484
354910;201607;6284;18714;3682;13061;709;2822;199;683;908;3505
354920;201607;403;1178;268;917;56;214;65;217;121;431
354925;201607;313;933;191;656;34;132;27;84;61;216
354930;201607;311;772;173;537;27;89;72;215;99;304
354940;201607;1867;6616;1545;5767;548;2212;181;644;729;2856
354950;201607;1448;4572;1236;4220;173;744;692;2289;865;3033
354960;201607;757;2348;660;2192;139;528;298;969;437;1497
354970;201607;3826;12406;3323;11389;596;2366;1802;5967;2398;8333
354980;201607;33241;82686;20340;61328;3587;12266;7068;19879;10655;32145
354990;201607;51767;149574;40751;128079;7125;24543;20283;61922;27408;86465
354995;201607;1700;5149;1425;4698;356;1244;734;2415;1090;3659
355000;201607;1402;4461;1236;4149;363;1441;261;758;624;2199
355010;201607;3511;10745;2701;8895;793;2778;845;2835;1638;5613
355020;201607;2874;9457;2196;8055;837;3362;516;1825;1353;5187
355030;201607;1100062;2983733;920582;2637887;201158;631496;414867;1146707;616025;1778203
355040;201607;2523;7680;2223;7155;455;1600;1299;4123;1754;5723
355050;201607;1117;3371;885;2924;307;1042;155;504;462;1546
355060;201607;4304;14192;3479;12472;820;3336;1071;3513;1891;6849
355070;201607;6406;19741;5626;18434;1219;4551;2781;8605;4000;13156
355080;201607;955;3258;677;2612;144;646;44;152;188;798
355090;201607;1096;3698;919;3313;175;678;362;1298;537;1976
355100;201607;17630;54165;14622;49150;3859;14312;6845;22518;10704;36830
355110;201607;1181;3800;1006;3473;318;1200;226;757;544;1957
355120;201607;626;1967;516;1752;113;454;197;647;310;1101
355130;201607;625;1584;296;875;48;147;95;257;143;404
355140;201607;1116;3680;1059;3578;217;819;600;2077;817;2896
355150;201607;3423;9823;2852;8904;591;1955;1459;4594;2050;6549
355160;201607;1655;5130;1370;4658;410;1536;382;1289;792;2825
355170;201607;8349;23299;6343;19976;2057;6878;1684;5526;3741;12404
355180;201607;2828;8718;2300;7755;591;2355;754;2335;1345;4690
355190;201607;1385;4361;1184;3966;367;1384;376;1336;743;2720
355200;201607;756;2662;689;2517;289;1151;166;563;455;1714
355210;201607;2672;8377;2339;7692;378;1462;1341;4236;1719;5698
355220;201607;33883;101868;27649;89353;9143;31295;7290;22452;16433;53747
355230;201607;1379;3748;772;2431;157;506;184;511;341;1017
355240;201607;25130;71564;17399;55731;3848;13064;5607;17684;9455;30748
355250;201607;27644;86526;23266;78070;6443;23252;8790;29110;15233;52362
355255;201607;871;2401;543;1730;109;378;152;459;261;837
355260;201607;1227;3566;1040;3243;247;889;442;1258;689;2147
355270;201607;1572;4607;1419;4331;150;496;1009;3020;1159;3516
355280;201607;25668;74205;20477;64162;3984;13955;9077;27277;13061;41232
355290;201607;921;2899;733;2447;156;557;239;735;395;1292
355300;201607;1209;3893;1010;3482;220;821;343;1151;563;1972
355310;201607;1018;3062;836;2711;143;525;429;1382;572;1907
355320;201607;581;1760;496;1583;102;394;199;550;301;944
355330;201607;1885;5752;1368;4722;296;1121;567;1914;863;3035
355340;201607;2506;6473;2236;6036;349;971;1406;3750;1755;4721
355350;201607;1314;4397;1052;3807;272;1072;297;1049;569;2121
355360;201607;1139;3594;1006;3321;162;552;646;2208;808;2760
355365;201607;315;918;210;740;61;230;47;161;108;391
355370;201607;7588;18576;5529;16020;1458;4535;2308;7161;3766;11696
355380;201607;3226;9604;2526;8078;577;2040;583;1630;1160;3670
355385;201607;881;2818;799;2653;244;896;265;814;509;1710
355390;201607;840;2412;626;1972;122;427;242;669;364;1096
355395;201607;1876;5635;1352;4416;192;634;582;1794;774;2428
355400;201607;8835;28925;7631;26412;2319;8711;2254;7586;4573;16297
355410;201607;16754;53791;13348;46948;4171;16049;2719;9816;6890;25865
355420;201607;719;2531;655;2402;198;830;184;663;382;1493
355430;201607;3459;9611;2846;8560;539;1742;1437;4233;1976;5975
355440;201607;919;2800;672;2251;135;473;187;580;322;1053
355450;201607;3748;10701;2166;7168;411;1445;651;2016;1062;3461
355460;201607;595;1607;394;1243;81;306;118;306;199;612
355465;201607;340;1095;287;990;61;227;74;255;135;482
355470;201607;787;2369;622;2071;151;552;269;855;420;1407
355475;201607;160;540;151;514;37;134;74;236;111;370
355480;201607;2803;9659;2543;9138;591;2309;1238;4393;1829;6702
355490;201607;986;2807;633;2055;106;358;172;534;278;892
355495;201607;718;2391;630;2201;143;559;190;636;333;1195
355500;201607;7374;21286;4892;15937;921;3296;870;2680;1791;5976
355510;201607;1973;5289;1114;3558;179;676;324;929;503;1605
355520;201607;427;990;215;586;33;110;95;219;128;329
355530;201607;431;1027;177;546;26;90;36;94;62;184
355535;201607;666;2039;532;1788;154;592;139;399;293;991
355540;201607;8083;25281;7608;24526;1852;6409;4153;13094;6005;19503
355550;201607;714;2167;599;1964;116;441;266;860;382;1301
355560;201607;1226;3654;782;2658;169;651;71;189;240;840
355570;201607;188;590;124;444;23;90;11;35;34;125
355580;201607;1246;3475;852;2668;162;572;320;1002;482;1574
355590;201607;225;588;178;506;24;79;97;267;121;346
355600;201607;1149;3478;950;3070;306;1073;296;914;602;1987
355610;201607;1593;4392;1219;3685;212;693;562;1654;774;2347
355620;201607;4025;12489;3236;10735;559;2170;1486;4580;2045;6750
355630;201607;3248;9214;2063;6844;412;1460;567;1904;979;3364
355635;201607;905;2966;782;2764;80;327;542;1945;622;2272
355640;201607;2957;9355;2167;7757;435;1746;290;1026;725;2772
355645;201607;3442;11527;3060;10922;493;2021;1828;6491;2321;8512
355650;201607;7354;21791;6289;19813;1110;4133;3762;11060;4872;15193
355660;201607;1240;3901;991;3395;192;792;423;1362;615;2154
355670;201607;2840;8659;2027;6827;368;1413;831;2502;1199;3915
355680;201607;1677;5496;1233;4424;353;1363;200;708;553;2071
355690;201607;460;1428;346;1228;189;712;28;79;217;791
355695;201607;279;876;160;554;10;37;8;16;18;53
355700;201607;5317;17419;4523;15632;1148;4144;1783;6064;2931;10208
355710;201607;10090;25043;6010;17576;1355;4251;1567;4434;2922;8685
355715;201607;306;910;201;674;56;206;30;88;86;294
355720;201607;1527;5033;1250;4395;314;1203;398;1273;712;2476
355730;201607;822;2677;691;2375;223;779;182;617;405;1396
410010;201607;1364;4215;1167;3786;282;1008;242;779;524;1787
410020;201607;1140;3685;976;3305;253;903;388;1291;641;2194
410030;201607;1113;3762;915;3275;250;961;172;620;422;1581
410040;201607;9604;31205;8342;28782;2154;8292;2588;8932;4742;17224
410045;201607;1020;2872;721;2300;177;603;172;518;349;1121
410050;201607;2531;6943;1602;5130;447;1534;119;303;566;1837
410060;201607;2280;6869;1977;6272;392;1298;891;2887;1283;4185
410070;201607;1717;4833;1304;4018;399;1347;308;926;707;2273
410080;201607;1373;3884;1067;3318;196;702;459;1334;655;2036
410090;201607;985;3047;908;2887;202;708;376;1233;578;1941
410100;201607;2668;8132;2010;6577;452;1678;238;725;690;2403
410105;201607;371;1160;246;850;46;191;33;103;79;294
410110;201607;2790;8073;2225;6989;364;1260;718;2255;1082;3515
410115;201607;519;1403;402;1194;68;227;134;351;202;578
410120;201607;2434;8367;2265;8052;794;3002;753;2711;1547;5713
410130;201607;1047;3272;977;3096;386;1293;263;785;649;2078
410140;201607;17118;44457;11332;34152;2452;8090;2890;8498;5342;16588
410150;201607;16060;40548;8455;25264;1679;5433;1359;3770;3038;9203
410160;201607;3025;9263;2715;8720;714;2614;961;3123;1675;5737
410165;201607;677;1983;540;1657;113;373;241;690;354;1063
410170;201607;2276;6518;1717;5282;491;1657;263;791;754;2448
410180;201607;10993;34489;9409;30993;2138;7685;3947;12205;6085;19890
410185;201607;542;1506;400;1228;91;288;85;236;176;524
410190;201607;2063;6054;1629;5081;352;1214;283;820;635;2034
410200;201607;3804;10602;2775;8597;621;2203;390;1155;1011;3358
410210;201607;2637;7719;1921;6153;357;1342;421;1122;778;2464
410220;201607;655;1799;477;1471;82;299;150;463;232;762
410230;201607;1394;4376;1196;3975;273;1020;471;1556;744;2576
410240;201607;4323;13010;3898;12131;1321;4722;683;2036;2004;6758
410250;201607;2651;7287;1841;5617;449;1501;343;1023;792;2524
410260;201607;1559;4538;1267;4037;284;992;542;1743;826;2735
410270;201607;557;1551;425;1283;65;228;189;550;254;778
410275;201607;851;2540;560;1876;83;295;250;843;333;1138
410280;201607;2240;6432;1652;5258;362;1310;469;1408;831;2718
410290;201607;3385;10043;2817;8950;602;2000;1176;3830;1778;5830
410300;201607;716;2000;595;1752;96;322;270;714;366;1036
410302;201607;409;1109;265;847;32;113;133;435;165;548
410304;201607;1225;3861;1102;3601;282;971;451;1507;733;2478
410305;201607;1862;5068;1512;4468;262;848;847;2509;1109;3357
410310;201607;2279;7229;2025;6781;471;1745;750;2545;1221;4290
410315;201607;661;1895;414;1400;77;291;126;401;203;692
410320;201607;1201;3651;765;2625;125;491;69;216;194;707
410322;201607;529;1536;330;1097;53;174;87;286;140;460
410330;201607;1373;3768;1104;3241;247;761;295;859;542;1620
410335;201607;942;2781;810;2526;137;485;328;953;465;1438
410337;201607;806;2130;589;1731;85;298;195;526;280;824
410340;201607;524;1527;359;1102;47;160;142;387;189;547
410345;201607;1840;5362;1287;4150;317;1071;331;1060;648;2131
410347;201607;717;1926;504;1508;63;226;155;439;218;665
410350;201607;1044;3118;763;2552;155;589;166;499;321;1088
410360;201607;3761;10242;2948;8781;399;1362;1483;4291;1882;5653
410370;201607;11941;34796;8752;27315;1621;5672;2516;6959;4137;12631
410380;201607;1316;3823;1189;3561;148;549;600;1747;748;2296
410390;201607;2481;7382;1993;6342;626;2163;465;1329;1091;3492
410395;201607;861;2839;762;2627;197;753;342;1184;539;1937
410400;201607;4487;13731;3729;12190;787;2850;1387;4389;2174;7239
410405;201607;857;2476;692;2173;168;594;239;734;407;1328
410410;201607;1264;3892;1218;3827;332;1265;572;1697;904;2962
410420;201607;6879;22140;5626;19311;1516;5746;774;2340;2290;8086
410425;201607;2726;8598;1932;6807;397;1517;209;697;606;2214
410430;201607;14255;38144;10242;30713;2075;6893;2860;8252;4935;15145
410440;201607;2734;8691;2427;8093;634;2326;985;3219;1619;5545
410442;201607;2665;8829;2334;8086;703;2553;705;2474;1408;5027
410445;201607;2317;7572;1992;6979;543;2143;646;2361;1189;4504
410450;201607;2071;5862;1608;4949;467;1550;197;502;664;2052
410460;201607;1855;5430;1441;4622;394;1312;292;909;686;2221
410465;201607;2074;6775;1740;6043;395;1477;628;2096;1023;3573
410470;201607;1717;5506;1384;4750;311;1238;307;1053;618;2291
410480;201607;30268;84840;18976;61041;3673;12877;1949;5477;5622;18354
410490;201607;10982;33751;8458;28444;2023;7661;2371;7411;4394;15072
410500;201607;1543;4836;1236;4131;443;1644;243;769;686;2413
410510;201607;2481;6511;1730;5037;338;1027;603;1631;941;2658
410520;201607;3086;10578;2890;10183;853;3170;1258;4499;2111;7669
410530;201607;1569;4286;1095;3295;221;733;272;759;493;1492
410540;201607;3088;9082;2168;7115;455;1589;647;2115;1102;3704
410550;201607;6093;17623;4249;13598;875;3113;564;1679;1439;4792
410560;201607;1248;3673;959;3086;250;918;261;748;511;1666
410570;201607;2616;8211;2329;7721;619;2194;715;2653;1334;4847
410580;201607;21538;64499;17568;56631;4388;15795;5254;16014;9642;31809
410590;201607;1366;4206;858;2853;150;543;178;515;328;1058
410600;201607;1835;5311;1457;4568;376;1177;527;1679;903;2856
410610;201607;769;2154;604;1833;78;247;223;668;301;915
410620;201607;1704;5741;1257;4637;324;1275;126;468;450;1743
410630;201607;2463;7244;1713;5564;405;1453;224;608;629;2061
410640;201607;4555;12462;3358;10181;908;3201;542;1564;1450;4765
410645;201607;1118;3858;1041;3730;493;1829;238;916;731;2745
410650;201607;2105;6481;1688;5598;572;2026;265;817;837;2843
410655;201607;849;2384;624;1938;97;369;213;604;310;973
410657;201607;752;2101;537;1657;129;461;170;456;299;917
410660;201607;2933;8294;1622;5351;362;1276;184;563;546;1839
410670;201607;942;2574;626;1902;122;380;187;541;309;921
410680;201607;2900;9391;2347;8044;754;2555;626;2328;1380;4883
410685;201607;642;1835;549;1674;88;307;306;902;394;1209
410690;201607;115454;329800;80572;256878;17184;60890;19081;54182;36265;115072
410700;201607;2213;6623;2008;6229;518;1724;857;2551;1375;4275
410710;201607;901;2632;616;2010;152;518;139;400;291;918
410712;201607;815;2437;704;2223;256;885;184;589;440;1474
410715;201607;905;2864;668;2294;149;547;183;594;332;1141
410720;201607;3247;9515;2396;7732;512;1888;481;1408;993;3296
410725;201607;1079;3024;754;2399;121;403;125;372;246;775
410730;201607;521;1458;415;1279;115;387;95;311;210;698
410740;201607;896;2635;644;2127;109;414;274;896;383;1310
410750;201607;1819;5276;1488;4576;325;1103;474;1381;799;2484
410752;201607;312;857;162;529;33;122;45;125;78;247
410753;201607;418;1213;263;853;43;156;78;233;121;389
410754;201607;1118;3226;940;2925;78;248;606;2032;684;2280
410755;201607;805;1977;606;1665;74;256;355;909;429;1165
410760;201607;2427;7286;2091;6676;578;2037;634;2014;1212;4051
410765;201607;15072;44941;11382;37658;2117;7995;894;2917;3011;10912
410770;201607;908;2495;643;1957;165;546;127;381;292;927
410773;201607;1329;3771;1162;3513;172;601;799;2352;971;2953
410775;201607;1409;4040;1291;3871;296;1022;506;1498;802;2520
410780;201607;542;1467;369;1131;92;274;108;377;200;651
410785;201607;744;2351;624;2079;176;638;177;586;353;1224
410790;201607;427;1381;368;1224;112;394;32;80;144;474
410800;201607;2831;7068;2212;6021;389;1242;819;2108;1208;3350
410810;201607;336;1037;283;927;48;177;106;341;154;518
410820;201607;827;2476;617;2002;170;572;100;316;270;888
410830;201607;30046;85062;23957;74453;6632;22890;8037;24309;14669;47199
410832;201607;1015;2938;874;2667;111;422;493;1427;604;1849
410840;201607;6444;18674;4193;13847;987;3496;336;965;1323;4461
410845;201607;1237;3628;1045;3242;218;742;411;1258;629;2000
410850;201607;2715;8015;2411;7508;575;2000;952;3037;1527;5037
410855;201607;591;1636;426;1287;82;280;155;438;237;718
410860;201607;3610;10336;2891;8845;590;1962;916;2723;1506;4685
410865;201607;1478;4942;1404;4803;365;1319;787;2785;1152;4104
410870;201607;1232;3697;1140;3554;158;538;785;2470;943;3008
410880;201607;3749;11784;3111;10443;702;2660;544;1798;1246;4458
410890;201607;898;2910;703;2497;187;746;77;251;264;997
410895;201607;1074;3688;955;3420;373;1445;208;716;581;2161
410900;201607;939;2548;614;1914;102;349;184;531;286;880
410910;201607;410;1073;309;894;36;122;161;449;197;571
410920;201607;827;2293;657;2011;174;604;225;689;399;1293
410930;201607;1621;4772;1338;4200;358;1311;387;1189;745;2500
410940;201607;20766;66012;17530;59957;5515;20526;3902;13665;9417;34191
410950;201607;1773;5724;1629;5467;174;641;1230;4128;1404;4769
410960;201607;7379;20232;4616;14995;1419;5095;958;3035;2377;8130
410965;201607;1045;3138;853;2753;232;780;320;1013;552;1793
410970;201607;4493;13180;3507;11243;1007;3728;570;1788;1577;5516
410975;201607;1608;4546;1266;3889;230;820;461;1368;691;2188
410980;201607;5805;16226;3736;12094;741;2705;906;2793;1647;5498
410990;201607;907;2626;557;1856;176;654;60;164;236;818
411000;201607;493;1480;330;1104;61;234;65;178;126;412
411005;201607;481;1411;296;967;54;194;35;102;89;296
411007;201607;2302;7135;1969;6433;545;1894;572;1873;1117;3767
411010;201607;3966;13432;3556;12502;1090;4182;477;1659;1567;5841
411020;201607;2531;7701;2178;7105;723;2613;669;2128;1392;4741
411030;201607;660;1756;473;1397;78;259;127;348;205;607
411040;201607;677;1955;322;1073;60;224;66;226;126;450
411050;201607;1985;6815;1776;6350;561;2215;267;859;828;3074
411060;201607;1541;4636;1176;3818;269;1010;150;449;419;1459
411065;201607;361;1071;283;917;63;219;102;319;165;538
411070;201607;5868;17355;4635;14867;1201;4278;1127;3380;2328;7658
411080;201607;2158;6387;1912;5927;504;1729;517;1573;1021;3302
411090;201607;820;2030;564;1631;82;292;105;276;187;568
411095;201607;1503;4222;1103;3390;169;598;262;730;431;1328
411100;201607;1316;3771;933;2970;165;652;180;536;345;1188
411110;201607;597;1753;315;1071;46;182;26;72;72;254
411120;201607;1624;4895;1219;3995;310;1174;352;1055;662;2229
411125;201607;4221;13691;3990;13226;1108;3864;1561;5206;2669;9070
411130;201607;692;2054;520;1686;117;395;141;506;258;901
411140;201607;2172;7360;1851;6596;468;1749;741;2715;1209;4464
411150;201607;4110;11525;3104;9506;762;2569;423;1149;1185;3718
411155;201607;955;2602;700;2133;100;347;297;870;397;1217
411160;201607;257;727;199;617;41;138;44;135;85;273
411170;201607;711;2237;581;1932;146;533;190;609;336;1142
411180;201607;5690;16820;4599;14731;1039;3651;1538;4958;2577;8609
411190;201607;1404;4008;1167;3554;312;1056;254;702;566;1758
411200;201607;4270;12518;3400;11002;891;3257;1034;3210;1925;6467
411210;201607;1967;5573;1561;4838;380;1331;189;530;569;1861
411220;201607;1111;3101;890;2703;203;705;337;936;540;1641
411230;201607;1254;3475;810;2599;161;557;270;846;431;1403
411240;201607;1445;3498;800;2355;149;471;264;717;413;1188
411250;201607;2172;6349;1796;5663;488;1689;482;1555;970;3244
411260;201607;316;844;212;662;31;100;90;268;121;368
411270;201607;1765;5436;1547;5017;261;964;712;2232;973;3196
411275;201607;1319;3861;1064;3297;268;876;245;719;513;1595
411280;201607;1521;4415;1042;3400;205;728;203;636;408;1364
411290;201607;745;2175;562;1790;137;466;151;476;288;942
411295;201607;978;2699;872;2490;124;396;369;1087;493;1483
411300;201607;1233;3133;845;2395;95;298;298;792;393;1090
411310;201607;857;2302;666;1982;69;246;212;624;281;870
411320;201607;5368;15466;3948;12774;1053;3527;757;2329;1810;5856
411325;201607;1529;4765;1328;4337;283;976;646;2169;929;3145
411330;201607;3078;9469;2573;8470;802;2942;640;2163;1442;5105
411340;201607;939;2750;599;1948;64;250;209;656;273;906
411342;201607;729;2054;600;1785;172;560;201;553;373;1113
411345;201607;885;2726;789;2546;198;724;366;1165;564;1889
411350;201607;2733;8156;2011;6662;588;2137;232;765;820;2902
411360;201607;552;1380;363;1049;50;180;142;356;192;536
411370;201607;45374;127037;35553;108826;5748;20350;15087;43250;20835;63600
411373;201607;1492;4553;1283;4178;279;1067;333;1093;612;2160
411375;201607;1121;3055;816;2460;172;562;226;642;398;1204
411380;201607;1227;3329;712;2134;126;402;191;526;317;928
411390;201607;1790;5241;1427;4457;296;1020;367;1060;663;2080
411400;201607;2126;6003;1635;4985;340;1147;453;1327;793;2474
411410;201607;2033;6128;1585;5099;381;1368;390;1120;771;2488
411420;201607;4056;11412;2771;8710;457;1641;448;1175;905;2816
411430;201607;3210;9558;2667;8668;620;2190;1314;4232;1934;6422
411435;201607;430;1401;364;1234;87;324;143;451;230;775
411440;201607;2690;8544;2373;7890;726;2524;593;2120;1319;4644
411450;201607;2302;6975;2075;6542;438;1386;1008;3354;1446;4740
411460;201607;3261;9457;1768;6033;297;1134;118;371;415;1505
411470;201607;814;2417;549;1794;104;378;72;201;176;579
411480;201607;4492;13406;3363;11217;897;3319;485;1564;1382;4883
411490;201607;1434;4329;1210;3918;276;996;292;883;568;1879
411500;201607;1841;4859;1277;3857;274;944;367;1087;641;2031
411510;201607;2034;6047;1660;5276;459;1620;294;881;753;2501
411520;201607;26644;72150;16184;50321;2995;10188;3434;10065;6429;20253
411530;201607;1007;2787;720;2278;173;640;138;404;311;1044
411535;201607;510;1557;281;1005;33;145;20;61;53;206
411540;201607;2989;8047;2164;6351;526;1751;622;1662;1148;3413
411545;201607;982;3206;881;3008;129;463;574;2028;703;2491
411550;201607;795;2132;631;1873;202;681;121;356;323;1037
411560;201607;2354;6933;1666;5371;306;1108;158;453;464;1561
411570;201607;6857;18169;5083;15321;1257;4294;1157;3642;2414;7936
411573;201607;859;2514;800;2418;113;361;512;1571;625;1932
411575;201607;1570;4831;1318;4297;323;1110;438;1460;761;2570
411580;201607;3951;11238;2664;8649;442;1708;349;992;791;2700
411585;201607;762;2410;393;1375;90;318;62;205;152;523
411590;201607;373;1131;323;1048;46;181;139;420;185;601
411600;201607;308;877;212;720;52;210;83;283;135;493
411605;201607;1704;4674;1179;3583;186;656;435;1292;621;1948
411610;201607;2185;6120;1755;5278;370;1218;791;2329;1161;3547
411620;201607;2747;8525;2476;8086;595;2108;1233;4112;1828;6220
411630;201607;518;1357;330;1076;69;285;55;151;124;436
411640;201607;457;1377;349;1126;53;185;121;354;174;539
411650;201607;192;620;154;546;31;130;31;105;62;235
411660;201607;897;2387;669;1980;98;331;311;899;409;1230
411670;201607;1122;3113;909;2658;190;615;311;855;501;1470
411680;201607;1435;4261;1261;3949;259;888;610;1931;869;2819
411690;201607;3346;9749;2640;8440;684;2299;640;2172;1324;4471
411695;201607;786;2522;618;2150;135;503;198;709;333;1212
411700;201607;1719;4923;1200;3877;267;979;183;541;450;1520
411705;201607;1854;6380;1623;5917;399;1428;816;3189;1215;4617
411710;201607;1696;4967;1366;4291;370;1265;231;740;601;2005
411720;201607;902;2535;703;2132;104;361;200;553;304;914
411721;201607;741;2181;597;1886;168;571;79;225;247;796
411722;201607;668;2010;446;1501;100;393;100;284;200;677
411725;201607;1418;4492;885;3155;195;714;162;611;357;1325
411727;201607;1808;5260;1314;4177;357;1179;259;798;616;1977
411729;201607;600;1559;421;1222;117;362;89;218;206;580
411730;201607;5525;15738;4560;13882;1566;4905;1243;3800;2809;8705
411740;201607;642;1812;399;1276;74;269;102;298;176;567
411745;201607;910;2601;748;2272;146;474;247;748;393;1222
411750;201607;4854;14328;3685;11707;717;2465;1186;3677;1903;6142
411760;201607;7789;22640;6628;20612;2152;7139;1672;5386;3824;12525
411770;201607;3390;11021;2784;9631;847;3179;507;1692;1354;4871
411780;201607;2850;8722;2601;8306;539;1905;1478;4900;2017;6805
411790;201607;3329;9374;2320;7292;585;2051;560;1743;1145;3794
411800;201607;1158;3329;786;2518;129;450;106;293;235;743
411810;201607;1691;4812;1376;4191;310;1075;505;1416;815;2491
411820;201607;13535;43341;11320;38729;3994;14192;2755;9780;6749;23972
411830;201607;522;1347;383;1106;109;360;17;65;126;425
411840;201607;10453;29644;7740;24352;1850;6432;1477;4646;3327;11078
411845;201607;508;1554;314;1041;56;212;40;114;96;326
411850;201607;7176;21212;5849;18515;1453;5081;1614;5040;3067;10121
411860;201607;897;2717;722;2344;175;612;239;739;414;1351
411870;201607;868;2802;597;2070;127;504;115;356;242;860
411880;201607;2305;6564;1821;5719;476;1727;368;1075;844;2802
411885;201607;930;2552;775;2285;146;531;258;721;404;1252
411890;201607;1105;3373;752;2524;133;526;61;165;194;691
411900;201607;944;2943;663;2254;156;528;100;351;256;879
411910;201607;1217;3983;925;3275;278;1061;224;728;502;1789
411915;201607;16761;45461;10571;33158;2069;7019;2324;6664;4393;13683
411920;201607;855;2875;742;2603;220;892;82;241;302;1133
411925;201607;575;1648;383;1270;92;325;86;264;178;589
411930;201607;5901;19274;5166;17808;2347;8668;737;2582;3084;11250
411940;201607;3198;10609;2763;9671;770;2886;598;2028;1368;4914
411950;201607;12091;38024;10288;34483;2349;8522;4647;15456;6996;23978
411960;201607;5470;16024;5033;15217;1052;3598;2182;6453;3234;10051
411965;201607;567;1606;403;1322;79;305;113;382;192;687
411970;201607;757;2110;636;1924;188;578;279;920;467;1498
411980;201607;1662;4930;1432;4469;353;1173;427;1344;780;2517
411990;201607;30792;96825;24729;83998;6359;24022;7120;23555;13479;47577
411995;201607;2517;7601;2133;6904;657;2389;542;1664;1199;4053
412000;201607;2276;5693;1758;4827;275;943;885;2197;1160;3140
412010;201607;710;2383;572;2075;104;407;123;410;227;817
412015;201607;647;1895;523;1637;97;314;250;770;347;1084
412020;201607;366;1062;242;780;47;159;69;208;116;367
412030;201607;706;2198;502;1737;92;377;115;378;207;755
412033;201607;840;2394;565;1769;98;342;143;434;241;776
412035;201607;992;2732;644;2084;124;429;220;702;344;1131
412040;201607;584;1822;461;1552;87;310;107;356;194;666
412050;201607;1733;4947;1319;4135;224;793;308;930;532;1723
412060;201607;6847;23170;6196;21862;1929;7433;1852;6513;3781;13946
412065;201607;816;2447;631;2054;148;538;170;505;318;1043
412070;201607;1361;3649;1005;2913;161;509;372;1064;533;1573
412080;201607;1382;4242;841;2995;104;421;24;74;128;495
412085;201607;445;1272;147;505;26;94;19;55;45;149
412090;201607;4536;13825;4214;13251;800;2643;2352;7674;3152;10317
412100;201607;1927;5908;1558;5182;460;1664;376;1268;836;2932
412110;201607;1096;3083;741;2333;170;577;154;505;324;1082
412120;201607;1697;5740;1462;5206;389;1540;463;1493;852;3033
412125;201607;645;2090;586;1978;148;544;215;697;363;1241
412130;201607;601;1794;439;1425;109;380;61;182;170;562
412135;201607;482;1353;305;965;65;208;98;294;163;502
412140;201607;1590;4731;1294;4105;319;1105;244;727;563;1832
412150;201607;2886;8292;2488;7492;343;1135;1471;4330;1814;5465
412160;201607;1179;3731;743;2603;185;706;95;314;280;1020
412170;201607;4539;13853;3707;12219;984;3550;1358;4296;2342;7846
412175;201607;1435;4712;1242;4299;257;976;599;2081;856;3057
412180;201607;1656;5007;1233;4203;296;1174;371;1180;667;2354
412190;201607;3261;9158;2444;7681;512;1777;776;2605;1288;4382
412200;201607;2120;6734;1518;5181;297;1095;471;1617;768;2712
412210;201607;677;1854;387;1226;77;281;40;98;117;379
412215;201607;3615;10980;3237;10305;741;2375;1829;6044;2570;8419
412217;201607;1094;3092;965;2862;107;394;662;1864;769;2258
412220;201607;5638;18269;5348;17719;1520;5100;2526;8642;4046;13742
412230;201607;2816;9199;2433;8417;543;2164;689;2195;1232;4359
412240;201607;8814;22394;5165;15631;1013;3515;995;2740;2008;6255
412250;201607;1892;5506;1588;4888;404;1371;224;595;628;1966
412260;201607;1345;3687;879;2695;131;467;312;851;443;1318
412265;201607;990;2994;868;2785;217;794;354;1133;571;1927
412270;201607;873;2744;584;2020;115;462;186;597;301;1059
412280;201607;628;1931;468;1584;174;635;34;88;208;723
412290;201607;1025;2903;771;2431;166;584;238;694;404;1278
412300;201607;1859;5574;1563;5009;436;1543;345;1051;781;2594
412310;201607;1017;2948;877;2728;129;495;434;1376;563;1871
412320;201607;886;2350;628;1892;110;405;216;657;326;1062
412330;201607;1529;4383;1151;3602;184;650;501;1545;685;2195
412340;201607;954;2953;630;2128;99;371;100;309;199;680
412350;201607;2225;6880;1724;5776;377;1365;104;280;481;1645
412360;201607;307;904;187;606;19;76;64;180;83;256
412370;201607;953;2763;688;2277;168;615;132;448;300;1063
412380;201607;1523;4818;1257;4164;339;1201;277;911;616;2112
412382;201607;670;1869;463;1444;79;257;101;292;180;549
412385;201607;2372;7283;2106;6672;756;2463;542;1780;1298;4243
412390;201607;2125;6014;1904;5657;485;1604;802;2450;1287;4054
412395;201607;816;2289;638;1983;85;295;344;1037;429;1332
412400;201607;918;2875;778;2572;214;751;191;650;405;1401
412402;201607;1854;5475;1493;4736;359;1289;305;895;664;2184
412405;201607;3577;10322;2214;7255;382;1434;125;375;507;1809
412410;201607;4930;14886;3998;13077;1136;4343;791;2502;1927;6845
412420;201607;365;1077;247;800;44;155;76;210;120;365
412430;201607;550;1527;393;1217;57;193;137;404;194;597
412440;201607;3199;9683;2516;8426;633;2330;667;2290;1300;4620
412450;201607;271;889;203;699;34;111;18;47;52;158
412460;201607;740;2304;609;2010;166;578;123;402;289;980
412470;201607;1838;6214;1549;5461;552;2022;334;1264;886;3286
412480;201607;1171;3504;817;2634;152;533;108;265;260;798
412490;201607;899;2656;752;2366;140;474;237;727;377;1201
412500;201607;1951;5597;1602;4897;319;1098;369;998;688;2096
412510;201607;2231;7218;1816;6202;574;2138;489;1600;1063;3738
412520;201607;1528;4303;1117;3451;314;1028;183;525;497;1553
412530;201607;608;1783;465;1446;92;311;91;261;183;572
412535;201607;732;2133;491;1565;101;335;117;349;218;684
412540;201607;1202;3416;907;2804;133;492;255;770;388;1262
412545;201607;766;2195;581;1792;104;368;176;473;280;841
412550;201607;29843;89032;20762;68681;4839;17291;4502;14136;9341;31427
412555;201607;259;770;173;567;28;95;38;102;66;197
412560;201607;5246;15975;4064;13396;825;3203;1110;3514;1935;6717
412570;201607;4257;12392;2850;9371;693;2543;472;1588;1165;4131
412575;201607;863;2638;674;2175;136;493;220;667;356;1160
412580;201607;1219;3352;866;2666;158;531;298;858;456;1389
412590;201607;436;1269;276;911;55;192;65;207;120;399
412600;201607;1412;4271;1066;3496;236;859;268;824;504;1683
412610;201607;731;2169;463;1481;120;414;124;371;244;785
412620;201607;1224;3824;948;3252;257;1015;145;428;402;1443
412625;201607;9679;27721;7249;22897;1634;5643;858;2566;2492;8209
412627;201607;947;2914;666;2257;218;817;86;287;304;1104
412630;201607;3271;10242;2584;8712;543;1912;715;2315;1258;4227
412635;201607;471;1373;323;1046;76;261;21;41;97;302
412640;201607;891;2660;586;1945;108;387;50;153;158;540
412650;201607;1717;5102;1433;4558;317;1154;416;1230;733;2384
412660;201607;2727;7827;2141;6635;463;1614;449;1268;912;2882
412665;201607;633;1642;353;1091;90;287;78;234;168;521
412667;201607;1668;4780;1302;4044;290;972;333;990;623;1962
412670;201607;551;1688;426;1430;109;409;73;227;182;636
412680;201607;1345;4023;840;2886;143;553;176;535;319;1088
412690;201607;782;2337;595;1925;169;584;114;372;283;956
412700;201607;1837;5555;1541;5106;521;1958;413;1339;934;3297
412710;201607;6874;21593;5783;19341;1332;4955;1352;4275;2684;9230
412720;201607;1372;4219;966;3211;185;685;166;445;351;1130
412730;201607;2131;6332;1273;4360;292;1077;145;453;437;1530
412740;201607;1432;4534;1071;3706;276;1070;146;553;422;1623
412750;201607;4028;12141;3592;11416;453;1740;2262;7102;2715;8842
412760;201607;2393;7557;2239;7277;374;1402;1366;4320;1740;5722
412770;201607;11120;30482;6350;20350;968;3405;1076;3069;2044;6474
412780;201607;1287;3926;1101;3555;242;876;392;1195;634;2071
412785;201607;2336;6540;1754;5366;433;1350;815;2574;1248;3924
412788;201607;1386;4413;1189;3997;319;1230;329;1009;648;2239
412790;201607;1124;3347;829;2707;199;729;165;452;364;1181
412795;201607;974;2674;734;2214;153;483;274;829;427;1312
412796;201607;2707;8262;2471;7814;561;1988;994;2996;1555;4984
412800;201607;3013;8612;2343;7172;396;1355;835;2456;1231;3811
412810;201607;11240;30485;6614;20607;960;3444;1471;3857;2431;7301
412820;201607;7326;21276;5397;17498;1266;4417;1329;4375;2595;8792
412830;201607;347;1073;273;893;43;161;66;186;109;347
412840;201607;1843;5231;1475;4480;291;973;320;966;611;1939
412850;201607;2754;8052;2222;7106;470;1736;700;2100;1170;3836
412853;201607;1721;4931;1523;4534;173;608;806;2236;979;2844
412855;201607;1478;4245;1137;3476;249;839;268;704;517;1543
412860;201607;1191;3391;969;2985;247;862;382;1138;629;2000
412862;201607;762;1956;508;1499;87;280;136;404;223;684
412863;201607;1177;3979;1143;3916;165;631;813;2735;978;3366
412865;201607;712;2163;529;1753;110;376;179;629;289;1005
412870;201607;924;2608;729;2283;270;956;142;429;412;1385
412880;201607;877;2538;680;2144;170;608;76;198;246;806
420005;201607;535;1588;327;1116;63;229;106;352;169;581
420010;201607;3191;8917;2541;8001;343;1142;1735;5590;2078;6732
420020;201607;756;2440;426;1567;57;240;47;167;104;407
420030;201607;505;1314;258;851;56;228;31;101;87;329
420040;201607;721;2288;442;1667;113;470;33;109;146;579
420050;201607;697;2009;462;1528;115;416;183;614;298;1030
420055;201607;205;624;116;408;21;79;19;66;40;145
420060;201607;242;783;163;591;26;120;30;84;56;204
420070;201607;1353;4268;1026;3470;179;682;405;1369;584;2051
420075;201607;173;462;89;272;21;69;13;32;34;101
420080;201607;595;1864;479;1637;139;507;146;503;285;1010
420090;201607;485;1594;329;1246;88;347;62;244;150;591
420100;201607;1201;3725;1071;3544;231;803;632;2111;863;2914
420110;201607;327;1103;296;1030;78;287;113;395;191;682
420120;201607;274;934;219;810;66;283;46;152;112;435
420125;201607;272;993;242;925;69;283;106;386;175;669
420127;201607;546;1588;207;752;52;204;21;72;73;276
420130;201607;1888;6332;1519;5568;397;1619;328;1105;725;2724
420140;201607;4530;13257;3204;10680;804;2995;478;1474;1282;4469
420150;201607;744;2088;457;1529;85;313;171;545;256;858
420160;201607;272;748;164;538;30;98;51;168;81;266
420165;201607;220;692;132;460;31;124;31;103;62;227
420170;201607;206;646;143;523;56;237;17;54;73;291
420180;201607;406;1227;217;779;38;144;47;160;85;304
420190;201607;461;1303;232;785;41;155;17;53;58;208
420195;201607;1361;3952;1100;3527;285;996;304;949;589;1945
420200;201607;2609;8119;1550;5682;335;1426;211;732;546;2158
420205;201607;1016;3308;848;2999;199;767;449;1617;648;2384
420207;201607;1556;4494;1078;3528;299;1114;225;708;524;1822
420208;201607;576;1577;312;1111;101;389;69;274;170;663
420209;201607;320;979;206;708;34;136;83;274;117;410
420210;201607;1777;5358;1165;4346;302;1319;383;1381;685;2700
420213;201607;781;2797;732;2684;157;631;422;1555;579;2186
420215;201607;322;1034;216;772;63;235;18;73;81;308
420220;201607;164;584;133;515;35;157;39;146;74;303
420230;201607;4255;12253;3122;10251;629;2466;1225;3880;1854;6346
420240;201607;10938;30390;6922;22780;1195;4708;2847;8534;4042;13242
420243;201607;600;1814;474;1564;101;359;178;589;279;948
420245;201607;1181;3544;815;2765;144;570;275;845;419;1415
420250;201607;525;1672;470;1565;123;478;202;646;325;1124
420253;201607;500;1305;376;1138;44;132;230;722;274;854
420257;201607;305;842;190;627;34;116;97;322;131;438
420260;201607;1204;3770;979;3356;225;854;398;1366;623;2220
420270;201607;609;1827;202;706;36;147;46;130;82;277
420280;201607;2193;5983;1343;4438;288;1072;453;1432;741;2504
420285;201607;147;433;68;260;10;43;1;6;11;49
420287;201607;530;1570;436;1423;139;474;141;470;280;944
420290;201607;6247;18495;4173;13745;828;2916;1215;3756;2043;6672
420300;201607;6823;20290;4307;14841;952;3641;728;2419;1680;6060
420310;201607;793;2125;683;1948;94;301;498;1384;592;1685
420315;201607;966;3043;750;2611;238;883;237;816;475;1699
420320;201607;4818;14737;3923;13143;1150;4256;1425;4795;2575;9051
420325;201607;238;795;209;728;48;178;79;267;127;445
420330;201607;989;3384;718;2711;158;660;191;674;349;1334
420340;201607;1440;4419;1085;3621;229;860;122;361;351;1221
420350;201607;1469;4343;1059;3535;289;1048;377;1235;666;2283
420360;201607;3080;9336;1915;6796;438;1764;182;596;620;2360
420370;201607;1845;5235;1435;4529;166;593;1019;3162;1185;3755
420380;201607;5112;15500;3402;11606;814;3013;839;2792;1653;5805
420390;201607;1438;4016;754;2557;139;541;125;348;264;889
420395;201607;1400;4290;957;3278;156;625;121;364;277;989
420400;201607;1271;3672;881;2911;221;835;193;578;414;1413
420410;201607;760;2015;526;1628;90;319;323;993;413;1312
420415;201607;467;1454;338;1148;96;343;103;350;199;693
420417;201607;724;2308;590;1977;109;381;282;946;391;1327
420419;201607;370;1111;238;842;86;336;18;72;104;408
420420;201607;10765;32262;8551;27990;2914;10505;2160;6778;5074;17283
420425;201607;1223;3287;832;2551;90;350;354;1019;444;1369
420430;201607;3357;10124;2136;7254;461;1677;664;2317;1125;3994
420435;201607;295;865;178;604;39;150;74;238;113;388
420440;201607;908;2802;512;1777;203;757;108;360;311;1117
420445;201607;372;1091;251;799;59;203;83;255;142;458
420450;201607;824;2484;551;1885;122;451;113;370;235;821
420455;201607;1953;5766;1659;5266;309;1237;793;2398;1102;3635
420460;201607;8813;25509;6614;21592;1497;5635;2497;7771;3994;13406
420470;201607;1107;2919;643;2029;140;498;191;561;331;1059
420475;201607;121;349;61;208;18;60;5;17;23;77
420480;201607;4971;14232;3597;11687;1055;3756;796;2591;1851;6347
420490;201607;652;1696;352;1187;89;339;82;289;171;628
420500;201607;1543;4853;1159;4087;375;1496;385;1363;760;2859
420510;201607;93;350;82;334;18;88;45;177;63;265
420515;201607;105;349;83;305;15;65;17;61;32;126
420517;201607;837;2582;741;2411;124;453;437;1385;561;1838
420519;201607;550;1430;391;1157;61;210;115;308;176;518
420520;201607;644;1620;377;1212;81;292;101;269;182;561
420530;201607;1042;3427;764;2801;180;760;179;599;359;1359
420535;201607;258;742;129;463;35;128;9;40;44;168
420540;201607;21651;60958;15246;47517;3600;12441;4003;10852;7603;23293
420543;201607;393;1027;306;887;52;123;193;597;245;720
420545;201607;1539;4790;1224;4108;302;1144;378;1200;680;2344
420550;201607;4154;12989;3017;10668;841;3499;554;1863;1395;5362
420555;201607;354;1067;262;874;67;246;80;250;147;496
420560;201607;538;1543;396;1290;67;234;199;643;266;877
420570;201607;2168;6835;1647;5648;411;1620;538;1706;949;3326
420580;201607;1490;4514;1177;3976;271;1069;492;1626;763;2695
420590;201607;3248;9701;2126;7119;443;1638;350;1054;793;2692
420600;201607;919;2973;830;2787;132;466;493;1710;625;2176
420610;201607;521;1578;277;1019;70;303;63;231;133;534
420620;201607;568;1752;504;1621;133;456;151;496;284;952
420630;201607;1007;3091;717;2412;164;589;255;816;419;1405
420640;201607;801;2398;385;1413;96;393;34;124;130;517
420650;201607;2528;7362;1589;5414;270;1019;387;1246;657;2265
420660;201607;475;1372;336;1082;62;226;109;342;171;568
420665;201607;696;1949;452;1483;76;288;134;397;210;685
420670;201607;1690;4948;1168;3852;237;930;283;857;520;1787
420675;201607;208;667;150;529;24;91;47;159;71;250
420680;201607;515;1212;296;874;55;180;101;284;156;464
420690;201607;863;2944;627;2296;109;427;101;323;210;750
420700;201607;3217;9401;2467;7910;509;1828;802;2448;1311;4276
420710;201607;591;1974;450;1665;127;527;146;526;273;1053
420720;201607;1728;4863;1316;4317;360;1277;647;2117;1007;3394
420730;201607;3299;9789;2657;8668;645;2317;1096;3486;1741;5803
420740;201607;827;2546;674;2256;220;803;262;832;482;1635
420750;201607;2373;7506;1717;5984;291;1171;524;1681;815;2852
420757;201607;104;245;44;152;9;37;20;70;29;107
420760;201607;365;1127;201;672;50;184;31;81;81;265
420765;201607;588;1849;307;1134;72;297;56;195;128;492
420768;201607;1180;4070;922;3528;355;1385;329;1327;684;2712
420770;201607;638;1854;347;1274;80;341;68;257;148;598
420775;201607;643;1904;367;1228;84;312;63;186;147;498
420780;201607;1518;4570;905;3083;188;675;139;447;327;1122
420785;201607;280;852;203;663;41;147;49;148;90;295
420790;201607;1271;4316;994;3685;279;1137;371;1311;650;2448
420800;201607;871;2465;420;1417;99;354;95;321;194;675
420810;201607;2037;6854;1606;5905;519;2150;366;1277;885;3427
420820;201607;8286;24606;5730;20217;1498;5909;1460;5121;2958;11030
420830;201607;2663;8322;2177;7411;655;2442;764;2579;1419;5021
420840;201607;997;2935;486;1742;97;399;88;294;185;693
420845;201607;1346;3993;945;3298;263;1054;218;751;481;1805
420850;201607;1629;5060;982;3666;238;998;75;277;313;1275
420860;201607;449;1252;271;917;77;295;75;254;152;549
420870;201607;1139;3161;885;2757;302;1105;239;658;541;1763
420880;201607;1009;3347;768;2725;184;710;136;451;320;1161
420890;201607;10311;27157;5167;16895;899;3221;1195;3450;2094;6671
420895;201607;245;673;127;419;36;115;15;49;51;164
420900;201607;1858;5223;1180;3910;254;985;295;892;549;1877
420910;201607;24422;71848;16431;55881;3230;12429;4926;15750;8156;28179
420915;201607;553;2178;405;1736;94;430;169;691;263;1121
420917;201607;478;1470;214;718;41;157;77;227;118;384
420920;201607;180;497;69;239;12;48;10;40;22;88
420930;201607;18096;51686;13961;44600;3133;11184;5386;16759;8519;27943
420940;201607;2861;8544;2163;7121;630;2321;200;576;830;2897
420945;201607;199;606;129;446;26;110;34;101;60;211
420950;201607;640;1771;290;1056;47;224;46;154;93;378
420960;201607;941;2659;738;2298;144;491;302;901;446;1392
420970;201607;2527;7890;2078;7068;682;2590;560;1891;1242;4481
420980;201607;464;1346;341;1144;110;400;133;492;243;892
420985;201607;499;1419;231;829;48;206;52;164;100;370
420990;201607;897;2422;491;1661;94;366;92;254;186;620
421000;201607;566;1898;364;1383;75;303;59;204;134;507
421003;201607;731;1962;264;884;41;158;35;77;76;235
421005;201607;154;473;116;408;30;116;59;213;89;329
421010;201607;5300;14950;3627;11951;920;3409;786;2398;1706;5807
421020;201607;487;1477;371;1283;44;159;203;717;247;876
421030;201607;736;2670;658;2462;216;888;111;402;327;1290
421040;201607;904;2281;572;1763;99;355;283;840;382;1195
421050;201607;1660;4707;973;3244;215;799;203;586;418;1385
421055;201607;193;550;98;314;27;87;17;40;44;127
421060;201607;503;1693;331;1219;83;331;109;397;192;728
421070;201607;699;2224;432;1543;96;368;66;222;162;590
421080;201607;530;1607;448;1482;96;311;290;973;386;1284
421085;201607;556;1457;291;966;61;232;75;237;136;469
421090;201607;425;1178;201;669;31;130;61;177;92;307
421100;201607;949;2562;496;1586;136;451;52;155;188;606
421105;201607;1488;4486;1197;3981;278;993;405;1424;683;2417
421110;201607;986;3526;894;3312;356;1392;201;695;557;2087
421120;201607;1347;4324;902;3215;144;616;221;703;365;1319
421125;201607;407;1124;300;937;77;280;102;290;179;570
421130;201607;3281;10704;2777;9727;931;3553;916;3287;1847;6840
421140;201607;354;1024;260;834;46;152;101;307;147;459
421145;201607;561;1767;344;1182;54;180;98;339;152;519
421150;201607;600;1731;428;1439;91;355;176;571;267;926
421160;201607;1228;3356;592;1927;131;476;186;566;317;1042
421165;201607;281;952;220;779;31;106;89;323;120;429
421170;201607;1327;3819;1061;3410;194;679;626;2016;820;2695
421175;201607;1244;3479;869;2841;190;760;287;850;477;1610
421180;201607;578;1594;299;1004;61;233;57;180;118;413
421185;201607;404;1123;284;890;48;139;137;458;185;597
421187;201607;287;847;211;691;44;150;92;289;136;439
421189;201607;418;1272;340;1109;83;297;99;305;182;602
421190;201607;11836;33611;7164;24344;1563;5941;1058;3418;2621;9359
421200;201607;932;3056;789;2763;202;758;235;794;437;1552
421205;201607;257;776;190;641;47;188;46;131;93;319
421210;201607;1505;4565;1126;3683;293;988;294;968;587;1956
421220;201607;1936;6513;1672;5927;552;2207;303;957;855;3164
421223;201607;538;1696;397;1403;97;364;132;472;229;836
421225;201607;1108;3519;935;3164;203;743;381;1307;584;2050
421227;201607;800;2546;706;2396;149;578;399;1311;548;1889
421230;201607;442;1435;387;1339;93;359;173;576;266;935
421240;201607;424;1336;229;837;35;158;40;137;75;295
421250;201607;1721;4927;1108;3843;307;1162;235;829;542;1991
421260;201607;360;1026;100;361;24;87;19;64;43;151
421265;201607;751;2271;659;2122;121;448;383;1201;504;1649
421270;201607;838;2215;414;1356;86;282;82;301;168;583
421280;201607;1629;5098;1277;4474;380;1493;431;1470;811;2963
421290;201607;1206;3348;714;2303;127;452;125;366;252;818
421300;201607;309;941;236;783;66;268;94;278;160;546
421310;201607;236;729;182;605;39;141;58;181;97;322
421315;201607;358;1030;192;681;36;135;18;65;54;200
421320;201607;641;1921;391;1342;69;249;62;153;131;402
421330;201607;558;1815;427;1566;151;612;86;325;237;937
421335;201607;506;1662;416;1483;103;421;87;330;190;751
421340;201607;1768;5038;1402;4457;201;794;792;2493;993;3287
421350;201607;981;3212;823;2873;165;692;410;1362;575;2054
421360;201607;2998;8581;1897;6436;390;1553;548;1717;938;3270
421370;201607;685;2268;523;1909;149;604;163;591;312;1195
421380;201607;970;2728;797;2399;132;456;392;1150;524;1606
421390;201607;173;497;70;246;17;63;29;106;46;169
421400;201607;271;895;185;726;54;243;60;217;114;460
421410;201607;336;956;215;720;36;131;90;301;126;432
421415;201607;356;1158;165;608;36;145;30;102;66;247
421420;201607;876;2620;643;2095;116;427;213;653;329;1080
421430;201607;238;736;180;620;34;129;38;137;72;266
421440;201607;851;2463;568;1947;123;494;241;814;364;1308
421450;201607;493;1514;291;1055;62;253;29;114;91;367
421460;201607;637;1733;337;1176;67;276;71;246;138;522
421470;201607;431;1429;337;1219;95;378;105;361;200;739
421480;201607;3109;8719;1941;6611;560;2255;330;926;890;3181
421490;201607;278;839;128;493;27;120;21;76;48;196
421500;201607;2209;7451;1815;6631;601;2475;270;994;871;3469
421505;201607;361;1198;314;1090;73;267;153;532;226;799
421507;201607;526;1579;334;1171;74;274;96;358;170;632
421510;201607;174;571;150;530;24;114;78;229;102;343
421520;201607;892;2362;582;1728;72;269;243;635;315;904
421530;201607;413;1268;249;904;50;225;61;218;111;443
421535;201607;686;1981;372;1337;50;207;155;514;205;721
421540;201607;332;904;251;766;58;197;91;254;149;451
421545;201607;834;2624;608;2185;142;571;161;565;303;1136
421550;201607;2016;6403;1689;5834;521;2052;524;1729;1045;3781
421555;201607;328;956;115;408;17;64;17;58;34;122
421560;201607;211;644;92;318;18;70;19;61;37;131
421565;201607;850;2447;736;2289;230;807;336;1065;566;1872
421567;201607;638;2338;562;2163;290;1148;132;523;422;1671
421568;201607;512;1572;334;1146;76;270;93;320;169;590
421569;201607;231;702;103;381;25;97;16;59;41;156
421570;201607;1379;4139;773;2689;194;738;131;440;325;1178
421575;201607;449;1470;388;1342;63;238;219;765;282;1003
421580;201607;3065;9613;2276;7871;581;2307;583;1797;1164;4104
421590;201607;217;670;175;590;26;93;92;305;118;398
421600;201607;534;1602;405;1324;102;371;89;260;191;631
421605;201607;633;1923;461;1603;102;421;131;429;233;850
421610;201607;1408;3806;1027;3135;152;523;474;1386;626;1909
421620;201607;4451;13365;2958;10280;825;3091;874;3060;1699;6151
421625;201607;380;1050;153;523;25;87;16;53;41;140
421630;201607;3013;8890;1680;5759;351;1308;249;824;600;2132
421635;201607;244;730;128;432;21;86;37;98;58;184
421640;201607;1058;3131;751;2521;169;611;314;1034;483;1645
421650;201607;2109;6736;1588;5548;434;1733;207;621;641;2354
421660;201607;7782;25019;6319;22051;1550;6082;1995;6514;3545;12596
421670;201607;1074;3251;745;2513;183;698;221;710;404;1408
421680;201607;1145;3649;936;3208;321;1168;204;683;525;1851
421690;201607;1635;5305;1235;4409;284;1129;131;428;415;1557
421700;201607;503;1619;286;1068;52;212;63;203;115;415
421710;201607;214;715;109;399;24;93;30;98;54;191
421715;201607;261;692;138;438;35;115;39;115;74;230
421720;201607;1881;5518;1157;4017;306;1170;176;539;482;1709
421725;201607;125;397;100;338;38;139;21;62;59;201
421730;201607;593;1708;293;1005;48;174;54;166;102;340
421740;201607;775;2473;537;1902;140;558;101;330;241;888
421750;201607;1013;2684;617;1904;118;404;249;703;367;1107
421755;201607;320;920;184;596;43;155;58;179;101;334
421760;201607;842;2503;425;1503;75;296;111;357;186;653
421770;201607;2989;8965;2250;7484;561;1952;768;2655;1329;4607
421775;201607;499;1453;348;1176;71;259;114;377;185;636
421780;201607;1212;4062;913;3348;236;981;249;847;485;1828
421790;201607;790;2139;452;1579;130;530;137;451;267;981
421795;201607;351;1035;221;712;42;147;63;205;105;352
421800;201607;2753;8162;2052;6842;460;1726;785;2506;1245;4232
421810;201607;609;1883;431;1515;114;442;62;211;176;653
421820;201607;1044;3031;634;2153;123;449;106;320;229;769
421825;201607;1459;4611;1360;4408;162;617;982;3101;1144;3718
421830;201607;2451;8341;2161;7728;505;2055;885;3008;1390;5063
421835;201607;158;468;115;405;18;81;75;257;93;338
421840;201607;291;941;208;751;49;212;62;195;111;407
421850;201607;407;1292;240;860;45;189;44;150;89;339
421860;201607;314;954;202;722;36;149;49;148;85;297
421870;201607;3934;11046;2718;8633;803;2791;508;1599;1311;4390
421875;201607;412;1236;186;693;39;160;21;73;60;233
421880;201607;876;2671;649;2186;150;561;147;457;297;1018
421885;201607;305;979;245;870;72;274;81;278;153;552
421890;201607;877;2973;756;2728;249;1049;250;844;499;1893
421895;201607;373;1180;331;1107;73;265;189;634;262;899
421900;201607;957;2649;593;1902;167;579;157;464;324;1043
421910;201607;493;1570;333;1197;78;339;49;148;127;487
421915;201607;505;1493;303;1010;57;186;61;189;118;375
421917;201607;585;1658;414;1405;142;559;132;438;274;997
421920;201607;759;2113;480;1735;247;926;117;444;364;1370
421930;201607;3185;8334;1716;5728;440;1618;254;779;694;2397
421935;201607;661;2154;488;1781;104;441;169;588;273;1029
421940;201607;268;893;142;523;22;93;26;80;48;173
421950;201607;3670;9931;1733;5822;425;1548;229;793;654;2341
421960;201607;199;585;143;479;26;98;37;117;63;215
421970;201607;2288;6297;1414;4494;422;1439;401;1174;823;2613
421985;201607;494;1277;272;848;42;158;80;245;122;403
422000;201607;1190;3561;982;3164;262;923;383;1241;645;2164
430003;201607;798;2320;613;2005;175;651;168;544;343;1195
430005;201607;329;971;236;795;44;158;107;348;151;506
430010;201607;2164;5813;1620;4898;392;1252;680;2099;1072;3351
430020;201607;723;1799;602;1636;94;297;373;984;467;1281
430030;201607;1047;2719;757;2187;253;778;140;386;393;1164
430040;201607;11279;29386;8322;24065;2438;7768;1303;3619;3741;11387
430045;201607;709;1898;516;1514;93;297;215;605;308;902
430047;201607;296;700;148;443;22;69;57;171;79;240
430050;201607;1197;3180;669;2110;134;444;158;482;292;926
430055;201607;306;825;160;501;24;86;68;211;92;297
430057;201607;75;177;35;102;4;9;5;6;9;15
430060;201607;16644;52617;14296;48570;3953;14509;5847;20235;9800;34744
430063;201607;1003;2932;796;2500;195;632;401;1290;596;1922
430064;201607;1355;4002;1087;3518;275;926;385;1265;660;2191
430066;201607;168;397;117;318;9;29;64;172;73;201
430070;201607;607;1610;173;561;26;101;24;56;50;157
430080;201607;692;1949;414;1387;101;370;116;348;217;718
430085;201607;923;2392;580;1770;116;390;188;598;304;988
430087;201607;938;2850;861;2705;139;534;508;1470;647;2004
430090;201607;853;2232;322;1045;41;142;59;200;100;342
430100;201607;855;2264;437;1390;115;395;120;339;235;734
430105;201607;1008;2929;674;2306;175;671;224;763;399;1434
430107;201607;260;851;187;644;37;140;50;163;87;303
430110;201607;1935;5495;1574;4937;377;1258;735;2252;1112;3510
430120;201607;1783;5248;1308;4257;278;957;592;1911;870;2868
430130;201607;3886;9988;3294;9104;824;2439;1318;3600;2142;6039
430140;201607;1212;3673;811;2758;228;819;257;860;485;1679
430150;201607;759;2020;507;1537;128;417;133;420;261;837
430155;201607;408;1120;218;709;35;140;50;153;85;293
430160;201607;17209;49337;14892;45451;3490;11702;6206;19305;9696;31007
430163;201607;1954;5702;1577;5051;247;891;818;2623;1065;3514
430165;201607;468;1154;129;434;18;64;16;50;34;114
430170;201607;964;2715;377;1342;59;233;37;112;96;345
430175;201607;925;2855;757;2465;183;572;329;1128;512;1700
430180;201607;851;2326;690;2065;147;507;363;1051;510;1558
430185;201607;593;1529;332;1029;63;215;102;264;165;479
430187;201607;668;1944;515;1629;111;398;179;543;290;941
430190;201607;1716;5045;1482;4587;271;934;823;2529;1094;3463
430192;201607;199;601;93;299;8;29;16;47;24;76
430195;201607;389;1174;92;309;12;42;3;8;15;50
430200;201607;1424;4514;1214;4079;387;1365;315;1050;702;2415
430205;201607;589;1668;440;1384;43;172;305;957;348;1129
430210;201607;6409;16914;3807;11608;626;2117;978;2564;1604;4681
430215;201607;367;1018;248;762;48;158;101;301;149;459
430220;201607;750;1893;255;872;36;153;44;149;80;302
430222;201607;282;857;223;733;41;161;107;332;148;493
430223;201607;365;1027;299;909;61;179;151;473;212;652
430225;201607;36;88;16;45;4;11;6;15;10;26
430230;201607;1661;4868;1595;4798;183;411;1372;4308;1555;4719
430235;201607;293;957;237;823;59;235;73;236;132;471
430237;201607;536;1381;389;1132;44;153;240;664;284;817
430240;201607;1043;2681;703;2123;93;346;360;1038;453;1384
430245;201607;865;2643;653;2199;171;565;274;984;445;1549
430250;201607;1212;3449;1054;3189;392;1261;168;498;560;1759
430258;201607;163;459;119;383;12;43;51;175;63;218
430260;201607;806;2265;571;1809;89;298;292;963;381;1261
430265;201607;285;873;223;748;63;215;23;71;86;286
430270;201607;2993;8257;2577;7574;358;1266;1555;4410;1913;5676
430280;201607;4754;12750;3823;11153;884;2689;1719;5040;2603;7729
430290;201607;2494;6491;2283;6195;133;400;1981;5370;2114;5770
430300;201607;9336;27228;7716;24160;1770;6044;3405;10879;5175;16923
430310;201607;6669;19858;5092;16842;1219;4426;1939;6114;3158;10540
430320;201607;870;2516;543;1810;92;273;260;916;352;1189
430330;201607;672;1779;520;1494;137;398;217;594;354;992
430340;201607;707;1771;371;1210;81;273;182;589;263;862
430350;201607;6318;19100;5352;17068;1876;6232;1677;5305;3553;11537
430355;201607;395;985;153;471;29;97;20;56;49;153
430360;201607;1072;2803;871;2454;174;567;381;998;555;1565
430367;201607;288;754;173;536;42;149;57;170;99;319
430370;201607;572;1574;364;1153;95;328;78;216;173;544
430380;201607;867;2228;484;1552;133;462;132;424;265;886
430390;201607;3980;11130;2635;8406;559;1977;433;1318;992;3295
430400;201607;1435;3396;1021;2742;303;845;398;1028;701;1873
430410;201607;634;1691;447;1363;75;252;218;656;293;908
430420;201607;3652;10527;2864;8805;734;2347;1105;3348;1839;5695
430430;201607;763;2028;476;1505;125;436;119;384;244;820
430435;201607;2052;5535;1537;4616;398;1267;558;1696;956;2963
430440;201607;4021;12563;3136;10545;609;2168;1487;5182;2096;7350
430450;201607;7621;20956;6014;17893;1901;5966;1613;4934;3514;10900
430460;201607;28782;84446;22074;72521;6105;22225;6614;21516;12719;43741
430461;201607;511;1358;162;519;23;73;40;126;63;199
430462;201607;275;781;184;625;34;127;30;109;64;236
430463;201607;4230;13360;3637;12264;842;3041;1676;5811;2518;8852
430465;201607;649;1741;539;1557;140;436;288;821;428;1257
430466;201607;3651;9976;3181;9248;683;2198;1725;4853;2408;7051
430467;201607;511;1508;441;1377;94;320;189;565;283;885
430468;201607;1444;3985;1219;3652;328;1069;477;1381;805;2450
430469;201607;475;1282;59;202;10;32;7;17;17;49
430470;201607;7738;20573;5470;16775;1636;5427;990;3081;2626;8508
430471;201607;589;1917;514;1757;156;542;132;482;288;1024
430480;201607;990;2608;506;1632;83;301;108;317;191;618
430485;201607;216;593;99;315;12;43;18;47;30;90
430490;201607;331;944;220;713;51;180;97;320;148;500
430495;201607;371;1105;244;839;54;209;70;218;124;427
430500;201607;1206;3307;973;2925;227;775;472;1386;699;2161
430510;201607;21453;62172;17114;53951;5439;18829;4972;14844;10411;33673
430511;201607;402;1237;176;624;35;133;17;40;52;173
430512;201607;1175;2995;997;2687;261;753;311;874;572;1627
430513;201607;812;2094;471;1377;106;335;176;490;282;825
430515;201607;487;1393;351;1114;55;181;156;510;211;691
430517;201607;1189;3729;984;3311;194;671;528;1824;722;2495
430520;201607;1579;4347;1045;3244;258;916;285;795;543;1711
430530;201607;1115;2992;529;1693;66;261;136;392;202;653
430535;201607;2377;7124;1798;5978;403;1487;664;2156;1067;3643
430537;201607;486;1534;418;1396;32;109;311;1044;343;1153
430540;201607;750;1661;498;1317;88;247;295;779;383;1026
430543;201607;495;1272;431;1205;75;210;310;900;385;1110
430544;201607;677;2157;562;1906;114;427;284;940;398;1367
430545;201607;1335;4212;1148;3983;383;1452;502;1774;885;3226
430550;201607;640;1843;380;1262;88;313;80;252;168;565
430558;201607;101;277;54;169;10;36;14;37;24;73
430560;201607;384;923;176;538;17;62;57;159;74;221
430570;201607;1125;2880;709;2061;160;541;282;708;442;1249
430580;201607;1284;3199;787;2383;133;447;359;1115;492;1562
430583;201607;169;463;55;176;4;13;8;24;12;37
430585;201607;340;886;216;626;47;168;87;214;134;382
430587;201607;191;598;162;534;45;156;47;161;92;317
430590;201607;1248;3454;1148;3283;119;394;851;2394;970;2788
430593;201607;25;94;23;87;5;20;10;37;15;57
430595;201607;299;844;84;284;10;46;10;26;20;72
430597;201607;344;1008;238;750;31;104;55;146;86;250
430600;201607;2104;5591;1143;3452;225;739;343;972;568;1711
430605;201607;1365;4069;1057;3434;208;767;424;1388;632;2155
430607;201607;776;1865;578;1573;63;179;367;1038;430;1217
430610;201607;8264;22006;6340;18997;1868;6135;1702;5112;3570;11247
430613;201607;275;667;112;340;17;46;20;50;37;96
430620;201607;745;2108;593;1800;166;551;227;655;393;1206
430630;201607;439;1356;219;738;41;139;25;71;66;210
430632;201607;702;1963;351;1118;59;217;116;320;175;537
430635;201607;607;1735;459;1420;89;315;245;731;334;1046
430637;201607;481;1358;421;1241;67;228;250;697;317;925
430640;201607;1661;4435;769;2502;101;356;41;95;142;451
430642;201607;486;1261;306;932;60;184;128;394;188;578
430645;201607;273;635;105;304;17;47;25;75;42;122
430650;201607;1842;5908;1553;5327;329;1177;873;3045;1202;4222
430655;201607;166;419;143;373;29;104;74;156;103;260
430660;201607;5810;16226;4602;14089;1073;3604;1931;5901;3004;9505
430670;201607;515;1481;471;1404;35;105;359;1108;394;1213
430673;201607;747;1758;343;1026;74;223;95;287;169;510
430675;201607;262;768;95;328;15;59;34;112;49;171
430676;201607;3644;10803;2960;9524;810;2779;937;3071;1747;5850
430680;201607;1173;3348;729;2386;146;505;161;457;307;962
430690;201607;4365;12221;3452;10442;1120;3570;852;2602;1972;6172
430692;201607;273;885;200;743;21;92;130;464;151;556
430693;201607;1298;3561;829;2601;183;648;185;552;368;1200
430695;201607;584;1596;383;1176;79;280;144;402;223;682
430697;201607;489;1359;355;1115;87;276;132;426;219;702
430700;201607;10302;26274;5111;16392;983;3631;390;1230;1373;4861
430705;201607;285;857;236;755;85;295;59;169;144;464
430710;201607;1806;4546;1338;3764;277;876;540;1550;817;2426
430720;201607;894;2158;564;1675;124;398;190;574;314;972
430730;201607;1651;4270;1106;3380;246;745;461;1493;707;2238
430740;201607;576;1594;327;1090;80;284;54;199;134;483
430745;201607;506;1418;242;763;37;123;37;112;74;235
430750;201607;1594;4341;1255;3775;224;753;700;2071;924;2824
430755;201607;510;1367;333;1005;29;94;136;391;165;485
430760;201607;3078;7446;2094;6037;505;1667;781;2356;1286;4023
430770;201607;6440;18489;5065;15941;982;3367;2650;8250;3632;11617
430780;201607;2501;6605;1502;4746;301;1052;465;1430;766;2482
430781;201607;539;1543;351;1152;78;264;89;291;167;555
430783;201607;546;1327;333;969;52;156;154;424;206;580
430786;201607;72;238;47;176;6;24;11;38;17;62
430790;201607;4774;12987;3299;10074;731;2457;1205;3445;1936;5902
430800;201607;914;2563;611;1886;133;445;207;616;340;1061
430805;201607;563;1565;359;1139;41;130;186;588;227;718
430807;201607;449;1274;303;950;66;240;84;247;150;487
430810;201607;745;1995;271;910;55;197;58;190;113;387
430820;201607;1316;3932;812;2765;187;682;175;569;362;1251
430825;201607;406;1048;141;425;26;75;25;50;51;125
430830;201607;1746;5385;1610;5187;255;904;1043;3334;1298;4238
430840;201607;1005;2987;878;2758;212;648;435;1418;647;2066
430843;201607;85;221;42;128;4;14;15;41;19;55
430845;201607;297;888;243;772;103;362;30;69;133;431
430850;201607;2518;7355;2111;6590;530;1820;839;2569;1369;4389
430860;201607;1062;2833;531;1717;116;437;188;584;304;1021
430865;201607;638;1670;564;1552;179;519;269;729;448;1248
430870;201607;727;2003;388;1267;95;324;72;196;167;520
430880;201607;1207;3388;852;2695;230;768;239;809;469;1577
430885;201607;247;591;139;428;20;69;91;283;111;352
430890;201607;1782;4696;1161;3486;159;623;278;715;437;1338
430900;201607;2874;7512;2299;6545;468;1590;1056;2846;1524;4436
430905;201607;1069;3007;676;2182;162;557;140;429;302;986
430910;201607;1587;4620;1066;3506;233;855;391;1166;624;2021
430912;201607;484;1359;370;1158;44;147;231;735;275;882
430915;201607;589;1825;410;1485;142;560;95;363;237;923
430920;201607;16830;50608;14759;46708;2808;9894;8504;26350;11312;36244
430925;201607;135;303;58;168;11;34;22;65;33;99
430930;201607;10000;28025;6799;22078;1883;6565;1573;5430;3456;11995
430940;201607;1293;3892;746;2545;186;700;112;346;298;1046
430950;201607;992;2703;650;2001;153;533;242;672;395;1205
430955;201607;168;494;80;262;15;59;20;57;35;116
430957;201607;265;856;213;759;51;179;98;365;149;544
430960;201607;1414;3753;1147;3289;258;818;557;1628;815;2446
430965;201607;1554;4314;1327;3943;78;305;1040;3038;1118;3343
430970;201607;524;1425;303;957;57;182;79;244;136;426
430975;201607;603;1934;466;1615;103;382;198;696;301;1078
430980;201607;451;1109;271;840;63;201;91;281;154;482
430990;201607;585;1843;384;1307;74;270;110;371;184;641
430995;201607;615;1752;470;1461;137;460;183;529;320;989
431000;201607;1639;4168;819;2521;151;498;69;198;220;696
431010;201607;2703;7537;1634;5474;306;1140;236;720;542;1860
431020;201607;11405;27702;7303;20574;1813;5391;1835;5101;3648;10492
431030;201607;328;942;155;553;36;144;21;71;57;215
431033;201607;2455;7119;2157;6684;564;1854;1060;3393;1624;5247
431036;201607;222;563;91;295;18;59;20;51;38;110
431040;201607;947;2676;749;2334;151;561;379;1127;530;1688
431041;201607;540;1415;468;1316;140;402;188;555;328;957
431043;201607;499;1410;280;978;118;454;69;220;187;674
431046;201607;116;329;82;256;10;39;24;72;34;111
431050;201607;1699;4269;1247;3505;300;898;596;1652;896;2550
431053;201607;603;1921;487;1667;145;518;120;430;265;948
431055;201607;671;1795;619;1712;54;152;482;1347;536;1499
431057;201607;379;1101;228;771;47;174;61;188;108;362
431060;201607;5617;16556;4952;15509;1549;5031;1752;5695;3301;10726
431065;201607;565;1613;411;1301;73;261;140;399;213;660
431070;201607;717;2018;407;1311;83;279;70;175;153;454
431075;201607;298;894;211;706;39;134;66;241;105;375
431080;201607;647;1961;472;1547;102;367;132;405;234;772
431085;201607;845;2291;662;1912;109;334;381;1096;490;1430
431087;201607;595;1671;507;1499;57;168;349;1045;406;1213
431090;201607;519;1280;241;734;55;183;45;131;100;314
431100;201607;3694;10173;2961;8933;822;2734;961;2822;1783;5556
431110;201607;1561;4089;1151;3289;257;754;415;1123;672;1877
431112;201607;569;1831;523;1738;134;447;256;832;390;1279
431113;201607;518;1470;405;1256;110;361;117;371;227;732
431115;201607;1395;3984;1215;3683;212;674;709;2173;921;2847
431120;201607;2731;8257;2079;6943;631;2449;709;2170;1340;4619
431123;201607;460;1318;302;1007;55;174;165;562;220;736
431125;201607;1392;4148;983;3261;307;1039;252;917;559;1956
431127;201607;266;719;65;216;8;20;9;23;17;43
431130;201607;3389;9651;2434;7851;516;1819;810;2642;1326;4461
431140;201607;4881;11942;2740;8350;438;1497;752;2088;1190;3585
431142;201607;466;1354;400;1233;50;162;270;857;320;1019
431150;201607;1122;3310;849;2757;184;660;296;951;480;1611
431160;201607;909;2637;750;2328;131;394;376;1278;507;1672
431162;201607;517;1288;220;726;28;103;27;65;55;168
431164;201607;171;473;52;185;10;38;4;18;14;56
431170;201607;729;2004;519;1629;147;494;152;469;299;963
431171;201607;795;2321;691;2118;196;641;241;723;437;1364
431173;201607;482;1390;388;1228;143;496;126;380;269;876
431175;201607;1049;2911;870;2609;265;856;260;768;525;1624
431177;201607;822;2654;634;2284;199;796;252;889;451;1685
431179;201607;375;812;102;296;17;53;21;51;38;104
431180;201607;2351;6623;1574;5083;424;1489;317;988;741;2477
431190;201607;639;1770;366;1175;59;210;65;184;124;394
431198;201607;368;1207;333;1138;125;445;94;345;219;790
431200;201607;409;1156;118;404;21;71;4;10;25;81
431205;201607;290;875;136;475;26;82;43;157;69;239
431210;201607;779;2068;629;1816;163;473;331;986;494;1459
431213;201607;232;712;180;611;32;122;92;314;124;436
431215;201607;287;837;156;534;42;157;9;25;51;182
431217;201607;159;498;118;406;32;118;48;164;80;282
431220;201607;888;2394;517;1606;49;174;219;619;268;793
431225;201607;1357;3727;1059;3187;249;793;393;1177;642;1970
431230;201607;860;2474;644;2033;106;368;291;893;397;1261
431235;201607;115;317;32;99;8;28;5;9;13;37
431237;201607;502;1462;396;1304;86;337;216;689;302;1026
431238;201607;41;131;33;113;9;37;8;28;17;65
431240;201607;3186;9350;2791;8734;766;2607;1082;3379;1848;5986
431242;201607;381;1170;326;1073;88;301;125;434;213;735
431244;201607;394;907;232;640;27;91;117;295;144;386
431245;201607;1224;3172;842;2471;133;409;398;1162;531;1571
431247;201607;204;582;138;438;39;128;34;102;73;230
431250;201607;1520;4845;1316;4547;371;1412;527;1845;898;3257
431260;201607;354;992;172;599;29;127;51;164;80;291
431261;201607;249;843;213;763;33;145;97;327;130;472
431262;201607;424;1154;189;618;25;88;91;307;116;395
431265;201607;1476;3745;782;2341;158;519;207;516;365;1035
431267;201607;231;654;155;477;26;99;99;282;125;381
431270;201607;2826;7013;1786;5282;433;1389;590;1785;1023;3174
431275;201607;227;685;125;454;34;128;16;56;50;184
431280;201607;329;914;133;445;20;75;22;51;42;126
431290;201607;329;1008;238;799;52;207;35;83;87;290
431295;201607;90;248;44;138;4;13;14;40;18;53
431300;201607;392;983;66;249;5;20;2;7;7;27
431301;201607;282;857;113;382;23;83;17;45;40;128
431303;201607;766;2033;444;1366;59;213;138;406;197;619
431306;201607;2374;6078;1484;4487;204;735;420;1117;624;1852
431308;201607;39;132;35;118;17;61;12;40;29;101
431310;201607;755;2238;461;1569;100;359;136;483;236;842
431320;201607;798;2195;412;1366;76;271;75;222;151;493
431330;201607;2940;7185;1470;4572;384;1341;114;307;498;1648
431333;201607;426;1143;171;520;30;100;29;72;59;172
431335;201607;54;162;38;128;12;44;8;19;20;63
431337;201607;2534;7605;1861;6257;467;1720;310;1024;777;2744
431339;201607;607;1635;413;1240;76;235;200;606;276;841
431340;201607;24568;65032;17760;53096;4313;14193;4583;13557;8896;27750
431342;201607;548;1366;426;1173;111;357;240;606;351;963
431344;201607;359;970;253;778;10;24;182;574;192;598
431346;201607;301;763;108;336;21;70;14;42;35;112
431349;201607;736;2060;457;1403;80;266;171;485;251;751
431350;201607;4193;12191;3377;10681;761;2711;1233;3705;1994;6416
431360;201607;659;1676;429;1276;94;284;133;401;227;685
431365;201607;1336;3945;1136;3608;226;764;609;2002;835;2766
431370;201607;4948;13782;3853;11905;1089;3612;1243;4012;2332;7624
431380;201607;935;2901;857;2739;113;410;512;1612;625;2022
431390;201607;3156;8245;1878;5799;369;1298;508;1406;877;2704
431395;201607;1267;3756;1059;3385;239;839;504;1608;743;2447
431400;201607;380;1179;177;599;38;139;32;105;70;244
431402;201607;1288;3015;753;2097;160;480;352;949;512;1429
431403;201607;257;733;188;617;63;226;45;143;108;369
431405;201607;4134;11500;3331;10283;636;2211;1728;5272;2364;7483
431406;201607;744;2253;551;1859;114;394;283;965;397;1359
431407;201607;549;1555;360;1188;86;294;108;344;194;638
431410;201607;14406;40863;9745;31845;2904;10633;1337;4325;4241;14958
431413;201607;221;555;92;301;11;44;20;59;31;103
431415;201607;730;2050;513;1638;117;431;159;439;276;870
431417;201607;571;1435;471;1295;64;198;292;795;356;993
431420;201607;1373;3738;1209;3490;244;737;555;1705;799;2442
431430;201607;568;1483;340;1030;64;214;123;335;187;549
431440;201607;23201;64021;18725;56877;5548;18026;5948;19301;11496;37327
431442;201607;128;370;77;245;12;41;5;13;17;54
431445;201607;525;1479;220;710;36;120;68;213;104;333
431446;201607;438;1270;304;981;77;259;96;298;173;557
431447;201607;585;1656;452;1387;73;237;226;691;299;928
431449;201607;800;2195;631;1903;73;229;358;1102;431;1331
431450;201607;2227;5422;1943;5017;264;784;1405;3516;1669;4300
431454;201607;63;220;55;199;12;45;22;86;34;131
431455;201607;724;1810;384;1082;91;265;107;275;198;540
431460;201607;3357;9208;2840;8223;782;2338;932;2841;1714;5179
431470;201607;1771;5136;1303;4114;288;932;465;1501;753;2433
431475;201607;206;595;36;142;5;26;2;6;7;32
431477;201607;736;1910;480;1387;74;234;234;643;308;877
431478;201607;283;709;92;267;13;35;14;29;27;64
431480;201607;3015;8339;2298;7085;529;1785;952;2880;1481;4665
431490;201607;111468;298152;94614;273023;11793;40275;65116;183652;76909;223927
431500;201607;602;1662;470;1399;82;247;258;763;340;1010
431505;201607;506;1217;339;972;29;74;210;606;239;680
431507;201607;360;883;208;584;40;110;108;304;148;414
431510;201607;1899;5295;1471;4439;332;1061;513;1474;845;2535
431513;201607;306;809;148;449;27;79;67;199;94;278
431514;201607;111;295;45;156;3;12;9;33;12;45
431515;201607;666;1899;456;1418;100;338;160;457;260;795
431517;201607;84;273;67;230;9;32;20;63;29;95
431520;201607;526;1329;247;796;49;183;34;101;83;284
431530;201607;4346;10142;3220;8798;1020;2989;973;2868;1993;5857
431531;201607;275;794;187;600;26;90;64;194;90;284
431532;201607;506;1386;408;1180;83;257;167;467;250;724
431535;201607;348;903;152;468;27;98;46;116;73;214
431540;201607;2058;6751;1812;6382;181;713;1199;4393;1380;5106
431545;201607;340;948;49;168;5;16;7;28;12;44
431550;201607;2258;6583;1971;6072;438;1529;875;2591;1313;4120
431555;201607;700;1734;513;1431;62;172;313;895;375;1067
431560;201607;20629;60550;14643;49179;3603;13573;3357;12053;6960;25626
431570;201607;5894;15063;4725;13555;1236;3714;2164;6370;3400;10084
431575;201607;417;1056;304;881;55;186;69;176;124;362
431580;201607;626;1765;378;1240;76;268;107;336;183;604
431590;201607;977;2628;604;1891;120;381;187;609;307;990
431595;201607;444;1254;350;1058;44;126;206;637;250;763
431600;201607;2044;5608;1474;4598;332;1218;358;1088;690;2306
431610;201607;1497;4245;1074;3424;184;609;441;1428;625;2037
431620;201607;486;1422;242;767;58;178;93;271;151;449
431630;201607;1429;3842;888;2710;241;760;262;782;503;1542
431640;201607;6277;17454;5591;16458;1084;3444;3348;9946;4432;13390
431642;201607;510;1366;388;1145;49;163;177;506;226;669
431643;201607;328;861;170;489;29;89;56;138;85;227
431645;201607;1750;4950;1481;4484;255;886;882;2636;1137;3522
431647;201607;157;454;102;333;14;54;19;51;33;105
431650;201607;342;1024;238;800;41;173;68;202;109;375
431660;201607;1165;3265;724;2373;152;550;148;433;300;983
431670;201607;1279;3364;948;2775;213;724;379;1026;592;1750
431673;201607;233;647;114;373;26;88;15;40;41;128
431675;201607;640;1681;144;481;21;79;35;105;56;184
431680;201607;9802;26523;7388;22095;2019;6479;1933;5878;3952;12357
431690;201607;23685;65505;18512;56867;5078;16611;6217;19917;11295;36528
431695;201607;141;439;99;333;22;79;25;63;47;142
431697;201607;457;1289;401;1184;100;317;200;604;300;921
431700;201607;1566;4434;1337;4005;217;710;741;2177;958;2887
431710;201607;12623;36143;10303;32474;3370;11464;2623;9094;5993;20558
431720;201607;7258;19921;5457;16459;1239;4021;1854;5511;3093;9532
431725;201607;25;75;13;48;3;13;3;9;6;22
431730;201607;3964;11429;3135;9982;801;2812;879;2980;1680;5792
431740;201607;5301;14623;4209;12689;1404;4679;737;2061;2141;6740
431750;201607;9092;25644;7855;23648;1755;5762;3717;11318;5472;17080
431755;201607;334;916;77;262;13;39;15;51;28;90
431760;201607;4073;11441;3243;9941;671;2297;1402;4093;2073;6390
431770;201607;2039;5379;1668;4819;289;873;982;2824;1271;3697
431775;201607;211;564;133;411;39;124;15;40;54;164
431780;201607;2453;6605;1830;5436;498;1577;417;1163;915;2740
431790;201607;1181;3517;930;2993;168;598;369;1168;537;1766
431795;201607;379;1011;224;669;37;109;72;216;109;325
431800;201607;8713;25463;6919;22119;2294;8036;1072;3348;3366;11384
431805;201607;342;839;106;355;20;75;19;66;39;141
431810;201607;3255;8883;2497;7412;486;1572;1101;3202;1587;4774
431820;201607;2544;7826;2185;7133;492;1776;896;2835;1388;4611
431830;201607;10949;26482;8469;22841;2229;6525;3395;9328;5624;15853
431840;201607;2685;8021;2313;7378;547;1888;1069;3474;1616;5362
431842;201607;807;2032;326;1003;46;158;75;207;121;365
431843;201607;354;1030;290;910;42;158;142;429;184;587
431844;201607;289;790;87;291;25;90;16;46;41;136
431845;201607;497;1444;375;1186;25;87;236;751;261;838
431846;201607;330;1008;285;940;27;106;203;670;230;776
431848;201607;256;689;147;470;17;64;32;91;49;155
431849;201607;478;1168;98;295;17;50;16;41;33;91
431850;201607;4824;14020;4169;12753;960;3118;1584;4865;2544;7983
431860;201607;789;2069;569;1665;88;296;278;771;366;1067
431861;201607;101;291;55;188;8;28;9;23;17;51
431862;201607;483;1568;392;1402;96;400;142;487;238;887
431870;201607;18426;52992;14650;46199;3604;12403;5103;16237;8707;28640
431880;201607;4308;12755;3450;10979;830;2942;1198;3669;2028;6611
431890;201607;5117;13784;3705;11256;1142;3689;866;2791;2008;6480
431900;201607;1104;3059;721;2281;181;659;281;818;462;1477
431910;201607;1029;2459;497;1431;71;213;143;382;214;595
431912;201607;502;1449;412;1287;117;355;161;521;278;876
431915;201607;1302;3506;1002;2972;233;731;389;1172;622;1903
431920;201607;1305;3646;1124;3358;137;427;787;2336;924;2763
431930;201607;1252;3390;860;2734;197;611;419;1406;616;2017
431935;201607;55;176;47;158;10;38;13;41;23;79
431936;201607;388;1119;283;881;66;205;119;385;185;590
431937;201607;335;866;185;559;40;136;34;91;74;227
431940;201607;2579;6956;1691;5198;383;1289;452;1362;835;2651
431950;201607;1631;4949;1433;4590;282;1020;711;2217;993;3237
431960;201607;2912;8333;2533;7610;715;2279;802;2431;1517;4710
431970;201607;487;1343;225;753;40;144;43;133;83;277
431971;201607;97;284;59;207;8;31;11;34;19;65
431973;201607;472;1603;416;1491;54;195;263;978;317;1173
431975;201607;108;253;24;90;5;22;6;20;11;42
431980;201607;1392;4035;1116;3487;275;911;367;1113;642;2024
431990;201607;7452;20421;5483;17202;1112;4043;1720;5162;2832;9205
432000;201607;10141;28160;8054;24601;2441;7748;2836;8776;5277;16524
432010;201607;2247;6280;1819;5520;368;1220;849;2551;1217;3771
432020;201607;2326;5569;1710;4712;266;813;1084;2920;1350;3733
432023;201607;516;1451;336;1050;68;243;120;327;188;570
432026;201607;1192;3572;874;2907;125;423;450;1480;575;1903
432030;201607;422;1207;307;949;66;205;146;440;212;645
432032;201607;603;1540;394;1166;69;231;173;468;242;699
432035;201607;834;2500;739;2334;262;908;249;806;511;1714
432040;201607;993;2324;447;1397;67;226;158;488;225;714
432045;201607;252;709;146;501;27;95;44;149;71;244
432050;201607;642;1772;549;1611;79;253;314;949;393;1202
432055;201607;952;2682;668;2162;127;440;350;1117;477;1557
432057;201607;413;995;298;804;51;133;170;442;221;575
432060;201607;556;1472;207;704;37;148;45;132;82;280
432065;201607;224;639;168;539;45;157;66;199;111;356
432067;201607;978;2978;724;2443;132;446;336;1152;468;1598
432070;201607;2364;6517;1539;4844;329;1128;331;1001;660;2129
432080;201607;3836;10697;3193;9589;926;3036;1181;3574;2107;6610
432085;201607;323;891;212;710;55;189;103;340;158;529
432090;201607;1506;4272;1171;3627;309;1029;481;1440;790;2469
432100;201607;1363;3917;654;2227;114;416;44;116;158;532
432110;201607;2681;8023;1983;6608;514;1962;217;673;731;2635
432120;201607;4767;13998;4003;12691;1424;4829;1152;3651;2576;8480
432130;201607;2735;7449;2195;6759;654;2201;918;2905;1572;5106
432132;201607;393;1097;184;630;31;115;53;178;84;293
432135;201607;741;2204;643;2015;112;377;410;1272;522;1649
432140;201607;1917;6085;1506;5287;343;1246;632;2363;975;3609
432143;201607;1397;4068;1162;3672;218;728;563;1851;781;2579
432145;201607;1281;3858;790;2731;141;570;125;396;266;966
432146;201607;180;579;127;455;30;116;30;107;60;223
432147;201607;650;2038;485;1677;144;519;134;493;278;1012
432149;201607;366;1010;234;702;44;128;88;262;132;390
432150;201607;3796;10504;2821;8762;593;2034;877;2692;1470;4726
432160;201607;4567;14194;3961;13107;1194;4188;1412;4838;2606;9026
432162;201607;412;985;72;221;14;44;12;35;26;79
432163;201607;367;981;94;299;7;23;2;3;9;26
432166;201607;677;1992;552;1740;87;326;242;723;329;1049
432170;201607;1155;3533;793;2759;196;710;151;505;347;1215
432180;201607;2800;7458;1785;5451;459;1492;379;1054;838;2546
432183;201607;416;1287;321;1088;129;466;66;223;195;689
432185;201607;913;2410;581;1805;103;332;263;818;366;1150
432190;201607;3349;9052;2154;6471;484;1530;606;1713;1090;3243
432195;201607;1130;3011;816;2491;155;460;365;1110;520;1570
432200;201607;3102;9190;2469;8113;625;2266;1074;3548;1699;5814
432210;201607;428;1166;306;965;65;237;115;347;180;584
432215;201607;846;2547;719;2345;155;477;401;1388;556;1865
432218;201607;276;700;172;498;24;70;62;155;86;225
432220;201607;4253;11162;3449;9880;452;1544;2060;5721;2512;7265
432225;201607;97;295;77;255;26;94;22;74;48;168
432230;201607;1044;2790;628;1881;136;447;157;400;293;847
432232;201607;528;1470;416;1251;74;254;183;532;257;786
432234;201607;366;1013;239;740;53;170;66;196;119;366
432235;201607;109;310;37;125;7;25;1;1;8;26
432237;201607;471;1265;419;1177;22;89;304;831;326;920
432240;201607;14082;43461;11712;40355;1757;7184;7001;24985;8758;32169
432250;201607;4774;16135;4295;15173;1357;5157;1434;5211;2791;10368
432252;201607;419;1110;283;893;56;185;148;485;204;670
432253;201607;1322;4150;765;2662;185;705;66;228;251;933
432254;201607;867;2333;246;812;52;193;27;74;79;267
432255;201607;196;529;120;393;21;78;41;124;62;202
432260;201607;7739;19126;5391;15319;1153;3341;2259;6780;3412;10121
432270;201607;2605;7650;2164;6868;635;2114;675;2195;1310;4309
432280;201607;1415;3822;758;2404;129;451;167;471;296;922
432285;201607;195;609;27;99;4;16;2;4;6;20
432290;201607;570;1649;356;1161;92;293;90;294;182;587
432300;201607;23921;70202;20792;64864;3824;13058;11928;36966;15752;50024
432310;201607;822;2375;640;2066;162;563;312;980;474;1543
432320;201607;229;583;114;354;21;67;21;56;42;123
432330;201607;336;884;131;427;20;70;15;38;35;108
432335;201607;155;442;64;229;12;46;11;27;23;73
432340;201607;316;768;169;511;31;110;53;148;84;258
432345;201607;643;1763;588;1674;85;322;365;949;450;1271
432350;201607;395;1072;209;690;36;113;59;190;95;303
432360;201607;191;585;43;152;8;38;9;24;17;62
432370;201607;424;1181;334;1010;34;106;206;638;240;744
432375;201607;768;1905;575;1592;79;216;335;944;414;1160
432377;201607;197;643;36;136;7;29;8;22;15;51
432380;201607;929;2989;777;2687;263;1008;299;1007;562;2015
500020;201607;2343;6803;1777;5826;394;1509;730;2312;1124;3821
500025;201607;1399;3253;847;2299;93;254;480;1288;573;1542
500060;201607;6988;20594;5517;18109;723;2470;3510;11982;4233;14452
500070;201607;4442;12594;3475;10876;763;2689;1426;4514;2189;7203
500080;201607;1493;4357;1116;3665;292;1070;397;1303;689;2373
500085;201607;2303;5850;1604;4832;149;480;984;2893;1133;3373
500090;201607;2387;6756;1716;5541;376;1275;728;2481;1104;3756
500100;201607;2713;7764;2250;6976;489;1747;881;2642;1370;4389
500110;201607;8462;24576;6609;21701;1222;4385;3032;10630;4254;15015
500124;201607;2068;6520;1778;6033;417;1343;908;3439;1325;4782
500150;201607;1416;3568;971;2838;205;706;361;928;566;1634
500190;201607;4962;12690;3812;11134;760;2427;2037;6083;2797;8510
500200;201607;2477;6191;1870;5119;410;1193;762;1982;1172;3175
500210;201607;4805;14221;3973;12914;939;3245;1836;6144;2775;9389
500215;201607;1536;4710;1180;4002;217;802;443;1513;660;2315
500220;201607;3045;9409;2515;8502;498;1796;1140;3976;1638;5772
500230;201607;2825;7138;1994;5828;409;1274;955;2875;1364;4149
500240;201607;4598;14314;3312;11664;635;2462;993;3716;1628;6178
500260;201607;2788;7009;1991;5810;334;1080;986;2780;1320;3860
500270;201607;126302;322067;79786;241497;19026;62946;18454;55990;37480;118936
500280;201607;1377;3461;1123;3119;77;226;878;2482;955;2708
500290;201607;4604;10365;2632;7537;518;1668;948;2684;1466;4352
500295;201607;2708;7786;1664;5466;292;1076;402;1112;694;2188
500310;201607;793;2048;644;1837;142;478;329;897;471;1375
500315;201607;3118;9656;2558;8747;377;1328;1587;5664;1964;6992
500320;201607;17347;54950;13605;48007;4063;15624;3708;14030;7771;29654
500325;201607;4138;10522;3004;8763;573;1780;1607;4769;2180;6549
500330;201607;6885;17830;4727;13897;777;2561;2093;6088;2870;8649
500345;201607;2205;5707;1702;4947;387;1209;804;2349;1191;3558
500348;201607;2290;6594;1982;6112;155;588;1417;4322;1572;4910
500350;201607;1275;3723;696;2368;86;299;220;759;306;1058
500370;201607;24034;71359;18067;60567;4098;15553;5290;18033;9388;33586
500375;201607;2905;7933;2150;6502;440;1430;637;1894;1077;3324
500380;201607;3154;8685;2472;7499;596;1914;1019;3117;1615;5031
500390;201607;601;1331;343;938;56;183;168;424;224;607
500400;201607;1370;4115;1008;3260;258;913;241;726;499;1639
500410;201607;2223;6204;1794;5584;360;1196;914;2951;1274;4147
500430;201607;2701;7372;2000;6376;396;1423;821;2764;1217;4187
500440;201607;1498;3916;999;3054;170;566;449;1384;619;1950
500450;201607;1678;4929;1190;3993;283;1051;190;551;473;1602
500460;201607;3789;11286;2814;9392;787;2901;589;1915;1376;4816
500470;201607;3074;8904;2112;6843;578;2075;344;1036;922;3111
500480;201607;2289;6825;2101;6598;194;577;1613;5471;1807;6048
500490;201607;979;2666;720;2219;220;785;168;527;388;1312
500500;201607;3923;11748;3019;10428;986;3870;1053;3812;2039;7682
500510;201607;861;2213;545;1654;75;262;237;664;312;926
500515;201607;1917;5062;1583;4630;209;634;951;3028;1160;3662
500520;201607;3219;10901;2845;10239;412;1701;1810;6532;2222;8233
500525;201607;1199;3728;951;3262;174;676;447;1599;621;2275
500540;201607;6352;17164;3738;12308;996;3857;498;1480;1494;5337
500560;201607;4698;15247;4244;14548;493;1877;3044;10518;3537;12395
500568;201607;4389;10617;2948;8486;617;2153;943;2525;1560;4678
500570;201607;7842;20586;5015;15303;1358;4496;990;2972;2348;7468
500580;201607;3759;10441;2995;9218;299;956;2158;6773;2457;7729
500600;201607;3974;10486;2568;7896;637;2140;690;2147;1327;4287
500620;201607;7887;22382;5925;18674;1040;3509;2519;8112;3559;11621
500625;201607;754;2170;416;1396;79;279;138;464;217;743
500627;201607;610;1679;418;1308;88;283;102;328;190;611
500630;201607;6131;16547;4360;13585;1132;3826;1352;4167;2484;7993
500635;201607;2767;10118;2272;9354;302;1228;1574;6998;1876;8226
500640;201607;1670;3979;1259;3400;96;310;911;2419;1007;2729
500660;201607;19429;55040;14937;47843;4559;16313;4592;14792;9151;31105
500690;201607;2578;7552;2074;6842;943;3244;578;2110;1521;5354
500710;201607;3536;10342;2925;9320;699;2516;1215;3860;1914;6376
500720;201607;6208;16336;3906;12364;1002;3490;846;2688;1848;6178
500730;201607;1001;2742;678;2113;167;561;210;633;377;1194
500740;201607;4359;11715;3447;10051;418;1482;1596;4781;2014;6263
500750;201607;970;2649;803;2384;153;517;423;1215;576;1732
500755;201607;1210;3512;814;2710;190;679;165;445;355;1124
500769;201607;5502;14399;3105;9532;565;1942;620;1673;1185;3615
500770;201607;1742;5030;1221;4029;316;1149;310;1055;626;2204
500780;201607;1155;3276;900;2816;231;747;248;778;479;1525
500790;201607;9939;26788;8150;23811;1467;4840;4311;12432;5778;17272
500793;201607;2255;6394;1707;5447;502;1693;336;948;838;2641
500795;201607;2410;7067;2036;6538;245;691;1434;4945;1679;5636
500797;201607;843;2268;578;1804;110;386;218;650;328;1036
500800;201607;2963;7814;2231;6758;787;2697;583;1871;1370;4568
500830;201607;19921;52464;13872;41407;2774;9232;4777;13699;7551;22931
500840;201607;1352;3726;882;2782;120;418;340;1031;460;1449
510010;201607;1263;3692;1020;3296;245;792;538;1788;783;2580
510020;201607;3426;9590;2090;6914;502;1817;476;1472;978;3289
510025;201607;7649;22085;5657;18297;1366;4832;1567;4807;2933;9639
510030;201607;1691;4541;1373;4054;262;877;700;2030;962;2907
510035;201607;845;2392;617;2055;113;407;353;1204;466;1611
510040;201607;1773;4800;1366;4177;224;732;741;2299;965;3031
510050;201607;1866;5359;1339;4352;356;1279;414;1314;770;2593
510060;201607;1611;4552;1217;3810;233;799;498;1531;731;2330
510080;201607;1054;3314;828;2869;266;1016;135;408;401;1424
510100;201607;686;1777;477;1358;43;143;239;640;282;783
510120;201607;311;670;200;529;13;44;137;363;150;407
510125;201607;3179;8263;2394;6900;409;1401;950;2575;1359;3976
510130;201607;1774;4885;1446;4334;388;1284;478;1419;866;2703
510140;201607;2857;8979;2237;8040;986;3957;449;1432;1435;5389
510160;201607;1317;4393;1197;4214;187;708;772;2731;959;3439
510170;201607;5216;15673;4236;13982;844;3096;1934;6276;2778;9372
510180;201607;12388;31848;8511;25728;2411;7783;2560;8798;4971;16581
510185;201607;1355;3992;1116;3658;145;464;720;2634;865;3098
510190;201607;2386;6689;1685;5647;300;1089;854;3025;1154;4114
510250;201607;13976;41780;11963;38747;3724;12858;4554;15474;8278;28332
510260;201607;2157;8862;1817;8192;374;1585;939;4921;1313;6506
510263;201607;4129;10951;3016;9187;780;2582;789;2327;1569;4909
510267;201607;5747;16533;3980;12787;877;3114;956;2931;1833;6045
510268;201607;888;2569;760;2391;142;498;451;1412;593;1910
510269;201607;1003;3065;735;2554;263;962;162;556;425;1518
510270;201607;2741;8844;2253;7857;497;1804;857;2954;1354;4758
510279;201607;1828;5584;1466;4836;396;1393;461;1401;857;2794
510285;201607;1244;3616;957;3129;266;950;299;947;565;1897
510300;201607;3391;9736;2767;8856;218;812;2055;6671;2273;7483
510305;201607;1510;4650;1162;4012;285;1067;378;1339;663;2406
510310;201607;789;2390;654;2142;227;774;201;655;428;1429
510320;201607;3686;10418;2817;8845;565;2104;879;2659;1444;4763
510325;201607;5184;16120;4369;15022;1012;3550;2661;9650;3673;13200
510330;201607;2749;8595;2174;7569;577;2160;745;2671;1322;4831
510335;201607;4931;14644;3978;13456;498;1688;2731;9791;3229;11479
510336;201607;594;1819;438;1526;85;323;213;742;298;1065
510337;201607;2044;6630;1620;5824;651;2462;304;1176;955;3638
510340;201607;77633;205374;53620;167599;17483;61224;10422;34438;27905;95662
510343;201607;1122;3190;866;2718;108;362;517;1627;625;1989
510345;201607;1622;4783;1295;4212;313;1118;480;1526;793;2644
510350;201607;3246;8696;2436;7560;594;1983;1108;3613;1702;5596
510360;201607;1765;4302;1117;3513;114;450;774;2407;888;2857
510370;201607;1289;4195;1057;3820;236;892;566;2172;802;3064
510380;201607;526;1532;302;1053;93;351;27;91;120;442
510385;201607;950;3568;688;2965;98;455;309;1489;407;1944
510390;201607;1093;3447;959;3215;258;821;506;1806;764;2627
510395;201607;774;1873;551;1554;74;241;236;755;310;996
510410;201607;3821;12272;3293;11269;834;2929;1618;5764;2452;8693
510420;201607;2431;6083;1801;5059;189;644;951;2654;1140;3298
510450;201607;656;1716;454;1398;111;387;133;405;244;792
510452;201607;672;2126;505;1740;88;338;273;936;361;1274
510454;201607;851;2678;721;2425;99;354;479;1642;578;1996
510455;201607;975;2980;724;2444;140;552;251;803;391;1355
510460;201607;2303;5955;1718;5126;205;732;965;2788;1170;3520
510480;201607;4575;11847;3225;9439;674;2085;1022;2853;1696;4938
510490;201607;1600;4930;1349;4547;305;1177;736;2424;1041;3601
510500;201607;1521;4490;1031;3526;223;907;452;1483;675;2390
510510;201607;2672;9127;2285;8428;709;2836;649;2495;1358;5331
510515;201607;6312;18872;4505;14939;1067;3932;1037;3271;2104;7203
510517;201607;1621;4827;1309;4240;375;1259;323;1053;698;2312
510520;201607;2125;4850;1521;4111;47;134;1032;3035;1079;3169
510523;201607;1003;2936;885;2736;108;321;635;2047;743;2368
510525;201607;8146;21196;5537;17103;1161;3739;1959;6036;3120;9775
510530;201607;528;1495;442;1373;51;228;295;868;346;1096
510550;201607;2754;8866;2144;7670;603;2311;727;2644;1330;4955
510558;201607;1900;5438;1613;5026;212;719;943;3094;1155;3813
510560;201607;1710;5114;1099;4097;318;1315;250;981;568;2296
510562;201607;5395;15674;4073;13053;1157;4008;1014;3420;2171;7428
510590;201607;3069;8088;2556;7445;482;1405;1510;4645;1992;6050
510600;201607;1615;4106;1066;3197;210;689;393;1154;603;1843
510610;201607;2943;8276;2353;7385;247;927;1542;4813;1789;5740
510615;201607;2059;6217;1723;5671;516;1765;762;2629;1278;4394
510617;201607;609;1786;506;1612;30;86;406;1346;436;1432
510618;201607;1492;4260;1080;3464;208;789;490;1518;698;2307
510619;201607;800;2202;476;1585;56;207;59;163;115;370
510620;201607;1426;3548;795;2556;207;748;112;332;319;1080
510621;201607;882;3013;779;2807;208;834;220;758;428;1592
510622;201607;3873;11702;2756;9338;761;2841;504;1575;1265;4416
510623;201607;3271;9273;2568;8042;672;2343;910;2706;1582;5049
510624;201607;1497;4327;922;3118;199;758;192;610;391;1368
510625;201607;2079;5803;1579;4973;461;1635;294;952;755;2587
510626;201607;1579;4187;1025;3397;330;1223;238;819;568;2042
510627;201607;723;2065;484;1554;130;466;109;349;239;815
510628;201607;1567;3862;1096;3208;167;490;688;2042;855;2532
510629;201607;1783;5748;1432;4981;433;1640;448;1564;881;3204
510630;201607;2501;8379;1795;6886;455;1898;299;1206;754;3104
510631;201607;377;1064;323;970;20;54;260;789;280;843
510637;201607;2728;7947;2328;7304;737;2528;828;2602;1565;5130
510642;201607;4714;15501;4053;14540;1159;4583;1796;6763;2955;11346
510645;201607;974;2203;624;1731;195;540;183;542;378;1082
510650;201607;6313;20685;5680;19947;1398;5090;3537;13032;4935;18122
510665;201607;1740;4504;1052;3244;197;640;393;1260;590;1900
510670;201607;401;906;226;657;27;101;109;311;136;412
510675;201607;6482;20106;5138;17496;1552;5811;1189;4073;2741;9884
510677;201607;1909;5183;1576;4756;180;552;1165;3697;1345;4249
510680;201607;723;2173;529;1780;134;485;92;285;226;770
510682;201607;2107;6681;1607;5704;485;1947;317;1096;802;3043
510685;201607;954;2527;756;2232;81;291;481;1379;562;1670
510700;201607;4323;11099;2915;9119;650;2097;1354;4417;2004;6514
510704;201607;9702;25533;7475;21833;1478;4852;3232;8979;4710;13831
510706;201607;1901;5669;1301;4770;291;1085;665;2614;956;3699
510710;201607;3368;9231;2365;7227;573;1837;667;1909;1240;3746
510715;201607;725;1761;475;1330;79;223;187;550;266;773
510718;201607;2346;5803;1526;4842;691;2261;350;1312;1041;3573
510719;201607;405;935;259;742;25;93;123;350;148;443
510720;201607;1160;2820;836;2377;217;697;294;742;511;1439
510724;201607;725;2178;561;1875;123;462;221;697;344;1159
510726;201607;632;1546;471;1298;77;242;264;678;341;920
510729;201607;724;1810;400;1212;98;337;127;378;225;715
510730;201607;2781;7912;2027;6542;566;2010;533;1684;1099;3694
510735;201607;994;3247;766;2892;168;703;382;1470;550;2173
510740;201607;1146;2756;803;2254;147;397;412;1236;559;1633
510757;201607;721;2363;593;2122;287;1062;156;548;443;1610
510760;201607;32274;81795;21510;64388;6119;20249;4648;13579;10767;33828
510770;201607;4384;11012;3684;10170;372;991;2439;7488;2811;8479
510774;201607;354;985;313;920;62;187;157;503;219;690
510775;201607;713;2088;584;1863;181;646;162;478;343;1124
510776;201607;545;1496;413;1221;100;327;165;473;265;800
510777;201607;1590;4636;1173;4078;119;437;938;3317;1057;3754
510779;201607;634;1900;481;1612;79;272;228;795;307;1067
510780;201607;3757;11004;3055;9941;755;2553;1263;4479;2018;7032
510785;201607;1753;5063;1280;4236;400;1387;245;858;645;2245
510787;201607;2298;6842;1804;5984;795;2798;319;1027;1114;3825
510788;201607;567;1449;406;1217;132;394;125;456;257;850
510790;201607;16053;46176;10927;36502;2441;9418;1205;4207;3646;13625
510792;201607;8289;23995;5611;18942;1210;4561;911;2987;2121;7548
510794;201607;1211;3754;970;3286;308;1162;279;914;587;2076
510795;201607;8129;24051;5929;19977;1701;6341;1208;4371;2909;10712
510800;201607;1606;4479;1270;3991;299;1030;543;1594;842;2624
510805;201607;1983;5441;1494;4656;299;1047;735;2194;1034;3241
510810;201607;661;1623;506;1407;132;370;247;676;379;1046
510820;201607;729;1709;476;1331;81;279;189;468;270;747
510830;201607;698;2061;565;1860;128;444;284;1004;412;1448
510835;201607;646;1904;486;1608;111;410;197;619;308;1029
510840;201607;47331;117748;37455;104894;8855;26235;17651;51244;26506;77479
510850;201607;1627;4486;1062;3454;287;1027;154;458;441;1485
510860;201607;2681;8202;1909;6711;685;2700;152;518;837;3218
510880;201607;624;2058;531;1893;145;554;228;841;373;1395
510885;201607;647;1802;519;1627;97;347;217;674;314;1021
510890;201607;842;2620;685;2389;169;665;341;1189;510;1854
510895;201607;1104;3366;918;3000;222;828;362;1113;584;1941
520005;201607;1466;4622;1292;4371;329;1116;670;2386;999;3502
520010;201607;1737;5789;1405;5109;542;2253;258;848;800;3101
520013;201607;3377;9431;2487;7759;580;1884;811;2585;1391;4469
520015;201607;473;1344;382;1214;98;345;137;449;235;794
520017;201607;1065;3123;880;2809;214;765;354;1066;568;1831
520020;201607;459;1173;352;1026;76;239;156;444;232;683
520025;201607;27364;83698;25603;81549;2869;9957;20264;64590;23133;74547
520030;201607;4673;14377;3891;13083;718;2677;2023;6905;2741;9582
520050;201607;427;1072;292;858;22;60;183;562;205;622
520055;201607;756;2271;662;2079;113;337;375;1220;488;1557
520060;201607;1350;4206;1147;3807;268;1024;423;1344;691;2368
520080;201607;1839;5291;1538;4897;285;869;891;3044;1176;3913
520082;201607;1090;2916;962;2715;115;281;654;1922;769;2203
520085;201607;832;2498;722;2308;171;549;250;794;421;1343
520090;201607;981;2261;707;1923;138;322;381;1156;519;1478
520110;201607;41998;120480;32475;106090;12313;45855;5134;16754;17447;62609
520120;201607;189;496;123;384;22;80;35;114;57;194
520130;201607;3390;9463;3064;8995;604;1954;1687;5097;2291;7051
520140;201607;37569;120220;31770;109585;11871;44695;5523;19207;17394;63902
520145;201607;362;986;253;789;55;185;77;235;132;420
520150;201607;488;1273;396;1168;65;220;222;645;287;865
520160;201607;890;2382;719;2129;221;677;211;647;432;1324
520170;201607;4405;10041;3431;8931;237;657;2834;7526;3071;8183
520180;201607;2098;6095;1736;5557;312;1181;907;2885;1219;4066
520215;201607;1966;4991;1612;4439;185;533;1048;2944;1233;3477
520235;201607;700;1803;509;1517;96;333;222;635;318;968
520250;201607;1549;4377;1114;3644;302;1100;264;858;566;1958
520260;201607;792;1996;520;1499;84;267;189;515;273;782
520280;201607;563;1625;497;1539;163;515;207;724;370;1239
520310;201607;1213;2885;844;2294;216;646;296;879;512;1525
520320;201607;1874;5770;1539;5142;126;440;1004;3440;1130;3880
520330;201607;2710;8268;2062;7164;596;2273;333;1147;929;3420
520340;201607;1858;4654;1421;4077;197;493;941;2903;1138;3396
520350;201607;3295;8879;2530;7500;664;2163;967;2819;1631;4982
520355;201607;1098;3574;979;3392;284;1101;441;1485;725;2586
520357;201607;863;2330;718;2088;73;237;490;1438;563;1675
520360;201607;693;1990;587;1814;163;526;231;741;394;1267
520380;201607;1300;3483;872;2654;136;454;369;1094;505;1548
520390;201607;1096;2572;638;1970;191;695;213;603;404;1298
520393;201607;519;1248;408;1092;56;165;244;642;300;807
520396;201607;697;2239;571;1990;79;322;358;1220;437;1542
520400;201607;1674;4783;1417;4407;266;900;860;2657;1126;3557
520410;201607;1524;3658;1097;3058;216;690;594;1628;810;2318
520420;201607;324;895;236;716;44;151;83;227;127;378
520425;201607;1184;3259;969;2870;272;815;436;1334;708;2149
520430;201607;1901;5015;1176;3650;285;914;199;565;484;1479
520440;201607;3722;9521;2491;7317;742;2394;535;1580;1277;3974
520450;201607;10688;29165;7268;22968;1658;5806;508;1572;2166;7378
520455;201607;676;1990;540;1762;163;569;205;673;368;1242
520460;201607;891;2500;729;2231;122;444;414;1235;536;1679
520465;201607;822;2262;709;2122;91;311;468;1379;559;1690
520470;201607;1762;5631;1572;5335;301;1041;1032;3640;1333;4681
520480;201607;952;2721;655;2168;122;442;211;621;333;1063
520485;201607;1305;4074;1133;3811;269;1019;651;2181;920;3200
520490;201607;4086;12565;3234;11244;790;2799;1636;6004;2426;8803
520495;201607;1357;3587;1144;3318;89;274;900;2699;989;2973
520500;201607;1318;3689;1084;3353;263;911;489;1493;752;2404
520505;201607;737;2085;627;1911;107;310;350;1087;457;1397
520510;201607;9116;25317;6544;21298;1624;5893;2163;7247;3787;13140
520520;201607;1080;2975;857;2656;263;876;266;853;529;1729
520530;201607;2000;6510;1633;5886;565;2050;516;2085;1081;4135
520540;201607;2851;7961;2079;6513;572;1916;382;1230;954;3146
520545;201607;1089;3256;899;2913;185;663;282;861;467;1524
520547;201607;655;2065;564;1895;195;662;191;632;386;1294
520549;201607;9632;28148;8030;25980;2265;7673;3825;12766;6090;20439
520551;201607;3649;11038;3351;10615;773;2709;2116;6663;2889;9372
520552;201607;772;2301;693;2201;112;371;488;1586;600;1957
520570;201607;564;1578;418;1337;136;481;145;438;281;919
520580;201607;3235;7877;2260;6541;480;1550;1145;3332;1625;4882
520590;201607;1406;3965;1075;3398;271;897;229;727;500;1624
520620;201607;7718;23187;6846;22003;1605;5369;3942;12905;5547;18274
520630;201607;928;2367;666;1985;102;320;290;867;392;1187
520640;201607;2798;7642;2285;6789;594;1826;933;2876;1527;4702
520650;201607;848;2253;622;1838;117;403;339;983;456;1386
520660;201607;348;988;273;888;101;366;91;300;192;666
520670;201607;950;2782;857;2652;54;192;682;2079;736;2271
520680;201607;766;1995;597;1736;148;435;269;803;417;1238
520690;201607;325;856;246;734;59;156;117;362;176;518
520710;201607;552;1425;345;1025;9;24;207;613;216;637
520725;201607;1602;4089;1189;3407;183;577;739;2113;922;2690
520735;201607;815;2229;577;1785;130;460;194;588;324;1048
520740;201607;1713;4604;1360;4161;258;887;723;2201;981;3088
520750;201607;618;1654;488;1458;105;305;238;762;343;1067
520753;201607;1463;3939;1315;3739;151;407;906;2772;1057;3179
520760;201607;821;2172;720;2041;73;205;524;1565;597;1770
520780;201607;1939;4709;1508;4120;151;424;986;2689;1137;3113
520790;201607;2831;7200;2189;6269;196;543;1577;4739;1773;5282
520800;201607;16214;45416;13909;42696;2574;7661;8877;29043;11451;36704
520810;201607;1068;2612;830;2331;72;206;640;1907;712;2113
520815;201607;586;1847;428;1507;183;726;25;77;208;803
520830;201607;1655;4197;1338;3848;55;173;1147;3295;1202;3468
520840;201607;1658;5321;1401;4884;558;2094;308;1146;866;3240
520850;201607;594;1814;445;1551;121;484;137;480;258;964
520860;201607;6626;19368;4997;16680;1238;4495;1759;6072;2997;10567
520870;201607;102657;272070;72085;223099;21205;72837;16360;49900;37565;122737
520880;201607;7060;20161;5333;17676;2082;7652;697;2354;2779;10006
520890;201607;3867;10758;3086;9478;630;2154;1520;4656;2150;6810
520910;201607;3881;11085;2805;9047;989;3440;539;1686;1528;5126
520915;201607;650;1930;528;1696;113;391;253;813;366;1204
520920;201607;3479;9277;2487;7734;460;1572;1023;3312;1483;4884
520929;201607;610;1616;476;1409;95;258;247;790;342;1048
520940;201607;1068;3044;857;2737;95;349;617;1965;712;2314
520945;201607;657;1579;524;1365;112;258;271;704;383;962
520960;201607;1039;3018;813;2597;85;283;419;1379;504;1662
520970;201607;2868;8636;2468;7936;695;2461;660;2080;1355;4541
520980;201607;762;2189;669;2052;187;623;374;1146;561;1769
520990;201607;2972;9466;2795;9226;359;1236;1954;6772;2313;8008
520993;201607;933;2365;740;2087;52;160;546;1566;598;1726
520995;201607;2322;6135;2017;5768;328;877;1386;4103;1714;4980
521000;201607;7092;21254;5765;18768;1966;7096;1444;4515;3410;11611
521010;201607;4021;11631;3150;10053;778;2514;1272;4111;2050;6625
521015;201607;695;1904;593;1746;117;344;366;1086;483;1430
521020;201607;3012;8615;2079;6692;630;2192;231;717;861;2909
521030;201607;664;1666;497;1388;90;244;206;604;296;848
521040;201607;6112;16441;5110;14939;1562;4724;1876;5813;3438;10537
521056;201607;857;2594;709;2351;232;831;250;899;482;1730
521060;201607;1119;2893;899;2563;154;448;487;1464;641;1912
521080;201607;1141;2715;676;1969;79;285;264;666;343;951
521090;201607;2977;7953;2333;7116;741;2371;734;2346;1475;4717
521100;201607;2015;4556;1508;3913;219;534;1019;2776;1238;3310
521120;201607;4719;12198;3651;10845;732;2259;1710;5477;2442;7736
521130;201607;1025;2760;766;2274;107;394;444;1303;551;1697
521140;201607;1041;3142;847;2770;215;746;293;984;508;1730
521150;201607;12206;30407;7772;22784;2664;8302;1909;5812;4573;14114
521160;201607;851;1990;538;1464;99;284;238;634;337;918
521170;201607;1150;2798;864;2383;149;430;510;1386;659;1816
521180;201607;6453;20697;5806;19602;1688;6065;2047;7039;3735;13104
521190;201607;9415;26826;6289;21006;1654;6135;1316;4404;2970;10539
521200;201607;759;2069;612;1823;72;242;368;1099;440;1341
521205;201607;608;1712;470;1463;45;155;270;844;315;999
521210;201607;933;2579;605;1922;176;650;124;333;300;983
521220;201607;4391;11065;3288;9633;712;2321;1597;4775;2309;7096
521225;201607;392;951;318;870;31;80;231;663;262;743
521230;201607;1176;3728;1078;3541;318;1117;555;1800;873;2917
521250;201607;29471;91037;25380;84910;10610;37344;7312;25818;17922;63162
521260;201607;703;1692;578;1516;105;312;318;815;423;1127
521270;201607;1894;5381;1716;5136;156;400;1294;4054;1450;4454
521280;201607;1847;5566;1510;4921;457;1581;467;1516;924;3097
521290;201607;494;1365;367;1171;99;372;169;512;268;884
521295;201607;1192;2892;988;2619;103;261;728;2001;831;2262
521300;201607;1926;5389;1646;4946;200;609;1037;3169;1237;3778
521305;201607;748;2102;613;1895;116;350;342;1100;458;1450
521308;201607;4414;12972;3486;11176;899;2992;1444;4633;2343;7625
521310;201607;8033;23471;5701;18931;1552;5641;1183;3719;2735;9360
521340;201607;328;847;307;823;15;48;265;702;280;750
521350;201607;1980;5415;1606;4819;248;736;1013;3131;1261;3867
521370;201607;947;2748;695;2294;223;810;145;476;368;1286
521375;201607;1281;3700;1101;3386;283;958;513;1455;796;2413
521377;201607;1091;2763;1000;2661;57;121;873;2366;930;2487
521380;201607;5521;15560;3958;12653;610;2098;1058;3541;1668;5639
521385;201607;508;1356;448;1281;122;375;226;673;348;1048
521390;201607;802;2216;645;2007;216;791;201;610;417;1401
521400;201607;2044;5829;1886;5639;218;711;1486;4483;1704;5194
521405;201607;1391;3877;1084;3323;308;1001;457;1441;765;2442
521410;201607;717;2177;671;2106;213;625;325;1115;538;1740
521440;201607;1381;3989;1124;3451;208;722;422;1143;630;1865
521450;201607;3927;12588;3174;11112;1064;3982;640;2207;1704;6189
521460;201607;6729;19254;5560;17277;1453;4908;2523;7756;3976;12664
521470;201607;696;2002;518;1654;119;409;93;301;212;710
521480;201607;374;1116;252;851;52;182;85;287;137;469
521483;201607;2833;7359;2142;6173;564;1681;649;1854;1213;3535
521486;201607;1628;4118;1314;3666;107;281;978;2753;1085;3034
521487;201607;576;1471;406;1195;120;394;85;230;205;624
521490;201607;789;2238;629;1979;58;239;416;1264;474;1503
521500;201607;1351;4216;1012;3490;200;804;251;758;451;1562
521520;201607;891;2093;672;1802;158;436;339;982;497;1418
521523;201607;13254;47096;12346;45557;4340;17234;2017;8441;6357;25675
521525;201607;1056;2714;892;2473;115;381;574;1557;689;1938
521530;201607;1741;4946;1091;3611;263;939;158;514;421;1453
521540;201607;944;2542;654;2055;152;567;223;680;375;1247
521550;201607;1450;3703;957;2696;186;559;463;1272;649;1831
521560;201607;3704;11986;3075;11104;1148;4585;1131;4092;2279;8677
521565;201607;607;1568;512;1450;81;229;336;950;417;1179
521570;201607;4652;12778;2976;9466;722;2519;565;1858;1287;4377
521580;201607;562;1292;349;992;88;257;65;177;153;434
521590;201607;650;1789;523;1591;155;529;156;449;311;978
521600;201607;501;1375;353;1117;99;328;82;257;181;585
521630;201607;1371;3427;975;2853;247;879;201;514;448;1393
521640;201607;2078;5257;1604;4612;413;1219;718;2142;1131;3361
521645;201607;582;1704;433;1395;87;294;150;457;237;751
521680;201607;1364;4362;1151;3955;518;1899;159;536;677;2435
521690;201607;574;1660;506;1545;132;475;234;664;366;1139
521710;201607;2898;8451;2302;7414;517;1767;778;2549;1295;4316
521720;201607;1898;5354;1500;4645;274;875;790;2383;1064;3258
521730;201607;3673;11913;3179;10933;1219;4616;663;2029;1882;6645
521740;201607;3642;9999;2876;8902;619;2108;1353;4455;1972;6563
521760;201607;13676;43668;11931;40699;3251;12160;4859;16862;8110;29022
521770;201607;2621;7565;2108;6631;762;2592;600;1814;1362;4406
521800;201607;6977;21028;5978;19330;1831;6323;2241;7595;4072;13918
521805;201607;932;2093;671;1719;139;313;380;1055;519;1368
521810;201607;808;1998;590;1689;105;320;268;816;373;1136
521830;201607;5242;16472;4681;15644;687;2528;3238;10893;3925;13421
521839;201607;729;1987;540;1643;103;343;214;623;317;966
521850;201607;6918;18389;5252;15546;1261;3979;1555;4358;2816;8337
521860;201607;2065;5509;1579;4771;377;1327;475;1423;852;2750
521870;201607;499;1635;412;1456;108;398;145;491;253;889
521878;201607;785;2238;556;1763;90;325;224;667;314;992
521880;201607;23522;59958;15824;47660;4153;13459;4860;15297;9013;28756
521890;201607;3432;10101;2618;8539;755;2678;498;1586;1253;4264
521900;201607;1462;3820;1017;3158;263;898;369;1083;632;1981
521910;201607;910;2455;806;2333;145;449;460;1423;605;1872
521920;201607;297;940;245;844;91;349;54;175;145;524
521925;201607;676;2051;559;1836;118;417;202;627;320;1044
521930;201607;3580;11415;3073;10452;1091;3919;561;1982;1652;5901
521935;201607;604;1699;515;1538;116;347;261;764;377;1111
521940;201607;1013;2774;827;2495;168;587;443;1297;611;1884
521945;201607;679;2098;584;1948;102;341;318;1142;420;1483
521950;201607;646;1672;523;1493;64;203;354;1016;418;1219
521960;201607;661;1979;533;1727;110;393;235;758;345;1151
521970;201607;2667;6901;2201;6339;184;519;1755;5259;1939;5778
521971;201607;1031;2716;705;2120;120;379;181;523;301;902
521973;201607;953;2926;801;2655;160;561;394;1324;554;1885
521975;201607;12555;34280;11341;32826;1842;5608;7914;22961;9756;28569
521980;201607;2043;5599;1741;5230;232;602;1371;4317;1603;4919
521990;201607;1172;3298;941;2936;114;398;614;1951;728;2349
522000;201607;2285;6188;1655;5383;215;777;944;3256;1159;4033
522005;201607;398;966;275;780;87;248;97;285;184;533
522010;201607;3461;9840;2884;8887;1047;3325;676;2125;1723;5450
522015;201607;902;2648;752;2406;177;584;370;1194;547;1778
522020;201607;5178;13324;3975;11499;915;2765;2008;5786;2923;8551
522026;201607;631;1746;462;1537;108;391;168;601;276;992
522028;201607;537;1517;431;1286;52;157;266;790;318;947
522040;201607;2432;5879;1914;5241;359;986;1228;3443;1587;4429
522045;201607;15376;49635;12667;44159;3648;13993;2433;8511;6081;22504
522050;201607;1162;3279;821;2633;193;650;226;650;419;1300
522060;201607;2756;8036;2156;7116;589;2118;963;3239;1552;5357
522068;201607;1715;5300;1531;5086;160;462;1181;4158;1341;4620
522070;201607;703;2087;622;1954;77;301;431;1325;508;1626
522100;201607;509;1523;436;1417;145;529;199;625;344;1154
522108;201607;868;2638;722;2403;67;280;546;1778;613;2058
522119;201607;1386;4197;1160;3843;267;923;547;1889;814;2812
522130;201607;356;1001;289;921;76;247;176;577;252;824
522140;201607;17656;49118;14107;43024;4244;14048;3750;11007;7994;25055
522145;201607;824;2267;704;2088;236;689;299;981;535;1670
522150;201607;973;2578;796;2295;213;640;310;914;523;1554
522155;201607;825;2323;718;2158;138;377;448;1441;586;1818
522157;201607;658;1815;560;1674;44;157;440;1317;484;1474
522160;201607;5995;17002;4345;14028;1342;4795;460;1515;1802;6310
522170;201607;2316;6740;1852;5896;630;2140;441;1392;1071;3532
522180;201607;339;986;253;842;76;262;72;255;148;517
522185;201607;15420;43625;12672;40119;3360;11254;6605;21577;9965;32831
522190;201607;891;2199;678;1893;109;319;336;987;445;1306
522200;201607;1706;5465;1390;4789;373;1397;341;1124;714;2521
522205;201607;1401;3890;1124;3449;202;668;598;1822;800;2490
522220;201607;1405;3668;1130;3337;232;702;630;1997;862;2699
522230;201607;1226;3430;1032;3128;129;489;658;1989;787;2478
530010;201607;224564;694530;197597;648009;53733;195712;72184;233514;125917;429226
110001;201606;3349;11099;2963;10492;655;2447;1570;5662;2225;8109
110002;201606;13112;38242;10200;33172;3178;11208;3264;10618;6442;21826
110003;201606;750;2423;659;2252;210;762;160;532;370;1294
110004;201606;10011;31112;8105;27312;2604;9513;1566;5556;4170;15069
110005;201606;1807;5748;1558;5288;495;1735;661;2260;1156;3995
110006;201606;1910;5766;1296;4561;407;1542;166;541;573;2083
110007;201606;1310;4008;1216;3820;358;1195;509;1817;867;3012
110008;201606;2334;7954;2190;7762;333;1122;1645;6072;1978;7194
110009;201606;4565;13717;3556;12110;1084;3978;1137;3961;2221;7939
110010;201606;7494;22544;6586;21321;1793;5725;3340;11983;5133;17708
110011;201606;7456;23062;6362;20968;2218;7715;2128;7099;4346;14814
110012;201606;15279;43754;12044;38276;3565;12152;3269;10712;6834;22864
110013;201606;5251;16639;4524;15332;1807;6283;1269;4678;3076;10961
110014;201606;4035;11833;3499;10982;895;2916;1879;5977;2774;8893
110015;201606;4814;14366;3414;11664;998;3682;656;2256;1654;5938
110018;201606;4053;11423;2995;9830;792;2938;1100;3497;1892;6435
110020;201606;62784;171729;46668;149817;10486;36007;21075;70484;31561;106491
110025;201606;4222;12109;3434;10711;537;1830;2126;6558;2663;8388
110026;201606;625;1914;574;1836;135;411;333;1123;468;1534
110028;201606;6673;20094;5257;17349;1617;5894;723;2379;2340;8273
110029;201606;1356;3910;1093;3490;315;1049;471;1535;786;2584
110030;201606;10213;27755;7844;24540;2090;7265;3126;10078;5216;17343
110032;201606;3836;11969;3312;10985;1099;3804;999;3300;2098;7104
110033;201606;5168;16452;4634;15542;1593;5383;1730;6250;3323;11633
110034;201606;3381;9084;2769;8253;763;2376;1571;4693;2334;7069
110037;201606;1962;6607;1676;6051;424;1647;773;2786;1197;4433
110040;201606;3390;10597;2875;9655;889;3207;1111;3707;2000;6914
110045;201606;4979;16142;4311;15292;1355;5149;2086;7531;3441;12680
110050;201606;1628;5207;1381;4760;435;1599;626;2180;1061;3779
110060;201606;830;2697;661;2346;241;944;142;498;383;1442
110070;201606;1935;6486;1783;6171;548;2025;789;2664;1337;4689
110080;201606;4291;11734;3715;11080;548;1525;2703;8537;3251;10062
110090;201606;710;2097;558;1827;136;505;255;801;391;1306
110092;201606;1292;4305;1178;4144;193;733;780;2817;973;3550
110094;201606;3552;10607;3071;9940;1049;3595;1257;4144;2306;7739
110100;201606;2138;6771;1938;6402;507;1778;1026;3441;1533;5219
110110;201606;1593;5111;1413;4867;601;2105;384;1441;985;3546
110120;201606;1777;5588;1381;4730;431;1574;289;976;720;2550
110130;201606;2395;6919;1768;5811;583;2051;378;1269;961;3320
110140;201606;2326;7547;1917;6716;583;2238;504;1627;1087;3865
110143;201606;1218;3777;920;3262;293;1099;387;1410;680;2509
110145;201606;1004;2858;803;2536;205;709;410;1292;615;2001
110146;201606;439;1347;370;1242;70;233;208;722;278;955
110147;201606;702;2060;554;1797;146;508;203;618;349;1126
110148;201606;1200;3640;841;2820;180;643;101;312;281;955
110149;201606;3292;9857;2638;8799;882;2947;1113;3940;1995;6887
110150;201606;2398;6977;1992;6387;566;1958;777;2630;1343;4588
110155;201606;843;2598;745;2375;178;616;351;1077;529;1693
110160;201606;1900;6094;1589;5492;574;2052;570;2014;1144;4066
110170;201606;2811;7866;2026;6423;427;1440;1029;3270;1456;4710
110175;201606;1609;4921;1295;4499;221;815;711;2615;932;3430
110180;201606;1277;3722;1068;3410;266;845;604;1972;870;2817
120001;201606;2734;9363;2528;9037;525;1954;1572;5811;2097;7765
120005;201606;1527;6399;1429;6199;181;875;1040;4650;1221;5525
120010;201606;4562;15500;4361;15203;516;1784;3411;12208;3927;13992
120013;201606;1877;7503;1787;7369;414;1695;1091;4785;1505;6480
120017;201606;1957;7112;1826;6869;540;2027;838;3525;1378;5552
120020;201606;14080;62785;13586;61819;1982;9148;9850;46479;11832;55627
120025;201606;2404;8417;2315;8292;445;1646;1501;5510;1946;7156
120030;201606;6358;24768;6205;24593;238;1103;5668;22581;5906;23684
120032;201606;1454;7106;1398;6976;181;1068;1046;5237;1227;6305
120033;201606;3521;14126;3433;13968;248;1051;3004;12345;3252;13396
120034;201606;2118;8910;2027;8729;168;973;1648;7010;1816;7983
120035;201606;3085;13963;3007;13813;230;1190;2573;11948;2803;13138
120038;201606;2618;9511;2470;9231;610;2322;1373;5351;1983;7673
120039;201606;1683;8387;1641;8294;171;1018;1268;6488;1439;7506
120040;201606;44335;158403;40584;151463;10009;40338;20983;80168;30992;120506
120042;201606;2969;12543;2826;12220;288;1431;2130;9312;2418;10743
120043;201606;890;4187;859;4137;71;340;700;3500;771;3840
120045;201606;4246;14496;4138;14367;451;1683;3495;12174;3946;13857
120050;201606;8018;32906;7631;32084;1051;4751;5359;23257;6410;28008
120060;201606;7652;34037;7485;33744;743;3810;6003;27415;6746;31225
120070;201606;2652;9936;2576;9771;454;1736;1713;6697;2167;8433
120080;201606;3546;13463;3389;13193;582;2403;2436;9679;3018;12082
130002;201606;3045;12552;2866;12278;196;1003;2458;10569;2654;11572
130006;201606;1953;8291;1719;7868;261;1352;1218;5597;1479;6949
130008;201606;2195;8593;2035;8305;169;777;1648;6774;1817;7551
130010;201606;3014;9905;2757;9615;164;663;2463;8590;2627;9253
130014;201606;3140;10286;2758;9676;458;1748;1796;6372;2254;8120
130020;201606;2643;9828;2559;9681;102;539;2235;8350;2337;8889
130030;201606;7513;28350;7227;28021;343;1158;6585;26106;6928;27264
130040;201606;3744;11563;3320;10997;259;955;2708;9105;2967;10060
130050;201606;6011;24617;5674;24148;377;1641;4853;21230;5230;22871
130060;201606;5767;26871;5532;26492;543;3099;4423;21172;4966;24271
130063;201606;3740;16543;3608;16384;283;1388;3170;14544;3453;15932
130068;201606;3150;13208;2840;12552;345;1714;1960;8766;2305;10480
130070;201606;7140;23043;6306;22067;601;2133;5084;18249;5685;20382
130080;201606;5373;23616;5062;23157;694;3589;3715;17173;4409;20762
130083;201606;2141;8439;2015;8258;293;1374;1461;6000;1754;7374
130090;201606;2654;9525;2543;9358;107;493;2272;8361;2379;8854
130100;201606;5773;21181;5624;21001;157;664;5325;19944;5482;20608
130110;201606;6678;21417;6268;20939;629;1986;5182;17823;5811;19809
130115;201606;4480;15851;4262;15517;178;754;3790;13850;3968;14604
130120;201606;14716;55581;13778;54399;1305;5314;11404;46040;12709;51354
130130;201606;3878;15844;3819;15735;230;1151;3357;13825;3587;14976
130140;201606;6254;24331;6142;24205;201;838;5812;22970;6013;23808
130150;201606;3419;13478;3334;13375;167;909;3005;11947;3172;12856
130160;201606;4181;17372;4026;17169;458;2265;3302;14058;3760;16323
130165;201606;2858;11807;2718;11574;241;1238;2224;9477;2465;10715
130170;201606;9337;32896;8167;31466;907;3729;6430;25319;7337;29048
130180;201606;3480;11484;3411;11390;83;293;3231;10835;3314;11128
130185;201606;11445;36305;10209;34905;790;2369;8546;30679;9336;33048
130190;201606;16687;57389;14603;54712;2510;9536;9851;38552;12361;48088
130195;201606;1967;8239;1898;8146;111;469;1682;7352;1793;7821
130200;201606;2053;7077;1861;6785;404;1437;1182;4529;1586;5966
130210;201606;1248;4951;1175;4855;121;606;960;3946;1081;4552
130220;201606;2002;8172;1829;7847;324;1601;1111;4733;1435;6334
130230;201606;3638;16704;3406;16316;413;2075;2619;12929;3032;15004
130240;201606;8693;32530;7925;31481;418;2156;6909;27549;7327;29705
130250;201606;19555;68346;18382;66852;2593;9146;13724;52258;16317;61404
130255;201606;4334;14779;4037;14323;173;682;3569;12784;3742;13466
130260;201606;243362;795733;218469;753617;62546;230038;99080;348369;161626;578407
130270;201606;7369;30458;6850;29653;910;4003;5146;23043;6056;27046
130280;201606;3296;13678;3185;13546;111;505;2957;12729;3068;13234
130290;201606;11227;39468;10716;38881;190;559;10151;37559;10341;38118
130300;201606;4366;16955;4172;16652;247;1165;3649;14627;3896;15792
130310;201606;4953;19015;4578;18519;364;1628;3816;15649;4180;17277
130320;201606;2951;10576;2692;10221;374;1538;1896;7376;2270;8914
130330;201606;3560;13030;3245;12631;230;1125;2729;10622;2959;11747
130340;201606;17909;68290;16641;66724;2287;9123;13086;54146;15373;63269
130350;201606;3256;13582;3171;13456;291;1588;2656;11140;2947;12728
130353;201606;6018;18439;5271;17497;1079;3494;3346;11981;4425;15475
130356;201606;4549;16422;4272;16012;440;1659;3300;12799;3740;14458
130360;201606;3257;9294;2874;8888;102;272;2649;8374;2751;8646
130370;201606;5502;21055;4780;20132;234;1267;4078;17255;4312;18522
130380;201606;7926;32787;7641;32392;468;2275;6637;28314;7105;30589
130390;201606;4988;22197;4682;21618;606;3174;3433;15949;4039;19123
130395;201606;2139;7573;1911;7134;226;917;1358;5063;1584;5980
130400;201606;2122;8023;2019;7876;133;629;1786;6987;1919;7616
130406;201606;10586;40259;9640;38911;1919;7974;6467;26836;8386;34810
130410;201606;3892;14793;3504;14134;1066;4559;1645;6901;2711;11460
130420;201606;10602;44628;10135;43956;1886;8093;7377;33169;9263;41262
130423;201606;3266;12703;3041;12397;288;1422;2538;10286;2826;11708
130426;201606;2273;9766;2199;9647;193;911;1835;8188;2028;9099
130430;201606;3384;11998;3243;11792;291;1127;2692;9924;2983;11051
130440;201606;3486;12766;3298;12552;236;1010;2850;10906;3086;11916
140002;201606;1622;5344;1494;5167;137;553;1121;3880;1258;4433
140005;201606;3243;9203;3128;9076;54;136;3021;8821;3075;8957
140010;201606;55522;160977;45844;146789;11393;38741;20383;69074;31776;107815
140015;201606;2820;9092;2643;8876;170;526;2300;7915;2470;8441
140017;201606;3106;9872;2812;9499;282;965;2158;7584;2440;8549
140020;201606;4352;14834;3942;14262;560;2275;2796;10177;3356;12452
140023;201606;2133;7193;1862;6794;208;836;1358;5051;1566;5887
140028;201606;2081;5729;1921;5517;230;774;1443;4022;1673;4796
140030;201606;3657;11608;3403;11282;441;1320;2539;8723;2980;10043
140040;201606;1676;7844;1642;7789;100;605;1466;6902;1566;7507
140045;201606;2439;9051;2220;8749;422;1553;1481;6301;1903;7854
140047;201606;5509;16659;4845;15639;1241;4089;2338;8157;3579;12246
140050;201606;1354;4313;1212;4122;253;889;761;2671;1014;3560
140060;201606;1458;4449;1301;4206;252;872;877;2882;1129;3754
140070;201606;1542;8472;1490;8313;152;1007;1173;6555;1325;7562
150010;201606;35802;107459;33679;104640;2368;8265;27622;86228;29990;94493
150013;201606;1731;5042;1565;4852;170;496;1223;3909;1393;4405
150020;201606;12369;41528;11946;40949;1266;4028;9840;34681;11106;38709
150030;201606;7178;30394;6949;30049;669;2650;5822;25964;6491;28614
150034;201606;4255;11735;4008;11430;157;476;3621;10387;3778;10863
150040;201606;12836;40933;11083;38833;1422;4309;8498;31804;9920;36113
150050;201606;5612;22038;5351;21597;308;1521;4604;18613;4912;20134
150060;201606;17813;55418;16172;52867;3054;9884;10495;35640;13549;45524
150070;201606;5993;24316;5365;23656;285;1438;4844;21543;5129;22981
150080;201606;72966;188656;62097;174555;12007;33696;35094;104244;47101;137940
150085;201606;5456;18452;5182;18111;412;1219;4452;16077;4864;17296
150090;201606;10159;38852;9596;38025;864;3564;7615;30830;8479;34394
150095;201606;5257;17176;4788;16509;357;1188;3878;13844;4235;15032
150100;201606;3238;12109;3034;11756;207;976;2438;9320;2645;10296
150110;201606;3315;16444;3302;16420;232;1129;2917;14746;3149;15875
150120;201606;6471;23738;6314;23499;512;1799;5249;20198;5761;21997
150125;201606;709;2082;618;1974;111;384;410;1328;521;1712
150130;201606;22093;66931;20397;64598;2388;7495;15268;49638;17656;57133
150140;201606;162290;453280;151867;439814;16847;48525;116967;345321;133814;393846
150145;201606;4513;14376;4106;13853;501;1803;3191;10959;3692;12762
150150;201606;12020;36449;11041;35011;1783;6043;7394;23783;9177;29826
150157;201606;3121;9343;2725;8785;362;1311;1934;6334;2296;7645
150160;201606;3087;9865;2899;9593;824;2794;1643;5630;2467;8424
150170;201606;21537;79432;20343;77534;2872;11314;14771;57441;17643;68755
150172;201606;3086;10474;2707;9850;385;1457;1917;7155;2302;8612
150175;201606;1905;5799;1782;5662;142;471;1478;4862;1620;5333
150178;201606;10068;31096;8849;29727;1038;3728;6555;22752;7593;26480
150180;201606;18554;74006;17833;73078;1328;6092;15257;63065;16585;69157
150190;201606;6964;23777;6692;23407;238;973;6097;21448;6335;22421
150195;201606;5237;17216;4895;16676;221;809;4305;14796;4526;15605
150200;201606;5337;16833;5080;16537;108;390;4781;15673;4889;16063
150210;201606;24904;93133;24054;91954;2035;7949;19993;78520;22028;86469
150215;201606;7120;22421;6265;21071;1896;6557;2713;9490;4609;16047
150220;201606;11941;37096;10694;35159;2432;8343;5662;19125;8094;27468
150230;201606;11804;36905;10292;34811;1418;5165;6948;24032;8366;29197
150240;201606;35460;105043;30929;97226;10330;33706;9684;32096;20014;65802
150250;201606;4027;16758;3883;16550;708;2990;2759;12246;3467;15236
150260;201606;2035;8086;1939;7921;393;1629;1226;5178;1619;6807
150270;201606;8505;26081;6730;23810;1718;6314;3794;14005;5512;20319
150275;201606;5891;21376;5579;20883;696;2610;4170;16014;4866;18624
150276;201606;2128;6357;1892;6045;320;1100;1374;4424;1694;5524
150277;201606;4801;14799;4154;14003;702;2523;2884;9981;3586;12504
150280;201606;5850;26191;5673;25823;961;4432;4035;18851;4996;23283
150285;201606;2875;11130;2695;10819;397;1713;1850;7599;2247;9312
150290;201606;9896;28461;9460;27968;621;1605;8253;25103;8874;26708
150293;201606;9640;26138;7268;22897;2101;7076;2653;9276;4754;16352
150295;201606;7539;21915;6211;20374;1459;4782;3551;13000;5010;17782
150300;201606;1971;6538;1844;6367;125;590;1490;5080;1615;5670
150304;201606;4122;13021;3571;12155;596;2015;2343;8316;2939;10331
150307;201606;6539;21674;6077;21027;382;1395;5112;17774;5494;19169
150309;201606;6031;20846;5446;20007;1138;4057;3359;13124;4497;17181
150310;201606;6306;26896;6083;26561;592;2829;4949;21846;5541;24675
150320;201606;9413;23121;8675;22318;515;1241;7481;19511;7996;20752
150330;201606;13852;47111;12974;45825;1804;6391;9571;34934;11375;41325
150340;201606;2454;7869;2266;7576;237;859;1720;5783;1957;6642
150345;201606;6651;22002;6213;21418;585;2065;4989;17548;5574;19613
150350;201606;8043;24542;7457;23792;1111;3099;5617;18725;6728;21824
150360;201606;21082;65355;18423;61978;2978;10019;12572;44208;15550;54227
150370;201606;9921;35984;9223;35070;1138;4166;7153;28341;8291;32507
150375;201606;2872;12603;2778;12477;202;903;2410;11009;2612;11912
150380;201606;10040;28818;8860;27187;510;1662;7459;23212;7969;24874
150390;201606;7852;33851;7348;32942;1281;5654;4924;23014;6205;28668
150400;201606;5864;22978;5633;22523;474;1890;4524;18483;4998;20373
150405;201606;8231;24773;7319;23649;1099;2819;5226;18477;6325;21296
150410;201606;1577;5995;1457;5750;243;1136;899;3542;1142;4678
150420;201606;36399;121649;30712;112467;9978;39404;10162;40175;20140;79579
150430;201606;7405;24788;7037;24220;861;2918;5310;18762;6171;21680
150440;201606;5453;18747;5233;18448;671;2316;4034;14598;4705;16914
150442;201606;21668;62351;19157;58590;3335;10298;11816;37547;15151;47845
150445;201606;5218;18058;4840;17430;574;2060;3639;13444;4213;15504
150450;201606;4186;20365;4042;20140;390;2073;3323;16801;3713;18874
150460;201606;6973;25873;6429;25212;358;1754;5412;21937;5770;23691
150470;201606;17290;53353;16617;52564;409;1177;15689;50125;16098;51302
150475;201606;3238;11201;2990;10878;258;983;2465;9149;2723;10132
150480;201606;13898;47131;12822;45483;1239;4647;10218;36838;11457;41485
150490;201606;6966;26841;6807;26611;281;1279;6062;23893;6343;25172
150495;201606;4958;18339;4810;18146;176;730;4447;16891;4623;17621
150497;201606;2679;9850;2407;9325;764;3081;1098;4381;1862;7462
150500;201606;3152;8699;2920;8375;209;650;2376;6777;2585;7427
150503;201606;3606;11076;3080;10419;1000;3443;1661;5950;2661;9393
150506;201606;11020;38348;10025;36934;2237;7696;6375;25371;8612;33067
150510;201606;9687;37819;8855;36136;1427;5864;5888;25095;7315;30959
150520;201606;6679;26311;6560;26158;256;1034;6112;24614;6368;25648
150530;201606;12251;41709;11056;39892;1062;3818;8673;31925;9735;35743
150540;201606;4660;14151;4148;13446;284;999;3419;11122;3703;12121
150543;201606;5728;17656;5084;16743;1001;3375;3166;10846;4167;14221
150548;201606;9021;29035;8440;28298;414;1318;7666;26070;8080;27388
150549;201606;2032;6568;1867;6383;74;279;1698;5861;1772;6140
150550;201606;20090;63500;17558;59303;5245;18259;7047;25166;12292;43425
150553;201606;22826;78375;19063;70765;6982;27466;5039;19733;12021;47199
150555;201606;1716;5143;1449;4714;107;389;1076;3519;1183;3908
150560;201606;1937;6335;1816;6081;294;997;1146;3881;1440;4878
150563;201606;2695;8914;2493;8570;610;2281;1368;4744;1978;7025
150565;201606;3846;13223;3514;12705;175;836;2916;10583;3091;11419
150570;201606;5835;21195;5678;20927;452;2066;4568;16748;5020;18814
150580;201606;9602;40229;9345;39929;591;2517;8252;35989;8843;38506
150590;201606;5691;22661;5465;22378;201;970;5032;20646;5233;21616
150600;201606;7798;30265;7469;29793;375;1661;6664;26808;7039;28469
150610;201606;2404;8101;2188;7666;254;1005;1563;5421;1817;6426
150611;201606;2742;9432;2576;9136;177;696;2111;7517;2288;8213
150613;201606;12110;36133;9964;32927;3087;10780;4161;14291;7248;25071
150616;201606;3044;9269;2357;8136;596;2307;812;2690;1408;4997
150618;201606;6343;21660;5718;20543;1441;5281;3093;11548;4534;16829
150619;201606;5137;17520;4733;16886;551;2222;3475;12413;4026;14635
150620;201606;6337;22671;5782;21963;653;2523;4568;17809;5221;20332
150630;201606;5729;17318;5420;16954;504;1645;4493;14337;4997;15982
150635;201606;3983;12923;3566;12092;914;3253;1606;5634;2520;8887
150640;201606;1852;5585;1775;5492;173;492;1494;4846;1667;5338
150650;201606;12300;36945;10972;34690;2922;9429;4952;16428;7874;25857
150655;201606;5051;16703;4738;16138;644;2310;3472;11983;4116;14293
150658;201606;4471;13459;3886;12653;785;2813;2424;8181;3209;10994
150660;201606;5538;17310;5048;16596;1198;3922;2731;9334;3929;13256
150670;201606;7321;19262;6022;17669;650;1986;4710;14243;5360;16229
150680;201606;57744;200732;50302;188355;15124;58450;21248;86839;36372;145289
150690;201606;2045;6237;1841;5926;252;784;1279;4222;1531;5006
150700;201606;6135;19151;5613;18462;910;2970;3779;12883;4689;15853
150710;201606;4243;14294;3807;13584;426;1642;2763;10043;3189;11685
150715;201606;4947;15541;4306;14576;468;1796;3223;11005;3691;12801
150720;201606;6499;26213;6143;25578;791;3548;4540;19430;5331;22978
150730;201606;9917;33580;9188;32387;1042;3794;7171;25923;8213;29717
150740;201606;3679;11750;3288;11049;656;2331;1835;6223;2491;8554
150745;201606;5104;16244;4610;15563;1098;3857;2826;9660;3924;13517
150746;201606;1368;4446;1304;4335;146;531;962;3228;1108;3759
150747;201606;5311;16475;4704;15719;364;1057;3629;13071;3993;14128
150750;201606;3320;10753;3057;10415;215;881;2510;8598;2725;9479
150760;201606;11155;35738;10368;34724;1765;6047;7234;24839;8999;30886
150770;201606;5787;22119;5509;21653;346;1245;4712;19529;5058;20774
150775;201606;1124;3429;973;3161;211;830;526;1675;737;2505
150780;201606;3345;10824;3242;10711;112;414;2998;9949;3110;10363
150790;201606;4961;16228;4631;15836;315;1080;3752;13714;4067;14794
150795;201606;15147;48108;13667;45864;2883;9511;8368;29435;11251;38946
150796;201606;3101;9055;2811;8713;321;1062;2169;6869;2490;7931
150797;201606;3709;12633;3409;12113;131;587;2874;10193;3005;10780
150800;201606;13758;45089;12653;43729;2502;7950;8639;31906;11141;39856
150803;201606;6671;24043;6267;23394;723;2871;4722;17849;5445;20720
150805;201606;2587;9276;2404;8976;309;1188;1766;6702;2075;7890
150808;201606;5746;19058;4711;17063;1974;7743;686;2579;2660;10322
150810;201606;19005;58368;15912;54632;2329;7882;10701;38912;13030;46794
150812;201606;5167;16314;4764;15637;545;2123;3403;10889;3948;13012
150815;201606;8521;28073;7648;26983;777;2732;6111;22111;6888;24843
150820;201606;11389;32845;10193;31520;761;2053;8385;26737;9146;28790
150830;201606;12925;48402;12146;47386;760;3622;9993;40181;10753;43803
150835;201606;2092;7331;1945;7056;440;1641;1073;4006;1513;5647
150840;201606;7302;22198;6115;20216;1336;4859;3081;10183;4417;15042
160005;201606;796;2731;757;2653;73;302;610;2115;683;2417
160010;201606;1293;4332;1289;4327;38;74;1241;4230;1279;4304
160015;201606;1732;6441;1692;6383;58;179;1581;6073;1639;6252
160020;201606;1904;6880;1790;6731;211;867;1370;5255;1581;6122
160021;201606;1078;4643;1033;4565;147;755;754;3365;901;4120
160023;201606;995;4012;987;4002;100;409;828;3394;928;3803
160025;201606;1328;4055;1311;4038;25;102;1269;3894;1294;3996
160027;201606;8217;24365;7591;23673;1781;5368;5014;16471;6795;21839
160030;201606;47262;163739;41795;154680;9795;36366;22871;90686;32666;127052
160040;201606;4279;16754;4179;16615;186;1033;3813;14988;3999;16021
160050;201606;2982;11405;2669;10959;1243;4881;995;4606;2238;9487
160053;201606;2786;10658;2722;10565;561;2244;1858;7383;2419;9627
160055;201606;553;2193;546;2184;34;163;486;1937;520;2100
160060;201606;15420;52478;14360;51216;1955;6927;10935;40008;12890;46935
160070;201606;2550;10126;2402;9872;200;980;2008;8232;2208;9212
160080;201606;2544;9622;2500;9569;95;466;2338;8898;2433;9364
170025;201606;520;1682;467;1612;132;462;253;895;385;1357
170030;201606;1157;3804;1007;3536;243;874;431;1564;674;2438
170035;201606;1430;4146;1173;3689;201;679;573;1842;774;2521
170040;201606;1888;5926;1658;5637;226;829;1015;3759;1241;4588
170070;201606;1661;4463;1296;3974;266;899;708;2148;974;3047
170100;201606;2359;7058;2048;6593;221;741;1589;5191;1810;5932
170105;201606;748;2321;590;2005;131;522;281;908;412;1430
170110;201606;946;3102;817;2865;191;719;358;1285;549;2004
170130;201606;1339;4229;1100;3769;283;1005;513;1840;796;2845
170190;201606;1536;4518;1159;3908;392;1254;271;1122;663;2376
170200;201606;1589;4417;1027;3356;294;1043;232;740;526;1783
170210;201606;31256;88685;25118;78935;7959;27262;6422;21502;14381;48764
170215;201606;1199;3691;1015;3411;108;434;716;2411;824;2845
170220;201606;5561;19154;5125;18305;1232;4565;2725;9944;3957;14509
170230;201606;1377;4414;1133;3946;253;993;497;1709;750;2702
170240;201606;2727;8112;2224;7327;267;1053;1535;5043;1802;6096
170255;201606;3322;10594;2763;9613;841;2985;1150;4204;1991;7189
170270;201606;1012;2494;697;2067;63;185;471;1377;534;1562
170290;201606;2749;8225;2475;7910;241;544;2037;6989;2278;7533
170300;201606;1912;5860;1586;5329;196;758;1037;3528;1233;4286
170305;201606;730;2196;591;1942;91;340;317;1047;408;1387
170307;201606;1019;3601;860;3308;189;812;418;1673;607;2485
170310;201606;1589;4402;1196;3737;314;1042;538;1733;852;2775
170320;201606;1131;3250;818;2714;195;703;310;1063;505;1766
170330;201606;797;2584;722;2468;78;304;560;1896;638;2200
170360;201606;452;1430;375;1296;73;272;187;642;260;914
170370;201606;1338;3799;1035;3314;165;589;563;1815;728;2404
170380;201606;1719;5542;1388;4993;228;949;736;2685;964;3634
170382;201606;563;1864;465;1692;74;302;309;1146;383;1448
170384;201606;1564;6286;1427;6025;344;1554;774;3321;1118;4875
170386;201606;897;2664;776;2486;225;841;331;1019;556;1860
170388;201606;643;1932;528;1746;115;437;202;651;317;1088
170389;201606;915;3087;832;2950;64;277;634;2228;698;2505
170390;201606;1273;3636;1075;3390;86;306;851;2722;937;3028
170410;201606;532;1694;445;1541;47;201;279;964;326;1165
170460;201606;481;1324;321;1036;73;270;106;340;179;610
170510;201606;757;2525;600;2217;97;431;302;1089;399;1520
170550;201606;6804;19275;5019;16170;1640;5848;699;2334;2339;8182
170555;201606;1348;3849;1078;3434;202;704;549;1823;751;2527
170560;201606;1051;3413;824;3117;171;713;466;1860;637;2573
170600;201606;1316;3853;1160;3638;294;901;697;2267;991;3168
170610;201606;1669;5017;1331;4469;164;618;838;2827;1002;3445
170625;201606;418;1245;310;1027;51;179;109;353;160;532
170650;201606;1207;3898;1008;3544;284;1040;359;1390;643;2430
170700;201606;4126;12822;3334;11518;760;2896;1486;5381;2246;8277
170710;201606;1765;5213;1414;4579;241;828;815;2688;1056;3516
170720;201606;1837;4976;1565;4548;187;476;1184;3608;1371;4084
170730;201606;971;2845;786;2551;207;717;328;1096;535;1813
170740;201606;2163;7673;1876;7143;291;1171;1221;4711;1512;5882
170755;201606;766;2392;614;2056;106;410;255;846;361;1256
170765;201606;1295;3533;971;3005;262;834;403;1326;665;2160
170770;201606;1661;5655;1513;5403;286;1048;930;3403;1216;4451
170820;201606;3482;11263;3134;10692;692;2538;1591;5535;2283;8073
170825;201606;723;2163;607;1942;100;329;302;960;402;1289
170830;201606;1397;4061;1204;3778;73;155;1041;3383;1114;3538
170900;201606;2495;8888;2352;8661;204;829;1916;7130;2120;7959
170930;201606;3658;11040;3176;10273;817;2825;1462;4920;2279;7745
170950;201606;13679;39738;10195;33611;3229;12062;1735;5852;4964;17914
170980;201606;495;1439;365;1231;63;231;155;509;218;740
171050;201606;1486;5002;1336;4714;89;403;1056;3698;1145;4101
171070;201606;1439;4531;1313;4350;309;1017;760;2636;1069;3653
171090;201606;1064;2846;878;2592;63;196;653;1922;716;2118
171110;201606;589;1723;434;1436;121;467;186;558;307;1025
171150;201606;1026;2798;671;2174;108;379;397;1315;505;1694
171180;201606;694;2083;477;1632;116;413;188;693;304;1106
171190;201606;1619;6005;1430;5603;303;1244;700;2908;1003;4152
171195;201606;847;2944;726;2727;106;451;435;1655;541;2106
171200;201606;676;2122;536;1858;170;621;189;649;359;1270
171215;201606;463;1362;356;1146;59;218;167;545;226;763
171240;201606;694;2532;639;2425;76;365;420;1628;496;1993
171245;201606;615;2067;502;1800;123;487;168;595;291;1082
171250;201606;1030;3003;819;2657;184;646;406;1290;590;1936
171270;201606;395;1620;370;1566;118;483;160;755;278;1238
171280;201606;874;2664;722;2396;166;549;335;1216;501;1765
171320;201606;3767;11331;3161;10285;884;2926;1377;4695;2261;7621
171330;201606;2783;8092;2256;7268;624;2116;1038;3381;1662;5497
171360;201606;1361;4479;1231;4274;136;527;920;3220;1056;3747
171370;201606;636;1844;547;1722;118;416;309;977;427;1393
171380;201606;1263;4099;1054;3722;413;1474;291;1155;704;2629
171395;201606;882;2684;681;2297;135;568;320;1023;455;1591
171420;201606;2054;6347;1573;5419;401;1506;583;2021;984;3527
171430;201606;1060;3242;882;2952;186;629;485;1649;671;2278
171488;201606;2470;7556;2116;7042;480;1607;1192;4168;1672;5775
171500;201606;799;2387;667;2183;78;252;469;1578;547;1830
171510;201606;871;3052;780;2897;81;354;545;2058;626;2412
171515;201606;500;1431;384;1228;58;188;221;699;279;887
171525;201606;635;2021;541;1868;77;314;330;1095;407;1409
171550;201606;323;1101;247;952;89;368;60;248;149;616
171570;201606;1220;3858;1066;3557;217;714;685;2359;902;3073
171575;201606;1897;5336;1427;4490;278;916;676;2153;954;3069
171610;201606;5233;16674;4382;15202;1210;4673;1436;5087;2646;9760
171620;201606;2653;7668;2278;7170;130;531;1874;5907;2004;6438
171630;201606;870;2675;718;2434;193;695;352;1214;545;1909
171650;201606;2130;6640;1659;5682;457;1669;579;2002;1036;3671
171660;201606;2387;6671;1852;5721;262;874;1026;3168;1288;4042
171665;201606;1459;4248;1165;3797;190;686;660;2256;850;2942
171670;201606;1900;5377;1564;4837;426;1446;673;2058;1099;3504
171700;201606;1096;3506;930;3199;147;562;566;1937;713;2499
171720;201606;704;2092;597;1922;177;598;267;895;444;1493
171750;201606;1145;3579;886;3071;268;931;272;1009;540;1940
171780;201606;1124;3084;836;2670;105;378;456;1475;561;1853
171790;201606;1345;4739;1203;4481;269;965;713;2829;982;3794
171800;201606;652;2052;574;1934;71;247;395;1387;466;1634
171820;201606;10105;30007;8392;27452;1708;6022;4428;14829;6136;20851
171830;201606;1368;5071;1215;4733;311;1208;561;2289;872;3497
171840;201606;775;2127;660;1973;44;136;540;1621;584;1757
171845;201606;704;1938;546;1672;85;285;295;927;380;1212
171850;201606;915;3250;811;3046;110;499;521;1941;631;2440
171855;201606;1111;3545;1015;3366;83;324;762;2501;845;2825
171865;201606;443;1471;382;1373;87;334;195;702;282;1036
171870;201606;721;2168;584;1922;151;531;220;787;371;1318
171875;201606;1246;4005;1042;3675;96;400;707;2488;803;2888
171880;201606;810;3050;789;3021;86;331;633;2488;719;2819
171884;201606;898;2476;664;2119;155;554;181;692;336;1246
171886;201606;1379;4491;1110;3949;347;1368;258;952;605;2320
171888;201606;706;2120;534;1780;64;227;299;1014;363;1241
171889;201606;503;1581;451;1497;83;269;245;886;328;1155
171890;201606;1184;3673;988;3395;159;625;610;2101;769;2726
171900;201606;488;1781;403;1565;106;438;174;696;280;1134
172000;201606;540;1767;468;1635;81;328;276;937;357;1265
172010;201606;1179;4069;1092;3921;119;520;808;2889;927;3409
172015;201606;331;1283;270;1160;54;236;144;631;198;867
172020;201606;2276;7563;2116;7310;260;949;1515;5318;1775;6267
172025;201606;691;2009;504;1689;87;333;259;901;346;1234
172030;201606;1131;3649;995;3425;74;330;760;2603;834;2933
172049;201606;1330;3434;968;2818;458;1473;360;965;818;2438
172065;201606;1352;3547;1106;3268;60;156;1000;3030;1060;3186
172080;201606;2376;7486;2044;6923;237;962;1339;4507;1576;5469
172085;201606;509;1417;361;1118;58;178;105;331;163;509
172090;201606;3634;10139;2987;9188;156;551;2470;7667;2626;8218
172093;201606;607;1804;476;1583;98;387;244;805;342;1192
172097;201606;593;1796;477;1604;114;406;184;627;298;1033
172100;201606;33709;98806;25728;85017;7413;27343;7006;23696;14419;51039
172110;201606;1649;6201;1463;5898;184;816;1067;4431;1251;5247
172120;201606;5031;15681;4170;14469;778;2722;2579;9350;3357;12072
172125;201606;243;777;202;702;47;189;94;331;141;520
172130;201606;550;1517;427;1316;42;162;275;834;317;996
172208;201606;2097;6194;1881;5892;278;930;1198;3789;1476;4719
172210;201606;2515;7630;2197;7183;476;1716;1274;4150;1750;5866
210005;201606;21659;67334;18291;62188;5875;21532;6980;24506;12855;46038
210010;201606;1658;6051;1496;5771;89;363;1212;4775;1301;5138
210015;201606;3405;10698;3023;10117;196;557;2575;8871;2771;9428
210020;201606;7138;17114;6684;16593;220;625;6107;15090;6327;15715
210030;201606;5472;18202;5137;17744;375;1725;4269;14628;4644;16353
210040;201606;1896;5198;1752;5032;79;241;1569;4532;1648;4773
210043;201606;6768;18914;5800;17708;642;1869;4194;13614;4836;15483
210047;201606;6478;24277;5892;23374;612;2795;4494;17896;5106;20691
210050;201606;2278;8405;1909;7694;635;2596;766;3390;1401;5986
210055;201606;1756;6038;1595;5788;110;458;1241;4516;1351;4974
210060;201606;7218;27956;6691;26983;1046;4450;4501;18654;5547;23104
210070;201606;7146;20971;6601;20307;174;642;6002;18597;6176;19239
210080;201606;3663;12630;3568;12511;48;227;3400;11952;3448;12179
210083;201606;4421;15393;4050;15002;124;519;3803;14166;3927;14685
210087;201606;2972;8699;2698;8349;280;889;2163;6813;2443;7702
210090;201606;10017;32574;9481;31733;523;1960;8246;27715;8769;29675
210095;201606;5954;21437;5706;21094;374;1539;4845;18126;5219;19665
210100;201606;7282;21756;6653;20970;569;2096;5375;16821;5944;18917
210110;201606;2840;9903;2731;9759;125;590;2456;8728;2581;9318
210120;201606;26188;71297;22784;67365;2539;6387;17160;53992;19699;60379
210125;201606;3549;11288;3425;11159;140;358;3102;10359;3242;10717
210130;201606;4118;12266;3798;11816;275;942;3156;9817;3431;10759
210135;201606;1672;4910;1449;4592;106;339;1167;3747;1273;4086
210140;201606;17008;54107;14775;51119;2554;9253;9613;34602;12167;43855
210150;201606;4628;11372;4148;10786;68;210;3886;10085;3954;10295
210160;201606;17578;55240;16506;53703;1321;3993;13582;45479;14903;49472
210170;201606;13965;49490;13561;48974;686;2648;12125;44266;12811;46914
210173;201606;2020;8111;1929;7961;98;552;1702;6987;1800;7539
210177;201606;3053;9425;2898;9245;142;451;2618;8452;2760;8903
210180;201606;1474;4507;1375;4358;65;257;1170;3687;1235;3944
210190;201606;4866;15427;4464;14693;247;1140;3500;11278;3747;12418
210193;201606;1392;4366;1254;4139;70;253;1035;3465;1105;3718
210197;201606;2086;6953;1924;6759;234;821;1502;5451;1736;6272
210200;201606;8348;28084;7723;27190;985;3283;5930;21749;6915;25032
210203;201606;6718;21215;6344;20736;407;1214;5551;18481;5958;19695
210207;201606;3028;9813;2845;9485;278;920;2144;7311;2422;8231
210210;201606;8373;28248;7987;27742;139;536;7342;26041;7481;26577
210215;201606;1146;4769;1091;4684;105;521;866;3764;971;4285
210220;201606;6249;24463;5940;23966;363;1746;5029;20501;5392;22247
210230;201606;5208;16886;4856;16350;278;1031;4207;14271;4485;15302
210232;201606;12905;41410;10816;38755;1462;5546;7253;28012;8715;33558
210235;201606;3651;11400;3263;10911;180;727;2806;9431;2986;10158
210237;201606;2347;9002;2279;8905;36;178;2164;8509;2200;8687
210240;201606;3012;9408;2805;9120;158;574;2371;7719;2529;8293
210250;201606;5228;16868;4907;16450;166;801;4466;14868;4632;15669
210255;201606;2609;8345;2380;7952;286;1006;1753;5922;2039;6928
210260;201606;5151;16823;4735;16197;540;1834;3612;12720;4152;14554
210270;201606;5387;15119;4723;14193;147;670;4136;12328;4283;12998
210275;201606;3579;8709;3381;8490;229;519;3011;7726;3240;8245
210280;201606;5605;16874;4827;15825;331;1484;3691;11897;4022;13381
210290;201606;5664;18728;5210;18183;308;1163;4452;15732;4760;16895
210300;201606;38016;105533;31502;97535;2240;7566;23984;77520;26224;85086
210310;201606;2916;8190;2664;7853;90;230;2353;7039;2443;7269
210312;201606;2214;6953;2091;6791;75;353;1854;6006;1929;6359
210315;201606;2648;8714;2443;8442;137;524;2126;7452;2263;7976
210317;201606;4196;13038;3997;12797;158;601;3673;11803;3831;12404
210320;201606;19251;62363;17686;60475;966;3639;15202;52917;16168;56556
210325;201606;3633;11249;3223;10637;242;914;2540;8508;2782;9422
210330;201606;35836;87649;28294;79502;3901;9390;18821;60389;22722;69779
210340;201606;11835;35299;10752;33905;1200;3104;8003;27176;9203;30280
210350;201606;9992;30680;8962;29263;606;2137;7301;24144;7907;26281
210355;201606;3919;14323;3591;13832;192;835;3082;12114;3274;12949
210360;201606;16067;48556;14512;46434;1165;4254;11444;36785;12609;41039
210370;201606;9386;22540;7858;20907;261;545;7019;19336;7280;19881
210375;201606;3130;9445;2631;8802;767;2664;1343;4661;2110;7325
210380;201606;6107;16918;5433;16002;409;1145;4489;13488;4898;14633
210390;201606;2886;10267;2623;9846;157;821;2204;8227;2361;9048
210400;201606;4815;15260;4612;15032;113;318;4389;14451;4502;14769
210405;201606;8344;22740;6682;20420;2026;6286;2711;9097;4737;15383
210407;201606;2035;7232;1749;6731;217;861;1235;4815;1452;5676
210408;201606;2421;9352;2265;9157;144;679;1920;7985;2064;8664
210409;201606;3719;13495;3504;13183;223;1065;2896;10924;3119;11989
210410;201606;3592;12001;3465;11842;309;868;2876;10337;3185;11205
210420;201606;4084;13462;3742;12883;256;897;3059;10716;3315;11613
210430;201606;2162;6694;2085;6607;126;416;1835;5843;1961;6259
210440;201606;3939;12345;3809;12182;164;563;3484;11218;3648;11781
210450;201606;2811;8779;2497;8319;147;601;2022;6660;2169;7261
210455;201606;3917;11481;3512;10889;542;1690;2529;8182;3071;9872
210460;201606;3596;11865;3336;11465;204;841;2750;9475;2954;10316
210462;201606;1454;5272;1352;5082;110;515;1074;4038;1184;4553
210465;201606;2502;8326;2338;8101;159;495;2002;7119;2161;7614
210467;201606;6226;20585;5804;20101;413;1479;4947;17431;5360;18910
210470;201606;2047;5549;1504;4752;94;284;1127;3639;1221;3923
210480;201606;14824;47206;12895;44748;2195;7475;8822;32883;11017;40358
210490;201606;3617;10064;3150;9422;125;484;2667;7930;2792;8414
210500;201606;6291;25960;6048;25530;667;2934;4713;20356;5380;23290
210510;201606;6505;22144;6146;21727;381;1196;5279;19212;5660;20408
210515;201606;3684;11658;3526;11479;83;225;3314;10971;3397;11196
210520;201606;2613;7940;2385;7612;144;468;2022;6575;2166;7043
210530;201606;37779;115695;30298;104345;7564;29384;13381;48007;20945;77391
210535;201606;3234;11109;3093;10927;128;460;2779;9956;2907;10416
210540;201606;13505;44191;11829;41836;2298;8060;7191;27346;9489;35406
210542;201606;5782;16750;5275;16199;314;783;4598;14553;4912;15336
210545;201606;2338;7566;2228;7383;69;341;1976;6481;2045;6822
210547;201606;3710;13250;3472;12864;310;1163;2720;10314;3030;11477
210550;201606;6052;17965;5530;17422;206;530;5129;16533;5335;17063
210560;201606;4087;12826;3663;12139;183;710;3087;10239;3270;10949
210565;201606;1482;5284;1269;4945;122;588;946;3737;1068;4325
210570;201606;12390;35005;11227;33689;689;1688;9794;30222;10483;31910
210580;201606;3203;9467;2868;9050;315;691;2323;7802;2638;8493
210590;201606;4043;12784;3743;12405;262;1048;3224;10661;3486;11709
210592;201606;2507;7858;2409;7699;72;320;2131;6810;2203;7130
210594;201606;2677;7524;2147;6750;121;340;1672;5457;1793;5797
210596;201606;2707;10043;2563;9771;277;1167;1915;7426;2192;8593
210598;201606;1893;5842;1733;5647;107;455;1516;4886;1623;5341
210600;201606;3233;9297;2804;8723;164;583;2249;6982;2413;7565
210610;201606;2513;8294;2354;8088;154;695;2045;6928;2199;7623
210620;201606;1934;6321;1797;6155;58;161;1636;5735;1694;5896
210630;201606;3635;12812;3253;12194;350;1572;2288;8613;2638;10185
210632;201606;4541;15724;4199;15232;458;1853;3274;11913;3732;13766
210635;201606;1878;6566;1780;6420;77;263;1581;5811;1658;6074
210637;201606;2682;9096;2470;8807;168;668;2027;7291;2195;7959
210640;201606;4248;15854;4171;15768;6;23;4070;15539;4076;15562
210650;201606;6837;20928;6631;20676;185;572;6296;19730;6481;20302
210660;201606;8176;24184;7406;23065;234;916;6721;20818;6955;21734
210663;201606;2707;8168;2552;7991;157;564;2193;6925;2350;7489
210667;201606;1861;6425;1753;6255;96;419;1517;5441;1613;5860
210670;201606;4490;16527;4265;16163;259;1205;3579;13639;3838;14844
210675;201606;5098;14112;4691;13620;390;985;3872;11637;4262;12622
210680;201606;4071;11153;3589;10580;179;517;3109;9267;3288;9784
210690;201606;7388;24876;7092;24560;298;1053;6309;22532;6607;23585
210700;201606;2641;7810;2431;7578;406;1016;1690;5991;2096;7007
210710;201606;4860;15950;4562;15492;230;1000;3875;13095;4105;14095
210720;201606;2595;9394;2449;9192;131;623;2177;8121;2308;8744
210725;201606;1088;4129;977;3927;107;458;643;2673;750;3131
210730;201606;1135;3506;999;3308;73;249;797;2648;870;2897
210735;201606;4154;14331;3785;13730;524;1996;2746;10225;3270;12221
210740;201606;4982;14908;4695;14614;214;996;4265;12994;4479;13990
210745;201606;3964;11672;3714;11355;241;709;3170;9792;3411;10501
210750;201606;20382;55132;17962;52413;1822;5354;13988;41954;15810;47308
210760;201606;5880;16843;5454;16395;38;120;5297;15996;5335;16116
210770;201606;5918;16232;5129;15329;138;564;4640;13866;4778;14430
210780;201606;8167;27239;7477;26085;905;3236;5327;19119;6232;22355
210790;201606;4656;14649;4233;14167;258;704;3505;12340;3763;13044
210800;201606;4822;13569;4332;12988;146;547;3879;11655;4025;12202
210805;201606;3803;15701;3665;15465;202;1017;3179;13519;3381;14536
210810;201606;5435;16488;5012;15953;324;700;4371;14493;4695;15193
210820;201606;7722;22402;7036;21432;995;2972;4944;15517;5939;18489
210825;201606;5687;19582;5411;19209;605;2079;4287;15723;4892;17802
210830;201606;8369;24579;7930;24053;833;2176;6414;20233;7247;22409
210840;201606;3664;9999;3280;9436;131;421;2763;7912;2894;8333
210845;201606;5836;17786;5638;17571;74;180;5456;17176;5530;17356
210850;201606;6240;21971;5629;20972;660;2855;4047;15087;4707;17942
210860;201606;17851;52784;16006;50277;1232;4044;12824;40893;14056;44937
210870;201606;5851;19645;5332;18991;631;2250;4095;14967;4726;17217
210880;201606;4255;13843;4050;13577;324;1217;3372;11338;3696;12555
210890;201606;5195;15254;4711;14697;399;1132;3918;12771;4317;13903
210900;201606;4982;14863;4098;13441;1573;5428;1099;3923;2672;9351
210905;201606;1841;5792;1640;5504;121;358;1317;4547;1438;4905
210910;201606;8578;27265;7698;25826;1088;3987;5341;18062;6429;22049
210920;201606;2883;10413;2758;10205;181;840;2266;8398;2447;9238
210923;201606;1503;5115;1394;4955;164;665;948;3486;1112;4151
210927;201606;4813;15367;4541;15080;70;252;4349;14539;4419;14791
210930;201606;2487;9046;2343;8842;130;710;1993;7423;2123;8133
210940;201606;2872;10961;2797;10824;194;895;2376;9152;2570;10047
210945;201606;5901;17869;5694;17650;190;319;5409;17070;5599;17389
210950;201606;5280;16260;4544;15108;449;1576;3413;11573;3862;13149
210955;201606;1881;6076;1662;5750;186;648;1183;4287;1369;4935
210960;201606;9372;29662;8628;28713;1824;5802;5381;19273;7205;25075
210970;201606;1359;4787;1197;4524;171;730;831;3140;1002;3870
210975;201606;1788;5962;1708;5831;121;483;1376;4701;1497;5184
210980;201606;10197;23943;9842;23581;526;1034;8897;21807;9423;22841
210990;201606;16720;50932;13571;46583;3191;11533;6968;25129;10159;36662
211000;201606;15407;49540;13675;47490;842;3681;11412;40177;12254;43858
211003;201606;4806;17229;4367;16633;344;1552;3345;13135;3689;14687
211010;201606;6490;23767;6211;23438;76;342;5920;22529;5996;22871
211020;201606;7408;24005;7173;23670;654;2325;5891;19499;6545;21824
211023;201606;2234;7563;2151;7431;166;685;1775;6115;1941;6800
211027;201606;2891;11159;2812;11038;292;1265;2285;9025;2577;10290
211030;201606;3863;11811;3607;11542;574;1286;2741;9606;3315;10892
211040;201606;4392;16466;4194;16167;179;981;3662;14135;3841;15116
211050;201606;10237;26430;9825;25982;231;635;9272;24538;9503;25173
211060;201606;6156;21722;5970;21468;434;1621;5181;18849;5615;20470
211065;201606;1961;6357;1798;6142;78;283;1631;5615;1709;5898
211070;201606;8119;27889;7459;26820;438;1732;6205;22626;6643;24358
211080;201606;1338;4065;1141;3767;98;468;887;2823;985;3291
211085;201606;1919;6510;1752;6236;250;911;1220;4432;1470;5343
211090;201606;3526;10276;3288;9950;158;645;2837;8475;2995;9120
211100;201606;6618;17147;6475;16998;42;140;6313;16602;6355;16742
211102;201606;2976;11338;2801;11086;220;956;2388;9571;2608;10527
211105;201606;2657;8559;2272;7969;229;936;1710;5957;1939;6893
211107;201606;4446;14137;4014;13589;244;865;3306;11499;3550;12364
211110;201606;6383;18952;5135;17099;888;2896;3274;11425;4162;14321
211120;201606;35815;99619;32284;95493;5133;14718;22938;70709;28071;85427
211125;201606;2072;6590;1828;6201;126;526;1519;5141;1645;5667
211130;201606;148377;404652;136598;390116;22617;66932;79024;238198;101641;305130
211140;201606;5488;17907;5123;17365;216;939;4409;14920;4625;15859
211150;201606;9754;28201;8791;26999;483;1781;7443;22883;7926;24664
211153;201606;2845;8731;2585;8390;606;1989;1687;5658;2293;7647
211157;201606;1205;3872;1043;3631;107;471;697;2484;804;2955
211160;201606;4134;13513;3500;12452;319;1530;2441;8475;2760;10005
211163;201606;1688;5578;1585;5436;43;129;1440;5048;1483;5177
211167;201606;1512;5046;1450;4964;34;155;1357;4654;1391;4809
211170;201606;6374;16837;6100;16518;116;400;5682;15318;5798;15718
211172;201606;2452;7207;2228;6897;127;537;1909;5832;2036;6369
211174;201606;2804;8168;2528;7824;78;391;2292;6983;2370;7374
211176;201606;4287;13431;3672;12620;416;1664;2698;9402;3114;11066
211178;201606;3951;10375;3697;10099;58;181;3527;9608;3585;9789
211180;201606;4234;14740;3987;14377;310;1229;3332;12104;3642;13333
211190;201606;2835;9432;2621;9114;96;452;2287;7941;2383;8393
211195;201606;1475;4460;1231;4158;61;193;1051;3671;1112;3864
211200;201606;2165;7167;1900;6808;353;1222;1223;4678;1576;5900
211210;201606;6807;20965;6452;20487;445;1442;5486;17576;5931;19018
211220;201606;34599;99397;29820;93353;5359;17413;19460;62866;24819;80279
211223;201606;5154;15696;4715;15021;460;1530;3583;11590;4043;13120
211227;201606;1625;5730;1481;5506;135;560;1197;4490;1332;5050
211230;201606;8378;27280;7574;25963;784;2854;5791;20165;6575;23019
211240;201606;7998;27607;7571;27085;309;1490;6812;24148;7121;25638
211245;201606;5550;16471;5512;16431;80;141;5380;16193;5460;16334
211250;201606;13305;43246;12538;42354;1267;3674;10220;36203;11487;39877
211260;201606;8571;26626;8162;26078;433;1623;7319;23355;7752;24978
211270;201606;10347;35365;9273;34022;626;2854;7369;27613;7995;30467
211280;201606;12982;38631;12053;37502;951;2539;9982;32221;10933;34760
211285;201606;1734;6355;1517;5892;289;1230;820;3311;1109;4541
211290;201606;7208;23643;6913;23272;465;1502;5953;20410;6418;21912
211300;201606;8295;24876;7757;24165;166;515;7227;22700;7393;23215
211400;201606;11893;37006;10438;34994;2624;8986;5403;19961;8027;28947
220005;201606;1848;5289;1686;5048;84;344;1385;4059;1469;4403
220010;201606;1379;4068;1228;3841;55;237;1000;3079;1055;3316
220020;201606;3304;10478;3134;10200;562;1908;2034;6650;2596;8558
220025;201606;2260;5560;2044;5238;37;130;1750;4420;1787;4550
220027;201606;1381;3713;1233;3524;76;238;1010;2896;1086;3134
220030;201606;3249;8910;3185;8815;145;524;2840;7738;2985;8262
220040;201606;7605;23702;7012;22631;1323;4415;4528;14642;5851;19057
220045;201606;1380;4566;1262;4344;72;346;980;3298;1052;3644
220050;201606;4460;13436;3893;12490;237;984;3126;9924;3363;10908
220060;201606;2063;5086;1897;4889;35;85;1722;4436;1757;4521
220070;201606;2438;7151;2228;6822;144;446;1831;5633;1975;6079
220080;201606;713;2141;660;2062;58;240;556;1682;614;1922
220090;201606;1800;4570;1497;4167;62;218;1295;3546;1357;3764
220095;201606;724;1949;676;1885;13;57;627;1723;640;1780
220100;201606;1356;4089;1130;3687;86;371;861;2761;947;3132
220105;201606;2259;7160;2025;6722;169;591;1517;5080;1686;5671
220110;201606;3405;9864;3202;9541;129;527;2814;8248;2943;8775
220115;201606;2475;8440;2380;8288;130;541;2128;7373;2258;7914
220117;201606;1302;3452;1081;3121;54;170;897;2599;951;2769
220120;201606;12244;35489;11324;34377;168;727;10616;32186;10784;32913
220130;201606;862;2942;775;2803;35;194;666;2378;701;2572
220140;201606;1682;4479;1485;4238;159;364;1220;3600;1379;3964
220150;201606;7041;21434;6647;20878;228;997;5861;18240;6089;19237
220155;201606;1117;3402;905;3008;59;246;603;1979;662;2225
220157;201606;1072;2698;943;2506;28;101;817;2133;845;2234
220160;201606;2601;7885;2321;7380;121;533;1862;5839;1983;6372
220170;201606;1378;4160;1187;3851;65;298;967;3103;1032;3401
220173;201606;2068;6217;1716;5541;65;321;1373;4348;1438;4669
220177;201606;1767;5252;1736;5212;46;170;1635;4895;1681;5065
220180;201606;1122;3062;938;2724;35;134;666;1853;701;1987
220190;201606;4608;15014;4255;14545;516;1857;3281;11230;3797;13087
220191;201606;1415;4680;1335;4546;152;622;1021;3405;1173;4027
220192;201606;1762;4997;1417;4388;101;364;1043;3224;1144;3588
220194;201606;1699;5113;1525;4819;122;474;1190;3658;1312;4132
220196;201606;2018;5887;1854;5606;135;511;1507;4502;1642;5013
220198;201606;1334;3823;1027;3421;12;42;960;3244;972;3286
220200;201606;4461;14789;4171;14391;474;1751;3253;11306;3727;13057
220202;201606;2187;6526;1929;6079;53;264;1667;5127;1720;5391
220205;201606;2762;7262;2474;6863;54;220;2210;6062;2264;6282
220207;201606;895;2711;764;2480;77;312;545;1736;622;2048
220208;201606;1817;5833;1567;5403;253;980;973;3371;1226;4351
220209;201606;1537;4646;1361;4350;51;222;1120;3534;1171;3756
220210;201606;1678;4544;1492;4258;56;243;1237;3441;1293;3684
220211;201606;1577;4445;1506;4362;55;210;1332;3814;1387;4024
220213;201606;1752;4953;1615;4706;52;213;1312;3715;1364;3928
220217;201606;1990;6334;1908;6241;36;136;1769;5861;1805;5997
220220;201606;10809;29909;9686;28249;819;2261;7100;21242;7919;23503
220225;201606;1087;3137;898;2873;42;169;744;2349;786;2518
220230;201606;5355;14730;4880;14064;162;495;4357;12609;4519;13104
220240;201606;2917;8994;2696;8603;133;517;2182;6929;2315;7446
220245;201606;1476;4022;1267;3730;34;119;1128;3368;1162;3487
220250;201606;3183;9112;2899;8690;88;358;2540;7601;2628;7959
220253;201606;1606;4825;1379;4417;169;607;972;3110;1141;3717
220255;201606;1743;4903;1512;4513;61;279;1237;3524;1298;3803
220260;201606;4612;14820;4074;13850;321;1177;3039;10422;3360;11599
220265;201606;1333;4608;1218;4428;136;567;809;2983;945;3550
220270;201606;6888;22350;6624;21893;422;1895;5516;17743;5938;19638
220271;201606;1489;4147;1334;3903;74;220;1102;3266;1176;3486
220272;201606;1787;5374;1626;5103;81;348;1286;3955;1367;4303
220273;201606;1226;3543;1083;3296;92;330;809;2448;901;2778
220275;201606;2103;5366;1737;4932;40;187;1561;4358;1601;4545
220277;201606;2227;6191;1961;5778;89;339;1563;4522;1652;4861
220280;201606;1570;4204;1381;3883;86;315;1122;3064;1208;3379
220285;201606;1620;4296;1339;3914;27;106;1210;3554;1237;3660
220290;201606;5939;20016;5172;18942;536;2266;3800;13965;4336;16231
220300;201606;1817;6131;1652;5886;94;487;1354;4734;1448;5221
220310;201606;2430;8236;2247;8030;97;443;1908;6910;2005;7353
220320;201606;3045;9286;2594;8461;282;1095;1854;6021;2136;7116
220323;201606;1463;5178;1281;4913;139;590;994;3826;1133;4416
220325;201606;1161;3735;986;3380;81;356;720;2444;801;2800
220327;201606;1283;4153;1176;3969;54;282;957;3146;1011;3428
220330;201606;3619;9774;3278;9358;115;309;2966;8563;3081;8872
220335;201606;1844;5713;1674;5522;31;93;1576;5261;1607;5354
220340;201606;1848;5092;1577;4682;105;368;1172;3411;1277;3779
220342;201606;1119;3680;1053;3580;76;332;847;2871;923;3203
220345;201606;2878;7353;2541;6853;56;157;2324;6268;2380;6425
220350;201606;3947;10453;3379;9585;203;670;2636;7424;2839;8094
220360;201606;1292;3577;1111;3299;95;322;858;2507;953;2829
220370;201606;9244;26553;8417;25504;322;1202;7543;22766;7865;23968
220375;201606;1494;4736;1400;4621;17;54;1345;4486;1362;4540
220380;201606;1388;3724;1167;3426;48;205;988;2826;1036;3031
220385;201606;838;2152;680;1900;19;75;549;1503;568;1578
220390;201606;9501;28903;8363;26934;2150;7179;3431;11376;5581;18555
220400;201606;1504;3678;1208;3221;38;134;983;2542;1021;2676
220410;201606;1210;3529;1048;3276;81;322;819;2510;900;2832
220415;201606;880;2399;774;2257;52;169;568;1631;620;1800
220420;201606;2164;6238;1830;5586;96;303;1440;4400;1536;4703
220430;201606;2588;7313;2520;7224;125;449;2239;6346;2364;6795
220435;201606;1646;4883;1516;4669;57;232;1263;3864;1320;4096
220440;201606;2370;7851;2216;7641;148;570;1846;6291;1994;6861
220450;201606;2081;6419;1742;5930;386;1424;1027;3531;1413;4955
220455;201606;1342;4124;1250;3989;45;158;1108;3546;1153;3704
220460;201606;891;2451;818;2368;46;146;705;2023;751;2169
220465;201606;2358;7803;2148;7478;352;1318;1492;5240;1844;6558
220470;201606;3790;11235;3461;10714;211;777;2751;8403;2962;9180
220480;201606;2500;7124;2219;6707;152;442;1740;5285;1892;5727
220490;201606;2295;6555;2120;6337;72;286;1881;5571;1953;5857
220500;201606;3238;8702;2761;7886;108;472;2201;6107;2309;6579
220510;201606;2769;7977;2245;7086;120;461;1687;5304;1807;5765
220515;201606;1872;4600;1671;4335;124;307;1395;3642;1519;3949
220520;201606;5190;14171;4728;13563;106;343;4272;12307;4378;12650
220525;201606;1271;3625;1207;3527;56;210;1035;3005;1091;3215
220527;201606;1368;4199;1211;3882;130;431;877;2871;1007;3302
220530;201606;1264;3628;1112;3400;50;220;974;2905;1024;3125
220535;201606;865;2615;822;2558;68;244;644;1984;712;2228
220540;201606;3489;11179;3331;10933;150;664;2913;9463;3063;10127
220545;201606;1389;4629;1319;4495;134;526;1019;3433;1153;3959
220550;201606;9253;29543;8507;28291;758;2820;6425;21305;7183;24125
220551;201606;1465;4666;1339;4475;79;365;1071;3515;1150;3880
220552;201606;1609;4986;1388;4569;91;445;1074;3409;1165;3854
220553;201606;1592;4646;1324;4237;60;248;1035;3379;1095;3627
220554;201606;805;2337;716;2201;60;199;569;1748;629;1947
220555;201606;2223;6811;2052;6580;57;275;1839;5829;1896;6104
220556;201606;1441;4445;1282;4140;63;277;974;3054;1037;3331
220557;201606;1555;5052;1392;4737;138;542;977;3318;1115;3860
220558;201606;1082;3299;969;3116;62;278;756;2364;818;2642
220559;201606;1577;4473;1419;4209;33;116;1221;3622;1254;3738
220560;201606;1642;4115;1372;3750;49;156;1171;3148;1220;3304
220570;201606;7305;23540;6849;22737;1086;3775;4617;15628;5703;19403
220580;201606;6538;20545;6395;20341;227;861;5877;18616;6104;19477
220585;201606;2081;7134;1931;6870;184;732;1528;5415;1712;6147
220590;201606;1323;3916;1180;3710;146;495;851;2734;997;3229
220595;201606;2360;6914;2199;6704;45;200;2018;6097;2063;6297
220600;201606;1299;3130;1076;2848;116;202;841;2343;957;2545
220605;201606;1949;5685;1695;5284;84;332;1382;4244;1466;4576
220610;201606;2714;8245;2592;8079;66;279;2375;7370;2441;7649
220620;201606;7607;25357;7322;24970;328;1530;6498;21932;6826;23462
220630;201606;392;1208;329;1092;54;196;175;590;229;786
220635;201606;1669;5790;1496;5416;110;499;1085;3851;1195;4350
220640;201606;2646;7746;2370;7362;116;432;2008;6190;2124;6622
220650;201606;2206;6432;1959;5987;111;393;1496;4559;1607;4952
220660;201606;2796;8377;2512;7998;154;739;2164;6672;2318;7411
220665;201606;1176;3980;1089;3827;31;149;942;3306;973;3455
220667;201606;1690;5593;1568;5391;90;353;1304;4475;1394;4828
220669;201606;1856;6057;1756;5885;233;975;1245;4092;1478;5067
220670;201606;1958;5777;1729;5480;129;400;1456;4694;1585;5094
220672;201606;2506;7223;2341;7024;180;580;1993;6025;2173;6605
220675;201606;1273;3658;1191;3510;62;176;958;2842;1020;3018
220680;201606;2415;7465;2280;7291;138;460;1948;6249;2086;6709
220690;201606;1731;4780;1493;4404;120;355;1155;3472;1275;3827
220695;201606;940;2669;859;2528;37;124;686;2009;723;2133
220700;201606;8546;24303;7422;22581;573;2031;5682;17177;6255;19208
220710;201606;808;2392;666;2127;41;131;497;1591;538;1722
220720;201606;2086;5418;1969;5265;66;215;1748;4650;1814;4865
220730;201606;1380;3892;1169;3568;42;172;984;2961;1026;3133
220735;201606;1021;2608;821;2264;37;121;672;1822;709;1943
220740;201606;1370;4311;1191;4072;72;239;999;3502;1071;3741
220750;201606;3980;11273;3661;10795;262;780;3032;9015;3294;9795
220755;201606;1198;3366;1064;3157;62;227;844;2464;906;2691
220760;201606;2655;9062;2434;8768;151;740;2057;7319;2208;8059
220770;201606;22025;72872;19681;68412;6585;24084;6677;24384;13262;48468
220775;201606;1265;3493;1218;3440;14;51;1189;3360;1203;3411
220777;201606;1601;4375;1364;4016;81;234;1062;3134;1143;3368
220779;201606;1410;3622;1334;3525;49;180;1185;3084;1234;3264
220780;201606;5860;15763;5157;14715;392;1239;4162;11870;4554;13109
220785;201606;1305;3363;1233;3249;36;106;1141;2978;1177;3084
220790;201606;10229;30994;9451;29825;680;2503;7672;24066;8352;26569
220793;201606;826;2349;746;2233;53;202;615;1823;668;2025
220795;201606;1422;4111;1370;4039;57;198;1260;3707;1317;3905
220800;201606;16246;44299;14626;42016;1033;3548;11099;31486;12132;35034
220810;201606;3342;9633;2898;8883;133;546;2309;6966;2442;7512
220820;201606;5483;14835;4983;14148;220;697;4381;12345;4601;13042
220830;201606;7548;21166;7009;20324;584;1841;5589;16233;6173;18074
220840;201606;14091;44407;12513;41302;2723;9296;6382;21478;9105;30774
220850;201606;2884;9801;2721;9595;103;439;2467;8750;2570;9189
220855;201606;617;1884;537;1743;43;169;409;1305;452;1474
220860;201606;942;2518;837;2354;36;132;717;1989;753;2121
220865;201606;2601;7135;2078;6225;86;420;1654;4790;1740;5210
220870;201606;2236;7495;1984;7168;52;238;1807;6540;1859;6778
220880;201606;4721;12784;4390;12400;78;254;4111;11644;4189;11898
220885;201606;1267;4574;1120;4303;99;459;849;3243;948;3702
220887;201606;1374;3429;1210;3198;16;53;1125;2964;1141;3017
220890;201606;1633;5607;1459;5291;121;426;1140;4245;1261;4671
220900;201606;1893;5274;1678;4955;53;166;1442;4218;1495;4384
220910;201606;1541;4685;1348;4397;51;162;1181;3910;1232;4072
220915;201606;1020;2870;874;2590;44;179;667;1917;711;2096
220920;201606;1351;4836;1221;4646;105;499;928;3471;1033;3970
220930;201606;1393;4571;1320;4458;58;270;1119;3764;1177;4034
220935;201606;1086;3280;943;2976;45;202;648;1972;693;2174
220937;201606;1499;4101;1265;3714;63;247;969;2770;1032;3017
220940;201606;1345;4248;1259;4087;89;382;939;3003;1028;3385
220945;201606;428;1587;390;1513;39;190;284;1077;323;1267
220950;201606;1331;3286;938;2632;31;129;712;1925;743;2054
220955;201606;1467;4201;1296;3906;82;255;992;3005;1074;3260
220960;201606;920;2379;732;2067;26;80;575;1616;601;1696
220965;201606;1643;4897;1548;4755;69;340;1319;3921;1388;4261
220970;201606;2169;5726;1617;4834;127;432;1166;3519;1293;3951
220975;201606;681;2214;634;2152;28;158;577;1899;605;2057
220980;201606;1289;3860;1131;3606;68;262;868;2760;936;3022
220985;201606;1194;3537;1127;3444;98;385;871;2586;969;2971
220987;201606;1487;4730;1337;4481;96;418;1040;3411;1136;3829
220990;201606;1823;5261;1566;4827;51;247;1233;3715;1284;3962
220995;201606;1262;3721;965;3251;95;360;676;2352;771;2712
220997;201606;2268;6977;2170;6837;46;194;2029;6365;2075;6559
221000;201606;4228;12916;3951;12446;330;1304;3115;9642;3445;10946
221005;201606;1463;4541;1337;4307;391;1114;687;2363;1078;3477
221010;201606;1172;3040;1001;2831;37;136;873;2423;910;2559
221020;201606;1764;5474;1639;5244;87;380;1224;3855;1311;4235
221030;201606;1509;4461;1349;4196;80;327;1106;3398;1186;3725
221035;201606;1462;4023;1370;3903;59;141;1256;3649;1315;3790
221037;201606;624;1847;551;1729;20;82;399;1207;419;1289
221038;201606;602;1695;490;1501;36;126;320;984;356;1110
221039;201606;937;2615;839;2471;43;176;687;1961;730;2137
221040;201606;4548;14113;4256;13639;226;846;3479;11193;3705;12039
221050;201606;3480;10527;3252;10222;140;548;2841;8872;2981;9420
221060;201606;8149;23813;7050;22016;513;1784;5461;17063;5974;18847
221062;201606;1280;4485;1160;4248;56;310;956;3456;1012;3766
221063;201606;1073;3491;972;3312;139;453;678;2395;817;2848
221065;201606;2804;7555;2508;7094;98;307;2103;5875;2201;6182
221070;201606;3742;11817;3290;11032;167;678;2614;8808;2781;9486
221080;201606;3513;8968;2969;8225;100;328;2549;7084;2649;7412
221090;201606;1422;3873;1202;3520;47;210;1008;2885;1055;3095
221093;201606;1637;4878;1545;4691;234;787;950;2796;1184;3583
221095;201606;961;2545;847;2378;15;44;732;2039;747;2083
221097;201606;807;2250;663;1996;36;154;480;1406;516;1560
221100;201606;111988;327110;102467;311462;20406;66509;60612;182240;81018;248749
221110;201606;10386;32576;9649;31669;470;2077;8219;26745;8689;28822
221120;201606;4065;13190;3853;12823;654;2326;2642;8840;3296;11166
221130;201606;4647;13300;3870;11701;1053;3143;1775;5491;2828;8634
221135;201606;1520;4639;1408;4491;98;386;1197;3783;1295;4169
221140;201606;1348;3302;1223;3138;34;98;1076;2733;1110;2831
221150;201606;1220;3115;1010;2760;33;132;788;2113;821;2245
221160;201606;828;2186;776;2114;45;144;613;1675;658;1819
221170;201606;1151;3504;1065;3362;42;173;876;2735;918;2908
230010;201606;3408;9171;2741;8034;202;710;2106;6068;2308;6778
230015;201606;2918;9970;2725;9554;361;1446;1721;5950;2082;7396
230020;201606;13749;44713;13347;44068;755;3022;11343;37297;12098;40319
230030;201606;12019;34462;10786;32538;565;2184;8860;26420;9425;28604
230040;201606;4543;12411;3813;11163;292;1030;2799;8083;3091;9113
230050;201606;2656;9014;2074;7461;500;1841;665;2485;1165;4326
230060;201606;2235;6395;1916;5827;106;431;1475;4414;1581;4845
230070;201606;4213;11634;3614;10646;296;1066;2453;7257;2749;8323
230075;201606;8904;31388;8305;30219;637;3311;6452;22833;7089;26144
230080;201606;2434;6314;1976;5649;95;355;1612;4536;1707;4891
230090;201606;3909;11247;3456;10475;382;1303;2466;7469;2848;8772
230100;201606;16719;49567;15432;47293;2454;8267;9553;29508;12007;37775
230110;201606;13105;41472;11989;39122;2380;8279;6485;21071;8865;29350
230120;201606;7959;22016;6870;20411;814;2456;4660;14507;5474;16963
230125;201606;3061;8801;2534;7871;197;724;1828;5629;2025;6353
230130;201606;5832;18971;4964;17106;478;1918;3356;11459;3834;13377
230140;201606;3538;11193;2996;10192;312;1157;2069;7110;2381;8267
230150;201606;1705;5270;1472;4793;317;1107;787;2551;1104;3658
230160;201606;6229;18488;5561;17494;326;1302;4478;13988;4804;15290
230170;201606;6313;19700;5472;18124;394;1564;3930;12911;4324;14475
230180;201606;1717;5033;1504;4609;91;392;1099;3207;1190;3599
230185;201606;3923;12795;3524;12076;566;2050;2219;7797;2785;9847
230190;201606;12658;40332;11201;37420;2177;7943;5563;18601;7740;26544
230195;201606;5325;16174;4652;15040;310;1283;3631;11474;3941;12757
230200;201606;5152;14788;4632;13776;430;1444;3458;10169;3888;11613
230205;201606;4166;13483;3757;12772;326;1462;2686;8999;3012;10461
230210;201606;8955;25596;7839;23835;1317;4293;4914;15238;6231;19531
230220;201606;13337;37625;11990;35301;1021;3500;8842;25666;9863;29166
230230;201606;7352;23415;6729;22227;809;2866;4648;15446;5457;18312
230240;201606;13876;38595;12154;35759;616;2352;9461;27392;10077;29744
230250;201606;9769;30216;9687;30080;629;2392;7640;23421;8269;25813
230260;201606;14299;47526;13251;45423;2107;7882;7731;27048;9838;34930
230270;201606;7554;22080;6457;20158;706;2509;4271;13381;4977;15890
230280;201606;19921;58188;17687;54417;1476;5212;13312;40587;14788;45799
230290;201606;4828;14541;4117;13111;537;1730;2785;8897;3322;10627
230300;201606;4376;13139;4174;12854;307;1159;3396;10325;3703;11484
230310;201606;4839;14496;4225;13428;229;941;3070;9635;3299;10576
230320;201606;7138;22088;6471;20928;512;2076;4830;15437;5342;17513
230330;201606;4817;14037;4063;12563;370;1277;2864;8747;3234;10024
230340;201606;3402;11409;3082;10738;351;1427;2027;6926;2378;8353
230350;201606;18254;55075;16615;52311;1820;6810;10188;32689;12008;39499
230360;201606;3274;9327;2640;8171;255;933;1738;5320;1993;6253
230365;201606;3048;8164;2660;7506;122;466;2133;5957;2255;6423
230370;201606;54813;173738;49345;164464;13275;46520;22007;76490;35282;123010
230380;201606;6513;18990;5422;16958;293;1123;3892;12025;4185;13148
230390;201606;3496;10995;3101;10339;287;1261;2191;7151;2478;8412
230393;201606;3207;10441;2741;9525;227;1104;1952;6540;2179;7644
230395;201606;5701;16557;5090;15515;784;2447;3071;9684;3855;12131
230400;201606;5524;16614;4864;15570;272;1237;3815;11984;4087;13221
230410;201606;14464;45725;12504;41650;1775;6370;7536;25171;9311;31541
230420;201606;24353;77642;22046;73125;4690;16917;10698;35474;15388;52391
230423;201606;4203;13765;3867;13104;303;1278;2920;9847;3223;11125
230425;201606;5569;18399;5104;17414;713;2573;3286;11264;3999;13837
230426;201606;2684;7489;2121;6441;102;433;1573;4662;1675;5095
230427;201606;1840;5444;1389;4461;161;549;810;2533;971;3082
230428;201606;8758;27095;8307;26279;1391;4909;4895;15362;6286;20271
230430;201606;4597;14493;4240;13850;346;1415;3095;9883;3441;11298
230435;201606;4989;15621;4457;14642;739;2825;2519;8203;3258;11028
230440;201606;358236;1048449;326108;994154;74627;242127;158929;490831;233556;732958
230445;201606;4577;12285;3877;11231;280;856;2768;8027;3048;8883
230450;201606;3616;11339;3152;10507;348;1495;2130;6988;2478;8483
230460;201606;1964;6375;1683;5854;177;715;1161;4011;1338;4726
230465;201606;4021;11905;3373;10723;258;1045;2240;6958;2498;8003
230470;201606;10914;39566;10089;37868;1218;5296;7034;26324;8252;31620
230480;201606;1484;4603;1239;4129;172;675;815;2659;987;3334
230490;201606;2291;6976;1979;6365;309;1084;990;3097;1299;4181
230495;201606;5777;18888;5168;17788;760;3150;2871;9815;3631;12965
230500;201606;8979;31687;8547;30831;706;3133;6455;23211;7161;26344
230510;201606;1504;5293;1148;4379;306;1268;367;1412;673;2680
230520;201606;4847;14685;4365;13834;469;1769;2863;8955;3332;10724
230523;201606;14922;47933;13025;43653;3274;12032;3425;11850;6699;23882
230526;201606;4078;12161;3488;11116;236;1011;2688;8430;2924;9441
230530;201606;5420;17282;4870;16532;760;2758;3318;11637;4078;14395
230533;201606;4053;11225;3487;10155;380;1082;2470;7278;2850;8360
230535;201606;5553;16299;4841;15039;601;1924;3029;9723;3630;11647
230540;201606;17499;50997;15776;48298;655;2777;13129;39687;13784;42464
230550;201606;19552;57632;17324;53475;3110;10795;9388;28419;12498;39214
230560;201606;6847;19575;5902;17860;248;1086;4533;13484;4781;14570
230565;201606;3466;9553;2805;8345;120;464;2085;6167;2205;6631
230570;201606;3681;9946;3254;9409;130;514;2712;7749;2842;8263
230580;201606;10023;30074;9267;28992;530;2062;7928;24652;8458;26714
230590;201606;9167;28094;7841;25627;638;2709;5526;17540;6164;20249
230600;201606;3834;10474;2914;8665;164;515;1855;5558;2019;6073
230610;201606;6195;19558;5665;18692;703;2392;4009;13446;4712;15838
230620;201606;2186;6187;1740;5248;223;747;983;2874;1206;3621
230625;201606;7859;25367;7079;23606;2108;7566;2173;7337;4281;14903
230630;201606;10960;34545;10037;32844;2581;8051;4838;16978;7419;25029
230640;201606;26001;84179;23856;80943;2748;10785;17850;60228;20598;71013
230650;201606;4894;14908;4409;13980;290;1181;3353;10383;3643;11564
230655;201606;9218;34542;8855;33856;791;3431;6969;26857;7760;30288
230660;201606;6145;19078;5257;17402;352;1621;4006;12929;4358;14550
230670;201606;6095;16183;4876;14083;173;675;3764;10555;3937;11230
230680;201606;2659;7778;2286;7060;341;1114;1366;4211;1707;5325
230690;201606;6341;20356;6124;19901;710;2653;3865;12320;4575;14973
230700;201606;9631;26770;8546;24824;694;2554;6124;17231;6818;19785
230710;201606;7533;24261;6542;22428;737;2707;4584;15815;5321;18522
230720;201606;1833;5803;1575;5255;223;827;944;3136;1167;3963
230725;201606;3694;12467;3210;11293;770;2809;1105;3898;1875;6707
230730;201606;56982;171350;47988;156375;14130;51812;11410;39392;25540;91204
230740;201606;6143;18176;5534;17155;256;1082;4439;13558;4695;14640
230750;201606;8428;24208;7205;22205;435;1728;5473;16605;5908;18333
230760;201606;10985;32312;10099;30551;1086;3933;6977;20374;8063;24307
230763;201606;4326;13067;3855;12184;236;1049;2917;8858;3153;9907
230765;201606;38962;122238;34846;114283;9425;33193;10971;37289;20396;70482
230770;201606;25031;68989;22399;65132;2936;9275;14837;43120;17773;52395
230780;201606;5944;22733;5691;22166;1360;5467;2928;11949;4288;17416
230790;201606;2810;8875;2589;8498;241;921;1953;6409;2194;7330
230800;201606;7523;26394;6839;24900;1444;5798;3204;11482;4648;17280
230810;201606;12279;39349;11521;38064;920;3533;8949;29383;9869;32916
230820;201606;3291;11322;2876;10421;437;1810;1621;5816;2058;7626
230830;201606;7537;22642;6652;21010;459;1847;4975;15488;5434;17335
230835;201606;3986;10441;3242;9300;175;620;2510;7153;2685;7773
230837;201606;3208;10749;2745;9803;256;1145;1901;6640;2157;7785
230840;201606;9203;29636;8404;28285;724;2775;6445;21839;7169;24614
230850;201606;9563;29722;8853;28498;1083;3749;6164;20014;7247;23763
230860;201606;5132;14500;4556;13664;239;896;3737;11122;3976;12018
230870;201606;18777;49119;16145;45187;815;2733;12407;34539;13222;37272
230880;201606;1973;6659;1873;6452;160;726;1327;4483;1487;5209
230890;201606;3936;14263;3644;13634;463;2150;2329;8460;2792;10610
230900;201606;2917;9638;2426;8565;486;1682;1162;4217;1648;5899
230910;201606;3157;9159;2597;8166;196;846;1899;5798;2095;6644
230920;201606;4694;13527;4366;13110;230;876;3706;11166;3936;12042
230930;201606;7247;21737;6384;20131;586;2028;4380;13829;4966;15857
230940;201606;7929;22395;6962;20880;288;1032;5685;17066;5973;18098
230945;201606;6078;18340;5391;17259;478;1740;3709;12125;4187;13865
230950;201606;6459;17449;5847;16644;234;654;5064;14704;5298;15358
230960;201606;14293;43724;13067;41397;2573;8726;6287;20272;8860;28998
230970;201606;13861;41823;12166;38745;2442;8803;5650;17772;8092;26575
230980;201606;2948;9120;2574;8456;646;2107;1317;4583;1963;6690
230990;201606;1762;5180;1455;4585;136;550;936;2840;1072;3390
231000;201606;2700;7364;2153;6298;153;518;1386;3955;1539;4473
231010;201606;3140;8593;2553;7617;290;966;1685;4928;1975;5894
231020;201606;7902;26399;7475;25509;1292;4494;4627;16152;5919;20646
231025;201606;8020;24381;7282;23107;963;3269;4809;15524;5772;18793
231030;201606;7585;24375;6383;21921;1182;4369;3472;11978;4654;16347
231040;201606;3138;9870;2795;9190;163;755;2066;6586;2229;7341
231050;201606;11951;33777;10127;30557;770;2652;7404;22214;8174;24866
231060;201606;2408;7779;2233;7458;178;871;1631;5267;1809;6138
231070;201606;8671;27242;7763;25400;1461;5043;4198;13992;5659;19035
231080;201606;3869;12092;3530;11506;185;968;2737;8564;2922;9532
231085;201606;4867;14993;4674;14727;600;1915;3368;11014;3968;12929
231090;201606;4192;11665;3346;9991;184;665;2318;6802;2502;7467
231095;201606;2203;7086;1911;6494;231;898;1256;4268;1487;5166
231100;201606;3215;9887;2672;8845;202;810;1894;6202;2096;7012
231110;201606;3539;11661;3498;11586;360;1399;2451;8038;2811;9437
231120;201606;1985;6750;1878;6528;296;1126;1184;4155;1480;5281
231123;201606;2070;5674;1788;5193;125;405;1378;3968;1503;4373
231126;201606;6289;17791;5268;16064;300;1192;3853;11549;4153;12741
231130;201606;19213;58428;17352;55387;3139;10591;10455;34804;13594;45395
231135;201606;4180;12464;3559;11353;265;994;2497;7922;2762;8916
231140;201606;17237;53556;15111;49549;1379;6065;10034;31817;11413;37882
231150;201606;5794;16626;4979;15149;816;2669;2505;7746;3321;10415
231160;201606;5838;19175;5434;18368;969;3434;3242;11069;4211;14503
231170;201606;4302;13727;3833;12760;326;1427;2703;8747;3029;10174
231180;201606;14244;42093;12684;38958;2236;7359;7098;21616;9334;28975
231190;201606;4565;12809;3832;11686;248;1017;2926;8650;3174;9667
231195;201606;4640;15380;4001;14132;424;1879;2733;9498;3157;11377
231200;201606;7817;26398;6827;24348;467;2324;4868;16929;5335;19253
231210;201606;4969;15571;4323;14655;300;1412;3332;11152;3632;12564
231220;201606;11846;33955;10406;31303;621;2449;7710;22741;8331;25190
231230;201606;9203;30453;8317;29107;900;3747;6122;21458;7022;25205
231240;201606;12162;37820;10962;35422;2279;7756;5521;18072;7800;25828
231250;201606;1960;5585;1353;4105;355;1091;373;1078;728;2169
231260;201606;3468;10315;3118;9755;525;1690;1916;6132;2441;7822
231270;201606;7251;19797;6370;18429;360;1489;4833;13681;5193;15170
231280;201606;1748;5704;1633;5494;184;668;1115;3780;1299;4448
231290;201606;34024;113968;30700;106483;6534;25250;13444;45869;19978;71119
231300;201606;4506;13010;3647;11323;255;974;2455;7441;2710;8415
231310;201606;7427;21041;6151;18389;882;2777;3550;10521;4432;13298
231320;201606;7043;21319;5912;19085;309;1293;4207;13473;4516;14766
231325;201606;2782;8092;2428;7547;260;868;1622;5132;1882;6000
231330;201606;12183;38171;10451;34811;1798;6102;5874;19861;7672;25963
231335;201606;5432;15316;4694;13966;201;836;3741;10909;3942;11745
231340;201606;17544;57694;16176;55555;1154;4233;12833;44886;13987;49119
231350;201606;14113;42211;13352;41173;771;2345;11587;36228;12358;38573
231355;201606;4580;14411;4190;13749;304;1266;3078;10015;3382;11281
231360;201606;7696;24395;6819;22866;1063;3731;4454;15298;5517;19029
231370;201606;2430;6761;1893;5871;90;325;1418;4394;1508;4719
231375;201606;4250;14362;3967;13845;259;1176;3114;10772;3373;11948
231380;201606;5481;16622;5182;16237;375;1330;4090;13052;4465;14382
231390;201606;3463;10758;3178;10269;307;1170;2278;7296;2585;8466
231395;201606;3856;12594;3504;11937;581;2061;2093;7192;2674;9253
231400;201606;9041;27784;8375;26475;595;2319;6226;19436;6821;21755
231410;201606;14368;48413;13164;46563;1197;4645;10032;35709;11229;40354
240010;201606;2477;7353;2057;6518;339;1204;1055;3251;1394;4455
240020;201606;10633;33278;9510;31184;1925;6746;4873;16204;6798;22950
240030;201606;2534;7178;2448;7047;150;522;2100;5979;2250;6501
240040;201606;852;2497;718;2230;40;194;508;1499;548;1693
240050;201606;3459;9350;2937;8445;133;481;2343;6623;2476;7104
240060;201606;1415;4009;1257;3714;63;252;1002;2850;1065;3102
240070;201606;2552;7557;2374;7211;340;1143;1608;4779;1948;5922
240080;201606;3069;8187;2644;7606;151;525;2055;5858;2206;6383
240090;201606;2289;6138;1886;5418;56;225;1475;4153;1531;4378
240100;201606;7852;22614;6989;20863;595;2086;5059;14680;5654;16766
240110;201606;4800;15027;4289;13990;673;2534;2430;7696;3103;10230
240120;201606;2700;9253;2577;9008;384;1553;1659;5751;2043;7304
240130;201606;2768;7466;2430;6935;99;385;1999;5604;2098;5989
240140;201606;2233;6683;1902;6071;292;1132;1107;3410;1399;4542
240145;201606;5756;18132;5196;17122;1342;4609;2674;9115;4016;13724
240150;201606;985;2992;816;2641;85;350;536;1661;621;2011
240160;201606;1446;4579;1247;4239;139;573;795;2731;934;3304
240165;201606;899;2813;793;2600;123;380;480;1662;603;2042
240170;201606;2324;7023;2030;6478;485;1697;984;3125;1469;4822
240180;201606;2658;8388;2353;7760;397;1420;1435;4814;1832;6234
240185;201606;1416;4673;1317;4512;95;365;1048;3599;1143;3964
240190;201606;967;3044;865;2870;47;219;656;2166;703;2385
240200;201606;13472;35260;11257;32138;2571;7703;4908;14439;7479;22142
240210;201606;2931;8127;2642;7698;153;577;2177;6217;2330;6794
240220;201606;7351;24532;6804;23712;726;3164;5065;17489;5791;20653
240230;201606;5757;15191;4988;14006;153;545;4244;11880;4397;12425
240240;201606;1824;5538;1244;4127;238;870;228;675;466;1545
240250;201606;2668;7827;2509;7606;130;449;2170;6569;2300;7018
240260;201606;12233;41124;11613;40114;1850;7222;7668;26511;9518;33733
240270;201606;2244;7209;2064;6905;188;665;1577;5355;1765;6020
240280;201606;1572;4431;1403;4185;83;297;1126;3341;1209;3638
240290;201606;1272;3980;1127;3703;93;464;736;2271;829;2735
240300;201606;2280;6243;1696;5024;256;834;760;2191;1016;3025
240310;201606;9529;27101;8637;25710;1168;3873;4886;14785;6054;18658
240320;201606;2034;6018;1623;5189;77;331;1138;3512;1215;3843
240325;201606;34445;95045;27698;84387;8457;27591;7084;23072;15541;50663
240330;201606;1493;4547;1260;4055;96;398;799;2492;895;2890
240340;201606;2057;5328;1743;4832;176;543;1292;3550;1468;4093
240350;201606;1966;5667;1854;5533;106;373;1643;4902;1749;5275
240360;201606;7089;21450;6334;20324;1472;4903;3306;11093;4778;15996
240370;201606;2032;5594;1624;4833;171;518;1040;3111;1211;3629
240375;201606;857;2312;751;2129;65;248;534;1411;599;1659
240380;201606;2425;7220;1864;5969;253;838;974;3105;1227;3943
240390;201606;928;2571;780;2293;46;175;561;1597;607;1772
240400;201606;1334;3628;1076;3145;88;315;733;2068;821;2383
240410;201606;486;1610;437;1511;73;308;265;889;338;1197
240420;201606;4641;17777;4362;17150;865;3808;2454;9717;3319;13525
240430;201606;3298;9307;3014;8798;167;699;2396;6771;2563;7470
240440;201606;2486;6480;2226;6098;467;1372;1273;3436;1740;4808
240450;201606;3820;11365;3294;10360;345;1428;2024;6075;2369;7503
240460;201606;2896;8915;2733;8694;210;943;2229;6917;2439;7860
240470;201606;3572;11208;2831;9590;695;2363;1432;4955;2127;7318
240480;201606;518;1384;404;1168;35;119;202;563;237;682
240485;201606;1975;6239;1737;5753;260;941;1090;3623;1350;4564
240490;201606;1713;4352;1432;3918;45;171;1200;3232;1245;3403
240500;201606;2156;6152;1952;5851;131;489;1555;4617;1686;5106
240510;201606;1796;5307;1686;5142;129;424;1375;4201;1504;4625
240520;201606;1229;3584;1109;3377;95;362;838;2474;933;2836
240530;201606;1994;6452;1828;6191;311;1111;1255;4249;1566;5360
240540;201606;1742;5198;1665;5075;129;456;1377;4161;1506;4617
240550;201606;798;2283;685;2085;50;182;505;1512;555;1694
240560;201606;3209;9272;2990;8943;302;881;2332;7044;2634;7925
240570;201606;3069;8569;2289;6821;482;1550;843;2264;1325;3814
240580;201606;7684;23872;7136;22914;761;2866;5528;17497;6289;20363
240590;201606;774;2181;681;2013;34;137;519;1503;553;1640
240600;201606;1620;4730;1269;3991;150;559;719;2169;869;2728
240610;201606;4622;13321;4042;12222;497;1713;2593;7675;3090;9388
240615;201606;1041;3051;838;2664;157;530;466;1428;623;1958
240620;201606;1801;5515;1598;5173;167;568;1205;3909;1372;4477
240630;201606;2049;6215;1875;5918;194;599;1328;4280;1522;4879
240640;201606;897;2569;763;2351;49;220;543;1616;592;1836
240650;201606;3913;11612;3494;10995;199;753;2779;8679;2978;9432
240660;201606;2371;7579;2227;7365;187;717;1765;5797;1952;6514
240670;201606;2635;7853;2195;6935;288;1002;1247;3885;1535;4887
240680;201606;1509;4420;1225;3909;96;378;813;2541;909;2919
240690;201606;957;2626;820;2390;48;185;656;1857;704;2042
240700;201606;2587;7734;2176;6986;110;486;1663;5244;1773;5730
240710;201606;18719;48989;16189;45164;3012;8555;9205;26342;12217;34897
240720;201606;5257;15022;4778;14148;1280;3915;2337;6816;3617;10731
240725;201606;1064;3210;858;2764;83;284;503;1593;586;1877
240730;201606;2121;6424;1845;5908;129;466;1375;4387;1504;4853
240740;201606;1976;5786;1758;5391;167;650;1249;3705;1416;4355
240750;201606;2136;7978;1986;7688;437;1880;1042;4086;1479;5966
240760;201606;1333;3620;1114;3316;110;291;833;2620;943;2911
240770;201606;3156;9021;2821;8557;168;726;2327;6921;2495;7647
240780;201606;6104;16800;4930;14934;730;2342;2870;8825;3600;11167
240790;201606;903;2738;753;2464;47;195;529;1732;576;1927
240800;201606;35291;100882;31364;94374;7587;24155;13613;41679;21200;65834
240810;201606;85315;245548;78777;234486;20952;63990;37201;113529;58153;177519
240820;201606;6336;19319;5550;18080;1382;4878;2413;8252;3795;13130
240830;201606;8688;26929;8117;26100;395;1752;6836;21713;7231;23465
240840;201606;1213;3377;1028;3078;106;358;642;1862;748;2220
240850;201606;1299;3811;964;3035;137;475;494;1548;631;2023
240860;201606;1315;3738;1075;3312;67;264;816;2427;883;2691
240870;201606;1177;3214;963;2823;97;321;614;1710;711;2031
240880;201606;1172;3906;1104;3798;103;466;888;2955;991;3421
240890;201606;4995;14187;4224;12742;940;3055;1823;5410;2763;8465
240895;201606;2640;9092;2434;8728;262;1025;1778;6452;2040;7477
240910;201606;2875;8631;2539;7990;163;610;1953;6102;2116;6712
240920;201606;759;2454;661;2244;115;433;340;1138;455;1571
240930;201606;3478;9015;3061;8507;141;417;2522;7090;2663;7507
240933;201606;1449;4010;1280;3730;58;226;1013;2863;1071;3089
240940;201606;6594;17569;5306;15414;701;2111;3289;9480;3990;11591
240950;201606;963;3151;891;3023;69;324;665;2179;734;2503
240960;201606;797;2471;707;2303;58;207;503;1653;561;1860
240970;201606;1902;5285;1601;4775;104;399;1229;3547;1333;3946
240980;201606;2946;9759;2732;9364;494;1842;1674;5753;2168;7595
240990;201606;2780;8265;2614;7951;445;1495;1642;4914;2087;6409
241000;201606;1057;2950;895;2664;57;221;621;1817;678;2038
241010;201606;2810;9499;2622;9138;327;1423;1865;6256;2192;7679
241020;201606;2050;5705;1664;4931;197;610;1025;2980;1222;3590
241025;201606;1626;4941;1442;4605;69;310;1041;3278;1110;3588
241030;201606;2506;8222;2240;7696;219;958;1573;5326;1792;6284
241040;201606;2203;7507;2009;7161;171;707;1451;5218;1622;5925
241050;201606;1286;3802;1122;3518;87;343;839;2568;926;2911
241060;201606;872;2509;782;2363;67;236;560;1666;627;1902
241070;201606;775;2253;701;2123;65;242;517;1509;582;1751
241080;201606;1155;3409;959;3023;58;249;687;2123;745;2372
241090;201606;2175;6431;1835;5846;113;484;1384;4337;1497;4821
241100;201606;1184;3523;1030;3168;92;331;681;2059;773;2390
241105;201606;1184;3601;1033;3327;250;800;479;1640;729;2440
241110;201606;833;2580;700;2308;68;290;446;1416;514;1706
241120;201606;7286;22293;6637;21229;1433;4571;3782;12642;5215;17213
241140;201606;3413;9316;2945;8403;278;840;2080;5814;2358;6654
241142;201606;721;2152;542;1765;132;483;231;724;363;1207
241150;201606;5442;16034;4859;15038;547;1882;3307;10224;3854;12106
241160;201606;978;2867;875;2692;139;458;561;1716;700;2174
241170;201606;1156;3396;1075;3251;89;295;852;2550;941;2845
241180;201606;946;2640;767;2292;101;334;406;1187;507;1521
241190;201606;1202;3314;955;2811;68;258;624;1763;692;2021
241200;201606;19059;55297;16878;51937;4291;14202;7382;23332;11673;37534
241210;201606;1449;4074;1163;3485;154;542;659;1911;813;2453
241220;201606;7876;25831;7317;24802;1911;6692;3678;12894;5589;19586
241230;201606;3017;8826;2786;8459;171;654;2312;6893;2483;7547
241240;201606;1228;3613;836;2700;104;384;356;1145;460;1529
241250;201606;6054;18598;5062;16690;307;1550;3847;12278;4154;13828
241255;201606;1691;6455;1558;6144;349;1502;798;3153;1147;4655
241260;201606;5156;13925;4154;12357;243;1019;3083;9019;3326;10038
241270;201606;1889;5761;1665;5312;137;547;1146;3583;1283;4130
241280;201606;1850;5346;1692;5046;153;491;1247;3695;1400;4186
241290;201606;3024;8434;2573;7665;203;745;1839;5367;2042;6112
241300;201606;1452;4172;1253;3815;64;216;875;2665;939;2881
241310;201606;1615;4807;1479;4582;119;468;1150;3518;1269;3986
241320;201606;916;3129;836;2961;122;505;533;1873;655;2378
241330;201606;1438;4478;1356;4370;110;467;1137;3601;1247;4068
241335;201606;2760;8360;2546;7977;138;523;2109;6532;2247;7055
241340;201606;1832;5674;1569;5102;369;1303;700;2201;1069;3504
241350;201606;1926;6118;1749;5777;150;661;1301;4168;1451;4829
241355;201606;1433;3984;1172;3538;69;253;927;2782;996;3035
241360;201606;2089;5659;1719;4937;88;303;1243;3452;1331;3755
241370;201606;1353;4050;1117;3571;114;426;694;2183;808;2609
241380;201606;653;1857;559;1680;71;254;338;983;409;1237
241390;201606;2771;9073;2585;8754;285;1152;1934;6511;2219;7663
241400;201606;3715;10715;3373;10228;387;1303;2527;7746;2914;9049
241410;201606;2482;7567;2242;7230;404;1448;1418;4565;1822;6013
241415;201606;1652;4964;1490;4712;103;400;1177;3638;1280;4038
241420;201606;2278;7861;2006;7389;674;2731;515;1885;1189;4616
241430;201606;572;1697;444;1410;50;184;253;769;303;953
241440;201606;6286;22556;5886;21919;891;3644;4173;15643;5064;19287
241445;201606;997;2886;952;2833;69;176;781;2460;850;2636
241450;201606;3021;8237;2651;7718;320;1046;1850;5338;2170;6384
241460;201606;3413;9898;3022;9133;261;970;2161;6368;2422;7338
241470;201606;1402;3884;1150;3553;129;462;828;2544;957;3006
241475;201606;1259;3778;1052;3373;57;282;772;2376;829;2658
241480;201606;2788;9223;2565;8832;1041;3715;675;2593;1716;6308
241490;201606;682;1805;589;1679;39;114;375;1047;414;1161
241500;201606;736;2334;628;2172;31;136;499;1719;530;1855
250010;201606;2779;8615;2375;7742;139;622;1782;5685;1921;6307
250020;201606;1673;4779;1273;4033;89;385;865;2643;954;3028
250030;201606;6956;20207;6475;19528;447;1539;5359;16038;5806;17577
250040;201606;4140;13863;3817;13161;575;2137;2436;8409;3011;10546
250050;201606;3444;10842;3208;10469;480;1671;2152;6939;2632;8610
250053;201606;1234;3695;1131;3547;145;485;793;2525;938;3010
250057;201606;618;2606;607;2593;7;12;579;2542;586;2554
250060;201606;5168;15393;4841;14915;410;1478;3888;11879;4298;13357
250070;201606;3988;12347;3698;11846;176;840;2876;8907;3052;9747
250073;201606;794;2346;694;2174;40;152;567;1749;607;1901
250077;201606;2168;6300;1805;5722;142;501;1262;4027;1404;4528
250080;201606;4168;12106;3977;11784;312;1096;3163;9204;3475;10300
250090;201606;2563;7373;2421;7146;120;375;1983;5786;2103;6161
250100;201606;3843;12569;3626;12176;316;1279;2820;9298;3136;10577
250110;201606;5058;15093;4772;14680;420;1587;3839;11634;4259;13221
250115;201606;529;1689;474;1578;31;157;321;1007;352;1164
250120;201606;1984;6039;1706;5504;115;446;1309;4208;1424;4654
250130;201606;5299;16568;4886;15867;248;1067;4080;13175;4328;14242
250135;201606;1075;3203;983;3052;44;161;788;2445;832;2606
250140;201606;2022;6761;1937;6631;177;752;1503;5134;1680;5886
250150;201606;5033;16876;4574;16028;346;1572;3405;11757;3751;13329
250153;201606;1447;3941;1270;3695;54;241;1084;3075;1138;3316
250157;201606;1710;5599;1579;5351;162;626;1155;3902;1317;4528
250160;201606;3276;9761;3135;9553;120;442;2852;8680;2972;9122
250170;201606;1598;4683;1458;4474;133;453;1110;3409;1243;3862
250180;201606;15859;46385;14914;44954;1573;5707;11041;32544;12614;38251
250190;201606;4201;12075;3821;11482;597;1870;2388;7118;2985;8988
250200;201606;2018;5892;1691;5409;109;424;1392;4437;1501;4861
250205;201606;875;3015;812;2876;52;242;593;2088;645;2330
250210;201606;1457;4792;1370;4665;115;517;1077;3590;1192;4107
250215;201606;1363;4446;1288;4329;121;502;864;2899;985;3401
250220;201606;750;2277;660;2156;39;160;536;1752;575;1912
250230;201606;1533;3873;1261;3429;56;217;994;2570;1050;2787
250240;201606;2303;7705;2173;7464;136;552;1764;6049;1900;6601
250250;201606;4333;13080;4002;12648;195;683;3427;10880;3622;11563
250260;201606;1704;5193;1481;4840;89;335;1160;3802;1249;4137
250270;201606;1268;3998;1159;3865;89;325;891;3053;980;3378
250280;201606;3622;10700;3199;10040;324;1071;2427;7635;2751;8706
250290;201606;1910;5118;1606;4720;36;142;1413;4161;1449;4303
250300;201606;5520;16207;5239;15877;482;1958;4385;12945;4867;14903
250310;201606;1159;3548;1036;3350;83;329;802;2554;885;2883
250320;201606;8080;24458;7634;23738;935;3376;5434;16542;6369;19918
250330;201606;2400;7517;2078;7042;168;713;1590;5326;1758;6039
250340;201606;1097;3234;982;3035;38;156;827;2508;865;2664
250350;201606;4127;11498;3711;10998;149;568;3219;9579;3368;10147
250355;201606;1880;6068;1728;5855;83;398;1479;4929;1562;5327
250360;201606;1857;5437;1730;5251;63;194;1484;4524;1547;4718
250370;201606;11514;33572;10413;32339;778;2514;8998;28140;9776;30654
250375;201606;1080;3297;999;3182;40;164;871;2783;911;2947
250380;201606;1664;4775;1582;4675;98;381;1365;3962;1463;4343
250390;201606;1860;5057;1504;4452;179;542;985;2930;1164;3472
250400;201606;72572;192989;57827;169770;14669;45931;23155;69928;37824;115859
250403;201606;1506;4921;1391;4766;226;938;910;3040;1136;3978
250407;201606;1205;3375;1030;3099;84;283;761;2231;845;2514
250410;201606;545;1777;510;1718;33;163;399;1304;432;1467
250415;201606;1838;5518;1666;5217;107;368;1257;3890;1364;4258
250420;201606;1268;3745;1152;3569;32;132;1024;3157;1056;3289
250430;201606;6193;16884;5714;16179;271;963;4761;13199;5032;14162
250435;201606;1370;4199;1233;3956;112;406;883;2833;995;3239
250440;201606;4432;12781;4083;12303;150;520;3491;10481;3641;11001
250450;201606;1940;5485;1725;5201;72;279;1451;4309;1523;4588
250460;201606;6435;19374;6007;18806;522;1752;4821;15298;5343;17050
250470;201606;1565;4255;1327;3928;129;473;920;2625;1049;3098
250480;201606;3747;11351;3483;10991;117;520;3047;9599;3164;10119
250485;201606;665;1675;553;1506;34;109;445;1179;479;1288
250490;201606;3811;11918;3718;11784;660;2081;2750;8830;3410;10911
250500;201606;1755;5331;1578;5042;181;567;1152;3756;1333;4323
250510;201606;4874;13836;4359;13089;164;554;3829;11532;3993;12086
250520;201606;1759;5307;1643;5132;269;965;1017;3141;1286;4106
250523;201606;1621;5059;1575;4995;152;589;1274;3976;1426;4565
250527;201606;1402;4211;1331;4126;38;182;1220;3715;1258;3897
250530;201606;617;1880;535;1780;24;76;477;1603;501;1679
250535;201606;1307;4107;1228;3953;67;294;992;3125;1059;3419
250540;201606;2399;6853;2237;6666;69;311;1954;5715;2023;6026
250550;201606;913;3009;832;2886;58;280;661;2235;719;2515
250560;201606;1656;5198;1594;5111;74;323;1407;4432;1481;4755
250570;201606;2608;8283;2290;7665;161;716;1759;5733;1920;6449
250580;201606;1139;3027;981;2785;76;283;793;2178;869;2461
250590;201606;857;2677;798;2599;58;247;667;2117;725;2364
250600;201606;7321;21330;6862;20666;671;2060;5391;16378;6062;18438
250610;201606;3143;9049;2913;8704;256;863;2247;6676;2503;7539
250620;201606;698;2052;618;1890;82;272;402;1209;484;1481
250625;201606;2408;7730;2361;7671;55;135;2254;7417;2309;7552
250630;201606;9408;29280;8645;27755;2049;6828;4586;14860;6635;21688
250640;201606;3425;10557;3261;10349;190;809;2822;8818;3012;9627
250650;201606;828;2350;725;2197;57;232;549;1575;606;1807
250660;201606;1813;4897;1658;4693;23;50;1569;4482;1592;4532
250670;201606;2379;8026;2262;7821;152;713;1876;6358;2028;7071
250680;201606;4852;13739;4609;13450;177;667;4155;12087;4332;12754
250690;201606;6029;15761;5753;15439;350;1054;5176;13794;5526;14848
250700;201606;4725;13966;4334;13390;670;2263;2948;9034;3618;11297
250710;201606;4411;13685;3991;13127;452;1632;2862;9534;3314;11166
250720;201606;2690;7766;2522;7521;86;370;2234;6598;2320;6968
250730;201606;3522;10615;3287;10294;296;1110;2568;7897;2864;9007
250740;201606;1903;5544;1653;5161;166;661;1263;3797;1429;4458
250750;201606;99723;281189;91668;269495;12312;40375;62533;181894;74845;222269
250760;201606;2252;6410;2020;6076;135;532;1664;4937;1799;5469
250770;201606;3888;12963;3682;12697;494;1983;2638;9045;3132;11028
250780;201606;1828;5319;1578;4872;191;721;1019;3043;1210;3764
250790;201606;2392;7773;2269;7570;446;1527;1407;4817;1853;6344
250800;201606;2625;7383;2327;6907;107;373;1920;5603;2027;5976
250810;201606;1294;3797;1133;3549;77;335;889;2731;966;3066
250820;201606;1847;5826;1772;5733;77;327;1604;5146;1681;5473
250830;201606;5617;18106;5201;17280;594;2329;3652;11931;4246;14260
250840;201606;903;2941;767;2649;66;277;522;1805;588;2082
250850;201606;1982;6104;1801;5809;104;485;1416;4474;1520;4959
250855;201606;1080;3191;966;3024;57;244;719;2168;776;2412
250860;201606;3174;10319;2753;9554;700;2654;1032;3671;1732;6325
250870;201606;1064;3104;954;2889;41;170;740;2188;781;2358
250880;201606;1451;3985;1253;3710;145;449;941;2810;1086;3259
250890;201606;9276;27984;8761;27279;1180;4497;6337;19155;7517;23652
250900;201606;2827;9133;2482;8458;204;724;1851;6307;2055;7031
250905;201606;2006;6367;1926;6265;222;793;1522;4945;1744;5738
250910;201606;4924;14378;4652;13974;249;920;3868;11534;4117;12454
250915;201606;1404;4317;1379;4282;78;208;1226;3883;1304;4091
250920;201606;3268;9276;3067;8977;299;936;2293;6699;2592;7635
250930;201606;1998;6169;1881;5984;187;751;1403;4359;1590;5110
250933;201606;1126;3679;1049;3529;114;464;718;2385;832;2849
250937;201606;668;2049;601;1921;65;253;430;1335;495;1588
250939;201606;1532;4678;1433;4519;137;489;1021;3184;1158;3673
250940;201606;3775;11205;3540;10836;115;447;3049;9362;3164;9809
250950;201606;1278;3906;1128;3708;57;238;892;2954;949;3192
250960;201606;1072;3473;1020;3391;67;258;823;2710;890;2968
250970;201606;8419;23298;7404;21731;683;2246;5467;15955;6150;18201
250980;201606;2549;7530;2332;7148;132;572;1751;5178;1883;5750
250990;201606;1939;6582;1740;6158;262;1112;1098;3746;1360;4858
251000;201606;2096;6267;1890;5955;91;408;1571;4881;1662;5289
251010;201606;2756;8073;2470;7615;93;341;2139;6601;2232;6942
251020;201606;1637;4643;1499;4468;61;206;1371;4080;1432;4286
251030;201606;1083;3065;993;2914;70;268;732;2088;802;2356
251040;201606;1779;5568;1603;5275;106;509;1197;3802;1303;4311
251050;201606;1066;3087;909;2797;121;399;571;1722;692;2121
251060;201606;1023;2344;780;2034;41;138;622;1612;663;1750
251065;201606;467;1402;409;1313;33;126;279;839;312;965
251070;201606;621;1751;561;1669;40;154;445;1273;485;1427
251080;201606;19400;54585;17543;51587;4488;13847;8276;25177;12764;39024
251090;201606;2978;9202;2645;8579;215;825;1933;6167;2148;6992
251100;201606;979;3065;885;2905;90;381;594;1873;684;2254
251110;201606;1939;5676;1697;5209;149;487;1173;3589;1322;4076
251120;201606;6075;20538;5797;20055;631;2612;4380;14919;5011;17531
251130;201606;3965;10365;3649;10025;33;88;3567;9822;3600;9910
251140;201606;4245;12892;4002;12508;144;621;3384;10531;3528;11152
251150;201606;2549;8225;2380;7965;190;839;1801;5908;1991;6747
251160;201606;1844;5965;1785;5889;57;240;1645;5428;1702;5668
251170;201606;1406;4262;1331;4169;83;340;1139;3506;1222;3846
251180;201606;2537;7675;2308;7327;357;1214;1486;4703;1843;5917
251190;201606;4356;12048;4196;11867;157;519;3915;11012;4072;11531
251200;201606;3802;12321;3642;12122;99;436;3328;11061;3427;11497
251203;201606;1022;3405;998;3358;64;301;773;2551;837;2852
251207;201606;1098;3406;949;3139;61;279;638;2045;699;2324
251210;201606;7924;22398;6790;20911;689;2106;5266;16678;5955;18784
251220;201606;1170;3093;963;2793;80;246;736;2154;816;2400
251230;201606;4554;13617;4188;13180;229;901;3749;11684;3978;12585
251240;201606;3286;9901;3025;9567;372;1248;2304;7274;2676;8522
251250;201606;10392;30496;9625;29372;824;3085;7353;22005;8177;25090
251260;201606;488;1551;448;1495;23;96;339;1117;362;1213
251270;201606;4231;13655;3910;13269;146;648;3460;11739;3606;12387
251272;201606;1370;3951;1307;3870;67;220;1179;3485;1246;3705
251274;201606;908;2818;823;2675;88;369;571;1805;659;2174
251275;201606;1253;3626;1180;3508;75;330;928;2637;1003;2967
251276;201606;1224;3742;1152;3618;107;436;864;2651;971;3087
251278;201606;594;1865;528;1751;62;263;350;1138;412;1401
251280;201606;2333;6984;2191;6748;111;478;1778;5301;1889;5779
251290;201606;5611;15458;5281;15064;533;1947;4228;11761;4761;13708
251300;201606;782;2591;735;2522;45;190;588;1993;633;2183
251310;201606;2963;8863;2725;8523;157;672;2205;6741;2362;7413
251315;201606;1632;5621;1555;5491;165;653;1160;4091;1325;4744
251320;201606;1880;5241;1458;4553;82;313;1060;3306;1142;3619
251330;201606;1765;4742;1503;4408;73;291;1314;3789;1387;4080
251335;201606;1023;3447;939;3300;98;436;678;2335;776;2771
251340;201606;3385;9554;2998;8985;199;806;2291;6674;2490;7480
251350;201606;1275;4093;1191;3941;90;373;923;2977;1013;3350
251360;201606;1815;5670;1584;5370;63;270;1374;4688;1437;4958
251365;201606;801;2355;646;2033;31;131;455;1413;486;1544
251370;201606;22145;69228;21478;68324;2061;8155;17106;53130;19167;61285
251380;201606;1349;4177;1162;3862;59;290;972;3108;1031;3398
251385;201606;786;2107;668;1928;57;194;460;1259;517;1453
251390;201606;5804;19820;5257;18793;1378;5131;2666;9669;4044;14800
251392;201606;1048;3111;930;2926;77;289;714;2210;791;2499
251394;201606;616;1932;509;1740;45;188;353;1194;398;1382
251396;201606;822;2333;706;2143;79;236;476;1448;555;1684
251398;201606;965;2808;844;2587;39;157;579;1731;618;1888
251400;201606;1169;3273;998;3028;97;360;735;2168;832;2528
251410;201606;1482;3861;1268;3509;61;249;1057;2830;1118;3079
251420;201606;1986;5722;1752;5444;180;667;1320;4034;1500;4701
251430;201606;1620;5635;1480;5412;74;373;1228;4433;1302;4806
251440;201606;1242;3673;1021;3250;58;223;769;2440;827;2663
251445;201606;1482;4581;1399;4467;133;528;1078;3342;1211;3870
251450;201606;4531;14491;4265;14135;155;692;3614;11973;3769;12665
251455;201606;1074;3470;967;3272;89;369;677;2289;766;2658
251460;201606;793;2489;741;2401;61;211;607;1983;668;2194
251465;201606;437;1397;389;1297;17;81;295;961;312;1042
251470;201606;1177;3423;982;3040;92;353;604;1833;696;2186
251480;201606;944;2644;830;2462;39;177;663;1900;702;2077
251490;201606;1755;5231;1579;4961;170;636;1107;3440;1277;4076
251500;201606;1701;5445;1637;5330;115;470;1349;4307;1464;4777
251510;201606;2589;8449;2351;7977;409;1475;1391;4737;1800;6212
251520;201606;950;2574;836;2390;108;325;548;1549;656;1874
251530;201606;11994;33346;11324;32423;406;1745;9869;27667;10275;29412
251540;201606;2894;9237;2667;8811;184;745;2140;7009;2324;7754
251550;201606;3488;9085;2990;8437;84;339;2510;7007;2594;7346
251560;201606;697;2168;644;2074;97;370;396;1218;493;1588
251570;201606;1013;2988;819;2618;57;253;563;1720;620;1973
251580;201606;1901;5334;1748;5127;328;832;1170;3596;1498;4428
251590;201606;1483;4618;1417;4531;59;242;1176;3733;1235;3975
251593;201606;993;3092;923;2996;142;506;585;1859;727;2365
251597;201606;1896;5835;1829;5751;81;331;1631;5062;1712;5393
251600;201606;6462;19030;6020;18334;357;1307;4910;14844;5267;16151
251610;201606;3309;9880;2991;9327;250;804;2209;6928;2459;7732
251615;201606;1134;3253;924;2887;63;272;641;1940;704;2212
251620;201606;15113;41494;13458;39516;736;2294;11151;33854;11887;36148
251630;201606;4614;11927;3958;11012;283;896;3088;8455;3371;9351
251640;201606;2547;7432;2163;6798;113;473;1648;5106;1761;5579
251650;201606;3931;11379;3619;10974;224;751;3094;9342;3318;10093
251660;201606;3508;11270;3237;10795;157;759;2699;8783;2856;9542
251670;201606;4387;13156;3784;12378;59;193;3491;11606;3550;11799
251675;201606;727;2299;670;2223;126;484;426;1363;552;1847
251680;201606;2725;7819;2239;7068;116;497;1740;5413;1856;5910
251690;201606;3222;9765;3008;9355;173;634;2287;6981;2460;7615
251700;201606;1942;6272;1825;6125;108;506;1539;5067;1647;5573
251710;201606;897;2342;637;1841;102;334;298;796;400;1130
251720;201606;1410;4328;1229;4009;96;450;941;2964;1037;3414
251740;201606;776;2183;611;1903;62;215;386;1202;448;1417
260005;201606;25615;61924;21675;56450;4392;11484;11896;31444;16288;42928
260010;201606;10016;26985;8306;24763;1197;3733;4955;15396;6152;19129
260020;201606;6039;16719;5105;15324;241;894;4105;12374;4346;13268
260030;201606;6140;17532;5479;16532;394;1364;4228;12710;4622;14074
260040;201606;9928;24021;8203;22037;663;1775;6301;17544;6964;19319
260050;201606;11237;34737;10495;33869;548;2059;9071;29556;9619;31615
260060;201606;3872;10882;3438;10109;317;954;2541;7596;2858;8550
260070;201606;9804;28325;8995;27071;1191;4019;6119;18170;7310;22189
260080;201606;5757;15224;5104;14327;529;1675;3733;10335;4262;12010
260090;201606;5166;14244;4818;13744;598;1729;3598;10390;4196;12119
260100;201606;3343;9185;2895;8560;161;651;2396;7049;2557;7700
260105;201606;4948;13839;4686;13394;240;945;3925;10938;4165;11883
260110;201606;21033;59035;19376;57074;821;2745;17238;50842;18059;53587
260120;201606;11928;36070;10728;33984;2329;7649;5724;18742;8053;26391
260130;201606;3246;9073;3040;8753;377;1145;2207;6318;2584;7463
260140;201606;13298;32807;11439;30567;844;2601;9155;24641;9999;27242
260150;201606;3181;8887;2846;8439;199;801;2264;6637;2463;7438
260160;201606;5588;17550;4879;16615;310;1408;3991;13567;4301;14975
260170;201606;16418;46055;15629;44934;1084;3587;12999;37073;14083;40660
260180;201606;3255;9869;2960;9454;169;616;2503;8003;2672;8619
260190;201606;16157;37577;14703;35797;434;1334;12808;30776;13242;32110
260200;201606;11093;28955;10250;27860;505;1705;8854;24050;9359;25755
260210;201606;11677;35065;10394;33130;582;2330;8510;27082;9092;29412
260220;201606;9512;27352;9174;26918;426;1621;8157;23639;8583;25260
260230;201606;9679;27552;8902;26470;445;1673;7306;21712;7751;23385
260240;201606;3004;8906;2607;8334;317;1143;1865;5985;2182;7128
260250;201606;2272;6245;2026;5915;100;323;1697;4922;1797;5245
260260;201606;12275;34498;11183;32955;1198;3936;8440;25170;9638;29106
260270;201606;3638;10512;3363;10104;258;1142;2557;7349;2815;8491
260280;201606;12958;41756;11856;40115;741;2766;9900;33804;10641;36570
260290;201606;31110;93273;29355;90237;5082;16917;18666;56836;23748;73753
260300;201606;8542;26133;7539;24638;422;1838;5827;19096;6249;20934
260310;201606;4611;13526;4217;12955;929;2672;2559;8317;3488;10989
260320;201606;7196;23067;6667;22215;421;1630;5514;18412;5935;20042
260330;201606;2633;8443;2431;8078;160;729;1908;6190;2068;6919
260340;201606;1860;5449;1717;5225;54;195;1532;4657;1586;4852
260345;201606;22883;70881;21392;68114;5560;19643;8637;26591;14197;46234
260350;201606;4816;12984;4474;12499;188;697;3837;10593;4025;11290
260360;201606;2337;6745;2129;6387;134;545;1490;4447;1624;4992
260370;201606;5711;17752;5030;16536;450;1805;3596;11769;4046;13574
260380;201606;4874;15910;4429;15215;335;1459;3361;11462;3696;12921
260390;201606;4281;13681;3752;12631;333;1293;2661;8855;2994;10148
260392;201606;3482;11097;3168;10687;229;990;2680;8942;2909;9932
260400;201606;13761;38791;13007;37564;1695;5572;9112;25815;10807;31387
260410;201606;61237;174089;53485;161928;14779;47646;21521;67320;36300;114966
260415;201606;3833;12032;3303;10995;327;1407;2121;6821;2448;8228
260420;201606;12157;27531;10737;25987;257;901;9757;23367;10014;24268
260430;201606;2883;9274;2542;8646;252;953;1689;5739;1941;6692
260440;201606;3309;9946;2929;9176;398;1434;1850;5647;2248;7081
260450;201606;4930;14573;4713;14264;189;666;4210;12783;4399;13449
260460;201606;5610;17700;5106;16746;977;3553;2857;9203;3834;12756
260470;201606;4520;13680;4169;13260;182;558;3667;11984;3849;12542
260480;201606;4096;11651;3607;10971;481;1656;2415;7410;2896;9066
260490;201606;5053;13275;4382;12144;281;938;3552;9627;3833;10565
260500;201606;5892;16869;5236;15816;767;2380;3446;10515;4213;12895
260510;201606;8805;23466;8125;22580;359;1228;7148;19687;7507;20915
260515;201606;4771;14399;3699;12269;308;1211;2348;7781;2656;8992
260520;201606;16070;41723;15335;40741;1698;4647;11821;31345;13519;35992
260530;201606;9776;29722;8671;28039;406;1550;7347;23829;7753;25379
260540;201606;6048;14872;5494;14287;703;1305;4343;11945;5046;13250
260545;201606;71;254;48;187;10;40;11;38;21;78
260550;201606;2738;8923;2327;8045;454;1728;1031;3584;1485;5312
260560;201606;6186;16360;5565;15477;166;675;4902;13432;5068;14107
260570;201606;6871;22389;6268;21415;655;2627;4616;15728;5271;18355
260580;201606;3718;10377;3444;9919;161;601;2905;8180;3066;8781
260590;201606;6153;15367;5773;14933;302;825;5010;12981;5312;13806
260600;201606;27923;81572;25068;76847;2119;7946;18382;55931;20501;63877
260610;201606;6552;19629;6198;19062;794;2662;4427;13478;5221;16140
260620;201606;15674;47309;14939;46058;2447;8577;9588;28917;12035;37494
260630;201606;2226;6562;1990;6191;129;546;1613;4912;1742;5458
260640;201606;17243;47292;16132;45804;2343;7163;10857;30892;13200;38055
260650;201606;5402;16988;4797;15961;360;1422;3760;12572;4120;13994
260660;201606;7829;21712;7022;20688;310;1130;6020;17632;6330;18762
260670;201606;2375;6300;1939;5695;144;479;1371;4019;1515;4498
260680;201606;21440;60420;19581;57183;3825;11700;9896;29065;13721;40765
260690;201606;3671;9899;3065;8903;222;664;2314;6717;2536;7381
260700;201606;5754;17069;5616;16925;33;75;5502;16741;5535;16816
260710;201606;1318;3870;1224;3749;104;364;924;2871;1028;3235
260720;201606;17587;55903;16544;53977;3569;12184;9244;30455;12813;42639
260730;201606;6737;22419;6301;21697;819;3131;4613;15801;5432;18932
260740;201606;1294;3845;1138;3572;99;359;817;2547;916;2906
260750;201606;6834;20669;6080;19709;349;1155;5219;17246;5568;18401
260760;201606;4756;12756;4460;12381;229;732;3721;10373;3950;11105
260765;201606;7755;26112;7364;25456;1075;4794;5054;16822;6129;21616
260770;201606;3780;10055;3472;9592;144;506;2836;7739;2980;8245
260775;201606;4999;14590;4706;14156;464;1748;3373;9885;3837;11633
260780;201606;3640;11720;3394;11247;698;2640;1821;5802;2519;8442
260790;201606;110385;278196;102043;265861;19897;53835;60376;156995;80273;210830
260795;201606;3059;9112;2741;8629;238;894;1991;6298;2229;7192
260800;201606;4881;13061;4547;12610;129;566;4073;10960;4202;11526
260805;201606;3836;11251;3318;10426;376;1405;2276;7059;2652;8464
260810;201606;6849;19169;6605;18863;307;1022;5835;16632;6142;17654
260820;201606;4123;11641;3670;10938;773;2472;1947;5771;2720;8243
260825;201606;2892;9194;2582;8687;169;706;1989;6697;2158;7403
260830;201606;3693;11866;3304;11114;551;1881;2102;7218;2653;9099
260840;201606;4255;12121;3770;11411;244;907;3055;9137;3299;10044
260845;201606;4180;12098;3944;11681;460;1425;2904;8646;3364;10071
260850;201606;4941;16122;4385;14884;860;3282;2109;7093;2969;10375
260860;201606;3516;10781;3091;9949;187;726;2383;7639;2570;8365
260870;201606;4181;11378;3713;10790;392;1208;2871;8407;3263;9615
260875;201606;6446;17883;5716;16742;804;2436;3885;11476;4689;13912
260880;201606;9629;29166;8804;27830;607;2077;7031;22408;7638;24485
260890;201606;13088;37401;12182;35995;830;3041;9325;27314;10155;30355
260900;201606;5848;17918;5039;16364;490;2010;3195;10195;3685;12205
260910;201606;3008;9027;2726;8589;177;669;2065;6504;2242;7173
260915;201606;4548;15198;4295;14852;101;500;3938;13590;4039;14090
260920;201606;3202;9772;2964;9445;181;675;2395;7727;2576;8402
260930;201606;3904;12638;3466;11923;377;1405;2434;8397;2811;9802
260940;201606;13905;36857;12703;34936;1538;4956;8547;22985;10085;27941
260950;201606;6310;19415;5684;18174;905;3479;3029;9240;3934;12719
260960;201606;55606;153676;50817;146016;9994;30973;27408;78445;37402;109418
260970;201606;4930;14986;4497;14419;295;1210;3563;11434;3858;12644
260980;201606;3927;12626;3684;12318;140;599;3284;10940;3424;11539
260990;201606;17184;53001;15643;50880;1100;4272;12573;41011;13673;45283
261000;201606;16025;43356;13117;38926;2309;7343;6930;21316;9239;28659
261010;201606;2540;7038;2329;6790;121;289;2061;6157;2182;6446
261020;201606;6209;18005;5490;16789;524;1773;4034;12109;4558;13882
261030;201606;3557;11217;3214;10612;214;887;2541;8261;2755;9148
261040;201606;5127;16464;4460;15120;405;1662;3218;10748;3623;12410
261050;201606;7847;22932;7344;22034;943;3020;4998;15078;5941;18098
261060;201606;12228;35808;11292;34147;1011;3766;8493;25123;9504;28889
261070;201606;51585;126047;45550;117621;5758;15794;30701;79080;36459;94874
261080;201606;5683;16513;5353;16023;307;915;4633;14049;4940;14964
261090;201606;16504;45118;15130;43228;1258;3798;12054;34657;13312;38455
261100;201606;8113;25366;7250;23879;1249;4503;4276;14279;5525;18782
261110;201606;61157;180074;54299;169955;12399;41078;27731;89477;40130;130555
261120;201606;3792;9956;3310;9388;99;379;2949;8352;3048;8731
261130;201606;7041;18017;6524;17439;168;582;5948;15851;6116;16433
261140;201606;3241;9045;2943;8596;374;1310;1880;5390;2254;6700
261150;201606;5373;15555;4961;14910;357;1315;4100;12251;4457;13566
261153;201606;2146;6210;1767;5633;99;412;1308;4169;1407;4581
261160;201606;196365;513343;181564;492063;43829;124714;87911;242575;131740;367289
261170;201606;5863;15945;5333;15173;451;1379;4171;11964;4622;13343
261180;201606;9564;26516;8901;25584;961;3191;6129;17465;7090;20656
261190;201606;5152;15800;4788;15350;566;2395;3432;10676;3998;13071
261200;201606;3584;8977;3221;8549;339;920;2552;6854;2891;7774
261210;201606;1910;5038;1776;4869;111;321;1565;4300;1676;4621
261220;201606;13261;40956;11204;36656;1668;6066;6006;19519;7674;25585
261230;201606;4607;14443;4238;13989;139;598;3741;12438;3880;13036
261240;201606;4908;14373;4493;13684;595;1790;3158;9773;3753;11563
261245;201606;3578;10964;3075;10054;177;803;2406;7694;2583;8497
261247;201606;3259;9963;2782;9109;198;815;1984;6564;2182;7379
261250;201606;19512;51905;18268;50239;3071;8105;12739;36234;15810;44339
261255;201606;4050;12508;3607;11714;232;1049;2848;9010;3080;10059
261260;201606;12216;34158;10953;32616;557;1889;9278;27827;9835;29716
261270;201606;3625;10764;3268;10186;346;1240;2282;6979;2628;8219
261280;201606;2544;7733;2355;7454;145;587;1921;6000;2066;6587
261290;201606;2919;8360;2649;8004;146;553;2167;6579;2313;7132
261300;201606;10656;34289;9319;31851;1395;5508;5809;19647;7204;25155
261310;201606;7291;22403;6848;21597;1633;5296;3888;12344;5521;17640
261320;201606;5748;17774;5269;16916;253;1043;4284;13632;4537;14675
261330;201606;5518;15747;5208;15325;423;1500;4263;12375;4686;13875
261340;201606;3883;12981;3675;12644;398;1703;2500;8515;2898;10218
261350;201606;8073;26529;7583;25703;381;1899;6152;20358;6533;22257
261360;201606;8179;21462;7253;20164;559;1714;5731;15704;6290;17418
261370;201606;19616;57591;18220;55391;3664;11865;10521;32129;14185;43994
261380;201606;4109;14012;3804;13369;536;2109;2494;8746;3030;10855
261390;201606;16205;49132;14670;46611;2109;7369;9008;28796;11117;36165
261400;201606;4673;15976;4169;14927;356;1514;2945;10496;3301;12010
261410;201606;8801;24364;7900;22989;748;2385;6093;17738;6841;20123
261420;201606;7391;24792;7059;24335;1636;6317;4291;14641;5927;20958
261430;201606;3420;10570;2990;9938;265;956;2302;7758;2567;8714
261440;201606;1539;4846;1385;4610;72;352;1062;3459;1134;3811
261450;201606;14148;39969;13610;39332;357;1395;12364;35519;12721;36914
261460;201606;7161;20919;6665;20258;380;1164;5759;17708;6139;18872
261470;201606;3979;10866;3624;10408;87;289;3297;9546;3384;9835
261480;201606;3732;13166;3430;12616;311;1357;2547;9223;2858;10580
261485;201606;4907;15035;4406;14163;673;2530;2727;8621;3400;11151
261500;201606;5641;15677;5021;14859;433;1243;3777;11517;4210;12760
261510;201606;1883;6008;1707;5723;141;542;1271;4271;1412;4813
261520;201606;2675;8661;2503;8341;154;602;1677;5815;1831;6417
261530;201606;11410;36731;10219;34329;2096;8048;4598;15354;6694;23402
261540;201606;7072;22838;6662;22126;1432;4796;3976;13589;5408;18385
261550;201606;3430;9669;3229;9386;237;933;2555;7213;2792;8146
261560;201606;7010;23035;6358;22152;785;3186;4690;16412;5475;19598
261570;201606;3389;10224;2966;9538;387;1372;1914;6143;2301;7515
261580;201606;6016;18210;5439;17303;314;1350;4564;14350;4878;15700
261590;201606;2424;6836;2112;6356;190;598;1550;4708;1740;5306
261600;201606;5282;14255;4546;13217;328;1051;3588;10477;3916;11528
261610;201606;2372;6802;2078;6406;95;406;1697;5203;1792;5609
261618;201606;2506;6963;2274;6676;181;617;1768;5120;1949;5737
261620;201606;4104;12702;3826;12234;626;2040;2587;8426;3213;10466
261630;201606;7652;22399;6454;20171;802;3012;3757;11505;4559;14517
261640;201606;33527;83682;31384;81129;2011;5050;25580;68714;27591;73764
261650;201606;3718;11222;3456;10868;293;1124;2609;8268;2902;9392
270010;201606;4442;16571;4053;15828;410;1943;2846;11094;3256;13037
270020;201606;3841;10903;3573;10514;339;1179;2843;8225;3182;9404
270030;201606;39211;116857;36529;112594;8239;26279;20719;64729;28958;91008
270040;201606;10618;32377;9786;31286;1762;5867;6318;20679;8080;26546
270050;201606;4302;12076;3920;11605;393;1377;3131;9222;3524;10599
270060;201606;1869;5486;1736;5320;273;899;1200;3730;1473;4629
270070;201606;4313;13197;3956;12724;202;979;3407;10705;3609;11684
270080;201606;1256;3962;1091;3641;146;551;690;2243;836;2794
270090;201606;2101;6483;1923;6134;81;419;1587;4874;1668;5293
270100;201606;5653;17433;5327;16882;720;2631;3785;11824;4505;14455
270110;201606;3189;8725;2815;8319;399;1165;1941;6082;2340;7247
270120;201606;3104;8760;2731;8306;97;401;2419;7343;2516;7744
270130;201606;5095;15365;4703;14920;605;1980;3587;11661;4192;13641
270135;201606;1767;4692;1605;4490;158;330;1352;3933;1510;4263
270140;201606;10257;24642;8755;22767;710;2793;6922;16889;7632;19682
270150;201606;2703;8796;2621;8696;56;195;2511;8368;2567;8563
270160;201606;5048;16615;4600;16040;216;968;3951;13675;4167;14643
270170;201606;3771;12134;3473;11740;562;2232;2170;7272;2732;9504
270180;201606;2266;7438;2082;7177;132;673;1709;5750;1841;6423
270190;201606;1782;5848;1689;5728;102;406;1425;4869;1527;5275
270200;201606;2596;8627;2418;8374;240;1050;1851;6259;2091;7309
270210;201606;4669;13996;4382;13600;271;1169;3708;11295;3979;12464
270220;201606;1324;4355;1220;4171;253;954;703;2365;956;3319
270230;201606;10864;33984;9512;31878;1304;5384;5861;19100;7165;24484
270235;201606;6365;20460;5929;19773;370;1640;4865;16043;5235;17683
270240;201606;9439;28379;7914;26429;2002;7022;3904;13506;5906;20528
270250;201606;3259;8496;2956;8124;395;1128;2317;6363;2712;7491
270255;201606;4950;14838;3878;12920;292;1298;2765;8998;3057;10296
270260;201606;5867;18806;5665;18523;456;1953;4759;15214;5215;17167
270270;201606;1177;3357;1078;3215;193;615;656;1928;849;2543
270280;201606;3478;9826;3068;9238;380;1061;2122;6543;2502;7604
270290;201606;8122;28060;7578;27125;693;3166;5862;20683;6555;23849
270300;201606;3616;11395;3239;10951;358;1352;2388;8090;2746;9442
270310;201606;7527;22602;6611;21252;294;1450;5550;17458;5844;18908
270320;201606;5824;18264;5523;17775;778;2890;3970;12591;4748;15481
270330;201606;4278;14498;3996;14114;427;1635;3140;11203;3567;12838
270340;201606;1736;5275;1529;5003;125;487;1210;3915;1335;4402
270350;201606;1889;5067;1698;4841;145;475;1256;3594;1401;4069
270360;201606;1942;6045;1856;5948;130;405;1612;5268;1742;5673
270370;201606;1511;4966;1378;4744;119;522;1012;3466;1131;3988
270375;201606;2895;7945;2581;7532;127;462;2236;6471;2363;6933
270380;201606;5648;17341;5263;16822;440;1476;4127;13437;4567;14913
270390;201606;1248;3419;1097;3202;71;282;835;2346;906;2628
270400;201606;6327;18848;5646;17862;408;1705;4189;12904;4597;14609
270410;201606;4814;15008;4427;14311;426;1616;3193;10181;3619;11797
270420;201606;5798;18526;5567;18210;337;1522;4587;14706;4924;16228
270430;201606;135619;390620;121243;369158;34939;113399;48204;151737;83143;265136
270440;201606;4657;13969;4304;13498;221;931;3550;11102;3771;12033
270450;201606;6218;19159;5934;18797;368;1587;4951;15440;5319;17027
270460;201606;3409;9022;3060;8597;141;502;2662;7363;2803;7865
270470;201606;10324;32637;9464;31263;1218;4521;6295;20951;7513;25472
270480;201606;2825;8767;2499;8180;298;1232;1730;5427;2028;6659
270490;201606;974;3079;901;2979;53;229;718;2351;771;2580
270500;201606;4838;16475;4550;16117;309;1418;3799;13381;4108;14799
270510;201606;5921;17562;5304;16696;599;2476;4042;12275;4641;14751
270520;201606;3577;11285;3266;10762;1050;3774;1164;4028;2214;7802
270530;201606;1363;4210;1262;4061;132;462;870;2841;1002;3303
270540;201606;2041;6776;1864;6517;130;651;1518;5156;1648;5807
270550;201606;7149;20738;6216;19562;818;2815;4352;14040;5170;16855
270560;201606;3064;9184;2847;8851;282;1104;2122;6445;2404;7549
270570;201606;3804;12277;3491;11732;313;1344;2729;8989;3042;10333
270580;201606;2036;6404;1936;6271;161;561;1566;5146;1727;5707
270590;201606;1374;4543;1314;4444;11;45;1273;4321;1284;4366
270600;201606;2813;9299;2556;8870;185;918;2042;6902;2227;7820
270610;201606;3211;9981;2976;9648;195;760;2481;7961;2676;8721
270620;201606;1377;4651;1296;4521;105;489;1037;3491;1142;3980
270630;201606;16283;47456;14858;45165;2032;6384;10378;32202;12410;38586
270640;201606;5699;17442;5151;16613;352;1493;4141;13090;4493;14583
270642;201606;2270;8022;2117;7806;249;1156;1596;5776;1845;6932
270644;201606;2665;7816;2358;7407;220;687;1837;5906;2057;6593
270650;201606;3654;11495;3473;11245;522;2364;2450;7462;2972;9826
270660;201606;2112;5514;1692;4911;92;391;1268;3584;1360;3975
270670;201606;16508;42130;14233;39563;1727;4786;10501;30214;12228;35000
270680;201606;4294;12555;4102;12338;116;338;3819;11560;3935;11898
270690;201606;9071;25144;8099;24056;2411;6780;4613;14705;7024;21485
270700;201606;643;1986;580;1882;95;394;390;1204;485;1598
270710;201606;5901;18777;5582;18366;416;1692;4673;15193;5089;16885
270720;201606;3325;11212;3026;10674;178;969;2475;8533;2653;9502
270730;201606;6371;18496;6023;18123;539;1723;5018;15330;5557;17053
270740;201606;2276;6508;2144;6317;237;845;1675;4836;1912;5681
270750;201606;5087;15707;4712;15117;657;2387;3355;10682;4012;13069
270760;201606;3359;10097;3003;9514;180;723;2402;7535;2582;8258
270770;201606;18857;48967;15477;44890;3254;9531;8728;26805;11982;36336
270780;201606;1804;5801;1705;5640;211;810;1249;4078;1460;4888
270790;201606;1510;4746;1384;4565;342;1234;739;2415;1081;3649
270800;201606;11429;33308;10624;32266;702;2707;8896;26619;9598;29326
270810;201606;3301;10001;2580;8702;289;1165;1613;5482;1902;6647
270820;201606;1795;5834;1606;5525;255;1000;1022;3494;1277;4494
270830;201606;5615;15100;5079;14458;401;1186;4111;12063;4512;13249
270840;201606;7800;25119;7227;24373;397;1998;6183;20336;6580;22334
270850;201606;7323;22778;7032;22402;999;4125;5088;15402;6087;19527
270860;201606;11008;30769;9314;28608;1124;4197;6346;19132;7470;23329
270870;201606;2138;6458;1794;5751;213;760;1191;3770;1404;4530
270880;201606;8154;25975;7563;25111;483;2065;6176;20213;6659;22278
270890;201606;2377;7243;2223;6970;251;954;1635;5005;1886;5959
270895;201606;2867;10558;2741;10374;150;714;2389;9015;2539;9729
270900;201606;1923;5196;1563;4693;118;419;1160;3427;1278;3846
270910;201606;3548;11568;3267;11063;268;1224;2546;8396;2814;9620
270915;201606;9444;31359;8492;29686;1353;5618;5090;17451;6443;23069
270920;201606;6118;19223;5888;18903;309;1517;5210;16260;5519;17777
270930;201606;17289;45637;14311;42120;2652;7899;8686;26661;11338;34560
270940;201606;5601;18554;5273;18201;560;2658;3522;11666;4082;14324
280010;201606;647;1912;564;1769;57;249;366;1068;423;1317
280020;201606;4797;13838;4144;12741;620;2101;2650;8097;3270;10198
280030;201606;75234;194923;64292;178837;17780;52002;25717;74198;43497;126200
280040;201606;3107;9453;2751;8924;249;963;2059;6592;2308;7555
280050;201606;3792;12003;3496;11507;1080;3784;1529;5171;2609;8955
280060;201606;4823;15182;4259;14176;873;3161;2198;7504;3071;10665
280067;201606;7274;20366;6249;18820;901;2801;3969;12107;4870;14908
280070;201606;1896;6228;1806;6099;205;794;1370;4597;1575;5391
280100;201606;3800;11709;3428;11061;531;1895;2226;7237;2757;9132
280110;201606;1416;4220;1305;4053;62;253;1097;3362;1159;3615
280120;201606;7806;24454;7160;23413;1129;3550;4972;16911;6101;20461
280130;201606;7508;20826;6848;19874;994;3195;4685;13682;5679;16877
280140;201606;5722;15192;5217;14475;385;1176;4248;11809;4633;12985
280150;201606;3433;10217;3189;9820;297;1120;2342;7027;2639;8147
280160;201606;1369;3974;1191;3694;172;606;778;2363;950;2969
280170;201606;4781;14127;4332;13464;445;1464;3264;10274;3709;11738
280190;201606;1096;2999;986;2818;73;287;770;2124;843;2411
280200;201606;1171;3459;1065;3305;123;467;778;2359;901;2826
280210;201606;13718;40270;12293;38315;2199;7477;7199;22825;9398;30302
280220;201606;1565;4812;1463;4649;90;376;1218;3798;1308;4174
280230;201606;3451;10211;3092;9663;369;1304;2037;6376;2406;7680
280240;201606;3473;9992;3152;9490;229;740;2513;7573;2742;8313
280250;201606;818;2146;656;1881;115;387;334;887;449;1274
280260;201606;2043;5436;1905;5266;71;223;1724;4797;1795;5020
280270;201606;2222;6885;1985;6531;120;520;1566;5056;1686;5576
280280;201606;4122;13328;3725;12679;722;2072;2209;8328;2931;10400
280290;201606;17560;52645;15888;50115;2113;7547;10237;32429;12350;39976
280300;201606;9467;28618;8904;27936;761;2752;7072;22753;7833;25505
280310;201606;1375;3830;1207;3554;58;243;877;2524;935;2767
280320;201606;8635;27117;7899;25901;1473;5356;4310;14083;5783;19439
280330;201606;4470;12685;4072;12045;445;1583;3060;8753;3505;10336
280340;201606;3853;10725;3606;10389;305;1024;2918;8483;3223;9507
280350;201606;22119;61470;19688;57849;2815;9001;13029;38536;15844;47537
280360;201606;5821;18122;5376;17387;1012;3697;3063;9749;4075;13446
280370;201606;1890;5233;1623;4786;161;483;1137;3355;1298;3838
280380;201606;1034;3154;930;2989;113;450;656;2044;769;2494
280390;201606;3143;9190;2691;8364;294;993;1799;5611;2093;6604
280400;201606;4212;11837;3829;11287;1116;3283;1881;5862;2997;9145
280410;201606;2214;7004;1885;6364;254;989;1100;3589;1354;4578
280420;201606;4136;12001;3833;11529;209;729;3270;9820;3479;10549
280430;201606;2275;5785;2051;5478;124;443;1609;4211;1733;4654
280440;201606;4665;13710;4320;13285;358;1295;3513;10684;3871;11979
280445;201606;2509;6961;2331;6666;96;386;1856;5210;1952;5596
280450;201606;9114;24125;8461;23308;550;1302;7166;20320;7716;21622
280460;201606;6894;17994;6231;17056;697;2040;4652;12871;5349;14911
280470;201606;1798;5431;1630;5145;173;585;1181;3759;1354;4344
280480;201606;31795;91581;29767;88605;4837;16347;19605;57569;24442;73916
280490;201606;3854;11424;3388;10648;266;1030;2511;7763;2777;8793
280500;201606;926;2463;835;2348;45;140;705;1966;750;2106
280510;201606;2654;7651;2299;7188;185;716;1705;5321;1890;6037
280520;201606;1814;4866;1651;4671;119;340;1387;3953;1506;4293
280530;201606;2456;6594;2275;6381;147;465;1890;5355;2037;5820
280540;201606;9416;25551;8714;24583;277;1226;7637;21066;7914;22292
280550;201606;6969;18095;5842;16396;582;1744;4145;11649;4727;13393
280560;201606;7579;22272;7156;21662;384;1465;6067;18133;6451;19598
280570;201606;6494;17416;5652;16286;613;2080;3907;11165;4520;13245
280580;201606;5567;17071;4737;15621;722;2534;2939;9910;3661;12444
280590;201606;2480;7217;2233;6906;251;1066;1514;4543;1765;5609
280600;201606;3651;11147;3398;10773;342;1297;2608;8158;2950;9455
280610;201606;2501;6935;2276;6607;210;758;1659;4691;1869;5449
280620;201606;5234;15377;4595;14286;558;1730;3108;10018;3666;11748
280630;201606;3653;11821;3418;11464;317;1077;2735;9399;3052;10476
280640;201606;2235;6641;2135;6528;70;184;2008;6213;2078;6397
280650;201606;1119;3462;1010;3288;104;412;725;2339;829;2751
280660;201606;2725;7539;2597;7385;318;882;2105;6046;2423;6928
280670;201606;16403;42560;15115;40826;2371;6888;10151;27195;12522;34083
280680;201606;2810;7540;2477;7024;181;593;1951;5430;2132;6023
280690;201606;956;2713;845;2560;115;381;588;1782;703;2163
280700;201606;1071;3184;946;2982;74;246;682;2144;756;2390
280710;201606;12083;31357;10984;30100;657;1680;9401;26281;10058;27961
280720;201606;2343;6253;2132;6006;241;740;1496;4386;1737;5126
280730;201606;922;2748;860;2659;79;317;686;2075;765;2392
280740;201606;13240;35557;11475;32897;1444;4212;7560;22027;9004;26239
280750;201606;3503;10600;3208;10108;314;1142;2298;7249;2612;8391
280760;201606;5677;17169;5167;16424;826;2823;3196;10444;4022;13267
290010;201606;3011;6768;2187;5503;67;266;1717;4107;1784;4373
290020;201606;4370;14447;4274;14319;385;1211;3632;12359;4017;13570
290030;201606;3170;9725;2989;9459;377;1276;2274;7187;2651;8463
290035;201606;4669;11802;4031;10959;244;747;3117;8735;3361;9482
290040;201606;4143;10950;3537;10264;258;973;2754;7961;3012;8934
290050;201606;2476;8025;2219;7603;176;733;1641;5607;1817;6340
290060;201606;1310;3358;1101;3108;133;460;824;2255;957;2715
290070;201606;34003;83579;29053;77408;5695;15660;14861;41958;20556;57618
290080;201606;6095;18013;5170;16773;667;2183;3634;12189;4301;14372
290090;201606;2156;4675;1693;4183;111;257;1454;3662;1565;3919
290100;201606;9597;27310;8441;25514;1057;3386;5452;16910;6509;20296
290110;201606;4838;14276;4585;13846;685;2330;3024;8956;3709;11286
290115;201606;4825;14476;4270;13759;256;816;3499;11574;3755;12390
290120;201606;6816;17698;5615;16275;248;961;4689;13454;4937;14415
290130;201606;4632;12086;3824;11090;204;809;3074;8683;3278;9492
290135;201606;4568;11362;3894;10340;313;1007;2832;7239;3145;8246
290140;201606;4241;12990;3653;12195;279;1085;2984;9983;3263;11068
290150;201606;2198;6576;2091;6424;200;685;1670;5049;1870;5734
290160;201606;3395;8800;3242;8611;232;604;2753;7286;2985;7890
290170;201606;2759;8987;2495;8610;174;799;2089;7124;2263;7923
290180;201606;2965;8556;2558;7925;181;692;1995;6141;2176;6833
290190;201606;3798;12523;3616;12260;254;1135;2832;9486;3086;10621
290195;201606;2189;5913;1837;5385;75;334;1528;4408;1603;4742
290200;201606;3903;12013;3443;11315;269;1004;2709;8864;2978;9868
290205;201606;3228;9342;2901;8838;202;813;2215;6614;2417;7427
290210;201606;15050;41964;13563;40059;2194;5703;9309;29376;11503;35079
290220;201606;2313;6800;2184;6595;137;584;1744;5123;1881;5707
290225;201606;2983;7219;2671;6871;128;356;2419;6220;2547;6576
290230;201606;2254;7295;2131;7148;139;614;1777;5920;1916;6534
290240;201606;3624;9742;3295;9259;249;781;2577;7157;2826;7938
290250;201606;3867;12098;3520;11609;160;487;2935;10152;3095;10639
290260;201606;5099;14308;4252;13037;323;1161;3294;10078;3617;11239
290265;201606;3420;10597;3036;9916;186;787;2353;7637;2539;8424
290270;201606;12047;43500;11450;42561;1390;5716;8415;31497;9805;37213
290280;201606;5311;17164;4916;16520;426;1585;3648;12319;4074;13904
290290;201606;9845;30640;8730;28796;1212;4199;5941;19934;7153;24133
290300;201606;4680;13071;3380;10661;256;867;2260;7304;2516;8171
290310;201606;1457;4359;1256;4036;230;793;709;2309;939;3102
290320;201606;28777;81290;24420;75646;5390;17931;12773;40816;18163;58747
290323;201606;3892;10468;3419;9934;168;562;2862;8284;3030;8846
290327;201606;4458;13372;3826;12238;508;1723;2533;8116;3041;9839
290330;201606;1826;4446;1683;4295;113;307;1477;3802;1590;4109
290340;201606;5002;15254;4668;14840;1190;3923;2785;9001;3975;12924
290350;201606;4414;13527;3856;12707;361;1282;2766;9329;3127;10611
290360;201606;4588;13742;3960;12896;165;693;3314;10880;3479;11573
290370;201606;4782;13084;4113;12229;270;856;3372;10106;3642;10962
290380;201606;5632;16133;4885;15004;337;1118;3829;11976;4166;13094
290390;201606;14836;44681;13365;42550;2071;6944;8532;28152;10603;35096
290395;201606;2592;8423;2312;7896;141;655;1747;5960;1888;6615
290400;201606;3631;10548;3072;9703;251;892;2202;6889;2453;7781
290405;201606;4708;14691;3994;13393;551;1980;2473;8453;3024;10433
290410;201606;5968;17474;4843;15711;419;1722;3441;10846;3860;12568
290420;201606;3283;9457;2735;8673;205;759;2148;6804;2353;7563
290430;201606;3130;9715;2778;9086;472;1636;1697;5620;2169;7256
290440;201606;3013;7883;2409;7035;169;596;1855;5466;2024;6062
290450;201606;3301;9561;2801;8822;288;1037;1917;6008;2205;7045
290460;201606;12909;37235;11582;35001;3355;10521;4660;14276;8015;24797
290470;201606;4416;12112;3367;10566;735;2566;1564;5109;2299;7675
290475;201606;5510;17644;4899;16527;284;1360;3755;12346;4039;13706
290480;201606;2506;6699;2321;6461;248;715;1662;4886;1910;5601
290485;201606;4806;15168;4169;14214;298;1448;3349;11205;3647;12653
290490;201606;8184;21273;7721;20682;568;1766;6431;16996;6999;18762
290500;201606;4191;13083;3443;11612;565;2117;1863;6282;2428;8399
290510;201606;3366;9487;2938;8909;159;605;2447;7417;2606;8022
290515;201606;3526;9846;2968;9121;223;680;2402;7537;2625;8217
290520;201606;11992;36472;9687;32083;847;3349;5959;19582;6806;22931
290530;201606;5127;15025;4479;14022;338;1156;3544;11135;3882;12291
290540;201606;3929;11213;3729;10972;343;1053;3071;9125;3414;10178
290550;201606;4643;11986;4065;11333;116;339;3727;10453;3843;10792
290560;201606;6399;18275;5611;17165;1034;3302;3490;10795;4524;14097
290570;201606;42699;116084;38939;110974;3748;11647;28473;81071;32221;92718
290580;201606;7056;23749;6625;23068;759;2835;4904;17440;5663;20275
290590;201606;7313;23121;6290;21315;307;1318;5070;17152;5377;18470
290600;201606;17701;52946;16404;51123;1868;5884;12484;39997;14352;45881
290610;201606;2488;8339;2060;7492;152;714;1441;5130;1593;5844
290620;201606;6486;19451;5901;18553;363;1278;4865;15256;5228;16534
290630;201606;8192;21164;7175;20048;543;1586;6009;16994;6552;18580
290640;201606;2707;7769;2189;6942;133;564;1674;5206;1807;5770
290650;201606;11008;31416;10379;30587;2128;6248;6516;19825;8644;26073
290660;201606;3722;10217;3188;9458;157;517;2433;7509;2590;8026
290670;201606;6923;20981;6153;19702;702;2328;4326;14084;5028;16412
290680;201606;10451;30641;9396;29337;481;2019;7749;23915;8230;25934
290682;201606;4599;12986;4058;12219;161;626;3499;10431;3660;11057
290685;201606;3770;8885;2482;7093;296;900;1542;4502;1838;5402
290687;201606;7550;21174;5902;18675;1335;4327;2909;9741;4244;14068
290689;201606;3187;9147;2806;8575;218;733;2142;6761;2360;7494
290690;201606;5488;15403;4821;14522;685;2134;3246;9907;3931;12041
290700;201606;2362;7256;2225;7059;150;565;1763;5593;1913;6158
290710;201606;7745;24095;7241;23355;447;1543;5989;19418;6436;20961
290720;201606;18735;54231;17136;52226;1215;3679;14237;44276;15452;47955
290730;201606;7290;19793;6513;18780;825;2440;4631;13516;5456;15956
290740;201606;954;2800;756;2450;76;293;518;1665;594;1958
290750;201606;10295;28489;8844;25862;1395;4579;5122;14600;6517;19179
290755;201606;2353;6629;1905;5885;119;470;1400;4273;1519;4743
290760;201606;4216;12691;3423;11246;469;1476;2095;7135;2564;8611
290770;201606;2541;8856;2379;8644;137;632;1934;7052;2071;7684
290780;201606;9040;22720;7801;20934;686;1469;6056;16900;6742;18369
290790;201606;4394;13022;4042;12538;226;775;3467;10756;3693;11531
290800;201606;7253;15308;5734;13689;444;876;4452;11208;4896;12084
290810;201606;5325;16125;4474;14766;193;780;3450;11422;3643;12202
290820;201606;5698;15714;5060;14892;445;1457;3869;11533;4314;12990
290830;201606;4379;11549;4023;11063;231;860;3036;8163;3267;9023
290840;201606;17685;49788;15604;46708;2156;6333;10376;32444;12532;38777
290850;201606;6176;17696;5926;17396;655;1745;4706;14357;5361;16102
290860;201606;5120;16999;4763;16573;391;1484;3799;13538;4190;15022
290870;201606;4756;13831;3814;12254;274;1140;2755;8805;3029;9945
290880;201606;1446;3882;1153;3428;97;285;791;2396;888;2681
290890;201606;7154;18234;6080;17043;510;1367;5060;14434;5570;15801
290900;201606;2446;6969;1844;5924;247;867;1019;3260;1266;4127
290910;201606;4736;12539;3909;11343;117;499;3310;9466;3427;9965
290920;201606;4928;13437;4506;12864;238;720;3851;10998;4089;11718
290930;201606;8118;24314;7018;22548;388;1710;5544;17543;5932;19253
290940;201606;3527;11074;3163;10549;137;487;2567;8763;2704;9250
290950;201606;1565;4286;1365;3983;130;399;947;2800;1077;3199
290960;201606;5795;16237;5250;15557;231;806;4414;13131;4645;13937
290970;201606;3713;11518;3229;10731;292;1045;2234;7521;2526;8566
290980;201606;10633;30020;8994;26992;2464;7830;2816;8513;5280;16343
290990;201606;9129;27029;7871;24964;705;2664;5893;18352;6598;21016
291000;201606;3079;8951;2753;8578;123;449;2462;7692;2585;8141
291005;201606;14455;37362;12745;35139;1465;4162;9146;25642;10611;29804
291010;201606;3287;10095;2581;8614;242;846;1705;5775;1947;6621
291020;201606;1357;3535;1049;3009;120;358;580;1585;700;1943
291030;201606;2270;6127;1660;4936;155;514;999;2909;1154;3423
291040;201606;5568;16483;4938;15565;330;1313;3884;12236;4214;13549
291050;201606;7871;25318;7144;24019;1533;5804;3955;12991;5488;18795
291060;201606;6031;21933;5677;21382;916;3960;3746;13976;4662;17936
291070;201606;16319;46326;14243;43339;978;3524;11055;33567;12033;37091
291072;201606;23241;68004;18754;59180;4739;16198;6560;21169;11299;37367
291075;201606;5165;14448;4586;13587;318;855;3515;10566;3833;11421
291077;201606;1476;4172;1192;3706;112;403;770;2381;882;2784
291080;201606;78504;242572;70481;227513;24894;82376;16235;53300;41129;135676
291085;201606;5730;14919;4916;13848;356;1142;4039;11389;4395;12531
291090;201606;1633;3807;1474;3624;48;145;1321;3236;1369;3381
291100;201606;2592;6562;2079;5998;126;515;1635;4650;1761;5165
291110;201606;4935;17467;4450;16745;544;2382;3212;11882;3756;14264
291120;201606;7260;19554;6686;18704;784;2260;4774;13479;5558;15739
291125;201606;1935;3831;1478;3342;87;225;1192;2737;1279;2962
291130;201606;2854;8899;2415;8132;151;683;1803;5935;1954;6618
291140;201606;4169;12320;3605;11275;452;1428;2333;7400;2785;8828
291150;201606;1961;5120;1843;4981;113;389;1542;4110;1655;4499
291160;201606;5286;16442;4612;15322;860;3106;2643;8698;3503;11804
291165;201606;2554;7110;1954;6005;72;304;1412;4238;1484;4542
291170;201606;21974;56775;18767;52445;1766;5586;12205;34246;13971;39832
291180;201606;6235;16196;5063;14435;395;1241;3679;10551;4074;11792
291185;201606;3716;10006;3305;9384;171;548;2736;7680;2907;8228
291190;201606;7147;19391;6285;18194;469;1672;5088;14530;5557;16202
291200;201606;2906;8635;2321;7534;169;618;1558;5114;1727;5732
291210;201606;6883;16480;5782;15232;295;996;4431;11654;4726;12650
291220;201606;4230;12990;3855;12393;500;1858;2620;8314;3120;10172
291230;201606;3945;9969;3586;9580;85;163;3364;9116;3449;9279
291240;201606;4592;12405;3967;11314;163;566;3205;9002;3368;9568
291250;201606;3570;10887;2849;9552;271;976;1908;6496;2179;7472
291260;201606;1074;3106;977;2984;64;275;825;2439;889;2714
291270;201606;4551;14284;4046;13330;945;3243;2260;7530;3205;10773
291280;201606;2066;6015;1674;5333;344;1244;838;2596;1182;3840
291290;201606;5610;15560;4857;14573;752;2359;3082;9454;3834;11813
291300;201606;4392;12345;3385;10667;215;820;2479;7673;2694;8493
291310;201606;5369;15205;4666;13931;292;1023;3659;10846;3951;11869
291320;201606;6120;18980;4997;16837;1171;4112;2400;8256;3571;12368
291330;201606;1603;4770;1423;4472;109;416;1017;3145;1126;3561
291340;201606;3918;10834;3208;9813;142;543;2609;7941;2751;8484
291345;201606;3386;10676;3139;10377;184;658;2652;8946;2836;9604
291350;201606;5757;16666;5021;15424;301;1022;3883;12110;4184;13132
291360;201606;33541;90933;29501;85345;6437;18944;16200;48541;22637;67485
291370;201606;8289;23514;7765;22865;539;1802;6121;18147;6660;19949
291380;201606;3695;11044;3159;10176;194;734;2385;7774;2579;8508
291390;201606;10242;27377;9456;26455;1046;3040;7286;20477;8332;23517
291400;201606;13757;38033;12065;35477;2029;5558;7805;24211;9834;29769
291410;201606;3301;8622;2440;7253;145;617;1777;5092;1922;5709
291420;201606;2099;5692;1794;5319;94;360;1505;4413;1599;4773
291430;201606;3249;9433;2880;8934;175;839;2343;7016;2518;7855
291440;201606;6695;19964;5611;18142;534;1856;4085;13316;4619;15172
291450;201606;8297;24095;7238;22637;326;1018;5846;19067;6172;20085
291460;201606;13273;39828;11948;37779;1438;5157;7971;25310;9409;30467
291465;201606;8037;22693;7041;21562;460;1811;5826;17698;6286;19509
291470;201606;15951;42268;13997;39947;1006;2943;10705;31487;11711;34430
291480;201606;35273;89601;29764;82130;4228;13013;16993;47261;21221;60274
291490;201606;4272;13561;4036;13239;469;1585;2994;10044;3463;11629
291500;201606;4330;12223;3642;11200;224;865;2894;8807;3118;9672
291510;201606;3686;10955;3370;10528;82;324;2990;9465;3072;9789
291520;201606;3850;10413;3301;9678;335;1116;2272;6660;2607;7776
291530;201606;2205;5925;1738;5235;374;1157;904;2925;1278;4082
291535;201606;3773;11422;3405;10855;232;830;2675;8609;2907;9439
291540;201606;2134;5024;1781;4661;107;196;1585;4276;1692;4472
291550;201606;5141;13688;4452;12736;757;2153;2746;8077;3503;10230
291560;201606;18809;43977;13436;37734;873;2643;9980;29351;10853;31994
291570;201606;2225;5895;2036;5673;136;263;1739;5053;1875;5316
291580;201606;5485;16513;4851;15608;503;2022;3514;11248;4017;13270
291590;201606;1771;5548;1599;5269;154;581;1205;4003;1359;4584
291600;201606;5376;14571;3995;12393;966;3166;1773;5443;2739;8609
291610;201606;4920;15612;4733;15403;147;499;4339;14301;4486;14800
291620;201606;2964;7021;2343;6371;137;433;1872;5229;2009;5662
291630;201606;3164;7587;2613;6951;192;524;2058;5600;2250;6124
291640;201606;17002;45993;13539;40856;3418;11020;4365;13897;7783;24917
291650;201606;8212;24022;7558;23227;554;1493;6376;20004;6930;21497
291660;201606;2165;5657;1739;5001;147;566;1137;3092;1284;3658
291670;201606;1859;5149;1677;4906;113;327;1337;3991;1450;4318
291680;201606;4055;11711;3508;10808;621;2117;2140;6586;2761;8703
291685;201606;4790;11999;3969;10944;565;1525;2707;7748;3272;9273
291690;201606;3889;10380;3054;9008;218;660;2146;6296;2364;6956
291700;201606;9143;28227;8143;26496;918;3025;6022;19912;6940;22937
291710;201606;5255;13608;4247;12333;311;983;3113;9061;3424;10044
291720;201606;4514;14561;3833;13143;302;1288;2714;9058;3016;10346
291730;201606;6141;18028;5573;17273;451;1544;4426;13924;4877;15468
291733;201606;2694;7637;2275;7060;211;713;1508;4841;1719;5554
291735;201606;2927;8054;2439;7351;137;513;1995;5958;2132;6471
291740;201606;3699;10677;3163;9932;230;858;2530;7918;2760;8776
291750;201606;22537;57479;17556;49877;3590;10615;8888;26113;12478;36728
291760;201606;10993;34829;9723;32655;3857;14149;2637;9140;6494;23289
291770;201606;7665;22037;6459;19866;828;2980;4193;12620;5021;15600
291780;201606;4486;13455;4186;12959;241;822;3521;10895;3762;11717
291790;201606;2682;8041;2537;7851;112;493;2167;6606;2279;7099
291800;201606;30674;82555;26855;77324;3996;11892;17212;51057;21208;62949
291810;201606;10739;28971;9003;26843;399;1445;7394;22065;7793;23510
291820;201606;3781;11039;3354;10404;201;760;2581;8050;2782;8810
291830;201606;4122;10942;3801;10485;373;1083;2903;8107;3276;9190
291835;201606;6337;19570;5083;17318;1189;4247;2639;9228;3828;13475
291840;201606;47781;133063;41927;126376;5954;17744;29441;92341;35395;110085
291845;201606;2645;7623;2465;7394;105;259;2242;6895;2347;7154
291850;201606;4568;12989;3750;11691;371;1121;2745;8862;3116;9983
291855;201606;1839;4489;1584;4170;139;476;1200;3057;1339;3533
291860;201606;2181;6073;1721;5198;74;282;1160;3407;1234;3689
291870;201606;1420;3798;1018;3073;86;337;640;1859;726;2196
291875;201606;2821;8833;2551;8413;165;692;1849;5985;2014;6677
291880;201606;4964;15823;4609;15155;441;1532;3435;11336;3876;12868
291890;201606;1293;3340;1061;3056;208;581;719;2154;927;2735
291900;201606;1269;3380;1019;2974;58;224;763;2196;821;2420
291905;201606;2737;7384;2041;6103;88;340;1496;4325;1584;4665
291910;201606;2776;7383;2313;6824;122;469;1963;5760;2085;6229
291915;201606;7050;21392;5883;19289;344;1274;4542;15034;4886;16308
291920;201606;25639;75439;23561;72525;3426;11610;15362;47470;18788;59080
291930;201606;2613;7653;2302;7166;200;769;1672;5085;1872;5854
291940;201606;3380;9466;2476;7882;317;1119;1467;4566;1784;5685
291950;201606;8804;29021;7933;27390;1286;4545;4740;16894;6026;21439
291955;201606;11114;31410;10251;30324;2487;7315;5623;17746;8110;25061
291960;201606;3154;9177;2582;8313;233;757;1900;6367;2133;7124
291970;201606;3890;11895;3579;11374;403;1513;2412;7707;2815;9220
291980;201606;12027;33864;9208;29837;932;3162;6246;20640;7178;23802
291990;201606;2193;6581;1998;6329;94;332;1710;5533;1804;5865
291992;201606;2826;8529;2762;8421;363;1105;2105;6451;2468;7556
291995;201606;2078;5884;1788;5481;100;379;1496;4536;1596;4915
292000;201606;2446;6769;2198;6445;210;727;1577;4704;1787;5431
292010;201606;6487;16077;5075;14108;484;1317;3719;10589;4203;11906
292020;201606;4019;13744;3788;13364;541;2077;2784;9799;3325;11876
292030;201606;2008;6198;1784;5867;233;835;1029;3339;1262;4174
292040;201606;4430;11810;3815;11165;201;416;3268;10131;3469;10547
292045;201606;3228;10348;2945;9963;108;410;2700;9112;2808;9522
292050;201606;6402;19339;5447;17431;505;1930;3518;11163;4023;13093
292060;201606;12648;31724;11665;30533;713;1967;9852;25575;10565;27542
292070;201606;4621;14229;4334;13887;363;1200;3646;11771;4009;12971
292080;201606;3577;9191;2920;8355;181;618;2471;7072;2652;7690
292090;201606;3973;10273;3380;9584;203;737;2841;8074;3044;8811
292100;201606;11375;30265;9731;28050;2110;6375;5086;15254;7196;21629
292105;201606;3084;9330;2747;8792;132;575;2228;7102;2360;7677
292110;201606;6464;17198;5020;14922;1241;3755;2436;7467;3677;11222
292120;201606;7528;21023;6292;18727;1166;3440;3551;10877;4717;14317
292130;201606;2892;7894;2480;7326;368;1032;1603;4929;1971;5961
292140;201606;5007;13065;4143;11839;610;1702;2842;8305;3452;10007
292145;201606;2392;7284;2114;6820;276;839;1464;4913;1740;5752
292150;201606;12496;37989;11519;36446;578;2322;9473;29891;10051;32213
292160;201606;2483;7120;2116;6648;97;425;1863;5782;1960;6207
292170;201606;8835;24876;7279;22240;917;3115;4655;14253;5572;17368
292180;201606;3002;8657;2349;7533;436;1345;1281;4281;1717;5626
292190;201606;3302;9315;2779;8516;552;1821;1544;4809;2096;6630
292200;201606;6809;20739;5784;18965;1681;5905;2190;7346;3871;13251
292205;201606;3867;11550;3472;10982;189;849;2802;8669;2991;9518
292210;201606;6500;17153;5431;15748;291;1026;4538;13114;4829;14140
292220;201606;1853;5058;1653;4762;305;842;949;2749;1254;3591
292225;201606;3223;9908;2927;9459;162;675;2406;7734;2568;8409
292230;201606;6770;19184;6356;18538;365;1547;5006;14030;5371;15577
292240;201606;4850;14515;4309;13422;422;1356;2999;9336;3421;10692
292250;201606;5095;15675;4749;15079;974;3216;2486;8063;3460;11279
292260;201606;3177;9281;2947;8969;188;567;2463;7578;2651;8145
292265;201606;3182;9537;2745;8810;140;636;2092;6562;2232;7198
292270;201606;4135;10347;3333;9406;158;560;2830;8011;2988;8571
292273;201606;2784;6382;2125;5575;170;393;1616;4445;1786;4838
292275;201606;1592;4335;1409;4073;128;375;1096;3245;1224;3620
292280;201606;2223;6076;1946;5762;153;425;1508;4724;1661;5149
292285;201606;2503;6720;2058;6082;118;426;1598;4718;1716;5144
292290;201606;6988;20892;5818;19319;407;1674;4471;15023;4878;16697
292300;201606;8287;24524;7160;23146;1785;6192;3963;13221;5748;19413
292303;201606;2874;8633;2590;8242;112;452;2215;6977;2327;7429
292305;201606;2916;7860;2743;7619;60;251;2495;6846;2555;7097
292310;201606;5914;17370;5449;16672;220;871;4501;13717;4721;14588
292320;201606;6750;18734;5705;16985;404;1365;4423;13100;4827;14465
292330;201606;2232;5883;2033;5622;142;480;1657;4524;1799;5004
292335;201606;5160;13483;4598;12745;347;937;3745;10546;4092;11483
292340;201606;6436;17930;5494;16406;429;1384;4059;12141;4488;13525
292350;201606;2307;6722;1992;6281;138;550;1610;5078;1748;5628
292360;201606;5324;13726;5016;13216;194;413;4179;11509;4373;11922
292370;201606;8376;23807;7483;22620;619;1803;6031;18487;6650;20290
292380;201606;7273;21330;6602;20256;637;1938;5073;15705;5710;17643
292390;201606;3519;7894;2956;7284;80;185;2670;6662;2750;6847
292400;201606;20863;63395;19444;61159;2681;8760;13605;43232;16286;51992
292405;201606;4591;11328;3696;10174;216;571;2978;8297;3194;8868
292410;201606;1991;5278;1842;5110;125;378;1555;4313;1680;4691
292420;201606;3798;12164;3581;11853;255;1030;2914;9617;3169;10647
292430;201606;5561;16307;4198;14384;395;1609;2801;9662;3196;11271
292440;201606;8456;27847;7798;26866;236;1029;7025;24377;7261;25406
292450;201606;3996;11917;3279;10714;334;1166;2307;7630;2641;8796
292460;201606;4899;14616;4202;13453;522;1873;2844;9117;3366;10990
292465;201606;2426;7152;2026;6497;229;817;1286;4188;1515;5005
292467;201606;1866;5953;1780;5823;271;951;1221;4082;1492;5033
292470;201606;2927;7744;2410;6886;115;409;1892;5360;2007;5769
292480;201606;6296;16442;5319;15180;149;539;4774;13559;4923;14098
292490;201606;2409;6513;1973;5881;153;529;1486;4392;1639;4921
292500;201606;6616;19413;5654;17743;676;2261;3776;12005;4452;14266
292510;201606;12783;36283;10942;33585;836;3092;8257;25526;9093;28618
292520;201606;5575;15761;4858;14718;998;3138;2744;8458;3742;11596
292525;201606;5345;13796;4548;12868;188;624;3857;10973;4045;11597
292530;201606;27008;76742;23642;72193;6017;19176;11439;36361;17456;55537
292540;201606;2915;7866;2580;7467;241;862;2057;5893;2298;6755
292550;201606;6544;19991;5664;18851;560;2076;4368;14849;4928;16925
292560;201606;4039;11216;3496;10397;211;847;2668;7810;2879;8657
292570;201606;4224;11823;3885;11467;74;170;3660;11064;3734;11234
292575;201606;6346;20693;6139;20383;412;1416;5200;17462;5612;18878
292580;201606;6756;19959;6310;19341;329;1153;5394;16542;5723;17695
292590;201606;7509;21647;6991;20907;398;1362;5955;17579;6353;18941
292593;201606;3045;7816;2521;7000;329;881;1762;4880;2091;5761
292595;201606;5824;16041;5143;15175;376;1230;4074;12092;4450;13322
292600;201606;10757;30205;9614;28730;693;1820;7693;23586;8386;25406
292610;201606;4684;12939;3814;11539;299;950;2383;7522;2682;8472
292620;201606;6315;19156;5531;18257;110;375;5167;17267;5277;17642
292630;201606;9323;23476;7730;21036;637;1856;5497;15175;6134;17031
292640;201606;7812;25144;7224;24231;479;1921;5542;18780;6021;20701
292650;201606;4768;12619;4451;12213;372;956;3726;10315;4098;11271
292660;201606;10847;32265;9932;30946;944;3169;7616;23958;8560;27127
292665;201606;2396;7444;2271;7282;35;110;2100;6815;2135;6925
292670;201606;3750;10454;2916;8980;230;826;1869;5745;2099;6571
292680;201606;3692;10838;3299;10157;385;1235;2382;7313;2767;8548
292690;201606;2874;7769;2054;6458;199;649;1402;4560;1601;5209
292700;201606;9402;27727;8234;26013;1067;3321;5481;18135;6548;21456
292710;201606;2125;6958;2001;6794;68;267;1790;6111;1858;6378
292720;201606;9324;23599;8055;22195;329;1077;6911;19344;7240;20421
292730;201606;3661;10850;3512;10636;212;726;2870;8697;3082;9423
292740;201606;330644;879733;309092;847604;52805;155538;194411;529886;247216;685424
292750;201606;6580;17548;5652;16267;286;994;4523;13057;4809;14051
292760;201606;4033;12471;3629;11766;414;1509;2485;8066;2899;9575
292770;201606;5989;17425;5244;16356;910;3031;3245;10455;4155;13486
292780;201606;1892;4376;1433;3789;115;403;1044;2686;1159;3089
292790;201606;3355;8110;3205;7952;56;105;3093;7750;3149;7855
292800;201606;9243;26959;8485;25721;511;1790;6843;20660;7354;22450
292805;201606;3048;8525;2658;7975;270;890;1987;5977;2257;6867
292810;201606;9539;28094;7823;25661;923;3238;5424;18182;6347;21420
292820;201606;7417;20946;5567;18262;300;1329;4396;14286;4696;15615
292830;201606;1761;5167;1589;4928;62;254;1393;4302;1455;4556
292840;201606;7924;23862;7441;23222;318;1315;6608;20319;6926;21634
292850;201606;3125;8236;2529;7324;278;905;1643;4649;1921;5554
292860;201606;15357;39155;13999;37409;1006;2953;11083;29508;12089;32461
292870;201606;19346;52583;16908;48828;1873;6360;10366;29473;12239;35833
292880;201606;12714;35578;11273;33590;914;3307;8284;24217;9198;27524
292890;201606;5433;18047;4889;17081;672;2533;3262;11519;3934;14052
292895;201606;2849;6821;2185;5810;200;540;1543;4110;1743;4650
292900;201606;2775;8512;2634;8297;189;852;1991;6006;2180;6858
292905;201606;4076;12021;3288;10795;298;1060;2254;7480;2552;8540
292910;201606;4994;14704;4504;13835;552;1823;2783;8587;3335;10410
292920;201606;9328;26949;8869;26299;523;2068;7429;21433;7952;23501
292925;201606;5160;15491;4648;14746;356;1206;3662;11681;4018;12887
292930;201606;6486;20605;6088;19906;530;2304;4351;13909;4881;16213
292935;201606;2026;5895;1705;5545;83;276;1451;4896;1534;5172
292937;201606;3268;8229;2714;7539;172;535;2187;6084;2359;6619
292940;201606;3302;8908;2626;8004;243;784;1847;5800;2090;6584
292950;201606;8145;23608;7536;22603;554;2117;5634;16508;6188;18625
292960;201606;5298;13478;4562;12493;302;961;3436;9332;3738;10293
292970;201606;4295;12704;3766;11996;152;712;3104;9849;3256;10561
292975;201606;3556;9323;3320;9026;321;809;2819;7780;3140;8589
292980;201606;3334;8724;2607;7696;229;809;1883;5494;2112;6303
292990;201606;11879;33766;10291;31386;456;1737;8389;25484;8845;27221
293000;201606;2849;7283;2627;7021;52;156;2086;6002;2138;6158
293010;201606;17949;49489;15234;45167;2282;7414;9156;27014;11438;34428
293015;201606;7562;25512;6644;23714;748;3116;4463;15878;5211;18994
293020;201606;9033;29842;8488;29075;375;1686;7364;25084;7739;26770
293030;201606;5625;15929;4442;14083;268;974;3126;10322;3394;11296
293040;201606;3783;12200;3605;11866;198;676;3171;10496;3369;11172
293050;201606;20620;56301;18071;53034;3260;10111;9769;30283;13029;40394
293060;201606;3640;9687;3002;8640;252;850;2199;6248;2451;7098
293070;201606;24099;64775;19762;58606;4558;13874;9176;28762;13734;42636
293075;201606;3246;10976;2989;10579;192;856;2387;8480;2579;9336
293076;201606;3771;10300;3383;9785;173;486;2844;8416;3017;8902
293077;201606;4928;15259;4402;14541;799;2747;2768;9436;3567;12183
293080;201606;4627;14454;4189;13770;207;959;3433;11109;3640;12068
293090;201606;3304;10438;2723;9549;245;932;1990;7108;2235;8040
293100;201606;5861;17052;4830;15242;443;1501;3510;11205;3953;12706
293105;201606;4019;13090;3491;12076;464;1692;2334;8198;2798;9890
293110;201606;2050;5754;1793;5388;78;273;1474;4452;1552;4725
293120;201606;3774;12257;3581;11956;309;1011;2862;9722;3171;10733
293130;201606;4062;11364;3487;10728;136;483;3063;9616;3199;10099
293135;201606;32087;80799;24321;69872;5331;17319;9345;27437;14676;44756
293140;201606;1980;5513;1879;5372;141;520;1514;4205;1655;4725
293150;201606;5488;17999;4694;16474;699;2568;2957;10627;3656;13195
293160;201606;3819;9744;3413;9256;460;955;2559;7399;3019;8354
293170;201606;3395;9885;3103;9470;263;938;2242;6922;2505;7860
293180;201606;5305;14803;4218;13043;197;854;3292;9968;3489;10822
293190;201606;13839;41444;12679;39712;524;2395;10854;33427;11378;35822
293200;201606;7189;19629;6291;18515;239;1025;4900;14566;5139;15591
293210;201606;5126;14525;4501;13472;285;991;3456;10305;3741;11296
293220;201606;5018;14700;4266;13373;1130;3589;1628;5340;2758;8929
293230;201606;3781;11449;3396;10845;448;1614;2369;7592;2817;9206
293240;201606;4410;12043;3530;10583;145;502;2612;7851;2757;8353
293245;201606;4284;12086;3853;11480;252;798;3084;9245;3336;10043
293250;201606;5623;15248;5038;14388;545;1679;3529;10029;4074;11708
293260;201606;4559;13497;3846;12449;283;1061;2881;9395;3164;10456
293270;201606;5634;14733;5088;14142;352;904;4373;12365;4725;13269
293280;201606;5325;14668;4493;13557;229;720;3544;10825;3773;11545
293290;201606;14592;48081;13528;46084;3365;11819;6276;22209;9641;34028
293300;201606;6984;16298;5831;14962;361;883;4514;11813;4875;12696
293305;201606;4879;12024;4092;10977;149;513;3436;9161;3585;9674
293310;201606;2521;6534;2015;5671;207;622;1345;3760;1552;4382
293315;201606;4258;10783;3612;9816;274;714;2779;7642;3053;8356
293317;201606;2489;7075;2232;6606;182;536;1574;4679;1756;5215
293320;201606;7746;25374;7507;25068;998;3438;5714;19361;6712;22799
293325;201606;1822;5147;1490;4632;197;702;993;3067;1190;3769
293330;201606;50872;162363;45719;153363;10469;37630;21962;74988;32431;112618
293340;201606;2671;7531;2090;6533;273;931;1199;3760;1472;4691
293345;201606;3326;9796;2887;9208;258;707;2235;7504;2493;8211
293350;201606;6519;19014;6150;18587;217;520;5587;17358;5804;17878
293360;201606;13059;39288;11808;37717;826;3170;10160;32329;10986;35499
310010;201606;921;2473;713;2151;103;393;327;916;430;1309
310020;201606;2903;9009;2391;8051;618;2328;346;1092;964;3420
310030;201606;2329;7167;1909;6453;408;1563;1052;3522;1460;5085
310040;201606;974;2584;807;2355;74;266;616;1762;690;2028
310050;201606;1863;6332;1695;5963;383;1545;754;2596;1137;4141
310060;201606;3238;10003;2816;9456;280;1101;2211;7434;2491;8535
310070;201606;338;950;253;796;14;62;161;476;175;538
310080;201606;726;2149;599;1930;115;468;230;703;345;1171
310090;201606;4607;13588;3948;12451;482;1706;2623;8287;3105;9993
310100;201606;3464;10345;2913;9437;172;701;2253;7271;2425;7972
310110;201606;4801;13500;4099;12343;678;2326;2276;6683;2954;9009
310120;201606;627;1882;473;1587;140;586;180;489;320;1075
310130;201606;397;1210;361;1157;87;344;194;571;281;915
310140;201606;209;687;171;627;60;265;51;157;111;422
310150;201606;4703;14272;4057;13057;1009;3609;1415;4477;2424;8086
310160;201606;7177;22453;5940;20158;1978;7372;998;3335;2976;10707
310163;201606;1038;3310;878;2993;313;1156;236;782;549;1938
310170;201606;9140;25388;8122;23973;1053;3395;5605;16731;6658;20126
310180;201606;1656;4733;1420;4372;269;938;776;2311;1045;3249
310190;201606;2823;9228;2509;8653;718;2767;513;1748;1231;4515
310200;201606;1835;5927;1551;5357;335;1290;571;1980;906;3270
310205;201606;1122;3198;860;2804;127;399;475;1602;602;2001
310210;201606;2730;7813;2404;7331;137;493;1889;5733;2026;6226
310220;201606;1049;3134;923;2934;158;570;584;1814;742;2384
310230;201606;2525;7748;2135;6903;337;1317;1162;3554;1499;4871
310240;201606;898;3237;813;3059;131;555;463;1752;594;2307
310250;201606;816;2671;786;2617;154;648;465;1430;619;2078
310260;201606;3216;10110;2452;8575;631;2520;496;1567;1127;4087
310270;201606;2556;7181;2103;6540;166;663;1630;5017;1796;5680
310280;201606;2319;6062;1883;5413;211;837;1102;3013;1313;3850
310285;201606;2028;7128;1873;6895;195;856;1410;5245;1605;6101
310290;201606;1136;3409;1066;3296;272;978;556;1571;828;2549
310300;201606;1695;5680;1609;5525;410;1618;824;2720;1234;4338
310310;201606;365;990;261;801;41;134;127;400;168;534
310320;201606;396;1248;328;1121;45;202;169;557;214;759
310330;201606;524;1298;350;981;39;136;148;364;187;500
310340;201606;8361;24774;6843;22176;1378;4598;3344;11347;4722;15945
310350;201606;13648;36051;9928;29923;2588;8707;2677;7982;5265;16689
310360;201606;436;1283;403;1238;31;134;292;857;323;991
310370;201606;1400;4653;1257;4392;320;1132;636;2259;956;3391
310375;201606;1203;3280;785;2515;116;419;302;968;418;1387
310380;201606;376;966;244;763;72;242;77;212;149;454
310390;201606;454;1557;391;1434;110;431;78;246;188;677
310400;201606;10287;28210;7678;23884;1969;6745;1988;6292;3957;13037
310410;201606;727;2421;509;2040;128;563;94;375;222;938
310420;201606;5560;15483;3649;11532;723;2544;531;1458;1254;4002
310430;201606;1327;4288;1014;3682;273;1103;167;589;440;1692
310440;201606;557;1597;425;1354;92;346;172;555;264;901
310445;201606;1241;4031;1035;3649;87;365;721;2515;808;2880
310450;201606;4546;12681;3675;11428;359;1260;2578;8129;2937;9389
310460;201606;1551;4593;1285;4190;392;1418;303;1078;695;2496
310470;201606;4087;9170;3487;8452;209;517;3031;7409;3240;7926
310480;201606;1250;3610;933;2987;215;732;397;1223;612;1955
310490;201606;2869;9301;2509;8599;599;2392;1019;3409;1618;5801
310500;201606;1309;4372;1147;4025;298;1150;462;1579;760;2729
310510;201606;2031;6328;1584;5362;416;1527;286;980;702;2507
310520;201606;1415;3601;1065;3064;72;220;728;2071;800;2291
310530;201606;994;2974;527;1810;85;331;69;211;154;542
310540;201606;3023;9681;2705;9106;711;2563;1175;3949;1886;6512
310550;201606;1188;3311;943;2925;205;781;500;1459;705;2240
310560;201606;15510;46774;13072;42142;3563;12868;3999;12246;7562;25114
310570;201606;1162;3444;990;3154;141;551;673;2093;814;2644
310590;201606;4310;12519;3538;11085;616;2123;1633;5024;2249;7147
310600;201606;1407;4592;1257;4285;276;1107;537;1726;813;2833
310610;201606;464;1561;405;1432;96;425;125;397;221;822
310620;201606;141966;431729;121646;393758;29700;108532;46894;142529;76594;251061
310630;201606;4167;12453;3801;11846;351;1284;2814;8677;3165;9961
310640;201606;1281;3882;1046;3488;308;1150;286;900;594;2050
310650;201606;2670;8322;2098;7309;326;1231;1212;4250;1538;5481
310660;201606;1327;4020;1169;3819;121;428;868;2822;989;3250
310665;201606;1272;3762;1137;3576;87;307;922;2957;1009;3264
310670;201606;40152;122301;35647;113056;9236;31359;13535;42324;22771;73683
310680;201606;676;1907;604;1805;91;308;408;1200;499;1508
310690;201606;1417;4515;1151;4053;259;1111;434;1438;693;2549
310700;201606;538;1304;418;1153;69;228;263;714;332;942
310710;201606;6281;20273;4833;17870;1265;5508;640;2187;1905;7695
310720;201606;777;2325;713;2216;82;302;501;1546;583;1848
310730;201606;9318;28688;8288;26978;1421;5143;4894;15927;6315;21070
310740;201606;5008;15753;3955;13671;1022;3869;885;2958;1907;6827
310750;201606;1482;3675;1105;3169;201;620;523;1426;724;2046
310760;201606;598;1782;499;1617;89;313;195;635;284;948
310770;201606;899;2821;692;2498;160;652;300;1040;460;1692
310780;201606;3748;10279;3157;9241;469;1436;2033;5947;2502;7383
310790;201606;1949;6243;1775;5933;406;1398;871;3050;1277;4448
310800;201606;2814;8819;2165;7579;662;2701;187;608;849;3309
310810;201606;1145;3225;1013;2976;178;606;575;1599;753;2205
310820;201606;1302;3724;918;2996;219;785;236;769;455;1554
310825;201606;2543;8490;2000;7543;143;779;1458;5406;1601;6185
310830;201606;1342;4327;1079;3823;295;1139;352;1226;647;2365
310840;201606;2111;6364;1634;5535;377;1395;449;1451;826;2846
310850;201606;1522;4481;1289;4180;144;560;942;3053;1086;3613
310855;201606;2947;9150;2527;8505;398;1474;1682;5712;2080;7186
310860;201606;7427;22623;6216;20438;745;2716;3742;12481;4487;15197
310870;201606;1042;2816;809;2435;140;457;468;1416;608;1873
310880;201606;1069;3288;875;2929;152;596;468;1542;620;2138
310890;201606;2587;7788;1989;6757;543;2120;419;1285;962;3405
310900;201606;4120;12873;3215;10989;753;2901;1113;3591;1866;6492
310910;201606;1918;5399;1266;4143;256;974;177;497;433;1471
310920;201606;1873;5453;1478;4843;323;1190;666;2186;989;3376
310925;201606;917;2979;819;2810;273;1057;353;1180;626;2237
310930;201606;6152;17168;4912;15361;755;2565;2917;9437;3672;12002
310940;201606;6170;17116;5139;15553;785;2633;3004;9039;3789;11672
310945;201606;1152;3339;1014;3137;148;539;616;1858;764;2397
310950;201606;2076;6523;1523;5343;395;1619;483;1591;878;3210
310960;201606;384;1234;316;1105;90;337;121;439;211;776
310970;201606;1442;4712;1059;3846;276;1139;161;507;437;1646
310980;201606;433;1051;268;775;41;142;129;335;170;477
310990;201606;1164;3737;951;3274;219;838;297;948;516;1786
311000;201606;3535;11891;3216;11291;968;3812;1096;3664;2064;7476
311010;201606;721;2428;669;2332;225;830;307;1086;532;1916
311020;201606;933;2696;721;2327;146;541;340;1054;486;1595
311030;201606;1652;4483;1134;3532;291;1047;371;1056;662;2103
311040;201606;463;1545;395;1384;108;389;98;326;206;715
311050;201606;2220;6753;1928;6314;455;1675;914;2990;1369;4665
311060;201606;2448;7162;1819;5839;345;1276;580;1744;925;3020
311070;201606;1403;4782;1228;4455;273;1137;517;1863;790;3000
311080;201606;812;2501;690;2265;158;582;281;880;439;1462
311090;201606;1569;5862;1377;5467;452;1987;371;1419;823;3406
311100;201606;2041;6809;1646;5965;599;2339;261;968;860;3307
311110;201606;3456;8298;2491;6949;393;1213;1312;3705;1705;4918
311115;201606;1235;3544;1027;3236;117;468;702;2171;819;2639
311120;201606;7924;22087;6094;18896;1390;4877;1725;5029;3115;9906
311130;201606;2099;6356;1710;5764;363;1508;706;2268;1069;3776
311140;201606;1310;3442;1027;3072;92;322;696;2095;788;2417
311150;201606;1743;5988;1604;5762;279;1090;1019;3693;1298;4783
311160;201606;4010;13342;3274;12007;1208;4828;810;2993;2018;7821
311170;201606;792;2365;628;2067;85;309;309;1062;394;1371
311180;201606;1177;3385;921;2904;286;983;225;671;511;1654
311190;201606;1104;3089;830;2563;177;650;228;654;405;1304
311200;201606;2002;6082;1613;5277;466;1677;296;899;762;2576
311205;201606;1004;3304;858;3010;132;552;409;1442;541;1994
311210;201606;948;3053;872;2954;137;454;600;2119;737;2573
311220;201606;867;2685;708;2355;159;596;250;801;409;1397
311230;201606;8237;25886;6444;22229;1345;4965;2215;8069;3560;13034
311240;201606;1034;3099;810;2737;219;816;275;927;494;1743
311250;201606;760;2467;678;2340;201;784;242;756;443;1540
311260;201606;2409;6371;1814;5403;414;1393;661;1948;1075;3341
311265;201606;1241;3463;976;3026;179;618;539;1682;718;2300
311270;201606;3387;10671;2958;10072;335;1549;2083;6840;2418;8389
311280;201606;1273;3544;811;2591;172;654;205;639;377;1293
311290;201606;1985;6582;1854;6289;352;1205;1109;3832;1461;5037
311300;201606;4330;14282;3847;13425;421;1839;2748;9480;3169;11319
311310;201606;570;1896;515;1797;93;371;189;603;282;974
311320;201606;3810;12568;3426;11745;704;2757;1259;4078;1963;6835
311330;201606;4587;13631;3959;12573;1015;3580;1754;5644;2769;9224
311340;201606;11888;37077;10342;34146;3275;11700;2831;9299;6106;20999
311350;201606;2314;6441;1788;5464;304;1132;814;2271;1118;3403
311360;201606;1113;3067;869;2756;417;1381;140;493;557;1874
311370;201606;3690;10994;3058;9877;699;2677;1187;3504;1886;6181
311380;201606;410;1351;356;1249;112;423;123;434;235;857
311390;201606;1771;6368;1611;6149;708;3049;469;1687;1177;4736
311400;201606;1465;4579;1199;4076;238;943;497;1554;735;2497
311410;201606;1795;6040;1605;5797;424;1712;794;2914;1218;4626
311420;201606;1876;6028;1303;4648;268;1053;160;454;428;1507
311430;201606;3824;11395;2661;8876;623;2322;373;1228;996;3550
311440;201606;2428;7658;1787;6502;624;2627;288;1040;912;3667
311450;201606;1931;6632;1619;5957;461;1890;333;1147;794;3037
311455;201606;1124;2983;882;2587;221;707;387;1061;608;1768
311460;201606;628;2027;477;1719;119;504;118;390;237;894
311470;201606;479;1582;383;1378;115;469;85;273;200;742
311480;201606;788;2081;733;2006;147;393;480;1310;627;1703
311490;201606;224;822;202;761;61;257;72;248;133;505
311500;201606;434;1254;344;1090;79;301;153;469;232;770
311510;201606;2985;9097;2396;8044;737;2901;563;1868;1300;4769
311520;201606;609;1978;563;1886;180;664;228;737;408;1401
311530;201606;11608;29673;8300;24377;2021;7133;2228;6338;4249;13471
311535;201606;799;2306;517;1749;126;498;94;304;220;802
311540;201606;612;2115;569;2046;161;583;285;1036;446;1619
311545;201606;2102;6334;1862;6039;192;755;1372;4398;1564;5153
311547;201606;1490;4168;1252;3796;98;333;846;2558;944;2891
311550;201606;2903;9130;2424;8183;445;1764;905;3004;1350;4768
311560;201606;265;692;224;645;33;106;128;350;161;456
311570;201606;2001;5071;1550;4455;99;302;1153;3419;1252;3721
311580;201606;2394;4805;1790;4106;354;740;1077;2651;1431;3391
311590;201606;463;1410;392;1297;92;356;175;575;267;931
311600;201606;1203;3634;1022;3399;182;613;651;2225;833;2838
311610;201606;2898;10080;2581;9528;775;2787;1111;4359;1886;7146
311615;201606;3120;9583;2591;8743;270;1092;1840;6159;2110;7251
311620;201606;415;1286;372;1211;70;256;219;712;289;968
311630;201606;1377;3996;1142;3599;174;582;725;2251;899;2833
311640;201606;766;2445;635;2230;119;458;314;1106;433;1564
311650;201606;2257;6389;1914;5859;262;895;1127;3478;1389;4373
311660;201606;2567;8129;1904;6715;388;1434;180;552;568;1986
311670;201606;1665;4744;1339;4200;405;1399;455;1426;860;2825
311680;201606;2085;6479;1744;5908;362;1286;967;3328;1329;4614
311690;201606;504;1265;428;1174;31;88;352;983;383;1071
311700;201606;2186;5811;1780;5269;143;503;1362;3986;1505;4489
311710;201606;1648;4982;1215;4175;418;1593;333;1140;751;2733
311720;201606;396;1307;356;1230;72;282;160;541;232;823
311730;201606;5854;14582;3385;10360;973;3457;688;1728;1661;5185
311740;201606;790;2362;750;2311;151;442;545;1722;696;2164
311750;201606;4013;12868;3466;11996;626;2537;1905;6471;2531;9008
311760;201606;698;2329;613;2135;147;568;160;473;307;1041
311770;201606;2233;7047;1846;6321;472;1819;579;1911;1051;3730
311780;201606;1142;4002;963;3616;284;1246;234;817;518;2063
311783;201606;1946;6362;1633;5747;106;522;1214;4214;1320;4736
311787;201606;594;2017;441;1579;85;345;118;354;203;699
311790;201606;1527;4483;1142;3756;272;1037;384;1230;656;2267
311800;201606;4585;15262;3951;13742;814;3116;403;1292;1217;4408
311810;201606;1066;3428;925;3161;79;358;578;1956;657;2314
311820;201606;621;1890;507;1637;119;429;262;795;381;1224
311830;201606;8247;27207;6729;23617;2184;8434;815;2696;2999;11130
311840;201606;2953;8829;2642;8367;663;2396;1353;4214;2016;6610
311850;201606;279;863;246;807;39;138;137;444;176;582
311860;201606;48738;142254;41393;129465;7992;27824;21131;64548;29123;92372
311870;201606;2122;6143;1566;5089;329;1228;495;1503;824;2731
311880;201606;6811;19303;6002;18290;652;2021;4419;13882;5071;15903
311890;201606;1470;4320;1186;3800;274;967;539;1698;813;2665
311900;201606;741;2211;647;2072;86;304;401;1307;487;1611
311910;201606;4302;12416;3484;11242;815;2876;1596;5197;2411;8073
311920;201606;1893;6179;1658;5747;200;789;1035;3593;1235;4382
311930;201606;3518;9921;2956;9041;1183;3811;826;2516;2009;6327
311940;201606;12420;36922;9948;31916;2428;8587;2492;7635;4920;16222
311950;201606;2209;6435;1791;5806;164;622;1251;4015;1415;4637
311960;201606;385;1192;343;1106;73;287;141;382;214;669
311970;201606;346;1193;288;1063;66;283;73;257;139;540
311980;201606;603;1680;410;1331;75;270;142;473;217;743
311990;201606;433;1244;351;1116;128;449;126;385;254;834
311995;201606;1184;3599;727;2513;62;246;71;185;133;431
312000;201606;611;1825;548;1731;70;245;349;1120;419;1365
312010;201606;883;2860;744;2559;129;494;298;1004;427;1498
312015;201606;1371;4380;1223;4110;143;558;812;2700;955;3258
312020;201606;1078;3375;948;3167;191;694;464;1561;655;2255
312030;201606;1818;5207;1629;4971;101;388;1385;4190;1486;4578
312040;201606;737;2653;606;2312;154;638;126;469;280;1107
312050;201606;1238;4312;1060;3894;297;1228;165;545;462;1773
312060;201606;754;2268;654;2119;176;614;315;999;491;1613
312070;201606;1033;3151;688;2401;147;572;259;879;406;1451
312080;201606;2636;7221;2103;6400;326;1229;1168;3336;1494;4565
312083;201606;906;2544;778;2359;94;327;571;1706;665;2033
312087;201606;2144;6458;1932;6155;216;771;1443;4667;1659;5438
312090;201606;8886;27120;7514;24780;2146;7618;2955;9690;5101;17308
312100;201606;1435;4622;1154;4196;229;984;532;1885;761;2869
312110;201606;1036;3607;907;3333;305;1277;175;579;480;1856
312120;201606;720;2325;604;2092;149;626;219;662;368;1288
312125;201606;1094;3495;970;3266;216;715;544;1923;760;2638
312130;201606;869;2429;669;2050;104;358;252;732;356;1090
312140;201606;801;2541;695;2292;181;651;201;593;382;1244
312150;201606;501;1452;439;1330;24;84;279;804;303;888
312160;201606;7338;24508;6487;22771;1716;6691;2509;8680;4225;15371
312170;201606;913;2607;772;2376;81;293;487;1468;568;1761
312180;201606;1360;4152;1182;3802;252;905;492;1492;744;2397
312190;201606;585;1863;444;1583;161;630;64;233;225;863
312200;201606;4717;13426;3946;12207;703;2233;2263;7057;2966;9290
312210;201606;1085;2871;823;2487;194;668;407;1147;601;1815
312220;201606;1908;6360;1756;6193;168;483;1479;5486;1647;5969
312230;201606;12353;37661;9590;32416;3294;12420;1399;4666;4693;17086
312235;201606;1557;4628;1370;4352;169;649;975;3072;1144;3721
312240;201606;918;3063;739;2686;191;757;207;752;398;1509
312245;201606;2168;6410;1938;6112;107;404;1588;5003;1695;5407
312247;201606;786;2333;604;2019;163;594;263;898;426;1492
312250;201606;1179;3229;889;2735;174;659;372;1075;546;1734
312260;201606;893;2803;740;2547;124;497;464;1557;588;2054
312270;201606;636;1894;529;1687;73;308;261;766;334;1074
312280;201606;408;1356;363;1258;143;535;51;173;194;708
312290;201606;767;2509;703;2417;190;758;246;837;436;1595
312300;201606;878;2901;690;2460;200;792;68;189;268;981
312310;201606;854;3162;799;3049;232;987;335;1252;567;2239
312320;201606;1981;5639;1540;4805;449;1565;310;863;759;2428
312330;201606;992;2873;824;2640;122;463;595;1891;717;2354
312340;201606;313;843;264;766;36;133;160;418;196;551
312350;201606;284;718;249;677;26;91;204;528;230;619
312352;201606;1626;5094;1459;4851;256;867;983;3379;1239;4246
312360;201606;3054;9665;2545;8649;618;2322;754;2565;1372;4887
312370;201606;1685;5250;1531;5005;496;1854;585;1826;1081;3680
312380;201606;1888;5173;1678;4887;77;231;1424;4268;1501;4499
312385;201606;1311;3849;1126;3557;108;457;805;2465;913;2922
312390;201606;2062;6608;1656;5812;450;1702;327;1083;777;2785
312400;201606;3132;9941;2608;8895;975;3428;667;2379;1642;5807
312410;201606;9736;31608;8662;29579;1949;7263;3845;13011;5794;20274
312420;201606;3865;11844;3657;11579;491;1595;2604;8425;3095;10020
312430;201606;7942;23318;6835;21368;938;3073;4425;14004;5363;17077
312440;201606;763;2377;637;2159;170;643;302;1075;472;1718
312450;201606;1106;3624;851;3100;256;978;285;1084;541;2062
312460;201606;350;1050;312;1006;67;259;169;538;236;797
312470;201606;652;1764;419;1315;84;296;131;400;215;696
312480;201606;1192;3106;894;2782;199;709;497;1477;696;2186
312490;201606;1979;5186;1557;4563;227;770;910;2569;1137;3339
312500;201606;679;2022;590;1886;112;425;217;684;329;1109
312510;201606;3456;9983;2784;8625;428;1537;1409;4118;1837;5655
312520;201606;255;855;204;768;61;249;60;239;121;488
312530;201606;603;1775;537;1681;67;259;349;1081;416;1340
312540;201606;1437;4474;1095;3806;195;755;551;1910;746;2665
312550;201606;681;2062;585;1851;123;440;277;818;400;1258
312560;201606;2050;5384;1690;4931;95;375;1387;3992;1482;4367
312570;201606;2357;6939;1969;6283;568;1956;662;2107;1230;4063
312580;201606;521;1714;440;1538;73;308;167;569;240;877
312590;201606;1663;5467;1443;5006;267;1168;646;2085;913;3253
312595;201606;1916;6382;1715;5923;336;1202;949;3322;1285;4524
312600;201606;794;2553;612;2192;115;522;289;964;404;1486
312610;201606;7064;19712;5219;16379;1311;4490;1080;3294;2391;7784
312620;201606;2190;6254;1688;5560;136;511;1243;4233;1379;4744
312630;201606;332;1064;281;972;75;294;107;354;182;648
312640;201606;539;1720;437;1510;94;357;136;434;230;791
312650;201606;2145;6218;1570;5086;162;594;904;2897;1066;3491
312660;201606;1403;3673;1131;3279;105;374;782;2236;887;2610
312670;201606;5535;16286;4685;15130;1392;5045;1734;5544;3126;10589
312675;201606;1253;4000;1066;3594;133;519;680;2279;813;2798
312680;201606;1465;4408;1247;4116;184;751;791;2533;975;3284
312690;201606;2133;5638;1736;5083;282;940;1085;3064;1367;4004
312695;201606;813;2848;776;2799;131;469;540;2020;671;2489
312700;201606;1867;5582;1476;4802;212;782;745;2366;957;3148
312705;201606;1248;3545;1040;3170;77;288;733;2183;810;2471
312707;201606;1536;4851;1200;4204;175;753;616;2064;791;2817
312710;201606;6821;17099;4480;13362;1289;4327;904;2684;2193;7011
312720;201606;750;2542;652;2343;151;608;254;875;405;1483
312730;201606;1887;4467;1312;3788;152;520;778;2233;930;2753
312733;201606;1629;4330;1225;3606;77;270;755;2166;832;2436
312735;201606;823;2230;712;2081;148;518;442;1229;590;1747
312737;201606;838;2103;610;1781;178;522;222;672;400;1194
312738;201606;509;1542;374;1277;101;407;118;363;219;770
312740;201606;347;813;199;641;64;240;48;142;112;382
312750;201606;1251;4412;1177;4288;237;1032;600;2126;837;3158
312760;201606;1961;6267;1523;5376;389;1501;379;1334;768;2835
312770;201606;41029;111239;31275;95091;8355;27827;8839;26510;17194;54337
312780;201606;2653;9092;2362;8597;448;1852;1309;4869;1757;6721
312790;201606;322;816;194;600;38;141;62;152;100;293
312800;201606;4893;15793;3987;14011;1255;4796;1014;3619;2269;8415
312810;201606;2054;6256;1439;5053;385;1470;266;882;651;2352
312820;201606;1863;5305;1631;4922;108;409;1160;3414;1268;3823
312825;201606;1331;3624;1154;3394;87;287;902;2658;989;2945
312830;201606;2523;7689;1746;6130;461;1746;311;1100;772;2846
312840;201606;1218;3856;1004;3447;171;696;329;1019;500;1715
312850;201606;691;2148;545;1859;106;437;166;561;272;998
312860;201606;1150;3378;883;2906;253;932;248;745;501;1677
312870;201606;5564;17109;3920;13640;748;2918;799;2672;1547;5590
312880;201606;1266;3753;1122;3537;140;494;716;2324;856;2818
312890;201606;1673;5046;1090;3729;232;851;389;1364;621;2215
312900;201606;1206;3519;1051;3306;114;389;775;2505;889;2894
312910;201606;1665;3315;983;2437;165;478;458;1057;623;1535
312920;201606;869;2742;709;2444;187;752;281;904;468;1656
312930;201606;2134;6107;1856;5701;401;1291;909;2860;1310;4151
312940;201606;898;2891;781;2705;206;818;219;722;425;1540
312950;201606;3085;8615;2377;7561;857;2959;551;1785;1408;4744
312960;201606;1952;5574;1685;5226;142;445;1332;4244;1474;4689
312965;201606;1792;5638;1529;5169;190;784;930;3124;1120;3908
312970;201606;996;3294;821;2994;256;1051;216;781;472;1832
312980;201606;16947;56319;15894;54166;4714;17563;6077;20208;10791;37771
312990;201606;464;1365;331;1133;102;391;109;383;211;774
313000;201606;499;1627;403;1437;100;476;164;505;264;981
313005;201606;2579;8240;2281;7698;466;1601;1309;4488;1775;6089
313010;201606;3531;11211;2975;10255;774;2933;1373;4671;2147;7604
313020;201606;947;3090;736;2551;167;667;143;415;310;1082
313030;201606;1507;3994;1110;3445;217;811;510;1564;727;2375
313040;201606;817;2660;711;2414;114;474;310;974;424;1448
313050;201606;1796;5534;1343;4840;364;1478;349;1175;713;2653
313055;201606;1612;5013;1467;4812;67;268;1224;4049;1291;4317
313060;201606;741;2363;586;2004;168;599;74;223;242;822
313065;201606;1921;6170;1646;5739;295;1150;1093;3828;1388;4978
313070;201606;1035;2982;845;2656;179;646;375;1149;554;1795
313080;201606;443;1373;337;1159;83;337;100;294;183;631
313090;201606;5213;14918;4497;13764;1075;3551;2320;7182;3395;10733
313100;201606;1121;3376;1014;3208;82;244;800;2593;882;2837
313110;201606;1740;4919;1298;4074;208;766;580;1715;788;2481
313115;201606;2403;8026;2264;7740;522;2075;1062;3405;1584;5480
313120;201606;3504;9198;2973;8507;609;1962;1748;4974;2357;6936
313130;201606;25541;76478;22119;69642;4730;16676;9092;27222;13822;43898
313140;201606;576;1487;443;1291;30;111;319;911;349;1022
313150;201606;1310;4134;1112;3788;461;1661;276;960;737;2621
313160;201606;940;2851;811;2595;155;572;451;1406;606;1978
313170;201606;8201;27267;6303;22787;1625;6294;1336;4745;2961;11039
313180;201606;2363;6384;1885;5710;451;1531;740;2176;1191;3707
313190;201606;3380;11352;2696;9652;637;2497;695;2357;1332;4854
313200;201606;1132;3672;983;3390;121;479;688;2335;809;2814
313210;201606;4176;12897;3471;11815;758;2842;1663;5547;2421;8389
313220;201606;1499;4398;1080;3536;255;943;265;737;520;1680
313230;201606;2271;7987;2104;7765;282;1171;1532;5634;1814;6805
313240;201606;8036;24240;6254;20933;1324;5126;2407;7730;3731;12856
313250;201606;6884;21423;5931;19799;713;2658;3479;11602;4192;14260
313260;201606;616;1809;435;1420;79;295;107;345;186;640
313270;201606;5360;15877;4444;14323;828;2926;2386;7659;3214;10585
313280;201606;380;1244;278;1025;60;243;67;232;127;475
313290;201606;813;2839;667;2581;248;1076;109;394;357;1470
313300;201606;1805;5930;1487;5189;451;1768;217;659;668;2427
313310;201606;1045;3597;936;3368;231;977;198;656;429;1633
313320;201606;2314;6572;1720;5631;321;1179;767;2530;1088;3709
313330;201606;3973;12151;3308;10997;410;1720;1990;6440;2400;8160
313340;201606;1890;4656;1491;4069;262;723;848;2338;1110;3061
313350;201606;2884;8915;2299;7650;512;1923;485;1509;997;3432
313360;201606;1259;3574;955;3077;210;834;518;1584;728;2418
313370;201606;1155;3883;1086;3701;177;717;572;1842;749;2559
313375;201606;2311;5974;1587;4911;300;1155;508;1526;808;2681
313380;201606;4920;15169;4144;13622;1102;4033;1393;4329;2495;8362
313390;201606;867;2956;820;2890;86;377;574;1990;660;2367
313400;201606;3676;9937;3191;9375;274;747;2690;8128;2964;8875
313410;201606;1228;3471;1030;3169;225;776;593;1785;818;2561
313420;201606;18706;44280;11536;32471;2419;7763;1878;5265;4297;13028
313430;201606;1036;3212;787;2695;166;685;292;926;458;1611
313440;201606;6323;14197;4339;11894;270;752;2893;8168;3163;8920
313450;201606;625;1851;507;1627;111;407;161;487;272;894
313460;201606;2117;7135;1823;6628;531;2213;633;2122;1164;4335
313470;201606;3096;8488;2736;7981;397;1250;1832;5301;2229;6551
313480;201606;1038;2942;792;2548;129;484;278;832;407;1316
313490;201606;1492;4327;861;3305;293;1252;91;335;384;1587
313500;201606;400;1312;332;1142;58;213;112;387;170;600
313505;201606;9076;26289;8353;25470;288;613;7727;24055;8015;24668
313507;201606;1382;3768;1185;3480;122;424;797;2356;919;2780
313510;201606;15241;43509;13273;40598;1953;6373;7565;23359;9518;29732
313520;201606;14207;43385;11896;39261;1419;5419;7654;25154;9073;30573
313530;201606;603;1829;498;1643;43;173;181;571;224;744
313535;201606;2487;7333;2241;6888;186;657;1660;5049;1846;5706
313540;201606;1065;3319;792;2625;213;780;199;625;412;1405
313545;201606;1280;4647;1143;4378;171;814;679;2459;850;3273
313550;201606;1801;5743;1582;5321;363;1284;765;2539;1128;3823
313560;201606;2188;5058;1798;4615;215;522;1340;3552;1555;4074
313570;201606;873;3004;753;2773;234;944;257;922;491;1866
313580;201606;5718;16345;4542;14637;773;2764;2560;8364;3333;11128
313590;201606;965;2712;751;2412;354;1250;159;476;513;1726
313600;201606;3793;11318;3252;10450;407;1482;2259;7290;2666;8772
313610;201606;973;2887;833;2624;168;609;436;1341;604;1950
313620;201606;5386;16475;4663;15183;1302;4528;1699;5571;3001;10099
313630;201606;8124;22461;6122;19623;1075;3937;2904;9883;3979;13820
313640;201606;765;2205;572;1908;178;639;178;604;356;1243
313650;201606;1914;6280;1685;5899;250;1037;1108;3818;1358;4855
313652;201606;929;3243;850;3095;127;549;540;1913;667;2462
313655;201606;930;2966;779;2713;107;443;484;1669;591;2112
313657;201606;1329;3923;1089;3567;118;514;791;2428;909;2942
313660;201606;817;2669;719;2484;157;648;342;1128;499;1776
313665;201606;3698;11792;3166;10673;652;2466;1472;4808;2124;7274
313670;201606;44789;129995;33040;107360;7903;28608;10543;33729;18446;62337
313680;201606;1052;3100;928;2902;134;522;565;1717;699;2239
313690;201606;846;3038;743;2798;175;690;290;1110;465;1800
313695;201606;1333;4315;1143;3962;122;511;803;2795;925;3306
313700;201606;3440;11738;3014;11196;419;1643;2231;8455;2650;10098
313710;201606;1322;3534;1001;3039;192;642;507;1517;699;2159
313720;201606;5284;16682;4214;14381;884;3391;1419;4549;2303;7940
313730;201606;1285;3403;976;3011;154;536;573;1781;727;2317
313740;201606;2033;7296;1731;6580;568;2420;143;490;711;2910
313750;201606;2186;6599;1836;5924;505;1787;575;1704;1080;3491
313753;201606;1823;5199;1447;4571;277;988;675;2123;952;3111
313760;201606;4199;13455;3447;11972;1049;3984;980;3232;2029;7216
313770;201606;3302;10514;2870;9869;816;3004;1319;4576;2135;7580
313780;201606;3896;10669;3064;9432;473;1714;1265;3972;1738;5686
313790;201606;482;1662;455;1615;84;307;270;982;354;1289
313800;201606;1252;3344;1070;3073;116;375;734;2157;850;2532
313810;201606;1544;4412;1386;4187;102;296;1121;3489;1223;3785
313820;201606;12760;33825;10407;30173;1892;6367;4735;13292;6627;19659
313830;201606;417;1373;353;1245;93;369;137;492;230;861
313835;201606;889;2949;821;2843;153;625;452;1499;605;2124
313840;201606;7483;21387;5892;18712;1541;5459;1453;4534;2994;9993
313850;201606;1168;3153;1018;2889;197;683;537;1398;734;2081
313860;201606;2711;8157;2064;6779;485;1719;534;1697;1019;3416
313862;201606;1231;3086;863;2489;122;347;460;1416;582;1763
313865;201606;2253;6897;2027;6559;180;712;1553;4986;1733;5698
313867;201606;1104;3762;953;3433;292;1116;299;1117;591;2233
313868;201606;1623;5387;1380;4890;122;557;940;3249;1062;3806
313870;201606;778;2433;705;2308;192;742;234;685;426;1427
313880;201606;1408;4356;1199;4001;279;1056;525;1601;804;2657
313890;201606;1857;4969;1522;4528;252;727;964;3071;1216;3798
313900;201606;3933;14072;3507;13125;1120;4651;1002;3748;2122;8399
313910;201606;735;2452;615;2212;225;881;83;293;308;1174
313920;201606;3282;10888;2846;10078;495;1901;1632;5937;2127;7838
313925;201606;1850;5005;1391;4162;84;282;848;2549;932;2831
313930;201606;6599;24326;5602;22550;767;2894;3613;15751;4380;18645
313940;201606;8478;27769;7001;25426;1982;8056;2219;8636;4201;16692
313950;201606;4090;11536;3123;9983;989;3665;1040;3072;2029;6737
313960;201606;5455;13934;3932;11761;1108;3699;1115;3221;2223;6920
313970;201606;1436;4124;1256;3916;158;553;772;2532;930;3085
313980;201606;1242;3797;958;3311;253;998;404;1394;657;2392
313990;201606;1748;6436;1498;5845;522;2234;316;1127;838;3361
314000;201606;8017;25252;7208;23665;1217;4781;4213;13337;5430;18118
314010;201606;1154;3178;953;2919;107;403;623;1855;730;2258
314015;201606;1332;4474;1100;4050;275;1145;437;1572;712;2717
314020;201606;502;1511;361;1223;89;326;79;263;168;589
314030;201606;837;2708;675;2341;114;442;253;866;367;1308
314040;201606;710;2027;597;1830;204;676;203;601;407;1277
314050;201606;1701;5235;1362;4560;301;1184;532;1668;833;2852
314053;201606;1580;4928;1387;4669;199;666;923;3284;1122;3950
314055;201606;2184;6454;1904;6045;95;391;1525;4877;1620;5268
314060;201606;1161;3553;920;3140;72;332;615;2051;687;2383
314070;201606;4126;12747;3250;11019;869;3200;766;2484;1635;5684
314080;201606;1844;5754;1288;4468;237;937;259;794;496;1731
314085;201606;1964;6506;1723;6165;488;1898;676;2454;1164;4352
314090;201606;3270;11201;2878;10429;673;2731;1071;4076;1744;6807
314100;201606;3308;8357;2905;7832;173;402;2503;6972;2676;7374
314110;201606;3988;12617;3517;11659;687;2617;1472;4526;2159;7143
314120;201606;1055;2504;512;1625;114;410;130;408;244;818
314130;201606;714;2044;370;1258;66;253;68;215;134;468
314140;201606;4883;15028;4038;13389;821;3023;1868;6195;2689;9218
314150;201606;1577;4289;1254;3737;198;659;655;1940;853;2599
314160;201606;2563;6524;2005;5782;185;593;1225;3748;1410;4341
314170;201606;1076;3197;891;2814;116;396;482;1476;598;1872
314180;201606;5240;16541;4642;15563;1277;4591;2009;6920;3286;11511
314190;201606;715;2030;548;1764;129;516;212;615;341;1131
314200;201606;2951;9082;2568;8399;277;1108;1791;5736;2068;6844
314210;201606;1982;5728;1766;5373;195;716;1137;3380;1332;4096
314220;201606;1581;4883;1216;4191;416;1607;242;744;658;2351
314225;201606;1351;3854;1231;3700;66;220;1038;3168;1104;3388
314230;201606;662;2122;611;2038;117;450;322;1060;439;1510
314240;201606;1116;3359;934;3087;144;510;512;1786;656;2296
314250;201606;554;1626;423;1356;91;332;132;386;223;718
314260;201606;1022;3603;911;3359;210;884;299;1059;509;1943
314270;201606;2863;9244;2379;8375;245;1022;1581;5580;1826;6602
314280;201606;3112;8509;2126;6646;515;1897;719;2001;1234;3898
314290;201606;4771;13115;4080;11999;853;2600;2288;6726;3141;9326
314300;201606;1509;4983;1278;4460;387;1401;369;1273;756;2674
314310;201606;5432;15969;4622;14541;1187;4070;1785;5485;2972;9555
314315;201606;806;3143;732;2996;96;480;498;2015;594;2495
314320;201606;2979;8302;2125;7107;532;1942;1043;3618;1575;5560
314330;201606;54188;161851;46161;148924;13347;46831;15345;49338;28692;96169
314340;201606;2928;7878;1690;5496;383;1408;138;320;521;1728
314345;201606;1219;4086;1098;3888;229;863;684;2423;913;3286
314350;201606;1292;3728;1003;3255;318;1128;202;619;520;1747
314360;201606;672;2145;455;1642;105;435;100;380;205;815
314370;201606;548;1817;508;1761;122;472;326;1107;448;1579
314380;201606;1299;3879;905;3105;259;961;140;496;399;1457
314390;201606;13664;39258;10245;32981;2641;9379;2499;7597;5140;16976
314400;201606;4456;13022;3744;12031;1206;4073;1412;4750;2618;8823
314410;201606;2637;8128;2093;7092;574;2184;681;2364;1255;4548
314420;201606;760;2144;587;1884;42;213;407;1234;449;1447
314430;201606;6368;18906;5506;17304;1600;5535;1727;5541;3327;11076
314435;201606;1318;4201;1156;3922;109;469;769;2588;878;3057
314437;201606;1083;2802;891;2510;36;121;694;1941;730;2062
314440;201606;639;1855;499;1658;172;650;104;306;276;956
314450;201606;1601;4634;1338;4260;284;1098;655;1951;939;3049
314460;201606;4076;13568;3289;11871;858;3419;617;2159;1475;5578
314465;201606;2256;7053;2105;6788;110;544;1671;5235;1781;5779
314467;201606;1001;2851;838;2569;57;171;615;1912;672;2083
314470;201606;2286;7099;1923;6380;400;1539;721;2238;1121;3777
314480;201606;5920;19469;4249;15152;716;2765;518;1646;1234;4411
314490;201606;893;2643;693;2242;158;572;324;998;482;1570
314500;201606;1970;5539;1456;4630;337;1181;478;1443;815;2624
314505;201606;1772;5140;1621;4933;208;726;1121;3439;1329;4165
314510;201606;1886;5089;1283;4249;399;1458;320;1079;719;2537
314520;201606;2964;10602;2261;8939;556;2488;254;913;810;3401
314530;201606;5965;20882;5622;20278;943;3406;3569;13285;4512;16691
314535;201606;2761;7617;2321;6997;222;771;1732;5227;1954;5998
314537;201606;1128;3535;902;3127;125;530;542;1835;667;2365
314540;201606;416;1238;340;1086;67;250;113;334;180;584
314545;201606;1413;4247;1227;3981;113;418;933;3091;1046;3509
314550;201606;624;1696;463;1466;96;400;177;502;273;902
314560;201606;4375;14898;3708;13351;803;3256;1153;3975;1956;7231
314570;201606;296;877;230;752;42;161;117;369;159;530
314580;201606;526;1731;414;1503;112;466;54;196;166;662
314585;201606;832;2687;607;2206;146;616;161;556;307;1172
314587;201606;1957;5901;1674;5423;328;1065;873;2899;1201;3964
314590;201606;3200;10778;2384;8698;530;2188;344;1164;874;3352
314600;201606;1681;5484;1225;4512;314;1269;171;560;485;1829
314610;201606;6941;23357;6222;21693;1473;5851;2699;8962;4172;14813
314620;201606;1591;4746;1424;4504;147;482;1078;3423;1225;3905
314625;201606;1452;4863;1330;4659;183;809;908;3062;1091;3871
314630;201606;4819;14246;4194;13277;337;1387;3035;9499;3372;10886
314640;201606;583;1572;451;1350;121;406;136;345;257;751
314650;201606;1079;2997;776;2497;112;426;282;836;394;1262
314655;201606;1557;4619;1161;3855;279;925;474;1595;753;2520
314660;201606;293;781;211;619;23;69;97;268;120;337
314670;201606;1654;4348;1184;3535;177;599;677;1986;854;2585
314675;201606;1772;5324;1525;4883;154;579;1068;3399;1222;3978
314690;201606;2336;7423;1910;6681;574;2272;421;1422;995;3694
314700;201606;8991;30140;6520;24581;1990;8399;939;3533;2929;11932
314710;201606;8855;26535;6222;20923;1292;4952;923;2849;2215;7801
314720;201606;2425;7866;1961;6867;496;1950;579;2071;1075;4021
314730;201606;2230;6621;1817;5982;486;1800;681;2135;1167;3935
314740;201606;2866;9079;2469;8320;447;1745;1180;3836;1627;5581
314750;201606;348;1079;278;919;44;167;121;382;165;549
314760;201606;1728;5690;1291;4633;204;874;258;786;462;1660
314770;201606;1091;3376;621;2089;77;303;103;277;180;580
314780;201606;275;743;207;648;44;177;102;299;146;476
314790;201606;11109;32930;8511;28414;3334;12529;819;2451;4153;14980
314795;201606;1665;4757;1408;4356;111;449;1032;3075;1143;3524
314800;201606;11074;31847;7761;25305;2204;7871;941;2939;3145;10810
314810;201606;11667;33596;8964;28889;2727;9620;1942;6370;4669;15990
314820;201606;929;2557;651;2092;175;621;238;762;413;1383
314830;201606;1639;5383;1445;5065;393;1560;673;2381;1066;3941
314840;201606;935;3299;763;3050;132;647;462;1797;594;2444
314850;201606;1910;5434;1531;4764;190;758;1028;3088;1218;3846
314860;201606;3252;10678;2854;9948;580;2358;1540;5206;2120;7564
314870;201606;5532;17162;4724;16088;480;2101;3434;11620;3914;13721
314875;201606;1774;5710;1690;5598;139;446;1436;4828;1575;5274
314880;201606;889;2368;731;2164;46;116;543;1712;589;1828
314890;201606;613;1823;425;1417;92;361;153;466;245;827
314900;201606;528;1562;434;1424;88;314;229;734;317;1048
314910;201606;1702;5482;1368;4926;427;1758;463;1574;890;3332
314915;201606;2506;7857;2179;7310;208;869;1567;5146;1775;6015
314920;201606;558;1532;395;1282;43;163;212;635;255;798
314930;201606;4579;15279;3985;14016;1146;4374;1086;3641;2232;8015
314940;201606;397;1159;365;1108;56;195;218;625;274;820
314950;201606;334;966;248;840;51;198;70;225;121;423
314960;201606;737;2259;577;1936;140;522;180;568;320;1090
314970;201606;550;1882;458;1701;110;458;134;501;244;959
314980;201606;1480;4563;1234;4153;404;1519;106;334;510;1853
314990;201606;2583;8082;1968;6753;557;2200;402;1208;959;3408
314995;201606;1620;4890;1413;4576;148;605;946;3008;1094;3613
315000;201606;1066;3015;873;2708;97;351;560;1737;657;2088
315010;201606;439;1328;344;1144;83;349;121;352;204;701
315015;201606;2134;6413;1920;6165;253;812;1402;4779;1655;5591
315020;201606;810;2513;606;2075;90;327;249;814;339;1141
315030;201606;687;2038;551;1808;162;598;125;383;287;981
315040;201606;895;2736;839;2637;142;474;550;1725;692;2199
315050;201606;1368;3933;1106;3528;210;770;512;1636;722;2406
315053;201606;1047;3109;940;2917;152;601;453;1415;605;2016
315057;201606;1694;5717;1487;5380;270;1048;857;3122;1127;4170
315060;201606;832;2693;601;2182;143;561;89;319;232;880
315070;201606;742;2215;621;2015;162;556;292;908;454;1464
315080;201606;2863;9401;2462;8523;632;2362;1101;3787;1733;6149
315090;201606;786;2747;650;2419;161;664;159;576;320;1240
315100;201606;1170;3889;849;3141;218;945;211;721;429;1666
315110;201606;1414;4238;1196;3839;297;1057;448;1425;745;2482
315120;201606;14333;33404;9815;27576;1460;4303;4918;14862;6378;19165
315130;201606;1390;4579;1262;4337;350;1381;427;1426;777;2807
315140;201606;2750;8630;2237;7600;513;2032;796;2488;1309;4520
315150;201606;4628;12500;3509;10652;680;2329;1345;4067;2025;6396
315160;201606;1242;3602;1002;3138;225;757;419;1283;644;2040
315170;201606;1530;4605;1204;4012;281;1028;334;1182;615;2210
315180;201606;16947;47386;9804;32360;1882;7038;1727;5358;3609;12396
315190;201606;2031;5254;1688;4732;385;1115;988;2797;1373;3912
315200;201606;3856;12846;3185;11430;1054;4123;684;2478;1738;6601
315210;201606;7797;22863;6267;19750;1243;4440;2372;7187;3615;11627
315213;201606;1085;3393;1007;3284;54;200;815;2665;869;2865
315217;201606;2430;8294;2005;7509;261;1189;1182;4362;1443;5551
315220;201606;9813;27933;8228;25399;2414;7530;3312;10816;5726;18346
315230;201606;2934;7823;2650;7492;152;228;2292;6941;2444;7169
315240;201606;3031;9219;2562;8475;676;2412;1264;4135;1940;6547
315250;201606;10204;30871;7878;26477;1975;7422;2453;8242;4428;15664
315260;201606;1007;3116;689;2419;164;622;99;310;263;932
315270;201606;715;2292;559;1992;113;475;131;425;244;900
315280;201606;3072;8768;1964;6404;482;1687;322;989;804;2676
315290;201606;1354;3747;974;3137;318;1122;212;699;530;1821
315300;201606;526;1368;349;1148;134;468;138;465;272;933
315310;201606;1246;3940;1027;3548;137;575;648;2127;785;2702
315320;201606;782;2345;622;2135;121;479;292;1020;413;1499
315330;201606;724;2608;464;1910;112;517;66;259;178;776
315340;201606;3570;10154;2890;9146;600;2069;1193;3694;1793;5763
315350;201606;1877;5112;1400;4414;208;700;859;2787;1067;3487
315360;201606;1688;5580;1394;4914;280;1109;480;1604;760;2713
315370;201606;499;1517;427;1403;82;290;227;761;309;1051
315380;201606;203;691;159;586;40;178;40;120;80;298
315390;201606;1322;4350;988;3566;257;1061;184;623;441;1684
315400;201606;4245;12752;3445;11218;688;2468;1563;5023;2251;7491
315410;201606;2114;5478;1767;5006;164;554;1274;3649;1438;4203
315415;201606;1011;3279;901;3108;338;1210;347;1232;685;2442
315420;201606;1236;3927;968;3394;257;956;151;514;408;1470
315430;201606;3646;9844;2743;8393;797;2739;640;1898;1437;4637
315440;201606;927;2842;800;2629;174;654;351;1092;525;1746
315445;201606;2103;5820;1633;5097;193;704;1135;3534;1328;4238
315450;201606;2419;7554;2155;7141;392;1271;1355;4649;1747;5920
315460;201606;32742;106077;29044;98527;10366;37731;5889;19613;16255;57344
315470;201606;472;1415;388;1259;40;154;208;669;248;823
315480;201606;1732;5255;1162;3956;248;935;209;739;457;1674
315490;201606;3084;8205;2349;7232;404;1454;905;2690;1309;4144
315500;201606;500;1456;333;1079;43;162;135;384;178;546
315510;201606;1381;3930;1163;3588;132;455;825;2496;957;2951
315520;201606;1021;3061;840;2768;120;449;531;1701;651;2150
315530;201606;619;2075;505;1784;175;657;156;525;331;1182
315540;201606;1096;3412;903;3049;188;773;333;1122;521;1895
315550;201606;1728;4833;1349;4279;347;1231;431;1364;778;2595
315560;201606;6527;21576;5874;20652;642;2621;4029;14312;4671;16933
315570;201606;1931;6091;1781;5847;280;1056;1018;3292;1298;4348
315580;201606;2509;7277;1957;6289;547;2004;552;1715;1099;3719
315590;201606;867;2524;769;2379;131;453;424;1295;555;1748
315600;201606;2463;8659;1972;7720;317;1381;1103;4462;1420;5843
315610;201606;996;2815;808;2441;156;615;325;831;481;1446
315620;201606;317;1112;300;1083;82;283;176;667;258;950
315630;201606;891;2814;726;2470;191;676;159;515;350;1191
315640;201606;485;1391;396;1252;82;325;174;502;256;827
315645;201606;871;2603;700;2243;254;868;182;576;436;1444
315650;201606;1830;5025;1445;4473;102;436;1066;3273;1168;3709
315660;201606;2562;6597;2082;5846;229;667;1425;3961;1654;4628
315670;201606;10570;34545;9375;32257;2615;9714;3568;12221;6183;21935
315680;201606;3010;9955;2341;8595;746;2875;634;2353;1380;5228
315690;201606;3360;9467;2320;7605;602;2208;459;1628;1061;3836
315700;201606;7256;22449;6116;20196;1138;4276;2881;9190;4019;13466
315710;201606;1811;5166;1424;4544;136;587;923;2843;1059;3430
315720;201606;3636;11442;3217;10672;391;1595;1844;5871;2235;7466
315725;201606;1461;4586;1306;4350;235;812;895;3038;1130;3850
315727;201606;593;1820;489;1611;107;396;184;578;291;974
315730;201606;794;2458;728;2323;114;421;413;1283;527;1704
315733;201606;1002;2999;887;2799;258;920;319;954;577;1874
315737;201606;1253;3800;972;3294;85;347;616;2117;701;2464
315740;201606;1004;3059;840;2734;149;592;460;1408;609;2000
315750;201606;1117;3439;1015;3254;82;306;735;2349;817;2655
315760;201606;1038;2735;1000;2687;16;58;935;2492;951;2550
315765;201606;1480;4579;1319;4369;66;264;1082;3643;1148;3907
315770;201606;1421;4514;1221;4165;340;1280;329;1123;669;2403
315780;201606;22057;71481;19872;66775;5043;18466;6749;22493;11792;40959
315790;201606;3625;11911;3169;11007;330;1154;2118;7580;2448;8734
315800;201606;1450;5592;1148;4714;286;1277;190;747;476;2024
315810;201606;1364;3651;1149;3323;183;566;712;2001;895;2567
315820;201606;2439;8149;2118;7588;613;2275;939;3491;1552;5766
315830;201606;1203;3944;1004;3543;168;738;316;991;484;1729
315840;201606;846;2201;577;1729;111;377;159;447;270;824
315850;201606;1005;3529;975;3471;245;971;541;1849;786;2820
315860;201606;513;1741;380;1449;99;462;76;255;175;717
315870;201606;461;1339;375;1202;82;299;179;549;261;848
315880;201606;1205;3073;951;2756;228;822;334;901;562;1723
315890;201606;1487;5035;1315;4746;462;1749;573;2070;1035;3819
315895;201606;5246;16265;4497;14601;1007;3574;1582;4904;2589;8478
315900;201606;745;2217;712;2161;69;280;568;1634;637;1914
315910;201606;509;1707;470;1641;117;443;299;1027;416;1470
315920;201606;1581;4335;915;2920;207;737;163;440;370;1177
315930;201606;1076;2885;803;2412;218;733;213;620;431;1353
315935;201606;940;3115;836;2897;251;984;224;738;475;1722
315940;201606;622;1963;539;1795;110;418;263;860;373;1278
315950;201606;1190;3611;1059;3368;212;635;651;2147;863;2782
315960;201606;3483;10930;2386;8720;901;3840;141;389;1042;4229
315970;201606;740;2015;565;1779;42;110;396;1310;438;1420
315980;201606;4014;9760;2488;7232;669;2212;624;1579;1293;3791
315990;201606;3999;11444;3289;10258;532;2010;1668;5095;2200;7105
316000;201606;566;1672;474;1547;133;534;193;608;326;1142
316010;201606;622;2041;504;1820;88;375;221;739;309;1114
316020;201606;1033;3255;901;3048;119;501;616;2018;735;2519
316030;201606;3144;9174;2315;7679;220;878;1414;4779;1634;5657
316040;201606;3438;10818;2631;9136;471;1886;509;1520;980;3406
316045;201606;2043;6327;1872;6039;238;762;1333;4423;1571;5185
316050;201606;349;1109;278;997;50;209;137;466;187;675
316060;201606;737;2196;585;1971;84;354;343;1092;427;1446
316070;201606;6133;19040;5281;17201;1167;4338;2238;6966;3405;11304
316080;201606;738;2682;654;2480;170;712;80;314;250;1026
316090;201606;559;1651;370;1248;76;295;108;348;184;643
316095;201606;1437;4546;1237;4199;167;601;808;2764;975;3365
316100;201606;2765;9071;2110;7479;544;2166;435;1419;979;3585
316105;201606;936;2641;704;2251;168;584;280;901;448;1485
316110;201606;12237;41170;10850;38839;1421;5654;7182;26445;8603;32099
316120;201606;1135;3631;913;3108;231;842;245;730;476;1572
316130;201606;1516;3419;939;2624;130;413;414;1123;544;1536
316140;201606;953;2771;753;2465;101;349;457;1524;558;1873
316150;201606;1510;4065;1315;3730;188;639;812;2283;1000;2922
316160;201606;1238;3618;946;3066;176;636;402;1293;578;1929
316165;201606;935;2474;778;2251;140;477;437;1276;577;1753
316170;201606;1341;3812;999;3235;160;606;442;1311;602;1917
316180;201606;1393;4338;991;3444;239;930;187;584;426;1514
316190;201606;2830;8733;1511;5316;315;1108;250;775;565;1883
316200;201606;3836;12084;2959;10362;688;2786;759;2601;1447;5387
316210;201606;4656;14842;3925;13410;1462;5302;608;2120;2070;7422
316220;201606;795;2458;570;2018;131;531;66;253;197;784
316225;201606;1206;3307;1002;2990;155;542;603;1726;758;2268
316230;201606;415;1188;341;1059;55;199;169;561;224;760
316240;201606;6616;20093;5757;18943;652;2261;4273;14186;4925;16447
316245;201606;3213;11022;2953;10594;243;1204;2293;8001;2536;9205
316250;201606;10643;30519;8276;25924;2254;7828;2120;6392;4374;14220
316255;201606;2578;7678;2251;7281;319;1163;1585;5155;1904;6318
316257;201606;1355;3713;1013;3095;186;656;365;1056;551;1712
316260;201606;1795;5040;1421;4483;85;314;802;2689;887;3003
316265;201606;1322;3719;977;3045;103;367;583;1792;686;2159
316270;201606;3962;13140;3633;12468;935;3473;1509;5113;2444;8586
316280;201606;3196;10296;2896;9736;475;1829;1636;5396;2111;7225
316290;201606;3407;10538;2890;9539;631;2478;1182;3792;1813;6270
316292;201606;3423;10762;3028;10128;585;2219;1784;5769;2369;7988
316294;201606;876;2760;644;2284;124;519;57;205;181;724
316295;201606;1802;5935;1683;5710;228;958;1123;3692;1351;4650
316300;201606;1008;3095;855;2843;70;267;551;1868;621;2135
316310;201606;714;2035;481;1611;87;344;154;484;241;828
316320;201606;609;1910;487;1688;114;471;95;303;209;774
316330;201606;940;2875;737;2415;80;321;486;1549;566;1870
316340;201606;940;3013;759;2636;174;730;355;1145;529;1875
316350;201606;1306;4103;1160;3861;186;658;666;2240;852;2898
316360;201606;736;1944;582;1719;59;185;428;1278;487;1463
316370;201606;4510;14435;3865;13150;1200;4528;625;2133;1825;6661
316380;201606;1611;4212;1268;3739;91;319;903;2685;994;3004
316390;201606;895;2582;750;2359;175;613;319;1036;494;1649
316400;201606;1286;3929;980;3390;226;868;391;1327;617;2195
316410;201606;1066;3508;982;3385;179;667;654;2263;833;2930
316420;201606;1929;6125;1701;5827;165;712;1230;4111;1395;4823
316430;201606;950;2878;677;2318;178;692;151;472;329;1164
316440;201606;676;2203;558;2026;213;877;110;410;323;1287
316443;201606;687;2026;568;1817;122;459;229;692;351;1151
316447;201606;1576;4665;1430;4474;97;344;1216;3821;1313;4165
316450;201606;2105;7047;1788;6436;210;866;1209;4377;1419;5243
316460;201606;736;2272;664;2146;182;628;338;1070;520;1698
316470;201606;7247;23087;5785;20064;1574;6332;1599;5366;3173;11698
316480;201606;183;608;157;547;40;153;40;130;80;283
316490;201606;300;925;242;789;53;171;95;290;148;461
316500;201606;1132;3989;764;2898;162;681;36;126;198;807
316510;201606;752;2755;670;2590;247;1030;172;658;419;1688
316520;201606;1068;3209;860;2887;178;677;298;904;476;1581
316530;201606;1031;3323;873;3023;190;817;314;920;504;1737
316540;201606;733;2344;659;2218;95;389;237;763;332;1152
316550;201606;1174;3920;1097;3792;191;737;681;2384;872;3121
316553;201606;1896;6589;1490;5592;451;1913;334;1209;785;3122
316555;201606;2828;9647;2523;9263;211;817;1923;7281;2134;8098
316556;201606;644;1625;493;1385;46;158;337;914;383;1072
316557;201606;789;2825;747;2757;301;1182;206;697;507;1879
316560;201606;317;1116;270;1016;78;343;55;192;133;535
316570;201606;1245;3947;1093;3662;148;534;551;1871;699;2405
316580;201606;298;812;201;623;49;180;51;146;100;326
316590;201606;1464;3940;1036;3225;174;634;535;1534;709;2168
316600;201606;1049;3393;931;3162;249;933;379;1267;628;2200
316610;201606;574;2079;503;1934;102;480;316;1170;418;1650
316620;201606;2146;6487;1832;5961;223;886;1164;3750;1387;4636
316630;201606;1408;4686;1207;4249;441;1599;379;1406;820;3005
316640;201606;176;552;155;512;33;139;71;206;104;345
316650;201606;892;3240;792;3079;125;501;508;2064;633;2565
316660;201606;197;513;93;290;9;38;20;47;29;85
316670;201606;1875;5290;1517;4679;592;1984;361;1076;953;3060
316680;201606;1959;5272;1570;4724;155;513;1132;3406;1287;3919
316690;201606;1149;3883;1024;3599;310;1242;318;1104;628;2346
316695;201606;1091;3400;946;3121;107;407;596;1953;703;2360
316700;201606;364;1081;329;1025;40;174;217;618;257;792
316710;201606;2915;10829;2497;9921;918;3803;662;2838;1580;6641
316720;201606;16214;51567;13315;45410;3666;13397;3274;11007;6940;24404
316730;201606;363;1114;314;1018;80;300;134;402;214;702
316740;201606;670;2244;609;2141;100;414;382;1356;482;1770
316750;201606;398;1323;333;1180;58;241;118;383;176;624
316760;201606;3462;11420;2986;10766;1525;5704;882;3303;2407;9007
316770;201606;1291;3611;1161;3444;80;311;952;2812;1032;3123
316780;201606;585;1925;513;1783;164;664;83;254;247;918
316790;201606;850;2425;635;2064;172;601;207;695;379;1296
316800;201606;5139;16782;4547;15640;886;3485;2351;7686;3237;11171
316805;201606;783;2000;753;1960;37;90;664;1797;701;1887
316810;201606;611;1863;509;1658;149;538;200;603;349;1141
316820;201606;391;1014;221;722;40;171;34;98;74;269
316830;201606;567;1936;541;1891;157;605;246;848;403;1453
316840;201606;2804;8540;2464;7918;570;2089;1124;3477;1694;5566
316850;201606;2026;5882;1673;5305;240;870;948;2989;1188;3859
316860;201606;17669;55411;15091;50679;3595;13938;6183;20070;9778;34008
316870;201606;5990;19179;4845;16558;1501;5578;830;2790;2331;8368
316880;201606;863;2610;748;2418;223;854;238;744;461;1598
316890;201606;1268;3079;974;2685;257;820;528;1379;785;2199
316900;201606;2545;7572;2020;6509;472;1790;639;1838;1111;3628
316905;201606;455;1508;395;1372;134;502;142;492;276;994
316910;201606;814;2536;592;2099;167;619;116;433;283;1052
316920;201606;1594;4284;1140;3672;282;1045;451;1418;733;2463
316930;201606;8345;28069;6617;24317;1665;6764;930;3253;2595;10017
316935;201606;4961;14439;3381;11322;928;3478;708;2345;1636;5823
316940;201606;6920;22303;5580;19433;1345;5048;1173;3932;2518;8980
316950;201606;1546;4255;1293;3901;122;441;930;2776;1052;3217
316960;201606;4766;12007;3751;10612;657;2033;2154;6063;2811;8096
316970;201606;3233;10198;3044;9872;711;2710;1248;3790;1959;6500
316980;201606;943;2873;682;2368;236;906;111;385;347;1291
316990;201606;9586;30128;7988;26599;2487;9074;707;2303;3194;11377
317000;201606;2794;9412;2675;9278;269;830;2055;7962;2324;8792
317005;201606;2548;7855;2247;7368;413;1412;1325;4402;1738;5814
317010;201606;30383;75157;18733;57062;4664;16165;3794;12407;8458;28572
317020;201606;62855;170025;37307;118805;7819;27785;7368;21974;15187;49759
317030;201606;714;2095;595;1909;63;261;366;1158;429;1419
317040;201606;10317;29659;8236;26051;2055;6988;3213;10297;5268;17285
317043;201606;712;1918;604;1775;100;296;369;1091;469;1387
317047;201606;1136;2987;832;2492;90;300;444;1336;534;1636
317050;201606;1501;5087;1165;4287;241;990;434;1481;675;2471
317052;201606;2285;7361;2094;7061;195;812;1546;5138;1741;5950
317057;201606;1685;4691;1274;3970;123;497;763;2299;886;2796
317060;201606;416;1206;271;883;64;235;75;224;139;459
317065;201606;1275;4042;1151;3846;117;506;857;2805;974;3311
317070;201606;9675;29770;6702;23151;1564;6114;933;3207;2497;9321
317075;201606;1081;3258;858;2790;215;732;199;631;414;1363
317080;201606;6173;16802;5199;15162;1579;4879;1669;4816;3248;9695
317090;201606;4800;15872;4461;15333;519;1902;3176;11093;3695;12995
317100;201606;3019;8163;2220;6826;686;2302;738;2222;1424;4524
317103;201606;1976;6680;1674;6108;275;1243;846;3009;1121;4252
317107;201606;1321;4020;1147;3673;161;646;749;2252;910;2898
317110;201606;647;1639;375;1174;74;280;134;440;208;720
317115;201606;1137;3536;965;3185;96;332;707;2352;803;2684
317120;201606;10613;35002;8664;30458;2075;8074;3274;11321;5349;19395
317130;201606;7415;21856;6148;19589;1365;4916;2539;8071;3904;12987
317140;201606;555;1775;509;1703;72;269;337;1147;409;1416
317150;201606;959;2635;829;2484;96;339;612;1794;708;2133
317160;201606;3496;9111;2610;7920;189;647;1813;5485;2002;6132
317170;201606;1914;5138;1483;4424;182;655;678;1875;860;2530
317180;201606;1781;5959;1443;5230;403;1555;364;1304;767;2859
317190;201606;1363;3826;1073;3413;95;346;721;2272;816;2618
317200;201606;4475;13893;3839;12611;1024;3784;1206;3833;2230;7617
317210;201606;1034;3056;858;2818;147;609;503;1615;650;2224
317220;201606;285;978;270;955;80;307;129;444;209;751
320010;201606;4936;15391;4261;14020;779;2758;2259;7382;3038;10140
320013;201606;1872;5702;1307;4450;230;807;546;1935;776;2742
320016;201606;3095;8688;2652;8034;291;876;1907;5841;2198;6717
320020;201606;3836;11897;3267;10731;971;3467;1039;3468;2010;6935
320030;201606;1705;5371;1328;4589;401;1469;418;1418;819;2887
320035;201606;1795;5280;1539;4892;518;1811;573;1741;1091;3552
320040;201606;3089;9954;2572;8906;618;2345;854;2926;1472;5271
320050;201606;1736;4682;1482;4225;313;976;693;1902;1006;2878
320060;201606;11716;36753;8906;30402;2241;8410;2237;7306;4478;15716
320070;201606;1420;4535;1150;3939;293;1114;291;912;584;2026
320080;201606;5656;16269;4347;13681;1061;3490;1325;4346;2386;7836
320090;201606;8046;23330;6367;19981;1749;5895;2275;6974;4024;12869
320100;201606;2778;8577;2210;7412;637;2235;748;2537;1385;4772
320110;201606;1276;3783;1108;3456;309;1013;329;1048;638;2061
320115;201606;1750;6223;1581;5916;804;3089;435;1738;1239;4827
320120;201606;16338;48964;12627;41890;3279;12080;3648;12187;6927;24267
320130;201606;35936;114613;32317;107412;6980;26080;15242;49351;22222;75431
320140;201606;3693;11611;2647;9261;711;2758;345;1217;1056;3975
320150;201606;15889;43947;11579;35758;3057;10295;1592;4811;4649;15106
320160;201606;4864;15275;4190;13912;1104;4134;1440;4502;2544;8636
320170;201606;1718;5447;1396;4747;370;1345;529;1795;899;3140
320180;201606;746;2491;656;2328;261;950;178;672;439;1622
320190;201606;3661;12544;2899;10699;875;3377;559;2048;1434;5425
320200;201606;1024;3119;844;2812;247;891;267;937;514;1828
320210;201606;4730;13257;3991;11840;861;2904;1874;5241;2735;8145
320220;201606;2396;7377;1955;6515;535;1957;753;2554;1288;4511
320225;201606;1354;4561;1073;3896;378;1471;176;647;554;2118
320230;201606;4212;13451;3603;12425;1091;4010;1409;5038;2500;9048
320240;201606;12408;36306;9872;31742;2682;9393;2751;8971;5433;18364
320245;201606;3397;11552;3131;10916;1088;4006;849;2911;1937;6917
320250;201606;1847;5611;1302;4354;376;1426;230;693;606;2119
320255;201606;1758;5849;1534;5460;597;2235;559;2153;1156;4388
320260;201606;1064;3243;808;2673;222;781;227;693;449;1474
320265;201606;2398;7577;2072;7073;464;1631;1166;4111;1630;5742
320270;201606;2691;7898;1994;6562;481;1711;837;2790;1318;4501
320280;201606;6755;20449;5863;18662;1525;5370;1982;5913;3507;11283
320290;201606;1399;4559;1026;3664;345;1286;151;570;496;1856
320300;201606;4211;13968;3718;12871;1307;4805;867;3010;2174;7815
320305;201606;4417;14180;3791;12767;971;3556;1547;5082;2518;8638
320310;201606;1946;5766;1638;5147;426;1391;602;1876;1028;3267
320313;201606;2215;6370;1529;4818;375;1393;267;760;642;2153
320316;201606;1737;5222;1405;4537;444;1494;434;1400;878;2894
320320;201606;20371;61080;15953;52970;4391;16103;5302;17455;9693;33558
320330;201606;2999;8836;2507;8007;637;2012;1156;3933;1793;5945
320332;201606;5183;16885;4504;15593;1563;5737;1534;5369;3097;11106
320334;201606;1904;6005;1331;4770;378;1526;262;914;640;2440
320335;201606;2371;6975;1498;4926;400;1455;180;516;580;1971
320340;201606;5916;15889;4915;14250;1049;3317;2233;6644;3282;9961
320350;201606;5173;13611;3876;11264;798;2485;1653;4729;2451;7214
320360;201606;1712;4528;1254;3652;236;750;473;1313;709;2063
320370;201606;3002;9741;2422;8425;725;2603;765;2668;1490;5271
320380;201606;2204;6480;1940;6010;381;1318;1096;3321;1477;4639
320390;201606;7334;21974;5958;19096;1783;6203;1700;5287;3483;11490
320400;201606;3545;10877;3146;10170;858;3087;1308;4092;2166;7179
320405;201606;4123;12050;3577;11134;815;2751;1864;5735;2679;8486
320410;201606;5526;14569;4055;12602;995;3382;1843;5846;2838;9228
320420;201606;2200;6618;1731;5772;528;1977;434;1434;962;3411
320425;201606;1969;5205;1614;4617;184;585;1013;2857;1197;3442
320430;201606;2435;6759;2103;6097;410;1291;1152;3235;1562;4526
320435;201606;2815;9135;2314;8108;1054;3796;613;2321;1667;6117
320440;201606;1054;3481;931;3169;234;870;314;1036;548;1906
320450;201606;1994;6219;1615;5469;449;1655;664;2202;1113;3857
320455;201606;4131;13500;3050;10889;900;3425;686;2398;1586;5823
320460;201606;2660;8481;2018;7022;546;2039;518;1735;1064;3774
320465;201606;1619;5030;1235;4186;234;854;577;1967;811;2821
320470;201606;4463;13355;3068;10224;886;3271;531;1704;1417;4975
320480;201606;1773;5499;1549;5069;392;1420;569;1829;961;3249
320490;201606;16022;48709;13420;44001;4055;14535;4139;13716;8194;28251
320495;201606;1313;3783;864;2854;284;997;102;355;386;1352
320500;201606;47513;142411;41267;131179;9723;33823;19742;61771;29465;95594
320501;201606;4314;13445;3636;12417;1206;4586;1180;3975;2386;8561
320503;201606;1837;6229;1476;5448;569;2305;397;1362;966;3667
320506;201606;3969;12213;2830;9522;853;3071;199;593;1052;3664
320510;201606;8327;25812;7182;23608;1648;5948;3419;11155;5067;17103
320515;201606;1887;5437;1533;4653;444;1424;278;797;722;2221
320517;201606;2182;7001;1765;6161;582;2188;404;1405;986;3593
320520;201606;37856;112590;30877;99833;8172;29248;10926;35051;19098;64299
320530;201606;27277;81987;22552;72985;4696;17742;10878;33307;15574;51049
330010;201606;20285;61499;18244;57603;3927;13489;9847;30774;13774;44263
330015;201606;1660;4594;1422;4154;230;798;656;1877;886;2675
330020;201606;17575;51222;16011;48681;3028;10163;9518;28486;12546;38649
330022;201606;1872;5554;1577;5064;301;1092;836;2634;1137;3726
330023;201606;3199;9859;2797;9202;798;2850;899;2882;1697;5732
330025;201606;4550;12218;3575;10572;793;2569;1875;5543;2668;8112
330030;201606;8060;26539;7078;24605;1513;5875;3401;11376;4914;17251
330040;201606;12282;36083;10851;33465;2360;7887;5634;16961;7994;24848
330045;201606;71520;195084;61916;181505;7953;25597;41994;121604;49947;147201
330050;201606;2501;7697;2148;7032;649;2355;700;2147;1349;4502
330060;201606;5771;16552;4980;15404;1105;3908;2588;7913;3693;11821
330070;201606;21652;65184;19302;61212;4399;15166;9039;28731;13438;43897
330080;201606;7920;22526;7313;21583;816;2495;5098;15112;5914;17607
330090;201606;2672;7189;2408;6784;418;1323;1347;3698;1765;5021
330093;201606;2069;6072;1723;5467;352;1170;739;2467;1091;3637
330095;201606;1003;3378;865;3068;250;1037;262;882;512;1919
330100;201606;56740;178604;51631;170268;9071;34241;28815;94906;37886;129147
330110;201606;2372;7379;2096;6897;542;1934;662;2174;1204;4108
330115;201606;1920;5509;1684;5150;314;1092;899;2658;1213;3750
330120;201606;2623;7216;2299;6726;460;1558;1298;3666;1758;5224
330130;201606;3577;11448;3164;10721;805;2975;1479;4964;2284;7939
330140;201606;3071;9467;2792;9052;614;2228;1519;4909;2133;7137
330150;201606;2355;6915;1852;5908;451;1566;448;1471;899;3037
330160;201606;1172;3721;1031;3477;288;1136;484;1533;772;2669
330170;201606;100371;299757;91184;285293;16922;57085;53084;165490;70006;222575
330180;201606;2032;5919;1688;5288;172;690;1055;3127;1227;3817
330185;201606;8079;24924;6995;22850;1498;5354;3699;11868;5197;17222
330187;201606;3832;10913;3282;9993;474;1626;2185;6566;2659;8192
330190;201606;25587;72574;23803;69780;4167;12943;16015;46812;20182;59755
330200;201606;14114;44152;12527;41438;3090;10624;6323;21264;9413;31888
330205;201606;2177;5950;1886;5461;311;997;1087;3080;1398;4077
330210;201606;3366;9314;2744;8107;736;2279;760;2236;1496;4515
330220;201606;10319;31289;8907;28302;2441;8517;2446;7235;4887;15752
330225;201606;3823;11833;3405;11060;452;1805;2076;6613;2528;8418
330227;201606;17064;48847;15367;46385;3718;11627;8522;26211;12240;37838
330230;201606;1360;4039;1233;3836;288;1063;591;1749;879;2812
330240;201606;17425;53391;14836;48439;4948;17565;3850;12244;8798;29809
330245;201606;1293;3969;1005;3440;290;1117;190;621;480;1738
330250;201606;36002;104778;32752;99492;9911;30559;13483;42767;23394;73326
330260;201606;3842;11987;3345;10996;748;2722;1396;4377;2144;7099
330270;201606;19062;44288;12834;35781;3183;9893;4589;12969;7772;22862
330280;201606;2221;6551;1847;5824;330;1189;900;2678;1230;3867
330285;201606;18239;52045;16398;49320;2790;9169;10255;30622;13045;39791
330290;201606;3401;9616;3008;9028;493;1708;1788;5154;2281;6862
330300;201606;3288;10647;2998;10102;491;1930;1790;5876;2281;7806
330310;201606;2311;6555;1981;6005;303;983;1158;3489;1461;4472
330320;201606;13266;39615;12420;38318;1646;5610;9223;28300;10869;33910
330330;201606;27443;75526;23962;70073;4172;13873;14663;41613;18835;55486
330340;201606;14602;42312;11500;36665;2995;10348;3598;11375;6593;21723
330350;201606;86044;254176;78600;243328;11521;37873;54474;169169;65995;207042
330360;201606;5787;17169;5555;16854;366;1279;4750;14352;5116;15631
330370;201606;3475;12197;3142;11465;1072;4092;1075;3976;2147;8068
330380;201606;4949;15959;4180;14392;1025;3946;1565;5249;2590;9195
330385;201606;3971;13627;3622;12927;1135;4321;1377;5000;2512;9321
330390;201606;22969;74685;20229;69226;5113;19242;8779;29605;13892;48847
330395;201606;3033;8844;2742;8361;295;1086;1806;5402;2101;6488
330400;201606;2554;8018;2301;7594;341;1378;1418;4356;1759;5734
330410;201606;2808;8596;2321;7673;507;1871;1044;3353;1551;5224
330411;201606;2383;7417;2059;6734;256;991;1198;3770;1454;4761
330412;201606;1366;4563;1136;4103;232;974;521;1778;753;2752
330414;201606;24330;68551;21310;64290;4261;13003;12565;38477;16826;51480
330415;201606;3524;10773;3063;9972;814;2779;1170;3863;1984;6642
330420;201606;9780;28028;6695;22339;1603;5878;1291;4225;2894;10103
330430;201606;7321;21636;6462;20024;1391;4730;3032;9199;4423;13929
330440;201606;1665;5539;1450;5092;479;1869;332;1076;811;2945
330450;201606;1353;4463;1210;4210;278;1149;607;2057;885;3206
330452;201606;13653;39748;10836;34339;2871;10032;4064;12497;6935;22529
330455;201606;498334;1360780;405958;1213997;89443;287535;204784;610612;294227;898147
330460;201606;1189;3861;1053;3617;230;907;481;1617;711;2524
330470;201606;4406;13309;3925;12435;942;3292;1803;5610;2745;8902
330475;201606;7871;24272;6931;22693;2070;7347;2676;8721;4746;16068
330480;201606;5823;17042;5317;16304;961;3234;3200;9649;4161;12883
330490;201606;107936;284699;96876;268521;9919;29171;71130;197320;81049;226491
330500;201606;5553;17004;5285;16518;787;2700;3578;11094;4365;13794
330510;201606;37325;113384;33395;107245;10210;33367;15089;49896;25299;83263
330513;201606;1494;4443;1357;4197;399;1267;590;1883;989;3150
330515;201606;3029;9306;2648;8569;874;2926;786;2527;1660;5453
330520;201606;11440;34196;10185;32008;2172;7307;4874;15205;7046;22512
330530;201606;1506;4447;1332;4124;364;1217;542;1654;906;2871
330540;201606;2920;8656;2432;7782;625;2163;957;2966;1582;5129
330550;201606;7798;25959;6861;24175;3019;11132;1195;4329;4214;15461
330555;201606;10266;30007;9081;28321;1688;5396;5553;17827;7241;23223
330560;201606;4284;12823;3869;12042;717;2513;2080;6251;2797;8764
330570;201606;3396;9922;2902;9087;747;2471;1399;4395;2146;6866
330575;201606;5222;14979;4663;13971;711;2434;3039;8811;3750;11245
330580;201606;13890;43621;11793;39352;3245;11523;4705;15824;7950;27347
330590;201606;1604;4898;1485;4706;269;945;958;3011;1227;3956
330600;201606;10928;31530;8816;27976;1435;5205;4407;13777;5842;18982
330610;201606;8853;27598;8024;26136;1330;5050;4747;15126;6077;20176
330615;201606;1667;5827;1508;5497;652;2493;413;1591;1065;4084
330620;201606;3451;11881;3074;11110;1082;4237;761;2796;1843;7033
330630;201606;23015;67185;18900;59919;3252;12006;10194;31131;13446;43137
350010;201606;1991;5888;1332;4557;343;1284;185;606;528;1890
350020;201606;458;1252;320;982;53;171;166;492;219;663
350030;201606;4377;13696;3419;11799;1147;4331;838;2852;1985;7183
350040;201606;469;1609;354;1345;87;360;94;344;181;704
350050;201606;893;2694;722;2381;183;715;259;754;442;1469
350055;201606;656;1940;558;1779;100;356;335;1047;435;1403
350060;201606;114;334;90;297;25;97;44;140;69;237
350070;201606;3675;10991;2381;8250;511;1951;481;1524;992;3475
350075;201606;472;1574;373;1393;145;537;77;280;222;817
350080;201606;588;1675;401;1288;78;283;144;445;222;728
350090;201606;609;1571;393;1182;104;299;139;433;243;732
350100;201606;1854;5752;1336;4715;315;1268;400;1333;715;2601
350110;201606;456;1366;349;1142;45;176;189;602;234;778
350115;201606;1252;3772;1118;3498;196;718;618;1782;814;2500
350120;201606;593;1562;314;976;64;216;46;137;110;353
350130;201606;3262;9707;2859;8897;431;1540;1553;4593;1984;6133
350140;201606;567;1832;479;1681;83;343;241;832;324;1175
350150;201606;383;1280;329;1165;122;470;84;295;206;765
350160;201606;7874;22843;5395;17946;1247;4685;2094;6454;3341;11139
350170;201606;1648;5636;1414;5059;381;1429;324;1122;705;2551
350180;201606;1037;2893;673;2060;103;331;317;965;420;1296
350190;201606;2986;9258;2459;8187;526;2095;1162;3423;1688;5518
350200;201606;360;1135;315;1056;41;150;191;639;232;789
350210;201606;4883;13015;3647;10996;1016;3341;1512;4490;2528;7831
350220;201606;2595;8206;2248;7468;549;2194;899;2762;1448;4956
350230;201606;642;2099;585;2002;150;555;260;882;410;1437
350240;201606;480;1466;400;1280;70;249;230;709;300;958
350250;201606;2001;7222;1869;6966;646;2600;661;2451;1307;5051
350260;201606;961;2568;674;2051;117;390;300;877;417;1267
350270;201606;4977;15225;4214;13553;824;2910;1819;5634;2643;8544
350275;201606;1932;6320;1748;5998;489;1850;705;2333;1194;4183
350280;201606;22084;53934;13669;39714;3002;9403;3192;9274;6194;18677
350290;201606;1855;5943;1457;5109;335;1311;438;1473;773;2784
350300;201606;432;1249;350;1083;80;245;194;599;274;844
350310;201606;815;2708;713;2486;107;427;306;1046;413;1473
350315;201606;499;1576;399;1359;80;340;100;298;180;638
350320;201606;10450;32490;9238;30231;2718;9506;1523;5197;4241;14703
350330;201606;14018;38970;9423;28568;1956;5898;3187;9253;5143;15151
350335;201606;355;1120;312;1028;24;66;225;761;249;827
350340;201606;1099;3264;772;2607;157;602;232;778;389;1380
350350;201606;709;2195;607;2027;146;563;213;697;359;1260
350360;201606;790;2689;683;2461;177;651;281;1057;458;1708
350370;201606;610;1812;449;1464;101;357;83;260;184;617
350380;201606;4147;11830;2794;9453;769;2906;691;2136;1460;5042
350390;201606;8938;27394;7894;25427;2292;7754;3108;9906;5400;17660
350395;201606;364;1014;187;642;31;118;40;133;71;251
350400;201606;7772;22184;6285;19551;1436;4998;2579;7799;4015;12797
350410;201606;8130;26900;6316;23171;1785;7231;1157;4163;2942;11394
350420;201606;530;1614;384;1352;87;364;31;105;118;469
350430;201606;702;2154;576;1926;116;446;294;950;410;1396
350440;201606;1222;3816;1089;3541;259;863;500;1625;759;2488
350450;201606;7497;22844;5933;19634;1472;5291;1440;4613;2912;9904
350460;201606;1426;3911;897;2855;161;572;289;862;450;1434
350470;201606;233;650;193;580;29;110;116;330;145;440
350480;201606;794;2379;553;1859;87;342;94;274;181;616
350490;201606;1812;5414;1551;4995;384;1379;612;1849;996;3228
350500;201606;565;1655;495;1539;91;318;280;850;371;1168
350510;201606;1092;3263;833;2715;155;589;325;998;480;1587
350520;201606;1356;4990;1074;4257;260;1127;206;811;466;1938
350530;201606;2388;6964;1963;6092;593;1914;671;1993;1264;3907
350535;201606;1233;3977;1156;3843;161;664;761;2424;922;3088
350540;201606;1761;4970;1376;4273;374;1217;485;1564;859;2781
350550;201606;10933;29081;7566;23540;1592;5636;2633;7829;4225;13465
350560;201606;3203;10544;2858;9788;400;1452;1610;5570;2010;7022
350570;201606;17789;58565;15863;54654;4618;17197;6044;20094;10662;37291
350580;201606;1611;5048;1150;4006;276;1063;141;437;417;1500
350590;201606;4034;12459;3144;10672;821;3135;1183;3742;2004;6877
350600;201606;40888;100368;27004;76571;4597;14401;11831;31729;16428;46130
350610;201606;7010;20443;5599;17977;1214;4289;2477;7889;3691;12178
350620;201606;403;1145;302;989;55;213;131;408;186;621
350630;201606;1568;4595;1178;3851;237;955;405;1191;642;2146
350635;201606;6263;18461;4862;15987;1146;4132;1966;6366;3112;10498
350640;201606;734;2261;509;1719;99;358;104;329;203;687
350650;201606;7643;23049;4750;16197;1184;4517;734;2305;1918;6822
350660;201606;4626;13510;3814;12119;754;2654;1970;6159;2724;8813
350670;201606;1601;4940;1461;4675;294;972;819;2591;1113;3563
350680;201606;1052;3163;817;2711;178;660;340;1115;518;1775
350690;201606;851;2775;685;2448;157;618;209;717;366;1335
350700;201606;4193;12349;2835;9864;715;2724;782;2489;1497;5213
350710;201606;2632;8122;2303;7491;347;1248;1383;4430;1730;5678
350715;201606;777;2359;677;2163;190;646;275;821;465;1467
350720;201606;119;351;104;325;27;97;40;118;67;215
350730;201606;393;1462;377;1422;100;427;158;591;258;1018
350740;201606;1817;5575;1319;4423;261;969;379;1164;640;2133
350745;201606;485;1529;299;1036;45;172;135;432;180;604
350750;201606;9856;29676;7890;25851;1971;7157;1892;5797;3863;12954
350760;201606;12923;37492;10319;32845;2696;9495;3154;9293;5850;18788
350770;201606;706;1995;489;1578;70;253;249;788;319;1041
350775;201606;567;1526;477;1392;66;240;263;751;329;991
350780;201606;1855;5674;1441;4835;446;1663;233;810;679;2473
350790;201606;1899;5820;1400;4832;368;1391;266;797;634;2188
350800;201606;2873;9557;2686;9237;457;1868;1657;5512;2114;7380
350810;201606;1998;5636;1666;5167;461;1520;732;2329;1193;3849
350820;201606;552;1492;408;1225;65;250;195;543;260;793
350830;201606;850;2612;566;1973;79;288;137;427;216;715
350840;201606;2351;8303;1945;7361;636;2542;429;1548;1065;4090
350850;201606;5771;19138;4881;17200;1566;5800;1192;4192;2758;9992
350860;201606;3181;9804;3034;9590;227;907;2335;7321;2562;8228
350870;201606;2695;8459;2231;7725;456;1773;1332;4690;1788;6463
350880;201606;1241;4110;1044;3702;265;1013;260;900;525;1913
350890;201606;627;1794;408;1309;61;220;102;272;163;492
350900;201606;3814;12254;2860;10067;844;3231;334;1136;1178;4367
350910;201606;829;2451;721;2230;213;730;306;906;519;1636
350920;201606;10132;28820;9047;26941;1028;3472;6320;18186;7348;21658
350925;201606;4491;13957;3656;12272;953;3494;1245;3750;2198;7244
350930;201606;1558;4255;1216;3623;144;478;749;2155;893;2633
350940;201606;1797;5838;1638;5589;320;1272;941;3135;1261;4407
350945;201606;924;2889;788;2638;112;482;437;1395;549;1877
350950;201606;70624;211556;56878;182876;12638;44861;24430;75024;37068;119885
350960;201606;4538;14984;3883;13630;707;2844;2153;7264;2860;10108
350970;201606;4252;14555;3574;12937;1207;4772;689;2245;1896;7017
350980;201606;566;1859;510;1771;218;797;178;630;396;1427
350990;201606;1745;5863;1426;5269;427;1710;410;1500;837;3210
350995;201606;745;2545;711;2479;103;467;462;1522;565;1989
351000;201606;2990;8893;2484;7945;372;1368;1148;3474;1520;4842
351010;201606;353;996;208;680;48;172;67;222;115;394
351015;201606;809;2734;679;2490;156;642;327;1176;483;1818
351020;201606;8037;24903;6911;23119;1676;5984;3224;10944;4900;16928
351030;201606;1751;6141;1524;5583;371;1539;502;1723;873;3262
351040;201606;3385;10085;3080;9570;413;1500;2105;6330;2518;7830
351050;201606;14381;40609;10243;33342;2566;9128;2893;9466;5459;18594
351060;201606;35305;102478;28752;90719;5957;20811;13827;42652;19784;63463
351070;201606;1474;4118;977;3202;306;1086;111;333;417;1419
351080;201606;2559;7366;1966;6614;486;1844;896;2886;1382;4730
351090;201606;356;1215;287;1071;68;287;52;197;120;484
351100;201606;2066;6289;1666;5457;490;1712;490;1649;980;3361
351110;201606;7144;17841;3991;12696;856;3119;919;2814;1775;5933
351120;201606;652;1882;515;1606;76;273;243;649;319;922
351130;201606;997;2751;531;1782;99;361;105;320;204;681
351140;201606;1662;5573;1363;4950;433;1700;321;1118;754;2818
351150;201606;1510;5224;1091;4151;231;956;160;532;391;1488
351160;201606;1241;4302;1091;3950;288;1119;369;1245;657;2364
351170;201606;1382;4378;1156;3890;203;764;531;1705;734;2469
351190;201606;783;2504;613;2064;109;405;181;589;290;994
351200;201606;1989;5862;1671;5274;259;931;667;1987;926;2918
351210;201606;1102;3199;802;2585;150;540;302;906;452;1446
351220;201606;3202;10674;2913;10083;521;2003;1463;4978;1984;6981
351230;201606;1711;5292;1435;4772;283;1108;723;2317;1006;3425
351240;201606;1051;3236;774;2642;213;766;236;748;449;1514
351250;201606;975;2823;619;2024;100;338;218;690;318;1028
351260;201606;917;2677;793;2424;187;602;315;931;502;1533
351270;201606;318;1084;277;999;73;313;105;331;178;644
351280;201606;4780;13883;3648;11565;765;2661;1346;4104;2111;6765
351290;201606;962;2733;706;2240;171;562;276;860;447;1422
351300;201606;12639;40706;9503;34027;2318;9136;2993;10645;5311;19781
351310;201606;3081;9302;2477;8213;497;1895;1148;3546;1645;5441
351320;201606;801;2646;681;2370;142;563;231;738;373;1301
351330;201606;261;725;213;651;84;258;46;138;130;396
351340;201606;5617;18647;4807;17037;1352;5090;1798;6431;3150;11521
351350;201606;7527;24024;6482;21875;1785;6306;2358;7661;4143;13967
351360;201606;4051;12550;3694;11869;961;3451;1276;3812;2237;7263
351370;201606;2231;6840;1759;5851;360;1355;711;2177;1071;3532
351380;201606;37399;108839;33570;101810;6717;22139;15029;44764;21746;66903
351385;201606;222;683;193;629;38;137;85;260;123;397
351390;201606;1151;3703;962;3313;286;1154;376;1162;662;2316
351400;201606;889;2937;847;2843;293;1074;345;1125;638;2199
351410;201606;2488;7439;2174;6881;340;1141;1305;4064;1645;5205
351420;201606;315;899;214;706;48;165;51;170;99;335
351430;201606;813;2556;759;2467;115;411;551;1770;666;2181
351440;201606;3372;10026;2557;8265;608;2070;403;1224;1011;3294
351450;201606;1623;4558;1311;4042;331;1076;515;1675;846;2751
351460;201606;707;2092;600;1902;309;994;142;457;451;1451
351470;201606;992;2967;877;2744;178;641;416;1259;594;1900
351480;201606;2687;8705;2470;8349;414;1775;1436;4656;1850;6431
351490;201606;1777;5821;1576;5391;194;826;942;3078;1136;3904
351492;201606;220;678;178;576;12;49;112;360;124;409
351495;201606;188;601;150;500;34;138;62;197;96;335
351500;201606;26118;73817;19794;62074;4894;16928;7789;23446;12683;40374
351510;201606;8721;26555;7108;23300;1693;6031;3352;10839;5045;16870
351512;201606;467;1342;353;1096;57;171;179;560;236;731
351515;201606;2218;6923;1592;5533;385;1469;419;1310;804;2779
351518;201606;2079;6412;1435;5213;365;1528;456;1507;821;3035
351519;201606;780;2282;566;1815;102;392;159;391;261;783
351520;201606;781;2085;390;1335;63;259;70;229;133;488
351530;201606;390;1197;262;868;43;145;62;168;105;313
351535;201606;2349;6029;1829;5265;154;548;1216;3369;1370;3917
351540;201606;1745;5228;1387;4553;466;1692;204;666;670;2358
351550;201606;5135;14951;3625;11718;711;2595;1369;4260;2080;6855
351560;201606;357;1151;314;1071;70;283;56;189;126;472
351565;201606;169;565;153;523;29;101;64;217;93;318
351570;201606;12083;36418;10064;32360;2124;7398;5486;17230;7610;24628
351580;201606;325;860;196;590;46;145;58;175;104;320
351590;201606;433;1119;285;836;28;96;129;359;157;455
351600;201606;1734;4793;1454;4308;201;691;831;2347;1032;3038
351610;201606;656;1787;499;1519;67;260;234;633;301;893
351620;201606;18412;58309;14256;49887;3146;12446;3845;12225;6991;24671
351630;201606;19658;61205;17670;58014;3849;13471;10149;33169;13998;46640
351640;201606;12303;36595;10058;32542;1750;6241;5818;18590;7568;24831
351650;201606;455;1351;225;753;39;146;40;122;79;268
351660;201606;781;2498;574;1957;131;490;110;333;241;823
351670;201606;3829;11902;3152;10419;572;2172;1466;4568;2038;6740
351680;201606;611;1885;391;1372;90;309;73;262;163;571
351685;201606;380;1161;334;1079;78;239;171;562;249;801
351690;201606;1103;3272;800;2613;140;506;292;874;432;1380
351700;201606;1131;3314;971;3004;250;782;371;1137;621;1919
351710;201606;556;1821;469;1631;82;295;180;607;262;902
351720;201606;1575;4790;1082;3605;208;743;325;1052;533;1795
351730;201606;1057;3009;855;2710;210;774;374;1186;584;1960
351740;201606;3949;10788;3151;9204;662;2072;1235;3489;1897;5561
351750;201606;1117;3558;750;2703;185;716;185;655;370;1371
351760;201606;3499;10828;2823;9361;759;2725;947;2968;1706;5693
351770;201606;2161;6759;1834;6170;469;1680;825;2695;1294;4375
351780;201606;1511;4208;886;2827;156;533;208;639;364;1172
351790;201606;1030;2993;900;2787;224;670;455;1458;679;2128
351800;201606;440;984;266;713;31;87;112;288;143;375
351810;201606;986;2813;854;2610;89;292;618;1871;707;2163
351820;201606;2442;7667;1829;6381;461;1727;201;665;662;2392
351830;201606;3914;12116;2961;10002;521;1999;1421;4633;1942;6632
351840;201606;6886;22736;5956;20897;1550;5956;2199;7526;3749;13482
351850;201606;1906;5202;1361;4246;190;747;672;1907;862;2654
351860;201606;3291;10436;2839;9504;726;2622;1195;3894;1921;6516
351870;201606;27885;82915;23354;74758;6624;22461;9918;31732;16542;54193
351880;201606;110835;345153;93756;310343;27751;98079;25487;81494;53238;179573
351885;201606;628;2162;569;2040;141;523;254;895;395;1418
351890;201606;622;1914;494;1665;128;481;84;248;212;729
351900;201606;1204;3677;1007;3357;288;1042;324;1074;612;2116
351905;201606;463;1442;374;1272;52;206;202;637;254;843
351907;201606;18020;52715;14840;46741;1715;6478;9349;28567;11064;35045
351910;201606;1014;3159;832;2752;182;648;337;1084;519;1732
351920;201606;983;2670;856;2489;134;449;515;1473;649;1922
351925;201606;884;2733;741;2449;148;546;327;1007;475;1553
351930;201606;2583;8294;2454;8052;434;1799;1719;5320;2153;7119
351940;201606;964;2913;805;2602;162;568;355;1122;517;1690
351950;201606;1460;4001;1034;3205;143;484;498;1536;641;2020
351960;201606;4291;12261;3135;10113;666;2373;1357;4380;2023;6753
351970;201606;5171;18432;4591;17296;1353;5519;1682;6183;3035;11702
351980;201606;876;2594;662;2131;144;512;219;624;363;1136
351990;201606;1513;4236;1200;3655;267;989;260;677;527;1666
352000;201606;2248;7179;2023;6721;421;1561;1021;3205;1442;4766
352010;201606;1662;5567;1456;5105;376;1431;302;1084;678;2515
352020;201606;1390;4285;1186;3920;308;1118;465;1488;773;2606
352030;201606;4834;14044;3989;12790;813;2816;2142;6907;2955;9723
352040;201606;1942;6275;1553;5435;359;1398;296;976;655;2374
352042;201606;3353;9310;2092;6554;413;1409;940;2892;1353;4301
352044;201606;1664;5137;1108;3937;215;851;206;679;421;1530
352050;201606;10164;30699;6968;23649;1678;6473;1416;4392;3094;10865
352060;201606;718;2156;581;1880;126;465;226;679;352;1144
352070;201606;793;2036;631;1767;147;457;217;601;364;1058
352080;201606;416;1182;294;949;57;191;109;336;166;527
352090;201606;1183;4050;983;3535;170;680;236;789;406;1469
352100;201606;2676;8120;2057;6977;507;1880;806;2625;1313;4505
352110;201606;483;1665;408;1515;119;467;156;540;275;1007
352115;201606;451;1430;390;1320;68;243;201;676;269;919
352120;201606;896;2810;738;2512;121;504;378;1211;499;1715
352130;201606;1768;5076;1184;3895;299;1054;273;848;572;1902
352140;201606;1736;4962;1043;3489;174;611;369;1198;543;1809
352150;201606;761;2312;598;2002;149;523;272;909;421;1432
352160;201606;988;2717;763;2309;181;586;253;693;434;1279
352170;201606;2688;8057;2404;7468;441;1506;1298;3835;1739;5341
352180;201606;3236;9258;2707;8217;710;2338;976;2844;1686;5182
352190;201606;1160;3444;923;2947;162;648;322;840;484;1488
352200;201606;357;1227;279;1061;45;183;118;442;163;625
352210;201606;16087;43306;13097;38963;2307;7356;7839;23729;10146;31085
352215;201606;553;1708;503;1631;75;297;307;968;382;1265
352220;201606;12275;39018;10133;34634;3389;12440;2653;9124;6042;21564
352230;201606;12175;40612;10505;37482;2956;11668;3837;13300;6793;24968
352240;201606;12086;34761;9401;30096;2723;9885;2974;8686;5697;18571
352250;201606;22019;70338;19111;64430;5840;20999;6253;21182;12093;42181
352260;201606;5182;14703;3374;10937;654;2385;1198;3616;1852;6001
352265;201606;864;2716;735;2493;55;253;488;1594;543;1847
352270;201606;1714;5839;1437;5237;404;1563;373;1340;777;2903
352280;201606;2162;6487;1782;5830;402;1488;707;2218;1109;3706
352290;201606;1110;3511;934;3120;198;789;371;1137;569;1926
352300;201606;946;2746;746;2367;184;659;315;921;499;1580
352310;201606;41385;121801;33508;108183;8230;27985;16878;54964;25108;82949
352320;201606;5414;16585;4644;15117;1263;4443;1516;4530;2779;8973
352330;201606;1942;6139;1640;5714;532;2007;499;1713;1031;3720
352340;201606;5215;16512;3991;14120;1134;4412;800;2660;1934;7072
352350;201606;1644;5546;1471;5171;311;1244;547;1834;858;3078
352360;201606;1053;3195;918;2940;178;684;583;1757;761;2441
352370;201606;837;2838;753;2647;132;540;395;1347;527;1887
352380;201606;972;3069;830;2803;249;964;208;679;457;1643
352390;201606;18306;48764;12155;37233;2153;7565;5736;16504;7889;24069
352400;201606;3735;10576;2461;8090;722;2528;632;1938;1354;4466
352410;201606;2855;8613;2423;7906;560;1970;996;3163;1556;5133
352420;201606;872;2458;732;2180;152;501;325;937;477;1438
352430;201606;6259;18604;5211;16924;1633;5795;1800;5848;3433;11643
352440;201606;15073;45492;12195;39937;2914;10238;4631;14934;7545;25172
352450;201606;657;2001;444;1543;102;396;119;382;221;778
352460;201606;2306;7410;1912;6630;553;2160;545;1737;1098;3897
352470;201606;3930;10807;2608;8347;417;1487;981;2906;1398;4393
352480;201606;4307;11736;3308;9890;711;2457;1220;3304;1931;5761
352490;201606;653;2257;522;1923;107;431;123;432;230;863
352500;201606;8484;24333;7350;22636;3673;12182;1946;5374;5619;17556
352510;201606;2871;8983;2270;7852;709;2708;585;1975;1294;4683
352520;201606;1976;6922;1747;6362;454;1796;728;2613;1182;4409
352530;201606;8246;26094;6179;21400;1679;6260;922;2817;2601;9077
352540;201606;470;1452;338;1136;49;182;98;311;147;493
352550;201606;863;2845;611;2251;142;610;117;390;259;1000
352560;201606;628;1870;447;1464;81;266;114;336;195;602
352570;201606;1777;5815;1338;4812;355;1484;226;691;581;2175
352580;201606;847;2491;723;2286;148;514;369;1155;517;1669
352585;201606;221;705;184;636;58;223;51;174;109;397
352590;201606;12181;37110;9763;32405;2922;10398;3801;11925;6723;22323
352600;201606;1574;4809;1379;4453;312;1109;617;1903;929;3012
352610;201606;3265;9949;2678;8949;796;2955;797;2559;1593;5514
352620;201606;5172;15752;4673;14987;1010;3486;2517;7935;3527;11421
352630;201606;621;1946;584;1857;140;521;244;720;384;1241
352640;201606;2653;8078;2202;7189;277;1039;1270;4055;1547;5094
352650;201606;807;2392;597;1936;116;399;174;543;290;942
352660;201606;1022;3452;819;2998;173;719;211;772;384;1491
352670;201606;10711;31787;6579;22713;1675;6349;623;2086;2298;8435
352680;201606;2826;9420;2165;7911;512;2089;678;2263;1190;4352
352690;201606;30508;83738;21770;66427;3395;11592;10778;31607;14173;43199
352700;201606;592;1771;496;1623;148;540;218;687;366;1227
352710;201606;5245;15066;3897;12349;968;3446;1379;4161;2347;7607
352720;201606;7510;24144;6682;22314;2062;7012;2106;7033;4168;14045
352725;201606;405;1151;237;784;29;118;95;300;124;418
352730;201606;2142;7094;1936;6567;447;1668;704;2135;1151;3803
352740;201606;2083;5661;1660;4985;237;861;959;2739;1196;3600
352750;201606;481;1394;250;868;32;122;51;163;83;285
352760;201606;1179;4012;974;3498;299;1142;288;976;587;2118
352770;201606;768;2396;660;2179;162;576;277;885;439;1461
352780;201606;597;1984;474;1697;101;387;148;512;249;899
352790;201606;624;1785;448;1464;79;280;121;397;200;677
352800;201606;973;3415;713;2736;158;674;212;734;370;1408
352810;201606;1174;3051;773;2267;154;483;240;669;394;1152
352820;201606;637;1729;457;1435;106;367;108;342;214;709
352830;201606;519;1479;316;1018;62;227;44;110;106;337
352840;201606;3650;12308;3246;11446;968;3576;1224;4248;2192;7824
352850;201606;9020;26501;6972;23107;1909;6739;2462;8140;4371;14879
352860;201606;782;2602;718;2468;169;644;276;905;445;1549
352870;201606;937;2355;643;1750;71;259;350;839;421;1098
352880;201606;2265;6321;1663;5150;303;952;584;1711;887;2663
352885;201606;221;748;208;717;24;84;142;487;166;571
352890;201606;666;1750;467;1353;67;235;204;519;271;754
352900;201606;19521;56481;14218;45861;2998;10660;5134;15930;8132;26590
352910;201606;359;1035;207;690;27;97;35;109;62;206
352920;201606;2388;7166;1823;5984;365;1352;773;2359;1138;3711
352930;201606;5602;17275;4397;14656;1060;3777;1202;3876;2262;7653
352940;201606;21731;69537;17974;61042;6205;22718;2272;7152;8477;29870
352950;201606;325;951;209;740;48;200;38;119;86;319
352960;201606;600;1789;363;1250;62;235;74;233;136;468
352965;201606;367;1027;228;718;53;170;35;100;88;270
352970;201606;3151;7877;2545;6986;294;864;1718;4737;2012;5601
352980;201606;1078;3337;906;3051;187;627;533;1892;720;2519
352990;201606;3961;12338;3476;11505;914;3420;1502;4773;2416;8193
353000;201606;441;1243;244;790;33;123;40;124;73;247
353010;201606;2962;8195;2164;6654;543;1927;636;1734;1179;3661
353020;201606;4085;11077;2549;7778;388;1332;909;2526;1297;3858
353030;201606;3722;10958;3005;9608;912;3167;637;1987;1549;5154
353040;201606;528;1450;445;1324;117;385;141;400;258;785
353050;201606;4726;15668;3941;14026;1114;4272;1437;4968;2551;9240
353060;201606;37727;111004;33170;103615;3456;13118;23784;72027;27240;85145
353070;201606;10315;31688;7377;25456;1826;6765;1877;6552;3703;13317
353080;201606;5069;15893;3532;12544;829;3285;817;2707;1646;5992
353090;201606;516;1736;460;1615;49;207;275;901;324;1108
353100;201606;279;779;133;443;21;71;24;70;45;141
353110;201606;7368;22416;6319;20719;1319;4671;3648;12071;4967;16742
353120;201606;661;1954;425;1410;93;348;110;316;203;664
353130;201606;2451;7043;1966;6296;640;2223;633;1985;1273;4208
353140;201606;2225;6048;1711;5065;404;1299;703;1985;1107;3284
353150;201606;1613;4839;1299;4292;347;1181;379;1274;726;2455
353160;201606;655;1836;418;1342;99;331;65;166;164;497
353170;201606;410;1328;373;1270;103;449;178;555;281;1004
353180;201606;8212;23132;6559;20245;1121;3816;3589;10854;4710;14670
353190;201606;3629;10922;2989;9551;516;1857;1560;4699;2076;6556
353200;201606;950;3137;750;2662;232;924;199;652;431;1576
353205;201606;361;1179;318;1097;73;262;138;481;211;743
353210;201606;975;2467;692;1968;51;193;455;1258;506;1451
353215;201606;378;1175;323;1055;55;203;103;300;158;503
353220;201606;640;1983;522;1733;130;456;125;392;255;848
353230;201606;783;2527;712;2399;198;743;203;644;401;1387
353240;201606;1993;6399;1760;5940;361;1381;937;3070;1298;4451
353250;201606;1059;2850;800;2380;117;379;398;1132;515;1511
353260;201606;869;2392;627;1951;110;412;231;679;341;1091
353270;201606;630;1826;548;1673;128;423;208;617;336;1040
353280;201606;583;1876;478;1644;131;498;114;380;245;878
353282;201606;1715;5414;1562;5111;263;981;869;2706;1132;3687
353284;201606;348;936;199;620;37;117;47;143;84;260
353286;201606;140;422;101;339;17;60;22;74;39;134
353290;201606;675;2068;543;1830;84;350;303;966;387;1316
353300;201606;1385;4310;1158;3832;274;1029;434;1315;708;2344
353310;201606;179;554;151;502;47;170;55;177;102;347
353320;201606;522;1495;456;1386;78;253;258;763;336;1016
353325;201606;577;1895;479;1698;95;354;109;373;204;727
353330;201606;602;1734;411;1293;67;240;190;561;257;801
353340;201606;2666;7630;1790;5978;513;1796;490;1660;1003;3456
353350;201606;3130;9367;2517;8174;779;2682;798;2491;1577;5173
353360;201606;423;1366;379;1273;46;176;257;848;303;1024
353370;201606;623;2050;544;1869;77;317;296;980;373;1297
353380;201606;321;1070;266;953;58;248;90;299;148;547
353390;201606;5576;15156;3955;12288;826;2759;1403;4213;2229;6972
353400;201606;468;1427;402;1300;96;341;89;249;185;590
353410;201606;611;1770;510;1598;94;332;280;873;374;1205
353420;201606;588;1645;397;1212;105;312;113;334;218;646
353430;201606;2203;7399;1595;5882;422;1635;258;934;680;2569
353440;201606;57130;179668;46520;156059;12577;44482;16782;55126;29359;99608
353450;201606;410;1208;336;1057;79;288;124;367;203;655
353460;201606;3257;9155;2614;7956;336;1184;1315;4049;1651;5233
353470;201606;7933;23768;5810;19481;1391;5209;1320;4181;2711;9390
353475;201606;1561;4371;1101;3374;203;687;332;920;535;1607
353480;201606;1374;4143;1223;3845;191;656;749;2288;940;2944
353490;201606;944;2717;740;2315;153;506;287;861;440;1367
353500;201606;964;2572;796;2304;228;662;385;1098;613;1760
353510;201606;974;3089;723;2463;189;681;147;461;336;1142
353520;201606;1090;3110;855;2724;154;560;375;1149;529;1709
353530;201606;2490;7285;2164;6699;349;1275;1183;3520;1532;4795
353540;201606;1852;5642;1591;5192;423;1472;685;2203;1108;3675
353550;201606;6061;16656;5005;14965;568;2092;3168;9037;3736;11129
353560;201606;1972;6524;1627;5899;466;1883;433;1469;899;3352
353570;201606;435;1341;351;1163;69;247;192;593;261;840
353580;201606;2283;6802;2007;6334;318;1156;1325;4160;1643;5316
353590;201606;715;2069;524;1676;125;437;173;567;298;1004
353600;201606;1693;4681;1511;4379;234;778;789;2229;1023;3007
353610;201606;534;1791;401;1506;85;376;73;243;158;619
353620;201606;2123;6827;1792;6154;469;1723;549;1789;1018;3512
353625;201606;347;967;214;710;37;141;72;241;109;382
353630;201606;1471;5120;1184;4391;264;1070;144;469;408;1539
353640;201606;1291;3842;1002;3207;137;496;501;1569;638;2065
353650;201606;7596;22237;5627;18081;1106;3774;2028;6325;3134;10099
353657;201606;298;929;256;842;44;164;89;274;133;438
353660;201606;1067;2777;795;2312;319;1012;118;259;437;1271
353670;201606;3473;11179;2957;10080;962;3682;995;3123;1957;6805
353680;201606;686;2194;576;2003;186;727;218;726;404;1453
353690;201606;505;1349;282;918;53;182;57;151;110;333
353700;201606;1921;5869;1648;5335;282;1021;780;2411;1062;3432
353710;201606;2968;7159;1451;4703;330;1112;254;830;584;1942
353715;201606;495;1434;363;1159;42;156;93;280;135;436
353720;201606;1962;6065;1676;5623;323;1277;872;2793;1195;4070
353730;201606;4295;12891;3386;11022;723;2598;1133;3421;1856;6019
353740;201606;1790;5328;1379;4524;407;1429;345;1095;752;2524
353750;201606;834;2788;637;2324;142;567;157;587;299;1154
353760;201606;9745;26674;7895;24067;1197;4173;4923;14766;6120;18939
353770;201606;739;2304;460;1619;84;321;24;54;108;375
353780;201606;4051;14032;3532;12970;1148;4437;1104;4117;2252;8554
353790;201606;2090;7085;1730;6352;470;1982;407;1464;877;3446
353800;201606;15813;48078;12594;42295;3208;11822;4721;15654;7929;27476
353810;201606;1011;3221;777;2708;171;668;244;838;415;1506
353820;201606;1328;4415;1190;4088;219;885;629;2029;848;2914
353830;201606;663;1773;523;1550;94;304;276;798;370;1102
353850;201606;1652;5156;1446;4744;361;1231;587;1906;948;3137
353860;201606;2434;8051;2057;7189;557;2096;562;1923;1119;4019
353870;201606;28583;81892;19738;64512;4014;14554;6366;19133;10380;33687
353880;201606;2612;8190;2205;7474;329;1323;1188;3986;1517;5309
353890;201606;2619;6428;1825;5139;322;1017;876;2344;1198;3361
353900;201606;967;2965;712;2458;154;582;198;647;352;1229
353910;201606;1133;3986;1062;3846;267;1005;598;2186;865;3191
353920;201606;2210;6482;1541;5069;336;1223;268;784;604;2007
353930;201606;4422;13275;3101;10855;830;3185;606;2104;1436;5289
353940;201606;1157;3657;901;3065;163;628;287;911;450;1539
353950;201606;3205;10167;2847;9471;510;1913;1566;4990;2076;6903
353960;201606;598;1869;444;1526;106;391;95;294;201;685
353970;201606;523;1495;438;1371;55;190;270;846;325;1036
353980;201606;12667;37765;10804;34207;2299;7828;5356;16516;7655;24344
353990;201606;345;1076;311;1005;53;211;163;493;216;704
354000;201606;2159;6044;1422;4545;301;1040;151;477;452;1517
354010;201606;358;1086;298;986;62;211;173;581;235;792
354020;201606;4175;13092;3622;11875;967;3394;1180;3634;2147;7028
354025;201606;865;2418;633;1990;133;445;226;700;359;1145
354030;201606;456;1272;318;1017;59;204;134;412;193;616
354040;201606;758;2075;523;1623;54;187;271;778;325;965
354050;201606;922;2927;744;2557;216;818;169;565;385;1383
354060;201606;4827;14898;3377;11629;909;3328;885;2913;1794;6241
354070;201606;2709;9021;2300;8074;606;2291;479;1631;1085;3922
354075;201606;1862;6830;1716;6482;446;1892;785;2901;1231;4793
354080;201606;1510;4619;1071;3652;228;836;252;778;480;1614
354085;201606;323;819;289;769;13;51;241;631;254;682
354090;201606;1307;3853;1248;3754;130;446;873;2630;1003;3076
354100;201606;14340;47544;11777;42738;3034;11829;4965;17929;7999;29758
354105;201606;857;2548;749;2384;117;414;504;1588;621;2002
354110;201606;717;1939;555;1721;226;788;99;248;325;1036
354120;201606;1857;5100;1400;4236;264;892;597;1708;861;2600
354130;201606;6124;17583;4623;14689;1788;6017;529;1521;2317;7538
354140;201606;25970;65043;16040;47271;3336;10550;4896;13535;8232;24085
354150;201606;3802;10252;2886;8570;513;1692;1371;3937;1884;5629
354160;201606;3318;10722;2735;9389;717;2637;1017;3413;1734;6050
354165;201606;469;1611;399;1463;114;454;144;533;258;987
354170;201606;1302;4039;1048;3474;211;782;404;1230;615;2012
354180;201606;456;1354;396;1233;58;221;217;601;275;822
354190;201606;1549;4897;1293;4369;325;1214;441;1422;766;2636
354200;201606;977;2746;780;2407;103;370;352;1003;455;1373
354210;201606;597;1875;501;1698;78;324;268;846;346;1170
354220;201606;2846;8257;2412;7477;520;1762;1131;3441;1651;5203
354230;201606;603;1960;541;1834;103;404;236;776;339;1180
354240;201606;1207;3938;905;3232;180;713;196;680;376;1393
354250;201606;662;1875;440;1481;143;520;116;414;259;934
354260;201606;6752;20407;5687;18559;1604;5536;1884;6293;3488;11829
354270;201606;1135;3806;940;3355;207;810;316;1114;523;1924
354280;201606;669;2006;611;1909;84;348;417;1210;501;1558
354290;201606;889;3086;797;2884;185;727;351;1292;536;2019
354300;201606;3505;11518;3314;11148;886;3124;1671;5552;2557;8676
354310;201606;835;2543;662;2198;125;426;340;1143;465;1569
354320;201606;687;2063;572;1842;153;573;185;550;338;1123
354323;201606;440;1211;328;1009;69;238;116;319;185;557
354325;201606;1201;3950;937;3309;194;768;348;1150;542;1918
354330;201606;6399;19059;5138;16599;1079;3963;2353;7160;3432;11123
354340;201606;23439;71354;18947;63449;5407;19797;7185;23527;12592;43324
354350;201606;1014;3004;934;2855;252;866;491;1406;743;2272
354360;201606;440;1402;267;970;49;178;13;49;62;227
354370;201606;1127;3760;972;3460;115;516;566;1961;681;2477
354380;201606;815;2428;650;2129;200;784;118;327;318;1111
354390;201606;12804;37353;8824;29574;1953;7116;1784;5899;3737;13015
354400;201606;1529;5294;1252;4607;292;1156;365;1323;657;2479
354410;201606;5241;16073;4354;14391;1095;3894;1812;5936;2907;9830
354420;201606;1139;3414;844;2753;219;790;324;1023;543;1813
354425;201606;2307;6604;1949;5946;621;2005;474;1477;1095;3482
354430;201606;1304;4210;1190;3980;271;1060;493;1599;764;2659
354440;201606;523;1579;383;1260;52;188;156;489;208;677
354450;201606;403;1152;238;800;38;152;41;113;79;265
354460;201606;896;2472;630;1981;159;542;248;782;407;1324
354470;201606;558;1514;435;1265;43;162;222;591;265;753
354480;201606;693;1911;584;1745;88;313;349;1003;437;1316
354490;201606;690;2307;541;1948;81;323;226;780;307;1103
354500;201606;2108;6797;1853;6355;710;2715;379;1308;1089;4023
354510;201606;742;2088;670;1968;91;250;447;1348;538;1598
354515;201606;260;872;204;747;45;192;71;248;116;440
354520;201606;7421;23931;4230;14650;851;3391;1653;5330;2504;8721
354530;201606;2981;10187;2642;9441;676;2648;1139;4027;1815;6675
354540;201606;1182;3558;966;3173;364;1298;164;504;528;1802
354550;201606;454;1348;372;1186;76;265;170;519;246;784
354560;201606;1604;4473;1008;3151;158;511;431;1276;589;1787
354570;201606;979;2750;521;1668;84;304;81;235;165;539
354580;201606;10548;29479;7539;23969;1398;4893;2907;8790;4305;13683
354600;201606;1552;5038;1345;4633;270;1115;683;2231;953;3346
354610;201606;387;1115;230;738;30;96;65;198;95;294
354620;201606;377;1209;298;1075;69;309;147;513;216;822
354625;201606;277;873;194;688;38;149;54;174;92;323
354630;201606;2044;6781;1805;6272;757;2791;298;988;1055;3779
354640;201606;3342;10885;2633;9311;607;2440;539;1753;1146;4193
354650;201606;840;2489;730;2272;89;313;481;1493;570;1806
354660;201606;2303;6500;1715;5471;213;799;989;3112;1202;3911
354670;201606;1300;4111;1002;3395;276;1026;223;672;499;1698
354680;201606;4319;14027;3914;13239;1044;3799;1728;5793;2772;9592
354690;201606;749;2402;499;1783;96;362;118;411;214;773
354700;201606;1131;3188;793;2474;152;570;339;912;491;1482
354710;201606;505;1510;394;1264;47;175;166;470;213;645
354720;201606;226;598;131;411;43;143;29;87;72;230
354730;201606;7935;25572;6092;21773;1362;5332;2596;9001;3958;14333
354740;201606;236;733;140;507;21;88;19;70;40;158
354750;201606;2296;7012;1790;6063;478;1819;648;2095;1126;3914
354760;201606;1869;5913;1527;5182;507;1857;233;772;740;2629
354765;201606;285;786;141;467;20;74;20;59;40;133
354770;201606;2276;6310;1735;5390;587;1981;519;1558;1106;3539
354780;201606;50614;140819;42725;124611;6928;22968;23792;65844;30720;88812
354790;201606;777;2553;697;2385;131;478;363;1207;494;1685
354800;201606;2081;6071;1828;5733;392;1403;960;2933;1352;4336
354805;201606;980;2944;713;2358;94;348;157;472;251;820
354810;201606;573;1848;365;1341;70;317;59;177;129;494
354820;201606;943;3218;805;2906;194;813;218;722;412;1535
354830;201606;396;1096;306;935;84;280;123;346;207;626
354840;201606;613;1725;486;1502;107;356;243;741;350;1097
354850;201606;16301;49649;12071;41167;2611;10054;5042;16028;7653;26082
354860;201606;1343;4188;1144;3850;258;1012;445;1399;703;2411
354870;201606;43922;128906;38845;118541;8773;29021;17780;53320;26553;82341
354880;201606;4213;11554;2365;7655;378;1460;721;1952;1099;3412
354890;201606;15921;45992;13212;41168;2920;9921;5450;16558;8370;26479
354900;201606;416;1284;321;1081;60;211;86;282;146;493
354910;201606;6252;18634;3663;13003;692;2758;198;692;890;3450
354920;201606;404;1189;269;928;58;229;64;217;122;446
354925;201606;308;919;190;653;34;132;26;76;60;208
354930;201606;305;760;167;525;26;86;72;221;98;307
354940;201606;1860;6590;1541;5752;551;2223;183;648;734;2871
354950;201606;1435;4536;1228;4199;170;729;694;2308;864;3037
354960;201606;752;2335;655;2179;138;521;297;970;435;1491
354970;201606;3783;12309;3318;11353;600;2384;1811;5992;2411;8376
354980;201606;33281;82889;20481;61763;3648;12525;6970;19552;10618;32077
354990;201606;50841;147301;40145;126372;7104;24527;19886;60901;26990;85428
354995;201606;1692;5134;1420;4691;348;1201;736;2438;1084;3639
355000;201606;1381;4417;1222;4127;386;1531;253;741;639;2272
355010;201606;3492;10712;2700;8907;789;2767;863;2903;1652;5670
355020;201606;2833;9340;2167;7968;831;3349;513;1819;1344;5168
355030;201606;1078344;2936688;907429;2608132;199825;629774;410142;1137538;609967;1767312
355040;201606;2512;7662;2211;7136;460;1628;1287;4085;1747;5713
355050;201606;1111;3356;884;2927;304;1037;154;499;458;1536
355060;201606;4272;14132;3459;12430;814;3309;1052;3482;1866;6791
355070;201606;6355;19608;5601;18365;1222;4565;2775;8574;3997;13139
355080;201606;952;3255;680;2627;149;667;43;151;192;818
355090;201606;1093;3700;923;3330;176;684;364;1314;540;1998
355100;201606;17263;53263;14379;48471;3840;14310;6756;22294;10596;36604
355110;201606;1167;3769;1000;3459;322;1215;231;780;553;1995
355120;201606;618;1946;509;1737;111;448;198;656;309;1104
355130;201606;617;1576;296;880;48;147;96;260;144;407
355140;201606;1107;3661;1051;3562;221;841;589;2043;810;2884
355150;201606;3345;9615;2791;8726;583;1917;1426;4519;2009;6436
355160;201606;1626;5057;1349;4593;403;1512;388;1304;791;2816
355170;201606;8245;22983;6246;19669;2023;6755;1634;5382;3657;12137
355180;201606;2782;8606;2276;7676;587;2339;754;2336;1341;4675
355190;201606;1258;4198;1069;3821;359;1356;377;1344;736;2700
355200;201606;748;2643;683;2501;291;1159;161;549;452;1708
355210;201606;2633;8280;2311;7614;388;1491;1304;4124;1692;5615
355220;201606;32987;99342;26926;87228;8978;30784;6975;21645;15953;52429
355230;201606;1379;3762;778;2460;159;513;183;515;342;1028
355240;201606;25108;71456;17601;56282;3908;13286;5717;18022;9625;31308
355250;201606;27155;85394;23022;77402;6431;23245;8828;29256;15259;52501
355255;201606;860;2385;541;1729;106;373;151;459;257;832
355260;201606;1214;3536;1032;3226;246;886;441;1263;687;2149
355270;201606;1560;4547;1423;4322;147;478;1044;3137;1191;3615
355280;201606;25183;73022;20249;63511;3970;13975;9051;27271;13021;41246
355290;201606;908;2874;726;2437;157;562;238;743;395;1305
355300;201606;1189;3844;997;3446;213;802;344;1153;557;1955
355310;201606;989;3002;822;2680;148;540;428;1398;576;1938
355320;201606;575;1750;494;1584;102;393;197;550;299;943
355330;201606;1872;5735;1359;4710;292;1104;557;1896;849;3000
355340;201606;2477;6431;2215;6008;347;973;1393;3736;1740;4709
355350;201606;1302;4357;1046;3780;273;1097;294;1010;567;2107
355360;201606;1112;3511;987;3259;150;521;646;2202;796;2723
355365;201606;308;895;205;719;58;217;48;166;106;383
355370;201606;7536;18477;5488;15935;1441;4507;2310;7176;3751;11683
355380;201606;3191;9534;2499;8027;568;2026;574;1604;1142;3630
355385;201606;843;2701;764;2542;241;891;254;783;495;1674
355390;201606;835;2392;624;1958;124;435;234;639;358;1074
355395;201606;1882;5634;1363;4438;200;661;592;1829;792;2490
355400;201606;8785;28772;7598;26300;2327;8725;2257;7617;4584;16342
355410;201606;16362;52710;13080;46136;4078;15703;2649;9639;6727;25342
355420;201606;718;2532;654;2403;202;839;185;676;387;1515
355430;201606;3440;9573;2840;8543;548;1770;1438;4228;1986;5998
355440;201606;912;2785;673;2252;132;468;206;632;338;1100
355450;201606;3720;10635;2157;7136;402;1418;647;1999;1049;3417
355460;201606;590;1590;390;1227;80;302;117;302;197;604
355465;201606;339;1098;289;1001;61;230;76;264;137;494
355470;201606;756;2335;619;2068;139;505;281;913;420;1418
355475;201606;156;532;147;506;35;126;73;239;108;365
355480;201606;2729;9446;2482;8950;584;2284;1203;4278;1787;6562
355490;201606;967;2757;622;2027;111;380;159;495;270;875
355495;201606;708;2353;618;2150;141;539;191;641;332;1180
355500;201606;7328;21157;4868;15870;919;3275;857;2657;1776;5932
355510;201606;1974;5292;1119;3565;181;688;331;944;512;1632
355520;201606;423;983;214;586;34;117;95;222;129;339
355530;201606;423;1002;178;549;25;86;35;92;60;178
355535;201606;661;2033;526;1781;153;586;131;388;284;974
355540;201606;7988;25038;7517;24286;1866;6454;4061;12850;5927;19304
355550;201606;702;2139;595;1956;127;489;268;864;395;1353
355560;201606;1215;3618;777;2640;173;669;69;185;242;854
355570;201606;187;581;124;439;22;87;11;35;33;122
355580;201606;1243;3472;853;2674;160;569;321;1012;481;1581
355590;201606;225;588;177;504;24;79;97;267;121;346
355600;201606;1140;3451;950;3061;308;1091;297;897;605;1988
355610;201606;1562;4326;1202;3650;208;679;550;1626;758;2305
355620;201606;3951;12296;3194;10629;551;2142;1485;4607;2036;6749
355630;201606;3238;9203;2062;6851;415;1475;567;1909;982;3384
355635;201606;886;2903;767;2708;79;326;528;1891;607;2217
355640;201606;2904;9197;2125;7612;423;1707;260;909;683;2616
355645;201606;3370;11321;2996;10729;491;2020;1796;6397;2287;8417
355650;201606;7069;21130;6037;19229;1092;4075;3535;10539;4627;14614
355660;201606;1230;3876;986;3380;196;804;416;1343;612;2147
355670;201606;2738;8336;1964;6618;360;1378;806;2448;1166;3826
355680;201606;1657;5446;1219;4393;352;1370;196;695;548;2065
355690;201606;450;1412;338;1215;186;710;28;85;214;795
355695;201606;278;872;158;545;11;41;8;16;19;57
355700;201606;5217;17109;4443;15369;1121;4069;1761;5991;2882;10060
355710;201606;10026;24893;6000;17531;1363;4284;1553;4376;2916;8660
355715;201606;300;891;198;667;54;199;31;90;85;289
355720;201606;1521;5026;1247;4398;316;1214;389;1257;705;2471
355730;201606;801;2614;673;2325;213;752;180;615;393;1367
410010;201606;1365;4238;1175;3826;284;1019;247;800;531;1819
410020;201606;1132;3669;974;3306;239;851;406;1366;645;2217
410030;201606;1111;3754;925;3297;253;969;171;606;424;1575
410040;201606;9376;30603;8182;28300;2164;8369;2521;8710;4685;17079
410045;201606;1014;2859;721;2305;188;643;170;517;358;1160
410050;201606;2577;7094;1650;5283;451;1557;138;364;589;1921
410060;201606;2260;6842;1976;6289;383;1276;929;3027;1312;4303
410070;201606;1692;4768;1294;3989;412;1385;303;906;715;2291
410080;201606;1355;3847;1065;3312;193;695;472;1380;665;2075
410090;201606;980;3038;905;2881;204;718;369;1211;573;1929
410100;201606;2709;8224;2049;6696;471;1758;245;744;716;2502
410105;201606;369;1159;251;869;46;190;33;103;79;293
410110;201606;2781;8050;2225;6987;371;1294;716;2253;1087;3547
410115;201606;513;1383;397;1176;67;224;133;350;200;574
410120;201606;2406;8288;2241;7985;771;2924;764;2768;1535;5692
410130;201606;1037;3252;967;3076;388;1283;260;801;648;2084
410140;201606;16660;43547;11272;33976;2453;8131;2963;8699;5416;16830
410150;201606;15852;39946;8379;25029;1682;5440;1336;3677;3018;9117
410160;201606;2978;9143;2676;8613;714;2615;960;3136;1674;5751
410165;201606;705;2047;556;1701;127;424;239;674;366;1098
410170;201606;2254;6457;1705;5251;486;1639;285;876;771;2515
410180;201606;10692;33644;9178;30322;2130;7691;3787;11740;5917;19431
410185;201606;538;1498;396;1220;90;284;85;235;175;519
410190;201606;2040;5987;1611;5026;342;1181;279;807;621;1988
410200;201606;3760;10487;2741;8508;598;2141;380;1139;978;3280
410210;201606;2574;7554;1877;6030;356;1351;401;1067;757;2418
410220;201606;646;1786;470;1461;82;299;146;454;228;753
410230;201606;1383;4344;1187;3945;273;1026;462;1523;735;2549
410240;201606;4269;12866;3858;12011;1297;4645;700;2095;1997;6740
410250;201606;2636;7230;1831;5573;449;1515;339;993;788;2508
410260;201606;1536;4494;1253;4007;290;1013;526;1686;816;2699
410270;201606;546;1531;410;1255;70;244;171;500;241;744
410275;201606;844;2536;558;1888;86;308;251;858;337;1166
410280;201606;2216;6392;1634;5245;365;1335;456;1385;821;2720
410290;201606;3357;9943;2802;8882;612;2051;1171;3795;1783;5846
410300;201606;706;1971;591;1735;94;320;268;699;362;1019
410302;201606;408;1103;265;844;31;107;132;433;163;540
410304;201606;1222;3851;1101;3597;284;979;449;1498;733;2477
410305;201606;1845;5029;1505;4447;257;838;861;2555;1118;3393
410310;201606;2274;7218;2036;6797;473;1755;771;2611;1244;4366
410315;201606;656;1885;409;1393;77;293;122;393;199;686
410320;201606;1201;3640;774;2640;120;480;68;213;188;693
410322;201606;523;1526;325;1085;53;174;83;278;136;452
410330;201606;1364;3727;1100;3224;254;788;295;861;549;1649
410335;201606;947;2794;815;2543;141;507;341;992;482;1499
410337;201606;802;2113;590;1727;89;312;199;530;288;842
410340;201606;517;1522;358;1110;49;176;140;379;189;555
410345;201606;1800;5239;1263;4067;303;1026;334;1072;637;2098
410347;201606;704;1896;492;1483;63;227;153;435;216;662
410350;201606;1034;3092;760;2534;154;590;162;486;316;1076
410360;201606;3679;10065;2895;8674;410;1414;1440;4205;1850;5619
410370;201606;11808;34437;8670;27086;1612;5649;2497;6920;4109;12569
410380;201606;1296;3773;1169;3514;148;550;585;1717;733;2267
410390;201606;2459;7346;1987;6342;625;2149;477;1381;1102;3530
410395;201606;853;2811;753;2595;194;750;343;1193;537;1943
410400;201606;4448;13625;3757;12290;815;2980;1418;4505;2233;7485
410405;201606;840;2443;679;2144;160;574;241;742;401;1316
410410;201606;1267;3904;1220;3838;334;1273;574;1705;908;2978
410420;201606;6797;21918;5563;19133;1514;5748;762;2309;2276;8057
410425;201606;2714;8573;1928;6801;394;1515;199;675;593;2190
410430;201606;14147;37873;10204;30594;2062;6849;2878;8334;4940;15183
410440;201606;2737;8708;2437;8120;638;2352;996;3247;1634;5599
410442;201606;2640;8774;2319;8054;703;2551;695;2449;1398;5000
410445;201606;2304;7538;1978;6945;540;2140;653;2397;1193;4537
410450;201606;2056;5831;1597;4922;475;1560;191;513;666;2073
410460;201606;1857;5448;1452;4660;404;1351;298;931;702;2282
410465;201606;2047;6714;1721;5998;389;1470;640;2140;1029;3610
410470;201606;1695;5461;1368;4722;314;1260;308;1062;622;2322
410480;201606;29670;83351;18820;60533;3698;12980;1946;5487;5644;18467
410490;201606;10876;33545;8427;28404;2037;7728;2342;7340;4379;15068
410500;201606;1523;4788;1228;4114;439;1649;257;816;696;2465
410510;201606;2473;6458;1730;5005;340;1036;609;1629;949;2665
410520;201606;3057;10502;2869;10125;858;3189;1217;4377;2075;7566
410530;201606;1549;4247;1089;3285;215;713;283;806;498;1519
410540;201606;3059;9006;2145;7047;453;1579;629;2065;1082;3644
410550;201606;6024;17406;4200;13429;866;3088;553;1633;1419;4721
410560;201606;1238;3648;956;3078;255;941;258;739;513;1680
410570;201606;2608;8209;2335;7750;640;2272;767;2855;1407;5127
410580;201606;21045;63124;17164;55448;4352;15669;5014;15336;9366;31005
410590;201606;1359;4176;863;2856;146;526;181;524;327;1050
410600;201606;1826;5297;1455;4567;370;1174;545;1744;915;2918
410610;201606;765;2144;600;1828;84;268;220;657;304;925
410620;201606;1690;5695;1250;4610;329;1291;127;477;456;1768
410630;201606;2455;7207;1717;5563;415;1494;230;638;645;2132
410640;201606;4499;12352;3330;10132;906;3219;549;1589;1455;4808
410645;201606;1104;3823;1032;3704;502;1874;235;906;737;2780
410650;201606;2090;6428;1681;5565;568;2002;263;824;831;2826
410655;201606;845;2375;627;1947;100;377;218;627;318;1004
410657;201606;748;2083;535;1642;114;407;184;501;298;908
410660;201606;2848;8097;1612;5306;372;1325;189;582;561;1907
410670;201606;940;2568;622;1892;119;379;183;526;302;905
410680;201606;2878;9323;2340;8019;756;2562;641;2389;1397;4951
410685;201606;642;1839;549;1678;88;306;310;920;398;1226
410690;201606;114305;327244;80456;256869;17422;61854;18902;53847;36324;115701
410700;201606;2200;6608;2007;6242;514;1710;861;2588;1375;4298
410710;201606;893;2612;615;2010;150;515;142;408;292;923
410712;201606;808;2413;697;2199;254;876;179;576;433;1452
410715;201606;904;2869;673;2312;151;552;181;587;332;1139
410720;201606;3262;9569;2397;7753;521;1925;483;1432;1004;3357
410725;201606;1068;3003;754;2396;128;423;123;368;251;791
410730;201606;516;1453;414;1281;121;410;95;314;216;724
410740;201606;898;2642;648;2139;107;407;282;924;389;1331
410750;201606;1805;5245;1479;4560;326;1113;474;1386;800;2499
410752;201606;309;849;162;528;34;122;44;125;78;247
410753;201606;416;1201;261;843;43;157;78;236;121;393
410754;201606;1092;3196;919;2903;70;231;598;2029;668;2260
410755;201606;799;1978;602;1669;76;257;353;924;429;1181
410760;201606;2390;7193;2054;6586;570;2014;624;1999;1194;4013
410765;201606;14998;44763;11347;37585;2145;8113;877;2890;3022;11003
410770;201606;912;2507;647;1969;171;567;127;376;298;943
410773;201606;1312;3730;1145;3472;170;590;778;2303;948;2893
410775;201606;1402;4026;1290;3867;296;1022;504;1489;800;2511
410780;201606;534;1443;369;1129;87;260;110;382;197;642
410785;201606;738;2331;621;2066;174;630;171;567;345;1197
410790;201606;425;1378;373;1241;111;400;35;90;146;490
410800;201606;2810;7026;2197;5986;386;1239;823;2128;1209;3367
410810;201606;333;1023;281;914;51;192;109;345;160;537
410820;201606;820;2452;614;1986;171;581;100;311;271;892
410830;201606;29696;84338;23748;74022;6606;22874;7998;24318;14604;47192
410832;201606;995;2880;861;2622;106;399;489;1418;595;1817
410840;201606;6551;19084;4298;14255;1015;3626;336;967;1351;4593
410845;201606;1222;3602;1033;3222;219;758;407;1252;626;2010
410850;201606;2707;7984;2411;7504;567;1973;975;3095;1542;5068
410855;201606;583;1624;424;1288;86;290;144;415;230;705
410860;201606;3581;10262;2876;8798;572;1912;934;2770;1506;4682
410865;201606;1475;4966;1402;4829;367;1332;799;2852;1166;4184
410870;201606;1216;3682;1132;3548;168;566;768;2437;936;3003
410880;201606;3695;11664;3066;10333;702;2677;554;1831;1256;4508
410890;201606;901;2944;709;2538;192;768;75;255;267;1023
410895;201606;1071;3674;954;3412;368;1421;214;735;582;2156
410900;201606;927;2530;606;1905;103;358;179;524;282;882
410910;201606;404;1062;309;892;37;125;159;442;196;567
410920;201606;817;2265;650;1988;166;582;230;701;396;1283
410930;201606;1611;4747;1343;4218;350;1291;409;1277;759;2568
410940;201606;20511;65427;17435;59735;5567;20781;4080;14344;9647;35125
410950;201606;1736;5651;1601;5404;174;648;1201;4056;1375;4704
410960;201606;7294;20054;4578;14897;1425;5139;922;2908;2347;8047
410965;201606;1050;3176;868;2820;238;806;342;1104;580;1910
410970;201606;4463;13058;3492;11165;1004;3716;572;1789;1576;5505
410975;201606;1604;4552;1266;3903;224;800;467;1401;691;2201
410980;201606;5710;16012;3666;11931;736;2695;862;2705;1598;5400
410990;201606;903;2623;559;1871;177;659;65;171;242;830
411000;201606;484;1454;324;1085;58;218;64;183;122;401
411005;201606;484;1412;295;960;63;223;36;108;99;331
411007;201606;2286;7111;1962;6431;563;1961;580;1905;1143;3866
411010;201606;3915;13301;3520;12412;1077;4179;495;1723;1572;5902
411020;201606;2508;7685;2171;7126;740;2697;673;2161;1413;4858
411030;201606;653;1743;468;1392;79;267;124;340;203;607
411040;201606;662;1915;308;1037;57;214;64;219;121;433
411050;201606;1971;6772;1770;6333;559;2219;261;840;820;3059
411060;201606;1501;4518;1171;3790;269;1008;149;448;418;1456
411065;201606;362;1070;287;923;64;226;104;323;168;549
411070;201606;5794;17185;4572;14707;1209;4300;1065;3225;2274;7525
411080;201606;2138;6351;1898;5909;508;1748;507;1550;1015;3298
411090;201606;816;2012;562;1618;82;293;108;285;190;578
411095;201606;1491;4226;1111;3442;172;602;269;772;441;1374
411100;201606;1297;3747;940;3002;175;683;173;512;348;1195
411110;201606;590;1732;315;1074;44;173;25;72;69;245
411120;201606;1608;4844;1211;3973;306;1165;364;1107;670;2272
411125;201606;4161;13528;3948;13107;1111;3884;1549;5184;2660;9068
411130;201606;684;2029;513;1659;116;386;143;510;259;896
411140;201606;2149;7305;1837;6562;475;1776;730;2691;1205;4467
411150;201606;4064;11404;3081;9444;765;2568;428;1170;1193;3738
411155;201606;940;2554;688;2092;100;349;290;841;390;1190
411160;201606;251;707;197;608;41;136;45;139;86;275
411170;201606;706;2220;578;1919;145;528;194;625;339;1153
411180;201606;5623;16687;4562;14659;1029;3646;1545;5006;2574;8652
411190;201606;1391;3973;1159;3529;307;1050;257;707;564;1757
411200;201606;4238;12444;3388;10962;896;3284;1048;3253;1944;6537
411210;201606;1938;5514;1535;4776;390;1373;184;513;574;1886
411220;201606;1108;3101;889;2707;204;723;332;914;536;1637
411230;201606;1238;3442;797;2573;163;571;260;816;423;1387
411240;201606;1434;3475;797;2356;148;465;261;713;409;1178
411250;201606;2164;6327;1795;5659;490;1694;477;1533;967;3227
411260;201606;309;835;207;657;30;98;84;254;114;352
411270;201606;1745;5397;1536;4998;270;1031;705;2209;975;3240
411275;201606;1309;3855;1063;3312;271;890;249;735;520;1625
411280;201606;1486;4327;1021;3339;206;736;193;602;399;1338
411290;201606;746;2182;566;1811;142;485;160;506;302;991
411295;201606;973;2689;869;2486;134;426;361;1067;495;1493
411300;201606;1217;3087;843;2382;93;297;303;800;396;1097
411310;201606;844;2277;657;1965;72;260;216;640;288;900
411320;201606;5359;15436;3968;12819;1069;3603;749;2280;1818;5883
411325;201606;1518;4744;1321;4327;281;976;652;2191;933;3167
411330;201606;3054;9402;2568;8449;808;2956;636;2156;1444;5112
411340;201606;934;2731;597;1929;62;241;210;655;272;896
411342;201606;719;2037;591;1771;169;552;198;547;367;1099
411345;201606;886;2736;790;2555;198;723;365;1169;563;1892
411350;201606;2690;8053;1985;6598;582;2123;227;766;809;2889
411360;201606;554;1376;369;1055;50;181;152;374;202;555
411370;201606;44778;125485;35192;107787;5761;20433;14916;42808;20677;63241
411373;201606;1483;4546;1282;4185;285;1090;328;1080;613;2170
411375;201606;1110;3039;811;2456;173;565;220;637;393;1202
411380;201606;1212;3300;706;2128;126;404;191;532;317;936
411390;201606;1801;5276;1459;4551;297;1037;402;1152;699;2189
411400;201606;2096;5945;1613;4939;329;1118;447;1311;776;2429
411410;201606;2010;6057;1566;5041;381;1370;385;1105;766;2475
411420;201606;4015;11328;2748;8653;455;1635;441;1154;896;2789
411430;201606;3187;9512;2654;8638;631;2240;1286;4134;1917;6374
411435;201606;429;1407;363;1240;90;335;148;483;238;818
411440;201606;2652;8473;2346;7848;726;2540;586;2105;1312;4645
411450;201606;2293;6953;2073;6533;440;1389;1021;3392;1461;4781
411460;201606;3225;9355;1754;5982;298;1133;115;363;413;1496
411470;201606;812;2417;551;1801;105;382;70;195;175;577
411480;201606;4452;13317;3341;11166;896;3331;500;1612;1396;4943
411490;201606;1428;4332;1206;3924;279;1014;285;859;564;1873
411500;201606;1829;4840;1271;3851;277;964;365;1081;642;2045
411510;201606;2016;6026;1646;5256;454;1622;290;866;744;2488
411520;201606;26223;71090;15990;49778;3001;10220;3390;9986;6391;20206
411530;201606;1002;2769;716;2265;174;645;131;381;305;1026
411535;201606;506;1540;276;985;35;151;22;64;57;215
411540;201606;2966;8009;2142;6318;533;1785;605;1616;1138;3401
411545;201606;980;3218;878;3021;132;473;573;2041;705;2514
411550;201606;788;2114;630;1868;208;694;126;376;334;1070
411560;201606;2347;6919;1664;5361;318;1154;161;457;479;1611
411570;201606;6775;17943;5020;15123;1239;4244;1144;3605;2383;7849
411573;201606;852;2507;797;2415;116;374;505;1554;621;1928
411575;201606;1554;4768;1302;4236;306;1057;444;1475;750;2532
411580;201606;3913;11113;2634;8559;448;1731;356;1022;804;2753
411585;201606;745;2369;395;1391;93;331;69;237;162;568
411590;201606;367;1117;317;1033;45;172;139;423;184;595
411600;201606;308;879;213;723;50;198;85;294;135;492
411605;201606;1685;4624;1169;3553;190;669;428;1267;618;1936
411610;201606;2167;6059;1750;5250;368;1220;812;2377;1180;3597
411620;201606;2677;8391;2434;7990;605;2150;1189;3991;1794;6141
411630;201606;511;1339;323;1059;67;279;54;153;121;432
411640;201606;452;1371;349;1131;56;196;119;347;175;543
411650;201606;191;617;152;542;32;135;30;103;62;238
411660;201606;895;2388;671;1987;98;331;314;910;412;1241
411670;201606;1105;3071;901;2636;190;614;307;846;497;1460
411680;201606;1418;4224;1247;3912;261;895;602;1915;863;2810
411690;201606;3306;9656;2609;8359;688;2325;629;2139;1317;4464
411695;201606;778;2516;621;2167;138;518;191;688;329;1206
411700;201606;1699;4904;1197;3883;263;973;183;547;446;1520
411705;201606;1855;6393;1626;5935;399;1420;826;3228;1225;4648
411710;201606;1667;4880;1352;4241;365;1249;231;737;596;1986
411720;201606;889;2499;689;2093;102;355;199;551;301;906
411721;201606;728;2154;591;1872;171;589;76;218;247;807
411722;201606;660;1979;443;1484;97;379;104;300;201;679
411725;201606;1404;4455;876;3120;198;718;160;604;358;1322
411727;201606;1797;5261;1334;4263;372;1237;268;841;640;2078
411729;201606;594;1541;419;1214;111;346;92;218;203;564
411730;201606;5488;15692;4552;13888;1606;5081;1247;3811;2853;8892
411740;201606;644;1817;400;1279;76;274;120;360;196;634
411745;201606;897;2575;746;2271;146;480;246;747;392;1227
411750;201606;4778;14129;3634;11558;717;2482;1151;3578;1868;6060
411760;201606;7714;22424;6580;20462;2153;7152;1685;5437;3838;12589
411770;201606;3358;10950;2775;9610;857;3227;525;1761;1382;4988
411780;201606;2832;8700;2591;8296;521;1856;1501;4981;2022;6837
411790;201606;3274;9255;2318;7280;604;2119;564;1749;1168;3868
411800;201606;1153;3309;791;2533;129;446;111;321;240;767
411810;201606;1665;4761;1366;4169;308;1061;504;1426;812;2487
411820;201606;13395;42956;11228;38460;3979;14159;2729;9698;6708;23857
411830;201606;515;1334;376;1090;113;373;12;50;125;423
411840;201606;10308;29311;7644;24143;1850;6444;1441;4541;3291;10985
411845;201606;507;1552;316;1049;58;220;40;115;98;335
411850;201606;7087;20967;5790;18329;1437;5032;1602;4992;3039;10024
411860;201606;891;2709;722;2350;176;617;239;746;415;1363
411870;201606;862;2785;592;2058;130;517;110;333;240;850
411880;201606;2270;6476;1799;5658;475;1735;355;1027;830;2762
411885;201606;905;2489;752;2224;146;533;243;676;389;1209
411890;201606;1092;3324;745;2494;135;532;61;161;196;693
411900;201606;941;2932;663;2255;158;537;104;370;262;907
411910;201606;1205;3957;922;3268;274;1042;224;740;498;1782
411915;201606;16396;44646;10450;32823;2081;7116;2303;6625;4384;13741
411920;201606;847;2863;738;2602;219;890;83;247;302;1137
411925;201606;596;1694;393;1305;97;337;93;281;190;618
411930;201606;5869;19167;5150;17735;2299;8436;819;2910;3118;11346
411940;201606;3179;10563;2753;9640;763;2835;601;2062;1364;4897
411950;201606;11895;37503;10130;34054;2344;8537;4576;15269;6920;23806
411960;201606;5415;15916;4992;15139;1048;3582;2190;6525;3238;10107
411965;201606;571;1628;409;1347;82;319;115;391;197;710
411970;201606;737;2067;616;1879;175;546;272;904;447;1450
411980;201606;1647;4908;1421;4457;342;1141;450;1431;792;2572
411990;201606;29987;95021;24404;83154;6373;24123;7052;23473;13425;47596
411995;201606;2459;7451;2084;6771;653;2390;510;1569;1163;3959
412000;201606;2190;5518;1680;4659;269;931;832;2084;1101;3015
412010;201606;706;2372;566;2055;102;400;118;396;220;796
412015;201606;640;1872;518;1620;96;318;247;761;343;1079
412020;201606;365;1062;243;784;47;161;71;213;118;374
412030;201606;702;2190;504;1741;91;366;117;385;208;751
412033;201606;807;2321;552;1731;101;354;133;398;234;752
412035;201606;986;2729;645;2097;121;420;224;724;345;1144
412040;201606;571;1790;450;1525;81;289;110;369;191;658
412050;201606;1719;4915;1307;4105;229;790;312;955;541;1745
412060;201606;6798;23065;6164;21798;1926;7433;1847;6526;3773;13959
412065;201606;814;2432;630;2041;149;541;172;510;321;1051
412070;201606;1345;3606;991;2874;156;497;365;1053;521;1550
412080;201606;1342;4136;819;2927;102;413;23;78;125;491
412085;201606;445;1278;151;521;25;88;22;69;47;157
412090;201606;4463;13689;4162;13154;792;2639;2352;7715;3144;10354
412100;201606;1904;5856;1549;5150;465;1676;373;1269;838;2945
412110;201606;1078;3029;727;2293;167;568;141;460;308;1028
412120;201606;1687;5691;1456;5167;383;1513;468;1506;851;3019
412125;201606;636;2058;577;1946;147;538;211;684;358;1222
412130;201606;600;1792;438;1423;109;381;62;184;171;565
412135;201606;470;1318;305;969;66;213;96;293;162;506
412140;201606;1562;4672;1285;4090;318;1105;239;705;557;1810
412150;201606;2864;8250;2476;7472;335;1120;1497;4436;1832;5556
412160;201606;1159;3672;742;2597;190;734;93;301;283;1035
412170;201606;4497;13763;3689;12199;1005;3644;1348;4291;2353;7935
412175;201606;1422;4688;1232;4276;266;1013;583;2036;849;3049
412180;201606;1633;4967;1213;4160;287;1134;365;1190;652;2324
412190;201606;3218;9077;2425;7648;529;1858;758;2551;1287;4409
412200;201606;2107;6707;1519;5195;309;1143;469;1624;778;2767
412210;201606;674;1847;392;1250;76;275;38;93;114;368
412215;201606;3583;10922;3215;10270;726;2346;1827;6039;2553;8385
412217;201606;1078;3044;950;2817;110;405;646;1817;756;2222
412220;201606;5594;18186;5313;17653;1501;5067;2540;8694;4041;13761
412230;201606;2786;9117;2408;8348;547;2176;680;2174;1227;4350
412240;201606;8727;22175;5100;15468;1007;3479;962;2668;1969;6147
412250;201606;1879;5468;1582;4871;409;1392;225;593;634;1985
412260;201606;1330;3652;871;2682;129;469;311;861;440;1330
412265;201606;993;3012;874;2810;217;795;363;1175;580;1970
412270;201606;857;2703;571;1977;111;447;177;573;288;1020
412280;201606;617;1898;457;1551;172;628;31;83;203;711
412290;201606;1020;2893;773;2434;162;575;242;699;404;1274
412300;201606;1851;5552;1557;4991;444;1572;343;1049;787;2621
412310;201606;1005;2912;874;2706;128;483;432;1370;560;1853
412320;201606;861;2295;617;1865;112;408;211;647;323;1055
412330;201606;1512;4344;1145;3578;179;634;509;1572;688;2206
412340;201606;945;2928;627;2118;104;386;102;310;206;696
412350;201606;2191;6760;1713;5723;387;1396;113;308;500;1704
412360;201606;300;887;185;597;21;84;62;174;83;258
412370;201606;933;2724;680;2267;168;620;138;465;306;1085
412380;201606;1494;4754;1229;4099;340;1216;260;865;600;2081
412382;201606;666;1857;460;1433;81;266;99;286;180;552
412385;201606;2374;7304;2110;6699;766;2519;532;1728;1298;4247
412390;201606;2103;5970;1881;5611;483;1604;780;2392;1263;3996
412395;201606;812;2287;637;1990;83;293;349;1064;432;1357
412400;201606;903;2825;766;2530;214;752;181;615;395;1367
412402;201606;1852;5468;1494;4738;365;1319;309;900;674;2219
412405;201606;3551;10250;2199;7223;390;1460;120;367;510;1827
412410;201606;4870;14746;3972;13013;1146;4376;761;2426;1907;6802
412420;201606;367;1082;250;808;45;155;78;216;123;371
412430;201606;546;1519;392;1215;55;189;139;408;194;597
412440;201606;3182;9647;2520;8447;631;2338;675;2321;1306;4659
412450;201606;279;908;213;725;35;116;18;45;53;161
412460;201606;729;2269;602;1987;168;592;123;402;291;994
412470;201606;1837;6228;1557;5503;556;2042;336;1286;892;3328
412480;201606;1165;3485;822;2646;158;556;103;247;261;803
412490;201606;876;2595;741;2329;142;468;218;674;360;1142
412500;201606;1933;5547;1591;4861;322;1117;374;1013;696;2130
412510;201606;2217;7186;1816;6208;576;2147;511;1678;1087;3825
412520;201606;1511;4251;1111;3428;299;989;197;564;496;1553
412530;201606;604;1781;470;1465;93;309;94;275;187;584
412535;201606;717;2088;480;1529;104;346;116;347;220;693
412540;201606;1208;3425;910;2814;132;483;256;778;388;1261
412545;201606;757;2169;570;1761;99;350;169;452;268;802
412550;201606;29139;87209;20320;67452;4761;17072;4357;13787;9118;30859
412555;201606;257;768;172;569;28;96;37;102;65;198
412560;201606;5198;15813;4034;13293;819;3191;1112;3529;1931;6720
412570;201606;4210;12289;2821;9303;685;2536;472;1595;1157;4131
412575;201606;860;2625;669;2163;138;504;213;648;351;1152
412580;201606;1195;3306;852;2640;161;547;285;825;446;1372
412590;201606;426;1237;268;886;50;173;69;222;119;395
412600;201606;1412;4263;1070;3497;236;862;279;858;515;1720
412610;201606;730;2166;469;1492;117;396;126;375;243;771
412620;201606;1209;3793;942;3235;260;1026;139;406;399;1432
412625;201606;9633;27553;7240;22840;1653;5702;873;2614;2526;8316
412627;201606;932;2879;657;2234;217;818;73;243;290;1061
412630;201606;3252;10211;2572;8703;554;1950;721;2352;1275;4302
412635;201606;464;1359;319;1039;74;252;16;32;90;284
412640;201606;885;2645;585;1938;103;362;49;148;152;510
412650;201606;1713;5083;1433;4547;326;1190;423;1240;749;2430
412660;201606;2711;7790;2130;6610;458;1594;448;1275;906;2869
412665;201606;633;1649;355;1103;91;288;78;234;169;522
412667;201606;1668;4801;1306;4078;299;998;330;977;629;1975
412670;201606;538;1659;415;1403;109;413;67;205;176;618
412680;201606;1338;3997;838;2879;146;563;174;531;320;1094
412690;201606;781;2335;591;1920;172;603;118;381;290;984
412700;201606;1827;5551;1534;5107;525;1980;415;1350;940;3330
412710;201606;6854;21536;5778;19326;1346;5021;1370;4320;2716;9341
412720;201606;1364;4201;958;3188;179;664;162;438;341;1102
412730;201606;2097;6251;1264;4333;286;1062;136;424;422;1486
412740;201606;1412;4479;1063;3687;278;1082;145;548;423;1630
412750;201606;4000;12093;3568;11378;455;1770;2231;7022;2686;8792
412760;201606;2361;7489;2212;7216;387;1453;1328;4213;1715;5666
412770;201606;10950;30007;6276;20113;976;3446;1068;3048;2044;6494
412780;201606;1266;3904;1086;3538;244;889;385;1199;629;2088
412785;201606;2316;6503;1741;5338;448;1392;802;2544;1250;3936
412788;201606;1380;4397;1193;4003;320;1232;340;1050;660;2282
412790;201606;1114;3311;820;2676;195;710;165;453;360;1163
412795;201606;932;2583;729;2189;159;508;271;814;430;1322
412796;201606;2685;8233;2461;7811;560;2008;1001;3024;1561;5032
412800;201606;2980;8520;2324;7118;394;1363;838;2473;1232;3836
412810;201606;11131;30210;6556;20438;948;3399;1438;3773;2386;7172
412820;201606;7254;21080;5363;17384;1260;4392;1314;4351;2574;8743
412830;201606;342;1061;269;884;45;168;67;189;112;357
412840;201606;1797;5138;1448;4417;286;977;310;935;596;1912
412850;201606;2790;8180;2253;7234;473;1789;717;2157;1190;3946
412853;201606;1697;4869;1502;4478;175;618;791;2204;966;2822
412855;201606;1469;4241;1134;3492;248;836;272;730;520;1566
412860;201606;1183;3379;969;2996;244;855;387;1166;631;2021
412862;201606;760;1939;510;1492;79;248;144;423;223;671
412863;201606;1172;3978;1139;3918;170;648;804;2718;974;3366
412865;201606;700;2131;519;1726;108;370;177;623;285;993
412870;201606;908;2552;717;2233;265;946;140;411;405;1357
412880;201606;878;2546;688;2171;171;616;81;213;252;829
420005;201606;532;1581;328;1119;61;223;109;366;170;589
420010;201606;3167;8882;2531;7981;346;1156;1726;5565;2072;6721
420020;201606;750;2415;423;1555;57;238;45;168;102;406
420030;201606;501;1298;254;835;55;225;28;87;83;312
420040;201606;719;2288;451;1704;118;484;35;117;153;601
420050;201606;692;2002;459;1520;120;430;177;594;297;1024
420055;201606;206;630;120;420;20;76;21;72;41;148
420060;201606;243;785;165;594;26;120;32;86;58;206
420070;201606;1348;4251;1026;3467;180;684;401;1348;581;2032
420075;201606;173;462;89;272;21;69;13;32;34;101
420080;201606;593;1859;477;1632;141;517;145;502;286;1019
420090;201606;480;1586;331;1253;88;350;64;252;152;602
420100;201606;1196;3723;1066;3542;230;801;623;2095;853;2896
420110;201606;326;1100;295;1027;81;303;113;392;194;695
420120;201606;261;899;207;777;67;284;40;136;107;420
420125;201606;258;941;229;876;60;246;105;386;165;632
420127;201606;543;1576;205;740;52;202;21;72;73;274
420130;201606;1859;6231;1498;5494;387;1569;323;1091;710;2660
420140;201606;4496;13197;3181;10645;809;3012;454;1414;1263;4426
420150;201606;736;2069;450;1509;84;309;166;531;250;840
420160;201606;272;749;164;538;30;98;51;168;81;266
420165;201606;218;683;132;459;30;118;32;107;62;225
420170;201606;198;609;134;485;49;204;15;49;64;253
420180;201606;405;1232;222;802;41;155;47;162;88;317
420190;201606;461;1307;235;799;41;156;17;52;58;208
420195;201606;1331;3874;1079;3464;273;962;310;965;583;1927
420200;201606;2528;7860;1487;5467;323;1378;187;656;510;2034
420205;201606;1005;3272;840;2974;197;752;442;1601;639;2353
420207;201606;1537;4479;1069;3528;295;1102;231;735;526;1837
420208;201606;572;1571;309;1102;103;402;63;248;166;650
420209;201606;318;971;206;706;36;141;80;263;116;404
420210;201606;1720;5187;1127;4211;278;1234;377;1357;655;2591
420213;201606;778;2790;730;2678;156;627;426;1566;582;2193
420215;201606;321;1034;214;769;61;227;19;81;80;308
420220;201606;159;569;128;500;33;152;35;131;68;283
420230;201606;4238;12233;3118;10251;627;2452;1233;3923;1860;6375
420240;201606;10759;29805;6794;22316;1188;4675;2772;8289;3960;12964
420243;201606;596;1804;471;1555;96;344;180;589;276;933
420245;201606;1146;3478;798;2735;145;579;262;819;407;1398
420250;201606;525;1675;471;1571;123;479;203;650;326;1129
420253;201606;497;1306;374;1140;46;142;227;716;273;858
420257;201606;304;842;189;627;32;109;97;325;129;434
420260;201606;1203;3774;980;3364;228;868;399;1374;627;2242
420270;201606;602;1816;204;718;36;147;49;144;85;291
420280;201606;2190;5944;1341;4403;285;1043;455;1431;740;2474
420285;201606;146;438;70;267;11;47;2;10;13;57
420287;201606;526;1562;434;1418;139;471;139;468;278;939
420290;201606;6184;18318;4131;13625;824;2905;1204;3728;2028;6633
420300;201606;6690;20012;4295;14864;948;3642;735;2478;1683;6120
420310;201606;772;2078;673;1924;94;306;492;1368;586;1674
420315;201606;957;3026;743;2599;229;855;243;844;472;1699
420320;201606;4792;14680;3906;13105;1130;4185;1437;4847;2567;9032
420325;201606;239;797;210;730;48;178;79;267;127;445
420330;201606;983;3371;715;2704;163;681;184;653;347;1334
420340;201606;1437;4412;1084;3615;237;894;121;360;358;1254
420350;201606;1463;4334;1058;3538;290;1043;381;1275;671;2318
420360;201606;3062;9293;1905;6770;431;1730;181;594;612;2324
420370;201606;1838;5228;1433;4531;162;573;1025;3199;1187;3772
420380;201606;5081;15434;3380;11561;820;3043;813;2723;1633;5766
420390;201606;1427;3982;744;2526;136;532;125;346;261;878
420395;201606;1393;4267;959;3278;158;637;125;381;283;1018
420400;201606;1264;3647;880;2901;225;853;200;597;425;1450
420410;201606;759;2017;526;1632;90;322;322;986;412;1308
420415;201606;464;1449;336;1144;93;336;105;360;198;696
420417;201606;710;2273;584;1966;107;371;289;980;396;1351
420419;201606;368;1104;239;848;86;338;18;72;104;410
420420;201606;10718;32190;8528;27975;2918;10547;2170;6838;5088;17385
420425;201606;1218;3272;834;2554;85;331;362;1039;447;1370
420430;201606;3302;9974;2094;7135;445;1634;653;2304;1098;3938
420435;201606;295;866;178;605;38;146;75;243;113;389
420440;201606;906;2793;511;1772;203;755;107;357;310;1112
420445;201606;368;1080;247;788;57;196;82;252;139;448
420450;201606;810;2448;541;1858;121;448;108;354;229;802
420455;201606;1935;5756;1646;5265;319;1278;790;2415;1109;3693
420460;201606;8762;25376;6584;21500;1494;5627;2475;7724;3969;13351
420470;201606;1102;2901;644;2025;147;515;190;561;337;1076
420475;201606;120;347;62;211;18;60;6;20;24;80
420480;201606;4899;14095;3563;11604;1051;3773;762;2496;1813;6269
420490;201606;650;1691;351;1185;87;321;83;296;170;617
420500;201606;1525;4818;1162;4107;374;1490;391;1386;765;2876
420510;201606;86;328;75;312;18;89;39;156;57;245
420515;201606;106;356;84;312;16;70;17;63;33;133
420517;201606;840;2598;744;2436;127;466;435;1389;562;1855
420519;201606;550;1437;394;1169;60;209;117;319;177;528
420520;201606;646;1621;380;1218;82;295;106;284;188;579
420530;201606;1046;3443;768;2817;181;763;179;602;360;1365
420535;201606;255;735;132;471;36;130;7;34;43;164
420540;201606;21185;59844;15061;47013;3606;12467;3951;10818;7557;23285
420543;201606;389;1026;302;887;51;121;189;593;240;714
420545;201606;1520;4759;1217;4096;300;1137;382;1217;682;2354
420550;201606;4123;12915;3002;10618;830;3465;549;1832;1379;5297
420555;201606;354;1071;262;878;68;252;81;258;149;510
420560;201606;530;1523;389;1271;68;236;196;637;264;873
420570;201606;2138;6740;1629;5585;412;1620;528;1680;940;3300
420580;201606;1462;4456;1158;3934;272;1072;491;1638;763;2710
420590;201606;3192;9552;2095;7024;435;1592;334;1027;769;2619
420600;201606;883;2881;803;2720;130;463;472;1660;602;2123
420610;201606;519;1576;281;1033;75;327;64;233;139;560
420620;201606;560;1719;496;1588;131;449;149;485;280;934
420630;201606;996;3049;706;2372;164;587;249;793;413;1380
420640;201606;790;2366;377;1382;88;361;32;118;120;479
420650;201606;2547;7430;1602;5471;275;1043;388;1255;663;2298
420660;201606;464;1342;327;1055;56;208;111;350;167;558
420665;201606;688;1931;444;1465;72;278;130;384;202;662
420670;201606;1668;4895;1161;3837;241;950;276;826;517;1776
420675;201606;209;670;152;535;26;98;46;155;72;253
420680;201606;511;1199;293;863;56;184;98;275;154;459
420690;201606;853;2914;623;2290;113;435;109;356;222;791
420700;201606;3174;9266;2425;7772;507;1825;770;2358;1277;4183
420710;201606;586;1959;444;1649;120;498;148;548;268;1046
420720;201606;1717;4855;1312;4321;354;1257;657;2170;1011;3427
420730;201606;3260;9680;2628;8577;644;2322;1075;3401;1719;5723
420740;201606;827;2549;677;2271;218;796;268;857;486;1653
420750;201606;2333;7418;1692;5931;297;1215;514;1656;811;2871
420757;201606;103;242;43;149;9;37;18;65;27;102
420760;201606;362;1129;201;680;48;177;36;102;84;279
420765;201606;569;1798;297;1113;70;297;54;192;124;489
420768;201606;1167;4037;908;3490;349;1364;321;1300;670;2664
420770;201606;636;1842;346;1264;76;329;68;252;144;581
420775;201606;633;1866;366;1213;82;293;65;196;147;489
420780;201606;1518;4542;905;3060;194;695;145;455;339;1150
420785;201606;278;848;201;659;45;160;46;142;91;302
420790;201606;1271;4326;999;3711;281;1148;376;1340;657;2488
420800;201606;857;2442;413;1402;99;359;89;305;188;664
420810;201606;2021;6794;1594;5857;523;2175;358;1242;881;3417
420820;201606;8138;24121;5599;19782;1467;5791;1409;4986;2876;10777
420830;201606;2606;8180;2127;7277;642;2400;747;2556;1389;4956
420840;201606;995;2930;486;1746;103;430;86;286;189;716
420845;201606;1330;3954;937;3270;266;1066;207;705;473;1771
420850;201606;1616;5017;971;3625;239;995;76;278;315;1273
420860;201606;450;1261;272;922;78;299;75;257;153;556
420870;201606;1127;3124;875;2723;301;1107;237;647;538;1754
420880;201606;1007;3327;770;2720;181;700;132;432;313;1132
420890;201606;10343;27225;5218;17048;920;3294;1193;3435;2113;6729
420895;201606;244;668;127;419;37;120;14;45;51;165
420900;201606;1846;5186;1173;3876;256;978;292;888;548;1866
420910;201606;23998;70706;16212;55172;3191;12335;4851;15521;8042;27856
420915;201606;554;2192;406;1749;95;444;168;684;263;1128
420917;201606;475;1462;214;718;40;154;79;235;119;389
420920;201606;182;501;70;239;12;48;12;44;24;92
420930;201606;17881;51183;13870;44363;3159;11348;5359;16701;8518;28049
420940;201606;2843;8516;2154;7111;627;2310;201;587;828;2897
420945;201606;197;599;126;435;25;106;31;93;56;199
420950;201606;631;1773;294;1083;51;246;45;151;96;397
420960;201606;922;2624;726;2274;143;489;303;912;446;1401
420970;201606;2495;7788;2059;6988;680;2604;556;1859;1236;4463
420980;201606;462;1337;338;1132;113;413;131;483;244;896
420985;201606;500;1420;232;831;48;207;53;166;101;373
420990;201606;892;2404;492;1662;96;380;94;258;190;638
421000;201606;561;1875;359;1357;76;308;57;197;133;505
421003;201606;725;1948;268;889;39;151;36;76;75;227
421005;201606;155;479;117;414;30;116;60;219;90;335
421010;201606;5280;14913;3632;11969;933;3474;788;2393;1721;5867
421020;201606;482;1474;368;1283;46;168;199;710;245;878
421030;201606;729;2653;656;2460;217;892;109;396;326;1288
421040;201606;903;2292;573;1779;103;381;285;841;388;1222
421050;201606;1657;4690;976;3243;212;787;203;581;415;1368
421055;201606;191;543;98;313;26;82;17;40;43;122
421060;201606;500;1681;328;1204;79;314;108;389;187;703
421070;201606;699;2226;433;1547;98;367;64;224;162;591
421080;201606;525;1587;443;1462;98;319;283;947;381;1266
421085;201606;555;1470;295;994;53;203;86;290;139;493
421090;201606;421;1173;201;675;33;140;61;181;94;321
421100;201606;936;2527;499;1585;130;425;56;168;186;593
421105;201606;1472;4472;1189;3985;279;1009;414;1476;693;2485
421110;201606;980;3532;889;3320;354;1399;199;701;553;2100
421120;201606;1333;4288;892;3192;141;599;217;702;358;1301
421125;201606;404;1112;298;926;76;270;105;301;181;571
421130;201606;3228;10540;2734;9587;915;3511;902;3239;1817;6750
421140;201606;345;1001;254;818;45;147;95;287;140;434
421145;201606;556;1753;342;1175;53;179;101;342;154;521
421150;201606;596;1731;426;1441;89;347;175;573;264;920
421160;201606;1218;3329;582;1897;133;484;177;533;310;1017
421165;201606;280;950;222;788;31;103;89;325;120;428
421170;201606;1317;3814;1054;3408;196;690;623;2026;819;2716
421175;201606;1234;3451;868;2836;194;791;295;865;489;1656
421180;201606;572;1586;296;1001;60;230;56;182;116;412
421185;201606;395;1087;277;861;45;127;132;438;177;565
421187;201606;282;835;211;688;46;156;90;284;136;440
421189;201606;419;1271;341;1107;87;308;100;305;187;613
421190;201606;11695;33266;7089;24124;1544;5878;1027;3345;2571;9223
421200;201606;924;3040;785;2753;195;730;234;795;429;1525
421205;201606;252;764;188;637;48;197;44;123;92;320
421210;201606;1503;4572;1126;3693;286;966;298;994;584;1960
421220;201606;1926;6481;1663;5896;550;2204;303;967;853;3171
421223;201606;533;1682;397;1397;99;371;130;463;229;834
421225;201606;1096;3477;923;3123;205;748;372;1275;577;2023
421227;201606;795;2547;704;2401;150;584;403;1336;553;1920
421230;201606;439;1424;384;1328;93;359;171;568;264;927
421240;201606;425;1346;236;862;37;167;40;142;77;309
421250;201606;1703;4876;1098;3802;301;1130;239;839;540;1969
421260;201606;357;1021;99;359;25;90;19;64;44;154
421265;201606;730;2224;639;2076;123;458;355;1121;478;1579
421270;201606;831;2210;413;1359;88;289;85;319;173;608
421280;201606;1619;5064;1269;4451;380;1486;425;1459;805;2945
421290;201606;1197;3324;713;2307;131;468;120;351;251;819
421300;201606;306;933;235;780;67;273;94;279;161;552
421310;201606;234;720;182;601;38;137;58;179;96;316
421315;201606;359;1034;193;683;45;170;19;68;64;238
421320;201606;588;1817;375;1297;64;234;58;146;122;380
421330;201606;548;1779;418;1533;148;601;82;310;230;911
421335;201606;508;1674;418;1495;106;430;90;345;196;775
421340;201606;1760;5018;1402;4449;204;799;801;2522;1005;3321
421350;201606;972;3179;812;2836;161;675;403;1339;564;2014
421360;201606;2990;8574;1896;6447;388;1542;549;1747;937;3289
421370;201606;681;2248;521;1895;151;616;163;589;314;1205
421380;201606;969;2727;795;2396;132;458;392;1151;524;1609
421390;201606;170;493;71;252;15;56;27;100;42;156
421400;201606;266;877;181;710;55;243;56;205;111;448
421410;201606;334;952;216;728;36;131;90;302;126;433
421415;201606;350;1145;163;611;37;155;29;99;66;254
421420;201606;869;2600;635;2074;115;428;207;633;322;1061
421430;201606;238;737;180;621;35;131;38;137;73;268
421440;201606;842;2440;562;1928;123;493;239;809;362;1302
421450;201606;490;1508;294;1073;65;271;28;111;93;382
421460;201606;635;1727;334;1168;66;273;70;244;136;517
421470;201606;428;1419;334;1208;92;374;107;364;199;738
421480;201606;3068;8617;1904;6503;534;2155;335;954;869;3109
421490;201606;279;855;131;511;32;147;20;72;52;219
421500;201606;2185;7372;1801;6581;594;2453;274;1000;868;3453
421505;201606;359;1196;313;1090;73;268;153;536;226;804
421507;201606;526;1578;335;1171;73;269;98;363;171;632
421510;201606;175;564;151;523;26;122;80;231;106;353
421520;201606;885;2333;583;1730;66;246;250;662;316;908
421530;201606;414;1272;250;908;49;222;63;225;112;447
421535;201606;682;1997;371;1360;54;225;153;532;207;757
421540;201606;323;888;252;771;58;196;93;263;151;459
421545;201606;830;2629;607;2194;143;582;159;566;302;1148
421550;201606;1972;6297;1653;5741;501;1990;504;1673;1005;3663
421555;201606;327;952;114;404;17;64;17;58;34;122
421560;201606;209;638;93;321;18;70;19;61;37;131
421565;201606;845;2436;732;2279;229;802;333;1059;562;1861
421567;201606;639;2341;563;2166;291;1158;132;518;423;1676
421568;201606;511;1574;333;1148;78;280;92;317;170;597
421569;201606;231;703;103;379;24;94;18;64;42;158
421570;201606;1360;4080;759;2644;190;725;132;445;322;1170
421575;201606;444;1460;389;1349;60;237;241;837;301;1074
421580;201606;3034;9506;2245;7765;578;2300;556;1721;1134;4021
421590;201606;217;675;174;593;27;91;93;317;120;408
421600;201606;545;1635;414;1353;107;386;86;251;193;637
421605;201606;619;1890;446;1566;100;423;124;411;224;834
421610;201606;1405;3802;1038;3163;161;552;489;1430;650;1982
421620;201606;4434;13332;2957;10282;829;3098;882;3102;1711;6200
421625;201606;378;1044;152;521;25;90;16;52;41;142
421630;201606;2992;8861;1681;5763;362;1351;249;830;611;2181
421635;201606;244;727;128;429;21;86;39;103;60;189
421640;201606;1049;3109;749;2510;163;592;318;1048;481;1640
421650;201606;2064;6623;1575;5519;444;1790;204;612;648;2402
421660;201606;7673;24693;6226;21761;1538;6057;1954;6411;3492;12468
421670;201606;1072;3269;746;2538;194;755;223;723;417;1478
421680;201606;1138;3639;928;3199;322;1189;200;669;522;1858
421690;201606;1630;5296;1234;4406;284;1122;131;429;415;1551
421700;201606;505;1623;288;1069;53;213;65;203;118;416
421710;201606;214;716;108;396;24;93;29;95;53;188
421715;201606;262;696;139;442;35;115;40;119;75;234
421720;201606;1872;5503;1156;4015;307;1196;181;557;488;1753
421725;201606;118;376;97;326;32;111;23;74;55;185
421730;201606;592;1706;293;1006;49;179;53;162;102;341
421740;201606;744;2387;508;1823;134;544;92;303;226;847
421750;201606;1001;2663;611;1896;119;407;254;722;373;1129
421755;201606;321;927;186;604;44;158;59;183;103;341
421760;201606;823;2444;412;1463;74;290;114;379;188;669
421770;201606;2954;8867;2231;7423;554;1935;759;2618;1313;4553
421775;201606;498;1457;347;1179;71;259;113;376;184;635
421780;201606;1206;4049;919;3369;241;997;261;899;502;1896
421790;201606;782;2114;445;1556;129;527;128;417;257;944
421795;201606;350;1031;221;710;42;147;63;205;105;352
421800;201606;2729;8103;2044;6809;457;1710;792;2518;1249;4228
421810;201606;607;1886;429;1517;116;449;58;200;174;649
421820;201606;1043;3023;643;2178;124;457;116;346;240;803
421825;201606;1456;4615;1356;4411;160;617;977;3095;1137;3712
421830;201606;2426;8289;2146;7695;514;2102;888;3014;1402;5116
421835;201606;158;469;114;405;18;81;75;259;93;340
421840;201606;286;929;205;745;49;213;62;203;111;416
421850;201606;406;1287;239;856;50;208;45;156;95;364
421860;201606;313;946;202;718;35;148;48;143;83;291
421870;201606;3892;10936;2703;8592;812;2830;501;1580;1313;4410
421875;201606;416;1246;190;704;41;167;20;70;61;237
421880;201606;876;2678;651;2195;150;558;150;485;300;1043
421885;201606;303;970;242;860;73;274;85;300;158;574
421890;201606;867;2943;745;2696;242;1025;250;843;492;1868
421895;201606;367;1168;325;1095;74;268;182;618;256;886
421900;201606;949;2629;586;1882;168;579;154;457;322;1036
421910;201606;495;1587;334;1213;83;360;51;158;134;518
421915;201606;502;1483;301;1001;57;178;63;197;120;375
421917;201606;575;1655;412;1413;145;572;125;421;270;993
421920;201606;760;2115;481;1737;246;924;119;448;365;1372
421930;201606;3151;8253;1706;5699;429;1585;255;786;684;2371
421935;201606;654;2134;481;1760;105;447;167;576;272;1023
421940;201606;264;879;137;506;23;98;23;71;46;169
421950;201606;3639;9890;1729;5829;426;1565;232;810;658;2375
421960;201606;200;587;144;481;26;98;36;113;62;211
421970;201606;2256;6207;1394;4425;432;1478;387;1134;819;2612
421985;201606;491;1267;270;840;40;149;81;251;121;400
422000;201606;1173;3513;977;3135;250;870;384;1266;634;2136
430003;201606;799;2325;613;2009;179;662;171;555;350;1217
430005;201606;328;967;238;797;42;152;110;354;152;506
430010;201606;2155;5797;1613;4883;390;1250;686;2117;1076;3367
430020;201606;722;1797;602;1640;93;291;374;987;467;1278
430030;201606;1041;2721;757;2199;254;789;138;387;392;1176
430040;201606;11205;29192;8358;24141;2466;7835;1348;3757;3814;11592
430045;201606;704;1883;517;1509;96;308;218;607;314;915
430047;201606;293;696;150;445;22;69;58;172;80;241
430050;201606;1258;3356;742;2329;148;483;171;521;319;1004
430055;201606;303;818;159;499;24;86;69;210;93;296
430057;201606;75;177;35;102;4;9;5;6;9;15
430060;201606;16553;52388;14242;48414;3927;14415;5852;20273;9779;34688
430063;201606;994;2926;801;2526;195;647;408;1314;603;1961
430064;201606;1371;4070;1101;3579;287;976;393;1296;680;2272
430066;201606;168;396;117;317;9;29;64;171;73;200
430070;201606;601;1606;176;573;26;101;26;68;52;169
430080;201606;684;1920;408;1362;97;356;116;347;213;703
430085;201606;918;2381;580;1768;117;400;192;602;309;1002
430087;201606;939;2855;860;2705;135;516;517;1515;652;2031
430090;201606;863;2253;326;1054;41;141;60;203;101;344
430100;201606;844;2224;431;1361;114;388;119;334;233;722
430105;201606;1008;2948;672;2320;176;671;223;774;399;1445
430107;201606;259;847;187;642;37;139;49;157;86;296
430110;201606;1922;5482;1568;4935;385;1290;727;2237;1112;3527
430120;201606;1773;5223;1304;4250;271;928;600;1942;871;2870
430130;201606;3858;9936;3285;9098;805;2409;1352;3698;2157;6107
430140;201606;1209;3661;810;2753;230;821;258;867;488;1688
430150;201606;755;2010;507;1543;125;409;132;417;257;826
430155;201606;410;1127;219;712;33;134;54;166;87;300
430160;201606;17116;49172;14849;45372;3441;11535;6272;19556;9713;31091
430163;201606;1946;5694;1578;5057;254;917;813;2618;1067;3535
430165;201606;462;1141;131;443;18;60;16;50;34;110
430170;201606;958;2703;376;1341;54;210;39;119;93;329
430175;201606;921;2844;754;2456;185;581;326;1122;511;1703
430180;201606;847;2319;687;2060;142;493;365;1060;507;1553
430185;201606;590;1525;336;1048;62;213;102;264;164;477
430187;201606;662;1931;507;1609;112;401;172;526;284;927
430190;201606;1711;5030;1482;4585;273;941;824;2534;1097;3475
430192;201606;198;599;92;297;8;29;16;47;24;76
430195;201606;384;1158;90;303;11;37;3;8;14;45
430200;201606;1424;4530;1213;4096;389;1379;314;1052;703;2431
430205;201606;579;1656;434;1379;42;169;307;977;349;1146
430210;201606;6321;16750;3750;11512;636;2168;947;2554;1583;4722
430215;201606;366;1011;247;754;48;158;103;303;151;461
430220;201606;749;1887;260;883;39;166;45;150;84;316
430222;201606;282;854;223;728;42;165;106;325;148;490
430223;201606;361;1016;297;906;60;179;155;489;215;668
430225;201606;36;90;16;47;5;13;6;18;11;31
430230;201606;1659;4865;1593;4795;183;411;1370;4305;1553;4716
430235;201606;290;948;235;816;57;227;75;243;132;470
430237;201606;535;1388;390;1142;46;163;244;684;290;847
430240;201606;1031;2653;692;2091;101;365;345;998;446;1363
430245;201606;868;2659;656;2215;174;574;274;991;448;1565
430250;201606;1200;3412;1047;3166;396;1280;177;529;573;1809
430258;201606;163;460;119;384;12;43;51;176;63;219
430260;201606;800;2263;568;1813;82;271;306;1024;388;1295
430265;201606;277;848;215;723;60;204;17;56;77;260
430270;201606;2974;8215;2561;7534;365;1292;1539;4357;1904;5649
430280;201606;4735;12730;3808;11135;905;2761;1680;4928;2585;7689
430290;201606;2478;6470;2269;6176;132;402;1968;5352;2100;5754
430300;201606;9264;27121;7665;24098;1768;6071;3391;10898;5159;16969
430310;201606;6551;19581;5012;16643;1224;4459;1879;5977;3103;10436
430320;201606;866;2507;544;1813;90;267;264;935;354;1202
430330;201606;673;1792;521;1507;139;407;217;601;356;1008
430340;201606;707;1778;376;1233;80;274;187;604;267;878
430350;201606;6296;19065;5345;17065;1852;6158;1710;5425;3562;11583
430355;201606;391;973;150;465;29;97;19;55;48;152
430360;201606;1070;2807;873;2466;175;580;381;995;556;1575
430367;201606;289;756;174;535;44;160;58;167;102;327
430370;201606;567;1561;361;1144;97;334;74;206;171;540
430380;201606;865;2221;483;1550;132;464;134;430;266;894
430390;201606;3966;11120;2634;8415;573;2027;434;1337;1007;3364
430400;201606;1424;3379;1011;2724;304;856;389;1006;693;1862
430410;201606;629;1680;445;1360;79;272;219;663;298;935
430420;201606;3636;10501;2854;8795;731;2345;1132;3451;1863;5796
430430;201606;762;2030;476;1509;126;440;121;391;247;831
430435;201606;2031;5495;1521;4586;391;1252;556;1702;947;2954
430440;201606;3997;12538;3123;10543;612;2164;1487;5233;2099;7397
430450;201606;7613;20994;6033;17994;1921;6067;1577;4832;3498;10899
430460;201606;28541;83904;21946;72191;6120;22302;6630;21660;12750;43962
430461;201606;510;1357;162;523;25;82;40;128;65;210
430462;201606;273;775;182;619;34;127;30;109;64;236
430463;201606;4200;13302;3614;12219;821;2977;1687;5880;2508;8857
430465;201606;649;1739;538;1554;146;452;283;807;429;1259
430466;201606;3633;9957;3168;9240;672;2172;1743;4935;2415;7107
430467;201606;510;1506;439;1372;94;320;188;562;282;882
430468;201606;1409;3919;1208;3623;337;1104;474;1375;811;2479
430469;201606;477;1283;60;206;10;32;7;15;17;47
430470;201606;7707;20504;5455;16737;1621;5395;986;3059;2607;8454
430471;201606;587;1910;512;1750;158;545;127;467;285;1012
430480;201606;977;2565;497;1592;81;292;107;310;188;602
430485;201606;214;588;99;315;11;39;21;55;32;94
430490;201606;328;932;217;699;50;178;95;307;145;485
430495;201606;370;1103;242;836;55;216;63;196;118;412
430500;201606;1200;3301;971;2924;234;801;461;1358;695;2159
430510;201606;21073;61278;16892;53411;5452;18945;4883;14630;10335;33575
430511;201606;402;1237;176;624;35;133;17;40;52;173
430512;201606;1166;2987;988;2676;258;750;311;880;569;1630
430513;201606;806;2086;476;1401;105;332;181;511;286;843
430515;201606;483;1386;351;1115;54;177;158;522;212;699
430517;201606;1186;3722;981;3304;193;668;532;1842;725;2510
430520;201606;1552;4274;1042;3238;260;925;293;820;553;1745
430530;201606;1109;2979;526;1688;66;262;136;397;202;659
430535;201606;2323;6988;1761;5873;396;1475;637;2076;1033;3551
430537;201606;487;1540;419;1402;32;109;313;1054;345;1163
430540;201606;748;1657;496;1314;88;252;297;783;385;1035
430543;201606;489;1272;425;1205;76;215;305;898;381;1113
430544;201606;674;2148;562;1908;110;412;290;964;400;1376
430545;201606;1313;4149;1128;3923;381;1440;482;1723;863;3163
430550;201606;636;1841;382;1272;89;321;85;277;174;598
430558;201606;98;276;52;171;9;40;12;33;21;73
430560;201606;380;908;175;535;16;56;56;156;72;212
430570;201606;1117;2861;705;2049;160;540;278;696;438;1236
430580;201606;1272;3168;778;2357;145;486;336;1041;481;1527
430583;201606;168;458;55;174;4;13;8;24;12;37
430585;201606;335;875;215;625;50;180;84;207;134;387
430587;201606;191;597;161;532;46;163;46;158;92;321
430590;201606;1244;3451;1147;3284;124;413;845;2375;969;2788
430593;201606;24;92;22;85;6;28;8;27;14;55
430595;201606;295;832;84;282;10;46;10;26;20;72
430597;201606;338;988;236;744;31;106;56;151;87;257
430600;201606;2096;5587;1159;3501;227;749;353;1004;580;1753
430605;201606;1360;4065;1056;3439;217;810;428;1403;645;2213
430607;201606;772;1861;573;1567;63;182;367;1038;430;1220
430610;201606;8239;21958;6334;18998;1868;6144;1728;5181;3596;11325
430613;201606;273;660;114;347;18;51;21;52;39;103
430620;201606;736;2085;585;1780;167;561;222;643;389;1204
430630;201606;436;1350;219;740;42;143;23;68;65;211
430632;201606;700;1961;353;1124;63;237;120;331;183;568
430635;201606;608;1736;460;1421;89;313;246;734;335;1047
430637;201606;482;1366;423;1251;65;224;256;716;321;940
430640;201606;1648;4400;760;2492;95;342;37;81;132;423
430642;201606;469;1235;295;916;62;206;117;362;179;568
430645;201606;271;632;105;304;18;49;24;73;42;122
430650;201606;1832;5879;1549;5309;335;1187;866;3032;1201;4219
430655;201606;165;417;141;369;27;97;74;159;101;256
430660;201606;5761;16126;4580;14041;1085;3654;1918;5876;3003;9530
430670;201606;504;1455;460;1378;35;112;349;1076;384;1188
430673;201606;744;1746;344;1029;69;203;104;321;173;524
430675;201606;260;762;96;331;16;64;34;112;50;176
430676;201606;3592;10676;2935;9456;806;2767;939;3104;1745;5871
430680;201606;1212;3447;749;2452;153;534;172;502;325;1036
430690;201606;4353;12194;3451;10439;1123;3569;862;2638;1985;6207
430692;201606;274;889;201;747;21;93;135;480;156;573
430693;201606;1291;3551;830;2611;183;653;193;582;376;1235
430695;201606;587;1609;389;1201;85;306;149;426;234;732
430697;201606;482;1350;351;1111;88;280;132;436;220;716
430700;201606;10388;26451;5143;16490;995;3629;393;1248;1388;4877
430705;201606;279;844;233;750;85;298;57;168;142;466
430710;201606;1799;4528;1333;3750;281;883;533;1527;814;2410
430720;201606;893;2158;563;1673;124;399;192;580;316;979
430730;201606;1638;4252;1101;3383;251;760;457;1498;708;2258
430740;201606;570;1569;323;1069;78;275;52;194;130;469
430745;201606;506;1416;243;765;37;125;38;114;75;239
430750;201606;1587;4330;1251;3771;227;764;695;2066;922;2830
430755;201606;507;1360;334;1006;30;99;136;390;166;489
430760;201606;3048;7378;2069;5977;510;1698;758;2291;1268;3989
430770;201606;6363;18336;5000;15805;965;3334;2641;8262;3606;11596
430780;201606;2491;6584;1499;4743;301;1058;457;1401;758;2459
430781;201606;539;1546;351;1155;80;270;87;288;167;558
430783;201606;546;1330;336;974;53;159;156;425;209;584
430786;201606;72;239;47;177;8;32;10;37;18;69
430790;201606;4736;12880;3281;10003;724;2440;1213;3468;1937;5908
430800;201606;914;2570;614;1897;136;463;207;610;343;1073
430805;201606;560;1559;358;1137;41;129;186;590;227;719
430807;201606;443;1265;299;943;69;253;79;236;148;489
430810;201606;746;1983;279;934;55;202;58;188;113;390
430820;201606;1279;3859;811;2759;187;686;182;591;369;1277
430825;201606;408;1056;149;450;30;88;24;48;54;136
430830;201606;1744;5381;1610;5186;245;865;1067;3427;1312;4292
430840;201606;1005;2994;881;2769;214;656;442;1441;656;2097
430843;201606;85;223;42;130;4;14;14;40;18;54
430845;201606;299;899;249;794;106;375;31;73;137;448
430850;201606;2503;7314;2099;6555;522;1801;838;2569;1360;4370
430860;201606;1051;2803;525;1703;120;452;183;564;303;1016
430865;201606;638;1676;567;1563;182;527;274;744;456;1271
430870;201606;722;1992;388;1266;98;331;72;194;170;525
430880;201606;1192;3350;840;2662;230;771;235;803;465;1574
430885;201606;245;586;138;425;18;64;92;285;110;349
430890;201606;1783;4694;1167;3500;160;626;285;727;445;1353
430900;201606;2864;7498;2303;6557;481;1628;1066;2878;1547;4506
430905;201606;1066;3001;675;2182;162;561;140;435;302;996
430910;201606;1558;4547;1050;3455;227;832;398;1195;625;2027
430912;201606;485;1361;372;1161;46;155;233;733;279;888
430915;201606;585;1814;406;1474;138;545;97;373;235;918
430920;201606;16626;50047;14595;46241;2817;9968;8443;26139;11260;36107
430925;201606;135;303;58;168;11;34;22;65;33;99
430930;201606;9915;27833;6749;21947;1858;6493;1596;5528;3454;12021
430940;201606;1287;3868;746;2541;181;668;123;388;304;1056
430950;201606;994;2718;652;2016;153;531;246;692;399;1223
430955;201606;163;481;78;256;16;61;20;58;36;119
430957;201606;259;837;207;740;51;182;98;369;149;551
430960;201606;1403;3732;1147;3287;258;815;564;1652;822;2467
430965;201606;1539;4301;1315;3935;78;305;1028;3026;1106;3331
430970;201606;518;1415;299;951;56;181;79;249;135;430
430975;201606;603;1935;470;1626;105;386;199;698;304;1084
430980;201606;447;1108;268;839;63;214;89;277;152;491
430990;201606;584;1841;386;1313;79;289;106;359;185;648
430995;201606;616;1757;473;1470;139;466;183;529;322;995
431000;201606;1620;4131;819;2525;154;518;69;197;223;715
431010;201606;2659;7463;1612;5434;299;1121;236;731;535;1852
431020;201606;11333;27572;7269;20508;1800;5365;1836;5131;3636;10496
431030;201606;328;944;158;566;36;144;22;74;58;218
431033;201606;2441;7098;2148;6668;557;1826;1074;3460;1631;5286
431036;201606;216;543;87;280;17;54;18;43;35;97
431040;201606;942;2656;746;2320;151;563;376;1114;527;1677
431041;201606;535;1432;473;1348;145;414;189;572;334;986
431043;201606;486;1383;275;967;117;458;66;209;183;667
431046;201606;116;329;82;256;10;39;24;72;34;111
431050;201606;1693;4282;1271;3573;297;890;630;1756;927;2646
431053;201606;600;1911;486;1661;141;499;119;432;260;931
431055;201606;668;1783;617;1701;53;151;481;1337;534;1488
431057;201606;374;1090;227;768;47;172;59;180;106;352
431060;201606;5602;16508;4947;15483;1550;4998;1802;5879;3352;10877
431065;201606;562;1609;412;1307;76;272;141;404;217;676
431070;201606;710;2008;407;1316;85;289;69;168;154;457
431075;201606;295;891;208;703;40;140;64;240;104;380
431080;201606;646;1960;476;1560;100;366;137;422;237;788
431085;201606;844;2286;661;1907;112;343;376;1082;488;1425
431087;201606;593;1667;506;1496;59;174;348;1042;407;1216
431090;201606;516;1269;241;731;54;174;46;135;100;309
431100;201606;3686;10156;2959;8932;815;2713;969;2860;1784;5573
431110;201606;1557;4087;1148;3285;260;766;415;1121;675;1887
431112;201606;569;1836;525;1751;139;475;260;849;399;1324
431113;201606;513;1467;404;1263;115;379;121;385;236;764
431115;201606;1391;3985;1214;3691;218;699;713;2191;931;2890
431120;201606;2689;8146;2072;6936;623;2412;710;2182;1333;4594
431123;201606;460;1318;304;1013;56;180;168;567;224;747
431125;201606;1388;4154;990;3297;307;1042;257;935;564;1977
431127;201606;262;702;63;206;5;10;8;19;13;29
431130;201606;3353;9574;2414;7806;509;1800;806;2625;1315;4425
431140;201606;4816;11801;2706;8266;437;1499;734;2040;1171;3539
431142;201606;457;1334;392;1214;48;153;262;841;310;994
431150;201606;1117;3303;852;2770;196;700;293;933;489;1633
431160;201606;904;2632;746;2324;130;395;377;1279;507;1674
431162;201606;512;1281;217;719;32;116;25;58;57;174
431164;201606;172;474;51;183;10;38;4;18;14;56
431170;201606;729;2004;519;1629;151;516;152;462;303;978
431171;201606;787;2305;682;2099;202;665;230;689;432;1354
431173;201606;478;1383;390;1231;139;487;140;417;279;904
431175;201606;1039;2895;864;2602;268;864;258;766;526;1630
431177;201606;820;2649;634;2286;196;784;264;935;460;1719
431179;201606;374;809;101;293;17;53;20;48;37;101
431180;201606;2341;6599;1574;5086;432;1516;323;1009;755;2525
431190;201606;636;1766;370;1187;62;225;70;198;132;423
431198;201606;365;1197;329;1126;127;455;92;334;219;789
431200;201606;408;1155;119;408;23;77;4;10;27;87
431205;201606;291;875;139;481;27;83;42;154;69;237
431210;201606;769;2058;630;1821;161;462;334;998;495;1460
431213;201606;233;713;180;611;32;123;93;317;125;440
431215;201606;285;834;154;531;41;155;9;25;50;180
431217;201606;171;527;128;433;36;131;50;169;86;300
431220;201606;906;2440;539;1669;55;192;226;639;281;831
431225;201606;1354;3728;1066;3212;255;813;402;1203;657;2016
431230;201606;861;2482;649;2050;100;341;305;944;405;1285
431235;201606;114;316;32;101;6;23;6;13;12;36
431237;201606;499;1457;393;1299;85;330;218;709;303;1039
431238;201606;41;131;33;113;10;39;8;28;18;67
431240;201606;3038;8931;2701;8443;761;2587;1046;3278;1807;5865
431242;201606;369;1159;322;1071;87;304;127;442;214;746
431244;201606;390;897;232;636;27;90;119;298;146;388
431245;201606;1207;3141;837;2464;133;408;400;1167;533;1575
431247;201606;204;587;143;456;41;135;32;94;73;229
431250;201606;1505;4798;1305;4510;370;1405;529;1863;899;3268
431260;201606;350;979;171;595;31;137;50;159;81;296
431261;201606;245;833;211;756;33;141;93;314;126;455
431262;201606;423;1149;190;617;25;92;91;303;116;395
431265;201606;1458;3714;781;2342;154;510;211;539;365;1049
431267;201606;210;593;149;463;26;99;96;277;122;376
431270;201606;2810;7000;1795;5340;438;1420;602;1820;1040;3240
431275;201606;225;683;125;459;32;123;17;63;49;186
431280;201606;330;924;134;452;19;69;23;55;42;124
431290;201606;327;1008;239;804;54;213;38;98;92;311
431295;201606;90;248;44;138;4;13;14;40;18;53
431300;201606;391;980;66;248;6;22;2;7;8;29
431301;201606;277;850;114;392;24;87;18;54;42;141
431303;201606;761;2019;439;1352;59;215;134;388;193;603
431306;201606;2351;6039;1483;4490;198;722;427;1132;625;1854
431308;201606;38;128;34;114;17;61;11;36;28;97
431310;201606;757;2248;463;1579;99;359;139;494;238;853
431320;201606;792;2175;411;1361;77;274;76;226;153;500
431330;201606;2914;7111;1453;4518;388;1368;110;297;498;1665
431333;201606;426;1143;173;528;28;94;33;86;61;180
431335;201606;54;162;38;128;12;44;8;19;20;63
431337;201606;2494;7500;1844;6210;466;1708;313;1026;779;2734
431339;201606;603;1632;409;1237;74;234;200;608;274;842
431340;201606;24347;64603;17698;52993;4295;14133;4577;13642;8872;27775
431342;201606;541;1359;420;1167;115;371;229;582;344;953
431344;201606;357;967;250;772;9;20;183;582;192;602
431346;201606;313;798;120;369;23;74;17;50;40;124
431349;201606;735;2067;462;1425;82;272;175;504;257;776
431350;201606;4156;12109;3355;10631;751;2698;1238;3730;1989;6428
431360;201606;654;1671;427;1283;92;292;136;412;228;704
431365;201606;1283;3795;1096;3481;230;778;592;1947;822;2725
431370;201606;4923;13739;3839;11876;1112;3699;1207;3889;2319;7588
431380;201606;931;2892;855;2733;118;425;510;1613;628;2038
431390;201606;3123;8155;1854;5729;365;1278;489;1351;854;2629
431395;201606;1255;3731;1053;3372;236;845;511;1629;747;2474
431400;201606;377;1177;177;600;37;137;31;104;68;241
431402;201606;1289;3027;753;2101;162;484;350;949;512;1433
431403;201606;255;732;187;617;64;231;42;135;106;366
431405;201606;4085;11386;3301;10204;635;2206;1713;5251;2348;7457
431406;201606;748;2264;556;1869;115;399;286;970;401;1369
431407;201606;540;1530;355;1176;84;286;101;319;185;605
431410;201606;14136;40210;9591;31437;2875;10564;1298;4223;4173;14787
431413;201606;220;548;91;293;10;41;21;61;31;102
431415;201606;726;2049;512;1639;122;451;160;447;282;898
431417;201606;570;1440;472;1305;64;200;292;799;356;999
431420;201606;1371;3744;1207;3494;242;727;554;1713;796;2440
431430;201606;546;1414;336;1005;63;210;126;333;189;543
431440;201606;22933;63489;18588;56572;5536;18036;5910;19203;11446;37239
431442;201606;127;367;78;250;13;46;5;13;18;59
431445;201606;525;1483;233;754;35;114;73;225;108;339
431446;201606;434;1273;300;984;74;248;96;308;170;556
431447;201606;576;1635;444;1366;71;231;222;684;293;915
431449;201606;794;2185;626;1894;73;229;357;1104;430;1333
431450;201606;2213;5407;1930;5002;270;802;1389;3489;1659;4291
431454;201606;64;224;56;203;12;45;23;90;35;135
431455;201606;724;1807;384;1079;91;264;107;273;198;537
431460;201606;3351;9210;2837;8229;787;2353;926;2840;1713;5193
431470;201606;1784;5197;1327;4198;289;940;472;1524;761;2464
431475;201606;208;604;40;157;5;26;3;9;8;35
431477;201606;733;1901;481;1388;72;236;244;668;316;904
431478;201606;282;708;92;266;13;37;15;30;28;67
431480;201606;2991;8291;2277;7040;539;1835;930;2819;1469;4654
431490;201606;110763;296843;94196;272164;11750;40243;64969;183465;76719;223708
431500;201606;599;1660;469;1401;87;261;249;744;336;1005
431505;201606;504;1207;337;962;29;72;207;599;236;671
431507;201606;361;890;211;596;40;110;112;319;152;429
431510;201606;1899;5289;1472;4435;323;1034;523;1502;846;2536
431513;201606;303;810;146;454;25;75;67;206;92;281
431514;201606;111;295;45;156;3;12;10;36;13;48
431515;201606;657;1882;450;1406;97;329;159;462;256;791
431517;201606;81;262;64;219;10;36;15;46;25;82
431520;201606;525;1318;247;790;49;183;33;92;82;275
431530;201606;4324;10114;3214;8794;1014;2983;986;2911;2000;5894
431531;201606;271;784;183;589;31;115;60;182;91;297
431532;201606;498;1374;403;1173;86;262;166;474;252;736
431535;201606;349;909;153;470;27;98;47;120;74;218
431540;201606;2052;6744;1805;6374;189;738;1200;4421;1389;5159
431545;201606;341;946;49;162;7;22;5;16;12;38
431550;201606;2249;6561;1967;6055;442;1556;881;2611;1323;4167
431555;201606;698;1737;516;1445;63;175;318;920;381;1095
431560;201606;20474;60190;14553;48941;3614;13623;3327;11983;6941;25606
431570;201606;5870;15030;4700;13521;1240;3733;2138;6322;3378;10055
431575;201606;412;1047;299;872;53;184;72;189;125;373
431580;201606;624;1761;384;1257;79;278;110;347;189;625
431590;201606;969;2614;596;1876;117;374;184;604;301;978
431595;201606;446;1260;353;1069;39;114;221;682;260;796
431600;201606;2026;5538;1459;4531;336;1233;356;1061;692;2294
431610;201606;1485;4230;1073;3431;187;621;444;1451;631;2072
431620;201606;487;1429;248;787;60;190;96;280;156;470
431630;201606;1424;3824;890;2712;246;783;265;786;511;1569
431640;201606;6231;17380;5552;16390;1091;3487;3309;9854;4400;13341
431642;201606;514;1374;390;1151;50;169;180;513;230;682
431643;201606;324;863;167;489;28;85;55;139;83;224
431645;201606;1732;4920;1470;4466;260;908;875;2619;1135;3527
431647;201606;154;445;103;337;17;64;17;47;34;111
431650;201606;333;1009;231;788;40;170;62;188;102;358
431660;201606;1160;3251;721;2364;150;543;152;456;302;999
431670;201606;1272;3343;943;2761;214;716;384;1053;598;1769
431673;201606;232;643;117;384;24;84;16;45;40;129
431675;201606;632;1662;143;480;20;76;35;108;55;184
431680;201606;9768;26416;7371;22039;2022;6504;1925;5868;3947;12372
431690;201606;23581;65253;18453;56716;5066;16613;6253;20046;11319;36659
431695;201606;140;431;98;325;21;76;24;57;45;133
431697;201606;452;1293;399;1192;102;328;200;609;302;937
431700;201606;1557;4416;1331;3993;213;696;741;2184;954;2880
431710;201606;12579;36087;10273;32444;3365;11450;2582;8992;5947;20442
431720;201606;7162;19680;5407;16324;1225;3978;1847;5507;3072;9485
431725;201606;25;75;12;45;3;13;3;9;6;22
431730;201606;3926;11358;3108;9927;786;2779;871;2956;1657;5735
431740;201606;5291;14624;4192;12674;1397;4666;748;2097;2145;6763
431750;201606;9049;25534;7823;23563;1747;5788;3764;11453;5511;17241
431755;201606;334;911;81;275;14;44;16;54;30;98
431760;201606;3959;11205;3193;9831;683;2343;1360;3981;2043;6324
431770;201606;2031;5368;1668;4820;284;867;986;2842;1270;3709
431775;201606;210;563;134;415;40;130;14;36;54;166
431780;201606;2447;6579;1828;5419;499;1583;420;1163;919;2746
431790;201606;1178;3524;938;3031;168;605;396;1266;564;1871
431795;201606;378;1012;223;670;34;101;73;221;107;322
431800;201606;8700;25461;6921;22146;2308;8123;1093;3408;3401;11531
431805;201606;341;840;108;364;21;80;18;62;39;142
431810;201606;3236;8847;2493;7407;476;1543;1102;3218;1578;4761
431820;201606;2523;7799;2170;7117;478;1730;902;2880;1380;4610
431830;201606;10886;26384;8431;22779;2256;6609;3339;9206;5595;15815
431840;201606;2666;7974;2299;7344;554;1922;1044;3388;1598;5310
431842;201606;807;2036;336;1032;49;168;78;214;127;382
431843;201606;353;1023;291;909;40;150;143;428;183;578
431844;201606;290;792;90;297;25;90;17;49;42;139
431845;201606;492;1437;374;1188;24;84;236;757;260;841
431846;201606;326;997;281;929;27;101;198;661;225;762
431848;201606;251;673;144;459;16;58;33;94;49;152
431849;201606;477;1166;102;307;19;58;17;41;36;99
431850;201606;4792;13951;4165;12745;966;3137;1589;4879;2555;8016
431860;201606;786;2063;570;1669;87;293;275;763;362;1056
431861;201606;101;291;55;188;9;34;9;23;18;57
431862;201606;479;1563;388;1396;107;449;127;434;234;883
431870;201606;18233;52502;14509;45836;3592;12384;5012;16025;8604;28409
431880;201606;4302;12743;3449;10981;825;2928;1209;3709;2034;6637
431890;201606;5100;13764;3698;11256;1149;3720;891;2889;2040;6609
431900;201606;1098;3049;718;2274;178;650;284;829;462;1479
431910;201606;1027;2456;495;1425;76;232;142;379;218;611
431912;201606;500;1448;410;1286;115;351;162;524;277;875
431915;201606;1298;3499;1000;2967;232;723;388;1173;620;1896
431920;201606;1297;3640;1118;3354;137;431;786;2346;923;2777
431930;201606;1248;3391;866;2755;199;613;427;1439;626;2052
431935;201606;51;158;43;140;10;38;14;43;24;81
431936;201606;386;1111;283;882;69;214;119;385;188;599
431937;201606;335;866;185;559;38;130;35;98;73;228
431940;201606;2559;6929;1691;5215;384;1304;450;1368;834;2672
431950;201606;1615;4914;1416;4553;281;1026;706;2212;987;3238
431960;201606;2893;8315;2522;7612;712;2273;820;2498;1532;4771
431970;201606;487;1338;226;753;42;152;45;138;87;290
431971;201606;95;277;58;203;7;28;13;41;20;69
431973;201606;466;1600;410;1486;59;212;259;982;318;1194
431975;201606;108;253;24;90;5;22;6;20;11;42
431980;201606;1383;4020;1110;3481;273;911;363;1104;636;2015
431990;201606;7386;20295;5452;17134;1102;4009;1708;5145;2810;9154
432000;201606;10014;27841;7954;24334;2450;7831;2766;8552;5216;16383
432010;201606;2218;6215;1796;5466;375;1245;839;2532;1214;3777
432020;201606;2318;5549;1709;4704;262;789;1100;2974;1362;3763
432023;201606;514;1446;334;1048;70;251;115;314;185;565
432026;201606;1198;3603;882;2943;127;434;461;1522;588;1956
432030;201606;417;1201;302;943;62;193;147;449;209;642
432032;201606;602;1539;393;1165;69;231;171;462;240;693
432035;201606;829;2489;733;2322;257;894;263;855;520;1749
432040;201606;972;2256;430;1351;72;248;139;430;211;678
432045;201606;249;700;143;491;26;92;43;145;69;237
432050;201606;641;1769;548;1608;77;250;317;955;394;1205
432055;201606;952;2683;678;2191;129;445;363;1153;492;1598
432057;201606;412;995;303;815;50;128;183;483;233;611
432060;201606;548;1448;206;703;37;148;45;133;82;281
432065;201606;223;639;168;541;45;158;66;200;111;358
432067;201606;970;2966;718;2434;133;461;343;1177;476;1638
432070;201606;2359;6508;1551;4869;331;1156;323;964;654;2120
432080;201606;3773;10591;3161;9539;939;3087;1137;3459;2076;6546
432085;201606;317;882;206;701;54;193;98;327;152;520
432090;201606;1472;4182;1139;3540;310;1035;445;1332;755;2367
432100;201606;1345;3866;658;2241;113;405;42;110;155;515
432110;201606;2674;8023;1978;6612;522;2004;225;706;747;2710
432120;201606;4747;13914;3979;12611;1420;4823;1143;3614;2563;8437
432130;201606;2707;7412;2177;6740;654;2224;907;2880;1561;5104
432132;201606;393;1096;187;638;33;121;53;178;86;299
432135;201606;721;2169;643;2017;94;321;448;1396;542;1717
432140;201606;1918;6091;1508;5295;345;1259;634;2364;979;3623
432143;201606;1387;4039;1155;3650;223;743;561;1856;784;2599
432145;201606;1267;3827;786;2723;145;573;128;407;273;980
432146;201606;176;570;125;451;30;116;28;103;58;219
432147;201606;646;2034;484;1680;142;514;138;511;280;1025
432149;201606;366;1013;234;705;45;133;89;270;134;403
432150;201606;3708;10330;2781;8670;588;2040;871;2667;1459;4707
432160;201606;4508;14043;3911;12973;1187;4170;1408;4843;2595;9013
432162;201606;411;982;72;218;14;44;12;32;26;76
432163;201606;368;984;96;305;8;25;3;7;11;32
432166;201606;675;1986;555;1745;86;331;259;772;345;1103
432170;201606;1131;3473;775;2715;186;678;148;500;334;1178
432180;201606;2790;7437;1810;5540;473;1527;412;1195;885;2722
432183;201606;415;1284;322;1091;132;477;68;232;200;709
432185;201606;902;2398;577;1812;114;383;258;813;372;1196
432190;201606;3335;9036;2159;6510;488;1553;609;1734;1097;3287
432195;201606;1124;3010;840;2559;155;475;433;1301;588;1776
432200;201606;3084;9150;2457;8085;618;2244;1084;3595;1702;5839
432210;201606;426;1163;308;968;72;261;123;369;195;630
432215;201606;847;2563;719;2359;157;483;404;1412;561;1895
432218;201606;276;700;173;501;30;89;62;155;92;244
432220;201606;4235;11148;3453;9904;445;1509;2093;5835;2538;7344
432225;201606;93;288;74;250;23;87;24;81;47;168
432230;201606;1048;2802;632;1893;142;464;160;408;302;872
432232;201606;522;1464;411;1248;75;258;172;508;247;766
432234;201606;365;1012;238;739;53;170;64;191;117;361
432235;201606;109;310;37;125;7;25;1;1;8;26
432237;201606;469;1259;418;1172;20;85;306;833;326;918
432240;201606;13960;43229;11638;40194;1762;7212;6928;24812;8690;32024
432250;201606;4742;16029;4274;15099;1373;5224;1414;5131;2787;10355
432252;201606;410;1099;279;889;56;187;144;479;200;666
432253;201606;1322;4156;772;2695;190;729;70;244;260;973
432254;201606;866;2330;248;817;52;193;28;76;80;269
432255;201606;196;531;120;395;21;81;42;126;63;207
432260;201606;7681;18999;5365;15251;1143;3317;2242;6736;3385;10053
432270;201606;2592;7628;2160;6873;643;2144;705;2308;1348;4452
432280;201606;1404;3798;749;2380;135;465;160;460;295;925
432285;201606;195;610;27;99;4;16;2;4;6;20
432290;201606;569;1649;359;1175;92;296;93;303;185;599
432300;201606;23686;69611;20610;64357;3816;13058;11845;36749;15661;49807
432310;201606;819;2365;641;2065;161;558;321;1012;482;1570
432320;201606;222;562;111;345;20;65;21;56;41;121
432330;201606;333;873;129;422;21;75;14;36;35;111
432335;201606;151;434;62;223;11;44;12;31;23;75
432340;201606;311;756;164;499;30;105;51;148;81;253
432345;201606;645;1772;590;1683;84;319;372;975;456;1294
432350;201606;393;1065;207;683;35;112;56;180;91;292
432360;201606;189;579;42;148;8;38;8;21;16;59
432370;201606;426;1184;336;1013;34;106;210;648;244;754
432375;201606;765;1898;572;1585;78;215;334;940;412;1155
432377;201606;192;628;38;145;7;32;8;20;15;52
432380;201606;917;2961;772;2676;263;1005;299;1012;562;2017
500020;201606;2299;6743;1744;5785;395;1531;709;2281;1104;3812
500025;201606;1375;3180;843;2271;96;263;474;1260;570;1523
500060;201606;6952;20517;5494;18053;726;2493;3504;11972;4230;14465
500070;201606;4409;12522;3464;10845;758;2697;1447;4557;2205;7254
500080;201606;1484;4337;1104;3638;293;1080;388;1277;681;2357
500085;201606;2264;5789;1581;4792;156;512;959;2835;1115;3347
500090;201606;2373;6750;1711;5553;368;1257;743;2548;1111;3805
500100;201606;2691;7714;2238;6943;502;1796;880;2636;1382;4432
500110;201606;8322;24297;6564;21578;1223;4375;3075;10795;4298;15170
500124;201606;2044;6470;1764;6003;400;1286;920;3486;1320;4772
500150;201606;1415;3563;973;2839;201;696;365;935;566;1631
500190;201606;4928;12612;3791;11071;747;2388;2028;6065;2775;8453
500200;201606;2449;6140;1852;5077;398;1172;754;1949;1152;3121
500210;201606;4789;14180;3971;12898;933;3224;1849;6183;2782;9407
500215;201606;1544;4734;1195;4048;216;805;449;1526;665;2331
500220;201606;3024;9369;2500;8470;500;1802;1127;3941;1627;5743
500230;201606;2810;7116;1988;5822;411;1288;947;2851;1358;4139
500240;201606;4584;14270;3302;11637;626;2399;1008;3810;1634;6209
500260;201606;2764;6977;1992;5821;323;1066;997;2802;1320;3868
500270;201606;125021;319038;79242;239934;19009;63030;18226;55298;37235;118328
500280;201606;1378;3476;1136;3156;79;232;893;2528;972;2760
500290;201606;4545;10265;2603;7473;528;1702;925;2642;1453;4344
500295;201606;2705;7823;1666;5521;300;1112;388;1092;688;2204
500310;201606;781;2034;640;1833;143;485;325;890;468;1375
500315;201606;3097;9614;2541;8709;384;1358;1572;5633;1956;6991
500320;201606;17184;54547;13512;47733;4048;15595;3741;14146;7789;29741
500325;201606;4110;10477;2986;8736;573;1783;1598;4761;2171;6544
500330;201606;6796;17686;4695;13858;799;2653;2070;6041;2869;8694
500345;201606;2190;5670;1690;4915;382;1196;808;2365;1190;3561
500348;201606;2277;6564;1969;6083;153;578;1415;4328;1568;4906
500350;201606;1280;3744;718;2434;94;326;224;767;318;1093
500370;201606;23744;70637;17929;60166;4086;15539;5230;17856;9316;33395
500375;201606;2904;7931;2149;6496;453;1483;621;1840;1074;3323
500380;201606;3100;8564;2446;7434;615;1974;1007;3094;1622;5068
500390;201606;584;1299;337;920;56;184;169;424;225;608
500400;201606;1367;4107;1007;3256;260;926;243;729;503;1655
500410;201606;2215;6179;1787;5555;357;1196;918;2944;1275;4140
500430;201606;2682;7348;1998;6375;397;1426;820;2764;1217;4190
500440;201606;1493;3918;1001;3068;170;569;455;1408;625;1977
500450;201606;1671;4909;1186;3978;282;1049;198;582;480;1631
500460;201606;3744;11156;2799;9334;792;2919;594;1946;1386;4865
500470;201606;3084;8945;2133;6927;586;2114;346;1045;932;3159
500480;201606;2258;6755;2075;6537;197;586;1587;5414;1784;6000
500490;201606;978;2672;721;2232;219;771;174;565;393;1336
500500;201606;3896;11749;3011;10442;996;3935;1044;3780;2040;7715
500510;201606;857;2209;542;1651;78;276;230;641;308;917
500515;201606;1899;5026;1565;4595;217;655;929;2983;1146;3638
500520;201606;3183;10834;2827;10218;413;1690;1809;6588;2222;8278
500525;201606;1195;3729;949;3265;171;664;454;1633;625;2297
500540;201606;6337;17153;3743;12328;1005;3880;494;1470;1499;5350
500560;201606;4693;15234;4242;14538;511;1952;3029;10456;3540;12408
500568;201606;4346;10532;2932;8444;603;2118;980;2667;1583;4785
500570;201606;7786;20480;5017;15311;1346;4464;1009;3034;2355;7498
500580;201606;3726;10404;2976;9204;301;976;2137;6741;2438;7717
500600;201606;3947;10414;2564;7861;623;2086;716;2223;1339;4309
500620;201606;7759;22091;5876;18542;1051;3563;2457;7925;3508;11488
500625;201606;773;2238;428;1446;79;282;142;487;221;769
500627;201606;593;1656;417;1320;84;273;111;372;195;645
500630;201606;6085;16422;4336;13503;1127;3837;1355;4152;2482;7989
500635;201606;2736;10046;2241;9278;302;1241;1538;6892;1840;8133
500640;201606;1665;3969;1261;3401;98;316;911;2416;1009;2732
500660;201606;19352;54830;14920;47753;4589;16450;4642;14933;9231;31383
500690;201606;2572;7522;2070;6816;935;3194;581;2133;1516;5327
500710;201606;3531;10364;2939;9377;707;2532;1240;3965;1947;6497
500720;201606;6172;16230;3898;12327;1017;3539;839;2661;1856;6200
500730;201606;994;2724;678;2109;166;548;211;638;377;1186
500740;201606;4316;11602;3438;9988;427;1531;1582;4722;2009;6253
500750;201606;955;2614;793;2357;154;527;417;1199;571;1726
500755;201606;1203;3504;808;2702;191;697;170;470;361;1167
500769;201606;5441;14253;3102;9505;584;2006;616;1668;1200;3674
500770;201606;1738;5018;1227;4049;323;1177;318;1082;641;2259
500780;201606;1132;3211;881;2766;229;757;248;782;477;1539
500790;201606;9881;26673;8123;23739;1426;4705;4385;12681;5811;17386
500793;201606;2252;6402;1707;5459;486;1641;349;994;835;2635
500795;201606;2392;7026;2023;6503;242;687;1428;4918;1670;5605
500797;201606;838;2258;576;1800;108;378;219;659;327;1037
500800;201606;2934;7739;2223;6718;786;2686;594;1909;1380;4595
500830;201606;19641;51844;13713;41015;2772;9253;4705;13534;7477;22787
500840;201606;1332;3690;889;2802;130;451;342;1035;472;1486
510010;201606;1255;3688;1027;3324;257;844;534;1769;791;2613
510020;201606;3405;9537;2096;6931;523;1894;495;1546;1018;3440
510025;201606;7610;22013;5676;18362;1379;4901;1623;4988;3002;9889
510030;201606;1685;4515;1368;4030;260;869;700;2016;960;2885
510035;201606;843;2399;619;2071;112;402;356;1224;468;1626
510040;201606;1757;4757;1358;4149;228;737;745;2310;973;3047
510050;201606;1865;5362;1342;4366;357;1283;415;1323;772;2606
510060;201606;1594;4494;1205;3768;234;799;490;1500;724;2299
510080;201606;1056;3333;828;2881;270;1030;134;410;404;1440
510100;201606;683;1779;480;1373;45;155;242;646;287;801
510120;201606;308;663;197;522;13;44;133;354;146;398
510125;201606;3146;8180;2384;6860;409;1405;948;2566;1357;3971
510130;201606;1762;4847;1435;4299;389;1279;477;1411;866;2690
510140;201606;2836;8954;2240;8054;1001;4014;456;1464;1457;5478
510160;201606;1310;4379;1192;4203;185;701;784;2777;969;3478
510170;201606;5178;15571;4226;13931;835;3075;1953;6330;2788;9405
510180;201606;12333;31734;8505;25707;2393;7713;2595;8931;4988;16644
510185;201606;1348;3975;1112;3647;146;470;718;2620;864;3090
510190;201606;2348;6699;1659;5665;301;1129;819;2975;1120;4104
510250;201606;13817;41494;11850;38554;3656;12725;4544;15518;8200;28243
510260;201606;2149;8836;1816;8176;386;1663;919;4805;1305;6468
510263;201606;4100;10912;3007;9173;786;2613;792;2332;1578;4945
510267;201606;5689;16356;3945;12674;883;3131;954;2928;1837;6059
510268;201606;869;2524;740;2344;142;501;427;1350;569;1851
510269;201606;1004;3065;735;2551;263;956;164;567;427;1523
510270;201606;2730;8796;2248;7822;482;1745;877;3009;1359;4754
510279;201606;1818;5564;1468;4843;400;1411;454;1377;854;2788
510285;201606;1254;3644;965;3154;272;967;300;953;572;1920
510300;201606;3352;9668;2750;8817;224;841;2042;6639;2266;7480
510305;201606;1509;4658;1170;4039;288;1077;378;1335;666;2412
510310;201606;777;2369;647;2126;228;778;197;644;425;1422
510320;201606;3594;10205;2791;8766;584;2184;863;2619;1447;4803
510325;201606;5177;16143;4368;15052;1027;3604;2659;9659;3686;13263
510330;201606;2715;8502;2145;7481;593;2232;720;2575;1313;4807
510335;201606;4915;14599;3961;13409;487;1642;2752;9885;3239;11527
510336;201606;590;1813;436;1524;86;323;213;747;299;1070
510337;201606;2035;6626;1615;5826;652;2468;306;1190;958;3658
510340;201606;76683;203507;53223;166752;17436;61139;10292;34360;27728;95499
510343;201606;1119;3193;873;2745;112;367;544;1731;656;2098
510345;201606;1614;4766;1290;4203;319;1153;475;1509;794;2662
510350;201606;3203;8619;2418;7518;585;1937;1108;3632;1693;5569
510360;201606;1763;4303;1114;3514;116;458;772;2403;888;2861
510370;201606;1266;4132;1041;3771;229;857;576;2220;805;3077
510380;201606;525;1529;305;1067;96;361;29;101;125;462
510385;201606;940;3539;691;2975;104;480;310;1491;414;1971
510390;201606;1089;3421;975;3242;249;698;573;2098;822;2796
510395;201606;771;1887;553;1573;78;260;234;760;312;1020
510410;201606;3785;12165;3275;11195;827;2917;1628;5786;2455;8703
510420;201606;2417;6080;1792;5066;192;674;944;2641;1136;3315
510450;201606;647;1695;452;1392;109;385;135;413;244;798
510452;201606;656;2079;492;1702;82;318;268;924;350;1242
510454;201606;842;2648;717;2414;101;369;479;1638;580;2007
510455;201606;974;2990;728;2464;142;557;253;821;395;1378
510460;201606;2289;5928;1717;5121;210;744;968;2803;1178;3547
510480;201606;4473;11656;3191;9373;673;2104;1020;2868;1693;4972
510490;201606;1591;4907;1341;4529;291;1134;739;2442;1030;3576
510500;201606;1520;4501;1035;3547;230;924;446;1475;676;2399
510510;201606;2652;9085;2266;8390;715;2858;665;2569;1380;5427
510515;201606;6217;18653;4505;14947;1085;4009;1048;3321;2133;7330
510517;201606;1618;4824;1312;4253;378;1267;332;1084;710;2351
510520;201606;2112;4829;1511;4095;49;141;1027;3016;1076;3157
510523;201606;1000;2933;880;2724;106;317;634;2040;740;2357
510525;201606;8061;20942;5481;16925;1157;3740;1972;6104;3129;9844
510530;201606;522;1485;438;1367;52;233;289;853;341;1086
510550;201606;2746;8843;2139;7654;602;2315;734;2686;1336;5001
510558;201606;1883;5392;1602;4993;227;771;916;3005;1143;3776
510560;201606;1688;5069;1090;4071;320;1332;243;939;563;2271
510562;201606;5372;15685;4080;13126;1164;4054;1028;3479;2192;7533
510590;201606;3042;8047;2535;7411;468;1383;1509;4647;1977;6030
510600;201606;1609;4113;1065;3213;210;682;396;1178;606;1860
510610;201606;2924;8228;2347;7358;246;923;1550;4855;1796;5778
510615;201606;2050;6191;1713;5642;513;1763;769;2654;1282;4417
510617;201606;607;1779;504;1605;29;85;406;1344;435;1429
510618;201606;1471;4202;1067;3436;194;733;497;1565;691;2298
510619;201606;801;2216;482;1608;60;227;56;149;116;376
510620;201606;1416;3532;789;2543;207;742;110;334;317;1076
510621;201606;855;2952;769;2776;208;839;227;783;435;1622
510622;201606;3846;11659;2731;9314;768;2857;437;1384;1205;4241
510623;201606;3250;9256;2563;8050;690;2421;924;2749;1614;5170
510624;201606;1494;4325;930;3156;202;777;193;619;395;1396
510625;201606;2069;5781;1575;4957;458;1619;297;961;755;2580
510626;201606;1578;4180;1026;3401;333;1241;244;842;577;2083
510627;201606;721;2058;484;1549;129;463;107;336;236;799
510628;201606;1551;3825;1089;3186;145;430;718;2127;863;2557
510629;201606;1782;5756;1433;4997;437;1666;454;1579;891;3245
510630;201606;2483;8350;1792;6870;468;1944;292;1190;760;3134
510631;201606;362;1024;311;941;21;54;244;745;265;799
510637;201606;2693;7865;2313;7265;716;2466;848;2668;1564;5134
510642;201606;4683;15386;4037;14457;1143;4496;1820;6842;2963;11338
510645;201606;968;2178;619;1710;195;541;179;527;374;1068
510650;201606;6298;20707;5670;19975;1383;5054;3576;13203;4959;18257
510665;201606;1726;4464;1038;3204;193;634;386;1233;579;1867
510670;201606;401;903;226;656;28;107;107;303;135;410
510675;201606;6441;20031;5123;17465;1551;5828;1225;4191;2776;10019
510677;201606;1915;5209;1583;4784;181;550;1173;3733;1354;4283
510680;201606;715;2145;522;1751;138;496;93;291;231;787
510682;201606;2107;6667;1631;5757;496;1989;324;1113;820;3102
510685;201606;948;2516;758;2239;80;288;493;1421;573;1709
510700;201606;4297;11031;2903;9080;626;2018;1377;4483;2003;6501
510704;201606;9578;25257;7503;21871;1466;4777;3374;9471;4840;14248
510706;201606;1888;5592;1291;4701;291;1074;669;2611;960;3685
510710;201606;3344;9187;2346;7190;565;1824;655;1881;1220;3705
510715;201606;718;1751;474;1332;88;261;182;529;270;790
510718;201606;2325;5761;1516;4811;684;2249;352;1314;1036;3563
510719;201606;405;935;258;741;24;90;126;358;150;448
510720;201606;1148;2793;835;2365;223;718;303;768;526;1486
510724;201606;716;2153;554;1854;119;440;225;715;344;1155
510726;201606;622;1534;477;1313;75;239;277;706;352;945
510729;201606;727;1821;405;1225;95;326;133;398;228;724
510730;201606;2742;7823;2020;6511;550;1951;540;1725;1090;3676
510735;201606;997;3275;769;2920;169;709;384;1492;553;2201
510740;201606;1092;2685;787;2230;146;400;413;1237;559;1637
510757;201606;701;2317;579;2086;272;1008;158;566;430;1574
510760;201606;31871;80919;21348;63951;6101;20243;4673;13729;10774;33972
510770;201606;4245;10847;3607;10073;353;948;2414;7480;2767;8428
510774;201606;351;983;317;930;62;189;164;528;226;717
510775;201606;710;2085;582;1863;185;663;161;475;346;1138
510776;201606;536;1470;418;1233;97;313;177;514;274;827
510777;201606;1590;4647;1175;4095;117;432;940;3331;1057;3763
510779;201606;631;1893;482;1612;79;271;228;800;307;1071
510780;201606;3722;10939;3024;9877;750;2559;1241;4412;1991;6971
510785;201606;1745;5051;1279;4231;411;1420;250;874;661;2294
510787;201606;2270;6749;1784;5914;792;2789;339;1099;1131;3888
510788;201606;565;1445;405;1214;137;409;119;439;256;848
510790;201606;15936;45871;10886;36362;2459;9522;1199;4172;3658;13694
510792;201606;8130;23647;5573;18826;1224;4655;895;2930;2119;7585
510794;201606;1201;3731;963;3267;306;1161;278;908;584;2069
510795;201606;8118;24038;5952;20043;1707;6359;1249;4525;2956;10884
510800;201606;1572;4386;1239;3904;298;1025;530;1573;828;2598
510805;201606;1961;5409;1493;4669;289;1015;766;2319;1055;3334
510810;201606;650;1586;498;1377;131;365;239;645;370;1010
510820;201606;729;1711;477;1335;81;278;190;471;271;749
510830;201606;689;2068;559;1869;126;445;294;1057;420;1502
510835;201606;633;1869;481;1587;110;409;191;597;301;1006
510840;201606;46994;116931;37239;104278;8851;26346;17533;50867;26384;77213
510850;201606;1517;4299;1042;3421;285;1019;156;475;441;1494
510860;201606;2653;8182;1902;6722;701;2765;152;525;853;3290
510880;201606;624;2057;531;1892;146;559;225;831;371;1390
510885;201606;641;1794;515;1621;102;357;208;655;310;1012
510890;201606;842;2622;686;2392;173;677;340;1184;513;1861
510895;201606;1089;3332;913;2991;224;842;373;1158;597;2000
520005;201606;1446;4575;1282;4337;324;1103;665;2364;989;3467
520010;201606;1727;5749;1399;5079;547;2282;258;841;805;3123
520013;201606;3391;9453;2505;7792;581;1890;827;2626;1408;4516
520015;201606;471;1339;380;1209;99;352;135;439;234;791
520017;201606;1058;3111;878;2814;212;765;358;1081;570;1846
520020;201606;454;1156;347;1009;77;243;155;440;232;683
520025;201606;26847;82471;25186;80481;2797;9700;20089;64303;22886;74003
520030;201606;4657;14356;3888;13094;720;2684;2027;6929;2747;9613
520050;201606;424;1067;291;856;22;60;182;561;204;621
520055;201606;749;2257;660;2072;111;328;373;1215;484;1543
520060;201606;1350;4206;1150;3814;273;1038;423;1340;696;2378
520080;201606;1827;5275;1528;4890;283;870;895;3071;1178;3941
520082;201606;1083;2915;957;2716;114;279;653;1938;767;2217
520085;201606;832;2502;722;2311;172;554;251;800;423;1354
520090;201606;980;2257;707;1920;137;317;382;1156;519;1473
520110;201606;41791;120015;32404;105850;12346;45964;5257;17170;17603;63134
520120;201606;189;496;123;384;22;80;35;114;57;194
520130;201606;3430;9576;3099;9102;610;1970;1698;5147;2308;7117
520140;201606;37174;119303;31614;109114;11849;44643;5599;19472;17448;64115
520145;201606;362;987;253;790;54;179;79;244;133;423
520150;201606;471;1229;380;1126;59;196;214;633;273;829
520160;201606;886;2379;718;2129;220;674;210;644;430;1318
520170;201606;4369;9970;3406;8873;238;652;2804;7469;3042;8121
520180;201606;2089;6084;1728;5544;317;1205;891;2835;1208;4040
520215;201606;1952;4968;1614;4445;171;491;1076;3025;1247;3516
520235;201606;694;1793;504;1507;96;332;221;634;317;966
520250;201606;1537;4360;1139;3710;311;1141;269;879;580;2020
520260;201606;784;1980;517;1485;75;239;189;511;264;750
520280;201606;562;1623;496;1537;164;516;207;725;371;1241
520310;201606;1209;2885;848;2306;222;660;298;886;520;1546
520320;201606;1869;5767;1537;5146;125;439;1007;3457;1132;3896
520330;201606;2706;8242;2066;7157;595;2257;343;1178;938;3435
520340;201606;1825;4586;1397;4025;199;502;928;2883;1127;3385
520350;201606;3245;8809;2509;7492;666;2183;946;2789;1612;4972
520355;201606;1069;3518;957;3346;304;1193;415;1400;719;2593
520357;201606;862;2324;719;2088;73;236;498;1459;571;1695
520360;201606;681;1974;580;1805;155;512;235;758;390;1270
520380;201606;1297;3476;874;2657;135;438;372;1112;507;1550
520390;201606;1096;2566;639;1965;192;701;212;593;404;1294
520393;201606;507;1226;398;1073;55;164;245;646;300;810
520396;201606;697;2239;571;1990;78;318;358;1219;436;1537
520400;201606;1673;4777;1425;4423;259;873;887;2738;1146;3611
520410;201606;1503;3621;1089;3042;217;693;590;1622;807;2315
520420;201606;324;895;236;716;44;151;83;227;127;378
520425;201606;1141;3160;943;2800;263;790;439;1347;702;2137
520430;201606;1892;5002;1170;3638;281;906;198;565;479;1471
520440;201606;3710;9507;2493;7337;748;2423;537;1594;1285;4017
520450;201606;10573;28931;7199;22792;1653;5784;505;1572;2158;7356
520455;201606;669;1981;535;1754;155;546;207;684;362;1230
520460;201606;883;2482;725;2222;121;445;410;1223;531;1668
520465;201606;813;2254;702;2117;92;313;458;1367;550;1680
520470;201606;1758;5625;1574;5336;300;1038;1032;3640;1332;4678
520480;201606;948;2730;657;2188;124;453;215;646;339;1099
520485;201606;1307;4087;1135;3824;269;1019;653;2194;922;3213
520490;201606;4026;12441;3198;11154;792;2823;1623;5984;2415;8807
520495;201606;1347;3582;1138;3317;85;261;900;2712;985;2973
520500;201606;1305;3663;1082;3348;265;916;491;1500;756;2416
520505;201606;738;2091;629;1920;109;320;354;1101;463;1421
520510;201606;8988;25033;6468;21094;1632;5932;2145;7210;3777;13142
520520;201606;1076;2965;854;2647;264;875;266;857;530;1732
520530;201606;1992;6485;1627;5867;555;2007;528;2129;1083;4136
520540;201606;2844;7953;2083;6533;574;1925;387;1252;961;3177
520545;201606;1079;3225;894;2888;182;651;288;879;470;1530
520547;201606;656;2062;566;1893;199;674;190;620;389;1294
520549;201606;9530;27875;7959;25758;2276;7713;3763;12570;6039;20283
520551;201606;3596;10901;3307;10492;776;2730;2069;6524;2845;9254
520552;201606;769;2295;692;2197;112;370;487;1583;599;1953
520570;201606;563;1583;419;1343;138;490;143;433;281;923
520580;201606;3222;7879;2248;6539;493;1610;1125;3292;1618;4902
520590;201606;1383;3905;1059;3355;268;888;231;738;499;1626
520620;201606;7617;23029;6806;21917;1617;5419;3935;12904;5552;18323
520630;201606;923;2368;663;1987;97;300;295;891;392;1191
520640;201606;2788;7633;2280;6788;597;1835;927;2872;1524;4707
520650;201606;845;2251;621;1841;116;401;338;986;454;1387
520660;201606;348;987;273;887;102;371;91;298;193;669
520670;201606;938;2756;845;2626;56;198;676;2080;732;2278
520680;201606;753;1963;595;1729;150;440;269;801;419;1241
520690;201606;319;855;244;737;59;156;115;365;174;521
520710;201606;547;1416;342;1021;9;24;206;616;215;640
520725;201606;1590;4076;1184;3401;181;571;739;2124;920;2695
520735;201606;784;2162;562;1743;132;465;189;572;321;1037
520740;201606;1656;4523;1322;4106;258;906;701;2168;959;3074
520750;201606;600;1613;479;1430;98;287;237;757;335;1044
520753;201606;1464;3945;1316;3745;149;404;908;2780;1057;3184
520760;201606;813;2153;713;2023;72;203;521;1552;593;1755
520780;201606;1927;4692;1500;4107;149;432;990;2706;1139;3138
520790;201606;2807;7184;2199;6315;212;580;1580;4777;1792;5357
520800;201606;16006;45149;13780;42524;2568;7706;8786;28901;11354;36607
520810;201606;1038;2574;826;2322;84;228;630;1883;714;2111
520815;201606;585;1849;431;1518;187;747;26;82;213;829
520830;201606;1648;4200;1337;3858;54;172;1148;3307;1202;3479
520840;201606;1634;5251;1379;4816;554;2082;302;1127;856;3209
520850;201606;592;1807;443;1543;122;489;144;500;266;989
520860;201606;6581;19241;4961;16576;1237;4498;1730;5967;2967;10465
520870;201606;101890;270606;71679;222219;21118;72696;16360;50047;37478;122743
520880;201606;6957;19908;5262;17460;2039;7489;717;2434;2756;9923
520890;201606;3837;10721;3067;9452;618;2112;1523;4698;2141;6810
520910;201606;3874;11078;2805;9053;985;3429;538;1681;1523;5110
520915;201606;649;1932;527;1698;117;405;247;797;364;1202
520920;201606;3463;9244;2482;7723;479;1639;1008;3260;1487;4899
520929;201606;589;1572;458;1373;83;228;255;821;338;1049
520940;201606;1066;3038;857;2731;107;398;615;1944;722;2342
520945;201606;651;1569;520;1358;114;264;267;695;381;959
520960;201606;1031;3003;808;2587;85;285;414;1369;499;1654
520970;201606;2852;8592;2460;7905;685;2422;667;2106;1352;4528
520980;201606;756;2171;666;2038;189;626;371;1137;560;1763
520990;201606;2961;9463;2786;9225;383;1338;1931;6703;2314;8041
520993;201606;925;2356;739;2092;50;155;544;1572;594;1727
520995;201606;2313;6090;2017;5743;313;818;1430;4236;1743;5054
521000;201606;6993;21024;5708;18625;1948;7080;1450;4528;3398;11608
521010;201606;3989;11538;3127;9986;793;2564;1231;3989;2024;6553
521015;201606;689;1893;590;1739;117;344;359;1070;476;1414
521020;201606;3006;8609;2081;6707;635;2231;242;752;877;2983
521030;201606;663;1662;497;1384;92;245;208;613;300;858
521040;201606;6072;16349;5088;14886;1563;4726;1893;5874;3456;10600
521056;201606;855;2594;710;2360;233;832;250;907;483;1739
521060;201606;1118;2893;898;2563;152;434;489;1477;641;1911
521080;201606;1143;2724;675;1971;81;293;263;665;344;958
521090;201606;2948;7896;2311;7074;727;2337;724;2322;1451;4659
521100;201606;1987;4440;1508;3863;223;540;1029;2764;1252;3304
521120;201606;4597;12041;3579;10735;717;2257;1688;5408;2405;7665
521130;201606;1021;2748;763;2264;108;396;440;1291;548;1687
521140;201606;1035;3123;845;2764;215;745;292;981;507;1726
521150;201606;12087;30184;7719;22655;2670;8329;1867;5696;4537;14025
521160;201606;847;1989;537;1467;102;298;236;631;338;929
521170;201606;1144;2793;860;2380;152;440;507;1383;659;1823
521180;201606;6416;20636;5767;19527;1702;6160;1988;6836;3690;12996
521190;201606;9350;26653;6270;20950;1663;6178;1321;4417;2984;10595
521200;201606;752;2063;610;1827;77;257;367;1095;444;1352
521205;201606;607;1708;471;1464;40;140;272;848;312;988
521210;201606;929;2571;602;1915;184;683;125;336;309;1019
521220;201606;4337;10989;3246;9568;724;2383;1546;4649;2270;7032
521225;201606;380;932;312;857;28;72;230;664;258;736
521230;201606;1167;3703;1072;3523;317;1109;555;1807;872;2916
521250;201606;28920;90075;25122;84365;10547;37289;7304;25841;17851;63130
521260;201606;701;1686;577;1514;101;302;323;834;424;1136
521270;201606;1886;5372;1715;5140;158;409;1293;4054;1451;4463
521280;201606;1819;5496;1485;4855;458;1608;438;1403;896;3011
521290;201606;496;1371;369;1177;98;367;170;518;268;885
521295;201606;1182;2885;984;2619;102;259;727;2011;829;2270
521300;201606;1921;5381;1644;4944;201;610;1033;3165;1234;3775
521305;201606;747;2100;613;1894;115;346;345;1112;460;1458
521308;201606;4385;12879;3459;11089;915;3040;1391;4478;2306;7518
521310;201606;7903;23187;5643;18803;1544;5620;1175;3737;2719;9357
521340;201606;324;836;304;814;13;50;264;692;277;742
521350;201606;1972;5403;1615;4848;238;709;1059;3280;1297;3989
521370;201606;953;2770;699;2312;227;827;146;481;373;1308
521375;201606;1172;3541;989;3220;251;872;421;1338;672;2210
521377;201606;1090;2729;1008;2642;53;107;906;2439;959;2546
521380;201606;5485;15488;3939;12606;641;2222;1007;3358;1648;5580
521385;201606;505;1346;446;1272;120;370;233;683;353;1053
521390;201606;794;2216;648;2021;208;764;210;642;418;1406
521400;201606;2022;5774;1869;5589;210;684;1484;4483;1694;5167
521405;201606;1387;3865;1081;3312;309;1009;453;1424;762;2433
521410;201606;715;2174;669;2103;211;617;325;1120;536;1737
521440;201606;1371;3971;1124;3453;205;710;427;1157;632;1867
521450;201606;3891;12502;3151;11061;1071;4040;634;2194;1705;6234
521460;201606;6658;19136;5536;17244;1442;4919;2561;7890;4003;12809
521470;201606;697;2004;519;1656;119;410;92;298;211;708
521480;201606;375;1124;253;858;54;191;86;288;140;479
521483;201606;2818;7345;2139;6187;582;1768;657;1884;1239;3652
521486;201606;1604;4082;1305;3651;109;286;970;2736;1079;3022
521487;201606;579;1482;409;1206;120;390;88;243;208;633
521490;201606;784;2236;626;1979;59;243;413;1263;472;1506
521500;201606;1347;4209;1014;3498;203;816;250;756;453;1572
521520;201606;890;2095;672;1805;158;438;339;980;497;1418
521523;201606;13124;46792;12262;45322;4302;17150;1956;8230;6258;25380
521525;201606;1055;2720;896;2486;116;384;580;1579;696;1963
521530;201606;1732;4925;1087;3604;262;934;158;520;420;1454
521540;201606;939;2526;650;2043;153;572;221;675;374;1247
521550;201606;1391;3567;939;2652;186;557;460;1263;646;1820
521560;201606;3636;11841;3029;10991;1147;4600;1095;3974;2242;8574
521565;201606;598;1546;504;1429;80;228;330;930;410;1158
521570;201606;4626;12739;2971;9455;730;2563;569;1872;1299;4435
521580;201606;559;1286;352;995;93;277;72;192;165;469
521590;201606;642;1773;518;1579;156;534;149;435;305;969
521600;201606;498;1364;352;1113;98;325;82;254;180;579
521630;201606;1361;3406;966;2836;248;882;196;499;444;1381
521640;201606;2071;5237;1600;4597;412;1219;718;2139;1130;3358
521645;201606;580;1697;433;1400;86;296;156;476;242;772
521680;201606;1358;4344;1146;3938;528;1940;154;519;682;2459
521690;201606;574;1663;506;1548;132;477;238;677;370;1154
521710;201606;2882;8412;2297;7401;512;1742;793;2616;1305;4358
521720;201606;1893;5339;1507;4665;296;948;820;2480;1116;3428
521730;201606;3639;11836;3157;10886;1224;4633;661;2046;1885;6679
521740;201606;3607;9877;2848;8800;614;2075;1358;4474;1972;6549
521760;201606;13558;43407;11886;40587;3209;11996;4962;17239;8171;29235
521770;201606;2613;7548;2106;6626;766;2600;611;1849;1377;4449
521800;201606;6975;21030;5987;19354;1826;6301;2254;7636;4080;13937
521805;201606;932;2092;671;1718;140;311;381;1062;521;1373
521810;201606;805;1992;588;1684;109;333;266;809;375;1142
521830;201606;5229;16458;4669;15631;705;2587;3222;10864;3927;13451
521839;201606;730;1997;544;1660;106;361;213;619;319;980
521850;201606;6887;18336;5245;15548;1275;4025;1558;4372;2833;8397
521860;201606;2041;5453;1562;4724;369;1306;478;1421;847;2727
521870;201606;487;1601;399;1411;103;385;141;482;244;867
521878;201606;781;2228;555;1757;91;331;226;672;317;1003
521880;201606;23431;59761;15775;47529;4158;13484;4849;15256;9007;28740
521890;201606;3404;10054;2622;8561;770;2739;517;1652;1287;4391
521900;201606;1450;3801;1014;3158;260;890;366;1075;626;1965
521910;201606;901;2433;799;2313;144;450;463;1431;607;1881
521920;201606;298;941;245;844;91;349;54;175;145;524
521925;201606;674;2047;562;1844;119;423;204;634;323;1057
521930;201606;3625;11611;3117;10644;1111;3987;582;2062;1693;6049
521935;201606;589;1664;505;1512;111;339;259;757;370;1096
521940;201606;1004;2760;818;2482;171;596;440;1303;611;1899
521945;201606;678;2102;584;1953;99;330;323;1167;422;1497
521950;201606;645;1663;523;1487;63;197;354;1016;417;1213
521960;201606;661;1986;534;1735;109;393;236;760;345;1153
521970;201606;2647;6869;2186;6312;197;558;1731;5197;1928;5755
521971;201606;1022;2696;705;2117;128;400;179;518;307;918
521973;201606;942;2897;793;2628;155;542;388;1302;543;1844
521975;201606;12397;33996;11258;32641;1849;5628;7854;22859;9703;28487
521980;201606;2030;5585;1731;5219;231;604;1363;4306;1594;4910
521990;201606;1173;3298;944;2940;102;350;630;2012;732;2362
522000;201606;2277;6191;1651;5389;221;806;940;3250;1161;4056
522005;201606;399;967;275;780;87;248;97;285;184;533
522010;201606;3446;9818;2880;8880;1059;3360;672;2121;1731;5481
522015;201606;894;2635;750;2403;176;583;369;1191;545;1774
522020;201606;5157;13290;3977;11504;926;2794;2021;5818;2947;8612
522026;201606;611;1661;448;1470;110;399;164;583;274;982
522028;201606;529;1506;426;1279;54;171;266;795;320;966
522040;201606;2405;5831;1890;5196;372;1023;1188;3348;1560;4371
522045;201606;15113;48931;12501;43653;3622;13929;2440;8559;6062;22488
522050;201606;1162;3281;824;2647;195;659;229;661;424;1320
522060;201606;2740;8005;2136;7077;608;2190;935;3151;1543;5341
522068;201606;1707;5300;1533;5097;153;435;1194;4212;1347;4647
522070;201606;703;2094;625;1968;77;304;440;1360;517;1664
522100;201606;511;1532;439;1427;147;531;201;635;348;1166
522108;201606;865;2643;721;2416;73;311;542;1775;615;2086
522119;201606;1380;4207;1156;3860;275;963;548;1902;823;2865
522130;201606;351;987;285;910;76;250;174;569;250;819
522140;201606;17585;48938;14088;42954;4233;14029;3771;11074;8004;25103
522145;201606;819;2255;701;2079;239;697;291;958;530;1655
522150;201606;892;2463;763;2255;207;637;307;912;514;1549
522155;201606;820;2323;714;2160;140;388;445;1437;585;1825
522157;201606;654;1806;557;1668;44;157;437;1312;481;1469
522160;201606;5922;16832;4300;13912;1337;4793;467;1538;1804;6331
522170;201606;2310;6721;1847;5878;634;2146;433;1366;1067;3512
522180;201606;338;982;252;838;75;258;72;255;147;513
522185;201606;15262;43333;12583;39917;3339;11209;6627;21653;9966;32862
522190;201606;884;2189;674;1885;110;318;334;992;444;1310
522200;201606;1700;5445;1388;4781;377;1419;342;1126;719;2545
522205;201606;1399;3897;1129;3477;212;706;594;1813;806;2519
522220;201606;1397;3656;1129;3332;237;714;623;1975;860;2689
522230;201606;1213;3385;1021;3085;127;480;652;1964;779;2444
530010;201606;222419;689907;196061;644468;53821;196356;71011;230634;124832;426990
110001;201605;3331;11071;2958;10484;693;2576;1429;5146;2122;7722
110002;201605;12963;37999;10146;33094;3020;10679;3047;9795;6067;20474
110003;201605;747;2419;660;2254;199;711;140;462;339;1173
110004;201605;9934;30916;8053;27178;2381;8661;1378;4815;3759;13476
110005;201605;1801;5732;1554;5275;499;1739;610;2075;1109;3814
110006;201605;1896;5746;1296;4573;352;1352;136;426;488;1778
110007;201605;1313;4035;1218;3844;365;1233;463;1648;828;2881
110008;201605;2325;7939;2181;7742;370;1244;1563;5797;1933;7041
110009;201605;4544;13693;3564;12144;1025;3794;1024;3517;2049;7311
110010;201605;7478;22425;6584;21244;1767;5681;3226;11492;4993;17173
110011;201605;7422;22994;6340;20928;2180;7544;1937;6417;4117;13961
110012;201605;14825;42902;11843;37805;3257;10910;2934;9682;6191;20592
110013;201605;5248;16647;4520;15337;1771;6199;1107;4032;2878;10231
110014;201605;4020;11826;3498;11000;894;2897;1772;5617;2666;8514
110015;201605;4756;14224;3400;11635;936;3454;573;1935;1509;5389
110018;201605;4014;11323;2992;9797;760;2806;1021;3199;1781;6005
110020;201605;62315;170556;46417;149066;10302;35158;19941;66273;30243;101431
110025;201605;4197;12051;3429;10708;561;1860;2044;6302;2605;8162
110026;201605;618;1897;570;1825;142;433;308;1041;450;1474
110028;201605;6647;20030;5237;17288;1417;5117;625;2033;2042;7150
110029;201605;1335;3875;1083;3467;317;1057;417;1349;734;2406
110030;201605;10162;27622;7812;24430;2047;7056;2982;9547;5029;16603
110032;201605;3807;11946;3311;11014;1078;3664;885;2932;1963;6596
110033;201605;5170;16470;4653;15605;1509;5085;1666;5968;3175;11053
110034;201605;3369;9063;2772;8254;823;2514;1472;4381;2295;6895
110037;201605;1947;6559;1669;6016;435;1665;695;2498;1130;4163
110040;201605;3386;10613;2885;9702;836;3028;1037;3409;1873;6437
110045;201605;4948;16053;4270;15184;1381;5371;1930;6850;3311;12221
110050;201605;1607;5163;1365;4725;465;1676;544;1896;1009;3572
110060;201605;802;2647;654;2344;224;897;118;406;342;1303
110070;201605;1928;6468;1781;6165;547;2053;730;2430;1277;4483
110080;201605;4270;11699;3704;11057;614;1727;2603;8212;3217;9939
110090;201605;713;2106;561;1835;125;465;242;751;367;1216
110092;201605;1281;4275;1172;4123;205;769;740;2678;945;3447
110094;201605;3541;10604;3071;9957;1036;3598;1166;3776;2202;7374
110100;201605;2132;6758;1938;6399;568;1981;923;3059;1491;5040
110110;201605;1588;5091;1412;4852;578;2004;341;1275;919;3279
110120;201605;1779;5615;1388;4773;390;1411;268;902;658;2313
110130;201605;2374;6905;1772;5844;560;1959;317;1049;877;3008
110140;201605;2317;7547;1923;6759;538;2058;480;1560;1018;3618
110143;201605;1218;3778;920;3263;288;1063;356;1297;644;2360
110145;201605;997;2847;800;2534;203;704;384;1205;587;1909
110146;201605;431;1329;363;1224;73;243;197;686;270;929
110147;201605;695;2049;552;1795;141;476;177;542;318;1018
110148;201605;1197;3633;840;2819;143;493;79;243;222;736
110149;201605;3261;9800;2623;8756;893;2967;1015;3591;1908;6558
110150;201605;2379;6958;1984;6380;542;1847;707;2382;1249;4229
110155;201605;835;2575;739;2354;185;634;310;935;495;1569
110160;201605;1900;6085;1591;5489;561;1973;504;1768;1065;3741
110170;201605;2816;7902;2035;6468;442;1471;958;3041;1400;4512
110175;201605;1604;4910;1297;4500;212;777;699;2552;911;3329
110180;201605;1279;3737;1072;3427;267;832;580;1911;847;2743
120001;201605;2730;9406;2529;9088;504;1896;1538;5682;2042;7578
120005;201605;1509;6330;1414;6137;157;745;1031;4656;1188;5401
120010;201605;4556;15503;4354;15203;538;1885;3325;11887;3863;13772
120013;201605;1848;7400;1761;7270;415;1718;1022;4488;1437;6206
120017;201605;1954;7121;1826;6888;525;2024;787;3303;1312;5327
120020;201605;14010;62692;13549;61804;1925;9031;9713;45877;11638;54908
120025;201605;2404;8426;2315;8301;449;1710;1450;5285;1899;6995
120030;201605;6287;24586;6138;24416;206;989;5592;22340;5798;23329
120032;201605;1452;7077;1397;6951;165;1008;1023;5089;1188;6097
120033;201605;3521;14159;3435;14006;234;974;3062;12641;3296;13615
120034;201605;2103;8825;2013;8649;147;857;1642;6978;1789;7835
120035;201605;3088;13994;3012;13848;213;1105;2571;11953;2784;13058
120038;201605;2593;9441;2448;9167;622;2387;1279;4966;1901;7353
120039;201605;1652;8354;1612;8263;157;954;1244;6464;1401;7418
120040;201605;44159;157919;40437;151034;9534;38578;19823;75424;29357;114002
120042;201605;2956;12548;2816;12236;319;1583;2060;9049;2379;10632
120043;201605;893;4200;862;4150;73;355;691;3454;764;3809
120045;201605;4194;14364;4086;14235;505;1878;3362;11753;3867;13631
120050;201605;7953;32861;7580;32066;1024;4695;5243;22856;6267;27551
120060;201605;7595;33948;7434;33669;685;3632;5931;27124;6616;30756
120070;201605;2627;9863;2553;9701;415;1564;1673;6558;2088;8122
120080;201605;3534;13418;3378;13149;595;2456;2362;9369;2957;11825
130002;201605;3036;12524;2857;12250;163;832;2448;10552;2611;11384
130006;201605;1956;8299;1722;7877;248;1291;1198;5507;1446;6798
130008;201605;2157;8515;2008;8252;158;713;1617;6706;1775;7419
130010;201605;2988;9870;2734;9583;161;619;2419;8493;2580;9112
130014;201605;3086;10149;2717;9559;480;1800;1686;6017;2166;7817
130020;201605;2645;9804;2561;9657;66;347;2231;8305;2297;8652
130030;201605;7464;28210;7188;27893;375;1267;6472;25702;6847;26969
130040;201605;3753;11619;3333;11061;287;1014;2662;8991;2949;10005
130050;201605;5945;24458;5637;24017;370;1599;4775;20930;5145;22529
130060;201605;5700;26719;5470;26347;518;3016;4319;20764;4837;23780
130063;201605;3713;16460;3583;16303;279;1378;3125;14352;3404;15730
130068;201605;3140;13170;2833;12520;314;1544;1923;8620;2237;10164
130070;201605;6943;22239;6130;21285;589;2031;4827;17175;5416;19206
130080;201605;5315;23498;5030;23067;690;3590;3609;16719;4299;20309
130083;201605;2123;8394;2002;8220;282;1303;1409;5795;1691;7098
130090;201605;2633;9484;2527;9323;95;441;2261;8334;2356;8775
130100;201605;5718;21124;5570;20946;143;600;5246;19795;5389;20395
130110;201605;6637;21343;6238;20877;673;2069;5037;17402;5710;19471
130115;201605;4432;15753;4216;15422;168;695;3724;13668;3892;14363
130120;201605;14631;55389;13709;54225;1329;5352;11197;45354;12526;50706
130130;201605;3849;15753;3794;15650;212;1077;3319;13669;3531;14746
130140;201605;6252;24297;6141;24173;218;869;5780;22838;5998;23707
130150;201605;3359;13378;3279;13280;146;825;2943;11806;3089;12631
130160;201605;4150;17309;4000;17111;437;2163;3256;13899;3693;16062
130165;201605;2857;11829;2721;11601;234;1186;2206;9418;2440;10604
130170;201605;9223;32759;8102;31389;970;4046;6162;24330;7132;28376
130180;201605;3463;11432;3395;11339;119;288;3168;10735;3287;11023
130185;201605;11334;36070;10123;34698;862;2634;8293;29847;9155;32481
130190;201605;16564;57145;14542;54552;2604;9909;9441;36947;12045;46856
130195;201605;1947;8168;1879;8077;102;452;1654;7235;1756;7687
130200;201605;2045;7084;1855;6793;444;1614;1110;4235;1554;5849
130210;201605;1234;4907;1163;4813;112;568;965;3965;1077;4533
130220;201605;1984;8115;1813;7793;296;1457;1050;4491;1346;5948
130230;201605;3625;16621;3399;16249;360;1825;2588;12770;2948;14595
130240;201605;8590;32375;7865;31382;368;1970;6818;27264;7186;29234
130250;201605;19451;68116;18311;66676;2677;9467;13385;50966;16062;60433
130255;201605;4294;14723;4005;14279;175;690;3524;12695;3699;13385
130260;201605;241388;790607;217280;749930;62555;230662;91809;319445;154364;550107
130270;201605;7195;30057;6702;29285;926;4091;4881;22105;5807;26196
130280;201605;3286;13637;3178;13509;117;527;2934;12639;3051;13166
130290;201605;11142;39582;10652;39014;212;673;10083;37552;10295;38225
130300;201605;4345;16905;4152;16603;234;1100;3617;14529;3851;15629
130310;201605;4940;18940;4573;18460;321;1408;3818;15647;4139;17055
130320;201605;2936;10544;2686;10201;364;1482;1859;7244;2223;8726
130330;201605;3538;12964;3238;12581;205;984;2705;10498;2910;11482
130340;201605;17780;68015;16535;66476;2518;10044;12567;52204;15085;62248
130350;201605;3240;13541;3161;13424;263;1496;2632;11023;2895;12519
130353;201605;6005;18417;5264;17482;1114;3639;3201;11465;4315;15104
130356;201605;4545;16434;4274;16032;442;1630;3274;12740;3716;14370
130360;201605;3234;9215;2852;8806;125;337;2602;8219;2727;8556
130370;201605;5444;20969;4739;20061;210;1193;4008;17010;4218;18203
130380;201605;7888;32688;7616;32329;417;2079;6644;28370;7061;30449
130390;201605;4961;22100;4668;21557;494;2614;3488;16203;3982;18817
130395;201605;2123;7537;1902;7113;219;883;1317;4887;1536;5770
130400;201605;2106;7998;2010;7867;141;676;1755;6864;1896;7540
130406;201605;10526;40100;9591;38776;2150;8997;6041;25017;8191;34014
130410;201605;3876;14755;3493;14113;1051;4548;1516;6361;2567;10909
130420;201605;10549;44606;10090;43946;2129;9199;6938;31461;9067;40660
130423;201605;3219;12545;3007;12258;263;1298;2492;10104;2755;11402
130426;201605;2238;9679;2167;9567;206;984;1748;7866;1954;8850
130430;201605;3364;11973;3231;11779;289;1099;2635;9735;2924;10834
130440;201605;3478;12755;3293;12545;242;988;2826;10859;3068;11847
140002;201605;1620;5337;1494;5162;117;479;1109;3826;1226;4305
140005;201605;3227;9206;3111;9078;62;153;2993;8793;3055;8946
140010;201605;55061;159871;45541;145951;11092;37692;19042;64232;30134;101924
140015;201605;2803;9093;2639;8893;224;618;2225;7781;2449;8399
140017;201605;3099;9841;2814;9484;268;859;2143;7522;2411;8381
140020;201605;4317;14725;3918;14166;552;2188;2718;9886;3270;12074
140023;201605;2133;7203;1861;6804;196;779;1332;4971;1528;5750
140028;201605;2080;5759;1929;5559;250;813;1403;3874;1653;4687
140030;201605;3645;11569;3396;11248;443;1255;2501;8617;2944;9872
140040;201605;1666;7823;1633;7766;93;567;1455;6872;1548;7439
140045;201605;2426;9016;2209;8718;432;1614;1428;6074;1860;7688
140047;201605;5498;16582;4852;15607;1267;4161;2186;7606;3453;11767
140050;201605;1353;4318;1214;4133;266;917;717;2509;983;3426
140060;201605;1451;4439;1295;4196;232;822;843;2731;1075;3553
140070;201605;1515;8346;1466;8196;124;852;1151;6445;1275;7297
150010;201605;35496;107101;33429;104363;2148;7137;27245;85511;29393;92648
150013;201605;1713;5004;1555;4823;182;525;1195;3830;1377;4355
150020;201605;12326;41472;11910;40903;1369;4371;9582;33821;10951;38192
150030;201605;7163;30393;6935;30048;743;2926;5650;25331;6393;28257
150034;201605;4229;11691;3992;11396;158;478;3593;10297;3751;10775
150040;201605;12788;40918;11041;38824;1739;5413;7989;30192;9728;35605
150050;201605;5606;22039;5355;21617;284;1422;4581;18502;4865;19924
150060;201605;17706;55132;16081;52612;3010;9786;10182;34513;13192;44299
150070;201605;5940;24189;5317;23534;284;1425;4751;21225;5035;22650
150080;201605;72555;187928;61872;174110;12183;33849;33775;100334;45958;134183
150085;201605;5415;18356;5148;18021;446;1352;4337;15704;4783;17056
150090;201605;10109;38786;9563;37996;831;3426;7505;30467;8336;33893
150095;201605;5235;17157;4778;16500;359;1155;3815;13685;4174;14840
150100;201605;3214;12044;3019;11716;171;823;2418;9241;2589;10064
150110;201605;3283;16337;3273;16317;229;1144;2849;14438;3078;15582
150120;201605;6431;23676;6278;23445;503;1800;5136;19817;5639;21617
150125;201605;693;2048;607;1946;105;375;392;1257;497;1632
150130;201605;21970;66704;20340;64482;2361;7173;15021;49036;17382;56209
150140;201605;160969;451173;151024;438323;17493;49966;114558;338402;132051;388368
150145;201605;4481;14311;4083;13803;531;1933;3132;10741;3663;12674
150150;201605;11944;36324;10989;34924;1873;6274;7084;22844;8957;29118
150157;201605;3104;9302;2714;8755;355;1293;1877;6146;2232;7439
150160;201605;3086;9888;2899;9617;915;3116;1485;5081;2400;8197
150170;201605;21477;79301;20294;77422;2975;11581;14255;55515;17230;67096
150172;201605;3083;10489;2709;9875;409;1536;1845;6903;2254;8439
150175;201605;1898;5784;1777;5649;148;464;1447;4793;1595;5257
150178;201605;10019;31050;8833;29723;1062;3790;6337;22052;7399;25842
150180;201605;18468;73793;17759;72882;1297;5970;15000;62063;16297;68033
150190;201605;6916;23606;6649;23241;251;946;6007;21187;6258;22133
150195;201605;5228;17210;4886;16670;230;835;4252;14636;4482;15471
150200;201605;5307;16812;5063;16530;112;376;4741;15614;4853;15990
150210;201605;24701;92809;23886;91675;2050;7886;19553;77210;21603;85096
150215;201605;6958;21972;6126;20663;1828;6401;2454;8530;4282;14931
150220;201605;11911;37075;10673;35164;2456;8260;5326;18044;7782;26304
150230;201605;11754;36921;10258;34847;1408;5157;6752;23375;8160;28532
150240;201605;35290;104622;30874;97065;10070;32747;8753;28841;18823;61588
150250;201605;4025;16732;3882;16526;680;2917;2717;12004;3397;14921
150260;201605;2029;8084;1938;7926;394;1616;1161;4926;1555;6542
150270;201605;8491;26071;6735;23824;1755;6472;3594;13161;5349;19633
150275;201605;5841;21280;5546;20811;681;2486;4046;15585;4727;18071
150276;201605;2114;6324;1878;6012;376;1286;1281;4119;1657;5405
150277;201605;4778;14801;4138;14017;764;2704;2760;9624;3524;12328
150280;201605;5816;26036;5640;25672;1019;4718;3831;17903;4850;22621
150285;201605;2839;11083;2662;10769;424;1790;1745;7261;2169;9051
150290;201605;9852;28440;9424;27957;641;1549;8103;24880;8744;26429
150293;201605;9568;26030;7238;22838;2113;7086;2402;8401;4515;15487
150295;201605;7551;21962;6226;20422;1494;4956;3386;12299;4880;17255
150300;201605;1945;6494;1828;6341;116;506;1460;5030;1576;5536
150304;201605;4084;12950;3544;12110;580;1990;2261;8026;2841;10016
150307;201605;6461;21533;6009;20900;379;1248;4997;17558;5376;18806
150309;201605;6018;20875;5442;20050;1226;4461;3195;12469;4421;16930
150310;201605;6180;26665;5960;26332;556;2729;4792;21387;5348;24116
150320;201605;9410;22995;8686;22221;580;1289;7382;19274;7962;20563
150330;201605;13739;46904;12869;45635;1815;6469;9282;33988;11097;40457
150340;201605;2446;7871;2261;7586;247;843;1675;5668;1922;6511
150345;201605;6592;21927;6164;21361;567;1940;4892;17381;5459;19321
150350;201605;7973;24526;7404;23797;1224;3298;5359;18154;6583;21452
150360;201605;20943;65126;18350;61823;3102;10388;12054;42490;15156;52878
150370;201605;9855;35863;9181;34981;1297;4708;6835;27303;8132;32011
150375;201605;2868;12595;2775;12470;219;968;2378;10880;2597;11848
150380;201605;9982;28739;8815;27128;535;1663;7330;22894;7865;24557
150390;201605;7811;33707;7318;32836;1295;5630;4715;22138;6010;27768
150400;201605;5822;22906;5598;22466;464;1858;4452;18241;4916;20099
150405;201605;8174;24652;7263;23530;1243;3202;4956;17729;6199;20931
150410;201605;1582;6017;1462;5772;207;933;877;3464;1084;4397
150420;201605;36423;121814;30753;112654;9631;38472;9197;35830;18828;74302
150430;201605;7361;24710;6999;24150;929;3012;5136;18317;6065;21329
150440;201605;5420;18709;5206;18419;764;2649;3850;14020;4614;16669
150442;201605;21450;61958;19022;58321;3481;10667;11341;36139;14822;46806
150445;201605;5175;17955;4805;17338;591;2111;3525;13067;4116;15178
150450;201605;4201;20441;4061;20229;367;1900;3320;16849;3687;18749
150460;201605;6900;25742;6361;25087;322;1620;5325;21690;5647;23310
150470;201605;17133;52884;16467;52105;427;1129;15481;49568;15908;50697
150475;201605;3170;10983;2933;10677;263;993;2375;8808;2638;9801
150480;201605;13788;46918;12750;45351;1251;4624;10076;36460;11327;41084
150490;201605;6950;26798;6792;26572;263;1152;6007;23728;6270;24880
150495;201605;4920;18303;4775;18113;165;671;4398;16810;4563;17481
150497;201605;2665;9832;2399;9320;785;3190;1011;4025;1796;7215
150500;201605;3119;8658;2903;8354;240;682;2291;6586;2531;7268
150503;201605;3613;11115;3096;10469;1061;3691;1553;5511;2614;9202
150506;201605;10994;38353;9999;36940;2414;8561;5939;23661;8353;32222
150510;201605;9597;37673;8797;36074;1415;5875;5692;24339;7107;30214
150520;201605;6659;26269;6543;26119;251;988;6064;24469;6315;25457
150530;201605;12191;41518;11004;39719;1108;3791;8432;31113;9540;34904
150540;201605;4643;14114;4136;13417;271;880;3365;10977;3636;11857
150543;201605;5658;17514;5030;16622;1017;3493;3030;10338;4047;13831
150548;201605;8975;28942;8407;28224;448;1423;7569;25787;8017;27210
150549;201605;2021;6583;1867;6410;72;261;1692;5877;1764;6138
150550;201605;19971;63170;17487;59061;5257;18223;6453;22892;11710;41115
150553;201605;22759;78209;19040;70680;6887;27411;4299;16423;11186;43834
150555;201605;1695;5122;1439;4705;96;343;1083;3570;1179;3913
150560;201605;1930;6329;1811;6084;286;965;1110;3754;1396;4719
150563;201605;2688;8898;2487;8556;623;2334;1293;4435;1916;6769
150565;201605;3797;13077;3470;12569;178;824;2860;10419;3038;11243
150570;201605;5815;21204;5675;20967;403;1769;4578;16960;4981;18729
150580;201605;9546;40113;9294;39826;588;2513;8163;35708;8751;38221
150590;201605;5667;22626;5456;22359;168;793;5025;20639;5193;21432
150600;201605;7732;30167;7419;29715;359;1582;6568;26536;6927;28118
150610;201605;2397;8097;2185;7669;216;831;1530;5319;1746;6150
150611;201605;2727;9396;2563;9105;164;653;2083;7425;2247;8078
150613;201605;11963;35818;9883;32710;3151;11020;3706;12649;6857;23669
150616;201605;3034;9247;2355;8128;567;2169;760;2497;1327;4666
150618;201605;6279;21528;5677;20445;1606;5882;2759;10297;4365;16179
150619;201605;5110;17474;4722;16865;537;2127;3404;12163;3941;14290
150620;201605;6333;22685;5782;21984;711;2747;4462;17415;5173;20162
150630;201605;5700;17229;5399;16873;541;1743;4397;14022;4938;15765
150635;201605;3962;12921;3560;12119;877;3111;1539;5410;2416;8521
150640;201605;1836;5560;1764;5474;239;690;1401;4576;1640;5266
150650;201605;12256;36836;10947;34628;2926;9376;4607;15266;7533;24642
150655;201605;5004;16642;4700;16091;637;2217;3353;11648;3990;13865
150658;201605;4454;13429;3871;12623;881;3147;2246;7549;3127;10696
150660;201605;5518;17275;5038;16574;1260;4139;2523;8610;3783;12749
150670;201605;7281;19190;5984;17604;719;2232;4544;13762;5263;15994
150680;201605;56960;199626;49865;187755;14908;58370;19237;78724;34145;137094
150690;201605;2037;6233;1839;5931;262;795;1244;4122;1506;4917
150700;201605;6134;19135;5613;18448;966;3237;3655;12376;4621;15613
150710;201605;4241;14310;3809;13609;444;1645;2707;9904;3151;11549
150715;201605;4905;15480;4281;14541;470;1805;3160;10796;3630;12601
150720;201605;6495;26246;6144;25622;778;3428;4444;19083;5222;22511
150730;201605;9772;33189;9099;32084;1062;3865;6995;25256;8057;29121
150740;201605;3677;11752;3294;11066;678;2372;1721;5809;2399;8181
150745;201605;5104;16232;4611;15553;1179;4220;2647;8915;3826;13135
150746;201605;1370;4460;1306;4349;126;401;941;3181;1067;3582
150747;201605;5308;16489;4707;15739;363;1029;3586;12962;3949;13991
150750;201605;3298;10726;3051;10409;206;816;2491;8546;2697;9362
150760;201605;11068;35553;10292;34553;1936;6639;6801;23392;8737;30031
150770;201605;5773;22093;5494;21624;355;1288;4651;19344;5006;20632
150775;201605;1108;3393;960;3130;192;750;499;1591;691;2341
150780;201605;3327;10771;3225;10659;101;359;2973;9870;3074;10229
150790;201605;4951;16247;4621;15859;360;1278;3680;13452;4040;14730
150795;201605;15074;47879;13597;45641;3040;10051;7893;27754;10933;37805
150796;201605;3078;9024;2796;8690;354;1146;2105;6701;2459;7847
150797;201605;3681;12573;3406;12114;107;465;2885;10250;2992;10715
150800;201605;13697;45018;12596;43661;2692;8772;8252;30435;10944;39207
150803;201605;6646;23985;6245;23337;673;2614;4600;17447;5273;20061
150805;201605;2559;9207;2382;8914;324;1207;1706;6506;2030;7713
150808;201605;5720;19003;4712;17074;1814;7203;592;2155;2406;9358
150810;201605;18915;58290;15890;54649;2339;7794;10420;38141;12759;45935
150812;201605;5162;16311;4759;15638;496;1888;3334;10626;3830;12514
150815;201605;8496;27967;7633;26891;837;2939;5959;21564;6796;24503
150820;201605;11307;32618;10131;31314;782;1848;8293;26593;9075;28441
150830;201605;12869;48298;12092;47286;630;3105;9897;39834;10527;42939
150835;201605;2088;7332;1942;7059;447;1634;984;3682;1431;5316
150840;201605;7089;21686;5956;19812;1337;4860;2800;9274;4137;14134
160005;201605;788;2711;750;2634;75;307;595;2059;670;2366
160010;201605;1289;4318;1285;4313;47;94;1227;4195;1274;4289
160015;201605;1707;6333;1672;6286;67;233;1542;5894;1609;6127
160020;201605;1897;6876;1786;6731;211;846;1342;5159;1553;6005
160021;201605;1066;4632;1024;4565;133;689;747;3372;880;4061
160023;201605;989;3996;981;3986;99;398;809;3331;908;3729
160025;201605;1308;3990;1292;3974;26;103;1247;3821;1273;3924
160027;201605;8132;24190;7513;23506;1983;6031;4613;15206;6596;21237
160030;201605;46201;161360;41025;152691;9810;36919;21297;84596;31107;121515
160040;201605;4286;16745;4187;16607;175;1004;3818;14934;3993;15938
160050;201605;2976;11393;2665;10948;1372;5556;772;3547;2144;9103
160053;201605;2747;10581;2684;10490;533;2176;1785;7101;2318;9277
160055;201605;523;2109;516;2100;31;132;449;1836;480;1968
160060;201605;15389;52349;14348;51127;2352;8122;10295;37788;12647;45910
160070;201605;2509;9962;2366;9718;185;904;1989;8119;2174;9023
160080;201605;2502;9492;2461;9444;102;505;2292;8724;2394;9229
170025;201605;516;1671;463;1601;129;449;236;836;365;1285
170030;201605;1154;3799;1005;3532;257;935;392;1412;649;2347
170035;201605;1417;4120;1163;3677;211;733;526;1665;737;2398
170040;201605;1888;5937;1662;5652;197;753;994;3664;1191;4417
170070;201605;1649;4447;1294;3972;276;921;684;2072;960;2993
170100;201605;2350;7046;2049;6604;237;765;1554;5080;1791;5845
170105;201605;749;2324;591;2008;118;452;275;892;393;1344
170110;201605;941;3085;816;2859;180;669;342;1229;522;1898
170130;201605;1338;4237;1104;3788;295;1064;468;1652;763;2716
170190;201605;1530;4505;1166;3915;433;1406;207;849;640;2255
170200;201605;1577;4401;1022;3349;266;934;220;698;486;1632
170210;201605;31150;88494;25072;78847;7529;25675;5981;19901;13510;45576
170215;201605;1187;3671;1005;3392;94;368;706;2378;800;2746
170220;201605;5553;19170;5120;18332;1262;4692;2546;9271;3808;13963
170230;201605;1362;4372;1125;3924;242;962;467;1578;709;2540
170240;201605;2711;8074;2216;7302;249;972;1503;4915;1752;5887
170255;201605;3293;10551;2758;9616;854;3035;1076;3924;1930;6959
170270;201605;998;2491;696;2086;67;208;464;1373;531;1581
170290;201605;2752;8277;2480;7964;257;582;2010;6950;2267;7532
170300;201605;1907;5849;1591;5345;180;685;1037;3524;1217;4209
170305;201605;727;2193;589;1942;92;343;311;1028;403;1371
170307;201605;1011;3589;854;3302;176;773;397;1593;573;2366
170310;201605;1587;4398;1202;3753;311;1041;509;1617;820;2658
170320;201605;1118;3220;809;2689;197;706;270;918;467;1624
170330;201605;787;2562;714;2449;74;286;545;1842;619;2128
170360;201605;451;1425;373;1288;72;253;175;599;247;852
170370;201605;1338;3809;1049;3352;184;673;543;1700;727;2373
170380;201605;1721;5558;1392;5012;226;930;705;2552;931;3482
170382;201605;558;1854;464;1690;74;301;299;1110;373;1411
170384;201605;1554;6269;1419;6010;330;1481;729;3143;1059;4624
170386;201605;891;2658;774;2487;219;806;316;970;535;1776
170388;201605;641;1929;526;1742;107;399;191;617;298;1016
170389;201605;913;3079;830;2942;73;299;613;2158;686;2457
170390;201605;1260;3637;1070;3401;84;295;840;2709;924;3004
170410;201605;531;1695;445;1545;35;144;280;974;315;1118
170460;201605;482;1323;324;1038;69;256;103;324;172;580
170510;201605;751;2516;599;2225;80;354;300;1086;380;1440
170550;201605;6755;19164;4994;16105;1525;5444;576;1841;2101;7285
170555;201605;1338;3834;1074;3426;201;695;515;1711;716;2406
170560;201605;1045;3401;821;3108;167;692;453;1815;620;2507
170600;201605;1311;3858;1158;3649;321;984;653;2145;974;3129
170610;201605;1661;5002;1324;4462;153;569;821;2769;974;3338
170625;201605;416;1241;311;1033;46;151;98;318;144;469
170650;201605;1206;3912;1010;3563;254;928;353;1363;607;2291
170700;201605;4085;12741;3303;11450;685;2595;1413;5079;2098;7674
170710;201605;1726;5149;1393;4549;217;744;795;2638;1012;3382
170720;201605;1830;4955;1559;4527;209;503;1152;3539;1361;4042
170730;201605;960;2806;781;2524;205;697;297;976;502;1673
170740;201605;2153;7632;1868;7109;288;1162;1172;4513;1460;5675
170755;201605;756;2366;609;2044;96;380;244;802;340;1182
170765;201605;1291;3532;977;3027;269;875;377;1227;646;2102
170770;201605;1653;5649;1509;5403;258;949;911;3325;1169;4274
170820;201605;3455;11207;3114;10648;670;2439;1494;5177;2164;7616
170825;201605;717;2148;601;1927;95;313;284;903;379;1216
170830;201605;1383;4051;1191;3770;91;222;1002;3291;1093;3513
170900;201605;2481;8871;2339;8645;210;825;1874;7022;2084;7847
170930;201605;3606;10959;3140;10214;843;2893;1296;4373;2139;7266
170950;201605;13616;39589;10182;33560;3002;11237;1499;4968;4501;16205
170980;201605;497;1454;371;1251;65;233;151;504;216;737
171050;201605;1477;4994;1331;4717;82;394;1049;3662;1131;4056
171070;201605;1433;4525;1308;4347;325;1065;697;2422;1022;3487
171090;201605;1050;2838;866;2583;62;176;635;1896;697;2072
171110;201605;588;1726;440;1454;124;466;172;515;296;981
171150;201605;1006;2761;674;2182;131;450;367;1209;498;1659
171180;201605;690;2082;477;1641;116;411;169;637;285;1048
171190;201605;1622;6013;1432;5608;281;1159;658;2729;939;3888
171195;201605;835;2911;716;2698;100;410;413;1589;513;1999
171200;201605;675;2123;541;1869;169;628;175;574;344;1202
171215;201605;459;1354;355;1145;56;201;162;532;218;733
171240;201605;694;2532;638;2423;66;316;421;1638;487;1954
171245;201605;615;2070;504;1810;106;421;158;553;264;974
171250;201605;1025;2994;816;2645;171;606;388;1219;559;1825
171270;201605;395;1619;370;1565;122;484;138;674;260;1158
171280;201605;863;2637;717;2387;171;571;308;1121;479;1692
171320;201605;3755;11326;3161;10308;891;2920;1293;4365;2184;7285
171330;201605;2780;8099;2257;7280;623;2125;963;3103;1586;5228
171360;201605;1308;4375;1189;4188;159;597;817;2898;976;3495
171370;201605;631;1833;545;1715;117;421;297;918;414;1339
171380;201605;1261;4092;1053;3718;411;1482;253;975;664;2457
171395;201605;872;2646;680;2281;118;475;309;990;427;1465
171420;201605;2057;6371;1619;5565;395;1442;566;1956;961;3398
171430;201605;1049;3223;873;2937;184;626;448;1513;632;2139
171488;201605;2460;7563;2115;7061;466;1529;1134;3978;1600;5507
171500;201605;776;2348;664;2174;81;254;458;1548;539;1802
171510;201605;870;3059;779;2903;66;278;545;2073;611;2351
171515;201605;499;1433;386;1234;58;184;211;663;269;847
171525;201605;633;2029;541;1878;77;297;314;1050;391;1347
171550;201605;318;1078;246;937;86;366;49;192;135;558
171570;201605;1203;3820;1051;3523;208;667;666;2304;874;2971
171575;201605;1895;5335;1431;4502;280;923;647;2058;927;2981
171610;201605;5204;16612;4377;15193;1124;4353;1337;4704;2461;9057
171620;201605;2635;7627;2264;7136;111;446;1866;5901;1977;6347
171630;201605;868;2684;716;2443;216;788;309;1063;525;1851
171650;201605;2128;6641;1660;5694;445;1618;520;1795;965;3413
171660;201605;2381;6651;1856;5732;252;855;1028;3153;1280;4008
171665;201605;1454;4241;1165;3800;193;687;639;2179;832;2866
171670;201605;1893;5363;1560;4828;418;1415;633;1915;1051;3330
171700;201605;1086;3499;931;3212;132;497;566;1946;698;2443
171720;201605;704;2093;597;1923;187;629;246;820;433;1449
171750;201605;1141;3576;884;3071;254;881;249;925;503;1806
171780;201605;1118;3082;844;2690;91;313;488;1587;579;1900
171790;201605;1348;4742;1212;4501;282;1029;690;2724;972;3753
171800;201605;650;2046;574;1931;67;248;397;1384;464;1632
171820;201605;9996;29716;8322;27251;1634;5746;4266;14212;5900;19958
171830;201605;1359;5045;1212;4722;321;1214;500;2062;821;3276
171840;201605;768;2120;655;1966;37;116;536;1618;573;1734
171845;201605;701;1937;548;1678;82;278;287;898;369;1176
171850;201605;909;3245;805;3041;92;406;507;1904;599;2310
171855;201605;1089;3485;996;3311;71;284;742;2430;813;2714
171865;201605;443;1467;383;1372;75;275;190;685;265;960
171870;201605;716;2154;580;1910;150;538;198;695;348;1233
171875;201605;1240;3996;1040;3677;99;420;691;2412;790;2832
171880;201605;804;3034;784;3006;84;331;620;2441;704;2772
171884;201605;966;2659;704;2277;166;591;172;670;338;1261
171886;201605;1376;4484;1112;3953;315;1222;236;851;551;2073
171888;201605;700;2114;538;1805;54;184;300;1032;354;1216
171889;201605;503;1586;451;1502;94;324;221;790;315;1114
171890;201605;1184;3693;990;3417;137;527;589;2033;726;2560
171900;201605;486;1772;403;1568;104;413;168;677;272;1090
172000;201605;533;1765;463;1637;78;290;256;897;334;1187
172010;201605;1172;4083;1087;3939;120;526;791;2855;911;3381
172015;201605;322;1278;270;1169;53;211;140;635;193;846
172020;201605;2258;7542;2102;7293;258;942;1476;5196;1734;6138
172025;201605;689;2008;506;1694;85;310;245;854;330;1164
172030;201605;1130;3679;998;3463;60;261;751;2591;811;2852
172049;201605;1335;3470;982;2870;258;793;575;1705;833;2498
172065;201605;1340;3530;1097;3255;62;161;987;3007;1049;3168
172080;201605;2363;7469;2043;6922;211;838;1315;4420;1526;5258
172085;201605;503;1395;357;1100;54;152;97;308;151;460
172090;201605;3551;10004;2920;9066;162;563;2372;7431;2534;7994
172093;201605;604;1807;480;1606;118;461;232;779;350;1240
172097;201605;592;1794;476;1602;105;365;169;575;274;940
172100;201605;33368;98228;25559;84704;6921;25592;6295;21055;13216;46647
172110;201605;1644;6177;1460;5878;173;787;1045;4305;1218;5092
172120;201605;5021;15667;4171;14474;790;2729;2477;8996;3267;11725
172125;201605;241;770;200;695;39;164;90;310;129;474
172130;201605;552;1520;430;1322;41;154;272;826;313;980
172208;201605;2086;6185;1869;5883;278;907;1136;3606;1414;4513
172210;201605;2491;7599;2184;7164;491;1758;1174;3811;1665;5569
210005;201605;21612;67280;18287;62204;5901;21426;6396;22349;12297;43775
210010;201605;1605;5751;1450;5486;99;438;1145;4367;1244;4805
210015;201605;3386;10689;3018;10136;191;505;2560;8894;2751;9399
210020;201605;7142;17135;6688;16615;224;556;6077;15063;6301;15619
210030;201605;5455;18194;5122;17741;321;1471;4217;14508;4538;15979
210040;201605;1885;5210;1742;5045;88;258;1535;4474;1623;4732
210043;201605;6702;18828;5753;17647;608;1750;4131;13465;4739;15215
210047;201605;6483;24346;5897;23443;576;2663;4424;17620;5000;20283
210050;201605;2273;8402;1909;7704;678;2806;640;2798;1318;5604
210055;201605;1737;5981;1578;5735;125;493;1204;4396;1329;4889
210060;201605;7181;27865;6667;26925;1004;4179;4345;18081;5349;22260
210070;201605;7097;20851;6557;20193;132;477;5940;18406;6072;18883
210080;201605;3654;12682;3563;12567;36;168;3387;11974;3423;12142
210083;201605;4339;15276;3989;14907;121;501;3738;14063;3859;14564
210087;201605;2958;8679;2693;8338;283;888;2131;6730;2414;7618
210090;201605;9929;32474;9402;31645;474;1711;8110;27451;8584;29162
210095;201605;5927;21421;5682;21081;340;1388;4776;17914;5116;19302
210100;201605;7243;21753;6633;21008;704;2436;5185;16356;5889;18792
210110;201605;2835;9917;2731;9777;103;473;2466;8800;2569;9273
210120;201605;26010;70839;22676;67005;2637;6450;16599;52706;19236;59156
210125;201605;3543;11314;3418;11184;188;460;3036;10235;3224;10695
210130;201605;4108;12227;3795;11788;271;863;3118;9708;3389;10571
210135;201605;1661;4900;1454;4606;100;326;1169;3740;1269;4066
210140;201605;16962;54031;14757;51086;2566;9358;9251;33224;11817;42582
210150;201605;4608;11332;4137;10758;61;166;3883;10099;3944;10265
210160;201605;17482;55073;16420;53549;1323;3928;13327;44729;14650;48657
210170;201605;13918;49418;13525;48922;698;2597;12012;43988;12710;46585
210173;201605;1998;8096;1914;7958;100;580;1670;6874;1770;7454
210177;201605;3044;9429;2890;9251;150;489;2588;8374;2738;8863
210180;201605;1470;4509;1373;4364;54;203;1163;3675;1217;3878
210190;201605;4858;15418;4463;14695;212;922;3469;11220;3681;12142
210193;201605;1391;4370;1253;4143;72;256;1030;3460;1102;3716
210197;201605;2082;6944;1922;6760;239;819;1474;5371;1713;6190
210200;201605;8316;28022;7693;27134;1028;3398;5738;21112;6766;24510
210203;201605;6631;21074;6285;20627;403;1138;5444;18223;5847;19361
210207;201605;3050;9863;2868;9537;290;926;2111;7194;2401;8120
210210;201605;8353;28207;7979;27716;74;343;7332;26011;7406;26354
210215;201605;1148;4788;1094;4704;93;446;870;3810;963;4256
210220;201605;6202;24190;5898;23702;341;1616;4935;20038;5276;21654
210230;201605;5196;16860;4855;16342;271;926;4160;14155;4431;15081
210232;201605;12831;41256;10769;38637;1472;5588;7012;27092;8484;32680
210235;201605;3644;11392;3263;10914;162;636;2787;9381;2949;10017
210237;201605;2341;9012;2275;8917;36;184;2156;8494;2192;8678
210240;201605;3012;9431;2813;9157;154;473;2362;7755;2516;8228
210250;201605;5220;16921;4912;16520;124;623;4479;14954;4603;15577
210255;201605;2577;8289;2355;7910;296;1047;1693;5733;1989;6780
210260;201605;5130;16762;4716;16139;570;1865;3491;12348;4061;14213
210270;201605;5378;15103;4723;14196;125;566;4138;12332;4263;12898
210275;201605;3571;8697;3374;8480;417;1117;2739;6924;3156;8041
210280;201605;5575;16840;4819;15826;269;1153;3700;11973;3969;13126
210290;201605;5650;18771;5215;18252;312;1087;4444;15815;4756;16902
210300;201605;37801;105264;31385;97406;2045;6760;23819;77190;25864;83950
210310;201605;2910;8190;2665;7865;82;184;2349;7035;2431;7219
210312;201605;2198;6942;2080;6787;61;292;1842;5990;1903;6282
210315;201605;2613;8666;2420;8413;139;526;2086;7358;2225;7884
210317;201605;4173;12972;3979;12737;156;562;3635;11699;3791;12261
210320;201605;19197;62368;17653;60513;895;3219;15066;52627;15961;55846
210325;201605;3593;11211;3190;10608;238;903;2478;8356;2716;9259
210330;201605;35769;87376;28218;79238;3968;9487;18349;59074;22317;68561
210340;201605;11750;35240;10686;33871;1160;3153;7792;26678;8952;29831
210350;201605;9935;30710;8937;29338;585;1930;7205;24026;7790;25956
210355;201605;3905;14316;3586;13842;188;798;3079;12154;3267;12952
210360;201605;15968;48416;14460;46365;1083;3797;11301;36439;12384;40236
210370;201605;9387;22549;7858;20915;290;552;6924;19193;7214;19745
210375;201605;3116;9435;2627;8804;782;2716;1246;4307;2028;7023
210380;201605;6089;16910;5425;16009;447;1196;4390;13272;4837;14468
210390;201605;2877;10277;2618;9861;131;696;2212;8310;2343;9006
210400;201605;4803;15235;4600;15007;115;336;4360;14362;4475;14698
210405;201605;8339;22744;6694;20448;2178;6752;2281;7823;4459;14575
210407;201605;2029;7234;1753;6762;221;847;1225;4846;1446;5693
210408;201605;2408;9331;2254;9139;145;684;1905;7950;2050;8634
210409;201605;3705;13492;3494;13187;210;1016;2870;10859;3080;11875
210410;201605;3565;11959;3460;11828;321;958;2828;10142;3149;11100
210420;201605;4054;13410;3717;12840;243;808;3013;10604;3256;11412
210430;201605;2166;6708;2089;6621;114;346;1830;5853;1944;6199
210440;201605;3926;12349;3798;12189;201;588;3416;11123;3617;11711
210450;201605;2805;8795;2499;8349;140;507;2011;6696;2151;7203
210455;201605;3900;11450;3497;10860;541;1656;2438;7911;2979;9567
210460;201605;3591;11872;3335;11477;184;750;2724;9389;2908;10139
210462;201605;1456;5281;1354;5091;90;424;1072;4032;1162;4456
210465;201605;2509;8361;2345;8136;195;569;1956;7012;2151;7581
210467;201605;6170;20474;5759;20001;396;1397;4858;17165;5254;18562
210470;201605;2036;5525;1495;4731;87;238;1108;3585;1195;3823
210480;201605;14691;46934;12803;44532;2371;8081;8357;31250;10728;39331
210490;201605;3599;10071;3151;9455;126;433;2658;7957;2784;8390
210500;201605;6271;25930;6039;25525;645;2806;4623;20037;5268;22843
210510;201605;6498;22145;6148;21741;347;1025;5244;19180;5591;20205
210515;201605;3657;11741;3502;11566;80;233;3289;11034;3369;11267
210520;201605;2586;7921;2362;7600;165;495;1955;6465;2120;6960
210530;201605;37254;114381;29892;103271;7492;29136;12264;43713;19756;72849
210535;201605;3226;11162;3097;10992;95;314;2800;10091;2895;10405
210540;201605;13490;44194;11821;41846;2408;8315;6774;25909;9182;34224
210542;201605;5777;16757;5274;16210;297;710;4570;14485;4867;15195
210545;201605;2337;7562;2227;7379;53;277;1972;6461;2025;6738
210547;201605;3715;13282;3477;12894;291;975;2693;10304;2984;11279
210550;201605;6026;17938;5519;17410;261;610;5052;16403;5313;17013
210560;201605;4088;12831;3664;12144;170;646;3069;10172;3239;10818
210565;201605;1474;5266;1263;4929;100;503;932;3676;1032;4179
210570;201605;12325;34841;11180;33546;743;1679;9604;29820;10347;31499
210580;201605;3191;9448;2860;9035;287;648;2221;7636;2508;8284
210590;201605;4044;12801;3744;12422;291;1027;3163;10566;3454;11593
210592;201605;2492;7827;2395;7670;41;177;2123;6801;2164;6978
210594;201605;2662;7501;2147;6751;120;293;1646;5432;1766;5725
210596;201605;2683;9998;2543;9733;261;1089;1867;7268;2128;8357
210598;201605;1890;5869;1728;5671;93;351;1493;4873;1586;5224
210600;201605;3212;9294;2804;8750;177;570;2216;6928;2393;7498
210610;201605;2506;8283;2350;8083;117;531;2044;6935;2161;7466
210620;201605;1922;6292;1791;6135;53;140;1625;5711;1678;5851
210630;201605;3623;12797;3243;12180;337;1478;2249;8500;2586;9978
210632;201605;4526;15732;4192;15251;434;1697;3231;11811;3665;13508
210635;201605;1880;6577;1784;6433;100;348;1555;5714;1655;6062
210637;201605;2665;9079;2459;8800;156;619;2001;7222;2157;7841
210640;201605;4231;15907;4159;15827;7;32;4059;15596;4066;15628
210650;201605;6832;20929;6628;20681;206;637;6264;19640;6470;20277
210660;201605;8114;24109;7368;23021;258;887;6671;20826;6929;21713
210663;201605;2689;8122;2537;7950;167;581;2146;6791;2313;7372
210667;201605;1854;6439;1748;6272;85;374;1516;5462;1601;5836
210670;201605;4472;16497;4252;16138;222;1000;3539;13539;3761;14539
210675;201605;5077;14092;4684;13618;397;987;3843;11551;4240;12538
210680;201605;4057;11150;3591;10595;180;468;3083;9227;3263;9695
210690;201605;7360;24779;7062;24461;259;857;6261;22391;6520;23248
210700;201605;2632;7823;2429;7597;517;1334;1561;5629;2078;6963
210710;201605;4840;15936;4553;15493;204;876;3838;13006;4042;13882
210720;201605;2582;9350;2441;9155;133;612;2148;8013;2281;8625
210725;201605;1087;4126;976;3924;124;519;609;2546;733;3065
210730;201605;1122;3524;1001;3350;89;271;783;2672;872;2943
210735;201605;4116;14273;3765;13699;613;2311;2573;9650;3186;11961
210740;201605;4971;14948;4689;14659;208;902;4248;13030;4456;13932
210745;201605;3956;11658;3708;11344;253;690;3128;9696;3381;10386
210750;201605;20269;54928;17890;52261;1889;5467;13754;41289;15643;46756
210760;201605;5858;16777;5448;16348;35;112;5300;15971;5335;16083
210770;201605;5889;16204;5115;15320;124;488;4622;13854;4746;14342
210780;201605;8174;27296;7485;26144;879;3049;5235;18862;6114;21911
210790;201605;4633;14617;4207;14130;268;678;3444;12238;3712;12916
210800;201605;4795;13591;4328;13039;132;422;3865;11741;3997;12163
210805;201605;3776;15652;3642;15421;173;902;3143;13399;3316;14301
210810;201605;5417;16484;5008;15967;336;657;4312;14394;4648;15051
210820;201605;7715;22418;7037;21454;1106;3273;4732;14862;5838;18135
210825;201605;5662;19518;5391;19154;629;2106;4192;15424;4821;17530
210830;201605;8346;24559;7912;24041;890;2302;6245;19825;7135;22127
210840;201605;3652;9991;3274;9438;146;391;2722;7863;2868;8254
210845;201605;5826;17771;5627;17555;82;190;5413;17105;5495;17295
210850;201605;6151;21812;5562;20838;650;2782;3904;14653;4554;17435
210860;201605;17781;52766;15979;50329;1242;3958;12640;40446;13882;44404
210870;201605;5845;19650;5328;18996;607;2104;4023;14699;4630;16803
210880;201605;4224;13796;4025;13540;313;1161;3323;11196;3636;12357
210890;201605;5180;15230;4703;14685;429;1233;3838;12503;4267;13736
210900;201605;4953;14818;4088;13420;1523;5264;1005;3550;2528;8814
210905;201605;1832;5772;1643;5509;120;314;1303;4552;1423;4866
210910;201605;8534;27177;7681;25784;1107;3946;5170;17523;6277;21469
210920;201605;2878;10403;2754;10197;168;789;2245;8301;2413;9090
210923;201605;1499;5122;1393;4968;147;591;937;3458;1084;4049
210927;201605;4784;15379;4531;15113;58;203;4344;14591;4402;14794
210930;201605;2468;9016;2325;8813;118;680;1971;7342;2089;8022
210940;201605;2850;10932;2777;10799;166;749;2364;9162;2530;9911
210945;201605;5899;17863;5693;17647;272;370;5317;16976;5589;17346
210950;201605;5267;16252;4542;15119;429;1450;3357;11419;3786;12869
210955;201605;1878;6077;1660;5753;173;596;1167;4235;1340;4831
210960;201605;9351;29649;8622;28733;2109;6733;4941;17829;7050;24562
210970;201605;1356;4796;1196;4538;156;656;828;3143;984;3799
210975;201605;1782;5955;1704;5827;107;388;1370;4712;1477;5100
210980;201605;10137;23890;9795;23542;686;1314;8666;21431;9352;22745
210990;201605;16635;50686;13528;46422;3166;11427;6623;23745;9789;35172
211000;201605;15337;49436;13629;47411;783;3316;11307;39924;12090;43240
211003;201605;4780;17025;4348;16439;298;1379;3310;12856;3608;14235
211010;201605;6446;23676;6181;23366;68;312;5900;22478;5968;22790
211020;201605;7399;24016;7172;23692;624;2223;5823;19270;6447;21493
211023;201605;2226;7550;2148;7424;175;667;1742;6035;1917;6702
211027;201605;2896;11176;2817;11055;293;1186;2247;8926;2540;10112
211030;201605;3847;11798;3593;11530;612;1428;2664;9379;3276;10807
211040;201605;4336;16380;4147;16095;136;740;3647;14228;3783;14968
211050;201605;10181;26352;9787;25922;261;640;9185;24399;9446;25039
211060;201605;6138;21699;5956;21449;455;1704;5105;18613;5560;20317
211065;201605;1939;6345;1790;6152;58;167;1662;5812;1720;5979
211070;201605;8070;27795;7422;26749;396;1539;6149;22486;6545;24025
211080;201605;1330;4080;1140;3793;76;368;881;2823;957;3191
211085;201605;1902;6491;1736;6215;292;1085;1136;4134;1428;5219
211090;201605;3520;10272;3285;9952;125;492;2831;8459;2956;8951
211100;201605;6614;17137;6471;16988;38;127;6306;16585;6344;16712
211102;201605;2978;11347;2807;11105;236;968;2348;9456;2584;10424
211105;201605;2652;8551;2269;7967;213;843;1675;5843;1888;6686
211107;201605;4436;14135;4008;13592;216;762;3273;11435;3489;12197
211110;201605;6360;18924;5121;17083;933;3049;3113;10889;4046;13938
211120;201605;35637;99255;32130;95154;5494;15590;21929;67812;27423;83402
211125;201605;2069;6604;1829;6224;118;466;1507;5129;1625;5595
211130;201605;143731;394078;132096;379857;23181;68133;75768;228495;98949;296628
211140;201605;5473;17686;5120;17166;182;731;4386;14697;4568;15428
211150;201605;9666;28070;8724;26896;421;1498;7352;22705;7773;24203
211153;201605;2840;8737;2585;8407;606;1983;1661;5584;2267;7567
211157;201605;1198;3860;1038;3623;87;396;693;2485;780;2881
211160;201605;4126;13526;3500;12487;250;1212;2436;8474;2686;9686
211163;201605;1680;5563;1579;5424;36;115;1433;5033;1469;5148
211167;201605;1509;5040;1447;4958;34;157;1351;4635;1385;4792
211170;201605;6353;16815;6083;16501;104;309;5645;15265;5749;15574
211172;201605;2439;7200;2217;6892;120;510;1886;5783;2006;6293
211174;201605;2789;8140;2516;7803;70;352;2274;6937;2344;7289
211176;201605;4285;13431;3678;12630;386;1487;2652;9221;3038;10708
211178;201605;3886;10269;3654;10019;60;157;3490;9563;3550;9720
211180;201605;4220;14706;3976;14348;288;1154;3287;11985;3575;13139
211190;201605;2826;9442;2622;9145;71;342;2297;8006;2368;8348
211195;201605;1466;4465;1227;4171;52;148;1039;3661;1091;3809
211200;201605;2157;7161;1899;6810;356;1204;1160;4463;1516;5667
211210;201605;6764;20840;6421;20380;422;1304;5411;17336;5833;18640
211220;201605;34120;98766;29599;93027;5549;17943;18597;60073;24146;78016
211223;201605;5119;15546;4685;14877;519;1663;3426;11048;3945;12711
211227;201605;1618;5729;1474;5506;129;526;1175;4432;1304;4958
211230;201605;8362;27276;7560;25963;780;2777;5662;19768;6442;22545
211240;201605;7988;27632;7565;27115;265;1235;6776;24094;7041;25329
211245;201605;5544;16396;5507;16357;115;187;5336;16060;5451;16247
211250;201605;13240;43310;12475;42422;1452;4180;9815;35281;11267;39461
211260;201605;8567;26614;8165;26078;489;1686;7222;23094;7711;24780
211270;201605;10305;35330;9243;34004;518;2361;7286;27358;7804;29719
211280;201605;12887;38408;11986;37318;1066;2747;9744;31630;10810;34377
211285;201605;1720;6315;1507;5857;272;1144;763;3095;1035;4239
211290;201605;7187;23615;6898;23250;456;1404;5907;20305;6363;21709
211300;201605;8261;24872;7743;24190;151;422;7225;22792;7376;23214
211400;201605;11859;36957;10426;34980;2764;9445;4955;18369;7719;27814
220005;201605;1838;5274;1683;5047;69;260;1371;4027;1440;4287
220010;201605;1367;4051;1221;3831;48;193;985;3043;1033;3236
220020;201605;3283;10437;3117;10167;562;1843;1955;6404;2517;8247
220025;201605;2246;5542;2037;5229;24;75;1742;4412;1766;4487
220027;201605;1375;3695;1231;3510;65;192;1006;2886;1071;3078
220030;201605;3202;8860;3140;8770;148;516;2778;7645;2926;8161
220040;201605;7539;23557;6972;22544;1459;4716;4202;13639;5661;18355
220045;201605;1382;4567;1263;4343;55;251;974;3280;1029;3531
220050;201605;4435;13397;3884;12479;200;807;3113;9916;3313;10723
220060;201605;2040;5115;1909;4963;43;89;1738;4534;1781;4623
220070;201605;2426;7148;2224;6831;156;476;1793;5525;1949;6001
220080;201605;709;2138;658;2062;49;206;551;1672;600;1878
220090;201605;1777;4538;1494;4168;52;170;1295;3561;1347;3731
220095;201605;725;1966;677;1902;14;65;625;1725;639;1790
220100;201605;1345;4094;1136;3733;79;331;854;2763;933;3094
220105;201605;2247;7132;2014;6696;152;502;1484;4982;1636;5484
220110;201605;3388;9850;3186;9528;107;429;2796;8233;2903;8662
220115;201605;2445;8413;2350;8261;131;547;2078;7263;2209;7810
220117;201605;1295;3460;1077;3135;54;167;882;2570;936;2737
220120;201605;12217;35536;11315;34453;140;615;10637;32366;10777;32981
220130;201605;853;2944;770;2810;33;186;663;2381;696;2567
220140;201605;1668;4466;1476;4232;189;445;1181;3505;1370;3950
220150;201605;7018;21463;6640;20937;162;683;5873;18374;6035;19057
220155;201605;1112;3395;905;3016;47;187;596;1966;643;2153
220157;201605;1069;2702;951;2529;21;69;831;2177;852;2246
220160;201605;2597;7865;2318;7361;91;409;1861;5824;1952;6233
220170;201605;1368;4188;1180;3886;42;203;957;3123;999;3326
220173;201605;2058;6214;1709;5544;44;219;1359;4332;1403;4551
220177;201605;1764;5246;1735;5208;49;194;1628;4859;1677;5053
220180;201605;1116;3059;941;2732;24;85;663;1840;687;1925
220190;201605;4573;14997;4239;14545;547;1957;3177;10931;3724;12888
220191;201605;1414;4680;1335;4548;138;521;1000;3354;1138;3875
220192;201605;1764;5011;1425;4412;91;285;1038;3234;1129;3519
220194;201605;1696;5114;1528;4835;110;409;1181;3647;1291;4056
220196;201605;2008;5898;1851;5634;139;494;1476;4454;1615;4948
220198;201605;1331;3816;1025;3415;11;40;960;3246;971;3286
220200;201605;4440;14795;4157;14402;522;1878;3131;10945;3653;12823
220202;201605;2170;6528;1935;6130;42;209;1676;5198;1718;5407
220205;201605;2761;7259;2480;6867;41;160;2221;6088;2262;6248
220207;201605;890;2698;763;2472;72;278;541;1729;613;2007
220208;201605;1807;5819;1565;5397;229;877;956;3298;1185;4175
220209;201605;1536;4659;1361;4368;46;203;1122;3558;1168;3761
220210;201605;1673;4535;1489;4252;36;156;1237;3451;1273;3607
220211;201605;1575;4511;1509;4436;51;203;1331;3872;1382;4075
220213;201605;1747;4943;1621;4716;34;132;1325;3752;1359;3884
220217;201605;1975;6372;1897;6286;37;131;1757;5907;1794;6038
220220;201605;10790;29928;9697;28325;731;1852;7125;21407;7856;23259
220225;201605;1081;3142;908;2911;36;132;750;2386;786;2518
220230;201605;5288;14673;4833;14027;146;425;4323;12608;4469;13033
220240;201605;2909;9015;2697;8644;139;519;2165;6912;2304;7431
220245;201605;1470;4009;1265;3721;23;79;1128;3370;1151;3449
220250;201605;3173;9091;2894;8676;82;319;2528;7578;2610;7897
220253;201605;1607;4836;1383;4431;175;637;954;3027;1129;3664
220255;201605;1725;4887;1498;4503;44;180;1217;3505;1261;3685
220260;201605;4591;14804;4074;13867;305;1088;3010;10342;3315;11430
220265;201605;1330;4603;1216;4427;120;489;793;2933;913;3422
220270;201605;6871;22292;6626;21869;379;1636;5480;17610;5859;19246
220271;201605;1479;4156;1331;3923;73;193;1106;3335;1179;3528
220272;201605;1785;5378;1629;5119;51;212;1297;4004;1348;4216
220273;201605;1207;3511;1073;3275;83;258;782;2391;865;2649
220275;201605;2081;5342;1732;4927;25;106;1564;4397;1589;4503
220277;201605;2221;6218;1966;5825;75;261;1583;4632;1658;4893
220280;201605;1566;4206;1379;3889;83;288;1113;3056;1196;3344
220285;201605;1602;4293;1330;3921;27;105;1194;3534;1221;3639
220290;201605;5906;19961;5151;18903;466;1959;3775;13932;4241;15891
220300;201605;1814;6129;1649;5884;81;433;1351;4723;1432;5156
220310;201605;2406;8222;2246;8044;77;330;1939;7075;2016;7405
220320;201605;3051;9303;2600;8478;257;943;1818;5896;2075;6839
220323;201605;1447;5154;1269;4895;134;555;972;3780;1106;4335
220325;201605;1157;3735;987;3394;77;321;715;2449;792;2770
220327;201605;1283;4160;1180;3984;34;186;966;3178;1000;3364
220330;201605;3549;9726;3250;9363;111;287;2936;8556;3047;8843
220335;201605;1839;5728;1671;5540;33;91;1566;5261;1599;5352
220340;201605;1843;5100;1582;4704;99;330;1210;3560;1309;3890
220342;201605;1106;3645;1043;3550;56;252;844;2849;900;3101
220345;201605;2872;7371;2539;6875;59;132;2310;6274;2369;6406
220350;201605;3934;10460;3379;9610;191;579;2619;7402;2810;7981
220360;201605;1286;3582;1113;3313;97;324;847;2475;944;2799
220370;201605;9167;26485;8366;25467;315;1094;7458;22671;7773;23765
220375;201605;1486;4761;1394;4648;16;43;1337;4513;1353;4556
220380;201605;1367;3678;1150;3385;44;157;957;2760;1001;2917
220385;201605;838;2160;679;1907;17;68;546;1499;563;1567
220390;201605;9460;28853;8347;26923;2115;6998;3177;10521;5292;17519
220400;201605;1507;3670;1217;3223;39;125;988;2541;1027;2666
220410;201605;1209;3533;1051;3289;67;259;823;2535;890;2794
220415;201605;880;2397;778;2262;52;153;561;1605;613;1758
220420;201605;2159;6235;1829;5592;75;223;1446;4422;1521;4645
220430;201605;2578;7295;2509;7205;125;409;2207;6285;2332;6694
220435;201605;1639;4882;1516;4679;38;155;1267;3877;1305;4032
220440;201605;2370;7861;2225;7669;150;552;1844;6296;1994;6848
220450;201605;2074;6420;1735;5924;385;1402;980;3377;1365;4779
220455;201605;1336;4175;1249;4049;42;135;1135;3721;1177;3856
220460;201605;887;2442;816;2361;39;116;708;2028;747;2144
220465;201605;2344;7765;2135;7445;363;1330;1430;5042;1793;6372
220470;201605;3791;11249;3465;10732;171;536;2723;8366;2894;8902
220480;201605;2493;7141;2212;6725;134;362;1723;5281;1857;5643
220490;201605;2286;6559;2111;6341;58;212;1869;5576;1927;5788
220500;201605;3236;8714;2764;7908;87;391;2211;6154;2298;6545
220510;201605;2756;7961;2242;7091;86;322;1671;5250;1757;5572
220515;201605;1862;4597;1665;4336;129;294;1365;3599;1494;3893
220520;201605;5185;14193;4731;13594;103;301;4262;12323;4365;12624
220525;201605;1265;3615;1203;3519;37;127;1041;3035;1078;3162
220527;201605;1365;4199;1210;3887;127;424;862;2825;989;3249
220530;201605;1256;3628;1111;3411;46;196;973;2921;1019;3117
220535;201605;863;2614;820;2557;69;231;629;1948;698;2179
220540;201605;3464;11213;3314;10980;114;515;2896;9511;3010;10026
220545;201605;1385;4632;1316;4500;138;535;994;3359;1132;3894
220550;201605;9198;29480;8505;28318;740;2630;6377;21222;7117;23852
220551;201605;1464;4672;1340;4484;65;300;1067;3508;1132;3808
220552;201605;1595;4969;1378;4558;57;298;1067;3402;1124;3700
220553;201605;1596;4656;1323;4241;46;193;1032;3373;1078;3566
220554;201605;798;2334;714;2203;56;175;562;1731;618;1906
220555;201605;2219;6810;2053;6584;47;235;1847;5856;1894;6091
220556;201605;1440;4465;1288;4175;49;198;985;3125;1034;3323
220557;201605;1553;5042;1390;4727;128;459;950;3234;1078;3693
220558;201605;1078;3296;967;3116;48;216;753;2356;801;2572
220559;201605;1568;4467;1421;4219;33;107;1225;3640;1258;3747
220560;201605;1642;4121;1380;3766;47;127;1171;3148;1218;3275
220570;201605;7279;23496;6835;22710;1216;4052;4326;14723;5542;18775
220580;201605;6488;20494;6349;20296;242;815;5786;18463;6028;19278
220585;201605;2077;7136;1928;6875;167;647;1521;5413;1688;6060
220590;201605;1316;3926;1180;3733;168;564;826;2672;994;3236
220595;201605;2342;6884;2184;6680;34;161;1997;6052;2031;6213
220600;201605;1295;3127;1078;2854;163;279;797;2280;960;2559
220605;201605;1948;5683;1700;5291;67;238;1386;4259;1453;4497
220610;201605;2692;8212;2576;8056;55;226;2356;7339;2411;7565
220620;201605;7579;25318;7297;24936;291;1409;6480;21888;6771;23297
220630;201605;392;1207;332;1098;45;159;175;595;220;754
220635;201605;1662;5810;1496;5449;82;390;1082;3855;1164;4245
220640;201605;2643;7752;2370;7370;102;363;2004;6186;2106;6549
220650;201605;2207;6453;1968;6024;108;364;1512;4639;1620;5003
220660;201605;2765;8360;2489;7995;135;653;2127;6605;2262;7258
220665;201605;1169;4019;1092;3885;19;102;970;3440;989;3542
220667;201605;1693;5605;1581;5421;76;278;1321;4533;1397;4811
220669;201605;1855;6065;1755;5893;244;1014;1206;3958;1450;4972
220670;201605;1952;5789;1727;5498;121;327;1430;4673;1551;5000
220672;201605;2495;7206;2332;7009;184;581;1958;5935;2142;6516
220675;201605;1269;3657;1187;3509;68;170;942;2810;1010;2980
220680;201605;2389;7428;2256;7256;150;482;1902;6155;2052;6637
220690;201605;1723;4770;1492;4405;112;327;1149;3463;1261;3790
220695;201605;935;2651;855;2517;30;96;681;1997;711;2093
220700;201605;8498;24243;7389;22543;502;1718;5619;17022;6121;18740
220710;201605;808;2398;679;2163;40;119;500;1605;540;1724
220720;201605;2086;5432;1973;5287;51;150;1756;4683;1807;4833
220730;201605;1372;3890;1172;3583;18;84;999;3021;1017;3105
220735;201605;1019;2610;824;2275;41;113;665;1817;706;1930
220740;201605;1365;4321;1189;4087;72;228;980;3464;1052;3692
220750;201605;3974;11303;3658;10828;298;789;2963;8915;3261;9704
220755;201605;1198;3377;1070;3175;46;164;858;2509;904;2673
220760;201605;2654;9104;2437;8815;135;663;2058;7363;2193;8026
220770;201605;21941;72680;19629;68291;6440;23543;5985;21697;12425;45240
220775;201605;1263;3500;1218;3450;17;52;1183;3355;1200;3407
220777;201605;1599;4394;1372;4056;65;156;1068;3168;1133;3324
220779;201605;1409;3622;1337;3529;44;151;1180;3071;1224;3222
220780;201605;5841;15745;5159;14729;384;1100;4127;11837;4511;12937
220785;201605;1295;3346;1223;3232;40;102;1120;2940;1160;3042
220790;201605;10150;30948;9399;29814;682;2442;7574;23868;8256;26310
220793;201605;828;2356;748;2240;37;132;625;1873;662;2005
220795;201605;1419;4112;1368;4042;59;175;1247;3702;1306;3877
220800;201605;16150;44101;14558;41867;884;2885;11017;31299;11901;34184
220810;201605;3344;9664;2907;8929;114;453;2322;7038;2436;7491
220820;201605;5458;14829;4980;14170;250;683;4321;12276;4571;12959
220830;201605;7516;21106;6990;20283;559;1658;5515;16069;6074;17727
220840;201605;14039;44383;12514;41395;2735;9216;6018;20327;8753;29543
220850;201605;2860;9801;2702;9601;101;446;2430;8668;2531;9114
220855;201605;615;1886;535;1743;28;118;406;1295;434;1413
220860;201605;943;2524;838;2360;30;106;714;1983;744;2089
220865;201605;2598;7165;2086;6273;65;311;1663;4838;1728;5149
220870;201605;2239;7507;1987;7180;49;221;1805;6535;1854;6756
220880;201605;4714;12839;4388;12460;78;235;4110;11718;4188;11953
220885;201605;1258;4575;1116;4313;83;399;839;3225;922;3624
220887;201605;1376;3434;1212;3203;15;63;1125;2953;1140;3016
220890;201605;1629;5616;1458;5304;117;404;1126;4206;1243;4610
220900;201605;1850;5232;1645;4927;49;142;1402;4167;1451;4309
220910;201605;1530;4688;1341;4406;40;115;1180;3947;1220;4062
220915;201605;1019;2867;873;2587;26;104;665;1911;691;2015
220920;201605;1347;4825;1218;4637;87;434;916;3410;1003;3844
220930;201605;1383;4557;1314;4451;51;227;1106;3738;1157;3965
220935;201605;1083;3282;944;2985;35;156;648;1975;683;2131
220937;201605;1505;4133;1273;3748;54;207;977;2804;1031;3011
220940;201605;1341;4245;1255;4083;74;318;934;2994;1008;3312
220945;201605;428;1587;390;1512;28;134;282;1076;310;1210
220950;201605;1327;3287;968;2707;24;96;719;1942;743;2038
220955;201605;1453;4183;1283;3891;78;228;974;2964;1052;3192
220960;201605;913;2368;725;2055;21;66;570;1601;591;1667
220965;201605;1634;4877;1541;4737;45;229;1316;3916;1361;4145
220970;201605;2168;5723;1620;4835;131;400;1138;3442;1269;3842
220975;201605;678;2205;631;2143;27;158;574;1886;601;2044
220980;201605;1288;3858;1131;3605;70;237;849;2716;919;2953
220985;201605;1189;3526;1126;3439;82;297;860;2564;942;2861
220987;201605;1484;4722;1338;4487;77;347;1036;3398;1113;3745
220990;201605;1812;5254;1567;4839;38;199;1240;3733;1278;3932
220995;201605;1269;3751;970;3275;94;342;671;2352;765;2694
220997;201605;2265;6989;2167;6849;45;210;2020;6333;2065;6543
221000;201605;4218;12917;3944;12453;290;1124;3095;9607;3385;10731
221005;201605;1459;4553;1338;4331;527;1558;537;1901;1064;3459
221010;201605;1163;3034;996;2830;41;124;860;2421;901;2545
221020;201605;1758;5476;1637;5252;64;270;1221;3857;1285;4127
221030;201605;1499;4453;1346;4200;58;239;1101;3403;1159;3642
221035;201605;1457;4019;1366;3900;59;125;1248;3649;1307;3774
221037;201605;621;1843;551;1730;14;54;404;1222;418;1276
221038;201605;602;1695;490;1501;34;105;314;970;348;1075
221039;201605;929;2609;838;2477;38;159;691;1975;729;2134
221040;201605;4535;14109;4250;13648;180;638;3478;11236;3658;11874
221050;201605;3464;10515;3250;10229;138;482;2812;8811;2950;9293
221060;201605;8104;23759;7037;22018;502;1695;5388;16853;5890;18548
221062;201605;1276;4476;1161;4249;47;245;949;3440;996;3685
221063;201605;1071;3500;972;3324;172;562;633;2255;805;2817
221065;201605;2803;7600;2520;7163;106;293;2091;5886;2197;6179
221070;201605;3758;11877;3318;11114;141;555;2638;8876;2779;9431
221080;201605;3492;8949;2960;8221;92;287;2534;7035;2626;7322
221090;201605;1413;3876;1203;3538;31;139;1005;2895;1036;3034
221093;201605;1630;4867;1539;4681;244;796;899;2659;1143;3455
221095;201605;960;2549;853;2393;15;46;733;2039;748;2085
221097;201605;800;2239;657;1988;29;120;470;1380;499;1500
221100;201605;111690;326608;102299;311147;20269;64682;57974;173824;78243;238506
221110;201605;10332;32523;9613;31642;380;1603;8166;26652;8546;28255
221120;201605;4054;13171;3845;12811;665;2320;2533;8468;3198;10788
221130;201605;4591;13225;3856;11709;1118;3360;1638;5060;2756;8420
221135;201605;1507;4633;1397;4488;108;410;1169;3719;1277;4129
221140;201605;1348;3297;1224;3135;37;84;1067;2719;1104;2803
221150;201605;1222;3120;1016;2773;30;122;788;2109;818;2231
221160;201605;828;2194;778;2124;32;88;618;1695;650;1783
221170;201605;1142;3497;1056;3355;52;169;852;2708;904;2877
230010;201605;3398;9160;2735;8030;193;648;2086;6025;2279;6673
230015;201605;2909;9974;2730;9589;373;1487;1692;5851;2065;7338
230020;201605;13694;44639;13298;44004;676;2553;11247;37140;11923;39693
230030;201605;11979;34373;10761;32475;443;1606;8808;26318;9251;27924
230040;201605;4532;12394;3808;11158;281;972;2754;7950;3035;8922
230050;201605;2654;9019;2085;7504;481;1757;619;2295;1100;4052
230060;201605;2223;6398;1909;5840;67;266;1471;4430;1538;4696
230070;201605;4192;11631;3602;10661;296;1026;2406;7164;2702;8190
230075;201605;8821;31273;8238;30134;543;2870;6386;22692;6929;25562
230080;201605;2412;6291;1957;5632;92;333;1588;4503;1680;4836
230090;201605;3881;11215;3436;10456;386;1315;2415;7354;2801;8669
230100;201605;16639;49446;15357;47173;2492;8254;9138;28229;11630;36483
230110;201605;13096;41507;11999;39202;2312;7763;6185;20097;8497;27860
230120;201605;7935;21986;6851;20388;764;2201;4547;14252;5311;16453
230125;201605;3055;8810;2534;7889;165;601;1829;5643;1994;6244
230130;201605;5818;18965;4969;17157;453;1745;3330;11376;3783;13121
230140;201605;3514;11175;2991;10215;288;1072;2038;7039;2326;8111
230150;201605;1701;5301;1472;4832;288;1016;764;2482;1052;3498
230160;201605;6212;18519;5557;17545;259;1020;4463;14006;4722;15026
230170;201605;6299;19747;5470;18189;316;1232;3913;12904;4229;14136
230180;201605;1708;5028;1496;4606;73;320;1087;3186;1160;3506
230185;201605;3925;12816;3534;12113;554;1949;2182;7674;2736;9623
230190;201605;12665;40376;11207;37462;2209;7936;5294;17635;7503;25571
230195;201605;5309;16153;4641;15025;327;1297;3546;11217;3873;12514
230200;201605;5146;14787;4626;13776;410;1289;3396;10017;3806;11306
230205;201605;4145;13418;3741;12715;240;1062;2655;8896;2895;9958
230210;201605;8897;25503;7796;23761;1309;4071;4689;14569;5998;18640
230220;201605;13275;37570;11958;35294;971;3229;8709;25304;9680;28533
230230;201605;7309;23336;6690;22153;791;2670;4502;15038;5293;17708
230240;201605;13861;38741;12181;35973;565;1861;9412;27522;9977;29383
230250;201605;9773;30284;9693;30153;527;1964;7640;23429;8167;25393
230260;201605;14272;47604;13255;45563;2125;7785;7459;26112;9584;33897
230270;201605;7535;22066;6467;20219;706;2463;4200;13202;4906;15665
230280;201605;19784;57986;17594;54282;1443;4684;13015;39939;14458;44623
230290;201605;4818;14527;4115;13111;547;1668;2720;8729;3267;10397
230300;201605;4382;13165;4181;12881;251;926;3385;10295;3636;11221
230310;201605;4838;14489;4245;13468;204;838;3072;9607;3276;10445
230320;201605;7121;22078;6470;20950;426;1693;4789;15303;5215;16996
230330;201605;4817;14054;4074;12600;319;1050;2844;8688;3163;9738
230340;201605;3367;11317;3062;10684;336;1314;1970;6748;2306;8062
230350;201605;18157;54949;16555;52251;1728;6334;10009;32077;11737;38411
230360;201605;3262;9290;2633;8145;221;755;1719;5260;1940;6015
230365;201605;3013;8158;2638;7516;108;402;2106;5947;2214;6349
230370;201605;54351;172810;48987;163712;13056;45582;20242;70436;33298;116018
230380;201605;6486;18984;5407;16971;264;912;3843;11969;4107;12881
230390;201605;3485;10996;3089;10331;212;935;2185;7164;2397;8099
230393;201605;3194;10438;2733;9534;173;854;1944;6547;2117;7401
230395;201605;5704;16619;5108;15611;771;2346;3025;9565;3796;11911
230400;201605;5488;16570;4830;15531;258;1170;3746;11793;4004;12963
230410;201605;14363;45522;12442;41530;1689;5947;7303;24431;8992;30378
230420;201605;24280;77577;21998;73103;4624;16449;10125;33476;14749;49925
230423;201605;4181;13758;3859;13132;243;1018;2897;9794;3140;10812
230425;201605;5527;18311;5077;17363;701;2459;3168;10894;3869;13353
230426;201605;2675;7495;2123;6463;69;294;1576;4680;1645;4974
230427;201605;1835;5443;1398;4484;173;564;794;2478;967;3042
230428;201605;8707;26972;8262;26166;1332;4598;4731;14826;6063;19424
230430;201605;4576;14456;4225;13821;300;1204;3050;9744;3350;10948
230435;201605;4968;15640;4443;14672;733;2755;2413;7858;3146;10613
230440;201605;355421;1043557;324351;991087;73271;234646;149733;461060;223004;695706
230445;201605;4557;12247;3874;11224;270;775;2731;7950;3001;8725
230450;201605;3592;11302;3133;10472;316;1351;2093;6865;2409;8216
230460;201605;1957;6362;1687;5863;153;604;1168;4022;1321;4626
230465;201605;4054;12032;3410;10858;232;939;2240;6951;2472;7890
230470;201605;10861;39485;10055;37829;1218;5113;6854;25749;8072;30862
230480;201605;1478;4615;1240;4159;149;594;818;2684;967;3278
230490;201605;2282;6965;1972;6362;294;1001;965;3032;1259;4033
230495;201605;5760;18897;5160;17819;702;2854;2787;9520;3489;12374
230500;201605;8946;31682;8522;30841;583;2595;6369;22962;6952;25557
230510;201605;1502;5296;1150;4397;296;1201;334;1273;630;2474
230520;201605;4833;14672;4353;13824;427;1530;2793;8757;3220;10287
230523;201605;14754;47519;12906;43361;2924;10626;3113;10751;6037;21377
230526;201605;4050;12086;3463;11052;196;859;2638;8239;2834;9098
230530;201605;5386;17233;4844;16491;816;2990;3201;11185;4017;14175
230533;201605;4034;11163;3477;10110;420;1139;2393;7072;2813;8211
230535;201605;5547;16338;4850;15108;616;1891;2970;9613;3586;11504
230540;201605;17423;50891;15727;48232;556;2262;13054;39546;13610;41808
230550;201605;19393;57319;17231;53275;3004;10096;8933;26978;11937;37074
230560;201605;6800;19505;5919;17904;179;759;4545;13491;4724;14250
230565;201605;3450;9536;2798;8342;101;370;2077;6146;2178;6516
230570;201605;3667;9954;3251;9432;104;384;2707;7785;2811;8169
230580;201605;9991;30032;9240;28957;499;1837;7839;24471;8338;26308
230590;201605;9129;28091;7832;25669;568;2361;5492;17471;6060;19832
230600;201605;3827;10472;2921;8684;143;455;1875;5595;2018;6050
230610;201605;6166;19528;5642;18669;741;2451;3874;13058;4615;15509
230620;201605;2174;6175;1733;5247;205;670;962;2816;1167;3486
230625;201605;7846;25374;7076;23623;2013;7245;2041;6827;4054;14072
230630;201605;10920;34508;10014;32836;2664;8253;4465;15800;7129;24053
230640;201605;25856;84016;23773;80878;2596;9819;17519;59352;20115;69171
230650;201605;4880;14935;4404;14025;285;1122;3339;10381;3624;11503
230655;201605;9182;34528;8827;33861;756;3201;6878;26595;7634;29796
230660;201605;6123;19044;5242;17381;301;1382;3997;12927;4298;14309
230670;201605;6082;16159;4878;14090;142;488;3755;10549;3897;11037
230680;201605;2662;7809;2295;7099;338;1057;1338;4139;1676;5196
230690;201605;6290;20281;6096;19871;629;2338;3847;12240;4476;14578
230700;201605;9565;26684;8518;24815;608;2168;6071;17143;6679;19311
230710;201605;7519;24309;6539;22493;628;2222;4629;16041;5257;18263
230720;201605;1831;5810;1586;5301;204;724;933;3098;1137;3822
230725;201605;3688;12461;3217;11321;765;2753;1020;3594;1785;6347
230730;201605;56735;170947;47832;156133;13014;47663;10429;35700;23443;83363
230740;201605;6134;18185;5530;17175;204;836;4431;13556;4635;14392
230750;201605;8402;24166;7203;22199;364;1395;5454;16538;5818;17933
230760;201605;10803;31911;9974;30263;1054;3683;6778;19806;7832;23489
230763;201605;4295;13047;3827;12171;196;859;2896;8862;3092;9721
230765;201605;38714;121717;34664;113881;8803;30852;10033;33973;18836;64825
230770;201605;24964;68923;22429;65288;2877;8767;14582;42374;17459;51141
230780;201605;5931;22712;5680;22146;1376;5502;2725;11160;4101;16662
230790;201605;2809;8894;2587;8516;231;852;1921;6345;2152;7197
230800;201605;7501;26410;6833;24952;1433;5634;2983;10732;4416;16366
230810;201605;12221;39275;11481;38022;840;3006;8860;29317;9700;32323
230820;201605;3274;11288;2873;10423;399;1662;1583;5664;1982;7326
230830;201605;7505;22597;6637;20994;411;1613;4906;15271;5317;16884
230835;201605;3963;10444;3249;9369;174;575;2486;7134;2660;7709
230837;201605;3194;10724;2747;9813;259;1101;1862;6515;2121;7616
230840;201605;9157;29585;8368;28253;647;2472;6334;21493;6981;23965
230850;201605;9538;29664;8839;28461;1028;3376;6012;19553;7040;22929
230860;201605;5094;14470;4532;13659;197;722;3712;11118;3909;11840
230870;201605;18759;49143;16160;45279;690;2159;12412;34623;13102;36782
230880;201605;1971;6644;1871;6439;130;586;1316;4433;1446;5019
230890;201605;3929;14281;3643;13661;431;1988;2292;8333;2723;10321
230900;201605;2905;9640;2426;8589;503;1693;1080;3977;1583;5670
230910;201605;3137;9145;2581;8158;188;823;1874;5727;2062;6550
230920;201605;4669;13554;4346;13147;224;840;3655;11092;3879;11932
230930;201605;7270;21850;6416;20260;574;1917;4313;13648;4887;15565
230940;201605;7881;22376;6940;20911;285;980;5632;17008;5917;17988
230945;201605;6066;18375;5378;17290;416;1499;3679;12073;4095;13572
230950;201605;6442;17597;5830;16792;214;575;5011;14757;5225;15332
230960;201605;14277;43691;13075;41416;2481;8223;6043;19395;8524;27618
230970;201605;13759;41633;12074;38565;2343;8252;5285;16557;7628;24809
230980;201605;2929;9096;2565;8441;678;2217;1213;4226;1891;6443
230990;201605;1763;5193;1457;4603;114;483;930;2817;1044;3300
231000;201605;2695;7364;2149;6299;132;445;1381;3935;1513;4380
231010;201605;3133;8600;2548;7630;274;884;1651;4824;1925;5708
231020;201605;7879;26385;7468;25533;1279;4366;4494;15692;5773;20058
231025;201605;7993;24385;7259;23117;909;3040;4739;15304;5648;18344
231030;201605;7604;24475;6427;22099;1125;4067;3378;11698;4503;15765
231040;201605;3193;10009;2832;9300;142;626;2063;6572;2205;7198
231050;201605;11914;33737;10107;30558;741;2452;7285;21931;8026;24383
231060;201605;2391;7749;2221;7436;130;650;1625;5271;1755;5921
231070;201605;8659;27238;7750;25394;1410;4764;4025;13397;5435;18161
231080;201605;3885;12149;3545;11560;152;805;2757;8644;2909;9449
231085;201605;4830;14912;4638;14650;644;2060;3237;10569;3881;12629
231090;201605;4173;11652;3361;10057;179;617;2303;6788;2482;7405
231095;201605;2197;7070;1906;6478;203;776;1231;4180;1434;4956
231100;201605;3203;9875;2663;8837;193;740;1869;6148;2062;6888
231110;201605;3517;11661;3478;11591;318;1229;2411;7953;2729;9182
231120;201605;1978;6752;1873;6538;280;1040;1147;4054;1427;5094
231123;201605;2064;5668;1786;5199;131;368;1359;3958;1490;4326
231126;201605;6273;17779;5282;16114;253;988;3851;11571;4104;12559
231130;201605;19155;58395;17320;55394;3143;10463;10080;33616;13223;44079
231135;201605;4161;12451;3554;11362;244;870;2487;7923;2731;8793
231140;201605;17131;53419;15052;49501;1171;5158;9942;31574;11113;36732
231150;201605;5749;16522;4931;15035;788;2513;2410;7431;3198;9944
231160;201605;5828;19172;5431;18378;951;3219;3105;10624;4056;13843
231170;201605;4275;13664;3815;12719;270;1128;2650;8591;2920;9719
231180;201605;14132;41885;12616;38860;2213;7235;6818;20705;9031;27940
231190;201605;4555;12828;3831;11723;227;818;2910;8718;3137;9536
231195;201605;4604;15312;3976;14090;382;1685;2682;9359;3064;11044
231200;201605;7801;26428;6824;24406;400;2049;4836;16809;5236;18858
231210;201605;4969;15586;4333;14689;271;1286;3329;11135;3600;12421
231220;201605;11802;33957;10390;31356;492;1870;7663;22653;8155;24523
231230;201605;9158;30381;8285;29051;751;3154;6047;21186;6798;24340
231240;201605;12108;37712;10927;35360;2242;7452;5214;17091;7456;24543
231250;201605;1965;5659;1371;4220;410;1266;313;935;723;2201
231260;201605;3462;10293;3116;9741;515;1601;1852;5934;2367;7535
231270;201605;7244;19834;6379;18490;293;1217;4817;13641;5110;14858
231280;201605;1740;5691;1625;5481;180;632;1087;3704;1267;4336
231290;201605;33828;113680;30552;106315;6271;24068;12466;42431;18737;66499
231300;201605;4503;13007;3644;11318;243;895;2423;7335;2666;8230
231310;201605;7401;21003;6158;18438;867;2636;3460;10264;4327;12900
231320;201605;7030;21362;5949;19262;280;1184;4213;13546;4493;14730
231325;201605;2780;8112;2436;7590;254;828;1594;5040;1848;5868
231330;201605;12149;38245;10492;35037;1752;5894;5829;19736;7581;25630
231335;201605;5401;15304;4674;13967;161;669;3716;10870;3877;11539
231340;201605;17451;57532;16100;55426;1071;3723;12649;44463;13720;48186
231350;201605;13923;42002;13189;40997;858;2508;11292;35636;12150;38144
231355;201605;4554;14381;4170;13729;249;1019;3056;9963;3305;10982
231360;201605;7663;24345;6800;22838;1123;3821;4187;14446;5310;18267
231370;201605;2419;6737;1888;5860;73;231;1407;4376;1480;4607
231375;201605;4228;14364;3961;13878;222;1029;3123;10824;3345;11853
231380;201605;5444;16651;5149;16272;382;1317;3946;12722;4328;14039
231390;201605;3440;10724;3162;10242;252;892;2234;7176;2486;8068
231395;201605;3845;12582;3498;11932;592;2001;1967;6823;2559;8824
231400;201605;9007;27756;8359;26476;513;1984;6176;19269;6689;21253
231410;201605;14291;48260;13118;46470;1168;4340;9877;35291;11045;39631
240010;201605;2464;7339;2059;6538;319;1128;1024;3151;1343;4279
240020;201605;10573;33174;9471;31119;1953;6807;4568;15154;6521;21961
240030;201605;2518;7146;2434;7018;130;429;2074;5919;2204;6348
240040;201605;843;2476;713;2218;24;119;505;1492;529;1611
240050;201605;3447;9336;2930;8438;103;351;2334;6618;2437;6969
240060;201605;1407;3998;1252;3707;50;190;998;2845;1048;3035
240070;201605;2548;7555;2374;7220;342;1093;1551;4634;1893;5727
240080;201605;3050;8156;2638;7593;156;455;2038;5864;2194;6319
240090;201605;2288;6148;1885;5427;39;147;1473;4148;1512;4295
240100;201605;8124;23360;7265;21630;597;1994;5152;14935;5749;16929
240110;201605;4778;14964;4285;13979;611;2285;2410;7591;3021;9876
240120;201605;2680;9209;2560;8973;358;1411;1617;5618;1975;7029
240130;201605;2750;7463;2422;6948;95;337;1976;5570;2071;5907
240140;201605;2219;6651;1895;6060;273;1051;1082;3334;1355;4385
240145;201605;5745;18131;5192;17130;1417;4881;2453;8334;3870;13215
240150;201605;971;2960;804;2611;70;283;518;1617;588;1900
240160;201605;1437;4580;1241;4242;148;580;764;2665;912;3245
240165;201605;898;2815;793;2604;114;340;473;1649;587;1989
240170;201605;2313;7009;2024;6474;481;1680;919;2909;1400;4589
240180;201605;2644;8370;2344;7751;398;1411;1379;4633;1777;6044
240185;201605;1410;4676;1315;4522;82;312;1043;3595;1125;3907
240190;201605;966;3041;868;2876;37;174;655;2155;692;2329
240200;201605;13418;35210;11236;32149;2518;7528;4704;13835;7222;21363
240210;201605;2916;8130;2639;7719;158;573;2160;6200;2318;6773
240220;201605;7324;24500;6792;23706;668;2969;5026;17289;5694;20258
240230;201605;5743;15178;4977;13995;148;452;4208;11835;4356;12287
240240;201605;1829;5541;1254;4145;236;853;215;622;451;1475
240250;201605;2662;7804;2503;7583;114;362;2153;6516;2267;6878
240260;201605;12172;40998;11563;40005;1747;6730;7397;25522;9144;32252
240270;201605;2243;7215;2066;6916;179;628;1571;5338;1750;5966
240280;201605;1557;4398;1388;4151;72;249;1106;3294;1178;3543
240290;201605;1266;3979;1125;3705;55;291;740;2288;795;2579
240300;201605;2269;6236;1689;5028;251;790;718;2079;969;2869
240310;201605;9482;27068;8612;25711;1116;3663;4815;14568;5931;18231
240320;201605;2027;6027;1626;5213;53;231;1149;3561;1202;3792
240325;201605;34244;94658;27556;84104;8244;26948;6084;19599;14328;46547
240330;201605;1493;4536;1264;4051;71;285;796;2462;867;2747
240340;201605;2053;5334;1743;4842;167;488;1280;3525;1447;4013
240350;201605;1957;5664;1846;5531;93;328;1630;4870;1723;5198
240360;201605;7035;21333;6283;20207;1448;4828;3126;10437;4574;15265
240370;201605;2022;5570;1621;4831;179;507;1015;3057;1194;3564
240375;201605;850;2301;747;2123;72;248;515;1370;587;1618
240380;201605;2422;7234;1870;6003;242;804;938;2976;1180;3780
240390;201605;926;2562;780;2289;39;142;558;1588;597;1730
240400;201605;1328;3636;1088;3202;78;271;754;2160;832;2431
240410;201605;484;1603;435;1504;82;348;243;807;325;1155
240420;201605;4617;17747;4341;17132;862;3839;2326;9184;3188;13023
240430;201605;3291;9314;3011;8809;128;523;2376;6714;2504;7237
240440;201605;2475;6458;2219;6080;472;1369;1221;3305;1693;4674
240450;201605;3778;11266;3260;10280;304;1264;2012;6005;2316;7269
240460;201605;2890;8902;2731;8689;173;763;2209;6843;2382;7606
240470;201605;3562;11196;2842;9628;791;2554;1294;4512;2085;7066
240480;201605;519;1388;406;1174;32;106;204;568;236;674
240485;201605;1957;6191;1724;5719;239;873;1077;3577;1316;4450
240490;201605;1699;4338;1427;3917;38;137;1185;3196;1223;3333
240500;201605;2149;6138;1947;5839;124;427;1528;4553;1652;4980
240510;201605;1787;5280;1678;5116;123;403;1351;4114;1474;4517
240520;201605;1223;3574;1107;3375;107;385;826;2452;933;2837
240530;201605;1986;6435;1826;6182;346;1229;1178;3975;1524;5204
240540;201605;1737;5196;1660;5073;111;362;1368;4160;1479;4522
240550;201605;795;2284;684;2092;44;146;507;1531;551;1677
240560;201605;3204;9270;2990;8949;344;989;2256;6810;2600;7799
240570;201605;3062;8571;2292;6844;479;1523;782;2085;1261;3608
240580;201605;7617;23763;7079;22819;727;2626;5382;17112;6109;19738
240590;201605;773;2177;681;2010;28;105;516;1490;544;1595
240600;201605;1610;4721;1265;3996;131;476;702;2122;833;2598
240610;201605;4591;13239;4027;12162;449;1461;2532;7496;2981;8957
240615;201605;1028;3025;828;2641;167;573;435;1345;602;1918
240620;201605;1784;5504;1582;5169;167;522;1166;3843;1333;4365
240630;201605;2035;6210;1866;5922;159;444;1313;4275;1472;4719
240640;201605;894;2574;762;2360;50;236;535;1593;585;1829
240650;201605;3908;11619;3489;11002;172;611;2783;8734;2955;9345
240660;201605;2347;7547;2202;7335;172;651;1718;5695;1890;6346
240670;201605;2632;7853;2197;6947;274;916;1232;3846;1506;4762
240680;201605;1503;4413;1221;3906;91;329;790;2477;881;2806
240690;201605;960;2637;824;2403;46;171;654;1852;700;2023
240700;201605;2571;7715;2167;6975;77;326;1649;5215;1726;5541
240710;201605;18706;49089;16236;45413;3057;8468;8895;25551;11952;34019
240720;201605;5235;14983;4760;14112;1379;4284;2163;6174;3542;10458
240725;201605;1061;3202;862;2772;68;229;503;1578;571;1807
240730;201605;2111;6408;1842;5908;114;401;1365;4363;1479;4764
240740;201605;1963;5776;1755;5405;148;579;1238;3679;1386;4258
240750;201605;2121;7958;1978;7683;463;1982;933;3634;1396;5616
240760;201605;1326;3627;1115;3342;107;269;819;2625;926;2894
240770;201605;3150;9025;2817;8564;144;609;2327;6952;2471;7561
240780;201605;6090;16802;4926;14952;748;2306;2741;8459;3489;10765
240790;201605;898;2728;750;2459;33;130;527;1738;560;1868
240800;201605;35213;100763;31320;94313;7359;22928;12675;38775;20034;61703
240810;201605;84755;244324;78404;233605;20770;62838;34826;106118;55596;168956
240820;201605;6305;19251;5519;18012;1315;4625;2217;7552;3532;12177
240830;201605;8642;26866;8084;26056;352;1533;6788;21613;7140;23146
240840;201605;1218;3397;1035;3103;90;281;635;1846;725;2127
240850;201605;1291;3796;964;3039;116;387;490;1525;606;1912
240860;201605;1305;3728;1075;3317;45;161;816;2443;861;2604
240870;201605;1177;3214;963;2823;78;246;613;1707;691;1953
240880;201605;1171;3906;1105;3801;90;402;879;2925;969;3327
240890;201605;4996;14198;4228;12763;875;2738;1728;5100;2603;7838
240895;201605;2633;9091;2430;8734;257;1006;1742;6329;1999;7335
240910;201605;2859;8596;2533;7974;142;532;1928;6008;2070;6540
240920;201605;756;2455;659;2247;118;450;323;1077;441;1527
240930;201605;3470;9035;3061;8536;132;361;2519;7133;2651;7494
240933;201605;1428;3996;1271;3733;66;241;1003;2863;1069;3104
240940;201605;6538;17539;5282;15433;729;2143;3161;9148;3890;11291
240950;201605;961;3170;893;3047;57;275;671;2213;728;2488
240960;201605;792;2457;704;2291;63;221;496;1628;559;1849
240970;201605;1896;5272;1596;4763;90;347;1219;3514;1309;3861
240980;201605;2940;9755;2727;9362;482;1738;1623;5608;2105;7346
240990;201605;2758;8243;2593;7932;430;1410;1574;4735;2004;6145
241000;201605;1054;2942;895;2665;43;152;622;1831;665;1983
241010;201605;2800;9490;2615;9134;323;1365;1821;6132;2144;7497
241020;201605;2042;5685;1666;4931;197;574;992;2881;1189;3455
241025;201605;1626;4946;1440;4606;62;273;1038;3271;1100;3544
241030;201605;2498;8216;2237;7701;218;909;1549;5265;1767;6174
241040;201605;2203;7527;2020;7202;171;704;1456;5211;1627;5915
241050;201605;1280;3790;1120;3513;62;249;842;2573;904;2822
241060;201605;865;2499;777;2357;48;155;570;1704;618;1859
241070;201605;778;2259;705;2131;62;224;514;1489;576;1713
241080;201605;1136;3374;943;2996;37;167;677;2112;714;2279
241090;201605;2153;6404;1818;5824;112;504;1357;4272;1469;4776
241100;201605;1184;3529;1031;3173;96;324;663;2019;759;2343
241105;201605;1167;3576;1024;3313;233;757;465;1583;698;2340
241110;201605;820;2553;692;2292;53;214;434;1387;487;1601
241120;201605;7260;22276;6622;21226;1508;4803;3551;11910;5059;16713
241140;201605;3408;9329;2949;8433;281;789;2042;5741;2323;6530
241142;201605;722;2156;543;1768;126;466;212;646;338;1112
241150;201605;5431;16054;4855;15069;503;1651;3252;10095;3755;11746
241160;201605;974;2856;876;2688;142;438;542;1665;684;2103
241170;201605;1156;3405;1077;3264;88;274;845;2549;933;2823
241180;201605;944;2643;769;2308;95;304;398;1162;493;1466
241190;201605;1196;3297;953;2801;54;196;615;1729;669;1925
241200;201605;18937;55185;16813;51901;4137;13493;6911;21843;11048;35336
241210;201605;1441;4063;1157;3474;159;552;629;1817;788;2369
241220;201605;7835;25768;7297;24781;1894;6610;3479;12149;5373;18759
241230;201605;3015;8841;2789;8480;153;573;2314;6926;2467;7499
241240;201605;1218;3606;832;2706;89;323;352;1141;441;1464
241250;201605;6030;18570;5045;16678;201;1084;3829;12233;4030;13317
241255;201605;1681;6428;1554;6134;340;1474;762;2999;1102;4473
241260;201605;5127;13865;4134;12315;186;777;3058;8911;3244;9688
241270;201605;1876;5734;1655;5293;112;439;1134;3558;1246;3997
241280;201605;1851;5356;1693;5056;154;468;1229;3654;1383;4122
241290;201605;3013;8428;2564;7662;201;692;1810;5313;2011;6005
241300;201605;1446;4161;1252;3816;54;175;882;2698;936;2873
241310;201605;1615;4815;1478;4586;106;392;1135;3485;1241;3877
241320;201605;916;3139;838;2980;102;418;526;1857;628;2275
241330;201605;1434;4474;1351;4365;92;394;1129;3573;1221;3967
241335;201605;2750;8347;2540;7970;138;503;2094;6512;2232;7015
241340;201605;1831;5676;1574;5117;359;1267;666;2074;1025;3341
241350;201605;1915;6095;1739;5755;127;556;1287;4129;1414;4685
241355;201605;1425;3967;1171;3535;49;175;930;2797;979;2972
241360;201605;2080;5643;1718;4938;75;221;1236;3451;1311;3672
241370;201605;1352;4067;1121;3601;119;437;661;2073;780;2510
241380;201605;651;1862;557;1685;78;252;318;937;396;1189
241390;201605;2753;9065;2571;8751;249;1005;1916;6471;2165;7476
241400;201605;3708;10738;3380;10274;384;1263;2518;7714;2902;8977
241410;201605;2480;7581;2245;7253;393;1374;1368;4387;1761;5761
241415;201605;1646;4975;1490;4732;89;340;1196;3730;1285;4070
241420;201605;2275;7842;2008;7384;616;2482;454;1626;1070;4108
241430;201605;571;1699;444;1414;44;159;248;751;292;910
241440;201605;6256;22553;5872;21937;957;3879;4001;15048;4958;18927
241445;201605;993;2890;947;2836;79;202;765;2438;844;2640
241450;201605;3007;8219;2639;7703;297;945;1822;5267;2119;6212
241460;201605;3403;9895;3023;9152;228;810;2176;6417;2404;7227
241470;201605;1388;3862;1140;3535;119;410;809;2489;928;2899
241475;201605;1252;3759;1049;3359;38;182;777;2402;815;2584
241480;201605;2785;9217;2565;8832;992;3574;559;2122;1551;5696
241490;201605;680;1803;588;1678;32;84;371;1040;403;1124
241500;201605;759;2410;647;2229;29;119;507;1741;536;1860
250010;201605;2760;8602;2362;7735;107;472;1771;5663;1878;6135
250020;201605;1665;4765;1291;4087;65;258;865;2645;930;2903
250030;201605;6921;20185;6458;19535;429;1372;5318;16029;5747;17401
250040;201605;4133;13848;3818;13163;568;2013;2342;8105;2910;10118
250050;201605;3436;10804;3203;10436;473;1584;2128;6878;2601;8462
250053;201605;1228;3685;1125;3539;138;459;775;2472;913;2931
250057;201605;620;2686;610;2675;9;14;579;2621;588;2635
250060;201605;5137;15324;4813;14852;390;1342;3823;11714;4213;13056
250070;201605;3991;12379;3707;11898;137;662;2913;9040;3050;9702
250073;201605;786;2335;687;2166;34;123;561;1747;595;1870
250077;201605;2152;6281;1802;5730;129;438;1244;3988;1373;4426
250080;201605;4151;12084;3961;11764;297;927;3102;9067;3399;9994
250090;201605;2561;7394;2431;7184;96;288;2005;5860;2101;6148
250100;201605;3836;12590;3628;12214;306;1164;2779;9212;3085;10376
250110;201605;5056;15124;4785;14740;405;1503;3810;11537;4215;13040
250115;201605;526;1686;472;1576;27;144;318;996;345;1140
250120;201605;1978;6013;1703;5486;93;335;1302;4182;1395;4517
250130;201605;5281;16590;4886;15922;229;972;4096;13265;4325;14237
250135;201605;1063;3191;976;3045;36;125;779;2436;815;2561
250140;201605;2008;6749;1926;6622;163;680;1490;5119;1653;5799
250150;201605;5027;16867;4571;16027;254;1147;3406;11772;3660;12919
250153;201605;1433;3912;1260;3671;46;208;1076;3058;1122;3266
250157;201605;1712;5611;1581;5363;171;646;1135;3840;1306;4486
250160;201605;3261;9783;3132;9596;119;451;2848;8704;2967;9155
250170;201605;1588;4674;1451;4467;150;517;1076;3310;1226;3827
250180;201605;15747;46226;14844;44850;1405;4949;10854;31967;12259;36916
250190;201605;4187;12070;3822;11510;619;1893;2297;6831;2916;8724
250200;201605;2012;5879;1687;5399;93;351;1386;4411;1479;4762
250205;201605;872;3031;818;2923;46;230;603;2146;649;2376
250210;201605;1450;4787;1364;4661;106;449;1054;3536;1160;3985
250215;201605;1358;4449;1283;4332;87;365;858;2883;945;3248
250220;201605;747;2264;658;2144;35;149;534;1741;569;1890
250230;201605;1521;3888;1269;3484;48;169;1037;2729;1085;2898
250240;201605;2300;7722;2174;7490;109;435;1753;6030;1862;6465
250250;201605;4309;13056;3989;12639;170;580;3438;10953;3608;11533
250260;201605;1705;5202;1485;4855;70;247;1160;3810;1230;4057
250270;201605;1255;3959;1149;3830;90;308;873;3001;963;3309
250280;201605;3612;10685;3193;10035;339;1088;2374;7484;2713;8572
250290;201605;1907;5122;1615;4743;35;141;1438;4239;1473;4380
250300;201605;5510;16210;5235;15888;493;1985;4304;12675;4797;14660
250310;201605;1157;3550;1039;3361;72;283;801;2551;873;2834
250320;201605;8025;24370;7588;23664;848;3011;5278;16056;6126;19067
250330;201605;2395;7507;2082;7050;130;533;1605;5370;1735;5903
250340;201605;1095;3230;984;3043;32;121;830;2526;862;2647
250350;201605;4107;11479;3696;10986;132;480;3198;9535;3330;10015
250355;201605;1878;6082;1729;5875;62;316;1480;4950;1542;5266
250360;201605;1860;5455;1737;5274;58;155;1487;4550;1545;4705
250370;201605;11421;33546;10362;32373;806;2581;8871;27913;9677;30494
250375;201605;1077;3296;997;3182;29;119;867;2775;896;2894
250380;201605;1660;4776;1581;4679;88;348;1359;3934;1447;4282
250390;201605;1862;5059;1506;4457;173;495;977;2924;1150;3419
250400;201605;72340;192457;57693;169412;14634;45413;21343;63767;35977;109180
250403;201605;1501;4915;1386;4760;218;906;881;2933;1099;3839
250407;201605;1199;3374;1027;3102;75;213;748;2220;823;2433
250410;201605;543;1774;509;1716;24;123;402;1318;426;1441
250415;201605;1825;5507;1653;5205;102;331;1236;3863;1338;4194
250420;201605;1259;3741;1147;3576;27;112;1017;3151;1044;3263
250430;201605;6133;16798;5681;16137;253;852;4717;13144;4970;13996
250435;201605;1365;4206;1232;3969;122;453;862;2761;984;3214
250440;201605;4435;12825;4098;12362;144;442;3490;10526;3634;10968
250450;201605;1919;5473;1715;5206;59;203;1443;4337;1502;4540
250460;201605;6396;19314;5978;18758;521;1751;4717;14981;5238;16732
250470;201605;1555;4235;1323;3919;124;439;896;2542;1020;2981
250480;201605;3749;11404;3491;11057;95;423;3079;9749;3174;10172
250485;201605;668;1677;556;1508;30;95;445;1173;475;1268
250490;201605;3783;11916;3695;11790;710;2208;2609;8421;3319;10629
250500;201605;1750;5338;1583;5069;240;743;1076;3541;1316;4284
250510;201605;4843;13758;4334;13018;163;524;3789;11424;3952;11948
250520;201605;1743;5264;1630;5090;221;739;987;3028;1208;3767
250523;201605;1612;5058;1565;4992;171;627;1229;3865;1400;4492
250527;201605;1396;4203;1328;4122;22;111;1222;3741;1244;3852
250530;201605;609;1886;531;1790;23;70;475;1623;498;1693
250535;201605;1301;4105;1227;3959;43;195;997;3146;1040;3341
250540;201605;2394;6874;2239;6696;43;184;1987;5850;2030;6034
250550;201605;911;2999;830;2876;44;223;659;2223;703;2446
250560;201605;1647;5193;1589;5112;73;319;1407;4453;1480;4772
250570;201605;2594;8280;2277;7662;128;559;1740;5716;1868;6275
250580;201605;1140;3037;981;2794;70;253;782;2149;852;2402
250590;201605;855;2680;800;2608;71;280;663;2118;734;2398
250600;201605;7299;21297;6852;20661;698;2003;5275;16096;5973;18099
250610;201605;3136;9071;2913;8734;237;771;2222;6629;2459;7400
250620;201605;694;2039;615;1879;86;281;386;1161;472;1442
250625;201605;2395;7695;2348;7636;69;177;2226;7336;2295;7513
250630;201605;9368;29184;8616;27692;2008;6479;4314;14014;6322;20493
250640;201605;3418;10560;3263;10370;158;674;2844;8907;3002;9581
250650;201605;822;2343;721;2192;38;141;535;1543;573;1684
250660;201605;1812;4890;1659;4690;21;45;1569;4471;1590;4516
250670;201605;2368;8016;2251;7811;130;618;1855;6308;1985;6926
250680;201605;4827;13715;4588;13431;211;654;4066;11937;4277;12591
250690;201605;5995;15694;5720;15373;389;1044;5062;13584;5451;14628
250700;201605;4706;13942;4323;13383;665;2153;2847;8751;3512;10904
250710;201605;4349;13616;3965;13093;476;1666;2772;9299;3248;10965
250720;201605;2687;7775;2523;7539;78;345;2222;6558;2300;6903
250730;201605;3501;10575;3272;10263;243;838;2526;7780;2769;8618
250740;201605;1897;5547;1652;5171;156;596;1257;3804;1413;4400
250750;201605;99082;280006;91286;268705;11819;38091;61261;177912;73080;216003
250760;201605;2248;6417;2026;6100;117;456;1686;5007;1803;5463
250770;201605;3862;12942;3664;12684;465;1821;2553;8786;3018;10607
250780;201605;1820;5309;1577;4871;160;597;1012;3016;1172;3613
250790;201605;2390;7791;2273;7602;475;1580;1355;4678;1830;6258
250800;201605;2622;7367;2328;6899;85;265;1920;5591;2005;5856
250810;201605;1292;3793;1131;3545;69;287;887;2733;956;3020
250820;201605;1840;5799;1765;5706;70;284;1597;5132;1667;5416
250830;201605;5603;18109;5196;17299;524;2020;3586;11696;4110;13716
250840;201605;900;2934;766;2648;54;226;521;1800;575;2026
250850;201605;1969;6082;1791;5792;90;427;1404;4442;1494;4869
250855;201605;1061;3155;955;3004;55;228;702;2136;757;2364
250860;201605;3160;10313;2754;9584;670;2526;945;3336;1615;5862
250870;201605;1061;3110;957;2910;32;127;741;2203;773;2330
250880;201605;1435;3987;1248;3724;153;469;932;2804;1085;3273
250890;201605;9207;27933;8710;27255;1066;4036;6242;18914;7308;22950
250900;201605;2815;9118;2477;8455;237;776;1798;6182;2035;6958
250905;201605;1996;6363;1917;6262;255;879;1457;4768;1712;5647
250910;201605;4914;14396;4652;14002;216;745;3868;11573;4084;12318
250915;201605;1407;4354;1383;4320;103;236;1191;3847;1294;4083
250920;201605;3246;9277;3048;8981;279;811;2249;6645;2528;7456
250930;201605;1990;6165;1874;5982;164;663;1388;4319;1552;4982
250933;201605;1124;3677;1051;3536;88;334;705;2328;793;2662
250937;201605;662;2043;601;1931;53;203;428;1338;481;1541
250939;201605;1526;4685;1428;4527;136;476;998;3128;1134;3604
250940;201605;3750;11186;3522;10829;107;408;3025;9328;3132;9736
250950;201605;1276;3903;1129;3710;49;206;897;2955;946;3161
250960;201605;1071;3497;1026;3428;55;214;838;2784;893;2998
250970;201605;8368;23253;7379;21727;667;2101;5371;15709;6038;17810
250980;201605;2546;7525;2333;7152;99;409;1739;5146;1838;5555
250990;201605;1926;6560;1734;6147;254;1038;1054;3603;1308;4641
251000;201605;2082;6277;1883;5980;63;297;1572;4922;1635;5219
251010;201605;2750;8093;2471;7650;67;228;2152;6673;2219;6901
251020;201605;1626;4631;1489;4456;71;222;1344;4029;1415;4251
251030;201605;1079;3062;991;2913;61;211;729;2096;790;2307
251040;201605;1778;5575;1607;5292;83;387;1193;3793;1276;4180
251050;201605;1063;3096;926;2850;120;394;579;1745;699;2139
251060;201605;1014;2340;780;2041;42;136;613;1592;655;1728
251065;201605;466;1411;414;1333;29;99;283;862;312;961
251070;201605;620;1752;561;1675;36;144;446;1281;482;1425
251080;201605;19347;54646;17557;51752;4326;13369;8032;24345;12358;37714
251090;201605;2963;9181;2636;8573;197;726;1893;6052;2090;6778
251100;201605;976;3054;885;2902;78;310;590;1857;668;2167
251110;201605;1938;5689;1704;5235;132;379;1165;3586;1297;3965
251120;201605;6076;20553;5802;20081;609;2474;4283;14593;4892;17067
251130;201605;3952;10386;3645;10055;11;30;3591;9931;3602;9961
251140;201605;4222;12845;3985;12471;110;476;3369;10497;3479;10973
251150;201605;2504;8153;2342;7901;178;796;1760;5795;1938;6591
251160;201605;1825;5945;1766;5869;55;230;1619;5380;1674;5610
251170;201605;1405;4280;1331;4190;80;324;1131;3498;1211;3822
251180;201605;2536;7682;2311;7340;365;1165;1437;4572;1802;5737
251190;201605;4332;12001;4176;11826;153;471;3890;10980;4043;11451
251200;201605;3791;12298;3641;12113;86;374;3343;11106;3429;11480
251203;201605;1019;3434;995;3387;48;242;786;2640;834;2882
251207;201605;1094;3409;949;3150;53;244;644;2067;697;2311
251210;201605;7880;22384;6778;20945;667;2030;5222;16588;5889;18618
251220;201605;1160;3082;958;2787;85;253;715;2095;800;2348
251230;201605;4514;13596;4164;13180;200;783;3729;11682;3929;12465
251240;201605;3265;9887;3014;9567;354;1161;2257;7128;2611;8289
251250;201605;10328;30389;9573;29278;773;2767;7217;21632;7990;24399
251260;201605;484;1548;444;1492;19;81;336;1118;355;1199
251270;201605;4217;13620;3909;13248;128;607;3485;11788;3613;12395
251272;201605;1362;3954;1304;3879;75;248;1161;3440;1236;3688
251274;201605;903;2833;820;2693;80;329;562;1800;642;2129
251275;201605;1246;3620;1177;3508;60;268;914;2601;974;2869
251276;201605;1216;3723;1145;3601;70;282;850;2598;920;2880
251278;201605;588;1855;522;1741;57;230;341;1124;398;1354
251280;201605;2316;6967;2177;6738;97;390;1754;5268;1851;5658
251290;201605;5605;15465;5295;15093;540;1949;4183;11567;4723;13516
251300;201605;780;2589;734;2521;37;157;586;1990;623;2147
251310;201605;2963;8884;2731;8554;111;462;2219;6800;2330;7262
251315;201605;1625;5599;1550;5472;160;594;1120;3967;1280;4561
251320;201605;1873;5250;1456;4572;52;188;1062;3335;1114;3523
251330;201605;1758;4782;1507;4460;62;261;1309;3795;1371;4056
251335;201605;1017;3451;937;3308;79;364;666;2299;745;2663
251340;201605;3367;9555;2983;8991;186;748;2266;6616;2452;7364
251350;201605;1270;4083;1187;3932;81;324;912;2936;993;3260
251360;201605;1809;5739;1593;5460;58;252;1384;4779;1442;5031
251365;201605;801;2356;646;2034;18;73;455;1413;473;1486
251370;201605;21867;68792;21228;67935;1801;7063;16824;52432;18625;59495
251380;201605;1337;4157;1150;3841;35;185;959;3081;994;3266
251385;201605;783;2120;668;1944;71;202;442;1246;513;1448
251390;201605;5769;19770;5245;18800;1368;5054;2513;9135;3881;14189
251392;201605;1047;3122;934;2944;64;233;716;2226;780;2459
251394;201605;615;1928;508;1736;43;165;350;1184;393;1349
251396;201605;822;2335;712;2153;90;270;463;1389;553;1659
251398;201605;960;2807;843;2596;35;141;580;1739;615;1880
251400;201605;1165;3270;998;3032;85;303;730;2157;815;2460
251410;201605;1459;3831;1264;3506;51;210;1053;2831;1104;3041
251420;201605;1982;5722;1755;5457;199;647;1278;3938;1477;4585
251430;201605;1611;5673;1474;5453;69;362;1217;4430;1286;4792
251440;201605;1238;3678;1020;3261;47;188;763;2414;810;2602
251445;201605;1470;4562;1392;4453;101;399;1072;3316;1173;3715
251450;201605;4511;14498;4257;14159;103;463;3625;12076;3728;12539
251455;201605;1070;3474;966;3284;75;302;674;2290;749;2592
251460;201605;789;2485;735;2395;75;228;581;1931;656;2159
251465;201605;435;1393;386;1286;13;64;290;938;303;1002
251470;201605;1171;3414;984;3051;80;283;602;1842;682;2125
251480;201605;930;2625;828;2458;27;123;666;1918;693;2041
251490;201605;1735;5221;1568;4965;150;563;1103;3453;1253;4016
251500;201605;1695;5456;1632;5342;117;477;1318;4217;1435;4694
251510;201605;2577;8427;2344;7969;406;1433;1333;4542;1739;5975
251520;201605;930;2562;821;2385;110;333;513;1464;623;1797
251530;201605;11965;33358;11306;32449;311;1344;9852;27651;10163;28995
251540;201605;2877;9226;2658;8814;172;718;2133;7001;2305;7719
251550;201605;3483;9097;2993;8461;75;302;2501;6989;2576;7291
251560;201605;694;2162;641;2068;82;307;385;1179;467;1486
251570;201605;1009;2983;815;2611;42;179;564;1733;606;1912
251580;201605;1897;5347;1744;5140;345;844;1124;3492;1469;4336
251590;201605;1481;4628;1418;4546;50;204;1182;3760;1232;3964
251593;201605;988;3081;918;2985;130;445;563;1785;693;2230
251597;201605;1879;5814;1812;5729;55;237;1611;5018;1666;5255
251600;201605;6434;18973;6003;18291;335;1134;4862;14718;5197;15852
251610;201605;3283;9843;2977;9320;251;773;2197;6940;2448;7713
251615;201605;1134;3280;926;2917;59;244;657;2011;716;2255
251620;201605;14958;41282;13303;39306;734;2238;10959;33312;11693;35550
251630;201605;4582;11908;3951;11024;309;883;3042;8393;3351;9276
251640;201605;2536;7440;2157;6815;105;450;1637;5099;1742;5549
251650;201605;3906;11360;3608;10975;219;679;3075;9349;3294;10028
251660;201605;3489;11274;3231;10821;112;555;2709;8847;2821;9402
251670;201605;4376;13113;3783;12350;47;150;3487;11557;3534;11707
251675;201605;724;2300;668;2225;114;427;415;1334;529;1761
251680;201605;2708;7782;2228;7040;84;358;1736;5415;1820;5773
251690;201605;3216;9762;3008;9364;123;430;2284;6971;2407;7401
251700;201605;1937;6291;1822;6149;94;441;1553;5157;1647;5598
251710;201605;904;2353;653;1873;101;317;310;828;411;1145
251720;201605;1405;4324;1228;4011;74;355;939;2958;1013;3313
251740;201605;774;2185;614;1915;67;222;377;1185;444;1407
260005;201605;25404;61600;21578;56315;4490;11656;11525;30380;16015;42036
260010;201605;9950;26831;8247;24618;1264;3853;4721;14690;5985;18543
260020;201605;5991;16640;5077;15275;220;791;4062;12276;4282;13067
260030;201605;6076;17422;5444;16471;389;1338;4180;12600;4569;13938
260040;201605;9914;24125;8203;22160;671;1695;6253;17551;6924;19246
260050;201605;11220;34745;10484;33888;555;1978;9010;29501;9565;31479
260060;201605;3841;10859;3421;10109;316;943;2494;7500;2810;8443
260070;201605;9749;28220;8964;26997;1262;4162;5896;17475;7158;21637
260080;201605;5718;15163;5072;14279;537;1623;3619;10046;4156;11669
260090;201605;5096;14157;4757;13662;714;2019;3377;9815;4091;11834
260100;201605;3326;9170;2888;8555;147;614;2390;7020;2537;7634
260105;201605;4937;13838;4678;13394;219;823;3911;10945;4130;11768
260110;201605;20900;58901;19299;57008;786;2436;17085;50619;17871;53055
260120;201605;11744;35740;10591;33737;2403;7905;5281;17365;7684;25270
260130;201605;3221;9044;3023;8735;436;1279;2100;6051;2536;7330
260140;201605;13276;32808;11419;30567;798;2348;9062;24438;9860;26786
260150;201605;3158;8870;2826;8428;189;718;2219;6551;2408;7269
260160;201605;5564;17572;4884;16678;263;1161;4003;13667;4266;14828
260170;201605;16368;46036;15593;44933;1057;3381;12830;36662;13887;40043
260180;201605;3239;9848;2949;9441;183;634;2458;7886;2641;8520
260190;201605;16113;37558;14706;35841;404;1095;12813;30868;13217;31963
260200;201605;10955;28954;10141;27895;553;1773;8630;23788;9183;25561
260210;201605;11591;34982;10333;33080;534;2144;8436;26964;8970;29108
260220;201605;9486;27355;9166;26949;405;1508;8133;23627;8538;25135
260230;201605;9632;27508;8870;26454;405;1495;7253;21612;7658;23107
260240;201605;2978;8887;2589;8329;328;1182;1808;5840;2136;7022
260250;201605;2268;6261;2035;5955;100;277;1729;5085;1829;5362
260260;201605;12202;34357;11121;32834;1448;4649;8015;23888;9463;28537
260270;201605;3623;10483;3349;10073;249;1023;2530;7294;2779;8317
260280;201605;12920;41743;11843;40137;694;2447;9864;33833;10558;36280
260290;201605;31086;93268;29350;90268;5055;16497;17985;54701;23040;71198
260300;201605;8542;26147;7560;24691;406;1719;5805;19056;6211;20775
260310;201605;4581;13511;4204;12963;1129;3198;2257;7497;3386;10695
260320;201605;7143;22988;6633;22169;381;1445;5497;18435;5878;19880
260330;201605;2619;8405;2421;8049;109;472;1893;6158;2002;6630
260340;201605;1847;5456;1707;5236;52;182;1511;4628;1563;4810
260345;201605;22827;70789;21365;68071;5517;19312;8006;24321;13523;43633
260350;201605;4798;12950;4468;12481;194;685;3800;10486;3994;11171
260360;201605;2317;6729;2113;6379;140;553;1469;4406;1609;4959
260370;201605;5689;17733;5023;16545;423;1707;3552;11619;3975;13326
260380;201605;4874;15930;4432;15241;281;1154;3331;11401;3612;12555
260390;201605;4272;13695;3763;12696;305;1176;2664;8871;2969;10047
260392;201605;3486;11114;3185;10731;187;830;2735;9099;2922;9929
260400;201605;13660;38631;12934;37447;1614;5233;8874;25106;10488;30339
260410;201605;60983;173549;53305;161515;14827;47575;19484;60524;34311;108099
260415;201605;3833;12038;3311;11015;266;1121;2114;6787;2380;7908
260420;201605;12114;27481;10764;26018;214;701;9809;23478;10023;24179
260430;201605;2873;9325;2543;8718;234;846;1717;5918;1951;6764
260440;201605;3293;9916;2918;9157;387;1335;1797;5509;2184;6844
260450;201605;4904;14549;4692;14246;170;598;4177;12733;4347;13331
260460;201605;5590;17623;5109;16729;945;3313;2783;8944;3728;12257
260470;201605;4486;13679;4151;13278;183;563;3639;11965;3822;12528
260480;201605;4051;11594;3569;10923;556;1882;2271;7001;2827;8883
260490;201605;5027;13250;4362;12129;249;797;3520;9583;3769;10380
260500;201605;5866;16848;5217;15811;782;2341;3323;10151;4105;12492
260510;201605;8761;23427;8100;22570;356;1165;7118;19691;7474;20856
260515;201605;4769;14422;3702;12303;228;856;2341;7768;2569;8624
260520;201605;15965;41633;15268;40702;1824;4893;11540;30725;13364;35618
260530;201605;9699;29605;8618;27965;372;1364;7278;23702;7650;25066
260540;201605;6041;14897;5497;14324;836;1561;4188;11638;5024;13199
260545;201605;71;254;48;187;8;33;11;38;19;71
260550;201605;2722;8892;2328;8052;434;1638;968;3340;1402;4978
260560;201605;6180;16373;5574;15512;146;574;4912;13455;5058;14029
260570;201605;6835;22345;6248;21397;610;2371;4495;15344;5105;17715
260580;201605;3693;10364;3427;9917;149;522;2875;8134;3024;8656
260590;201605;6137;15376;5776;14961;305;794;4999;12966;5304;13760
260600;201605;27701;81081;24902;76453;2009;7354;18027;54849;20036;62203
260610;201605;6538;19633;6188;19079;830;2715;4272;13003;5102;15718
260620;201605;15612;47213;14902;46008;2377;8094;9298;28078;11675;36172
260630;201605;2208;6535;1981;6175;105;440;1594;4850;1699;5290
260640;201605;17144;47138;16047;45666;2456;7246;10366;29573;12822;36819
260650;201605;5381;16992;4782;15978;350;1302;3700;12479;4050;13781
260660;201605;7828;21799;7039;20803;297;1039;6056;17816;6353;18855
260670;201605;2360;6298;1925;5692;139;454;1351;3989;1490;4443
260680;201605;21302;60134;19498;57017;3848;11574;9382;27499;13230;39073
260690;201605;3674;9922;3078;8945;218;632;2330;6774;2548;7406
260700;201605;5712;17039;5578;16900;38;88;5461;16701;5499;16789
260710;201605;1311;3859;1216;3736;88;301;919;2855;1007;3156
260720;201605;17472;55715;16478;53903;3615;12234;8743;28844;12358;41078
260730;201605;6690;22354;6268;21657;877;3207;4397;15144;5274;18351
260740;201605;1284;3831;1133;3568;103;377;809;2532;912;2909
260750;201605;6794;20587;6054;19646;357;1127;5130;16980;5487;18107
260760;201605;4712;12687;4421;12318;234;720;3670;10279;3904;10999
260765;201605;7734;26080;7347;25433;996;4439;4953;16428;5949;20867
260770;201605;3772;10056;3474;9611;115;383;2862;7818;2977;8201
260775;201605;4992;14545;4703;14116;436;1586;3314;9670;3750;11256
260780;201605;3633;11715;3390;11247;654;2420;1756;5589;2410;8009
260790;201605;109785;277007;101710;265081;20461;54656;57600;149225;78061;203881
260795;201605;3037;9071;2726;8600;218;784;1962;6228;2180;7012
260800;201605;4851;13019;4523;12574;141;527;4015;10854;4156;11381
260805;201605;3836;11244;3340;10460;347;1244;2277;7025;2624;8269
260810;201605;6836;19201;6604;18908;288;903;5821;16647;6109;17550
260820;201605;4113;11649;3695;11033;845;2613;1893;5613;2738;8226
260825;201605;2892;9239;2586;8737;164;641;1988;6748;2152;7389
260830;201605;3674;11841;3291;11099;583;1931;1991;6885;2574;8816
260840;201605;4239;12121;3763;11427;242;888;3042;9136;3284;10024
260845;201605;4159;12067;3927;11657;457;1407;2838;8461;3295;9868
260850;201605;4912;16061;4368;14846;800;2982;2014;6770;2814;9752
260860;201605;3488;10759;3073;9940;143;545;2366;7625;2509;8170
260870;201605;4179;11475;3719;10903;447;1241;2768;8279;3215;9520
260875;201605;6437;17879;5721;16768;786;2341;3826;11289;4612;13630
260880;201605;9543;29054;8736;27742;613;2029;6874;22030;7487;24059
260890;201605;13009;37276;12125;35911;745;2604;9225;27126;9970;29730
260900;201605;5834;17938;5039;16414;428;1732;3187;10202;3615;11934
260910;201605;2991;9004;2719;8585;172;623;2041;6459;2213;7082
260915;201605;4527;15225;4285;14898;74;360;3952;13755;4026;14115
260920;201605;3203;9790;2970;9470;198;754;2374;7640;2572;8394
260930;201605;3892;12648;3471;11964;389;1388;2376;8258;2765;9646
260940;201605;13842;36768;12668;34908;1538;4745;8326;22355;9864;27100
260950;201605;6298;19413;5688;18210;835;3114;2960;9032;3795;12146
260960;201605;55313;153114;50627;145630;9749;29635;26089;74415;35838;104050
260970;201605;4903;15018;4475;14458;256;1049;3514;11351;3770;12400
260980;201605;3890;12611;3658;12321;113;480;3265;10985;3378;11465
260990;201605;16994;52797;15505;50760;1039;3857;12349;40633;13388;44490
261000;201605;15983;43305;13092;38900;2355;7387;6593;20320;8948;27707
261010;201605;2530;7046;2322;6801;122;274;2047;6167;2169;6441
261020;201605;6158;17904;5445;16706;562;1755;3888;11800;4450;13555
261030;201605;3532;11191;3200;10607;196;787;2515;8198;2711;8985
261040;201605;5105;16460;4455;15158;364;1468;3202;10763;3566;12231
261050;201605;7818;22925;7327;22043;934;2813;4837;14648;5771;17461
261060;201605;12191;35814;11283;34195;940;3378;8366;24742;9306;28120
261070;201605;51127;125366;45244;117158;6205;16471;29309;75782;35514;92253
261080;201605;5653;16533;5326;16045;317;893;4565;13983;4882;14876
261090;201605;16443;45094;15108;43271;1308;3662;11820;34221;13128;37883
261100;201605;8054;25311;7231;23891;1212;4363;4100;13686;5312;18049
261110;201605;60708;179104;54080;169337;12526;41561;26347;84505;38873;126066
261120;201605;3753;9900;3292;9355;86;320;2925;8310;3011;8630
261130;201605;6980;17921;6492;17379;167;533;5922;15828;6089;16361
261140;201605;3230;9033;2935;8594;362;1236;1824;5198;2186;6434
261150;201605;5358;15569;4952;14933;363;1327;4038;12077;4401;13404
261153;201605;2136;6185;1755;5605;71;296;1301;4157;1372;4453
261160;201605;195344;511245;181023;490750;43814;123904;83465;228690;127279;352594
261170;201605;5830;15903;5303;15131;478;1407;4059;11700;4537;13107
261180;201605;9529;26455;8903;25585;937;3004;6096;17314;7033;20318
261190;201605;5101;15740;4741;15298;480;2012;3352;10434;3832;12446
261200;201605;3564;8964;3202;8539;362;940;2489;6740;2851;7680
261210;201605;1900;5028;1771;4867;118;319;1552;4298;1670;4617
261220;201605;13201;40871;11166;36604;1617;5824;5769;18709;7386;24533
261230;201605;4597;14470;4246;14041;121;518;3759;12525;3880;13043
261240;201605;4882;14340;4470;13656;581;1659;3059;9543;3640;11202
261245;201605;3547;10932;3059;10048;146;669;2396;7685;2542;8354
261247;201605;3232;9938;2762;9103;195;815;1965;6511;2160;7326
261250;201605;19412;51803;18215;50204;3349;8813;12217;34866;15566;43679
261255;201605;4005;12483;3597;11755;208;837;2896;9342;3104;10179
261260;201605;12147;34099;10921;32612;548;1708;9180;27665;9728;29373
261270;201605;3596;10711;3242;10139;364;1282;2191;6718;2555;8000
261280;201605;2518;7706;2338;7440;126;487;1905;5992;2031;6479
261290;201605;2904;8326;2640;7977;141;518;2148;6525;2289;7043
261300;201605;10700;34416;9380;32027;1400;5405;5640;19039;7040;24444
261310;201605;7255;22311;6824;21527;1664;5330;3609;11449;5273;16779
261320;201605;5691;17704;5230;16885;205;780;4258;13677;4463;14457
261330;201605;5512;15758;5204;15340;395;1314;4207;12255;4602;13569
261340;201605;3865;12957;3661;12627;391;1673;2435;8269;2826;9942
261350;201605;8030;26465;7549;25652;250;1285;6130;20348;6380;21633
261360;201605;8151;21424;7277;20203;564;1682;5746;15701;6310;17383
261370;201605;19503;57340;18146;55216;3668;11652;10010;30531;13678;42183
261380;201605;4082;13979;3783;13346;546;2143;2423;8521;2969;10664
261390;201605;16119;49005;14624;46557;2061;7064;8746;27934;10807;34998
261400;201605;4651;15969;4170;14962;317;1361;2953;10547;3270;11908
261410;201605;8751;24320;7871;22983;771;2332;5968;17464;6739;19796
261420;201605;7370;24791;7044;24347;1632;6359;4057;13725;5689;20084
261430;201605;3402;10644;2984;10033;246;876;2291;7844;2537;8720
261440;201605;1536;4858;1383;4628;52;268;1049;3416;1101;3684
261450;201605;14096;39921;13589;39318;305;1127;12393;35701;12698;36828
261460;201605;7125;20922;6642;20276;404;1149;5715;17730;6119;18879
261470;201605;3946;10792;3590;10332;92;295;3262;9459;3354;9754
261480;201605;3695;13106;3403;12571;300;1227;2476;9030;2776;10257
261485;201605;4879;15020;4405;14192;661;2447;2644;8326;3305;10773
261500;201605;5626;15652;5015;14846;460;1249;3705;11340;4165;12589
261510;201605;1880;6013;1710;5741;120;437;1257;4243;1377;4680
261520;201605;2667;8648;2494;8325;122;465;1699;5922;1821;6387
261530;201605;11446;36873;10239;34446;1997;7550;4377;14603;6374;22153
261540;201605;7053;22842;6661;22158;1461;4854;3837;13093;5298;17947
261550;201605;3416;9656;3217;9375;221;833;2537;7206;2758;8039
261560;201605;6951;22952;6321;22101;838;3332;4548;15993;5386;19325
261570;201605;3376;10242;2964;9574;409;1397;1857;5997;2266;7394
261580;201605;5992;18174;5424;17287;317;1326;4516;14236;4833;15562
261590;201605;2408;6850;2116;6409;170;505;1554;4761;1724;5266
261600;201605;5281;14300;4558;13285;322;964;3564;10474;3886;11438
261610;201605;2380;6852;2087;6460;94;402;1697;5204;1791;5606
261618;201605;2497;6953;2267;6668;169;522;1744;5074;1913;5596
261620;201605;4084;12681;3807;12216;622;2029;2484;8128;3106;10157
261630;201605;7638;22385;6443;20183;761;2777;3658;11211;4419;13988
261640;201605;33385;83658;31260;81121;2049;5041;25235;68002;27284;73043
261650;201605;3681;11170;3420;10813;295;1105;2548;8089;2843;9194
270010;201605;4400;16530;4022;15810;383;1807;2795;10973;3178;12780
270020;201605;3817;10835;3550;10448;327;1072;2777;8051;3104;9123
270030;201605;39086;116696;36447;112494;8594;27090;19457;60744;28051;87834
270040;201605;10579;32360;9761;31294;1886;6149;5987;19716;7873;25865
270050;201605;4267;12054;3897;11595;386;1283;3049;9041;3435;10324
270060;201605;1864;5489;1730;5320;296;935;1141;3578;1437;4513
270070;201605;4304;13223;3952;12757;176;848;3402;10733;3578;11581
270080;201605;1250;3967;1093;3658;152;571;672;2192;824;2763
270090;201605;2101;6521;1928;6184;56;306;1610;4974;1666;5280
270100;201605;5642;17453;5318;16904;700;2504;3672;11471;4372;13975
270110;201605;3173;8688;2800;8283;345;1043;1869;5911;2214;6954
270120;201605;3084;8787;2726;8348;88;348;2448;7507;2536;7855
270130;201605;5036;15261;4667;14843;577;1889;3570;11633;4147;13522
270135;201605;1756;4676;1613;4504;168;336;1363;3986;1531;4322
270140;201605;10216;24615;8777;22815;742;2841;6850;16620;7592;19461
270150;201605;2687;8912;2609;8816;60;213;2488;8442;2548;8655
270160;201605;5067;16677;4642;16136;191;798;3980;13770;4171;14568
270170;201605;3747;12129;3452;11741;563;2222;2052;6895;2615;9117
270180;201605;2255;7445;2072;7186;95;492;1713;5824;1808;6316
270190;201605;1777;5857;1690;5744;101;398;1410;4822;1511;5220
270200;201605;2586;8621;2412;8377;204;874;1853;6317;2057;7191
270210;201605;4645;14007;4363;13618;263;1090;3645;11152;3908;12242
270220;201605;1320;4366;1223;4190;231;860;693;2340;924;3200
270230;201605;10818;33924;9482;31860;1185;4927;5762;18738;6947;23665
270235;201605;6346;20459;5917;19781;352;1507;4829;15973;5181;17480
270240;201605;9356;28170;7864;26267;1949;6722;3603;12426;5552;19148
270250;201605;3243;8485;2947;8120;461;1249;2214;6124;2675;7373
270255;201605;4939;14832;3882;12936;231;968;2753;8984;2984;9952
270260;201605;5841;18804;5652;18542;415;1747;4769;15338;5184;17085
270270;201605;1163;3350;1068;3214;213;673;606;1789;819;2462
270280;201605;3461;9848;3054;9261;340;888;2108;6559;2448;7447
270290;201605;8039;27960;7509;27050;583;2644;5762;20478;6345;23122
270300;201605;3565;11386;3192;10951;328;1244;2325;7959;2653;9203
270310;201605;7460;22489;6558;21158;239;1238;5490;17315;5729;18553
270320;201605;5808;18289;5528;17840;756;2826;3947;12497;4703;15323
270330;201605;4269;14460;3990;14079;404;1522;3109;11086;3513;12608
270340;201605;1740;5296;1533;5023;124;403;1185;3882;1309;4285
270350;201605;1871;5105;1681;4881;135;445;1238;3607;1373;4052
270360;201605;1927;6041;1844;5947;149;447;1567;5172;1716;5619
270370;201605;1505;4968;1376;4753;110;456;1003;3466;1113;3922
270375;201605;2847;7900;2543;7499;146;525;2129;6213;2275;6738
270380;201605;5605;17302;5233;16801;447;1483;4076;13304;4523;14787
270390;201605;1241;3437;1094;3226;65;252;831;2360;896;2612
270400;201605;6307;18870;5636;17900;356;1353;4150;12876;4506;14229
270410;201605;4774;14893;4403;14220;403;1442;3134;10002;3537;11444
270420;201605;5757;18473;5535;18170;243;1115;4551;14634;4794;15749
270430;201605;133695;386697;120200;366552;33185;107213;45000;140782;78185;247995
270440;201605;4637;13951;4289;13486;186;762;3520;11056;3706;11818
270450;201605;6210;19216;5943;18874;303;1324;4942;15410;5245;16734
270460;201605;3395;9037;3049;8616;136;451;2655;7412;2791;7863
270470;201605;10275;32641;9445;31319;1133;4087;6232;20881;7365;24968
270480;201605;2815;8784;2493;8204;265;1089;1695;5325;1960;6414
270490;201605;965;3101;894;3002;37;160;724;2407;761;2567
270500;201605;4825;16488;4550;16150;290;1293;3770;13323;4060;14616
270510;201605;5885;17525;5276;16673;620;2545;3917;11829;4537;14374
270520;201605;3555;11260;3257;10762;987;3587;1113;3812;2100;7399
270530;201605;1359;4201;1258;4051;125;429;858;2810;983;3239
270540;201605;2037;6781;1864;6527;101;522;1514;5152;1615;5674
270550;201605;7129;20715;6206;19549;786;2649;4253;13697;5039;16346
270560;201605;3043;9187;2833;8866;271;1047;2092;6390;2363;7437
270570;201605;3798;12283;3488;11743;300;1275;2699;8905;2999;10180
270580;201605;2013;6379;1915;6248;161;550;1515;5020;1676;5570
270590;201605;1370;4588;1311;4490;11;46;1268;4359;1279;4405
270600;201605;2789;9279;2539;8860;139;688;2018;6872;2157;7560
270610;201605;3189;9953;2957;9623;172;632;2441;7884;2613;8516
270620;201605;1369;4661;1290;4536;83;406;1031;3495;1114;3901
270630;201605;16222;47345;14837;45109;2120;6351;10007;31216;12127;37567
270640;201605;5672;17456;5139;16649;313;1341;4106;13023;4419;14364
270642;201605;2263;8018;2118;7812;217;1023;1592;5768;1809;6791
270644;201605;2644;7776;2345;7377;223;658;1821;5868;2044;6526
270650;201605;3640;11506;3467;11265;469;2120;2402;7310;2871;9430
270660;201605;2295;5853;1791;5131;79;311;1298;3663;1377;3974
270670;201605;16315;41856;14101;39372;1816;4909;10175;29493;11991;34402
270680;201605;4279;12578;4094;12371;118;326;3803;11588;3921;11914
270690;201605;8971;24979;8022;23918;2462;6936;4270;13608;6732;20544
270700;201605;640;1990;577;1886;78;322;388;1213;466;1535
270710;201605;5880;18777;5578;18392;394;1572;4669;15225;5063;16797
270720;201605;3307;11199;3010;10664;138;768;2450;8497;2588;9265
270730;201605;6324;18473;5988;18117;586;1842;4911;15077;5497;16919
270740;201605;2263;6489;2133;6301;238;816;1627;4706;1865;5522
270750;201605;5038;15690;4679;15132;630;2239;3322;10688;3952;12927
270760;201605;3342;10097;2989;9518;153;612;2373;7470;2526;8082
270770;201605;18754;48715;15398;44670;3299;9545;8233;25285;11532;34830
270780;201605;1790;5783;1700;5639;172;672;1266;4152;1438;4824
270790;201605;1509;4748;1386;4571;325;1153;700;2278;1025;3431
270800;201605;11376;33305;10579;32276;689;2609;8776;26364;9465;28973
270810;201605;3304;10032;2584;8736;255;1035;1583;5372;1838;6407
270820;201605;1778;5818;1600;5528;256;978;975;3347;1231;4325
270830;201605;5490;14993;4992;14398;351;1066;4034;11915;4385;12981
270840;201605;7783;25233;7237;24533;298;1580;6296;20870;6594;22450
270850;201605;7271;22763;6990;22395;1008;4009;4887;14839;5895;18848
270860;201605;10998;30806;9313;28657;1062;3885;6231;18746;7293;22631
270870;201605;2126;6448;1785;5743;235;809;1135;3610;1370;4419
270880;201605;8140;25989;7557;25135;449;1898;6170;20242;6619;22140
270890;201605;2357;7196;2210;6935;221;856;1616;4929;1837;5785
270895;201605;2842;10536;2718;10355;134;656;2351;8927;2485;9583
270900;201605;1925;5213;1567;4713;93;296;1166;3466;1259;3762
270910;201605;3547;11592;3269;11095;226;1024;2523;8320;2749;9344
270915;201605;9422;31398;8489;29760;1305;5375;4983;17044;6288;22419
270920;201605;6084;19149;5864;18842;200;1056;5277;16510;5477;17566
270930;201605;17204;45565;14242;42062;2725;8001;8273;25476;10998;33477
270940;201605;5606;18600;5311;18282;458;2062;4149;14102;4607;16164
280010;201605;647;1920;564;1777;53;237;363;1057;416;1294
280020;201605;4773;13827;4131;12745;687;2319;2502;7630;3189;9949
280030;201605;74308;193458;63871;178118;17911;52153;23687;67958;41598;120111
280040;201605;3097;9466;2746;8944;227;874;2039;6570;2266;7444
280050;201605;3775;11996;3481;11502;1113;3919;1355;4569;2468;8488
280060;201605;4719;14968;4222;14100;830;2981;2136;7312;2966;10293
280067;201605;7278;20460;6265;18940;900;2683;3894;11985;4794;14668
280070;201605;1900;6260;1812;6135;228;860;1330;4470;1558;5330
280100;201605;3780;11684;3420;11063;547;1968;2122;6864;2669;8832
280110;201605;1417;4250;1308;4088;57;238;1099;3398;1156;3636
280120;201605;7682;24179;7055;23160;1168;3487;4673;16089;5841;19576
280130;201605;7455;20737;6815;19821;1033;3282;4499;13162;5532;16444
280140;201605;5690;15191;5194;14489;367;1093;4190;11734;4557;12827
280150;201605;3393;10152;3167;9778;266;940;2297;6929;2563;7869
280160;201605;1366;3967;1195;3696;159;536;781;2371;940;2907
280170;201605;4745;14079;4298;13430;443;1401;3183;10094;3626;11495
280190;201605;1091;2987;981;2806;55;208;761;2106;816;2314
280200;201605;1166;3466;1066;3320;113;427;771;2334;884;2761
280210;201605;13680;40311;12276;38381;2260;7515;6929;22009;9189;29524
280220;201605;1556;4796;1457;4638;77;316;1205;3761;1282;4077
280230;201605;3427;10181;3081;9655;346;1185;2025;6359;2371;7544
280240;201605;3466;10000;3146;9499;251;730;2438;7406;2689;8136
280250;201605;818;2156;664;1904;110;378;328;856;438;1234
280260;201605;2029;5419;1892;5250;66;206;1709;4771;1775;4977
280270;201605;2222;6896;1986;6543;114;467;1550;5015;1664;5482
280280;201605;4118;13340;3728;12698;766;2128;2114;8064;2880;10192
280290;201605;17474;52534;15826;50042;2010;7090;9996;31742;12006;38832
280300;201605;9414;28581;8871;27920;766;2658;6962;22451;7728;25109
280310;201605;1362;3800;1197;3527;53;223;858;2463;911;2686
280320;201605;8592;27113;7863;25906;1403;5006;4093;13372;5496;18378
280330;201605;4473;12692;4085;12068;402;1401;3059;8726;3461;10127
280340;201605;3831;10717;3589;10391;321;1043;2852;8331;3173;9374
280350;201605;21811;61050;19541;57654;2842;8864;12515;37186;15357;46050
280360;201605;5742;17968;5347;17323;1003;3647;2920;9270;3923;12917
280370;201605;1884;5247;1626;4814;170;475;1109;3305;1279;3780
280380;201605;1037;3162;934;2998;90;335;652;2035;742;2370
280390;201605;3135;9193;2685;8373;334;1121;1727;5389;2061;6510
280400;201605;4192;11823;3827;11299;1223;3586;1696;5268;2919;8854
280410;201605;2203;6966;1878;6335;232;897;1080;3514;1312;4411
280420;201605;4117;11989;3818;11522;208;701;3232;9736;3440;10437
280430;201605;2265;5787;2046;5487;100;341;1601;4210;1701;4551
280440;201605;4645;13698;4340;13336;354;1204;3503;10653;3857;11857
280445;201605;2504;6956;2330;6668;78;292;1855;5216;1933;5508
280450;201605;9069;24149;8445;23372;582;1353;7129;20328;7711;21681
280460;201605;6872;18005;6215;17076;728;2083;4495;12515;5223;14598
280470;201605;1789;5414;1625;5133;174;549;1154;3699;1328;4248
280480;201605;31245;90543;29376;87818;4867;16204;18620;54568;23487;70772
280490;201605;3836;11387;3376;10619;236;886;2486;7684;2722;8570
280500;201605;922;2456;832;2343;40;110;697;1948;737;2058
280510;201605;2648;7648;2297;7191;177;640;1683;5279;1860;5919
280520;201605;1803;4871;1644;4681;143;376;1348;3898;1491;4274
280530;201605;2450;6620;2272;6410;137;382;1878;5370;2015;5752
280540;201605;9385;25529;8700;24587;224;926;7629;21117;7853;22043
280550;201605;6926;18056;5844;16432;571;1612;4070;11479;4641;13091
280560;201605;7561;22251;7147;21652;358;1242;5989;17926;6347;19168
280570;201605;6462;17376;5643;16281;568;1821;3819;10905;4387;12726
280580;201605;5546;17055;4723;15622;764;2542;2777;9448;3541;11990
280590;201605;2386;7105;2212;6882;219;941;1539;4624;1758;5565
280600;201605;3643;11151;3398;10790;291;1046;2565;8047;2856;9093
280610;201605;2476;6893;2267;6588;181;642;1642;4632;1823;5274
280620;201605;5208;15326;4576;14245;550;1650;3055;9881;3605;11531
280630;201605;3651;11831;3431;11505;312;1030;2734;9384;3046;10414
280640;201605;2228;6632;2128;6519;77;204;1989;6173;2066;6377
280650;201605;1110;3451;1003;3280;100;378;703;2277;803;2655
280660;201605;2693;7493;2580;7355;365;987;2033;5870;2398;6857
280670;201605;16237;42355;15002;40689;2469;7203;9657;25802;12126;33005
280680;201605;2786;7493;2469;7006;184;582;1931;5389;2115;5971
280690;201605;954;2716;847;2567;112;353;587;1786;699;2139
280700;201605;1067;3171;952;2991;66;216;681;2138;747;2354
280710;201605;12023;31295;10945;30064;687;1640;9253;26088;9940;27728
280720;201605;2341;6275;2133;6033;249;725;1452;4280;1701;5005
280730;201605;922;2765;860;2676;81;300;676;2071;757;2371
280740;201605;13181;35524;11460;32934;1489;4243;7344;21462;8833;25705
280750;201605;3496;10603;3203;10115;309;1040;2235;7105;2544;8145
280760;201605;5632;17098;5132;16369;790;2711;3095;10134;3885;12845
290010;201605;2996;6745;2179;5495;44;180;1710;4097;1754;4277
290020;201605;4359;14456;4263;14328;375;1004;3563;12265;3938;13269
290030;201605;3157;9722;2980;9463;478;1532;2121;6758;2599;8290
290035;201605;4652;11798;4021;10964;206;689;3091;8708;3297;9397
290040;201605;4078;10876;3496;10219;222;789;2717;7908;2939;8697
290050;201605;2470;8018;2214;7599;143;588;1645;5644;1788;6232
290060;201605;1309;3387;1108;3147;147;493;829;2289;976;2782
290070;201605;33807;83242;28889;77127;5974;15854;13805;39335;19779;55189
290080;201605;6078;18000;5166;16779;661;2171;3585;11980;4246;14151
290090;201605;2142;4664;1684;4177;133;318;1424;3588;1557;3906
290100;201605;9565;27250;8422;25472;1047;3288;5288;16424;6335;19712
290110;201605;4816;14248;4564;13823;677;2221;2922;8664;3599;10885
290115;201605;4804;14431;4261;13727;237;746;3470;11462;3707;12208
290120;201605;6774;17627;5593;16226;232;827;4637;13337;4869;14164
290130;201605;4633;12114;3833;11127;181;677;3075;8698;3256;9375
290135;201605;4541;11324;3879;10324;309;935;2755;7039;3064;7974
290140;201605;4205;12951;3630;12173;240;932;2965;9990;3205;10922
290150;201605;2196;6580;2089;6430;208;665;1647;4997;1855;5662
290160;201605;3354;8779;3206;8596;293;633;2655;7196;2948;7829
290170;201605;2749;8986;2489;8615;160;743;2066;7057;2226;7800
290180;201605;2957;8559;2558;7942;171;629;1977;6106;2148;6735
290190;201605;3757;12474;3597;12238;189;823;2814;9446;3003;10269
290195;201605;2167;5885;1822;5370;68;301;1504;4355;1572;4656
290200;201605;3871;11947;3417;11250;256;886;2663;8778;2919;9664
290205;201605;3212;9327;2898;8850;204;794;2194;6565;2398;7359
290210;201605;15062;41983;13590;40099;2419;6457;8833;27999;11252;34456
290220;201605;2317;6820;2190;6621;113;484;1752;5152;1865;5636
290225;201605;2958;7247;2661;6919;139;360;2391;6225;2530;6585
290230;201605;2253;7305;2133;7163;119;494;1765;5908;1884;6402
290240;201605;3601;9734;3285;9271;277;847;2499;6962;2776;7809
290250;201605;3840;12074;3494;11585;168;524;2893;10035;3061;10559
290260;201605;5056;14267;4232;13034;313;1088;3233;9954;3546;11042
290265;201605;3385;10531;3009;9865;157;663;2321;7560;2478;8223
290270;201605;11989;43453;11408;42541;1389;5588;8268;31124;9657;36712
290280;201605;5283;17136;4893;16503;432;1601;3604;12210;4036;13811
290290;201605;9816;30601;8733;28826;1277;4239;5741;19333;7018;23572
290300;201605;4657;13045;3367;10653;228;746;2223;7207;2451;7953
290310;201605;1456;4358;1267;4059;227;771;689;2231;916;3002
290320;201605;28661;81155;24326;75536;5511;18259;11671;37407;17182;55666
290323;201605;3874;10432;3404;9901;160;478;2813;8215;2973;8693
290327;201605;4443;13347;3817;12223;514;1678;2453;7881;2967;9559
290330;201605;1823;4465;1680;4314;115;309;1464;3786;1579;4095
290340;201605;4983;15226;4653;14816;1312;4269;2552;8233;3864;12502
290350;201605;4382;13497;3834;12695;334;1152;2715;9200;3049;10352
290360;201605;4582;13771;3962;12941;152;593;3310;10915;3462;11508
290370;201605;4755;13071;4092;12226;321;924;3272;9919;3593;10843
290380;201605;5606;16130;4874;15028;302;994;3814;11984;4116;12978
290390;201605;14711;44531;13291;42470;2103;6921;8154;27023;10257;33944
290395;201605;2568;8394;2294;7875;129;588;1711;5871;1840;6459
290400;201605;3613;10545;3062;9713;260;837;2145;6780;2405;7617
290405;201605;4683;14659;3973;13372;539;1844;2390;8244;2929;10088
290410;201605;5965;17529;4856;15808;393;1552;3423;10841;3816;12393
290420;201605;3272;9433;2731;8664;189;663;2129;6753;2318;7416
290430;201605;3111;9687;2776;9092;492;1675;1624;5396;2116;7071
290440;201605;2987;7870;2399;7041;156;559;1852;5476;2008;6035
290450;201605;3295;9576;2808;8859;280;988;1905;5999;2185;6987
290460;201605;12882;37193;11585;35031;3273;10051;4371;13383;7644;23434
290470;201605;4395;12048;3349;10504;740;2533;1436;4683;2176;7216
290475;201605;5435;17531;4850;16461;264;1241;3679;12177;3943;13418
290480;201605;2482;6639;2294;6398;249;713;1616;4747;1865;5460
290485;201605;4796;15169;4163;14222;274;1332;3312;11103;3586;12435
290490;201605;8121;21171;7665;20588;584;1668;6295;16740;6879;18408
290500;201605;4180;13073;3440;11618;500;1843;1806;6086;2306;7929
290510;201605;3354;9487;2934;8924;149;522;2435;7448;2584;7970
290515;201605;3506;9804;2952;9079;241;735;2356;7393;2597;8128
290520;201605;12206;37072;9862;32693;794;3085;5953;19559;6747;22644
290530;201605;5107;15014;4472;14031;318;972;3477;11004;3795;11976
290540;201605;3917;11197;3716;10955;359;1075;3010;8961;3369;10036
290550;201605;4624;11960;4057;11320;113;293;3714;10447;3827;10740
290560;201605;6355;18266;5585;17172;1249;3854;3142;9921;4391;13775
290570;201605;42531;115753;38825;110726;3706;11017;27929;79597;31635;90614
290580;201605;7015;23698;6591;23028;734;2713;4786;17071;5520;19784
290590;201605;7300;23160;6292;21379;261;1098;5043;17111;5304;18209
290600;201605;17602;52787;16328;50996;2029;6128;11965;38652;13994;44780
290610;201605;2482;8337;2063;7506;143;674;1434;5112;1577;5786
290620;201605;6462;19436;5897;18566;348;1138;4804;15118;5152;16256
290630;201605;8073;20939;7089;19863;582;1685;5867;16610;6449;18295
290640;201605;2696;7762;2181;6939;128;511;1642;5130;1770;5641
290650;201605;10935;31245;10310;30421;2216;6450;6173;18844;8389;25294
290660;201605;3701;10209;3175;9461;119;388;2413;7491;2532;7879
290670;201605;6889;20937;6146;19706;666;2166;4297;14005;4963;16171
290680;201605;10401;30603;9365;29331;406;1615;7735;24003;8141;25618
290682;201605;4570;12952;4033;12187;126;494;3474;10393;3600;10887
290685;201605;3767;8881;2477;7086;282;849;1498;4394;1780;5243
290687;201605;7536;21154;5897;18674;1360;4365;2724;9138;4084;13503
290689;201605;3174;9135;2795;8564;234;775;2093;6634;2327;7409
290690;201605;5462;15403;4810;14539;701;2177;3187;9726;3888;11903
290700;201605;2352;7253;2219;7060;138;502;1753;5591;1891;6093
290710;201605;7713;24100;7232;23394;424;1395;5954;19366;6378;20761
290720;201605;18604;54085;17033;52119;1248;3578;13955;43717;15203;47295
290730;201605;7245;19764;6472;18754;879;2440;4458;13138;5337;15578
290740;201605;948;2783;760;2455;74;274;513;1649;587;1923
290750;201605;10219;28351;8780;25748;1370;4454;4874;13844;6244;18298
290755;201605;2346;6633;1903;5894;89;337;1396;4276;1485;4613
290760;201605;4217;12703;3428;11272;452;1363;2046;6983;2498;8346
290770;201605;2537;8850;2381;8649;92;435;1936;7054;2028;7489
290780;201605;8998;22655;7776;20901;776;1619;5863;16491;6639;18110
290790;201605;4364;13009;4020;12541;218;690;3412;10681;3630;11371
290800;201605;7236;15330;5754;13752;510;992;4396;11135;4906;12127
290810;201605;5267;16084;4441;14762;170;612;3394;11398;3564;12010
290820;201605;5679;15697;5044;14878;449;1464;3808;11382;4257;12846
290830;201605;4373;11536;4017;11051;196;660;3035;8182;3231;8842
290840;201605;17641;49715;15592;46684;2301;6692;9988;31265;12289;37957
290850;201605;6155;17653;5922;17377;734;1882;4667;14322;5401;16204
290860;201605;5091;16965;4746;16552;399;1493;3723;13296;4122;14789
290870;201605;4716;13783;3795;12237;242;973;2720;8716;2962;9689
290880;201605;1435;3859;1144;3407;98;263;768;2335;866;2598
290890;201605;7123;18229;6060;17052;588;1440;4879;14106;5467;15546
290900;201605;2440;6981;1846;5949;252;870;974;3129;1226;3999
290910;201605;4722;12540;3910;11368;96;377;3301;9488;3397;9865
290920;201605;4877;13420;4465;12861;232;667;3780;10899;4012;11566
290930;201605;8060;24269;6993;22547;356;1562;5485;17407;5841;18969
290940;201605;3515;11059;3174;10572;103;353;2607;8912;2710;9265
290950;201605;1561;4308;1361;4005;142;415;929;2788;1071;3203
290960;201605;5773;16228;5232;15553;172;613;4369;13063;4541;13676
290970;201605;3685;11514;3208;10741;279;942;2184;7444;2463;8386
290980;201605;10568;29896;8957;26934;2392;7416;2537;7683;4929;15099
290990;201605;9089;27014;7850;24984;696;2411;5789;18192;6485;20603
291000;201605;3085;9036;2762;8666;117;409;2457;7750;2574;8159
291005;201605;14415;37313;12711;35094;1525;4304;8891;24931;10416;29235
291010;201605;3283;10103;2579;8625;226;774;1675;5674;1901;6448
291020;201605;1351;3523;1047;3006;106;303;568;1549;674;1852
291030;201605;2256;6119;1652;4939;154;505;974;2860;1128;3365
291040;201605;5555;16496;4938;15607;303;1179;3862;12187;4165;13366
291050;201605;7812;25212;7094;23928;1610;6078;3659;11942;5269;18020
291060;201605;6005;21890;5664;21357;876;3676;3625;13536;4501;17212
291070;201605;16246;46236;14202;43315;941;3255;10917;33289;11858;36544
291072;201605;23162;67941;18757;59270;4555;15511;6134;19684;10689;35195
291075;201605;5144;14416;4575;13577;246;645;3535;10692;3781;11337
291077;201605;1464;4146;1193;3707;94;307;762;2366;856;2673
291080;201605;78009;241298;70146;226592;24137;79138;14030;45518;38167;124656
291085;201605;5724;14914;4916;13850;393;1170;3972;11249;4365;12419
291090;201605;1622;3812;1471;3637;45;130;1313;3236;1358;3366
291100;201605;2602;6595;2092;6035;95;374;1639;4658;1734;5032
291110;201605;4877;17398;4410;16704;506;2197;3125;11624;3631;13821
291120;201605;7245;19550;6682;18711;803;2258;4686;13246;5489;15504
291125;201605;1909;3792;1453;3304;92;229;1151;2660;1243;2889
291130;201605;2839;8883;2404;8120;117;513;1784;5894;1901;6407
291140;201605;4156;12295;3603;11274;482;1425;2226;7123;2708;8548
291150;201605;1948;5143;1832;5006;99;317;1522;4103;1621;4420
291160;201605;5268;16401;4610;15320;921;3150;2465;8220;3386;11370
291165;201605;2542;7079;1945;5979;37;159;1410;4230;1447;4389
291170;201605;21881;56631;18734;52409;1635;5008;12213;34249;13848;39257
291180;201605;6207;16202;5037;14441;402;1277;3602;10377;4004;11654
291185;201605;3716;10031;3314;9426;181;536;2713;7657;2894;8193
291190;201605;7113;19360;6262;18178;443;1562;5045;14423;5488;15985
291200;201605;2901;8628;2321;7535;145;489;1549;5118;1694;5607
291210;201605;6843;16412;5759;15184;254;797;4388;11544;4642;12341
291220;201605;4207;12945;3834;12353;474;1762;2569;8143;3043;9905
291230;201605;3946;10007;3600;9631;82;146;3375;9176;3457;9322
291240;201605;4589;12422;3971;11339;126;400;3199;9000;3325;9400
291250;201605;3553;10855;2842;9541;264;905;1867;6384;2131;7289
291260;201605;1071;3107;976;2988;52;224;819;2422;871;2646
291270;201605;4521;14278;4039;13361;1206;4209;1919;6360;3125;10569
291280;201605;2050;5977;1663;5304;325;1156;798;2456;1123;3612
291290;201605;5578;15467;4841;14507;769;2289;2928;8982;3697;11271
291300;201605;4387;12356;3392;10692;197;728;2467;7630;2664;8358
291310;201605;5361;15229;4674;13982;275;855;3610;10780;3885;11635
291320;201605;6106;18997;4998;16881;1182;4068;2264;7817;3446;11885
291330;201605;1601;4771;1427;4485;104;370;1018;3164;1122;3534
291340;201605;3911;10978;3226;10004;121;414;2599;8053;2720;8467
291345;201605;3375;10682;3133;10391;181;605;2639;8933;2820;9538
291350;201605;5693;16532;4977;15323;289;987;3819;11929;4108;12916
291360;201605;33374;90714;29425;85250;7001;20549;15336;45876;22337;66425
291370;201605;8290;23539;7779;22908;501;1558;6068;18029;6569;19587
291380;201605;3667;11009;3138;10152;186;690;2340;7668;2526;8358
291390;201605;10223;27444;9448;26534;1196;3282;7007;19844;8203;23126
291400;201605;13684;37958;12020;35442;2231;6007;7402;23196;9633;29203
291410;201605;3288;8597;2434;7242;116;494;1765;5073;1881;5567
291420;201605;2089;5713;1804;5375;84;303;1506;4449;1590;4752
291430;201605;3234;9414;2872;8924;129;627;2341;7016;2470;7643
291440;201605;6648;19997;5612;18267;537;1849;4065;13356;4602;15205
291450;201605;8262;24131;7219;22693;300;931;5801;19070;6101;20001
291460;201605;13226;39754;11909;37708;1566;5436;7535;24015;9101;29451
291465;201605;8018;22689;7037;21580;405;1538;5803;17648;6208;19186
291470;201605;15840;42185;13919;39900;1000;2751;10477;31137;11477;33888
291480;201605;34996;89143;29604;81833;4117;12450;16646;46148;20763;58598
291490;201605;4255;13532;4020;13214;436;1431;2992;10044;3428;11475
291500;201605;4312;12251;3656;11290;185;704;2920;8955;3105;9659
291510;201605;3649;10903;3345;10494;67;226;2971;9474;3038;9700
291520;201605;3788;10327;3244;9598;284;932;2242;6645;2526;7577
291530;201605;2199;5929;1734;5241;382;1168;857;2799;1239;3967
291535;201605;3761;11410;3397;10851;193;667;2655;8570;2848;9237
291540;201605;2134;5040;1782;4679;117;217;1569;4258;1686;4475
291550;201605;5115;13691;4439;12762;786;2173;2630;7772;3416;9945
291560;201605;18714;43837;13386;37649;896;2572;9865;29076;10761;31648
291570;201605;2210;5917;2030;5704;128;259;1734;5072;1862;5331
291580;201605;5459;16499;4838;15618;460;1830;3471;11165;3931;12995
291590;201605;1758;5513;1585;5234;146;541;1183;3935;1329;4476
291600;201605;5368;14569;3990;12392;1005;3310;1629;4943;2634;8253
291610;201605;4909;15651;4723;15443;130;419;4317;14306;4447;14725
291620;201605;2958;7027;2339;6379;136;406;1860;5231;1996;5637
291630;201605;3137;7553;2597;6928;218;597;2018;5499;2236;6096
291640;201605;16951;45945;13532;40885;3301;10426;4020;12747;7321;23173
291650;201605;8156;23947;7512;23163;595;1544;6225;19712;6820;21256
291660;201605;2149;5629;1735;4991;128;471;1120;3042;1248;3513
291670;201605;1843;5121;1665;4883;95;262;1323;3968;1418;4230
291680;201605;4036;11676;3497;10785;591;1989;2062;6327;2653;8316
291685;201605;4777;11963;3962;10914;644;1692;2557;7349;3201;9041
291690;201605;3882;10374;3051;9013;225;627;2107;6214;2332;6841
291700;201605;9121;28205;8127;26487;885;2849;5916;19585;6801;22434
291710;201605;5236;13598;4248;12353;290;857;3113;9080;3403;9937
291720;201605;4479;14551;3817;13172;301;1196;2654;8961;2955;10157
291730;201605;6088;17946;5536;17214;495;1650;4305;13574;4800;15224
291733;201605;2674;7610;2297;7115;191;627;1502;4835;1693;5462
291735;201605;2903;7992;2423;7302;124;448;1960;5863;2084;6311
291740;201605;3667;10629;3142;9897;208;763;2486;7818;2694;8581
291750;201605;22472;57386;17524;49844;3693;10858;8345;24417;12038;35275
291760;201605;10944;34749;9701;32623;3864;14476;2281;7628;6145;22104
291770;201605;7672;22084;6479;19939;764;2583;4099;12360;4863;14943
291780;201605;4469;13441;4175;12954;226;746;3492;10823;3718;11569
291790;201605;2677;8057;2537;7874;80;328;2163;6619;2243;6947
291800;201605;30507;82253;26728;77074;4065;11781;16495;49067;20560;60848
291810;201605;10699;29013;8975;26904;350;1270;7308;21941;7658;23211
291820;201605;3766;11028;3347;10403;180;651;2575;8060;2755;8711
291830;201605;4088;10924;3773;10474;383;1124;2813;7882;3196;9006
291835;201605;6313;19551;5077;17341;1346;4917;2378;8249;3724;13166
291840;201605;47482;132422;41707;125836;6307;18540;28275;88850;34582;107390
291845;201605;2645;7676;2466;7448;116;301;2223;6876;2339;7177
291850;201605;4559;12993;3754;11717;353;992;2700;8755;3053;9747
291855;201605;1822;4490;1572;4181;151;523;1167;2986;1318;3509
291860;201605;2181;6121;1755;5317;74;273;1177;3478;1251;3751
291870;201605;1415;3789;1016;3068;70;272;636;1842;706;2114
291875;201605;2808;8814;2546;8407;99;398;1842;5973;1941;6371
291880;201605;4966;15860;4627;15232;445;1510;3405;11293;3850;12803
291890;201605;1283;3313;1052;3031;229;624;678;2051;907;2675
291900;201605;1258;3354;1013;2958;55;196;753;2172;808;2368
291905;201605;2730;7376;2056;6141;126;446;1452;4177;1578;4623
291910;201605;2762;7350;2305;6803;109;420;1942;5697;2051;6117
291915;201605;7029;21326;5873;19248;307;1090;4519;14956;4826;16046
291920;201605;25485;74918;23439;72053;3423;11109;14714;45417;18137;56526
291930;201605;2612;7671;2305;7192;192;693;1640;5012;1832;5705
291940;201605;3369;9467;2476;7905;292;1010;1439;4490;1731;5500
291950;201605;8762;28933;7901;27324;1249;4335;4540;16220;5789;20555
291955;201605;11025;31242;10177;30185;2444;7229;5334;16868;7778;24097
291960;201605;3141;9159;2571;8299;220;728;1871;6257;2091;6985
291970;201605;3884;11944;3584;11446;364;1304;2446;7904;2810;9208
291980;201605;11975;33782;9166;29768;1007;3293;6021;20070;7028;23363
291990;201605;2181;6585;1989;6336;80;269;1694;5526;1774;5795
291992;201605;2773;8440;2710;8332;368;1129;2031;6243;2399;7372
291995;201605;2062;5853;1786;5477;84;321;1514;4616;1598;4937
292000;201605;2439;6771;2193;6450;200;687;1559;4647;1759;5334
292010;201605;6446;16054;5048;14101;493;1264;3606;10392;4099;11656
292020;201605;3998;13753;3769;13379;553;2091;2706;9591;3259;11682
292030;201605;2014;6206;1795;5890;221;759;1020;3319;1241;4078
292040;201605;4411;11817;3800;11179;230;477;3215;10052;3445;10529
292045;201605;3221;10322;2936;9932;104;387;2681;9038;2785;9425
292050;201605;6362;19259;5426;17390;458;1728;3443;10889;3901;12617
292060;201605;12569;31679;11638;30549;853;2012;9589;25177;10442;27189
292070;201605;4591;14198;4314;13877;390;1192;3555;11577;3945;12769
292080;201605;3551;9170;2908;8362;189;603;2433;7023;2622;7626
292090;201605;3956;10290;3380;9622;196;708;2837;8089;3033;8797
292100;201605;11337;30265;9703;28060;2234;6708;4685;14123;6919;20831
292105;201605;3067;9330;2741;8810;113;481;2218;7106;2331;7587
292110;201605;6447;17210;5020;14965;1337;3992;2289;7047;3626;11039
292120;201605;7514;21022;6293;18757;1197;3471;3342;10312;4539;13783
292130;201605;2883;7888;2476;7326;388;1039;1539;4769;1927;5808
292140;201605;5010;13082;4159;11880;684;1805;2754;8128;3438;9933
292145;201605;2387;7292;2117;6837;252;782;1426;4795;1678;5577
292150;201605;12442;37982;11470;36450;496;1850;9357;29752;9853;31602
292160;201605;2468;7126;2111;6663;95;389;1841;5751;1936;6140
292170;201605;8805;24811;7260;22194;902;3002;4517;13807;5419;16809
292180;201605;2977;8640;2342;7546;424;1287;1249;4193;1673;5480
292190;201605;3297;9311;2776;8517;529;1720;1508;4685;2037;6405
292200;201605;6772;20716;5768;18981;1649;5838;1969;6552;3618;12390
292205;201605;3862;11541;3470;10979;159;656;2776;8621;2935;9277
292210;201605;6452;17146;5392;15751;291;1019;4443;12919;4734;13938
292220;201605;1855;5067;1654;4769;409;1125;827;2397;1236;3522
292225;201605;3200;9875;2907;9428;144;592;2391;7711;2535;8303
292230;201605;6719;19173;6321;18551;301;1276;4994;14115;5295;15391
292240;201605;4809;14414;4296;13398;455;1452;2906;9058;3361;10510
292250;201605;5052;15579;4706;14986;1014;3313;2273;7397;3287;10710
292260;201605;3158;9267;2942;8978;169;508;2472;7610;2641;8118
292265;201605;3165;9528;2731;8807;120;542;2064;6509;2184;7051
292270;201605;4117;10334;3322;9404;155;531;2792;7926;2947;8457
292273;201605;2766;6360;2114;5560;169;403;1583;4373;1752;4776
292275;201605;1580;4305;1398;4044;146;408;1049;3127;1195;3535
292280;201605;2195;6064;1921;5753;177;478;1453;4622;1630;5100
292285;201605;2496;6699;2054;6065;103;367;1598;4709;1701;5076
292290;201605;6962;20820;5792;19250;373;1483;4398;14788;4771;16271
292300;201605;8213;24381;7112;23042;1820;6222;3726;12442;5546;18664
292303;201605;2857;8608;2580;8230;96;378;2200;6932;2296;7310
292305;201605;2909;7835;2736;7594;57;227;2485;6813;2542;7040
292310;201605;5917;17376;5467;16697;159;567;4520;13763;4679;14330
292320;201605;6718;18714;5683;16983;398;1241;4348;12965;4746;14206
292330;201605;2228;5890;2036;5639;150;474;1643;4509;1793;4983
292335;201605;5138;13454;4587;12733;403;1065;3673;10382;4076;11447
292340;201605;6389;17870;5444;16348;423;1263;3959;11974;4382;13237
292350;201605;2297;6708;1989;6274;130;496;1593;5017;1723;5513
292360;201605;5304;13752;5016;13267;196;362;4186;11619;4382;11981
292370;201605;8315;23717;7452;22567;661;1711;5873;18202;6534;19913
292380;201605;7254;21320;6594;20259;661;1864;4967;15490;5628;17354
292390;201605;3487;7881;2948;7297;83;184;2669;6698;2752;6882
292400;201605;20768;63201;19385;61022;2695;8491;13265;42291;15960;50782
292405;201605;4567;11313;3679;10169;192;458;2938;8242;3130;8700
292410;201605;1978;5270;1834;5109;144;354;1524;4303;1668;4657
292420;201605;3787;12163;3576;11862;221;886;2924;9684;3145;10570
292430;201605;5563;16333;4205;14419;348;1345;2767;9564;3115;10909
292440;201605;8432;27855;7785;26890;183;800;6981;24299;7164;25099
292450;201605;3994;11946;3282;10753;321;1058;2288;7612;2609;8670
292460;201605;4882;14595;4193;13442;501;1720;2760;8857;3261;10577
292465;201605;2401;7118;2017;6492;193;680;1276;4189;1469;4869
292467;201605;1857;5930;1775;5806;300;1060;1149;3837;1449;4897
292470;201605;2916;7729;2404;6879;103;326;1874;5326;1977;5652
292480;201605;6224;16437;5318;15270;134;458;4795;13736;4929;14194
292490;201605;2409;6539;1975;5908;139;427;1474;4395;1613;4822
292500;201605;6579;19391;5620;17721;674;2163;3656;11713;4330;13876
292510;201605;12745;36163;10959;33564;745;2718;8325;25664;9070;28382
292520;201605;5530;15681;4817;14641;1031;3186;2572;7949;3603;11135
292525;201605;5323;13795;4532;12873;165;522;3830;10933;3995;11455
292530;201605;26787;76252;23457;71751;6118;19376;10517;33395;16635;52771
292540;201605;2871;7821;2539;7424;249;802;1972;5745;2221;6547
292550;201605;6464;19818;5602;18707;616;2191;4179;14333;4795;16524
292560;201605;4031;11220;3496;10412;184;689;2656;7800;2840;8489
292570;201605;4208;11824;3878;11479;71;159;3656;11090;3727;11249
292575;201605;6303;20641;6095;20327;437;1491;5066;17066;5503;18557
292580;201605;6720;19878;6289;19283;329;1099;5315;16308;5644;17407
292590;201605;7474;21624;6958;20886;421;1322;5821;17295;6242;18617
292593;201605;3033;7790;2513;6982;357;925;1685;4671;2042;5596
292595;201605;5811;16036;5130;15171;352;1097;4005;11931;4357;13028
292600;201605;10703;30116;9584;28673;833;1975;7447;23114;8280;25089
292610;201605;4659;12923;3800;11537;281;858;2362;7494;2643;8352
292620;201605;6261;19024;5490;18137;104;333;5116;17124;5220;17457
292630;201605;9302;23420;7715;20994;687;1867;5363;14861;6050;16728
292640;201605;7804;25176;7225;24281;400;1518;5509;18735;5909;20253
292650;201605;4766;12630;4455;12230;369;844;3717;10355;4086;11199
292660;201605;10808;32191;9895;30875;1024;3301;7400;23374;8424;26675
292665;201605;2397;7439;2276;7281;36;94;2097;6796;2133;6890
292670;201605;3734;10446;2905;8981;188;650;1846;5697;2034;6347
292680;201605;3671;10841;3314;10249;435;1251;2308;7196;2743;8447
292690;201605;2865;7751;2059;6461;170;522;1391;4519;1561;5041
292700;201605;9330;27619;8199;25958;1200;3500;5166;17342;6366;20842
292710;201605;2118;6937;1998;6778;59;224;1777;6058;1836;6282
292720;201605;9275;23571;8012;22175;288;926;6833;19198;7121;20124
292730;201605;3639;10804;3490;10589;229;720;2804;8532;3033;9252
292740;201605;328809;876043;307742;844762;53983;156825;186597;507260;240580;664085
292750;201605;6566;17542;5635;16257;274;877;4502;13055;4776;13932
292760;201605;3995;12422;3603;11739;389;1366;2445;7980;2834;9346
292770;201605;5917;17248;5185;16208;903;2977;3085;9944;3988;12921
292780;201605;1893;4407;1438;3824;98;333;1041;2691;1139;3024
292790;201605;3332;8077;3191;7930;63;110;3064;7698;3127;7808
292800;201605;9208;26907;8459;25680;490;1606;6754;20455;7244;22061
292805;201605;3020;8505;2638;7970;274;890;1932;5835;2206;6725
292810;201605;9492;28064;7827;25720;937;3158;5307;17876;6244;21034
292820;201605;7362;20920;5557;18300;279;1200;4377;14353;4656;15553
292830;201605;1763;5187;1597;4957;60;242;1406;4346;1466;4588
292840;201605;7887;23821;7405;23182;314;1213;6514;20133;6828;21346
292850;201605;3122;8261;2524;7345;281;848;1589;4534;1870;5382
292860;201605;15298;39071;13944;37331;1075;2973;10851;29006;11926;31979
292870;201605;19268;52377;16853;48670;1839;5998;10073;28615;11912;34613
292880;201605;12670;35503;11247;33551;888;3024;8139;23860;9027;26884
292890;201605;5376;17935;4849;16995;622;2311;3143;11151;3765;13462
292895;201605;2835;6804;2180;5809;225;576;1498;4013;1723;4589
292900;201605;2766;8514;2629;8303;156;714;1978;5971;2134;6685
292905;201605;4066;12005;3291;10802;280;955;2265;7523;2545;8478
292910;201605;4975;14699;4495;13847;533;1711;2719;8415;3252;10126
292920;201605;9251;26814;8799;26172;464;1737;7303;21129;7767;22866
292925;201605;5149;15515;4648;14789;336;1094;3616;11591;3952;12685
292930;201605;6459;20579;6082;19916;416;1856;4378;13963;4794;15819
292935;201605;2020;5900;1705;5556;82;277;1452;4910;1534;5187
292937;201605;3255;8217;2707;7536;180;531;2158;6028;2338;6559
292940;201605;3283;8893;2620;8010;253;791;1782;5661;2035;6452
292950;201605;8101;23519;7499;22517;479;1773;5545;16257;6024;18030
292960;201605;5260;13438;4531;12467;278;811;3373;9228;3651;10039
292970;201605;4273;12693;3756;12011;133;611;3090;9850;3223;10461
292975;201605;3537;9320;3306;9030;352;855;2775;7733;3127;8588
292980;201605;3326;8762;2605;7743;206;706;1869;5517;2075;6223
292990;201605;11819;33797;10281;31499;393;1404;8356;25546;8749;26950
293000;201605;2825;7259;2602;6996;52;152;2065;5970;2117;6122
293010;201605;17874;49349;15181;45060;2281;7112;8709;25733;10990;32845
293015;201605;7504;25433;6610;23684;701;2864;4318;15392;5019;18256
293020;201605;8980;29825;8450;29082;288;1326;7321;25051;7609;26377
293030;201605;5580;15850;4436;14069;234;801;3125;10330;3359;11131
293040;201605;3775;12231;3601;11901;182;562;3165;10547;3347;11109
293050;201605;20488;56090;17951;52836;3300;9961;9226;28684;12526;38645
293060;201605;3616;9642;2988;8616;229;728;2167;6168;2396;6896
293070;201605;23381;63826;19483;58218;4531;13646;8608;27115;13139;40761
293075;201605;3236;10993;2981;10603;198;856;2341;8348;2539;9204
293076;201605;3762;10294;3380;9786;173;462;2815;8355;2988;8817
293077;201605;4909;15261;4406;14579;829;2872;2652;9037;3481;11909
293080;201605;4617;14463;4187;13786;182;864;3437;11115;3619;11979
293090;201605;3299;10469;2726;9593;253;930;1957;7034;2210;7964
293100;201605;5831;17002;4815;15218;455;1503;3429;10977;3884;12480
293105;201605;4008;13069;3482;12060;477;1660;2233;7891;2710;9551
293110;201605;2037;5747;1792;5393;66;214;1472;4456;1538;4670
293120;201605;3770;12278;3586;11993;296;947;2823;9606;3119;10553
293130;201605;4053;11357;3484;10731;135;479;3043;9554;3178;10033
293135;201605;31807;79763;24110;68940;4916;15767;8909;25526;13825;41293
293140;201605;1975;5529;1880;5395;126;453;1521;4241;1647;4694
293150;201605;5462;17957;4680;16461;690;2502;2863;10324;3553;12826
293160;201605;3822;9754;3480;9354;519;1031;2561;7444;3080;8475
293170;201605;3381;9854;3087;9440;264;930;2207;6824;2471;7754
293180;201605;5263;14742;4198;13018;151;621;3264;9920;3415;10541
293190;201605;13807;41408;12663;39701;424;1964;10832;33383;11256;35347
293200;201605;7194;19671;6295;18555;170;651;4903;14624;5073;15275
293210;201605;5112;14525;4496;13485;276;882;3391;10155;3667;11037
293220;201605;4981;14613;4257;13352;1113;3526;1507;4899;2620;8425
293230;201605;3759;11440;3379;10843;459;1629;2279;7301;2738;8930
293240;201605;4396;12033;3522;10583;132;425;2599;7834;2731;8259
293245;201605;4264;12060;3843;11469;244;713;3035;9177;3279;9890
293250;201605;5610;15280;5029;14428;531;1591;3472;9895;4003;11486
293260;201605;4527;13469;3832;12448;240;822;2874;9460;3114;10282
293270;201605;5596;14781;5076;14222;385;937;4322;12361;4707;13298
293280;201605;5277;14625;4465;13546;210;625;3506;10797;3716;11422
293290;201605;14540;47996;13494;46030;3307;11567;5956;20999;9263;32566
293300;201605;6943;16239;5804;14921;337;770;4457;11732;4794;12502
293305;201605;4865;11995;4093;10977;135;427;3435;9185;3570;9612
293310;201605;2514;6529;2012;5673;201;568;1319;3695;1520;4263
293315;201605;4235;10764;3605;9824;328;808;2685;7454;3013;8262
293317;201605;2475;7067;2228;6617;184;521;1523;4570;1707;5091
293320;201605;7723;25398;7503;25119;874;3013;5759;19474;6633;22487
293325;201605;1813;5126;1484;4618;179;612;978;3029;1157;3641
293330;201605;50695;161820;45606;152955;10005;35450;20770;70767;30775;106217
293340;201605;2656;7498;2078;6513;262;861;1164;3673;1426;4534
293345;201605;3303;9764;2878;9197;243;638;2203;7411;2446;8049
293350;201605;6490;18977;6127;18556;232;502;5532;17315;5764;17817
293360;201605;13005;39332;11762;37772;877;3255;9977;31919;10854;35174
310010;201605;917;2473;718;2169;99;370;326;919;425;1289
310020;201605;2878;8981;2388;8050;545;2014;311;975;856;2989
310030;201605;2316;7143;1899;6435;401;1512;998;3339;1399;4851
310040;201605;969;2578;806;2355;56;201;626;1798;682;1999
310050;201605;1864;6351;1694;5977;348;1380;724;2489;1072;3869
310060;201605;3223;10019;2804;9480;288;1116;2165;7300;2453;8416
310070;201605;334;947;255;801;16;71;161;474;177;545
310080;201605;723;2147;597;1929;104;414;220;666;324;1080
310090;201605;4578;13549;3940;12449;438;1529;2585;8163;3023;9692
310100;201605;3441;10291;2898;9400;167;664;2214;7146;2381;7810
310110;201605;4764;13426;4089;12329;647;2200;2199;6412;2846;8612
310120;201605;619;1875;474;1592;127;537;178;477;305;1014
310130;201605;400;1217;365;1165;89;341;185;531;274;872
310140;201605;209;691;174;638;56;255;48;141;104;396
310150;201605;4675;14199;4040;13009;964;3389;1340;4228;2304;7617
310160;201605;7189;22503;5958;20237;1793;6616;913;3003;2706;9619
310163;201605;1029;3287;870;2973;276;996;217;722;493;1718
310170;201605;9090;25339;8085;23947;1071;3391;5405;16210;6476;19601
310180;201605;1644;4726;1407;4362;262;892;725;2169;987;3061
310190;201605;2813;9206;2497;8627;663;2523;417;1402;1080;3925
310200;201605;1831;5917;1553;5364;316;1229;542;1847;858;3076
310205;201605;1115;3197;857;2807;132;444;474;1589;606;2033
310210;201605;2717;7819;2407;7356;160;516;1882;5780;2042;6296
310220;201605;1047;3133;925;2937;157;558;563;1743;720;2301
310230;201605;2514;7734;2128;6906;315;1215;1124;3432;1439;4647
310240;201605;895;3231;813;3065;119;496;439;1691;558;2187
310250;201605;811;2664;784;2619;154;627;446;1377;600;2004
310260;201605;3194;10031;2448;8545;578;2315;481;1472;1059;3787
310270;201605;2540;7180;2109;6567;156;598;1647;5088;1803;5686
310280;201605;2306;6048;1877;5406;204;761;1077;2953;1281;3714
310285;201605;2026;7140;1874;6913;206;903;1392;5183;1598;6086
310290;201605;1131;3398;1060;3284;254;886;535;1505;789;2391
310300;201605;1690;5655;1607;5509;408;1604;793;2592;1201;4196
310310;201605;363;985;262;800;35;103;122;384;157;487
310320;201605;392;1233;325;1108;41;198;157;502;198;700
310330;201605;522;1298;351;987;36;112;142;347;178;459
310340;201605;8328;24827;6831;22263;1356;4483;3251;11127;4607;15610
310350;201605;13584;35910;9897;29840;2365;7923;2490;7328;4855;15251
310360;201605;437;1295;404;1250;26;119;292;855;318;974
310370;201605;1397;4639;1255;4380;348;1225;570;2022;918;3247
310375;201605;1198;3269;786;2518;106;377;291;931;397;1308
310380;201605;369;956;247;770;75;255;80;222;155;477
310390;201605;454;1553;392;1433;83;318;69;214;152;532
310400;201605;10212;28071;7637;23800;1763;5986;1822;5743;3585;11729
310410;201605;731;2432;512;2048;107;466;91;361;198;827
310420;201605;5531;15424;3634;11508;650;2271;487;1312;1137;3583
310430;201605;1326;4295;1015;3691;238;947;150;523;388;1470
310440;201605;556;1588;422;1343;70;255;169;531;239;786
310445;201605;1234;4018;1031;3640;123;479;670;2351;793;2830
310450;201605;4547;12734;3685;11503;355;1182;2530;8018;2885;9200
310460;201605;1534;4571;1275;4178;366;1340;271;958;637;2298
310470;201605;4080;9175;3482;8460;261;576;2957;7290;3218;7866
310480;201605;1232;3580;916;2955;185;612;367;1128;552;1740
310490;201605;2845;9238;2488;8541;594;2388;970;3213;1564;5601
310500;201605;1292;4329;1133;3988;254;987;438;1493;692;2480
310510;201605;2020;6317;1584;5371;375;1353;248;848;623;2201
310520;201605;1408;3593;1068;3074;77;214;722;2081;799;2295
310530;201605;996;2975;527;1807;63;248;65;190;128;438
310540;201605;2992;9608;2682;9056;663;2337;1157;3924;1820;6261
310550;201605;1186;3323;947;2950;196;742;463;1326;659;2068
310560;201605;15442;46621;13035;42052;3382;12132;3660;11001;7042;23133
310570;201605;1139;3415;971;3130;148;564;632;1996;780;2560
310590;201605;4281;12422;3518;11020;588;1967;1553;4767;2141;6734
310600;201605;1399;4565;1257;4276;265;1042;507;1620;772;2662
310610;201605;461;1554;403;1426;78;345;123;388;201;733
310620;201605;140822;429117;121011;392238;27800;100626;44406;133824;72206;234450
310630;201605;4125;12353;3785;11802;327;1160;2792;8603;3119;9763
310640;201605;1280;3879;1043;3481;295;1091;261;819;556;1910
310650;201605;2673;8356;2106;7359;324;1175;1175;4141;1499;5316
310660;201605;1325;4005;1168;3805;116;386;845;2733;961;3119
310665;201605;1261;3807;1132;3632;95;334;890;2922;985;3256
310670;201605;39725;121308;35349;112358;8941;30087;12591;39156;21532;69243
310680;201605;674;1908;603;1808;91;303;400;1176;491;1479
310690;201605;1412;4512;1147;4052;226;960;413;1361;639;2321
310700;201605;531;1282;412;1132;68;220;249;665;317;885
310710;201605;6259;20269;4833;17895;919;4024;611;2045;1530;6069
310720;201605;773;2318;708;2204;79;282;475;1458;554;1740
310730;201605;9314;28703;8297;27024;1422;5054;4750;15419;6172;20473
310740;201605;4963;15638;3950;13665;914;3433;834;2751;1748;6184
310750;201605;1477;3666;1114;3177;214;648;523;1405;737;2053
310760;201605;600;1797;500;1626;88;310;181;582;269;892
310770;201605;896;2812;691;2499;155;632;275;937;430;1569
310780;201605;3733;10250;3149;9224;473;1406;1968;5751;2441;7157
310790;201605;1944;6214;1768;5903;459;1586;753;2649;1212;4235
310800;201605;2799;8795;2160;7569;614;2492;160;506;774;2998
310810;201605;1139;3200;1010;2966;169;567;558;1544;727;2111
310820;201605;1293;3695;917;2983;205;722;217;708;422;1430
310825;201605;2532;8469;1994;7529;128;685;1450;5402;1578;6087
310830;201605;1335;4316;1072;3811;291;1102;306;1055;597;2157
310840;201605;2107;6377;1635;5567;336;1233;424;1365;760;2598
310850;201605;1525;4494;1294;4195;145;518;925;3012;1070;3530
310855;201605;2930;9151;2516;8521;385;1432;1633;5566;2018;6998
310860;201605;7424;22654;6225;20491;749;2647;3642;12162;4391;14809
310870;201605;1036;2815;806;2438;147;473;428;1297;575;1770
310880;201605;1060;3284;874;2948;146;574;459;1529;605;2103
310890;201605;2581;7773;1988;6748;459;1757;393;1184;852;2941
310900;201605;4062;12726;3170;10873;669;2555;1038;3321;1707;5876
310910;201605;1913;5393;1267;4148;219;819;150;405;369;1224
310920;201605;1867;5455;1473;4845;325;1218;636;2056;961;3274
310925;201605;913;2977;821;2820;288;1097;310;1032;598;2129
310930;201605;6109;17094;4896;15326;805;2738;2766;8931;3571;11669
310940;201605;6148;17128;5119;15570;791;2524;2867;8659;3658;11183
310945;201605;1128;3298;1001;3118;131;474;611;1839;742;2313
310950;201605;2058;6485;1517;5319;372;1522;455;1496;827;3018
310960;201605;386;1243;317;1113;90;342;112;408;202;750
310970;201605;1436;4699;1053;3833;247;1014;145;452;392;1466
310980;201605;432;1050;266;770;35;118;126;325;161;443
310990;201605;1151;3713;948;3280;206;784;262;835;468;1619
311000;201605;3526;11876;3210;11284;911;3566;1046;3429;1957;6995
311010;201605;715;2418;663;2324;219;828;289;1006;508;1834
311020;201605;918;2665;714;2312;133;495;327;1013;460;1508
311030;201605;1621;4399;1127;3505;282;1016;338;935;620;1951
311040;201605;459;1535;393;1379;84;297;89;290;173;587
311050;201605;2203;6709;1915;6281;485;1769;841;2734;1326;4503
311060;201605;2421;7088;1802;5798;324;1182;537;1602;861;2784
311070;201605;1393;4768;1224;4450;256;1053;502;1816;758;2869
311080;201605;814;2503;695;2273;142;515;274;832;416;1347
311090;201605;1550;5806;1354;5400;426;1853;307;1181;733;3034
311100;201605;2033;6786;1642;5951;544;2141;216;774;760;2915
311110;201605;3447;8294;2496;6958;389;1174;1257;3505;1646;4679
311115;201605;1225;3520;1020;3215;91;370;691;2125;782;2495
311120;201605;7871;21982;6084;18885;1339;4682;1632;4682;2971;9364
311130;201605;2085;6331;1701;5750;329;1355;684;2200;1013;3555
311140;201605;1284;3425;1019;3075;85;296;688;2074;773;2370
311150;201605;1729;5954;1591;5736;265;1066;983;3538;1248;4604
311160;201605;3995;13318;3266;11997;1119;4499;725;2653;1844;7152
311170;201605;787;2352;623;2056;62;227;297;1015;359;1242
311180;201605;1179;3395;921;2907;267;908;203;603;470;1511
311190;201605;1104;3095;827;2561;159;564;219;630;378;1194
311200;201605;1998;6068;1614;5274;425;1524;278;828;703;2352
311205;201605;1005;3314;859;3020;116;471;392;1393;508;1864
311210;201605;936;3018;863;2922;156;525;572;2015;728;2540
311220;201605;862;2677;704;2349;153;555;227;727;380;1282
311230;201605;8223;25832;6443;22216;1279;4711;2101;7574;3380;12285
311240;201605;1031;3090;808;2732;208;779;244;806;452;1585
311250;201605;757;2464;676;2339;194;741;208;639;402;1380
311260;201605;2397;6360;1803;5394;409;1359;611;1797;1020;3156
311265;201605;1225;3443;965;3016;183;622;500;1577;683;2199
311270;201605;3368;10629;2945;10040;284;1361;2053;6712;2337;8073
311280;201605;1265;3516;807;2572;161;599;187;571;348;1170
311290;201605;1977;6574;1855;6305;371;1260;1051;3632;1422;4892
311300;201605;4304;14272;3832;13429;408;1732;2677;9276;3085;11008
311310;201605;570;1897;516;1802;90;350;189;602;279;952
311320;201605;3798;12554;3426;11757;630;2441;1227;3956;1857;6397
311330;201605;4576;13635;3957;12596;1023;3624;1661;5287;2684;8911
311340;201605;11775;36833;10268;33982;3042;10810;2568;8385;5610;19195
311350;201605;2299;6423;1783;5461;282;1014;801;2234;1083;3248
311360;201605;1103;3040;859;2731;380;1256;125;430;505;1686
311370;201605;3680;11007;3057;9910;659;2471;1112;3266;1771;5737
311380;201605;406;1343;354;1247;95;356;117;415;212;771
311390;201605;1763;6363;1607;6148;687;2970;450;1621;1137;4591
311400;201605;1449;4540;1190;4053;218;876;480;1494;698;2370
311410;201605;1786;6028;1598;5789;428;1743;758;2787;1186;4530
311420;201605;1870;6005;1300;4631;234;921;151;410;385;1331
311430;201605;3795;11338;2644;8839;496;1814;301;984;797;2798
311440;201605;2412;7620;1784;6493;556;2343;268;947;824;3290
311450;201605;1920;6606;1613;5941;439;1804;301;1016;740;2820
311455;201605;1122;2983;883;2595;213;663;373;1015;586;1678
311460;201605;624;2012;473;1705;99;414;108;360;207;774
311470;201605;481;1589;385;1386;108;450;79;243;187;693
311480;201605;785;2067;732;1995;166;430;451;1236;617;1666
311490;201605;225;822;203;761;57;239;72;242;129;481
311500;201605;431;1243;342;1080;84;316;137;412;221;728
311510;201605;2956;9034;2381;7995;705;2795;498;1600;1203;4395
311520;201605;604;1967;559;1876;172;643;214;682;386;1325
311530;201605;11562;29599;8286;24348;1890;6624;2103;5931;3993;12555
311535;201605;799;2314;519;1757;113;443;85;267;198;710
311540;201605;609;2104;566;2036;194;690;240;862;434;1552
311545;201605;2095;6330;1861;6042;165;604;1345;4325;1510;4929
311547;201605;1487;4166;1250;3795;82;267;837;2537;919;2804
311550;201605;2895;9129;2430;8212;392;1532;877;2880;1269;4412
311560;201605;264;693;223;646;28;81;125;346;153;427
311570;201605;2000;5067;1546;4443;105;324;1124;3328;1229;3652
311580;201605;2345;4747;1766;4079;423;880;973;2422;1396;3302
311590;201605;452;1366;383;1258;90;337;155;509;245;846
311600;201605;1198;3632;1016;3395;175;570;629;2165;804;2735
311610;201605;2897;10120;2590;9592;834;2998;1009;4026;1843;7024
311615;201605;3097;9570;2587;8763;242;969;1820;6149;2062;7118
311620;201605;409;1271;367;1196;66;240;208;673;274;913
311630;201605;1373;3991;1138;3597;224;680;653;2068;877;2748
311640;201605;764;2440;633;2225;128;494;298;1038;426;1532
311650;201605;2256;6406;1911;5873;241;809;1088;3362;1329;4171
311660;201605;2439;7870;1843;6552;318;1173;159;475;477;1648
311670;201605;1660;4733;1337;4194;412;1415;406;1258;818;2673
311680;201605;2071;6459;1743;5913;369;1321;926;3156;1295;4477
311690;201605;489;1243;417;1156;32;94;334;945;366;1039
311700;201605;2189;5849;1793;5321;124;410;1359;3986;1483;4396
311710;201605;1644;4968;1211;4159;426;1642;280;918;706;2560
311720;201605;393;1296;354;1222;63;233;154;522;217;755
311730;201605;5813;14475;3363;10276;911;3210;634;1523;1545;4733
311740;201605;790;2359;749;2306;173;510;508;1605;681;2115
311750;201605;3998;12851;3470;12031;586;2362;1873;6357;2459;8719
311760;201605;699;2332;613;2138;136;529;155;460;291;989
311770;201605;2225;7030;1840;6308;418;1587;537;1767;955;3354
311780;201605;1124;3952;949;3575;263;1162;215;739;478;1901
311783;201605;1937;6354;1635;5765;93;474;1215;4216;1308;4690
311787;201605;591;2018;439;1574;79;313;105;312;184;625
311790;201605;1522;4474;1136;3746;237;897;373;1181;610;2078
311800;201605;4544;15141;3916;13636;815;3108;326;971;1141;4079
311810;201605;1065;3431;926;3173;68;325;580;1956;648;2281
311820;201605;613;1871;501;1623;125;450;240;720;365;1170
311830;201605;8179;27043;6692;23531;1979;7611;692;2214;2671;9825
311840;201605;2930;8792;2621;8333;666;2365;1244;3865;1910;6230
311850;201605;280;866;247;810;39;140;132;424;171;564
311860;201605;48224;141018;41049;128593;7804;26802;20042;60867;27846;87669
311870;201605;2114;6133;1570;5106;300;1111;486;1461;786;2572
311880;201605;6806;19349;6013;18370;672;1907;4306;13707;4978;15614
311890;201605;1465;4315;1181;3795;274;955;499;1575;773;2530
311900;201605;739;2209;647;2074;78;280;387;1263;465;1543
311910;201605;4244;12371;3475;11243;809;2818;1466;4765;2275;7583
311920;201605;1881;6156;1648;5730;189;721;1007;3503;1196;4224
311930;201605;3491;9872;2939;9012;1137;3629;731;2222;1868;5851
311940;201605;12361;36805;9921;31887;2293;8028;2232;6729;4525;14757
311950;201605;2200;6426;1802;5837;151;563;1266;4057;1417;4620
311960;201605;383;1187;342;1103;67;263;143;389;210;652
311970;201605;344;1187;288;1063;54;232;70;245;124;477
311980;201605;603;1677;409;1327;64;216;137;461;201;677
311990;201605;423;1225;344;1103;118;418;115;345;233;763
311995;201605;1174;3569;728;2509;44;165;67;167;111;332
312000;201605;607;1829;547;1739;68;231;335;1087;403;1318
312010;201605;879;2844;741;2551;120;460;292;961;412;1421
312015;201605;1358;4353;1212;4088;129;518;790;2624;919;3142
312020;201605;1073;3359;944;3152;192;679;435;1462;627;2141
312030;201605;1802;5201;1619;4974;91;324;1384;4238;1475;4562
312040;201605;738;2656;607;2314;130;536;116;430;246;966
312050;201605;1234;4303;1053;3877;244;1010;151;481;395;1491
312060;201605;748;2245;648;2096;179;629;295;917;474;1546
312070;201605;1024;3137;687;2409;150;573;236;811;386;1384
312080;201605;2629;7214;2101;6404;289;1057;1141;3244;1430;4301
312083;201605;889;2512;770;2338;93;311;553;1656;646;1967
312087;201605;2137;6495;1929;6196;199;712;1414;4606;1613;5318
312090;201605;8870;27167;7520;24884;2107;7351;2745;8953;4852;16304
312100;201605;1362;4529;1141;4186;241;1022;494;1768;735;2790
312110;201605;1031;3588;902;3312;262;1098;157;505;419;1603
312120;201605;713;2307;602;2084;128;535;210;631;338;1166
312125;201605;1087;3496;965;3269;209;695;516;1837;725;2532
312130;201605;855;2397;668;2042;90;302;243;702;333;1004
312140;201605;796;2531;693;2293;159;574;187;539;346;1113
312150;201605;499;1442;437;1321;20;73;282;810;302;883
312160;201605;7291;24393;6460;22693;1623;6278;2366;8150;3989;14428
312170;201605;913;2634;775;2407;64;216;490;1505;554;1721
312180;201605;1352;4140;1177;3793;247;857;463;1407;710;2264
312190;201605;584;1863;448;1596;147;574;60;215;207;789
312200;201605;4678;13376;3923;12185;711;2180;2143;6743;2854;8923
312210;201605;1074;2858;817;2480;198;677;367;1027;565;1704
312220;201605;1902;6355;1749;6188;171;515;1457;5409;1628;5924
312230;201605;12250;37399;9531;32247;3004;11276;1212;3955;4216;15231
312235;201605;1547;4621;1365;4350;157;599;956;3003;1113;3602
312240;201605;913;3048;736;2676;174;677;183;652;357;1329
312245;201605;2162;6434;1942;6147;97;343;1589;5027;1686;5370
312247;201605;781;2329;603;2023;163;591;249;854;412;1445
312250;201605;1175;3228;888;2736;155;552;355;1031;510;1583
312260;201605;890;2803;742;2555;123;492;450;1504;573;1996
312270;201605;634;1889;530;1690;61;259;259;756;320;1015
312280;201605;408;1355;362;1254;126;465;45;149;171;614
312290;201605;762;2488;701;2402;171;690;229;757;400;1447
312300;201605;874;2890;689;2454;167;645;62;167;229;812
312310;201605;847;3149;794;3042;219;934;305;1134;524;2068
312320;201605;1952;5575;1507;4724;388;1333;263;712;651;2045
312330;201605;984;2854;819;2623;129;494;574;1815;703;2309
312340;201605;310;832;263;758;39;139;157;409;196;548
312350;201605;284;723;250;683;23;76;204;535;227;611
312352;201605;1617;5087;1454;4846;287;1015;939;3206;1226;4221
312360;201605;3034;9632;2532;8636;533;2005;712;2413;1245;4418
312370;201605;1681;5254;1525;5006;475;1782;524;1607;999;3389
312380;201605;1877;5181;1661;4888;60;168;1408;4255;1468;4423
312385;201605;1304;3837;1121;3547;101;412;787;2414;888;2826
312390;201605;2046;6580;1650;5809;412;1552;281;900;693;2452
312400;201605;3127;9944;2610;8914;941;3326;612;2181;1553;5507
312410;201605;9596;31201;8541;29195;1829;6775;3604;12157;5433;18932
312420;201605;3849;11791;3642;11529;511;1610;2527;8181;3038;9791
312430;201605;7921;23320;6816;21363;949;2999;4265;13548;5214;16547
312440;201605;760;2358;633;2139;198;737;255;914;453;1651
312450;201605;1102;3615;850;3100;274;1043;236;893;510;1936
312460;201605;348;1045;310;1001;75;279;156;504;231;783
312470;201605;651;1766;421;1327;79;282;122;367;201;649
312480;201605;1193;3111;897;2788;194;672;487;1437;681;2109
312490;201605;1974;5173;1550;4547;217;710;874;2466;1091;3176
312500;201605;669;1994;583;1862;96;346;212;668;308;1014
312510;201605;3407;9855;2749;8529;398;1414;1351;3918;1749;5332
312520;201605;256;859;205;772;56;223;55;222;111;445
312530;201605;599;1768;534;1676;67;268;336;1028;403;1296
312540;201605;1433;4477;1097;3824;212;806;513;1780;725;2586
312550;201605;680;2065;584;1854;111;372;267;798;378;1170
312560;201605;2041;5378;1683;4927;78;300;1382;3993;1460;4293
312570;201605;2339;6900;1955;6251;528;1817;604;1910;1132;3727
312580;201605;520;1710;439;1534;63;259;162;548;225;807
312590;201605;1657;5457;1438;5000;242;1038;628;2030;870;3068
312595;201605;1908;6369;1708;5909;324;1146;915;3200;1239;4346
312600;201605;788;2543;607;2186;94;431;278;928;372;1359
312610;201605;7036;19640;5197;16327;1148;3969;995;2948;2143;6917
312620;201605;2183;6271;1686;5583;132;502;1242;4244;1374;4746
312630;201605;334;1077;287;993;78;305;104;337;182;642
312640;201605;536;1718;434;1507;90;329;124;398;214;727
312650;201605;2127;6190;1576;5108;142;521;914;2942;1056;3463
312660;201605;1392;3642;1122;3251;98;340;759;2165;857;2505
312670;201605;5529;16327;4691;15187;1260;4480;1643;5205;2903;9685
312675;201605;1233;3970;1050;3573;142;545;627;2119;769;2664
312680;201605;1469;4420;1252;4129;181;725;763;2417;944;3142
312690;201605;2123;5611;1726;5054;250;783;1063;3005;1313;3788
312695;201605;807;2840;771;2792;142;507;508;1920;650;2427
312700;201605;1854;5559;1474;4805;185;683;730;2326;915;3009
312705;201605;1248;3558;1049;3204;77;261;739;2222;816;2483
312707;201605;1536;4858;1207;4226;156;664;608;2032;764;2696
312710;201605;6759;16966;4426;13229;1185;3983;804;2320;1989;6303
312720;201605;753;2555;656;2358;152;606;237;807;389;1413
312730;201605;1884;4484;1308;3802;148;481;750;2177;898;2658
312733;201605;1627;4335;1228;3621;55;179;762;2204;817;2383
312735;201605;817;2233;708;2087;151;508;411;1145;562;1653
312737;201605;832;2096;608;1783;184;551;204;611;388;1162
312738;201605;508;1540;373;1275;89;344;113;352;202;696
312740;201605;381;953;232;780;68;254;58;182;126;436
312750;201605;1240;4386;1172;4272;226;979;567;1993;793;2972
312760;201605;1948;6228;1518;5355;351;1361;340;1175;691;2536
312770;201605;40269;109735;31111;94650;7762;25553;8187;24177;15949;49730
312780;201605;2637;9074;2350;8590;382;1551;1266;4743;1648;6294
312790;201605;318;808;190;592;36;135;52;124;88;259
312800;201605;4881;15774;3982;14003;1179;4506;906;3187;2085;7693
312810;201605;2045;6237;1428;5026;319;1206;240;793;559;1999
312820;201605;1857;5306;1629;4931;78;282;1145;3386;1223;3668
312825;201605;1323;3619;1149;3393;92;302;883;2609;975;2911
312830;201605;2528;7699;1762;6176;420;1599;275;955;695;2554
312840;201605;1210;3857;999;3451;150;591;311;974;461;1565
312850;201605;684;2127;542;1848;92;379;166;552;258;931
312860;201605;1132;3324;875;2872;231;840;236;697;467;1537
312870;201605;5550;17068;3921;13634;700;2669;755;2508;1455;5177
312880;201605;1262;3784;1123;3578;126;446;706;2317;832;2763
312890;201605;1654;5001;1083;3710;236;863;361;1257;597;2120
312900;201605;1202;3510;1054;3304;132;442;739;2372;871;2814
312910;201605;1642;3285;987;2444;150;416;460;1055;610;1471
312920;201605;867;2742;708;2444;177;698;272;878;449;1576
312930;201605;2115;6084;1843;5686;402;1284;877;2773;1279;4057
312940;201605;886;2879;774;2697;196;765;210;689;406;1454
312950;201605;3072;8579;2373;7542;796;2723;535;1707;1331;4430
312960;201605;1946;5587;1684;5250;180;527;1291;4181;1471;4708
312965;201605;1787;5658;1534;5209;184;755;929;3138;1113;3893
312970;201605;988;3279;815;2983;213;887;192;686;405;1573
312980;201605;16742;55762;15737;53727;4778;17851;5680;18752;10458;36603
312990;201605;460;1352;331;1135;96;377;100;346;196;723
313000;201605;498;1626;404;1440;93;444;162;491;255;935
313005;201605;2566;8209;2269;7668;475;1582;1208;4150;1683;5732
313010;201605;3542;11259;2986;10303;771;2880;1274;4318;2045;7198
313020;201605;942;3073;737;2554;143;572;136;378;279;950
313030;201605;1488;3967;1096;3427;212;802;486;1475;698;2277
313040;201605;816;2659;709;2412;100;417;294;914;394;1331
313050;201605;1780;5487;1330;4796;294;1194;334;1105;628;2299
313055;201605;1602;4997;1457;4796;68;246;1201;3991;1269;4237
313060;201605;743;2377;586;2012;150;538;60;177;210;715
313065;201605;1919;6172;1647;5748;303;1180;1064;3714;1367;4894
313070;201605;1034;2995;846;2671;178;644;356;1074;534;1718
313080;201605;444;1379;338;1165;71;286;98;290;169;576
313090;201605;5207;14908;4494;13762;1040;3396;2246;6916;3286;10312
313100;201605;1114;3355;1004;3180;87;272;780;2517;867;2789
313110;201605;1726;4890;1297;4070;194;694;562;1649;756;2343
313115;201605;2402;8039;2264;7755;510;1989;997;3180;1507;5169
313120;201605;3490;9171;2966;8489;645;2094;1669;4682;2314;6776
313130;201605;25287;75834;21946;69171;4627;16128;8529;25365;13156;41493
313140;201605;574;1483;443;1291;27;97;317;907;344;1004
313150;201605;1305;4117;1109;3775;488;1763;207;710;695;2473
313160;201605;937;2843;809;2589;127;460;446;1389;573;1849
313170;201605;7955;26603;6231;22577;1426;5463;1200;4287;2626;9750
313180;201605;2348;6379;1883;5731;439;1499;719;2121;1158;3620
313190;201605;3328;11200;2659;9544;566;2209;624;2100;1190;4309
313200;201605;1134;3685;985;3403;111;424;681;2323;792;2747
313210;201605;4148;12861;3456;11801;728;2706;1541;5103;2269;7809
313220;201605;1487;4367;1070;3510;246;900;233;638;479;1538
313230;201605;2273;8006;2109;7787;292;1168;1480;5457;1772;6625
313240;201605;7931;24018;6197;20806;1179;4549;2278;7267;3457;11816
313250;201605;6858;21386;5941;19820;740;2583;3387;11365;4127;13948
313260;201605;610;1792;435;1419;65;237;103;331;168;568
313270;201605;5335;15844;4433;14324;817;2853;2288;7310;3105;10163
313280;201605;377;1242;277;1026;53;217;59;199;112;416
313290;201605;810;2829;666;2573;239;1038;94;323;333;1361
313300;201605;1798;5914;1481;5174;401;1537;190;564;591;2101
313310;201605;1047;3598;938;3367;202;842;177;566;379;1408
313320;201605;2303;6554;1716;5620;297;1083;722;2375;1019;3458
313330;201605;3950;12116;3292;10984;356;1453;1949;6319;2305;7772
313340;201605;1887;4650;1493;4073;269;734;798;2191;1067;2925
313350;201605;2877;8908;2306;7681;451;1675;451;1374;902;3049
313360;201605;1241;3535;946;3058;217;858;489;1493;706;2351
313370;201605;1152;3873;1085;3698;164;668;557;1775;721;2443
313375;201605;2292;5929;1578;4883;282;1077;490;1453;772;2530
313380;201605;4876;15055;4114;13542;1029;3729;1285;3960;2314;7689
313390;201605;860;2943;814;2879;86;342;550;1932;636;2274
313400;201605;3657;9909;3184;9362;268;728;2683;8095;2951;8823
313410;201605;1214;3446;1019;3145;235;789;548;1658;783;2447
313420;201605;18670;44270;11583;32572;2111;6705;1770;4934;3881;11639
313430;201605;1034;3206;789;2698;143;581;287;899;430;1480
313440;201605;6221;14007;4266;11738;252;669;2795;7896;3047;8565
313450;201605;624;1853;507;1630;102;377;154;462;256;839
313460;201605;2109;7132;1816;6628;464;1971;586;1921;1050;3892
313470;201605;3085;8469;2731;7972;375;1144;1812;5233;2187;6377
313480;201605;1040;2962;803;2583;113;426;281;834;394;1260
313490;201605;1491;4332;864;3315;248;1050;84;304;332;1354
313500;201605;399;1297;329;1122;56;209;104;350;160;559
313505;201605;9050;26342;8328;25524;332;710;7632;23938;7964;24648
313507;201605;1379;3774;1187;3494;104;338;794;2353;898;2691
313510;201605;15217;43479;13281;40638;1894;6026;7404;22860;9298;28886
313520;201605;14123;43271;11870;39234;1309;4865;7464;24508;8773;29373
313530;201605;597;1814;496;1638;41;161;174;547;215;708
313535;201605;2465;7313;2230;6885;170;579;1644;5026;1814;5605
313540;201605;1065;3311;795;2625;202;734;180;550;382;1284
313545;201605;1273;4629;1140;4366;166;779;650;2344;816;3123
313550;201605;1791;5724;1575;5304;378;1303;694;2315;1072;3618
313560;201605;2178;5063;1792;4626;231;566;1295;3455;1526;4021
313570;201605;862;2977;741;2743;227;915;228;822;455;1737
313580;201605;5705;16312;4542;14640;750;2606;2527;8271;3277;10877
313590;201605;973;2743;760;2447;349;1243;148;434;497;1677
313600;201605;3774;11287;3245;10444;375;1328;2211;7135;2586;8463
313610;201605;964;2887;824;2623;161;573;411;1275;572;1848
313620;201605;5352;16423;4645;15162;1239;4299;1577;5169;2816;9468
313630;201605;8033;22296;6048;19477;1029;3782;2705;9219;3734;13001
313640;201605;762;2204;573;1914;177;653;161;526;338;1179
313650;201605;1913;6282;1689;5911;260;1052;1077;3686;1337;4738
313652;201605;928;3249;850;3106;132;566;518;1830;650;2396
313655;201605;928;2955;776;2701;98;406;475;1622;573;2028
313657;201605;1332;3936;1091;3573;101;462;797;2438;898;2900
313660;201605;806;2639;711;2466;152;617;319;1047;471;1664
313665;201605;3664;11704;3146;10617;647;2438;1392;4520;2039;6958
313670;201605;44106;128507;32708;106605;7458;26720;9766;31077;17224;57797
313680;201605;1046;3104;930;2915;138;530;559;1708;697;2238
313690;201605;835;3004;734;2768;169;649;260;1004;429;1653
313695;201605;1334;4323;1144;3970;103;414;793;2767;896;3181
313700;201605;3440;11760;3021;11226;465;1770;2125;8100;2590;9870
313710;201605;1320;3529;1011;3063;173;575;531;1577;704;2152
313720;201605;5231;16555;4189;14321;778;2932;1348;4299;2126;7231
313730;201605;1277;3399;975;3022;152;523;557;1734;709;2257
313740;201605;2023;7274;1724;6568;475;2039;118;381;593;2420
313750;201605;2172;6548;1826;5890;469;1618;545;1606;1014;3224
313753;201605;1802;5167;1435;4560;278;1005;642;2011;920;3016
313760;201605;4194;13447;3460;12003;942;3533;919;2988;1861;6521
313770;201605;3262;10463;2865;9867;834;3108;1232;4234;2066;7342
313780;201605;3878;10632;3047;9412;451;1653;1246;3898;1697;5551
313790;201605;481;1667;454;1620;95;340;252;932;347;1272
313800;201605;1239;3325;1059;3056;97;321;725;2122;822;2443
313810;201605;1527;4361;1389;4167;82;220;1153;3586;1235;3806
313820;201605;12679;33603;10374;30066;1739;5777;4577;12769;6316;18546
313830;201605;419;1375;354;1246;89;361;130;457;219;818
313835;201605;882;2948;815;2844;143;584;444;1489;587;2073
313840;201605;7453;21332;5886;18696;1417;4946;1325;4105;2742;9051
313850;201605;1164;3143;1016;2883;180;616;521;1349;701;1965
313860;201605;2692;8111;2055;6752;454;1591;485;1516;939;3107
313862;201605;1216;3043;856;2463;107;297;446;1373;553;1670
313865;201605;2244;6890;2022;6557;183;694;1505;4842;1688;5536
313867;201605;1097;3753;949;3432;270;1057;265;995;535;2052
313868;201605;1617;5399;1384;4924;112;511;941;3263;1053;3774
313870;201605;773;2423;705;2310;199;740;195;557;394;1297
313880;201605;1397;4316;1195;3988;270;1004;528;1613;798;2617
313890;201605;1852;4987;1524;4556;302;856;902;2899;1204;3755
313900;201605;3924;14054;3501;13117;1030;4321;934;3442;1964;7763
313910;201605;729;2436;614;2213;206;802;66;225;272;1027
313920;201605;3277;10876;2842;10064;472;1752;1559;5706;2031;7458
313925;201605;1848;5006;1393;4172;72;237;845;2539;917;2776
313930;201605;6374;23243;5396;21498;739;2733;3345;14467;4084;17200
313940;201605;8452;27730;6996;25430;1920;7852;2102;8095;4022;15947
313950;201605;4069;11511;3134;10009;954;3508;968;2778;1922;6286
313960;201605;5427;13842;3909;11682;1036;3374;1007;2837;2043;6211
313970;201605;1431;4102;1252;3898;135;473;767;2512;902;2985
313980;201605;1239;3800;961;3327;238;938;400;1384;638;2322
313990;201605;1748;6437;1499;5850;473;2025;284;976;757;3001
314000;201605;7941;25109;7169;23613;1202;4715;4132;13044;5334;17759
314010;201605;1148;3175;950;2922;87;313;612;1816;699;2129
314015;201605;1305;4401;1083;3997;257;1067;398;1415;655;2482
314020;201605;502;1516;362;1228;88;333;72;225;160;558
314030;201605;827;2682;667;2322;101;389;244;832;345;1221
314040;201605;684;1945;570;1743;242;787;121;345;363;1132
314050;201605;1697;5234;1359;4566;286;1117;490;1526;776;2643
314053;201605;1576;4923;1385;4669;203;684;883;3146;1086;3830
314055;201605;2171;6438;1893;6031;75;300;1506;4832;1581;5132
314060;201605;1158;3549;919;3143;62;280;598;1997;660;2277
314070;201605;4100;12664;3237;10975;804;2895;684;2203;1488;5098
314080;201605;1872;5831;1314;4557;213;847;265;800;478;1647
314085;201605;1961;6524;1726;6196;441;1715;653;2350;1094;4065
314090;201605;3266;11201;2878;10439;643;2653;983;3665;1626;6318
314100;201605;3282;8345;2891;7832;172;375;2458;6908;2630;7283
314110;201605;3953;12525;3498;11609;644;2464;1462;4457;2106;6921
314120;201605;1049;2502;520;1655;106;370;124;392;230;762
314130;201605;718;2056;376;1274;48;182;68;211;116;393
314140;201605;4865;15018;4037;13408;852;3077;1757;5805;2609;8882
314150;201605;1560;4240;1248;3702;177;564;636;1864;813;2428
314160;201605;2544;6515;2000;5801;181;578;1208;3716;1389;4294
314170;201605;1074;3195;888;2811;101;338;482;1479;583;1817
314180;201605;5207;16508;4613;15540;1260;4544;1829;6279;3089;10823
314190;201605;714;2024;547;1758;126;501;198;560;324;1061
314200;201605;2948;9102;2567;8422;258;995;1760;5672;2018;6667
314210;201605;1967;5697;1752;5342;192;706;1091;3212;1283;3918
314220;201605;1582;4895;1219;4206;369;1401;217;644;586;2045
314225;201605;1339;3845;1225;3702;85;259;1010;3119;1095;3378
314230;201605;660;2125;611;2045;118;449;308;1016;426;1465
314240;201605;1115;3365;936;3102;143;499;515;1803;658;2302
314250;201605;554;1639;424;1370;90;328;123;354;213;682
314260;201605;1024;3618;913;3372;215;879;276;984;491;1863
314270;201605;2862;9253;2383;8394;217;878;1567;5544;1784;6422
314280;201605;3096;8475;2115;6613;489;1779;649;1763;1138;3542
314290;201605;4749;13075;4072;11979;956;2920;2142;6230;3098;9150
314300;201605;1500;4955;1272;4441;349;1279;354;1207;703;2486
314310;201605;5368;15819;4593;14441;1177;4015;1660;5027;2837;9042
314315;201605;804;3135;731;2991;68;348;497;2010;565;2358
314320;201605;2968;8259;2122;7081;536;1959;997;3425;1533;5384
314330;201605;53838;160985;46037;148533;12708;44079;14351;45752;27059;89831
314340;201605;2911;7845;1695;5508;331;1193;127;266;458;1459
314345;201605;1208;4075;1089;3879;244;904;639;2283;883;3187
314350;201605;1288;3717;1001;3251;304;1061;178;538;482;1599
314360;201605;668;2134;455;1638;93;383;89;332;182;715
314370;201605;550;1835;511;1781;118;458;326;1119;444;1577
314380;201605;1286;3837;896;3073;234;879;115;388;349;1267
314390;201605;13630;39199;10260;33036;2389;8343;2362;7091;4751;15434
314400;201605;4426;12959;3736;12004;1305;4388;1154;3879;2459;8267
314410;201605;2619;8074;2086;7056;572;2150;610;2074;1182;4224
314420;201605;753;2125;587;1880;28;147;406;1233;434;1380
314430;201605;6345;18882;5507;17334;1534;5277;1555;4976;3089;10253
314435;201605;1315;4205;1154;3928;102;435;759;2559;861;2994
314437;201605;1077;2799;889;2512;31;91;700;1985;731;2076
314440;201605;637;1850;499;1658;163;619;94;258;257;877
314450;201605;1592;4632;1335;4268;290;1091;616;1836;906;2927
314460;201605;4067;13558;3294;11903;764;3065;574;1979;1338;5044
314465;201605;2244;7037;2097;6781;109;511;1641;5157;1750;5668
314467;201605;995;2840;834;2562;59;177;600;1872;659;2049
314470;201605;2247;6969;1887;6256;344;1374;695;2083;1039;3457
314480;201605;5866;19353;4226;15106;621;2413;461;1456;1082;3869
314490;201605;892;2640;694;2242;158;560;307;939;465;1499
314500;201605;1973;5575;1465;4677;318;1072;473;1441;791;2513
314505;201605;1765;5144;1616;4941;218;750;1084;3345;1302;4095
314510;201605;1874;5042;1272;4207;392;1440;288;948;680;2388
314520;201605;2927;10475;2237;8853;454;2015;237;833;691;2848
314530;201605;5929;20852;5597;20270;1052;3634;3311;12557;4363;16191
314535;201605;2750;7596;2319;6997;215;732;1719;5186;1934;5918
314537;201605;1128;3557;904;3153;116;490;537;1829;653;2319
314540;201605;417;1246;345;1099;68;249;108;320;176;569
314545;201605;1403;4238;1215;3970;111;409;902;2997;1013;3406
314550;201605;618;1677;460;1452;87;362;170;470;257;832
314560;201605;4347;14835;3690;13308;669;2722;1085;3712;1754;6434
314570;201605;295;868;227;741;57;200;98;306;155;506
314580;201605;523;1726;413;1504;97;419;50;172;147;591
314585;201605;832;2688;608;2208;136;575;149;507;285;1082
314587;201605;1946;5889;1665;5410;332;1040;814;2722;1146;3762
314590;201605;3169;10669;2360;8606;442;1840;293;962;735;2802
314600;201605;1723;5622;1277;4683;288;1158;160;507;448;1665
314610;201605;6888;23215;6188;21601;1340;5224;2561;8464;3901;13688
314620;201605;1585;4719;1422;4484;132;429;1067;3365;1199;3794
314625;201605;1437;4854;1320;4655;176;793;904;3040;1080;3833
314630;201605;4798;14229;4190;13290;276;1107;3057;9627;3333;10734
314640;201605;578;1567;450;1351;111;365;123;307;234;672
314650;201605;1066;2960;765;2467;102;401;268;784;370;1185
314655;201605;1559;4628;1170;3880;301;968;422;1436;723;2404
314660;201605;289;780;208;614;23;70;102;288;125;358
314670;201605;1634;4330;1176;3537;175;588;658;1935;833;2523
314675;201605;1769;5333;1524;4893;153;561;1058;3368;1211;3929
314690;201605;2328;7404;1909;6677;523;2072;402;1349;925;3421
314700;201605;8886;29934;6484;24552;1797;7658;804;2946;2601;10604
314710;201605;8810;26481;6226;20974;1165;4412;826;2510;1991;6922
314720;201605;2414;7835;1969;6887;482;1891;565;1993;1047;3884
314730;201605;2211;6604;1815;6003;476;1760;680;2164;1156;3924
314740;201605;2858;9074;2466;8321;407;1575;1140;3693;1547;5268
314750;201605;348;1079;278;918;47;179;116;360;163;539
314760;201605;1727;5699;1298;4660;205;863;248;749;453;1612
314770;201605;1098;3402;632;2132;71;274;98;259;169;533
314780;201605;273;737;205;643;50;195;92;269;142;464
314790;201605;11058;32804;8480;28328;3295;12383;645;1704;3940;14087
314795;201605;1661;4741;1407;4346;94;375;1021;3041;1115;3416
314800;201605;10991;31692;7754;25330;2063;7342;832;2555;2895;9897
314810;201605;11610;33489;8934;28838;2506;8874;1701;5492;4207;14366
314820;201605;921;2545;648;2090;160;569;224;713;384;1282
314830;201605;1631;5361;1438;5044;415;1611;586;2068;1001;3679
314840;201605;925;3293;764;3060;125;644;458;1757;583;2401
314850;201605;1901;5426;1526;4763;184;714;1000;3010;1184;3724
314860;201605;3224;10662;2853;9986;612;2416;1405;4794;2017;7210
314870;201605;5509;17172;4713;16116;443;1907;3418;11619;3861;13526
314875;201605;1763;5693;1686;5588;212;672;1353;4575;1565;5247
314880;201605;879;2353;724;2154;37;96;535;1695;572;1791
314890;201605;609;1815;420;1404;75;301;146;436;221;737
314900;201605;527;1566;435;1432;87;307;221;708;308;1015
314910;201605;1672;5407;1348;4867;401;1645;409;1371;810;3016
314915;201605;2495;7861;2177;7328;166;680;1572;5185;1738;5865
314920;201605;556;1526;397;1290;37;142;213;636;250;778
314930;201605;4537;15138;3958;13913;1023;3854;971;3241;1994;7095
314940;201605;398;1164;366;1113;60;202;211;607;271;809
314950;201605;336;973;250;847;42;158;68;217;110;375
314960;201605;734;2251;574;1929;136;511;162;492;298;1003
314970;201605;544;1863;455;1689;106;431;117;445;223;876
314980;201605;1468;4524;1222;4114;331;1257;85;262;416;1519
314990;201605;2573;8054;1957;6721;507;2004;358;1037;865;3041
314995;201605;1597;4837;1390;4521;139;552;907;2892;1046;3444
315000;201605;1065;3019;873;2713;90;317;552;1707;642;2024
315010;201605;439;1328;344;1143;80;335;113;322;193;657
315015;201605;2093;6360;1885;6118;243;810;1365;4664;1608;5474
315020;201605;811;2512;614;2097;95;363;248;799;343;1162
315030;201605;684;2031;550;1804;146;518;111;344;257;862
315040;201605;893;2726;838;2629;140;456;524;1631;664;2087
315050;201605;1360;3907;1102;3509;212;773;487;1542;699;2315
315053;201605;1040;3088;936;2911;143;559;444;1393;587;1952
315057;201605;1690;5719;1486;5389;246;912;838;3099;1084;4011
315060;201605;832;2703;604;2196;120;479;85;300;205;779
315070;201605;740;2215;622;2023;175;615;281;868;456;1483
315080;201605;2847;9374;2453;8509;617;2304;1018;3496;1635;5800
315090;201605;784;2752;660;2460;144;608;159;567;303;1175
315100;201605;1169;3892;851;3157;186;801;197;657;383;1458
315110;201605;1412;4245;1195;3847;276;967;415;1307;691;2274
315120;201605;14296;33343;9842;27648;1432;4209;4951;14860;6383;19069
315130;201605;1386;4566;1262;4339;329;1278;399;1332;728;2610
315140;201605;2733;8578;2224;7560;483;1904;740;2286;1223;4190
315150;201605;4610;12462;3503;10639;653;2226;1304;3915;1957;6141
315160;201605;1222;3540;996;3105;214;712;392;1190;606;1902
315170;201605;1521;4577;1200;3996;268;976;304;1067;572;2043
315180;201605;16843;47149;9823;32425;1675;6234;1595;4871;3270;11105
315190;201605;2025;5244;1690;4731;421;1223;908;2540;1329;3763
315200;201605;3843;12806;3175;11396;1000;3899;618;2188;1618;6087
315210;201605;7745;22742;6234;19668;1184;4203;2237;6728;3421;10931
315213;201605;1078;3411;1004;3309;50;185;818;2700;868;2885
315217;201605;2410;8265;2011;7537;223;1032;1176;4333;1399;5365
315220;201605;9788;28034;8235;25563;2397;7441;3204;10545;5601;17986
315230;201605;2928;7786;2646;7458;168;242;2267;6872;2435;7114
315240;201605;3034;9258;2572;8522;703;2540;1176;3783;1879;6323
315250;201605;10076;30570;7786;26227;1855;6921;2209;7373;4064;14294
315260;201605;1001;3092;688;2417;141;537;92;286;233;823
315270;201605;715;2295;558;1994;108;438;118;378;226;816
315280;201605;3054;8711;1960;6377;412;1430;299;905;711;2335
315290;201605;1349;3745;975;3144;289;1015;177;573;466;1588
315300;201605;524;1360;348;1141;144;495;126;427;270;922
315310;201605;1245;3948;1029;3560;136;561;641;2116;777;2677
315320;201605;776;2325;617;2120;106;427;279;962;385;1389
315330;201605;724;2605;468;1925;114;514;53;218;167;732
315340;201605;3546;10133;2887;9157;601;2075;1134;3487;1735;5562
315350;201605;1867;5098;1395;4407;237;811;800;2583;1037;3394
315360;201605;1675;5528;1387;4881;258;1010;445;1478;703;2488
315370;201605;496;1508;428;1402;79;266;217;735;296;1001
315380;201605;202;690;159;586;36;161;36;107;72;268
315390;201605;1314;4338;985;3565;223;913;168;556;391;1469
315400;201605;4217;12677;3454;11227;708;2520;1513;4834;2221;7354
315410;201605;2079;5424;1740;4960;166;572;1228;3525;1394;4097
315415;201605;1002;3253;896;3088;354;1282;322;1136;676;2418
315420;201605;1232;3917;971;3399;226;829;133;440;359;1269
315430;201605;3628;9803;2738;8370;728;2482;584;1689;1312;4171
315440;201605;919;2824;794;2616;166;623;343;1063;509;1686
315445;201605;2082;5823;1638;5137;183;636;1125;3521;1308;4157
315450;201605;2396;7505;2137;7104;408;1287;1276;4394;1684;5681
315460;201605;32557;105683;28929;98313;9618;34846;4948;16136;14566;50982
315470;201605;469;1411;386;1257;47;190;199;627;246;817
315480;201605;1723;5244;1154;3943;199;750;189;662;388;1412
315490;201605;3072;8206;2355;7260;355;1239;891;2629;1246;3868
315500;201605;497;1457;334;1088;40;149;132;378;172;527
315510;201605;1377;3923;1160;3584;108;355;812;2458;920;2813
315520;201605;1016;3054;836;2764;113;408;515;1650;628;2058
315530;201605;601;2014;496;1760;176;663;131;432;307;1095
315540;201605;1095;3414;904;3053;175;703;312;1046;487;1749
315550;201605;1714;4787;1337;4245;325;1139;405;1250;730;2389
315560;201605;6481;21505;5841;20598;558;2216;3943;14091;4501;16307
315570;201605;1926;6081;1786;5860;278;1062;978;3125;1256;4187
315580;201605;2493;7258;1952;6294;485;1794;512;1548;997;3342
315590;201605;862;2519;766;2377;119;403;414;1265;533;1668
315600;201605;2458;8668;1972;7735;346;1407;1009;4136;1355;5543
315610;201605;992;2815;804;2438;148;575;311;790;459;1365
315620;201605;317;1114;300;1085;88;302;166;636;254;938
315630;201605;875;2789;727;2482;167;589;151;487;318;1076
315640;201605;482;1386;394;1248;77;297;168;490;245;787
315645;201605;866;2608;700;2255;253;877;158;486;411;1363
315650;201605;1819;5011;1442;4471;85;368;1059;3262;1144;3630
315660;201605;2550;6611;2089;5898;279;784;1367;3843;1646;4627
315670;201605;10460;34287;9310;32099;2558;9489;3263;11043;5821;20532
315680;201605;3006;9958;2345;8623;722;2807;534;1972;1256;4779
315690;201605;3350;9448;2317;7618;553;1998;407;1433;960;3431
315700;201605;7208;22356;6083;20141;1051;3854;2747;8726;3798;12580
315710;201605;1796;5159;1420;4559;109;460;921;2854;1030;3314
315720;201605;3613;11353;3194;10579;382;1509;1786;5654;2168;7163
315725;201605;1448;4564;1299;4337;254;889;828;2811;1082;3700
315727;201605;592;1822;489;1614;100;377;179;556;279;933
315730;201605;790;2449;726;2321;104;376;402;1255;506;1631
315733;201605;987;2954;873;2755;261;901;265;771;526;1672
315737;201605;1248;3803;972;3308;69;304;613;2122;682;2426
315740;201605;994;3033;833;2713;147;584;431;1297;578;1881
315750;201605;1108;3423;1009;3245;58;230;738;2360;796;2590
315760;201605;1034;2740;995;2691;15;54;925;2480;940;2534
315765;201605;1459;4526;1301;4320;60;237;1058;3577;1118;3814
315770;201605;1405;4492;1210;4154;317;1194;295;1009;612;2203
315780;201605;21780;70690;19660;66161;4661;16899;6100;20249;10761;37148
315790;201605;3599;11837;3140;10925;286;959;2100;7529;2386;8488
315800;201605;1446;5588;1148;4723;258;1153;167;659;425;1812
315810;201605;1354;3642;1140;3315;186;536;690;1975;876;2511
315820;201605;2436;8166;2123;7624;673;2493;819;3060;1492;5553
315830;201605;1192;3917;1000;3528;126;538;301;944;427;1482
315840;201605;846;2210;588;1757;98;336;154;419;252;755
315850;201605;1005;3532;977;3480;235;935;521;1764;756;2699
315860;201605;513;1741;385;1468;89;402;68;226;157;628
315870;201605;454;1332;371;1201;81;292;164;506;245;798
315880;201605;1199;3073;952;2766;212;765;319;846;531;1611
315890;201605;1469;4996;1304;4721;486;1885;492;1753;978;3638
315895;201605;5196;16121;4480;14552;968;3410;1518;4668;2486;8078
315900;201605;738;2200;705;2144;64;264;557;1600;621;1864
315910;201605;505;1695;470;1636;142;556;267;890;409;1446
315920;201605;1574;4326;917;2928;179;632;150;391;329;1023
315930;201605;1069;2876;796;2403;193;644;193;565;386;1209
315935;201605;935;3099;837;2893;226;863;206;675;432;1538
315940;201605;620;1959;537;1789;112;429;251;808;363;1237
315950;201605;1182;3601;1058;3371;234;703;609;2013;843;2716
315960;201605;3461;10846;2371;8653;809;3428;105;228;914;3656
315970;201605;737;2005;565;1775;44;119;393;1301;437;1420
315980;201605;3985;9697;2471;7179;615;2014;562;1387;1177;3401
315990;201605;3982;11439;3284;10278;543;2040;1608;4876;2151;6916
316000;201605;563;1674;474;1553;138;558;182;564;320;1122
316010;201605;616;2029;496;1802;63;269;219;735;282;1004
316020;201605;1034;3263;902;3056;113;452;596;1955;709;2407
316030;201605;3134;9151;2315;7677;188;745;1400;4718;1588;5463
316040;201605;3447;10843;2630;9140;408;1646;475;1382;883;3028
316045;201605;2040;6336;1872;6054;239;754;1298;4334;1537;5088
316050;201605;349;1101;279;991;53;216;124;407;177;623
316060;201605;728;2184;582;1976;80;347;334;1058;414;1405
316070;201605;6091;18962;5247;17133;1136;4153;2075;6451;3211;10604
316080;201605;730;2665;647;2464;142;621;71;278;213;899
316090;201605;563;1674;376;1275;68;262;98;312;166;574
316095;201605;1436;4543;1239;4199;181;617;772;2632;953;3249
316100;201605;2755;9051;2100;7456;497;1974;396;1274;893;3248
316105;201605;936;2667;708;2287;178;599;260;868;438;1467
316110;201605;12225;41202;10850;38884;1266;4826;7083;26187;8349;31013
316120;201605;1134;3626;914;3109;218;777;227;667;445;1444
316130;201605;1500;3394;940;2622;127;418;397;1048;524;1466
316140;201605;943;2750;745;2443;101;333;424;1425;525;1758
316150;201605;1508;4087;1315;3752;185;619;786;2222;971;2841
316160;201605;1236;3608;949;3069;175;625;388;1229;563;1854
316165;201605;922;2440;770;2224;142;475;408;1173;550;1648
316170;201605;1334;3820;999;3258;156;589;424;1254;580;1843
316180;201605;1388;4326;986;3430;196;775;174;519;370;1294
316190;201605;2799;8668;1497;5282;268;920;217;670;485;1590
316200;201605;3838;12093;2959;10368;623;2502;705;2378;1328;4880
316210;201605;4608;14733;3901;13356;1414;5119;514;1780;1928;6899
316220;201605;787;2435;562;1998;107;434;65;249;172;683
316225;201605;1199;3290;996;2975;134;441;605;1749;739;2190
316230;201605;411;1172;337;1043;52;182;158;524;210;706
316240;201605;6594;20057;5742;18919;623;2047;4170;13925;4793;15972
316245;201605;3209;11016;2953;10595;207;1033;2315;8084;2522;9117
316250;201605;10597;30454;8246;25890;2078;7091;1957;5868;4035;12959
316255;201605;2556;7637;2233;7244;362;1289;1489;4858;1851;6147
316257;201605;1344;3691;1006;3084;168;583;353;1015;521;1598
316260;201605;1776;5005;1404;4447;84;301;788;2653;872;2954
316265;201605;1320;3725;977;3059;102;372;569;1741;671;2113
316270;201605;3950;13127;3626;12475;903;3373;1420;4746;2323;8119
316280;201605;3174;10263;2883;9726;435;1654;1610;5318;2045;6972
316290;201605;3368;10459;2857;9479;517;2023;1154;3705;1671;5728
316292;201605;3379;10675;2994;10057;549;2065;1700;5482;2249;7547
316294;201605;841;2693;628;2248;114;487;54;186;168;673
316295;201605;1777;5864;1659;5640;204;857;1083;3554;1287;4411
316300;201605;1007;3107;854;2855;62;229;553;1881;615;2110
316310;201605;706;2027;477;1612;85;341;139;437;224;778
316320;201605;610;1916;487;1688;88;370;84;251;172;621
316330;201605;932;2874;733;2421;77;287;470;1519;547;1806
316340;201605;930;2993;756;2632;165;688;329;1065;494;1753
316350;201605;1302;4115;1163;3889;190;662;647;2205;837;2867
316360;201605;735;1952;581;1729;66;208;410;1231;476;1439
316370;201605;4473;14369;3852;13138;1055;3945;544;1818;1599;5763
316380;201605;1605;4209;1267;3742;78;261;896;2672;974;2933
316390;201605;888;2567;744;2346;180;617;299;974;479;1591
316400;201605;1283;3931;986;3411;218;818;373;1256;591;2074
316410;201605;1053;3469;969;3346;181;669;611;2112;792;2781
316420;201605;1925;6133;1701;5840;129;559;1220;4069;1349;4628
316430;201605;947;2872;678;2325;162;607;137;427;299;1034
316440;201605;672;2194;556;2021;193;807;107;396;300;1203
316443;201605;684;2016;564;1805;118;446;217;645;335;1091
316447;201605;1571;4673;1428;4486;97;324;1207;3815;1304;4139
316450;201605;2094;7039;1781;6438;205;843;1195;4327;1400;5170
316460;201605;724;2239;655;2117;175;592;325;1032;500;1624
316470;201605;7198;23021;5746;20005;1443;5791;1476;4958;2919;10749
316480;201605;181;607;160;563;30;111;46;151;76;262
316490;201605;299;928;241;789;50;162;90;272;140;434
316500;201605;1137;4003;776;2936;139;561;33;122;172;683
316510;201605;752;2758;670;2591;231;949;159;605;390;1554
316520;201605;1062;3198;855;2876;148;542;280;851;428;1393
316530;201605;1026;3326;871;3032;181;778;297;866;478;1644
316540;201605;744;2390;670;2266;97;409;235;744;332;1153
316550;201605;1171;3917;1095;3791;215;841;649;2259;864;3100
316553;201605;1868;6504;1468;5522;396;1677;304;1089;700;2766
316555;201605;2785;9610;2485;9237;167;690;1900;7215;2067;7905
316556;201605;634;1617;490;1392;48;164;324;875;372;1039
316557;201605;785;2816;743;2748;273;1077;188;626;461;1703
316560;201605;311;1097;266;1000;63;286;54;186;117;472
316570;201605;1241;3939;1091;3660;125;441;546;1861;671;2302
316580;201605;295;807;198;618;43;159;47;134;90;293
316590;201605;1461;3942;1039;3238;225;751;469;1353;694;2104
316600;201605;1046;3387;929;3157;255;940;338;1123;593;2063
316610;201605;573;2082;503;1940;94;434;309;1156;403;1590
316620;201605;2138;6461;1826;5940;266;1036;1080;3445;1346;4481
316630;201605;1402;4680;1202;4246;476;1771;293;1063;769;2834
316640;201605;176;553;157;516;32;134;67;185;99;319
316650;201605;888;3230;789;3071;113;440;492;2013;605;2453
316660;201605;199;523;96;300;7;31;20;47;27;78
316670;201605;1862;5301;1509;4696;598;1987;289;857;887;2844
316680;201605;1935;5236;1563;4727;175;568;1104;3350;1279;3918
316690;201605;1147;3874;1023;3593;291;1156;296;1012;587;2168
316695;201605;1082;3386;936;3106;111;399;561;1853;672;2252
316700;201605;358;1082;323;1026;40;171;201;579;241;750
316710;201605;2898;10776;2483;9878;892;3711;566;2422;1458;6133
316720;201605;16064;51171;13207;45108;3457;12561;2834;9423;6291;21984
316730;201605;362;1112;314;1018;77;282;127;379;204;661
316740;201605;666;2246;606;2145;95;390;367;1308;462;1698
316750;201605;396;1324;331;1181;49;213;115;367;164;580
316760;201605;3429;11339;2963;10707;1554;5829;782;2912;2336;8741
316770;201605;1279;3609;1153;3447;86;326;929;2763;1015;3089
316780;201605;580;1906;514;1779;140;565;86;255;226;820
316790;201605;852;2432;638;2072;152;531;190;624;342;1155
316800;201605;5138;16810;4555;15684;836;3240;2279;7414;3115;10654
316805;201605;782;2012;753;1973;55;148;645;1749;700;1897
316810;201605;607;1851;507;1656;139;506;195;585;334;1091
316820;201605;392;1020;225;736;35;139;30;90;65;229
316830;201605;564;1929;537;1880;162;621;219;748;381;1369
316840;201605;2790;8520;2458;7913;530;1983;1071;3265;1601;5248
316850;201605;2018;5882;1674;5316;247;884;921;2903;1168;3787
316860;201605;17452;54845;14939;50240;3365;13014;5841;18770;9206;31784
316870;201605;5923;18977;4797;16399;1333;5000;704;2292;2037;7292
316880;201605;854;2591;739;2397;215;827;227;700;442;1527
316890;201605;1250;3062;995;2737;281;906;533;1366;814;2272
316900;201605;2530;7535;2006;6477;435;1580;601;1740;1036;3320
316905;201605;454;1510;393;1371;134;499;124;430;258;929
316910;201605;807;2520;589;2094;156;590;102;374;258;964
316920;201605;1586;4276;1140;3675;314;1149;384;1194;698;2343
316930;201605;8286;27952;6588;24279;1407;5672;790;2672;2197;8344
316935;201605;4940;14414;3356;11277;855;3173;628;2059;1483;5232
316940;201605;6892;22273;5622;19594;1202;4398;1109;3731;2311;8129
316950;201605;1533;4244;1288;3900;115;417;921;2740;1036;3157
316960;201605;4749;11993;3739;10602;687;2125;2039;5708;2726;7833
316970;201605;3208;10141;3025;9832;642;2419;1196;3586;1838;6005
316980;201605;937;2861;676;2355;204;797;97;329;301;1126
316990;201605;9639;30373;8076;26913;2352;8507;619;1942;2971;10449
317000;201605;2777;9382;2663;9254;333;1060;1951;7628;2284;8688
317005;201605;2537;7832;2244;7364;444;1467;1237;4115;1681;5582
317010;201605;30243;74847;18681;56895;4336;14860;3372;10951;7708;25811
317020;201605;61205;166499;36737;117301;6954;24426;6862;20255;13816;44681
317030;201605;708;2087;590;1904;57;239;357;1131;414;1370
317040;201605;10252;29534;8216;26020;2054;6983;2952;9349;5006;16332
317043;201605;707;1925;605;1793;86;245;375;1124;461;1369
317047;201605;1131;2986;830;2495;90;301;437;1321;527;1622
317050;201605;1490;5059;1161;4287;227;895;402;1380;629;2275
317052;201605;2285;7378;2098;7087;157;625;1543;5156;1700;5781
317057;201605;1677;4674;1273;3962;114;455;750;2250;864;2705
317060;201605;414;1198;272;885;58;208;74;218;132;426
317065;201605;1252;4020;1133;3831;110;481;832;2758;942;3239
317070;201605;9635;29692;6664;23055;1342;5212;823;2771;2165;7983
317075;201605;1076;3246;857;2784;200;688;182;566;382;1254
317080;201605;6151;16770;5199;15180;1534;4643;1505;4341;3039;8984
317090;201605;4783;15867;4447;15336;525;1828;3095;10869;3620;12697
317100;201605;2960;8047;2195;6764;665;2219;689;2052;1354;4271
317103;201605;1971;6704;1679;6160;240;1133;836;2961;1076;4094
317107;201605;1315;4018;1141;3669;161;633;719;2170;880;2803
317110;201605;651;1641;376;1174;65;251;127;412;192;663
317115;201605;1129;3518;963;3182;101;336;675;2261;776;2597
317120;201605;10549;34851;8620;30348;1931;7505;3058;10518;4989;18023
317130;201605;7333;21769;6127;19617;1255;4507;2471;7843;3726;12350
317140;201605;557;1779;514;1715;66;231;339;1153;405;1384
317150;201605;954;2639;825;2489;86;311;606;1779;692;2090
317160;201605;3484;9112;2620;7957;185;590;1823;5514;2008;6104
317170;201605;1902;5125;1482;4429;133;481;686;1885;819;2366
317180;201605;1777;5949;1444;5235;357;1362;342;1228;699;2590
317190;201605;1363;3872;1082;3472;118;409;716;2284;834;2693
317200;201605;4455;13864;3824;12594;967;3549;1144;3623;2111;7172
317210;201605;1027;3058;851;2820;139;579;482;1555;621;2134
317220;201605;276;958;263;939;81;320;105;349;186;669
320010;201605;4902;15305;4245;13974;731;2573;2186;7103;2917;9676
320013;201605;1828;5583;1364;4625;223;776;546;1936;769;2712
320016;201605;3074;8662;2642;8019;316;917;1857;5699;2173;6616
320020;201605;3825;11881;3259;10723;902;3209;998;3301;1900;6510
320030;201605;1717;5415;1352;4666;395;1445;400;1332;795;2777
320035;201605;1794;5280;1543;4902;514;1786;511;1527;1025;3313
320040;201605;3226;10363;2665;9240;561;2117;805;2747;1366;4864
320050;201605;1724;4659;1477;4212;317;977;649;1762;966;2739
320060;201605;11620;36477;8875;30301;1998;7405;2099;6786;4097;14191
320070;201605;1413;4534;1144;3942;259;971;272;848;531;1819
320080;201605;5670;16394;4375;13834;1009;3262;1250;4173;2259;7435
320090;201605;8009;23276;6348;19955;1700;5689;2107;6375;3807;12064
320100;201605;2765;8538;2206;7391;630;2197;679;2282;1309;4479
320110;201605;1266;3763;1102;3444;266;836;308;973;574;1809
320115;201605;1745;6202;1575;5891;854;3327;334;1317;1188;4644
320120;201605;16186;48562;12519;41573;3030;11024;3303;10991;6333;22015
320130;201605;35728;114088;32122;106924;6534;24261;14487;46620;21021;70881
320140;201605;3656;11531;2632;9215;649;2513;308;1070;957;3583
320150;201605;15818;43798;11545;35686;2732;9109;1431;4220;4163;13329
320160;201605;4863;15326;4205;13987;1038;3870;1345;4122;2383;7992
320170;201605;1715;5447;1394;4748;351;1268;498;1679;849;2947
320180;201605;745;2492;661;2341;257;944;148;554;405;1498
320190;201605;3637;12467;2886;10647;776;2992;461;1697;1237;4689
320200;201605;1022;3113;848;2815;225;814;256;889;481;1703
320210;201605;4709;13239;3996;11882;826;2769;1794;4954;2620;7723
320220;201605;2404;7411;1964;6548;506;1819;705;2391;1211;4210
320225;201605;1352;4555;1075;3902;371;1452;133;477;504;1929
320230;201605;4146;13320;3573;12350;1134;4189;1234;4359;2368;8548
320240;201605;12269;35928;9747;31385;2457;8607;2433;7822;4890;16429
320245;201605;3393;11544;3128;10907;1034;3827;724;2445;1758;6272
320250;201605;1826;5553;1290;4322;340;1310;208;592;548;1902
320255;201605;1755;5851;1533;5466;621;2381;486;1847;1107;4228
320260;201605;1064;3274;825;2738;206;733;212;620;418;1353
320265;201605;2375;7479;2060;7016;524;1847;1058;3729;1582;5576
320270;201605;2671;7865;1979;6535;435;1560;780;2597;1215;4157
320280;201605;6723;20385;5842;18617;1369;4811;1871;5512;3240;10323
320290;201605;1396;4548;1028;3660;308;1157;133;491;441;1648
320300;201605;4186;13919;3706;12858;1201;4438;763;2627;1964;7065
320305;201605;4404;14191;3798;12831;920;3386;1480;4796;2400;8182
320310;201605;1930;5742;1630;5141;399;1323;564;1731;963;3054
320313;201605;2210;6353;1528;4804;322;1202;264;729;586;1931
320316;201605;1733;5205;1410;4541;438;1488;390;1228;828;2716
320320;201605;20217;60749;15880;52797;4130;15106;4869;15791;8999;30897
320330;201605;2998;8837;2516;8030;683;2147;1056;3603;1739;5750
320332;201605;5084;16661;4441;15446;1567;5798;1291;4490;2858;10288
320334;201605;1888;5942;1321;4721;341;1371;229;784;570;2155
320335;201605;2359;6946;1493;4916;366;1325;162;453;528;1778
320340;201605;5904;15875;4904;14233;1045;3294;2082;6157;3127;9451
320350;201605;5139;13567;3855;11244;774;2373;1551;4455;2325;6828
320360;201605;1709;4510;1251;3631;210;655;455;1244;665;1899
320370;201605;2992;9705;2413;8393;677;2425;688;2381;1365;4806
320380;201605;2203;6464;1942;6003;387;1315;1042;3122;1429;4437
320390;201605;7299;21928;5939;19084;1680;5828;1508;4620;3188;10448
320400;201605;3528;10848;3150;10185;852;3052;1152;3539;2004;6591
320405;201605;4072;11951;3553;11095;817;2711;1770;5436;2587;8147
320410;201605;5507;14521;4052;12585;977;3273;1732;5413;2709;8686
320420;201605;2153;6508;1691;5675;497;1868;381;1268;878;3136
320425;201605;1942;5180;1610;4625;178;548;990;2787;1168;3335
320430;201605;2412;6705;2079;6044;404;1250;1084;3036;1488;4286
320435;201605;2817;9157;2321;8147;1085;3961;556;2071;1641;6032
320440;201605;1049;3467;924;3148;200;768;295;948;495;1716
320450;201605;1979;6181;1613;5461;432;1611;621;2022;1053;3633
320455;201605;4105;13445;3049;10907;849;3265;616;2115;1465;5380
320460;201605;2640;8441;2027;7063;498;1860;485;1625;983;3485
320465;201605;1612;5006;1231;4167;214;787;545;1834;759;2621
320470;201605;4394;13192;3025;10107;828;3085;444;1366;1272;4451
320480;201605;1773;5506;1560;5103;411;1469;519;1636;930;3105
320490;201605;15905;48428;13327;43761;3823;13793;3701;12077;7524;25870
320495;201605;1296;3751;859;2849;263;932;92;322;355;1254
320500;201605;47054;141255;40902;130214;9466;32624;18465;57450;27931;90074
320501;201605;4312;13448;3649;12447;1194;4562;1084;3538;2278;8100
320503;201605;1836;6229;1480;5461;582;2353;354;1181;936;3534
320506;201605;3950;12178;2821;9502;804;2929;174;492;978;3421
320510;201605;8202;25471;7078;23319;1617;5757;3171;10314;4788;16071
320515;201605;1867;5375;1529;4632;387;1223;248;695;635;1918
320517;201605;2156;6932;1760;6150;568;2176;344;1151;912;3327
320520;201605;37717;112296;30788;99634;7786;27696;10149;32377;17935;60073
320530;201605;27006;81397;22417;72636;4407;16486;10341;31411;14748;47897
330010;201605;20102;61015;18094;57182;3787;12942;9420;29290;13207;42232
330015;201605;1653;4582;1417;4141;233;788;615;1746;848;2534
330020;201605;17398;50776;15870;48304;2975;9955;9087;27016;12062;36971
330022;201605;1860;5531;1564;5040;300;1095;788;2466;1088;3561
330023;201605;3179;9809;2783;9163;764;2715;825;2613;1589;5328
330025;201605;4524;12167;3554;10532;782;2542;1793;5245;2575;7787
330030;201605;8012;26418;7055;24528;1454;5562;3319;11067;4773;16629
330040;201605;12125;35703;10713;33126;2342;7730;5227;15689;7569;23419
330045;201605;70596;193303;61480;180489;7917;25007;40966;118431;48883;143438
330050;201605;2448;7585;2136;6984;609;2201;641;1939;1250;4140
330060;201605;5731;16477;4964;15371;1180;4139;2455;7469;3635;11608
330070;201605;21623;65177;19287;61226;4179;14259;8555;27057;12734;41316
330080;201605;7917;22569;7322;21654;809;2397;4988;14834;5797;17231
330090;201605;2653;7154;2394;6752;433;1330;1285;3522;1718;4852
330093;201605;2055;6055;1712;5454;379;1250;640;2124;1019;3374
330095;201605;986;3322;852;3019;221;913;233;762;454;1675
330100;201605;56328;177763;51351;169658;8713;32489;27605;90795;36318;123284
330110;201605;2360;7364;2088;6891;505;1756;600;1969;1105;3725
330115;201605;1913;5477;1679;5124;307;1051;860;2521;1167;3572
330120;201605;2604;7185;2289;6710;462;1517;1232;3479;1694;4996
330130;201605;3559;11403;3155;10696;796;2900;1375;4599;2171;7499
330140;201605;3040;9383;2767;8977;593;2126;1461;4717;2054;6843
330150;201605;2345;6898;1849;5904;421;1440;413;1349;834;2789
330160;201605;1166;3715;1025;3474;275;1090;464;1455;739;2545
330170;201605;99973;298958;91098;285070;17120;56705;50954;158379;68074;215084
330180;201605;2024;5901;1683;5276;142;559;1028;3023;1170;3582
330185;201605;8005;24765;6933;22711;1503;5357;3470;11071;4973;16428
330187;201605;3803;10854;3270;9965;450;1552;2156;6458;2606;8010
330190;201605;25323;71953;23566;69194;4346;13407;15148;44208;19494;57615
330200;201605;14034;43999;12486;41366;3182;10908;5901;19830;9083;30738
330205;201605;2168;5932;1885;5454;319;1015;1042;2927;1361;3942
330210;201605;3393;9403;2795;8238;805;2498;697;1991;1502;4489
330220;201605;10250;31142;8882;28250;2285;7879;2248;6570;4533;14449
330225;201605;3803;11773;3401;11039;421;1636;2050;6518;2471;8154
330227;201605;17039;48860;15345;46401;3774;11714;7981;24513;11755;36227
330230;201605;1347;4019;1222;3818;278;1001;543;1598;821;2599
330240;201605;17165;52589;14716;48019;4672;16541;3416;10648;8088;27189
330245;201605;1291;3978;1016;3481;264;1003;174;558;438;1561
330250;201605;35915;104649;32710;99433;9833;30231;12464;39284;22297;69515
330260;201605;3809;11913;3333;10964;653;2391;1360;4206;2013;6597
330270;201605;18832;43896;12708;35541;3014;9364;4218;11841;7232;21205
330280;201605;2200;6523;1833;5808;316;1109;844;2510;1160;3619
330285;201605;18092;51753;16341;49195;2763;9002;9951;29653;12714;38655
330290;201605;3391;9594;3004;9015;491;1671;1740;4994;2231;6665
330300;201605;3259;10565;2973;10032;436;1699;1736;5679;2172;7378
330310;201605;2306;6552;1981;6009;309;991;1110;3328;1419;4319
330320;201605;13240;39584;12404;38308;1773;5974;8905;27261;10678;33235
330330;201605;27377;75428;23936;70040;3922;12931;14380;40630;18302;53561
330340;201605;14506;42101;11454;36550;2765;9448;3377;10598;6142;20046
330350;201605;85573;253458;78448;243130;11658;38024;53255;165287;64913;203311
330360;201605;5779;17199;5556;16894;342;1172;4769;14438;5111;15610
330370;201605;3430;12100;3113;11415;1067;4052;982;3651;2049;7703
330380;201605;4920;15887;4167;14364;924;3545;1504;4991;2428;8536
330385;201605;3954;13584;3621;12926;1088;4181;1274;4570;2362;8751
330390;201605;22876;74470;20170;69071;4822;18050;8311;27818;13133;45868
330395;201605;3015;8808;2729;8337;253;920;1800;5371;2053;6291
330400;201605;2516;7924;2271;7512;309;1255;1355;4129;1664;5384
330410;201605;2798;8594;2322;7689;476;1741;1005;3216;1481;4957
330411;201605;2351;7328;2040;6675;234;891;1176;3694;1410;4585
330412;201605;1347;4527;1126;4088;230;969;486;1640;716;2609
330414;201605;24235;68341;21298;64243;4315;12972;12175;37154;16490;50126
330415;201605;3517;10741;3069;9962;781;2606;1106;3638;1887;6244
330420;201605;9702;27916;6651;22265;1432;5205;1134;3673;2566;8878
330430;201605;7291;21595;6456;20043;1358;4550;2925;8854;4283;13404
330440;201605;1659;5535;1445;5089;440;1718;296;930;736;2648
330450;201605;1347;4451;1204;4198;267;1115;582;1953;849;3068
330452;201605;13631;39749;10829;34367;2732;9446;3806;11651;6538;21097
330455;201605;490458;1344412;402735;1205933;90162;287428;192917;571552;283079;858980
330460;201605;1185;3861;1055;3631;222;872;461;1545;683;2417
330470;201605;4387;13259;3905;12382;895;3099;1698;5237;2593;8336
330475;201605;7830;24210;6900;22654;2044;7308;2451;7843;4495;15151
330480;201605;5777;16956;5303;16276;955;3216;3123;9413;4078;12629
330490;201605;106684;282266;96222;267020;9722;28117;70273;195214;79995;223331
330500;201605;5552;17010;5285;16526;702;2384;3524;10886;4226;13270
330510;201605;37254;113326;33413;107361;10451;33992;13991;46138;24442;80130
330513;201605;1490;4440;1355;4198;402;1257;533;1696;935;2953
330515;201605;3009;9265;2642;8561;816;2666;724;2333;1540;4999
330520;201605;11421;34178;10179;32017;2097;6923;4628;14407;6725;21330
330530;201605;1494;4442;1329;4138;327;1104;523;1591;850;2695
330540;201605;2893;8584;2416;7734;569;1954;919;2861;1488;4815
330550;201605;7764;25902;6852;24168;2928;10785;977;3462;3905;14247
330555;201605;10182;29795;9008;28123;1734;5487;5251;16908;6985;22395
330560;201605;4252;12768;3850;12010;709;2489;1992;5939;2701;8428
330570;201605;3394;9919;2905;9095;756;2509;1334;4160;2090;6669
330575;201605;5182;14878;4635;13894;683;2328;2945;8472;3628;10800
330580;201605;13841;43472;11769;39265;3072;10754;4382;14689;7454;25443
330590;201605;1604;4902;1485;4710;284;975;909;2847;1193;3822
330600;201605;10840;31233;8752;27736;1275;4523;4356;13576;5631;18099
330610;201605;8811;27541;8006;26117;1341;4977;4622;14725;5963;19702
330615;201605;1660;5823;1504;5497;659;2584;304;1124;963;3708
330620;201605;3426;11827;3074;11139;1050;4134;682;2497;1732;6631
330630;201605;22819;66744;18787;59654;3147;11403;9824;29991;12971;41394
350010;201605;1984;5871;1326;4543;304;1120;161;503;465;1623
350020;201605;456;1245;319;977;47;151;158;461;205;612
350030;201605;4310;13548;3389;11707;1161;4369;704;2345;1865;6714
350040;201605;457;1572;347;1324;78;315;85;307;163;622
350050;201605;887;2675;719;2369;163;629;251;726;414;1355
350055;201605;647;1916;551;1760;103;336;311;987;414;1323
350060;201605;112;326;88;289;23;86;38;116;61;202
350070;201605;3639;10925;2383;8271;457;1721;442;1372;899;3093
350075;201605;457;1515;360;1342;138;513;71;254;209;767
350080;201605;581;1653;399;1280;77;281;140;426;217;707
350090;201605;602;1556;393;1184;100;281;136;425;236;706
350100;201605;1820;5688;1326;4684;285;1134;380;1258;665;2392
350110;201605;456;1365;349;1141;38;150;179;566;217;716
350115;201605;1235;3764;1107;3507;183;670;609;1784;792;2454
350120;201605;591;1554;313;970;60;192;40;123;100;315
350130;201605;3216;9584;2832;8815;395;1406;1521;4473;1916;5879
350140;201605;569;1841;484;1702;67;273;243;848;310;1121
350150;201605;381;1280;329;1169;115;434;73;261;188;695
350160;201605;7802;22620;5347;17788;1213;4527;1934;5880;3147;10407
350170;201605;1640;5620;1409;5047;356;1350;286;963;642;2313
350180;201605;1036;2895;673;2065;96;294;309;951;405;1245
350190;201605;2958;9204;2453;8192;525;2082;1129;3324;1654;5406
350200;201605;355;1126;310;1047;36;127;180;611;216;738
350210;201605;4842;12937;3626;10956;1016;3342;1400;4134;2416;7476
350220;201605;2558;8108;2224;7400;527;2079;825;2485;1352;4564
350230;201605;646;2115;589;2018;136;511;244;818;380;1329
350240;201605;478;1466;398;1279;68;227;221;690;289;917
350250;201605;1974;7162;1845;6911;641;2601;585;2157;1226;4758
350260;201605;956;2565;671;2049;115;377;290;846;405;1223
350270;201605;4937;15161;4185;13527;771;2667;1697;5258;2468;7925
350275;201605;1924;6312;1745;5999;485;1777;640;2104;1125;3881
350280;201605;21876;53470;13597;39566;2814;8775;2877;8330;5691;17105
350290;201605;1803;5796;1425;4995;310;1185;395;1325;705;2510
350300;201605;424;1236;345;1073;82;250;183;566;265;816
350310;201605;808;2679;710;2470;96;385;303;1027;399;1412
350315;201605;497;1570;397;1353;60;249;97;293;157;542
350320;201605;10637;33108;9412;30819;2618;9105;1345;4544;3963;13649
350330;201605;13896;38752;9383;28525;1871;5621;2999;8661;4870;14282
350335;201605;342;1093;301;1006;22;63;219;752;241;815
350340;201605;1094;3251;771;2602;138;522;221;735;359;1257
350350;201605;706;2198;608;2037;117;438;206;671;323;1109
350360;201605;779;2659;672;2431;179;676;256;961;435;1637
350370;201605;606;1807;450;1470;86;298;88;269;174;567
350380;201605;4103;11723;2760;9361;689;2602;649;1971;1338;4573
350390;201605;8841;27125;7857;25293;2301;7738;2840;8987;5141;16725
350395;201605;357;997;185;634;25;100;39;122;64;222
350400;201605;7728;22116;6260;19517;1384;4788;2417;7260;3801;12048
350410;201605;8071;26750;6282;23088;1636;6586;956;3369;2592;9955
350420;201605;538;1640;389;1371;75;320;28;92;103;412
350430;201605;691;2122;567;1899;115;438;271;862;386;1300
350440;201605;1204;3771;1079;3517;255;836;477;1552;732;2388
350450;201605;7448;22716;5899;19556;1324;4770;1323;4198;2647;8968
350460;201605;1399;3841;876;2805;160;574;254;748;414;1322
350470;201605;232;639;191;567;29;113;112;311;141;424
350480;201605;783;2353;542;1829;73;284;89;261;162;545
350490;201605;1806;5391;1554;5002;375;1316;582;1740;957;3056
350500;201605;559;1635;493;1526;89;316;269;812;358;1128
350510;201605;1072;3207;830;2706;137;528;321;976;458;1504
350520;201605;1334;4915;1051;4180;239;1053;182;723;421;1776
350530;201605;2341;6858;1934;6024;567;1813;602;1766;1169;3579
350535;201605;1232;3981;1156;3848;157;649;750;2384;907;3033
350540;201605;1749;4948;1373;4269;366;1191;444;1416;810;2607
350550;201605;10894;28993;7549;23495;1528;5354;2466;7271;3994;12625
350560;201605;3165;10469;2831;9735;387;1393;1545;5364;1932;6757
350570;201605;17592;58055;15733;54277;4561;16977;5562;18219;10123;35196
350580;201605;1606;5022;1152;3995;240;913;125;377;365;1290
350590;201605;4018;12428;3135;10656;781;2951;1092;3413;1873;6364
350600;201605;40434;99286;26878;76178;4343;13249;11362;30362;15705;43611
350610;201605;6968;20361;5563;17902;1149;4018;2349;7464;3498;11482
350620;201605;397;1129;297;975;55;213;124;382;179;595
350630;201605;1553;4576;1187;3882;237;940;388;1118;625;2058
350635;201605;6190;18311;4805;15868;1088;3888;1822;5911;2910;9799
350640;201605;720;2247;504;1725;85;323;92;293;177;616
350650;201605;7506;22652;4641;15874;1050;3981;559;1725;1609;5706
350660;201605;4468;13106;3756;11937;734;2555;1945;6040;2679;8595
350670;201605;1599;4946;1472;4713;296;970;823;2603;1119;3573
350680;201605;1038;3135;811;2695;172;631;325;1058;497;1689
350690;201605;839;2744;677;2426;147;562;198;682;345;1244
350700;201605;4138;12218;2788;9735;722;2746;672;2092;1394;4838
350710;201605;2603;8066;2291;7478;335;1201;1367;4399;1702;5600
350715;201605;774;2368;676;2175;196;665;248;744;444;1409
350720;201605;118;351;105;331;31;100;37;116;68;216
350730;201605;387;1450;375;1420;92;398;154;563;246;961
350740;201605;1807;5560;1322;4434;232;870;359;1086;591;1956
350745;201605;478;1507;297;1023;41;146;130;407;171;553
350750;201605;9783;29443;7804;25593;1735;6218;1685;5098;3420;11316
350760;201605;12831;37253;10252;32669;2494;8741;2945;8548;5439;17289
350770;201605;705;2002;489;1589;60;214;247;787;307;1001
350775;201605;560;1514;471;1382;61;216;260;752;321;968
350780;201605;1845;5639;1441;4825;402;1473;214;735;616;2208
350790;201605;1892;5819;1399;4841;322;1193;254;774;576;1967
350800;201605;2857;9511;2676;9207;420;1677;1637;5477;2057;7154
350810;201605;1976;5581;1645;5116;456;1516;653;2066;1109;3582
350820;201605;548;1481;406;1217;63;235;187;519;250;754
350830;201605;843;2602;565;1970;75;268;127;391;202;659
350840;201605;2328;8237;1928;7311;572;2295;386;1355;958;3650
350850;201605;5758;19111;4875;17186;1514;5620;1005;3470;2519;9090
350860;201605;3145;9715;3018;9533;215;868;2355;7358;2570;8226
350870;201605;2674;8426;2218;7706;496;1977;1261;4392;1757;6369
350880;201605;1224;4062;1030;3659;238;903;230;797;468;1700
350890;201605;621;1763;408;1297;53;183;95;244;148;427
350900;201605;3705;11967;2796;9897;725;2803;285;947;1010;3750
350910;201605;809;2399;706;2191;219;722;272;807;491;1529
350920;201605;10076;28739;9054;26977;988;3283;6249;17929;7237;21212
350925;201605;4515;14059;3690;12398;900;3239;1202;3587;2102;6826
350930;201605;1559;4258;1232;3664;133;435;766;2194;899;2629
350940;201605;1770;5763;1613;5518;303;1206;911;3027;1214;4233
350945;201605;922;2896;793;2661;108;453;445;1429;553;1882
350950;201605;69360;208267;55963;180478;12138;42880;22581;69012;34719;111892
350960;201605;4519;14935;3878;13616;675;2686;2100;7035;2775;9721
350970;201605;4232;14514;3574;12952;1123;4408;633;1992;1756;6400
350980;201605;566;1860;510;1772;208;772;160;560;368;1332
350990;201605;1730;5836;1425;5273;414;1639;367;1345;781;2984
350995;201605;734;2522;702;2462;99;458;452;1490;551;1948
351000;201605;2986;8890;2482;7946;346;1249;1098;3299;1444;4548
351010;201605;348;976;208;678;47;166;66;217;113;383
351015;201605;796;2705;670;2469;140;586;307;1097;447;1683
351020;201605;7974;24795;6873;23060;1693;5965;3002;10226;4695;16191
351030;201605;1707;6030;1504;5538;328;1404;461;1559;789;2963
351040;201605;3350;10019;3062;9533;410;1459;2061;6201;2471;7660
351050;201605;14091;40001;10074;32907;2448;8718;2585;8390;5033;17108
351060;201605;34859;101418;28452;89945;5851;20258;12952;39798;18803;60056
351070;201605;1460;4081;970;3179;263;941;99;278;362;1219
351080;201605;2547;7357;1958;6615;484;1807;860;2791;1344;4598
351090;201605;353;1210;284;1064;58;245;48;179;106;424
351100;201605;2050;6258;1652;5436;444;1520;426;1457;870;2977
351110;201605;7117;17749;3975;12634;814;2958;837;2522;1651;5480
351120;201605;632;1826;504;1575;60;225;242;650;302;875
351130;201605;989;2738;531;1791;86;309;91;273;177;582
351140;201605;1639;5503;1355;4915;415;1624;291;989;706;2613
351150;201605;1479;5159;1095;4154;185;742;163;540;348;1282
351160;201605;1226;4252;1078;3907;268;1068;332;1098;600;2166
351170;201605;1379;4380;1151;3890;198;724;506;1633;704;2357
351190;201605;772;2462;606;2035;99;347;158;516;257;863
351200;201605;1978;5839;1674;5276;300;1053;588;1703;888;2756
351210;201605;1083;3187;790;2584;159;577;270;811;429;1388
351220;201605;3162;10582;2885;10017;505;1950;1404;4767;1909;6717
351230;201605;1682;5251;1415;4741;266;1035;693;2237;959;3272
351240;201605;1041;3223;768;2637;206;738;211;663;417;1401
351250;201605;945;2724;609;1988;105;370;200;619;305;989
351260;201605;910;2658;791;2420;181;566;301;892;482;1458
351270;201605;313;1080;275;1000;60;256;100;317;160;573
351280;201605;4726;13747;3606;11459;723;2510;1254;3785;1977;6295
351290;201605;954;2710;704;2233;161;524;273;850;434;1374
351300;201605;12489;40308;9398;33734;2157;8534;2715;9543;4872;18077
351310;201605;3057;9237;2462;8168;453;1730;1101;3368;1554;5098
351320;201605;838;2752;713;2475;135;536;227;715;362;1251
351330;201605;255;707;208;636;79;240;42;124;121;364
351340;201605;5601;18659;4837;17116;1315;4925;1674;5913;2989;10838
351350;201605;7408;23686;6377;21563;1735;6113;2057;6609;3792;12722
351360;201605;4024;12493;3677;11832;868;3080;1198;3538;2066;6618
351370;201605;2196;6724;1736;5764;345;1305;682;2056;1027;3361
351380;201605;36957;107755;33290;101075;6526;21309;14166;42023;20692;63332
351385;201605;210;656;188;615;36;133;82;250;118;383
351390;201605;1134;3657;951;3285;244;989;358;1100;602;2089
351400;201605;846;2809;806;2718;283;1026;286;946;569;1972
351410;201605;2479;7420;2170;6868;338;1127;1266;3926;1604;5053
351420;201605;315;898;216;710;45;152;51;165;96;317
351430;201605;803;2534;750;2447;107;390;544;1755;651;2145
351440;201605;3325;9888;2546;8205;537;1779;367;1094;904;2873
351450;201605;1593;4484;1306;4033;315;1011;487;1578;802;2589
351460;201605;687;2054;583;1872;311;1019;131;418;442;1437
351470;201605;985;2947;873;2730;176;629;393;1179;569;1808
351480;201605;2667;8660;2450;8304;382;1658;1385;4456;1767;6114
351490;201605;1767;5792;1576;5394;168;704;940;3068;1108;3772
351492;201605;211;649;170;557;12;49;107;346;119;395
351495;201605;178;573;142;477;32;131;57;178;89;309
351500;201605;25094;71264;19277;60622;4741;16391;7242;21654;11983;38045
351510;201605;8668;26467;7081;23257;1637;5817;3217;10369;4854;16186
351512;201605;464;1333;353;1096;53;156;175;544;228;700
351515;201605;2206;6905;1584;5526;374;1416;388;1211;762;2627
351518;201605;2051;6345;1415;5159;326;1368;424;1392;750;2760
351519;201605;776;2279;569;1829;101;386;155;371;256;757
351520;201605;770;2061;385;1319;52;211;62;194;114;405
351530;201605;383;1179;267;887;38;119;64;175;102;294
351535;201605;2340;5992;1827;5248;138;474;1211;3349;1349;3823
351540;201605;1724;5186;1376;4528;435;1566;189;613;624;2179
351550;201605;5030;14685;3562;11563;660;2406;1282;3995;1942;6401
351560;201605;357;1151;314;1071;67;273;45;142;112;415
351565;201605;166;554;151;518;25;90;64;217;89;307
351570;201605;11877;35902;9918;31972;2109;7345;5121;15967;7230;23312
351580;201605;324;859;198;595;53;157;49;151;102;308
351590;201605;431;1116;285;841;28;91;126;358;154;449
351600;201605;1714;4737;1447;4279;182;619;826;2309;1008;2928
351610;201605;651;1789;498;1526;56;201;228;623;284;824
351620;201605;18219;57776;14113;49465;2807;10981;3502;10928;6309;21909
351630;201605;19377;60547;17433;57430;3892;13568;9584;31304;13476;44872
351640;201605;12124;36126;9903;32104;1721;6062;5506;17587;7227;23649
351650;201605;450;1345;223;755;40;152;28;78;68;230
351660;201605;762;2445;569;1946;118;426;110;331;228;757
351670;201605;3799;11804;3134;10363;566;2103;1388;4285;1954;6388
351680;201605;611;1886;390;1371;71;250;65;231;136;481
351685;201605;380;1163;337;1088;92;279;156;516;248;795
351690;201605;1091;3244;792;2595;128;449;273;820;401;1269
351700;201605;1126;3287;966;2977;241;724;359;1102;600;1826
351710;201605;555;1827;470;1642;75;257;178;606;253;863
351720;201605;1578;4803;1085;3615;199;707;303;966;502;1673
351730;201605;1047;2980;850;2697;213;772;336;1046;549;1818
351740;201605;3950;10801;3171;9268;639;1987;1165;3257;1804;5244
351750;201605;1106;3516;743;2678;171;656;168;602;339;1258
351760;201605;3495;10840;2842;9433;748;2690;887;2741;1635;5431
351770;201605;2143;6727;1825;6165;512;1817;742;2409;1254;4226
351780;201605;1488;4161;895;2861;140;483;216;672;356;1155
351790;201605;1021;2963;893;2760;245;722;404;1303;649;2025
351800;201605;437;978;274;734;32;101;115;290;147;391
351810;201605;980;2792;856;2607;104;328;605;1831;709;2159
351820;201605;2420;7611;1823;6373;436;1602;168;561;604;2163
351830;201605;3851;11964;2938;9943;511;1939;1329;4308;1840;6247
351840;201605;6812;22534;5902;20747;1463;5544;2030;6938;3493;12482
351850;201605;1887;5177;1352;4234;180;702;652;1855;832;2557
351860;201605;3263;10389;2825;9487;736;2660;1071;3444;1807;6104
351870;201605;27788;82724;23334;74709;6643;22325;9224;29332;15867;51657
351880;201605;109633;342274;93201;308900;26341;92943;22955;72440;49296;165383
351885;201605;609;2105;552;1989;146;547;224;797;370;1344
351890;201605;618;1895;492;1652;111;409;82;239;193;648
351900;201605;1193;3632;999;3322;268;939;305;1008;573;1947
351905;201605;454;1403;368;1239;50;190;197;616;247;806
351907;201605;17770;52116;14697;46357;1635;6206;9091;27661;10726;33867
351910;201605;991;3105;823;2726;166;591;327;1052;493;1643
351920;201605;985;2678;859;2498;117;391;507;1438;624;1829
351925;201605;879;2737;738;2454;120;424;326;1022;446;1446
351930;201605;2570;8272;2441;8030;435;1811;1673;5141;2108;6952
351940;201605;953;2878;798;2581;163;584;326;1023;489;1607
351950;201605;1452;3981;1031;3196;139;463;497;1536;636;1999
351960;201605;4238;12120;3098;10009;658;2392;1277;4060;1935;6452
351970;201605;5062;18073;4492;16963;1232;5002;1531;5639;2763;10641
351980;201605;852;2537;658;2130;116;418;210;592;326;1010
351990;201605;1481;4180;1184;3626;234;852;237;614;471;1466
352000;201605;2227;7118;2006;6668;417;1494;953;2975;1370;4469
352010;201605;1653;5529;1452;5078;346;1305;276;966;622;2271
352020;201605;1367;4222;1171;3872;270;970;436;1379;706;2349
352030;201605;4785;13947;3965;12743;877;2973;1984;6406;2861;9379
352040;201605;1919;6214;1550;5414;313;1202;277;898;590;2100
352042;201605;3253;9056;2061;6452;401;1350;884;2697;1285;4047
352044;201605;1632;5055;1102;3912;188;739;185;592;373;1331
352050;201605;9981;30161;6851;23290;1541;5871;1274;3883;2815;9754
352060;201605;704;2106;571;1849;115;430;223;664;338;1094
352070;201605;786;2017;626;1750;134;402;209;580;343;982
352080;201605;415;1186;295;958;53;180;107;329;160;509
352090;201605;1177;4020;975;3509;166;662;224;754;390;1416
352100;201605;2627;7961;2009;6818;492;1826;719;2309;1211;4135
352110;201605;481;1658;407;1511;110;432;151;519;261;951
352115;201605;429;1360;371;1256;58;200;185;611;243;811
352120;201605;900;2821;744;2533;127;519;367;1179;494;1698
352130;201605;1766;5053;1188;3886;295;1005;254;778;549;1783
352140;201605;1727;4943;1041;3487;161;562;355;1145;516;1707
352150;201605;746;2278;588;1983;150;530;257;857;407;1387
352160;201605;983;2713;768;2320;161;531;240;632;401;1163
352170;201605;2655;7986;2381;7420;427;1444;1243;3643;1670;5087
352180;201605;3208;9196;2691;8184;645;2093;918;2671;1563;4764
352190;201605;1148;3412;918;2935;137;533;303;761;440;1294
352200;201605;361;1250;286;1093;50;218;119;439;169;657
352210;201605;15955;43019;13029;38793;2318;7342;7519;22653;9837;29995
352215;201605;545;1691;500;1623;62;238;297;937;359;1175
352220;201605;12054;38513;10002;34294;3227;11830;2274;7793;5501;19623
352230;201605;12097;40393;10467;37355;2865;11233;3574;12243;6439;23476
352240;201605;12027;34636;9358;30006;2631;9518;2748;7847;5379;17365
352250;201605;22096;70674;19192;64777;5630;20179;5678;19068;11308;39247
352260;201605;5157;14641;3363;10908;624;2257;1135;3380;1759;5637
352265;201605;848;2679;721;2457;59;280;455;1468;514;1748
352270;201605;1702;5803;1429;5214;366;1408;342;1234;708;2642
352280;201605;2148;6472;1778;5832;402;1499;657;2050;1059;3549
352290;201605;1088;3451;920;3086;193;776;339;1015;532;1791
352300;201605;937;2733;737;2355;169;590;304;898;473;1488
352310;201605;40534;119569;32993;106652;8414;28632;15847;51328;24261;79960
352320;201605;5390;16543;4637;15116;1234;4282;1374;4052;2608;8334
352330;201605;1929;6136;1638;5724;517;1937;436;1499;953;3436
352340;201605;5221;16539;4001;14170;1020;3946;714;2310;1734;6256
352350;201605;1606;5441;1439;5086;270;1088;527;1774;797;2862
352360;201605;1040;3155;906;2902;178;689;563;1686;741;2375
352370;201605;836;2841;757;2666;119;474;387;1321;506;1795
352380;201605;955;3022;821;2774;243;935;179;564;422;1499
352390;201605;18190;48516;12128;37137;2076;7216;5564;15886;7640;23102
352400;201605;3736;10578;2465;8095;700;2400;592;1806;1292;4206
352410;201605;2862;8657;2441;7954;564;1932;948;3007;1512;4939
352420;201605;873;2467;743;2218;176;566;313;902;489;1468
352430;201605;6205;18472;5178;16840;1719;6097;1534;4892;3253;10989
352440;201605;15069;45465;12233;40015;2874;9987;4279;13703;7153;23690
352450;201605;648;1973;447;1551;97;374;115;359;212;733
352460;201605;2283;7369;1897;6608;522;2013;487;1534;1009;3547
352470;201605;3880;10695;2572;8252;389;1386;915;2699;1304;4085
352480;201605;4284;11712;3308;9896;669;2280;1148;3079;1817;5359
352490;201605;649;2244;517;1907;92;377;110;376;202;753
352500;201605;8353;24040;7290;22484;3568;11747;1732;4683;5300;16430
352510;201605;2837;8888;2241;7765;646;2447;516;1717;1162;4164
352520;201605;1983;6960;1760;6412;460;1793;687;2457;1147;4250
352530;201605;8145;25808;6153;21319;1516;5681;820;2378;2336;8059
352540;201605;461;1422;337;1132;48;171;89;279;137;450
352550;201605;849;2806;601;2219;133;570;105;346;238;916
352560;201605;624;1855;445;1455;67;212;111;328;178;540
352570;201605;1771;5803;1344;4839;297;1244;220;657;517;1901
352580;201605;842;2478;725;2287;151;525;377;1168;528;1693
352585;201605;205;662;171;601;54;206;31;115;85;321
352590;201605;12083;36806;9689;32163;2877;10239;3535;10949;6412;21188
352600;201605;1569;4797;1380;4455;322;1129;573;1748;895;2877
352610;201605;3249;9902;2682;8946;740;2765;740;2336;1480;5101
352620;201605;5153;15739;4665;15000;1004;3450;2445;7696;3449;11146
352630;201605;615;1946;580;1862;124;460;234;698;358;1158
352640;201605;2630;8039;2190;7168;250;939;1251;3988;1501;4927
352650;201605;802;2377;597;1933;112;382;170;527;282;909
352660;201605;1014;3426;811;2969;155;648;196;705;351;1353
352670;201605;10506;31268;6511;22513;1442;5458;541;1769;1983;7227
352680;201605;2805;9377;2157;7893;492;2013;641;2140;1133;4153
352690;201605;30200;82985;21640;66046;3318;11248;10440;30415;13758;41663
352700;201605;592;1777;496;1629;145;524;208;658;353;1182
352710;201605;5200;14951;3872;12288;923;3233;1307;3909;2230;7142
352720;201605;7473;24077;6667;22304;2003;6787;1924;6405;3927;13192
352725;201605;401;1127;235;771;33;133;89;270;122;403
352730;201605;2116;7027;1915;6505;395;1439;668;2005;1063;3444
352740;201605;2053;5616;1649;4968;229;830;934;2662;1163;3492
352750;201605;474;1374;244;848;29;105;46;151;75;256
352760;201605;1155;3933;959;3445;284;1055;277;943;561;1998
352770;201605;754;2363;654;2163;136;497;257;814;393;1311
352780;201605;594;1980;474;1703;96;368;141;485;237;853
352790;201605;617;1769;453;1483;84;295;108;354;192;649
352800;201605;938;3304;684;2637;143;609;192;667;335;1276
352810;201605;1154;3004;762;2246;137;434;229;638;366;1072
352820;201605;628;1710;449;1423;94;334;94;298;188;632
352830;201605;507;1452;310;1006;48;183;40;99;88;282
352840;201605;3597;12145;3211;11328;954;3499;1085;3733;2039;7232
352850;201605;8737;26011;6891;22965;1782;6313;2280;7462;4062;13775
352860;201605;776;2579;711;2442;168;625;254;828;422;1453
352870;201605;923;2330;640;1745;65;240;349;841;414;1081
352880;201605;2245;6301;1651;5137;289;921;557;1626;846;2547
352885;201605;215;728;203;699;20;73;136;460;156;533
352890;201605;660;1742;467;1356;61;218;214;557;275;775
352900;201605;19505;56481;14264;45997;2843;9980;4924;15142;7767;25122
352910;201605;358;1037;208;694;20;75;37;115;57;190
352920;201605;2339;7027;1794;5908;336;1259;731;2201;1067;3460
352930;201605;5573;17208;4405;14674;1026;3638;1085;3450;2111;7088
352940;201605;21661;69574;18009;61274;5639;20688;1980;5984;7619;26672
352950;201605;316;922;202;714;45;189;35;105;80;294
352960;201605;591;1767;360;1243;49;185;71;226;120;411
352965;201605;364;1024;233;736;53;172;32;88;85;260
352970;201605;3120;7824;2522;6945;294;850;1658;4580;1952;5430
352980;201605;1067;3318;899;3037;190;632;503;1798;693;2430
352990;201605;3927;12328;3451;11512;886;3307;1389;4395;2275;7702
353000;201605;444;1248;243;783;26;91;37;111;63;202
353010;201605;2957;8202;2164;6672;497;1752;580;1552;1077;3304
353020;201605;4067;11067;2568;7867;369;1276;901;2481;1270;3757
353030;201605;3700;10915;2993;9585;845;2913;564;1724;1409;4637
353040;201605;525;1443;444;1319;110;363;133;365;243;728
353050;201605;4677;15563;3901;13952;1107;4221;1334;4611;2441;8832
353060;201605;36739;108834;32691;102331;3379;12828;23337;70440;26716;83268
353070;201605;10219;31380;7317;25251;1697;6254;1722;5942;3419;12196
353080;201605;5036;15815;3511;12497;730;2882;751;2457;1481;5339
353090;201605;509;1714;456;1603;44;184;267;885;311;1069
353100;201605;263;726;126;421;19;63;19;56;38;119
353110;201605;7307;22251;6267;20570;1398;4974;3400;11176;4798;16150
353120;201605;654;1924;418;1378;84;310;101;272;185;582
353130;201605;2420;6978;1943;6245;602;2076;583;1825;1185;3901
353140;201605;2229;6064;1716;5081;396;1254;675;1893;1071;3147
353150;201605;1599;4801;1287;4258;343;1175;349;1158;692;2333
353160;201605;659;1851;422;1357;92;306;61;151;153;457
353170;201605;410;1330;373;1272;110;472;162;497;272;969
353180;201605;8123;23012;6488;20147;1121;3793;3365;10188;4486;13981
353190;201605;3602;10896;2981;9565;507;1814;1515;4567;2022;6381
353200;201605;918;3046;739;2634;228;903;179;587;407;1490
353205;201605;359;1178;317;1097;74;260;127;442;201;702
353210;201605;971;2461;692;1969;38;138;454;1256;492;1394
353215;201605;371;1158;319;1046;45;159;101;295;146;454
353220;201605;638;1987;522;1741;130;467;110;337;240;804
353230;201605;784;2533;716;2415;173;645;190;602;363;1247
353240;201605;1962;6304;1733;5857;352;1339;881;2860;1233;4199
353250;201605;1055;2846;798;2380;101;323;390;1112;491;1435
353260;201605;857;2362;616;1924;100;360;213;637;313;997
353270;201605;615;1803;539;1662;121;394;193;575;314;969
353280;201605;573;1861;475;1640;118;448;99;326;217;774
353282;201605;1704;5406;1555;5114;235;846;877;2768;1112;3614
353284;201605;341;919;196;610;31;95;47;146;78;241
353286;201605;140;423;101;338;16;49;18;64;34;113
353290;201605;638;1969;511;1740;78;336;282;896;360;1232
353300;201605;1370;4254;1149;3788;259;971;403;1205;662;2176
353310;201605;178;551;151;503;44;153;50;161;94;314
353320;201605;520;1492;457;1388;77;258;251;732;328;990
353325;201605;575;1886;478;1692;77;291;107;361;184;652
353330;201605;600;1730;410;1290;69;256;184;537;253;793
353340;201605;2651;7585;1771;5922;506;1789;426;1407;932;3196
353350;201605;3101;9283;2506;8126;745;2554;745;2284;1490;4838
353360;201605;397;1278;355;1189;42;165;231;745;273;910
353370;201605;616;2023;536;1837;69;277;289;954;358;1231
353380;201605;322;1072;266;954;51;216;85;277;136;493
353390;201605;5568;15162;3962;12313;740;2476;1358;4037;2098;6513
353400;201605;468;1419;404;1296;94;334;89;241;183;575
353410;201605;582;1689;484;1522;91;313;270;844;361;1157
353420;201605;586;1642;397;1213;111;343;100;282;211;625
353430;201605;2190;7371;1592;5877;377;1456;226;788;603;2244
353440;201605;56491;178056;46527;156021;12343;43292;15655;50779;27998;94071
353450;201605;406;1201;333;1051;68;236;123;373;191;609
353460;201605;3250;9146;2683;8128;343;1179;1325;4081;1668;5260
353470;201605;7931;23777;5816;19512;1248;4609;1213;3778;2461;8387
353475;201605;1559;4347;1093;3344;188;622;308;845;496;1467
353480;201605;1354;4092;1203;3794;191;661;703;2137;894;2798
353490;201605;938;2713;737;2317;146;482;263;782;409;1264
353500;201605;956;2550;788;2281;239;697;356;1001;595;1698
353510;201605;965;3057;720;2458;152;555;145;452;297;1007
353520;201605;1076;3078;843;2696;142;516;345;1055;487;1571
353530;201605;2471;7233;2158;6675;335;1219;1156;3416;1491;4635
353540;201605;1835;5603;1580;5167;422;1464;626;1991;1048;3455
353550;201605;5982;16469;4963;14849;525;1857;3095;8806;3620;10663
353560;201605;1958;6493;1623;5894;422;1719;403;1343;825;3062
353570;201605;431;1325;361;1182;60;206;215;666;275;872
353580;201605;2223;6674;1989;6295;316;1133;1270;3976;1586;5109
353590;201605;712;2059;525;1681;131;453;158;514;289;967
353600;201605;1689;4670;1519;4386;221;700;785;2212;1006;2912
353610;201605;528;1758;396;1474;72;315;69;222;141;537
353620;201605;2106;6798;1782;6135;432;1609;510;1625;942;3234
353625;201605;346;963;213;706;42;153;66;221;108;374
353630;201605;1463;5095;1180;4381;208;829;139;447;347;1276
353640;201605;1268;3795;994;3194;110;379;485;1532;595;1911
353650;201605;7442;21817;5523;17780;1005;3401;1886;5867;2891;9268
353657;201605;290;912;253;833;39;146;87;267;126;413
353660;201605;1070;2785;801;2326;300;938;106;205;406;1143
353670;201605;3445;11094;2941;10022;919;3515;911;2792;1830;6307
353680;201605;676;2173;571;1987;194;771;188;598;382;1369
353690;201605;506;1351;283;919;48;161;55;135;103;296
353700;201605;1902;5824;1631;5292;274;967;740;2287;1014;3254
353710;201605;2956;7122;1443;4678;306;1019;232;753;538;1772
353715;201605;481;1391;352;1119;32;119;95;277;127;396
353720;201605;1944;6043;1673;5623;323;1292;821;2581;1144;3873
353730;201605;4263;12811;3376;10998;658;2337;1056;3155;1714;5492
353740;201605;1776;5289;1375;4511;363;1241;317;1010;680;2251
353750;201605;825;2769;632;2316;125;512;144;538;269;1050
353760;201605;9611;26441;7810;23900;1249;4362;4639;13878;5888;18240
353770;201605;740;2302;462;1620;62;226;24;53;86;279
353780;201605;4017;13929;3503;12880;1089;4193;962;3568;2051;7761
353790;201605;2061;7013;1710;6297;442;1888;356;1268;798;3156
353800;201605;15671;47674;12482;41964;3217;11851;4261;13960;7478;25811
353810;201605;1001;3184;773;2686;154;598;234;797;388;1395
353820;201605;1312;4381;1182;4071;224;905;598;1904;822;2809
353830;201605;658;1761;519;1542;94;310;275;796;369;1106
353850;201605;1647;5142;1446;4744;330;1136;553;1774;883;2910
353860;201605;2430;8035;2057;7185;533;1980;509;1712;1042;3692
353870;201605;28345;81296;19674;64360;3791;13609;5944;17669;9735;31278
353880;201605;2583;8122;2181;7422;308;1236;1149;3844;1457;5080
353890;201605;2618;6416;1835;5153;295;894;868;2318;1163;3212
353900;201605;964;2970;709;2463;142;548;189;609;331;1157
353910;201605;1105;3912;1045;3795;274;1025;555;2029;829;3054
353920;201605;2248;6617;1579;5204;329;1201;266;777;595;1978
353930;201605;4395;13200;3074;10785;745;2839;564;1957;1309;4796
353940;201605;1154;3652;909;3082;146;558;279;874;425;1432
353950;201605;3179;10113;2840;9467;486;1815;1579;5039;2065;6854
353960;201605;588;1840;444;1521;103;371;83;244;186;615
353970;201605;506;1449;438;1360;48;158;286;894;334;1052
353980;201605;12446;37254;10718;33998;2301;7771;5126;15710;7427;23481
353990;201605;341;1073;307;1002;44;177;156;474;200;651
354000;201605;2134;5995;1416;4549;260;905;133;402;393;1307
354010;201605;358;1088;298;989;66;217;165;565;231;782
354020;201605;4153;13051;3623;11886;921;3200;1139;3508;2060;6708
354025;201605;865;2413;632;1984;124;412;214;655;338;1067
354030;201605;446;1245;308;990;45;155;127;392;172;547
354040;201605;744;2055;518;1627;58;195;254;741;312;936
354050;201605;917;2915;743;2558;192;713;158;521;350;1234
354060;201605;4803;14822;3379;11617;834;3035;833;2734;1667;5769
354070;201605;2667;8911;2276;8014;546;2077;421;1401;967;3478
354075;201605;1843;6758;1702;6430;401;1674;760;2801;1161;4475
354080;201605;1496;4595;1057;3625;206;720;218;690;424;1410
354085;201605;317;807;282;756;13;48;233;615;246;663
354090;201605;1299;3843;1243;3751;131;445;875;2653;1006;3098
354100;201605;14211;47133;11697;42425;2972;11516;4586;16372;7558;27888
354105;201605;834;2497;734;2343;113;398;475;1487;588;1885
354110;201605;706;1919;550;1709;198;682;82;195;280;877
354120;201605;1854;5104;1406;4264;237;792;590;1670;827;2462
354130;201605;6060;17457;4590;14614;1669;5598;436;1182;2105;6780
354140;201605;25870;64797;15983;47143;3229;10192;4626;12613;7855;22805
354150;201605;3785;10230;2890;8592;471;1543;1336;3810;1807;5353
354160;201605;3287;10629;2737;9382;725;2668;971;3232;1696;5900
354165;201605;459;1594;394;1455;106;426;134;497;240;923
354170;201605;1286;4007;1034;3446;198;733;379;1151;577;1884
354180;201605;456;1356;398;1239;52;195;218;605;270;800
354190;201605;1535;4868;1285;4351;321;1185;401;1291;722;2476
354200;201605;975;2752;783;2418;107;377;347;984;454;1361
354210;201605;590;1868;500;1708;72;297;269;858;341;1155
354220;201605;2817;8192;2397;7440;496;1642;1064;3237;1560;4879
354230;201605;600;1968;543;1859;101;391;228;754;329;1145
354240;201605;1191;3882;899;3206;160;627;185;632;345;1259
354250;201605;661;1878;440;1487;140;508;103;368;243;876
354260;201605;6768;20491;5751;18749;1627;5634;1767;5800;3394;11434
354270;201605;1123;3775;940;3362;199;778;298;1049;497;1827
354280;201605;659;2010;601;1911;81;327;400;1190;481;1517
354290;201605;880;3053;795;2876;187;740;339;1227;526;1967
354300;201605;3467;11441;3287;11097;909;3153;1519;5071;2428;8224
354310;201605;831;2544;659;2201;125;438;326;1097;451;1535
354320;201605;688;2070;574;1850;138;515;178;520;316;1035
354323;201605;437;1205;325;1003;64;216;110;301;174;517
354325;201605;1193;3934;930;3299;190;754;328;1080;518;1834
354330;201605;6317;18910;5108;16563;1024;3706;2292;6968;3316;10674
354340;201605;23131;70650;18777;63006;5391;19584;6630;21566;12021;41150
354350;201605;1012;2990;935;2847;257;887;465;1290;722;2177
354360;201605;441;1405;269;977;35;127;12;45;47;172
354370;201605;1115;3725;967;3439;106;461;555;1918;661;2379
354380;201605;813;2429;649;2132;183;711;102;276;285;987
354390;201605;12622;37005;8786;29529;1770;6437;1650;5389;3420;11826
354400;201605;1527;5301;1259;4635;252;989;362;1300;614;2289
354410;201605;5197;16008;4346;14403;1060;3758;1750;5713;2810;9471
354420;201605;1136;3417;841;2753;208;735;296;928;504;1663
354425;201605;2258;6508;1912;5865;589;1895;396;1230;985;3125
354430;201605;1291;4159;1183;3947;244;935;484;1559;728;2494
354440;201605;519;1568;384;1264;47;167;159;495;206;662
354450;201605;402;1151;236;797;35;142;36;96;71;238
354460;201605;885;2427;632;1968;160;543;244;747;404;1290
354470;201605;558;1523;435;1276;42;151;223;595;265;746
354480;201605;683;1890;583;1741;94;316;341;982;435;1298
354490;201605;682;2278;532;1915;79;302;198;681;277;983
354500;201605;2087;6751;1834;6309;628;2409;342;1165;970;3574
354510;201605;729;2095;657;1975;88;231;424;1322;512;1553
354515;201605;263;880;206;754;39;168;72;244;111;412
354520;201605;7288;23559;4133;14368;802;3157;1531;4927;2333;8084
354530;201605;2918;10029;2598;9330;696;2746;1008;3520;1704;6266
354540;201605;1178;3554;964;3175;339;1210;144;429;483;1639
354550;201605;449;1334;371;1179;68;231;171;512;239;743
354560;201605;1568;4379;1024;3199;166;521;416;1232;582;1753
354570;201605;945;2667;520;1669;74;266;76;213;150;479
354580;201605;10479;29310;7549;23986;1301;4477;2846;8564;4147;13041
354600;201605;1529;4997;1339;4617;264;1106;655;2115;919;3221
354610;201605;381;1089;225;717;23;62;57;171;80;233
354620;201605;375;1204;296;1070;67;298;146;510;213;808
354625;201605;272;861;196;696;32;122;52;169;84;291
354630;201605;2018;6708;1783;6211;723;2662;244;784;967;3446
354640;201605;3320;10825;2645;9352;542;2223;510;1626;1052;3849
354650;201605;837;2504;727;2286;91;322;466;1451;557;1773
354660;201605;2249;6378;1685;5394;198;741;953;3004;1151;3745
354670;201605;1305;4121;1005;3401;243;903;211;629;454;1532
354680;201605;4294;13964;3893;13182;1022;3698;1610;5357;2632;9055
354690;201605;750;2413;501;1799;89;332;111;393;200;725
354700;201605;1138;3227;804;2528;144;535;332;906;476;1441
354710;201605;506;1517;395;1271;43;161;164;461;207;622
354720;201605;223;588;132;413;37;116;28;84;65;200
354730;201605;7763;25100;5986;21443;1290;5067;2391;8256;3681;13323
354740;201605;238;738;143;517;17;68;24;88;41;156
354750;201605;2285;6999;1783;6053;471;1783;603;1952;1074;3735
354760;201605;1862;5889;1519;5157;440;1596;189;624;629;2220
354765;201605;286;789;142;470;15;57;15;38;30;95
354770;201605;2251;6246;1714;5337;596;1988;459;1365;1055;3353
354780;201605;49903;139221;42484;123958;6804;22346;23202;63714;30006;86060
354790;201605;763;2513;685;2349;121;456;356;1165;477;1621
354800;201605;2065;6024;1825;5710;415;1480;911;2761;1326;4241
354805;201605;970;2919;707;2345;62;212;152;456;214;668
354810;201605;570;1844;365;1345;66;301;58;171;124;472
354820;201605;938;3208;803;2904;162;687;203;656;365;1343
354830;201605;392;1091;303;932;81;265;116;326;197;591
354840;201605;606;1701;480;1481;108;335;222;692;330;1027
354850;201605;16048;49039;11949;40832;2513;9609;4763;15020;7276;24629
354860;201605;1332;4159;1143;3844;232;888;429;1347;661;2235
354870;201605;43415;127731;38532;117788;8677;28392;16540;49501;25217;77893
354880;201605;4176;11480;2382;7736;347;1316;688;1850;1035;3166
354890;201605;15775;45659;13122;40945;2922;9882;5067;15229;7989;25111
354900;201605;412;1271;317;1067;65;230;68;221;133;451
354910;201605;6235;18595;3653;12978;581;2310;163;557;744;2867
354920;201605;405;1188;270;927;48;191;61;202;109;393
354925;201605;308;915;191;649;27;108;24;66;51;174
354930;201605;296;731;161;500;23;76;68;206;91;282
354940;201605;1800;6385;1487;5564;513;2059;163;568;676;2627
354950;201605;1419;4504;1219;4184;132;575;701;2334;833;2909
354960;201605;753;2341;656;2185;126;476;281;903;407;1379
354970;201605;3739;12196;3301;11291;572;2257;1761;5791;2333;8048
354980;201605;33088;82416;20356;61427;3437;11697;6517;18074;9954;29771
354990;201605;50195;145840;39813;125504;6867;23447;19191;58593;26058;82040
354995;201605;1686;5123;1422;4704;331;1131;701;2321;1032;3452
355000;201605;1364;4386;1211;4110;352;1380;232;679;584;2059
355010;201605;3472;10666;2690;8883;732;2535;800;2707;1532;5242
355020;201605;2800;9253;2148;7920;785;3182;446;1564;1231;4746
355030;201605;1062249;2902109;899782;2590653;196017;613554;389516;1072426;585533;1685980
355040;201605;2487;7611;2196;7110;494;1712;1202;3823;1696;5535
355050;201605;1116;3372;894;2952;284;946;137;439;421;1385
355060;201605;4227;14008;3443;12375;760;3064;961;3155;1721;6219
355070;201605;6303;19467;5568;18279;1153;4337;2688;8233;3841;12570
355080;201605;946;3252;675;2625;105;471;40;144;145;615
355090;201605;1082;3664;917;3307;163;627;355;1285;518;1912
355100;201605;16952;52704;14206;48141;3782;14139;6308;20757;10090;34896
355110;201605;1162;3754;997;3450;293;1098;216;727;509;1825
355120;201605;613;1930;512;1741;97;394;193;622;290;1016
355130;201605;610;1556;299;888;45;137;92;241;137;378
355140;201605;1095;3627;1041;3536;219;833;550;1909;769;2742
355150;201605;3224;9276;2693;8441;547;1777;1351;4298;1898;6075
355160;201605;1596;4964;1334;4533;410;1545;352;1143;762;2688
355170;201605;8189;22804;6199;19501;1988;6659;1461;4737;3449;11396
355180;201605;2772;8608;2274;7695;563;2235;699;2139;1262;4374
355190;201605;1245;4172;1061;3804;377;1455;338;1179;715;2634
355200;201605;735;2611;678;2490;276;1109;145;486;421;1595
355210;201605;2579;8153;2263;7496;375;1452;1222;3820;1597;5272
355220;201605;32474;97817;26556;86057;8687;29762;6063;18371;14750;48133
355230;201605;1386;3806;784;2492;138;458;177;499;315;957
355240;201605;25027;71173;17655;56339;3703;12505;5481;17062;9184;29567
355250;201605;26532;83760;22625;76259;6238;22455;8072;26604;14310;49059
355255;201605;842;2332;536;1718;95;323;135;413;230;736
355260;201605;1213;3535;1033;3229;224;801;427;1207;651;2008
355270;201605;1571;4557;1450;4367;131;429;1090;3271;1221;3700
355280;201605;24762;71941;20090;62998;3670;12817;8734;26126;12404;38943
355290;201605;898;2854;723;2429;143;490;223;692;366;1182
355300;201605;1179;3809;989;3413;195;721;319;1051;514;1772
355310;201605;976;2980;822;2686;148;524;405;1321;553;1845
355320;201605;570;1747;490;1582;82;321;189;530;271;851
355330;201605;1854;5686;1345;4670;279;1066;521;1755;800;2821
355340;201605;2460;6408;2208;5998;359;996;1339;3586;1698;4582
355350;201605;1292;4332;1039;3761;251;1005;259;881;510;1886
355360;201605;1097;3480;979;3242;152;536;625;2132;777;2668
355365;201605;301;877;200;703;42;152;47;166;89;318
355370;201605;7516;18444;5479;15922;1484;4663;2122;6563;3606;11226
355380;201605;3171;9499;2490;8016;521;1830;536;1468;1057;3298
355385;201605;802;2571;734;2446;241;867;228;698;469;1565
355390;201605;826;2369;626;1962;138;486;223;596;361;1082
355395;201605;1866;5577;1374;4449;203;678;577;1753;780;2431
355400;201605;8700;28512;7534;26098;2224;8358;2031;6741;4255;15099
355410;201605;16048;51882;12858;45525;3830;14861;2239;8054;6069;22915
355420;201605;708;2510;648;2389;203;828;158;586;361;1414
355430;201605;3408;9503;2817;8488;545;1752;1353;3929;1898;5681
355440;201605;909;2792;685;2302;125;439;203;632;328;1071
355450;201605;3673;10503;2137;7074;375;1291;602;1865;977;3156
355460;201605;585;1579;388;1225;80;302;111;284;191;586
355465;201605;333;1078;287;993;58;211;74;257;132;468
355470;201605;746;2308;612;2047;133;478;261;845;394;1323
355475;201605;152;530;143;504;36;129;67;231;103;360
355480;201605;2698;9368;2465;8897;580;2245;1132;3992;1712;6237
355490;201605;952;2727;618;2022;107;364;145;441;252;805
355495;201605;700;2330;612;2134;113;423;184;615;297;1038
355500;201605;7296;21043;4858;15828;776;2746;807;2474;1583;5220
355510;201605;1969;5277;1125;3581;153;580;324;910;477;1490
355520;201605;416;972;215;590;28;92;93;224;121;316
355530;201605;415;982;171;531;20;70;31;81;51;151
355535;201605;654;2005;525;1771;159;614;116;323;275;937
355540;201605;7903;24827;7442;24090;1888;6525;3767;11819;5655;18344
355550;201605;691;2094;593;1943;128;494;260;835;388;1329
355560;201605;1205;3599;773;2636;144;554;63;161;207;715
355570;201605;182;566;121;432;19;77;7;23;26;100
355580;201605;1241;3478;855;2689;145;513;315;997;460;1510
355590;201605;227;592;179;508;24;81;97;260;121;341
355600;201605;1111;3382;933;3015;285;996;278;842;563;1838
355610;201605;1533;4241;1189;3607;213;702;511;1496;724;2198
355620;201605;3883;12101;3149;10489;509;1941;1422;4398;1931;6339
355630;201605;3241;9236;2062;6886;387;1393;514;1714;901;3107
355635;201605;880;2886;761;2691;85;342;506;1814;591;2156
355640;201605;2892;9153;2114;7570;344;1377;222;748;566;2125
355645;201605;3254;10990;2884;10402;479;1926;1664;5980;2143;7906
355650;201605;6705;20229;5724;18438;1030;3815;3218;9677;4248;13492
355660;201605;1217;3837;977;3349;176;727;404;1294;580;2021
355670;201605;2639;8011;1922;6435;336;1290;787;2347;1123;3637
355680;201605;1634;5367;1202;4334;310;1205;169;588;479;1793
355690;201605;442;1389;333;1199;185;699;20;61;205;760
355695;201605;276;866;157;542;8;27;7;14;15;41
355700;201605;5160;16947;4397;15240;1065;3870;1618;5455;2683;9325
355710;201605;9956;24675;5984;17469;1352;4210;1411;3898;2763;8108
355715;201605;293;874;194;656;46;164;31;95;77;259
355720;201605;1514;5003;1251;4416;329;1258;360;1133;689;2391
355730;201605;790;2569;663;2281;213;738;153;523;366;1261
410010;201605;1358;4219;1171;3813;250;872;229;740;479;1612
410020;201605;1125;3665;972;3319;243;876;382;1287;625;2163
410030;201605;1109;3760;930;3311;213;821;158;551;371;1372
410040;201605;9229;30245;8060;27984;1932;7511;2288;7842;4220;15353
410045;201605;1006;2836;715;2284;156;516;149;449;305;965
410050;201605;2551;7041;1632;5240;404;1396;125;318;529;1714
410060;201605;2241;6810;1974;6305;405;1353;890;2895;1295;4248
410070;201605;1682;4758;1295;4012;393;1325;275;804;668;2129
410080;201605;1353;3839;1076;3346;177;638;455;1322;632;1960
410090;201605;978;3037;906;2889;204;738;322;1028;526;1766
410100;201605;2681;8138;2034;6646;422;1550;214;636;636;2186
410105;201605;370;1155;253;872;39;165;30;86;69;251
410110;201605;2751;7971;2198;6917;346;1201;664;2075;1010;3276
410115;201605;512;1384;400;1181;62;197;125;325;187;522
410120;201605;2394;8254;2230;7955;758;2880;701;2511;1459;5391
410130;201605;1022;3230;953;3057;422;1396;211;659;633;2055
410140;201605;16506;43176;11206;33790;2315;7582;2744;8000;5059;15582
410150;201605;15740;39665;8313;24857;1568;5032;1184;3228;2752;8260
410160;201605;2942;9031;2651;8528;674;2441;921;2977;1595;5418
410165;201605;706;2065;557;1717;118;379;221;623;339;1002
410170;201605;2227;6388;1713;5295;473;1629;261;770;734;2399
410180;201605;10412;32844;8938;29609;2029;7308;3444;10586;5473;17894
410185;201605;525;1457;390;1199;84;259;79;214;163;473
410190;201605;2021;5930;1595;4970;288;977;245;695;533;1672
410200;201605;3722;10420;2770;8593;566;1985;351;1044;917;3029
410210;201605;2544;7491;1871;6024;300;1138;392;1039;692;2177
410220;201605;644;1783;471;1462;78;281;142;436;220;717
410230;201605;1347;4229;1167;3881;266;1011;433;1414;699;2425
410240;201605;4236;12790;3836;11960;1242;4410;569;1657;1811;6067
410250;201605;2615;7198;1816;5550;404;1337;317;911;721;2248
410260;201605;1518;4457;1244;3985;267;926;489;1563;756;2489
410270;201605;544;1531;408;1257;59;199;159;465;218;664
410275;201605;839;2530;567;1906;77;281;249;843;326;1124
410280;201605;2204;6368;1633;5238;325;1192;441;1314;766;2506
410290;201605;3345;9924;2797;8882;658;2193;1050;3391;1708;5584
410300;201605;700;1952;589;1727;92;296;250;652;342;948
410302;201605;405;1094;263;838;28;93;128;424;156;517
410304;201605;1211;3850;1094;3603;306;1049;372;1274;678;2323
410305;201605;1833;5001;1497;4426;316;1040;775;2282;1091;3322
410310;201605;2248;7192;2026;6801;435;1619;745;2522;1180;4141
410315;201605;629;1837;411;1395;70;253;110;352;180;605
410320;201605;1187;3599;770;2627;102;412;61;178;163;590
410322;201605;527;1542;335;1121;55;181;83;282;138;463
410330;201605;1367;3744;1108;3248;239;729;283;821;522;1550
410335;201605;943;2794;813;2550;145;499;319;952;464;1451
410337;201605;799;2092;589;1706;81;277;200;517;281;794
410340;201605;516;1526;358;1114;44;156;140;381;184;537
410345;201605;1777;5168;1254;4030;283;970;300;944;583;1914
410347;201605;700;1890;491;1485;62;226;144;405;206;631
410350;201605;1031;3083;757;2527;143;538;138;401;281;939
410360;201605;3636;9978;2872;8622;428;1457;1364;3979;1792;5436
410370;201605;11692;34192;8591;26926;1487;5219;2312;6287;3799;11506
410380;201605;1292;3768;1167;3512;139;503;566;1662;705;2165
410390;201605;2437;7293;1977;6317;585;1990;455;1309;1040;3299
410395;201605;852;2818;753;2604;195;752;309;1064;504;1816
410400;201605;4420;13556;3752;12283;763;2801;1372;4334;2135;7135
410405;201605;840;2448;681;2153;148;526;228;711;376;1237
410410;201605;1267;3906;1220;3840;319;1233;539;1574;858;2807
410420;201605;6689;21597;5495;18911;1302;4865;674;1983;1976;6848
410425;201605;2682;8496;1911;6766;307;1147;171;586;478;1733
410430;201605;14069;37800;10197;30664;1919;6310;2818;8119;4737;14429
410440;201605;2730;8712;2434;8136;628;2305;927;3023;1555;5328
410442;201605;2622;8733;2310;8027;672;2428;618;2164;1290;4592
410445;201605;2291;7535;1976;6965;522;2064;593;2166;1115;4230
410450;201605;2045;5792;1591;4902;420;1362;164;402;584;1764
410460;201605;1866;5496;1466;4718;367;1203;282;864;649;2067
410465;201605;2011;6608;1693;5917;366;1401;606;2001;972;3402
410470;201605;1683;5418;1365;4711;280;1106;302;1032;582;2138
410480;201605;29281;82457;18759;60371;3261;11238;1750;4847;5011;16085
410490;201605;10771;33345;8367;28313;1926;7317;2084;6434;4010;13751
410500;201605;1516;4770;1227;4115;441;1658;222;673;663;2331
410510;201605;2459;6435;1731;5020;322;936;601;1612;923;2548
410520;201605;3045;10490;2859;10117;837;3138;1122;4014;1959;7152
410530;201605;1531;4203;1089;3291;199;646;271;773;470;1419
410540;201605;3009;8868;2107;6952;402;1378;579;1890;981;3268
410550;201605;5957;17220;4162;13318;756;2667;506;1493;1262;4160
410560;201605;1228;3616;946;3044;210;770;248;692;458;1462
410570;201605;2584;8227;2327;7794;643;2314;725;2733;1368;5047
410580;201605;20815;62615;16993;55047;4036;14428;4625;13977;8661;28405
410590;201605;1344;4140;857;2858;123;416;168;501;291;917
410600;201605;1810;5282;1451;4586;363;1150;500;1610;863;2760
410610;201605;761;2139;596;1822;74;233;218;653;292;886
410620;201605;1670;5648;1243;4593;276;1116;108;384;384;1500
410630;201605;2438;7177;1722;5577;379;1360;202;531;581;1891
410640;201605;4451;12233;3305;10066;825;2918;476;1346;1301;4264
410645;201605;1108;3840;1040;3734;496;1869;202;770;698;2639
410650;201605;2072;6393;1667;5541;516;1825;227;709;743;2534
410655;201605;837;2372;629;1966;102;381;212;617;314;998
410657;201605;740;2054;529;1615;101;352;168;439;269;791
410660;201605;2727;7824;1591;5259;333;1171;161;475;494;1646
410670;201605;928;2537;615;1866;111;358;169;466;280;824
410680;201605;2861;9288;2326;7993;675;2247;580;2169;1255;4416
410685;201605;637;1826;547;1672;72;243;319;956;391;1199
410690;201605;112890;323927;79972;255681;15785;55614;17492;48898;33277;104512
410700;201605;2192;6594;2006;6246;519;1707;800;2397;1319;4104
410710;201605;891;2618;617;2028;137;468;135;385;272;853
410712;201605;801;2401;691;2188;250;859;165;528;415;1387
410715;201605;898;2848;668;2291;122;463;176;555;298;1018
410720;201605;3237;9507;2378;7703;454;1667;452;1304;906;2971
410725;201605;1054;2976;751;2390;110;344;112;321;222;665
410730;201605;511;1437;413;1276;120;402;97;323;217;725
410740;201605;914;2702;656;2178;98;378;268;864;366;1242
410750;201605;1787;5201;1468;4527;293;994;449;1302;742;2296
410752;201605;308;842;160;518;35;123;42;117;77;240
410753;201605;415;1196;260;838;35;133;74;217;109;350
410754;201605;1080;3183;916;2908;63;199;589;2009;652;2208
410755;201605;800;1982;604;1674;81;263;342;893;423;1156
410760;201605;2367;7158;2038;6551;535;1889;568;1792;1103;3681
410765;201605;14927;44571;11308;37462;1767;6572;767;2474;2534;9046
410770;201605;908;2499;645;1969;161;535;104;302;265;837
410773;201605;1303;3722;1138;3466;165;584;732;2166;897;2750
410775;201605;1397;4022;1289;3870;303;1008;456;1348;759;2356
410780;201605;531;1441;373;1142;90;270;105;369;195;639
410785;201605;737;2332;619;2063;180;660;145;476;325;1136
410790;201605;437;1417;387;1289;99;339;31;70;130;409
410800;201605;2798;6996;2187;5965;381;1225;747;1882;1128;3107
410810;201605;333;1020;281;914;50;187;97;306;147;493
410820;201605;820;2449;614;1981;142;501;86;257;228;758
410830;201605;30215;85507;24066;74960;6639;22985;7460;22290;14099;45275
410832;201605;981;2849;854;2604;90;334;484;1407;574;1741
410840;201605;6565;19169;4317;14347;858;3070;287;741;1145;3811
410845;201605;1220;3613;1037;3245;214;733;401;1224;615;1957
410850;201605;2687;7926;2403;7474;527;1812;958;3031;1485;4843
410855;201605;572;1593;414;1263;63;199;139;407;202;606
410860;201605;3562;10221;2878;8812;553;1835;896;2626;1449;4461
410865;201605;1467;4949;1398;4818;358;1332;762;2698;1120;4030
410870;201605;1203;3653;1120;3521;190;633;722;2300;912;2933
410880;201605;3647;11544;3034;10258;582;2191;509;1674;1091;3865
410890;201605;890;2905;704;2510;176;708;64;213;240;921
410895;201605;1066;3661;951;3403;336;1291;203;683;539;1974
410900;201605;923;2522;603;1897;87;294;173;502;260;796
410910;201605;403;1063;308;893;34;109;157;443;191;552
410920;201605;809;2238;644;1964;165;578;205;607;370;1185
410930;201605;1611;4752;1354;4246;338;1245;405;1238;743;2483
410940;201605;20368;65033;17332;59413;5188;19342;3714;12799;8902;32141
410950;201605;1735;5661;1607;5434;185;670;1158;3919;1343;4589
410960;201605;7243;19960;4551;14835;1311;4737;817;2473;2128;7210
410965;201605;1041;3157;868;2824;227;759;335;1080;562;1839
410970;201605;4423;12965;3462;11095;914;3369;543;1673;1457;5042
410975;201605;1600;4560;1268;3922;216;772;446;1326;662;2098
410980;201605;5646;15825;3628;11820;672;2434;780;2429;1452;4863
410990;201605;892;2586;557;1857;165;605;58;147;223;752
411000;201605;480;1444;336;1117;49;181;64;176;113;357
411005;201605;480;1411;294;961;56;196;30;82;86;278
411007;201605;2261;7058;1942;6391;561;1965;538;1749;1099;3714
411010;201605;3873;13189;3483;12318;903;3488;438;1502;1341;4990
411020;201605;2501;7680;2172;7134;695;2529;632;2006;1327;4535
411030;201605;651;1750;472;1411;67;220;117;326;184;546
411040;201605;659;1904;302;1018;49;181;55;187;104;368
411050;201605;1967;6769;1767;6331;490;1941;242;777;732;2718
411060;201605;1488;4480;1162;3762;226;846;132;379;358;1225
411065;201605;363;1074;288;927;49;160;100;313;149;473
411070;201605;5736;17045;4516;14584;1167;4171;922;2696;2089;6867
411080;201605;2122;6323;1886;5886;442;1525;464;1398;906;2923
411090;201605;816;2013;562;1621;65;241;112;290;177;531
411095;201605;1482;4208;1123;3472;153;531;270;759;423;1290
411100;201605;1298;3746;941;3000;155;614;159;451;314;1065
411110;201605;584;1715;318;1082;37;142;28;80;65;222
411120;201605;1599;4828;1215;3986;299;1132;357;1063;656;2195
411125;201605;4120;13427;3923;13043;1122;3957;1418;4695;2540;8652
411130;201605;679;2019;511;1653;112;389;129;453;241;842
411140;201605;2127;7262;1816;6521;475;1797;643;2374;1118;4171
411150;201605;4034;11337;3071;9425;654;2181;389;1032;1043;3213
411155;201605;915;2487;669;2032;92;317;270;783;362;1100
411160;201605;236;668;183;570;38;125;42;117;80;242
411170;201605;689;2164;564;1869;124;452;180;568;304;1020
411180;201605;5544;16480;4524;14546;975;3465;1434;4602;2409;8067
411190;201605;1383;3957;1151;3513;283;985;229;603;512;1588
411200;201605;4207;12384;3367;10913;839;3050;986;3035;1825;6085
411210;201605;1920;5496;1527;4788;386;1338;162;452;548;1790
411220;201605;1096;3075;877;2680;203;730;305;813;508;1543
411230;201605;1231;3432;794;2566;151;524;239;744;390;1268
411240;201605;1417;3424;791;2335;134;416;247;665;381;1081
411250;201605;2145;6283;1778;5613;476;1654;424;1352;900;3006
411260;201605;303;823;202;647;26;84;79;242;105;326
411270;201605;1727;5344;1525;4961;263;1001;672;2080;935;3081
411275;201605;1304;3846;1061;3313;254;826;222;653;476;1479
411280;201605;1482;4320;1020;3343;176;618;183;569;359;1187
411290;201605;740;2159;564;1798;137;462;138;426;275;888
411295;201605;960;2670;858;2468;148;458;325;961;473;1419
411300;201605;1214;3088;848;2395;80;244;311;822;391;1066
411310;201605;836;2252;654;1956;69;250;210;611;279;861
411320;201605;5349;15414;3973;12838;1010;3428;657;1922;1667;5350
411325;201605;1513;4732;1321;4328;274;957;621;2077;895;3034
411330;201605;3044;9386;2564;8447;801;2931;582;1938;1383;4869
411340;201605;924;2707;595;1930;55;208;198;608;253;816
411342;201605;707;2014;580;1751;154;497;188;522;342;1019
411345;201605;884;2747;791;2573;207;753;329;1050;536;1803
411350;201605;2658;7957;1961;6517;509;1879;188;606;697;2485
411360;201605;555;1389;372;1070;51;182;158;394;209;576
411370;201605;44338;124507;34954;107187;5446;19181;14316;40753;19762;59934
411373;201605;1465;4499;1268;4142;254;942;297;981;551;1923
411375;201605;1113;3052;819;2482;154;481;209;601;363;1082
411380;201605;1206;3288;710;2138;116;367;186;507;302;874
411390;201605;1802;5288;1480;4615;271;935;399;1113;670;2048
411400;201605;2080;5909;1598;4902;304;1017;411;1188;715;2205
411410;201605;1994;6015;1555;5013;334;1185;368;1049;702;2234
411420;201605;3960;11211;2719;8588;373;1325;393;1005;766;2330
411430;201605;3157;9425;2632;8567;636;2274;1207;3840;1843;6114
411435;201605;423;1387;357;1220;80;293;138;456;218;749
411440;201605;2623;8436;2325;7825;705;2498;484;1749;1189;4247
411450;201605;2271;6912;2059;6505;416;1318;980;3249;1396;4567
411460;201605;3210;9330;1763;6024;259;974;94;292;353;1266
411470;201605;809;2423;548;1804;81;293;70;197;151;490
411480;201605;4409;13229;3323;11145;835;3122;436;1367;1271;4489
411490;201605;1429;4331;1205;3921;240;838;267;799;507;1637
411500;201605;1824;4821;1261;3819;232;788;346;1028;578;1816
411510;201605;1994;5982;1625;5214;419;1484;254;739;673;2223
411520;201605;25963;70548;15925;49670;2722;9148;3168;9324;5890;18472
411530;201605;1010;2808;731;2323;164;613;123;338;287;951
411535;201605;503;1542;275;996;30;135;21;65;51;200
411540;201605;2959;7996;2149;6343;489;1621;565;1497;1054;3118
411545;201605;966;3185;867;2997;146;534;532;1897;678;2431
411550;201605;787;2108;630;1865;210;688;115;344;325;1032
411560;201605;2339;6891;1669;5364;272;974;153;422;425;1396
411570;201605;6668;17682;4944;14919;1123;3881;997;3088;2120;6969
411573;201605;846;2499;792;2408;132;412;468;1464;600;1876
411575;201605;1538;4728;1289;4200;266;905;421;1386;687;2291
411580;201605;3875;11008;2611;8490;301;1191;329;916;630;2107
411585;201605;727;2338;399;1408;87;308;65;226;152;534
411590;201605;358;1094;311;1015;45;174;134;408;179;582
411600;201605;307;874;213;722;49;183;80;280;129;463
411605;201605;1678;4614;1168;3559;183;630;419;1255;602;1885
411610;201605;2148;6011;1742;5229;351;1162;797;2305;1148;3467
411620;201605;2646;8306;2412;7926;631;2247;1074;3577;1705;5824
411630;201605;501;1307;314;1029;54;225;49;140;103;365
411640;201605;457;1391;360;1177;55;183;111;330;166;513
411650;201605;190;618;152;545;31;130;28;95;59;225
411660;201605;892;2380;673;1988;97;300;311;907;408;1207
411670;201605;1088;3043;893;2624;182;573;293;811;475;1384
411680;201605;1407;4214;1243;3919;236;799;626;2020;862;2819
411690;201605;3282;9600;2593;8322;664;2215;545;1862;1209;4077
411695;201605;778;2528;627;2191;136;520;184;648;320;1168
411700;201605;1692;4897;1200;3898;222;792;174;504;396;1296
411705;201605;1851;6390;1622;5930;372;1333;793;3100;1165;4433
411710;201605;1642;4825;1335;4202;335;1133;207;653;542;1786
411720;201605;878;2475;681;2076;91;311;193;529;284;840
411721;201605;719;2130;588;1865;156;524;62;180;218;704
411722;201605;659;1970;443;1477;93;366;103;292;196;658
411725;201605;1376;4406;878;3140;189;698;140;518;329;1216
411727;201605;1781;5236;1334;4268;333;1099;232;729;565;1828
411729;201605;577;1510;404;1184;119;354;63;146;182;500
411730;201605;5465;15680;4543;13898;1584;4898;1106;3365;2690;8263
411740;201605;640;1817;405;1295;65;224;126;376;191;600
411745;201605;891;2559;738;2252;144;467;233;716;377;1183
411750;201605;4722;14012;3605;11495;691;2400;1083;3318;1774;5718
411760;201605;7638;22272;6566;20432;2092;6918;1524;4827;3616;11745
411770;201605;3330;10882;2763;9582;774;2901;475;1567;1249;4468
411780;201605;2814;8665;2574;8259;494;1731;1479;4924;1973;6655
411790;201605;3231;9173;2328;7313;602;2123;531;1596;1133;3719
411800;201605;1151;3294;799;2553;118;418;113;320;231;738
411810;201605;1638;4696;1348;4119;260;871;481;1355;741;2226
411820;201605;13263;42614;11155;38249;3786;13453;2354;8249;6140;21702
411830;201605;516;1342;388;1120;101;337;11;43;112;380
411840;201605;10211;29104;7590;24050;1684;5842;1286;4014;2970;9856
411845;201605;501;1531;314;1038;49;175;40;114;89;289
411850;201605;6918;20589;5711;18087;1396;4812;1406;4324;2802;9136
411860;201605;875;2666;705;2300;164;562;217;668;381;1230
411870;201605;853;2754;586;2036;109;444;105;314;214;758
411880;201605;2244;6433;1787;5633;436;1592;339;958;775;2550
411885;201605;888;2449;739;2191;124;453;229;628;353;1081
411890;201605;1074;3278;732;2464;119;465;53;133;172;598
411900;201605;943;2951;670;2286;145;497;92;319;237;816
411910;201605;1194;3938;924;3280;256;965;196;638;452;1603
411915;201605;16098;43965;10341;32524;1865;6339;2101;6006;3966;12345
411920;201605;844;2855;736;2596;184;760;72;198;256;958
411925;201605;599;1707;398;1320;88;291;92;283;180;574
411930;201605;5858;19127;5143;17698;2281;8380;656;2199;2937;10579
411940;201605;3159;10514;2739;9606;678;2482;552;1895;1230;4377
411950;201605;11748;37109;10019;33727;2328;8420;4300;14229;6628;22649
411960;201605;5366;15858;4958;15103;1045;3578;2022;5976;3067;9554
411965;201605;570;1628;410;1353;71;283;117;403;188;686
411970;201605;732;2065;612;1878;163;509;247;841;410;1350
411980;201605;1636;4886;1413;4441;312;1045;428;1349;740;2394
411990;201605;29211;93268;24139;82472;6050;22866;6443;21204;12493;44070
411995;201605;2416;7357;2047;6686;617;2268;440;1320;1057;3588
412000;201605;2176;5506;1678;4668;246;826;814;2042;1060;2868
412010;201605;702;2362;562;2045;90;348;116;391;206;739
412015;201605;640;1884;522;1645;88;287;242;761;330;1048
412020;201605;357;1046;238;776;42;143;63;190;105;333
412030;201605;700;2184;502;1732;76;302;114;374;190;676
412033;201605;779;2272;540;1708;80;285;129;390;209;675
412035;201605;978;2721;643;2101;126;432;207;678;333;1110
412040;201605;571;1790;450;1525;76;266;101;341;177;607
412050;201605;1713;4919;1308;4129;213;738;302;912;515;1650
412060;201605;6754;22957;6141;21739;1902;7308;1631;5688;3533;12996
412065;201605;805;2407;625;2023;125;446;167;495;292;941
412070;201605;1340;3599;984;2861;144;459;340;975;484;1434
412080;201605;1315;4091;819;2940;90;355;20;71;110;426
412085;201605;440;1263;151;519;21;74;21;66;42;140
412090;201605;4370;13528;4089;13026;769;2564;2227;7335;2996;9899
412100;201605;1893;5833;1547;5145;445;1622;341;1136;786;2758
412110;201605;1070;3009;721;2280;156;514;124;410;280;924
412120;201605;1683;5697;1452;5174;381;1518;415;1296;796;2814
412125;201605;629;2044;573;1937;132;479;200;641;332;1120
412130;201605;589;1759;431;1398;101;359;59;174;160;533
412135;201605;467;1312;304;971;62;203;90;277;152;480
412140;201605;1550;4637;1277;4068;275;933;229;678;504;1611
412150;201605;2867;8275;2479;7493;340;1136;1449;4283;1789;5419
412160;201605;1149;3641;736;2578;168;657;77;232;245;889
412170;201605;4479;13748;3682;12206;986;3559;1250;3929;2236;7488
412175;201605;1409;4662;1221;4253;258;1005;542;1868;800;2873
412180;201605;1628;4965;1212;4167;269;1056;338;1088;607;2144
412190;201605;3178;8986;2407;7616;517;1846;695;2301;1212;4147
412200;201605;2102;6689;1518;5188;291;1066;432;1481;723;2547
412210;201605;674;1850;405;1292;58;211;34;81;92;292
412215;201605;3557;10866;3190;10216;738;2374;1704;5646;2442;8020
412217;201605;1070;3010;945;2791;114;424;625;1729;739;2153
412220;201605;5552;18091;5293;17617;1560;5285;2386;8109;3946;13394
412230;201605;2751;9034;2392;8304;490;1922;645;2067;1135;3989
412240;201605;8652;21969;5046;15308;869;2959;875;2389;1744;5348
412250;201605;1863;5432;1578;4866;375;1231;194;494;569;1725
412260;201605;1313;3601;856;2633;117;410;290;800;407;1210
412265;201605;997;3034;880;2835;224;818;349;1121;573;1939
412270;201605;840;2646;559;1937;93;362;159;507;252;869
412280;201605;609;1878;451;1535;140;520;24;58;164;578
412290;201605;1008;2871;769;2421;135;475;237;675;372;1150
412300;201605;1848;5548;1558;4999;389;1361;328;991;717;2352
412310;201605;999;2901;873;2706;115;426;432;1375;547;1801
412320;201605;850;2256;616;1850;102;372;200;588;302;960
412330;201605;1508;4326;1146;3572;188;660;497;1535;685;2195
412340;201605;939;2917;630;2131;81;287;91;276;172;563
412350;201605;2168;6706;1709;5713;333;1176;100;269;433;1445
412360;201605;293;862;181;584;20;81;58;162;78;243
412370;201605;911;2682;678;2256;149;549;126;413;275;962
412380;201605;1483;4727;1222;4084;294;1047;238;774;532;1821
412382;201605;661;1847;458;1427;76;246;90;241;166;487
412385;201605;2356;7259;2095;6662;694;2309;454;1422;1148;3731
412390;201605;2095;5955;1875;5599;482;1580;723;2220;1205;3800
412395;201605;803;2272;632;1982;81;281;336;1021;417;1302
412400;201605;897;2818;762;2522;200;708;157;534;357;1242
412402;201605;1825;5392;1468;4670;337;1204;274;784;611;1988
412405;201605;3525;10187;2192;7217;335;1257;107;311;442;1568
412410;201605;4815;14614;3942;12930;1081;4106;680;2113;1761;6219
412420;201605;354;1041;244;782;38;127;74;196;112;323
412430;201605;546;1522;393;1221;54;181;140;413;194;594
412440;201605;3184;9672;2533;8498;548;2032;677;2292;1225;4324
412450;201605;298;958;224;760;30;96;20;46;50;142
412460;201605;722;2245;598;1970;163;583;111;356;274;939
412470;201605;1827;6186;1553;5481;509;1881;296;1106;805;2987
412480;201605;1150;3457;826;2666;133;459;89;208;222;667
412490;201605;870;2581;736;2313;135;435;196;600;331;1035
412500;201605;1920;5519;1586;4852;288;1008;355;941;643;1949
412510;201605;2212;7170;1820;6222;553;2063;474;1562;1027;3625
412520;201605;1495;4205;1114;3432;276;894;191;546;467;1440
412530;201605;597;1761;464;1448;90;289;91;271;181;560
412535;201605;715;2085;478;1525;98;328;106;315;204;643
412540;201605;1216;3482;958;2963;132;486;254;770;386;1256
412545;201605;753;2156;564;1743;95;335;155;397;250;732
412550;201605;28704;86034;20061;66642;4414;15700;3873;12113;8287;27813
412555;201605;256;770;174;577;30;100;34;93;64;193
412560;201605;5162;15731;4015;13263;737;2911;1064;3338;1801;6249
412570;201605;4152;12154;2814;9275;616;2265;424;1421;1040;3686
412575;201605;860;2621;670;2167;131;480;191;558;322;1038
412580;201605;1201;3323;858;2658;143;466;272;784;415;1250
412590;201605;424;1230;270;883;51;183;66;210;117;393
412600;201605;1396;4235;1064;3493;215;764;260;792;475;1556
412610;201605;717;2135;460;1469;113;378;106;303;219;681
412620;201605;1187;3775;942;3243;218;868;131;380;349;1248
412625;201605;9569;27390;7224;22799;1410;4782;808;2400;2218;7182
412627;201605;913;2834;645;2205;191;721;55;175;246;896
412630;201605;3239;10232;2585;8787;516;1779;695;2296;1211;4075
412635;201605;466;1368;322;1049;68;226;13;24;81;250
412640;201605;875;2627;580;1934;79;271;40;117;119;388
412650;201605;1695;5032;1422;4508;273;991;402;1154;675;2145
412660;201605;2699;7772;2126;6605;410;1406;417;1157;827;2563
412665;201605;632;1649;356;1106;86;273;69;203;155;476
412667;201605;1652;4783;1296;4076;270;910;293;852;563;1762
412670;201605;537;1669;416;1417;104;397;63;196;167;593
412680;201605;1319;3953;826;2851;128;485;154;466;282;951
412690;201605;776;2321;585;1906;157;542;102;331;259;873
412700;201605;1820;5535;1527;5086;515;1952;374;1193;889;3145
412710;201605;6817;21398;5762;19246;1208;4505;1277;3945;2485;8450
412720;201605;1351;4164;959;3204;150;546;155;418;305;964
412730;201605;2058;6158;1252;4304;233;867;111;332;344;1199
412740;201605;1391;4410;1050;3652;228;885;136;521;364;1406
412750;201605;3972;12052;3547;11348;459;1763;2166;6821;2625;8584
412760;201605;2327;7416;2184;7156;390;1487;1248;3955;1638;5442
412770;201605;10863;29782;6242;19999;837;2922;1010;2845;1847;5767
412780;201605;1250;3877;1074;3514;236;842;355;1117;591;1959
412785;201605;2299;6489;1729;5330;478;1525;715;2240;1193;3765
412788;201605;1373;4380;1197;4018;294;1121;323;978;617;2099
412790;201605;1103;3280;812;2654;151;548;155;413;306;961
412795;201605;908;2531;725;2175;139;438;256;764;395;1202
412796;201605;2671;8215;2450;7804;578;2056;911;2714;1489;4770
412800;201605;2962;8499;2320;7123;363;1230;797;2339;1160;3569
412810;201605;11019;29865;6467;20159;831;2906;1333;3415;2164;6321
412820;201605;7219;21014;5353;17373;1182;4082;1199;3921;2381;8003
412830;201605;338;1057;267;886;43;164;63;177;106;341
412840;201605;1773;5077;1426;4366;252;850;278;833;530;1683
412850;201605;2802;8209;2292;7336;449;1657;754;2258;1203;3915
412853;201605;1684;4850;1492;4468;154;535;783;2187;937;2722
412855;201605;1458;4205;1130;3477;238;795;266;709;504;1504
412860;201605;1176;3356;961;2971;237;814;374;1134;611;1948
412862;201605;751;1927;506;1492;69;225;138;396;207;621
412863;201605;1162;3949;1130;3893;179;684;766;2589;945;3273
412865;201605;694;2116;518;1721;112;386;164;573;276;959
412870;201605;898;2537;711;2223;253;899;115;325;368;1224
412880;201605;869;2517;679;2142;144;505;72;183;216;688
420005;201605;534;1590;331;1130;52;185;107;360;159;545
420010;201605;3136;8837;2515;7959;356;1170;1681;5438;2037;6608
420020;201605;744;2409;422;1561;39;168;43;155;82;323
420030;201605;500;1299;254;838;45;180;27;85;72;265
420040;201605;714;2274;449;1698;81;332;27;87;108;419
420050;201605;688;1993;461;1521;122;427;153;509;275;936
420055;201605;204;624;118;414;19;73;19;63;38;136
420060;201605;242;785;164;594;22;101;30;80;52;181
420070;201605;1346;4243;1023;3457;171;664;375;1238;546;1902
420075;201605;170;449;89;271;16;54;15;38;31;92
420080;201605;589;1848;472;1620;147;544;115;392;262;936
420090;201605;471;1557;327;1239;76;309;51;204;127;513
420100;201605;1195;3723;1063;3540;243;838;588;1975;831;2813
420110;201605;323;1095;292;1022;63;229;104;367;167;596
420120;201605;259;902;207;783;62;262;33;116;95;378
420125;201605;255;934;226;869;60;245;90;325;150;570
420127;201605;543;1587;206;749;46;180;20;69;66;249
420130;201605;1820;6101;1467;5393;347;1407;291;971;638;2378
420140;201605;4479;13147;3175;10623;682;2531;408;1217;1090;3748
420150;201605;726;2034;441;1476;73;263;153;483;226;746
420160;201605;271;741;163;530;26;87;45;142;71;229
420165;201605;215;672;132;458;25;92;25;84;50;176
420170;201605;198;607;135;483;44;181;14;44;58;225
420180;201605;404;1235;225;817;37;139;43;146;80;285
420190;201605;458;1298;238;811;37;142;14;41;51;183
420195;201605;1307;3806;1063;3411;246;849;296;913;542;1762
420200;201605;2479;7737;1455;5375;248;1069;156;527;404;1596
420205;201605;965;3148;811;2876;181;696;416;1493;597;2189
420207;201605;1530;4467;1066;3523;284;1069;212;651;496;1720
420208;201605;570;1571;310;1106;97;373;57;227;154;600
420209;201605;315;963;203;698;31;120;75;249;106;369
420210;201605;1692;5135;1116;4185;280;1243;353;1267;633;2510
420213;201605;775;2787;730;2682;160;626;403;1495;563;2121
420215;201605;323;1040;216;784;53;199;18;74;71;273
420220;201605;158;566;128;500;29;123;32;117;61;240
420230;201605;4204;12157;3095;10195;579;2272;1175;3720;1754;5992
420240;201605;10589;29298;6654;21871;1038;4069;2594;7687;3632;11756
420243;201605;591;1798;469;1554;87;310;165;534;252;844
420245;201605;1115;3393;774;2663;119;462;233;740;352;1202
420250;201605;523;1674;472;1575;128;509;189;591;317;1100
420253;201605;496;1315;374;1150;49;150;218;699;267;849
420257;201605;307;851;194;643;36;120;92;308;128;428
420260;201605;1206;3792;987;3390;203;787;380;1294;583;2081
420270;201605;596;1812;201;719;30;124;47;145;77;269
420280;201605;2210;5989;1355;4443;263;945;436;1363;699;2308
420285;201605;149;442;71;266;11;47;3;15;14;62
420287;201605;524;1561;433;1416;128;433;131;436;259;869
420290;201605;6151;18222;4125;13601;754;2643;1150;3555;1904;6198
420300;201605;6638;19900;4304;14914;855;3243;654;2163;1509;5406
420310;201605;767;2087;674;1942;108;341;471;1324;579;1665
420315;201605;958;3031;745;2607;209;783;233;797;442;1580
420320;201605;4747;14530;3865;12969;1076;3941;1335;4464;2411;8405
420325;201605;237;792;209;726;41;157;75;250;116;407
420330;201605;976;3357;712;2700;159;664;163;557;322;1221
420340;201605;1433;4408;1082;3615;186;706;112;326;298;1032
420350;201605;1457;4331;1069;3577;282;994;364;1210;646;2204
420360;201605;3032;9181;1881;6668;373;1505;145;435;518;1940
420370;201605;1836;5239;1435;4548;164;537;1005;3162;1169;3699
420380;201605;5045;15409;3390;11628;784;2897;726;2432;1510;5329
420390;201605;1412;3940;736;2507;115;456;112;307;227;763
420395;201605;1383;4246;960;3289;118;473;116;346;234;819
420400;201605;1250;3595;868;2855;209;799;185;533;394;1332
420410;201605;751;2007;522;1631;108;381;298;915;406;1296
420415;201605;459;1435;332;1132;92;338;89;297;181;635
420417;201605;710;2270;586;1968;97;331;284;962;381;1293
420419;201605;365;1104;238;853;78;315;17;67;95;382
420420;201605;10605;31877;8444;27732;2863;10396;1865;5644;4728;16040
420425;201605;1216;3274;842;2575;75;300;374;1066;449;1366
420430;201605;3276;9924;2081;7102;430;1580;598;2081;1028;3661
420435;201605;297;873;180;612;39;145;72;231;111;376
420440;201605;901;2782;510;1772;205;763;86;284;291;1047
420445;201605;368;1083;254;812;53;174;85;268;138;442
420450;201605;804;2431;538;1846;109;402;101;331;210;733
420455;201605;1924;5727;1649;5264;283;1116;772;2340;1055;3456
420460;201605;8663;25106;6540;21353;1412;5309;2346;7236;3758;12545
420470;201605;1057;2841;645;2026;140;495;174;500;314;995
420475;201605;122;357;64;220;17;55;7;23;24;78
420480;201605;4839;14000;3542;11572;978;3447;655;2122;1633;5569
420490;201605;649;1687;350;1181;78;294;75;254;153;548
420500;201605;1530;4848;1167;4135;345;1367;364;1288;709;2655
420510;201605;85;328;74;312;18;84;34;137;52;221
420515;201605;106;356;84;312;13;57;16;59;29;116
420517;201605;836;2599;736;2428;137;506;398;1264;535;1770
420519;201605;550;1437;393;1166;61;191;105;296;166;487
420520;201605;644;1606;385;1220;74;247;106;279;180;526
420530;201605;1046;3460;770;2837;174;744;167;555;341;1299
420535;201605;255;732;134;476;31;109;3;16;34;125
420540;201605;20437;57953;14669;45891;3360;11518;3583;9683;6943;21201
420543;201605;390;1028;303;889;23;81;186;585;209;666
420545;201605;1519;4768;1217;4106;269;1019;363;1149;632;2168
420550;201605;4081;12830;2981;10558;725;3050;498;1614;1223;4664
420555;201605;356;1078;264;885;64;240;78;247;142;487
420560;201605;526;1517;387;1267;69;250;189;603;258;853
420570;201605;2113;6679;1630;5596;411;1623;512;1611;923;3234
420580;201605;1436;4393;1143;3890;273;1054;457;1517;730;2571
420590;201605;3147;9425;2071;6945;377;1375;307;920;684;2295
420600;201605;871;2841;791;2680;117;415;444;1567;561;1982
420610;201605;510;1552;281;1031;66;283;61;219;127;502
420620;201605;550;1687;488;1563;121;417;139;449;260;866
420630;201605;991;3038;704;2369;145;522;235;744;380;1266
420640;201605;786;2356;380;1392;78;329;19;58;97;387
420650;201605;2517;7334;1597;5443;244;913;384;1227;628;2140
420660;201605;459;1326;325;1046;59;215;100;314;159;529
420665;201605;687;1936;443;1467;66;242;118;348;184;590
420670;201605;1635;4793;1142;3776;218;850;277;827;495;1677
420675;201605;206;659;147;521;28;98;38;131;66;229
420680;201605;506;1190;290;859;43;144;95;268;138;412
420690;201605;852;2918;631;2324;111;414;95;306;206;720
420700;201605;3129;9145;2391;7685;477;1727;713;2145;1190;3872
420710;201605;581;1950;440;1640;112;473;134;487;246;960
420720;201605;1708;4838;1314;4323;338;1183;643;2120;981;3303
420730;201605;3224;9593;2602;8500;619;2216;990;3105;1609;5321
420740;201605;827;2552;679;2279;226;829;243;755;469;1584
420750;201605;2311;7378;1674;5886;265;1081;481;1539;746;2620
420757;201605;103;241;43;148;7;29;19;67;26;96
420760;201605;359;1114;201;676;37;135;36;102;73;237
420765;201605;566;1790;297;1111;54;233;55;191;109;424
420768;201605;1158;4010;899;3463;344;1346;278;1116;622;2462
420770;201605;626;1802;339;1232;69;296;64;228;133;524
420775;201605;631;1869;369;1227;76;269;58;170;134;439
420780;201605;1513;4534;910;3075;172;593;133;415;305;1008
420785;201605;272;827;195;638;32;112;42;126;74;238
420790;201605;1269;4309;997;3694;286;1160;331;1161;617;2321
420800;201605;848;2416;409;1392;93;340;78;265;171;605
420810;201605;2008;6760;1585;5830;476;1993;311;1028;787;3021
420820;201605;8015;23728;5494;19449;1338;5354;1231;4265;2569;9619
420830;201605;2563;8066;2094;7186;611;2286;699;2385;1310;4671
420840;201605;997;2942;490;1763;108;460;73;222;181;682
420845;201605;1304;3903;924;3236;244;999;181;595;425;1594
420850;201605;1603;4973;968;3616;207;888;63;210;270;1098
420860;201605;451;1267;275;932;71;277;71;242;142;519
420870;201605;1121;3106;874;2716;292;1057;220;579;512;1636
420880;201605;1003;3320;773;2730;145;554;125;402;270;956
420890;201605;10246;26977;5187;16972;821;2928;1153;3310;1974;6238
420895;201605;244;664;128;417;37;118;11;31;48;149
420900;201605;1845;5187;1177;3885;223;853;289;876;512;1729
420910;201605;23704;69969;16057;54733;2872;11069;4539;14326;7411;25395
420915;201605;556;2200;408;1757;88;405;161;647;249;1052
420917;201605;473;1460;214;724;39;154;76;219;115;373
420920;201605;182;501;70;239;10;38;12;46;22;84
420930;201605;17756;50857;13824;44195;2979;10597;5085;15705;8064;26302
420940;201605;2823;8479;2160;7143;558;2031;170;476;728;2507
420945;201605;199;610;129;448;22;96;29;85;51;181
420950;201605;623;1749;290;1068;39;198;40;134;79;332
420960;201605;913;2606;729;2289;140;485;305;912;445;1397
420970;201605;2476;7741;2044;6951;618;2356;523;1739;1141;4095
420980;201605;461;1336;339;1134;118;441;109;400;227;841
420985;201605;499;1421;234;841;43;192;47;141;90;333
420990;201605;881;2361;483;1625;75;278;91;252;166;530
421000;201605;557;1863;358;1352;70;277;54;176;124;453
421003;201605;719;1940;268;893;27;101;30;56;57;157
421005;201605;154;474;116;409;22;87;56;202;78;289
421010;201605;5273;14914;3641;12007;872;3229;691;2009;1563;5238
421020;201605;476;1469;368;1287;39;140;199;728;238;868
421030;201605;724;2632;654;2447;186;760;96;347;282;1107
421040;201605;895;2285;569;1778;96;365;275;809;371;1174
421050;201605;1649;4653;975;3236;176;639;192;554;368;1193
421055;201605;192;547;102;327;23;73;16;39;39;112
421060;201605;495;1671;325;1198;69;286;104;375;173;661
421070;201605;696;2222;434;1556;99;387;58;193;157;580
421080;201605;519;1566;438;1442;87;279;274;915;361;1194
421085;201605;550;1467;301;1011;55;216;87;302;142;518
421090;201605;409;1148;204;687;25;99;62;184;87;283
421100;201605;930;2521;502;1604;125;406;54;167;179;573
421105;201605;1466;4477;1189;4002;267;966;396;1412;663;2378
421110;201605;983;3559;894;3355;315;1257;186;637;501;1894
421120;201605;1315;4213;884;3152;125;526;212;688;337;1214
421125;201605;403;1111;297;927;81;294;92;261;173;555
421130;201605;3154;10297;2675;9388;881;3407;795;2820;1676;6227
421140;201605;344;1003;254;820;51;164;81;247;132;411
421145;201605;553;1745;342;1179;50;172;101;343;151;515
421150;201605;593;1719;424;1433;78;292;164;540;242;832
421160;201605;1216;3324;576;1886;113;402;169;518;282;920
421165;201605;278;945;222;785;34;120;86;308;120;428
421170;201605;1305;3800;1046;3398;207;737;596;1925;803;2662
421175;201605;1223;3438;881;2884;190;793;297;855;487;1648
421180;201605;570;1600;299;1022;61;242;46;146;107;388
421185;201605;395;1090;277;864;43;117;128;428;171;545
421187;201605;274;816;204;672;40;142;83;254;123;396
421189;201605;418;1273;346;1126;74;260;97;292;171;552
421190;201605;11609;33089;7040;24021;1374;5232;915;2918;2289;8150
421200;201605;905;2998;767;2714;166;628;207;701;373;1329
421205;201605;250;755;187;630;40;164;42;115;82;279
421210;201605;1491;4535;1116;3661;266;899;269;890;535;1789
421220;201605;1923;6488;1666;5917;477;1909;270;839;747;2748
421223;201605;515;1650;393;1390;100;377;115;403;215;780
421225;201605;1076;3406;906;3059;193;733;336;1131;529;1864
421227;201605;788;2543;699;2400;143;539;386;1288;529;1827
421230;201605;434;1412;379;1316;93;368;163;538;256;906
421240;201605;429;1371;248;906;30;135;38;132;68;267
421250;201605;1697;4868;1100;3816;286;1078;217;753;503;1831
421260;201605;355;1016;98;355;22;80;18;60;40;140
421265;201605;716;2200;625;2052;125;449;317;1011;442;1460
421270;201605;818;2186;415;1363;77;269;78;286;155;555
421280;201605;1589;4986;1261;4429;369;1482;386;1295;755;2777
421290;201605;1192;3314;706;2292;119;417;105;303;224;720
421300;201605;304;926;235;777;66;253;88;270;154;523
421310;201605;231;719;179;600;36;128;51;159;87;287
421315;201605;357;1030;192;682;41;148;15;53;56;201
421320;201605;549;1723;360;1254;55;208;48;115;103;323
421330;201605;544;1771;416;1528;130;527;72;260;202;787
421335;201605;505;1664;416;1487;98;401;79;298;177;699
421340;201605;1761;5035;1406;4469;198;768;789;2483;987;3251
421350;201605;972;3186;812;2842;149;616;384;1273;533;1889
421360;201605;2972;8541;1893;6451;371;1476;511;1592;882;3068
421370;201605;677;2238;517;1885;141;580;150;533;291;1113
421380;201605;965;2720;793;2392;124;427;379;1112;503;1539
421390;201605;141;423;72;255;10;37;31;116;41;153
421400;201605;262;860;177;693;46;193;46;163;92;356
421410;201605;333;946;215;722;23;76;91;305;114;381
421415;201605;347;1138;162;610;36;144;26;90;62;234
421420;201605;860;2585;626;2059;101;361;189;586;290;947
421430;201605;238;737;180;621;28;105;37;134;65;239
421440;201605;833;2424;555;1916;124;491;216;734;340;1225
421450;201605;492;1515;303;1114;60;245;27;106;87;351
421460;201605;632;1720;331;1160;54;224;66;236;120;460
421470;201605;429;1420;336;1212;95;381;94;318;189;699
421480;201605;3041;8545;1895;6464;488;1953;301;838;789;2791
421490;201605;279;855;131;511;26;122;17;55;43;177
421500;201605;2166;7336;1796;6565;558;2313;221;769;779;3082
421505;201605;359;1199;313;1093;72;252;140;495;212;747
421507;201605;525;1574;334;1167;61;218;89;327;150;545
421510;201605;174;559;150;518;24;112;77;219;101;331
421520;201605;878;2321;585;1732;62;230;243;634;305;864
421530;201605;410;1253;247;890;44;205;59;205;103;410
421535;201605;683;2002;374;1367;56;242;151;514;207;756
421540;201605;323;890;253;775;51;171;91;255;142;426
421545;201605;815;2596;593;2164;130;535;134;480;264;1015
421550;201605;1955;6251;1639;5703;454;1782;465;1546;919;3328
421555;201605;327;951;114;404;19;74;14;45;33;119
421560;201605;209;641;94;327;18;68;16;53;34;121
421565;201605;841;2434;732;2280;253;884;288;897;541;1781
421567;201605;647;2385;572;2212;296;1179;112;432;408;1611
421568;201605;513;1583;339;1170;70;249;93;325;163;574
421569;201605;233;699;112;407;17;64;21;72;38;136
421570;201605;1356;4065;755;2631;178;694;122;393;300;1087
421575;201605;446;1469;391;1358;69;257;231;810;300;1067
421580;201605;3029;9505;2266;7826;550;2128;530;1637;1080;3765
421590;201605;216;671;175;596;19;59;92;311;111;370
421600;201605;548;1647;418;1368;95;337;81;229;176;566
421605;201605;615;1878;440;1551;87;371;110;359;197;730
421610;201605;1394;3778;1049;3190;158;540;493;1431;651;1971
421620;201605;4404;13276;2954;10290;798;2972;807;2818;1605;5790
421625;201605;372;1029;151;520;23;79;15;55;38;134
421630;201605;2956;8771;1674;5735;354;1334;222;712;576;2046
421635;201605;245;731;129;433;14;57;38;101;52;158
421640;201605;1031;3083;745;2506;158;552;298;987;456;1539
421650;201605;2035;6540;1571;5496;384;1552;183;521;567;2073
421660;201605;7601;24475;6180;21606;1412;5532;1817;5882;3229;11414
421670;201605;1068;3262;744;2535;200;783;202;641;402;1424
421680;201605;1134;3635;928;3202;300;1100;167;545;467;1645
421690;201605;1620;5271;1235;4412;241;949;111;357;352;1306
421700;201605;501;1600;283;1042;46;188;63;186;109;374
421710;201605;215;715;108;394;26;98;25;81;51;179
421715;201605;262;695;139;441;33;118;36;96;69;214
421720;201605;1861;5458;1152;3991;286;1104;166;509;452;1613
421725;201605;108;350;97;325;28;99;22;65;50;164
421730;201605;586;1686;288;990;45;166;46;135;91;301
421740;201605;733;2337;503;1792;110;452;78;234;188;686
421750;201605;987;2617;602;1864;114;396;248;699;362;1095
421755;201605;321;928;186;605;39;138;56;176;95;314
421760;201605;810;2410;403;1433;79;313;108;352;187;665
421770;201605;2920;8791;2211;7369;562;1961;689;2377;1251;4338
421775;201605;492;1433;342;1162;59;225;102;330;161;555
421780;201605;1209;4047;925;3380;221;905;255;868;476;1773
421790;201605;772;2091;438;1535;110;442;118;385;228;827
421795;201605;347;1016;220;703;38;138;55;175;93;313
421800;201605;2690;7992;2020;6724;440;1674;737;2276;1177;3950
421810;201605;603;1886;426;1517;110;430;42;147;152;577
421820;201605;1045;3029;645;2187;104;371;115;341;219;712
421825;201605;1444;4591;1344;4387;155;609;930;2932;1085;3541
421830;201605;2404;8229;2132;7664;483;1968;864;2947;1347;4915
421835;201605;156;460;112;396;20;91;71;240;91;331
421840;201605;285;919;203;733;47;197;55;179;102;376
421850;201605;400;1257;238;846;42;184;43;147;85;331
421860;201605;319;963;206;732;32;126;44;131;76;257
421870;201605;3876;10877;2699;8566;802;2770;436;1351;1238;4121
421875;201605;421;1258;192;708;34;145;15;52;49;197
421880;201605;870;2661;650;2192;133;511;143;458;276;969
421885;201605;299;965;241;864;83;324;77;273;160;597
421890;201605;858;2921;742;2683;237;1004;235;784;472;1788
421895;201605;366;1163;325;1091;74;262;173;584;247;846
421900;201605;941;2607;579;1861;149;512;142;414;291;926
421910;201605;497;1583;338;1219;71;301;47;141;118;442
421915;201605;506;1505;308;1036;52;169;65;199;117;368
421917;201605;567;1629;406;1389;142;562;106;342;248;904
421920;201605;757;2109;479;1732;251;959;97;352;348;1311
421930;201605;3133;8216;1705;5696;376;1368;223;666;599;2034
421935;201605;651;2131;478;1757;100;429;153;526;253;955
421940;201605;260;868;134;496;18;76;17;50;35;126
421950;201605;3609;9847;1721;5824;381;1428;204;683;585;2111
421960;201605;199;585;146;483;30;110;32;91;62;201
421970;201605;2231;6168;1384;4412;423;1437;355;1042;778;2479
421985;201605;492;1275;274;853;39;147;83;262;122;409
422000;201605;1149;3431;969;3092;248;873;363;1184;611;2057
430003;201605;799;2327;613;2011;167;616;158;502;325;1118
430005;201605;326;968;237;801;42;157;102;328;144;485
430010;201605;2146;5768;1601;4850;391;1260;640;1956;1031;3216
430020;201605;719;1782;599;1626;83;244;362;951;445;1195
430030;201605;1030;2715;754;2210;242;776;123;330;365;1106
430040;201605;11144;29045;8384;24204;2210;6975;1267;3445;3477;10420
430045;201605;695;1869;517;1512;97;293;225;650;322;943
430047;201605;292;702;155;468;21;59;59;177;80;236
430050;201605;1253;3344;746;2337;135;447;168;493;303;940
430055;201605;302;813;160;501;26;96;66;196;92;292
430057;201605;75;176;35;102;4;9;6;9;10;18
430060;201605;16350;51861;14103;48011;3917;14332;5442;18761;9359;33093
430063;201605;990;2924;800;2531;199;659;378;1231;577;1890
430064;201605;1375;4083;1106;3593;281;935;379;1261;660;2196
430066;201605;173;415;122;336;10;34;68;182;78;216
430070;201605;596;1590;178;577;24;91;24;63;48;154
430080;201605;677;1899;408;1360;93;342;107;314;200;656
430085;201605;890;2310;577;1758;113;385;195;605;308;990
430087;201605;938;2864;863;2724;126;480;520;1530;646;2010
430090;201605;884;2311;342;1109;38;137;54;187;92;324
430100;201605;831;2190;422;1336;100;335;111;304;211;639
430105;201605;990;2891;662;2275;163;630;203;685;366;1315
430107;201605;259;845;188;644;36;131;44;139;80;270
430110;201605;1903;5442;1562;4918;389;1274;683;2101;1072;3375
430120;201605;1761;5189;1299;4240;269;914;567;1828;836;2742
430130;201605;3857;9965;3302;9163;805;2392;1296;3526;2101;5918
430140;201605;1204;3649;806;2744;222;784;228;770;450;1554
430150;201605;749;2003;505;1546;118;383;127;394;245;777
430155;201605;410;1134;225;735;32;124;55;175;87;299
430160;201605;17073;49158;14898;45527;3324;11157;6234;19133;9558;30290
430163;201605;1919;5617;1557;4989;236;859;776;2466;1012;3325
430165;201605;456;1125;133;448;14;46;19;57;33;103
430170;201605;952;2668;375;1329;47;165;35;108;82;273
430175;201605;918;2841;752;2455;204;624;277;998;481;1622
430180;201605;839;2311;682;2058;149;498;331;969;480;1467
430185;201605;586;1516;332;1038;54;178;95;243;149;421
430187;201605;658;1941;511;1648;114;417;165;498;279;915
430190;201605;1700;5010;1479;4583;281;962;803;2459;1084;3421
430192;201605;197;596;91;294;6;18;16;47;22;65
430195;201605;374;1134;89;299;8;29;3;8;11;37
430200;201605;1415;4491;1212;4076;350;1250;285;929;635;2179
430205;201605;571;1643;432;1376;42;165;301;963;343;1128
430210;201605;6243;16587;3699;11415;589;2000;862;2351;1451;4351
430215;201605;364;1009;248;759;42;134;100;291;142;425
430220;201605;750;1883;262;883;39;154;41;135;80;289
430222;201605;279;843;220;716;34;137;101;303;135;440
430223;201605;355;1005;299;919;64;194;155;503;219;697
430225;201605;36;90;16;47;5;14;5;15;10;29
430230;201605;1657;4916;1594;4851;211;494;1341;4279;1552;4773
430235;201605;280;915;227;791;47;180;65;211;112;391
430237;201605;528;1374;385;1132;39;140;245;690;284;830
430240;201605;999;2595;681;2064;102;373;324;929;426;1302
430245;201605;867;2662;655;2219;178;615;250;899;428;1514
430250;201605;1200;3416;1050;3175;372;1176;152;462;524;1638
430258;201605;164;457;120;381;10;34;52;173;62;207
430260;201605;790;2243;562;1797;59;197;305;1020;364;1217
430265;201605;272;830;210;705;42;132;10;35;52;167
430270;201605;2970;8228;2557;7543;350;1193;1479;4181;1829;5374
430280;201605;4708;12672;3789;11085;920;2769;1555;4557;2475;7326
430290;201605;2466;6448;2257;6154;147;417;1935;5290;2082;5707
430300;201605;9179;26941;7608;23975;1797;6158;3138;10052;4935;16210
430310;201605;6429;19260;4946;16440;1165;4225;1716;5382;2881;9607
430320;201605;860;2499;546;1827;99;285;240;857;339;1142
430330;201605;672;1798;519;1511;139;388;205;576;344;964
430340;201605;702;1767;373;1225;70;245;189;609;259;854
430350;201605;6277;19052;5341;17093;1907;6320;1569;4924;3476;11244
430355;201605;388;959;150;461;23;77;19;56;42;133
430360;201605;1065;2798;872;2463;174;566;352;906;526;1472
430367;201605;279;735;167;521;47;170;51;149;98;319
430370;201605;566;1559;363;1150;93;320;70;190;163;510
430380;201605;865;2229;486;1565;140;493;129;416;269;909
430390;201605;3938;11039;2639;8416;492;1684;400;1230;892;2914
430400;201605;1419;3380;1008;2728;315;876;350;903;665;1779
430410;201605;625;1683;448;1383;84;285;208;636;292;921
430420;201605;3622;10470;2852;8796;757;2394;1031;3143;1788;5537
430430;201605;761;2030;476;1511;132;454;106;343;238;797
430435;201605;2019;5467;1519;4579;382;1228;528;1595;910;2823
430440;201605;3986;12527;3119;10548;619;2170;1414;4980;2033;7150
430450;201605;7618;21056;6076;18152;1970;6226;1369;4135;3339;10361
430460;201605;28388;83566;21857;71957;5816;21058;6051;19529;11867;40587
430461;201605;510;1357;164;528;22;73;37;117;59;190
430462;201605;275;788;185;633;32;123;27;97;59;220
430463;201605;4163;13188;3590;12130;778;2822;1608;5560;2386;8382
430465;201605;649;1740;539;1556;160;504;266;745;426;1249
430466;201605;3591;9841;3136;9145;644;2019;1677;4749;2321;6768
430467;201605;509;1499;438;1368;92;308;174;517;266;825
430468;201605;1413;3939;1212;3641;329;1068;452;1304;781;2372
430469;201605;475;1274;62;212;9;30;8;18;17;48
430470;201605;7662;20420;5442;16713;1535;5085;860;2574;2395;7659
430471;201605;585;1910;510;1750;149;517;114;412;263;929
430480;201605;978;2556;499;1583;76;272;109;316;185;588
430485;201605;213;585;98;312;12;39;18;48;30;87
430490;201605;322;911;213;683;50;174;89;283;139;457
430495;201605;371;1104;242;834;44;168;55;167;99;335
430500;201605;1195;3305;966;2928;247;844;424;1257;671;2101
430510;201605;20807;60611;16762;53022;5360;18598;4466;13119;9826;31717
430511;201605;404;1240;177;626;28;109;16;39;44;148
430512;201605;1159;2978;984;2672;247;714;299;846;546;1560
430513;201605;804;2084;477;1407;102;324;171;481;273;805
430515;201605;481;1383;350;1114;52;170;156;520;208;690
430517;201605;1178;3705;977;3293;188;648;508;1766;696;2414
430520;201605;1545;4255;1050;3257;250;852;280;778;530;1630
430530;201605;1102;2959;530;1698;65;250;129;372;194;622
430535;201605;2303;6931;1756;5849;382;1402;591;1904;973;3306
430537;201605;485;1538;418;1403;37;123;303;1026;340;1149
430540;201605;747;1662;497;1322;92;258;278;741;370;999
430543;201605;485;1260;423;1196;79;232;296;857;375;1089
430544;201605;658;2097;556;1889;113;414;273;906;386;1320
430545;201605;1307;4144;1122;3918;385;1439;437;1558;822;2997
430550;201605;634;1838;382;1276;87;321;78;248;165;569
430558;201605;95;271;49;165;9;40;12;36;21;76
430560;201605;379;908;176;540;16;55;59;164;75;219
430570;201605;1115;2865;713;2070;166;571;265;639;431;1210
430580;201605;1265;3152;772;2343;152;525;310;949;462;1474
430583;201605;167;457;54;173;2;6;7;23;9;29
430585;201605;334;869;214;619;51;174;78;190;129;364
430587;201605;191;598;163;540;49;171;42;150;91;321
430590;201605;1228;3481;1139;3325;144;479;797;2282;941;2761
430593;201605;25;95;23;88;6;28;9;30;15;58
430595;201605;269;751;80;271;7;30;7;19;14;49
430597;201605;337;980;235;733;27;90;57;147;84;237
430600;201605;2100;5610;1179;3570;210;674;348;1005;558;1679
430605;201605;1356;4063;1064;3465;226;861;419;1359;645;2220
430607;201605;767;1856;568;1563;71;207;350;994;421;1201
430610;201605;8233;21940;6340;19017;1754;5697;1609;4765;3363;10462
430613;201605;275;658;119;353;21;59;21;49;42;108
430620;201605;718;2052;577;1760;157;505;208;606;365;1111
430630;201605;432;1340;217;735;37;122;21;62;58;184
430632;201605;698;1959;361;1151;56;207;125;343;181;550
430635;201605;606;1744;464;1443;93;331;243;722;336;1053
430637;201605;483;1374;425;1261;63;220;250;700;313;920
430640;201605;1634;4382;748;2479;71;232;29;61;100;293
430642;201605;464;1226;290;904;57;184;110;341;167;525
430645;201605;272;633;106;305;15;41;22;63;37;104
430650;201605;1831;5891;1554;5338;332;1174;831;2914;1163;4088
430655;201605;162;410;138;362;21;80;74;156;95;236
430660;201605;5713;16066;4553;14017;1095;3688;1780;5436;2875;9124
430670;201605;501;1450;457;1373;35;113;346;1070;381;1183
430673;201605;743;1743;343;1026;74;221;95;286;169;507
430675;201605;257;753;99;336;13;52;38;127;51;179
430676;201605;3551;10568;2908;9380;751;2605;846;2765;1597;5370
430680;201605;1205;3442;748;2464;135;454;161;470;296;924
430690;201605;4346;12181;3446;10438;1095;3464;795;2399;1890;5863
430692;201605;275;905;205;769;19;89;137;493;156;582
430693;201605;1287;3546;838;2634;165;599;181;526;346;1125
430695;201605;582;1610;391;1221;75;256;152;443;227;699
430697;201605;482;1359;355;1128;96;318;123;402;219;720
430700;201605;10363;26451;5158;16588;857;3133;314;929;1171;4062
430705;201605;276;838;234;754;77;267;54;158;131;425
430710;201605;1786;4525;1335;3773;276;872;504;1439;780;2311
430720;201605;893;2167;568;1693;133;420;172;517;305;937
430730;201605;1625;4232;1094;3373;250;754;408;1358;658;2112
430740;201605;560;1545;314;1053;73;259;46;167;119;426
430745;201605;504;1423;249;791;33;115;33;101;66;216
430750;201605;1580;4323;1248;3774;238;806;652;1925;890;2731
430755;201605;509;1367;336;1014;27;84;136;392;163;476
430760;201605;3034;7370;2064;5981;465;1600;731;2189;1196;3789
430770;201605;6334;18306;4990;15817;949;3284;2560;7987;3509;11271
430780;201605;2483;6566;1497;4737;280;955;434;1327;714;2282
430781;201605;539;1546;352;1159;72;238;81;270;153;508
430783;201605;548;1341;342;991;58;180;145;384;203;564
430786;201605;72;238;48;178;7;29;11;35;18;64
430790;201605;4705;12796;3278;9983;700;2348;1161;3286;1861;5634
430800;201605;912;2575;613;1904;132;445;195;579;327;1024
430805;201605;553;1545;356;1132;37;114;174;552;211;666
430807;201605;432;1247;292;929;65;240;69;202;134;442
430810;201605;735;1946;287;949;48;176;56;170;104;346
430820;201605;1290;3894;827;2806;168;615;185;616;353;1231
430825;201605;407;1052;151;455;24;62;23;45;47;107
430830;201605;1746;5391;1612;5196;250;889;1027;3278;1277;4167
430840;201605;999;2993;884;2783;227;712;418;1363;645;2075
430843;201605;84;219;41;126;4;15;13;37;17;52
430845;201605;307;928;254;812;105;364;24;60;129;424
430850;201605;2493;7309;2090;6551;502;1738;788;2404;1290;4142
430860;201605;1030;2758;523;1702;122;471;162;482;284;953
430865;201605;636;1664;564;1549;191;555;254;675;445;1230
430870;201605;717;1981;396;1297;94;311;62;164;156;475
430880;201605;1188;3342;839;2661;222;747;206;703;428;1450
430885;201605;247;594;140;433;16;53;93;291;109;344
430890;201605;1781;4722;1193;3601;139;544;306;817;445;1361
430900;201605;2852;7479;2323;6597;477;1590;1060;2815;1537;4405
430905;201605;1054;2984;669;2177;147;503;124;392;271;895
430910;201605;1544;4510;1042;3430;229;844;363;1065;592;1909
430912;201605;479;1355;369;1162;49;168;222;696;271;864
430915;201605;580;1808;400;1465;126;497;87;346;213;843
430920;201605;16349;49272;14387;45627;2784;9832;8006;24613;10790;34445
430925;201605;134;302;57;167;11;36;19;55;30;91
430930;201605;9865;27767;6761;21995;1781;6225;1449;4967;3230;11192
430940;201605;1277;3833;745;2530;175;631;108;345;283;976
430950;201605;995;2726;656;2028;149;518;230;626;379;1144
430955;201605;155;471;77;254;12;46;22;64;34;110
430957;201605;257;842;206;748;48;169;98;385;146;554
430960;201605;1391;3716;1138;3274;263;845;539;1583;802;2428
430965;201605;1529;4295;1309;3936;73;273;1021;3010;1094;3283
430970;201605;515;1406;300;953;50;166;78;238;128;404
430975;201605;602;1947;472;1650;87;321;201;719;288;1040
430980;201605;448;1109;266;838;61;207;81;251;142;458
430990;201605;576;1822;385;1320;70;254;95;319;165;573
430995;201605;608;1749;473;1474;145;481;158;458;303;939
431000;201605;1604;4081;813;2501;127;429;62;166;189;595
431010;201605;2640;7419;1608;5406;275;1023;215;649;490;1672
431020;201605;11293;27529;7249;20499;1705;4991;1702;4738;3407;9729
431030;201605;327;944;158;565;36;142;21;73;57;215
431033;201605;2425;7054;2140;6645;566;1891;1016;3236;1582;5127
431036;201605;210;528;82;267;15;51;15;34;30;85
431040;201605;940;2659;746;2327;151;557;361;1063;512;1620
431041;201605;527;1426;474;1357;154;441;178;537;332;978
431043;201605;481;1372;271;958;118;464;52;156;170;620
431046;201605;112;320;78;247;8;32;23;68;31;100
431050;201605;1690;4287;1279;3602;281;842;646;1805;927;2647
431053;201605;596;1909;485;1665;143;528;101;355;244;883
431055;201605;667;1780;617;1700;66;169;460;1286;526;1455
431057;201605;373;1090;226;768;44;159;55;171;99;330
431060;201605;5583;16472;4953;15503;1534;4910;1723;5590;3257;10500
431065;201605;562;1606;415;1312;73;263;144;415;217;678
431070;201605;710;2024;421;1375;90;302;67;181;157;483
431075;201605;294;883;207;695;35;127;59;211;94;338
431080;201605;650;1975;481;1576;93;340;130;404;223;744
431085;201605;845;2290;662;1911;98;297;365;1047;463;1344
431087;201605;588;1655;502;1485;56;161;335;1006;391;1167
431090;201605;518;1268;246;741;53;166;44;121;97;287
431100;201605;3678;10176;2962;8970;762;2502;929;2754;1691;5256
431110;201605;1551;4089;1150;3303;267;799;397;1057;664;1856
431112;201605;568;1836;525;1752;136;465;249;809;385;1274
431113;201605;511;1463;403;1261;104;342;110;360;214;702
431115;201605;1386;3985;1211;3695;226;726;681;2090;907;2816
431120;201605;2671;8111;2069;6938;633;2445;635;1908;1268;4353
431123;201605;456;1311;303;1015;61;207;157;531;218;738
431125;201605;1381;4139;995;3315;294;983;212;782;506;1765
431127;201605;261;701;63;208;4;9;8;19;12;28
431130;201605;3320;9468;2403;7754;467;1659;759;2430;1226;4089
431140;201605;4803;11768;2698;8248;381;1284;684;1870;1065;3154
431142;201605;452;1325;392;1213;41;127;258;825;299;952
431150;201605;1112;3306;849;2780;186;672;283;918;469;1590
431160;201605;901;2629;744;2322;135;396;364;1258;499;1654
431162;201605;510;1288;218;731;27;105;23;54;50;159
431164;201605;171;470;51;184;9;37;3;12;12;49
431170;201605;727;2008;519;1636;146;489;137;421;283;910
431171;201605;785;2299;680;2093;201;652;207;612;408;1264
431173;201605;476;1371;390;1225;137;471;118;349;255;820
431175;201605;1033;2889;867;2616;256;823;238;695;494;1518
431177;201605;822;2665;636;2302;207;837;241;853;448;1690
431179;201605;374;809;101;292;15;46;20;49;35;95
431180;201605;2318;6541;1564;5048;375;1292;304;925;679;2217
431190;201605;634;1762;373;1196;54;194;75;214;129;408
431198;201605;366;1207;332;1141;120;431;88;322;208;753
431200;201605;409;1161;122;419;16;53;4;10;20;63
431205;201605;292;876;138;477;33;105;36;135;69;240
431210;201605;764;2047;629;1816;174;503;308;914;482;1417
431213;201605;232;708;181;610;26;99;89;300;115;399
431215;201605;284;836;154;533;25;84;9;25;34;109
431217;201605;171;527;128;433;38;138;45;155;83;293
431220;201605;907;2437;548;1692;54;183;235;670;289;853
431225;201605;1355;3734;1071;3230;236;740;402;1197;638;1937
431230;201605;860;2478;650;2051;81;275;319;985;400;1260
431235;201605;114;316;32;101;5;16;5;11;10;27
431237;201605;495;1444;390;1290;79;317;213;686;292;1003
431238;201605;42;135;34;117;8;31;8;28;16;59
431240;201605;3008;8847;2672;8358;807;2721;922;2852;1729;5573
431242;201605;369;1160;322;1072;96;331;109;379;205;710
431244;201605;387;888;232;633;26;86;119;295;145;381
431245;201605;1193;3098;837;2456;124;381;411;1186;535;1567
431247;201605;205;590;145;461;37;114;30;89;67;203
431250;201605;1504;4806;1309;4536;359;1366;495;1720;854;3086
431260;201605;350;984;173;605;24;105;50;159;74;264
431261;201605;245;834;213;761;35;160;84;268;119;428
431262;201605;419;1131;186;600;23;89;87;287;110;376
431265;201605;1444;3692;774;2334;146;488;191;474;337;962
431267;201605;183;505;143;443;30;108;85;245;115;353
431270;201605;2800;6989;1813;5380;433;1438;590;1756;1023;3194
431275;201605;225;683;125;459;34;128;14;52;48;180
431280;201605;330;921;135;453;16;61;22;50;38;111
431290;201605;325;989;237;786;50;193;40;108;90;301
431295;201605;91;251;45;141;3;10;14;40;17;50
431300;201605;397;990;69;257;6;19;2;7;8;26
431301;201605;270;829;113;389;21;73;16;47;37;120
431303;201605;756;2002;437;1341;57;199;125;358;182;557
431306;201605;2334;6012;1480;4500;162;589;407;1064;569;1653
431308;201605;39;132;35;118;20;72;9;29;29;101
431310;201605;754;2239;463;1578;85;304;128;455;213;759
431320;201605;792;2176;408;1352;65;228;73;216;138;444
431330;201605;2887;7069;1436;4489;376;1325;79;206;455;1531
431333;201605;424;1138;174;530;25;84;33;84;58;168
431335;201605;54;166;38;132;13;48;6;13;19;61
431337;201605;2438;7389;1827;6178;405;1484;278;894;683;2378
431339;201605;597;1619;406;1232;79;244;183;553;262;797
431340;201605;24101;64032;17638;52815;3918;12724;4272;12666;8190;25390
431342;201605;541;1361;420;1169;130;414;206;523;336;937
431344;201605;357;977;251;784;10;25;181;586;191;611
431346;201605;318;810;125;387;26;88;16;47;42;135
431349;201605;730;2052;466;1439;88;283;163;474;251;757
431350;201605;4111;11988;3330;10543;696;2495;1177;3484;1873;5979
431360;201605;653;1670;429;1291;96;312;133;408;229;720
431365;201605;1252;3706;1070;3401;225;768;547;1786;772;2554
431370;201605;4896;13700;3813;11833;1071;3590;1070;3421;2141;7011
431380;201605;928;2890;859;2748;120;433;516;1622;636;2055
431390;201605;3103;8101;1842;5693;330;1133;466;1283;796;2416
431395;201605;1251;3720;1052;3370;243;844;482;1528;725;2372
431400;201605;364;1140;177;605;36;128;26;78;62;206
431402;201605;1285;3012;750;2090;154;447;332;892;486;1339
431403;201605;254;733;186;618;61;224;33;107;94;331
431405;201605;4015;11221;3271;10112;608;2091;1685;5133;2293;7224
431406;201605;749;2274;561;1888;141;502;256;853;397;1355
431407;201605;539;1539;357;1189;73;242;96;300;169;542
431410;201605;14013;39849;9530;31223;2664;9812;1095;3408;3759;13220
431413;201605;219;541;91;290;6;21;23;66;29;87
431415;201605;727;2044;516;1650;118;421;158;451;276;872
431417;201605;567;1434;469;1299;57;173;285;781;342;954
431420;201605;1370;3756;1205;3501;247;737;524;1623;771;2360
431430;201605;532;1389;327;987;58;182;110;291;168;473
431440;201605;22665;63009;18492;56369;5359;17353;5387;17421;10746;34774
431442;201605;127;367;79;251;10;35;5;11;15;46
431445;201605;525;1490;234;759;32;101;75;228;107;329
431446;201605;417;1228;298;978;73;251;87;273;160;524
431447;201605;571;1630;441;1369;90;276;195;628;285;904
431449;201605;789;2178;626;1898;59;184;359;1105;418;1289
431450;201605;2193;5401;1911;4997;270;797;1349;3412;1619;4209
431454;201605;64;224;56;203;12;44;22;87;34;131
431455;201605;722;1802;382;1073;95;275;94;235;189;510
431460;201605;3347;9224;2844;8265;745;2204;864;2648;1609;4852
431470;201605;1769;5189;1336;4240;294;929;447;1446;741;2375
431475;201605;207;604;47;188;5;26;2;4;7;30
431477;201605;731;1900;481;1392;58;194;245;667;303;861
431478;201605;281;713;95;277;13;36;15;31;28;67
431480;201605;2972;8236;2270;7003;557;1884;854;2525;1411;4409
431490;201605;110253;296056;93881;271675;11199;38083;63649;179353;74848;217436
431500;201605;599;1657;469;1398;92;276;241;717;333;993
431505;201605;505;1210;338;965;23;58;205;598;228;656
431507;201605;360;886;213;600;44;121;106;298;150;419
431510;201605;1895;5296;1475;4453;326;1040;483;1360;809;2400
431513;201605;302;808;146;454;19;59;67;206;86;265
431514;201605;111;293;45;156;3;12;10;36;13;48
431515;201605;657;1891;451;1416;101;353;149;420;250;773
431517;201605;77;244;60;201;10;34;10;27;20;61
431520;201605;521;1308;244;782;43;164;28;77;71;241
431530;201605;4311;10104;3222;8824;1064;3167;894;2556;1958;5723
431531;201605;271;787;187;607;29;97;57;184;86;281
431532;201605;496;1368;409;1188;89;272;150;425;239;697
431535;201605;348;906;152;467;25;86;47;120;72;206
431540;201605;2045;6736;1797;6365;175;642;1169;4342;1344;4984
431545;201605;344;954;49;162;5;14;5;17;10;31
431550;201605;2236;6559;1966;6083;396;1383;851;2529;1247;3912
431555;201605;697;1740;521;1461;70;199;314;907;384;1106
431560;201605;20329;59838;14500;48784;3394;12802;3098;11008;6492;23810
431570;201605;5860;15011;4696;13513;1260;3752;2005;5904;3265;9656
431575;201605;406;1030;295;860;44;147;65;168;109;315
431580;201605;622;1758;387;1262;78;275;107;326;185;601
431590;201605;961;2590;591;1859;107;335;175;573;282;908
431595;201605;445;1264;353;1076;38;117;217;672;255;789
431600;201605;1996;5478;1429;4471;313;1139;318;946;631;2085
431610;201605;1473;4212;1072;3442;181;599;419;1364;600;1963
431620;201605;484;1422;244;778;54;174;91;267;145;441
431630;201605;1419;3817;893;2725;248;804;241;694;489;1498
431640;201605;6195;17315;5526;16340;1210;3782;3071;9163;4281;12945
431642;201605;503;1351;390;1150;54;177;173;493;227;670
431643;201605;313;824;164;474;25;77;50;122;75;199
431645;201605;1723;4901;1468;4466;253;864;850;2548;1103;3412
431647;201605;154;446;103;338;17;64;14;39;31;103
431650;201605;323;984;224;773;28;117;52;153;80;270
431660;201605;1153;3229;721;2361;131;467;134;376;265;843
431670;201605;1272;3348;949;2780;202;672;379;1027;581;1699
431673;201605;239;667;122;402;23;77;15;44;38;121
431675;201605;625;1634;144;476;19;71;27;69;46;140
431680;201605;9707;26286;7349;21998;1975;6313;1696;5139;3671;11452
431690;201605;23474;65055;18416;56665;4951;16244;5741;18255;10692;34499
431695;201605;140;431;98;325;20;65;22;55;42;120
431697;201605;450;1290;397;1189;103;318;181;557;284;875
431700;201605;1551;4401;1325;3976;214;669;711;2100;925;2769
431710;201605;12566;36048;10261;32408;3284;11192;2265;7799;5549;18991
431720;201605;7139;19639;5412;16342;1175;3825;1774;5269;2949;9094
431725;201605;25;75;12;45;3;13;3;9;6;22
431730;201605;3912;11325;3096;9900;795;2812;799;2677;1594;5489
431740;201605;5266;14568;4173;12628;1341;4463;663;1808;2004;6271
431750;201605;9022;25517;7823;23592;1780;5872;3533;10737;5313;16609
431755;201605;332;906;81;277;13;47;14;43;27;90
431760;201605;3924;11137;3163;9770;622;2115;1282;3743;1904;5858
431770;201605;2019;5342;1658;4796;288;866;944;2708;1232;3574
431775;201605;210;564;141;433;37;114;12;29;49;143
431780;201605;2434;6551;1833;5437;447;1411;392;1076;839;2487
431790;201605;1176;3547;959;3128;150;548;467;1528;617;2076
431795;201605;377;1012;224;673;36;115;69;202;105;317
431800;201605;8694;25479;6926;22203;2100;7312;941;2907;3041;10219
431805;201605;339;829;106;354;18;69;17;57;35;126
431810;201605;3220;8828;2492;7419;457;1490;1069;3090;1526;4580
431820;201605;2508;7779;2163;7112;423;1521;889;2827;1312;4348
431830;201605;10829;26319;8389;22737;2312;6818;3009;8252;5321;15070
431840;201605;2659;7964;2302;7355;568;1957;993;3219;1561;5176
431842;201605;813;2053;343;1049;43;141;71;190;114;331
431843;201605;353;1018;290;901;42;148;139;415;181;563
431844;201605;285;777;92;303;21;76;19;49;40;125
431845;201605;488;1437;375;1196;22;73;237;762;259;835
431846;201605;324;991;280;924;23;85;195;644;218;729
431848;201605;252;675;144;459;15;50;32;93;47;143
431849;201605;472;1147;102;303;16;46;15;34;31;80
431850;201605;4780;13930;4172;12771;979;3185;1492;4536;2471;7721
431860;201605;788;2076;580;1698;94;311;281;776;375;1087
431861;201605;96;275;50;171;6;20;7;19;13;39
431862;201605;480;1568;388;1400;109;454;109;364;218;818
431870;201605;18049;52075;14384;45543;3455;11870;4560;14494;8015;26364
431880;201605;4277;12697;3435;10953;819;2867;1116;3358;1935;6225
431890;201605;5095;13762;3698;11263;1102;3556;802;2558;1904;6114
431900;201605;1085;3020;714;2263;179;655;271;785;450;1440
431910;201605;1022;2446;494;1427;72;203;132;359;204;562
431912;201605;499;1447;408;1283;119;352;147;486;266;838
431915;201605;1299;3505;1001;2973;223;698;359;1079;582;1777
431920;201605;1293;3635;1116;3353;132;413;777;2311;909;2724
431930;201605;1242;3378;865;2754;223;681;381;1299;604;1980
431935;201605;51;158;43;140;10;38;12;33;22;71
431936;201605;384;1109;287;897;65;205;114;371;179;576
431937;201605;335;868;184;559;41;142;25;66;66;208
431940;201605;2549;6908;1689;5212;353;1177;417;1261;770;2438
431950;201605;1602;4881;1406;4526;251;911;669;2077;920;2988
431960;201605;2870;8291;2511;7610;640;2007;782;2363;1422;4370
431970;201605;484;1335;225;755;39;149;42;124;81;273
431971;201605;96;277;59;203;5;19;12;38;17;57
431973;201605;467;1605;413;1494;60;214;251;950;311;1164
431975;201605;107;253;23;90;6;27;5;19;11;46
431980;201605;1385;4041;1120;3520;249;831;344;1028;593;1859
431990;201605;7278;20129;5427;17086;930;3347;1615;4828;2545;8175
432000;201605;9909;27603;7875;24153;2457;7866;2448;7438;4905;15304
432010;201605;2214;6211;1798;5468;361;1179;835;2517;1196;3696
432020;201605;2311;5545;1713;4721;246;746;1108;3000;1354;3746
432023;201605;515;1455;337;1066;65;232;106;280;171;512
432026;201605;1203;3636;889;2978;150;484;426;1440;576;1924
432030;201605;413;1192;306;955;58;169;145;446;203;615
432032;201605;603;1548;395;1176;71;231;164;445;235;676
432035;201605;826;2489;738;2342;278;956;231;752;509;1708
432040;201605;973;2263;431;1357;73;239;128;398;201;637
432045;201605;249;700;143;490;23;78;38;129;61;207
432050;201605;633;1747;542;1590;82;248;298;902;380;1150
432055;201605;949;2668;679;2183;125;410;352;1121;477;1531
432057;201605;410;992;309;827;51;129;188;492;239;621
432060;201605;541;1431;203;694;33;129;44;132;77;261
432065;201605;219;635;167;542;43;158;61;178;104;336
432067;201605;972;2979;723;2458;143;493;323;1124;466;1617
432070;201605;2357;6496;1560;4882;323;1098;284;828;607;1926
432080;201605;3736;10521;3139;9494;974;3183;1018;3064;1992;6247
432085;201605;311;858;201;678;47;166;96;322;143;488
432090;201605;1442;4102;1116;3467;306;1029;401;1181;707;2210
432100;201605;1332;3822;653;2215;89;307;42;103;131;410
432110;201605;2667;8006;1977;6607;455;1748;193;583;648;2331
432120;201605;4738;13890;3976;12599;1437;4843;967;3001;2404;7844
432130;201605;2637;7353;2156;6731;743;2559;749;2334;1492;4893
432132;201605;396;1102;195;667;26;99;55;178;81;277
432135;201605;684;2109;633;2018;86;304;453;1422;539;1726
432140;201605;1913;6096;1506;5310;339;1268;606;2250;945;3518
432143;201605;1380;4021;1150;3635;210;674;535;1772;745;2446
432145;201605;1245;3770;774;2695;120;460;111;356;231;816
432146;201605;173;570;123;452;28;110;24;95;52;205
432147;201605;647;2040;487;1693;130;486;120;437;250;923
432149;201605;365;1017;233;709;51;154;78;241;129;395
432150;201605;3671;10262;2755;8619;574;2013;788;2375;1362;4388
432160;201605;4467;13944;3882;12904;1168;4097;1296;4446;2464;8543
432162;201605;405;964;70;212;11;37;11;26;22;63
432163;201605;367;979;96;305;5;18;4;12;9;30
432166;201605;675;1989;555;1748;73;271;257;768;330;1039
432170;201605;1102;3393;740;2619;147;539;127;430;274;969
432180;201605;2785;7443;1829;5617;407;1309;387;1127;794;2436
432183;201605;416;1284;323;1091;125;454;60;194;185;648
432185;201605;898;2396;576;1815;108;360;239;759;347;1119
432190;201605;3330;9040;2170;6542;470;1486;570;1616;1040;3102
432195;201605;1102;2979;846;2578;119;362;461;1375;580;1737
432200;201605;3071;9130;2455;8087;594;2134;1028;3420;1622;5554
432210;201605;422;1156;306;965;73;259;114;344;187;603
432215;201605;840;2564;712;2360;152;459;389;1395;541;1854
432218;201605;274;694;174;502;29;82;60;151;89;233
432220;201605;4219;11124;3462;9934;407;1374;2099;5832;2506;7206
432225;201605;86;268;71;238;28;101;20;68;48;169
432230;201605;1042;2784;631;1891;130;421;150;369;280;790
432232;201605;519;1463;407;1245;68;224;162;489;230;713
432234;201605;366;1015;240;744;47;149;62;179;109;328
432235;201605;109;310;37;125;8;29;1;1;9;30
432237;201605;467;1258;423;1187;17;70;311;844;328;914
432240;201605;13885;43138;11595;40158;1737;7143;6753;24170;8490;31313
432250;201605;4723;16010;4270;15109;1327;5081;1312;4729;2639;9810
432252;201605;408;1093;277;883;49;168;139;464;188;632
432253;201605;1317;4162;774;2717;164;632;61;208;225;840
432254;201605;857;2319;249;826;53;194;31;85;84;279
432255;201605;197;535;122;402;24;85;37;112;61;197
432260;201605;7621;18869;5332;15164;1146;3328;2107;6321;3253;9649
432270;201605;2579;7616;2156;6887;614;2039;685;2256;1299;4295
432280;201605;1393;3779;749;2390;111;371;152;428;263;799
432285;201605;193;607;25;92;4;16;2;4;6;20
432290;201605;568;1643;360;1176;87;282;93;297;180;579
432300;201605;23495;69103;20472;63955;3833;13009;11273;34806;15106;47815
432310;201605;809;2344;637;2062;145;506;319;1009;464;1515
432320;201605;221;560;112;348;18;57;20;52;38;109
432330;201605;330;862;126;411;14;47;12;30;26;77
432335;201605;158;452;65;236;14;53;10;29;24;82
432340;201605;310;754;164;498;28;99;50;142;78;241
432345;201605;641;1771;587;1685;78;285;357;935;435;1220
432350;201605;394;1068;212;700;29;88;54;172;83;260
432360;201605;188;574;42;148;8;38;8;21;16;59
432370;201605;425;1181;343;1028;40;116;215;655;255;771
432375;201605;758;1889;575;1590;73;199;323;909;396;1108
432377;201605;185;608;40;151;8;27;6;14;14;41
432380;201605;912;2945;770;2665;258;992;276;918;534;1910
500020;201605;2257;6663;1717;5720;368;1443;669;2147;1037;3590
500025;201605;1365;3154;842;2266;96;262;458;1208;554;1470
500060;201605;6895;20382;5459;17958;683;2306;3414;11697;4097;14003
500070;201605;4378;12474;3461;10849;732;2596;1368;4228;2100;6824
500080;201605;1482;4347;1104;3652;282;1041;351;1164;633;2205
500085;201605;2244;5742;1571;4756;148;477;920;2715;1068;3192
500090;201605;2371;6774;1715;5592;343;1163;723;2488;1066;3651
500100;201605;2649;7629;2221;6894;490;1736;825;2428;1315;4164
500110;201605;8258;24190;6551;21544;1105;3942;2988;10467;4093;14409
500124;201605;2030;6440;1754;5982;378;1219;870;3332;1248;4551
500150;201605;1412;3558;978;2850;193;654;354;881;547;1535
500190;201605;4891;12582;3769;11057;736;2307;1912;5759;2648;8066
500200;201605;2442;6116;1850;5059;393;1166;710;1795;1103;2961
500210;201605;4774;14164;3972;12914;909;3127;1771;5863;2680;8990
500215;201605;1552;4748;1208;4074;194;712;434;1460;628;2172
500220;201605;2987;9278;2470;8396;477;1716;1047;3670;1524;5386
500230;201605;2793;7083;1967;5785;420;1351;889;2681;1309;4032
500240;201605;4582;14290;3302;11663;519;1996;972;3687;1491;5683
500260;201605;2746;6963;1980;5804;307;999;956;2684;1263;3683
500270;201605;124217;317071;78888;238953;17557;57659;16559;49629;34116;107288
500280;201605;1375;3505;1161;3231;88;263;892;2516;980;2779
500290;201605;4506;10196;2596;7454;529;1670;849;2379;1378;4049
500295;201605;2683;7798;1661;5528;261;959;385;1097;646;2056
500310;201605;771;2011;633;1814;138;453;308;842;446;1295
500315;201605;3089;9601;2538;8703;354;1244;1528;5488;1882;6732
500320;201605;17028;54092;13453;47493;3816;14758;3451;12924;7267;27682
500325;201605;4070;10366;2954;8638;572;1808;1520;4500;2092;6308
500330;201605;6754;17653;4695;13884;829;2748;1998;5793;2827;8541
500345;201605;2183;5657;1683;4902;369;1161;770;2242;1139;3403
500348;201605;2281;6584;1972;6102;129;477;1419;4352;1548;4829
500350;201605;1266;3739;722;2461;83;296;212;734;295;1030
500370;201605;23533;70138;17814;59859;3725;14147;4831;16353;8556;30500
500375;201605;2894;7919;2141;6485;445;1406;537;1557;982;2963
500380;201605;3087;8551;2436;7425;601;1929;927;2857;1528;4786
500390;201605;584;1293;338;916;49;151;172;439;221;590
500400;201605;1350;4073;1000;3247;224;793;227;666;451;1459
500410;201605;2199;6141;1777;5530;401;1349;830;2660;1231;4009
500430;201605;2662;7304;1985;6345;409;1486;763;2552;1172;4038
500440;201605;1494;3935;1005;3088;170;574;434;1331;604;1905
500450;201605;1667;4915;1186;3992;230;851;190;550;420;1401
500460;201605;3735;11118;2798;9314;696;2531;542;1744;1238;4275
500470;201605;3066;8919;2133;6946;518;1884;309;909;827;2793
500480;201605;2224;6717;2048;6502;195;546;1547;5337;1742;5883
500490;201605;971;2658;717;2221;208;733;151;494;359;1227
500500;201605;3881;11745;3004;10449;999;4019;952;3380;1951;7399
500510;201605;853;2197;538;1639;68;232;219;605;287;837
500515;201605;1889;4998;1557;4567;225;681;898;2876;1123;3557
500520;201605;3166;10804;2819;10199;393;1568;1768;6481;2161;8049
500525;201605;1164;3679;927;3231;149;589;436;1575;585;2164
500540;201605;6326;17161;3740;12351;962;3735;437;1239;1399;4974
500560;201605;4661;15176;4221;14495;566;2110;2924;10106;3490;12216
500568;201605;4335;10520;2932;8452;577;2028;958;2562;1535;4590
500570;201605;7704;20297;5021;15295;1263;4154;908;2669;2171;6823
500580;201605;3709;10373;2965;9184;257;807;2094;6614;2351;7421
500600;201605;3923;10332;2548;7794;586;1945;683;2084;1269;4029
500620;201605;7728;22026;5875;18545;1043;3561;2311;7382;3354;10943
500625;201605;777;2252;437;1481;71;255;133;447;204;702
500627;201605;579;1631;433;1368;82;261;113;382;195;643
500630;201605;6066;16403;4328;13503;1081;3674;1259;3846;2340;7520
500635;201605;2719;10021;2225;9257;285;1149;1464;6657;1749;7806
500640;201605;1650;3950;1250;3386;80;254;899;2399;979;2653
500660;201605;19223;54516;14864;47586;4337;15725;4129;13101;8466;28826
500690;201605;2573;7547;2071;6843;955;3316;500;1801;1455;5117
500710;201605;3533;10403;2960;9459;660;2374;1189;3774;1849;6148
500720;201605;6146;16153;3902;12321;968;3359;778;2414;1746;5773
500730;201605;988;2701;679;2101;159;512;187;551;346;1063
500740;201605;4294;11557;3423;9970;384;1337;1567;4678;1951;6015
500750;201605;939;2570;787;2331;133;427;411;1196;544;1623
500755;201605;1177;3411;788;2617;164;577;154;409;318;986
500769;201605;5311;13992;3054;9380;504;1719;574;1522;1078;3241
500770;201605;1716;4956;1222;4029;286;1002;303;1025;589;2027
500780;201605;1130;3208;883;2770;223;709;221;684;444;1393
500790;201605;9819;26538;8081;23652;1358;4533;4272;12280;5630;16813
500793;201605;2248;6392;1712;5477;452;1526;318;886;770;2412
500795;201605;2392;7064;2026;6548;248;661;1402;4893;1650;5554
500797;201605;835;2257;578;1810;97;336;213;650;310;986
500800;201605;2885;7649;2200;6673;829;2889;487;1546;1316;4435
500830;201605;19421;51400;13607;40779;2545;8370;4444;12701;6989;21071
500840;201605;1331;3683;900;2831;106;360;341;1035;447;1395
510010;201605;1257;3698;1034;3346;259;839;512;1697;771;2536
510020;201605;3390;9517;2099;6943;459;1634;484;1528;943;3162
510025;201605;7555;21906;5714;18484;1241;4329;1586;4832;2827;9161
510030;201605;1681;4509;1367;4025;246;814;675;1912;921;2726
510035;201605;833;2377;621;2070;127;438;333;1149;460;1587
510040;201605;1723;4679;1331;4081;205;665;711;2209;916;2874
510050;201605;1847;5324;1341;4364;326;1161;377;1196;703;2357
510060;201605;1584;4486;1207;3784;219;743;472;1436;691;2179
510080;201605;1073;3357;845;2920;233;893;121;358;354;1251
510100;201605;681;1782;481;1382;52;174;230;617;282;791
510120;201605;309;663;196;520;12;40;131;350;143;390
510125;201605;3130;8154;2379;6851;394;1356;913;2428;1307;3784
510130;201605;1756;4840;1435;4312;391;1264;439;1284;830;2548
510140;201605;2810;8912;2235;8047;955;3851;386;1174;1341;5025
510160;201605;1309;4383;1191;4203;194;747;750;2642;944;3389
510170;201605;5124;15429;4206;13857;767;2782;1891;6083;2658;8865
510180;201605;12225;31519;8465;25636;2342;7480;2358;8150;4700;15630
510185;201605;1341;3982;1110;3662;158;512;689;2550;847;3062
510190;201605;2341;6719;1656;5690;318;1195;764;2779;1082;3974
510250;201605;13682;41248;11773;38373;3518;12347;4186;14178;7704;26525
510260;201605;2132;8803;1803;8150;381;1728;862;4516;1243;6244
510263;201605;4071;10849;2991;9134;715;2323;739;2170;1454;4493
510267;201605;5635;16186;3929;12600;779;2722;886;2697;1665;5419
510268;201605;845;2470;719;2292;145;506;390;1242;535;1748
510269;201605;1005;3073;745;2584;247;887;154;532;401;1419
510270;201605;2713;8781;2245;7831;446;1608;863;2979;1309;4587
510279;201605;1805;5559;1466;4859;377;1334;399;1183;776;2517
510285;201605;1243;3614;960;3133;273;990;276;835;549;1825
510300;201605;3326;9627;2736;8792;196;724;2028;6604;2224;7328
510305;201605;1502;4636;1167;4025;284;1061;350;1214;634;2275
510310;201605;771;2367;650;2137;214;744;183;579;397;1323
510320;201605;3548;10106;2777;8742;625;2307;771;2312;1396;4619
510325;201605;5170;16159;4370;15083;1207;4346;2438;8780;3645;13126
510330;201605;2689;8443;2126;7437;561;2131;664;2360;1225;4491
510335;201605;4896;14545;3949;13366;491;1654;2705;9742;3196;11396
510336;201605;585;1805;433;1518;82;296;203;723;285;1019
510337;201605;2027;6619;1616;5836;625;2378;247;921;872;3299
510340;201605;76025;202094;52997;166205;16714;58507;8959;29347;25673;87854
510343;201605;1115;3195;881;2782;106;352;569;1831;675;2183
510345;201605;1612;4758;1298;4220;323;1141;460;1451;783;2592
510350;201605;3190;8604;2411;7514;574;1888;1054;3454;1628;5342
510360;201605;1761;4300;1112;3511;106;420;764;2371;870;2791
510370;201605;1254;4117;1043;3781;232;880;562;2148;794;3028
510380;201605;518;1518;312;1100;109;421;22;76;131;497
510385;201605;930;3503;683;2943;90;422;302;1445;392;1867
510390;201605;1078;3345;985;3222;259;672;592;2197;851;2869
510395;201605;766;1878;547;1561;80;266;221;729;301;995
510410;201605;3752;12106;3261;11172;803;2867;1566;5518;2369;8385
510420;201605;2403;6061;1785;5056;173;621;923;2571;1096;3192
510450;201605;648;1696;454;1397;96;330;137;421;233;751
510452;201605;645;2063;492;1722;75;292;266;943;341;1235
510454;201605;837;2642;714;2410;94;349;455;1567;549;1916
510455;201605;972;2975;725;2453;132;514;235;753;367;1267
510460;201605;2268;5870;1719;5111;209;740;972;2787;1181;3527
510480;201605;4411;11583;3147;9336;613;1912;870;2490;1483;4402
510490;201605;1589;4915;1341;4542;278;1078;717;2366;995;3444
510500;201605;1517;4489;1033;3537;226;905;417;1349;643;2254
510510;201605;2599;8995;2242;8360;681;2719;652;2490;1333;5209
510515;201605;6120;18436;4470;14887;957;3523;956;2987;1913;6510
510517;201605;1616;4822;1314;4262;372;1264;297;945;669;2209
510520;201605;2083;4776;1496;4064;63;191;1020;2983;1083;3174
510523;201605;996;2928;877;2720;112;344;615;1980;727;2324
510525;201605;7993;20717;5442;16761;1060;3347;1857;5753;2917;9100
510530;201605;519;1478;435;1360;50;226;284;838;334;1064
510550;201605;2734;8824;2131;7650;569;2217;679;2440;1248;4657
510558;201605;1865;5340;1586;4946;243;837;863;2796;1106;3633
510560;201605;1675;5032;1081;4041;295;1215;200;762;495;1977
510562;201605;5363;15683;4088;13163;1137;3996;964;3208;2101;7204
510590;201605;2996;7955;2501;7329;467;1361;1432;4428;1899;5789
510600;201605;1606;4107;1066;3224;191;607;389;1153;580;1760
510610;201605;2908;8212;2346;7363;197;695;1540;4826;1737;5521
510615;201605;2036;6157;1701;5617;490;1686;713;2462;1203;4148
510617;201605;607;1780;504;1606;35;94;397;1328;432;1422
510618;201605;1467;4213;1067;3449;184;697;472;1476;656;2173
510619;201605;800;2215;481;1607;52;197;54;139;106;336
510620;201605;1412;3524;784;2535;193;696;93;261;286;957
510621;201605;855;2963;770;2793;198;791;222;771;420;1562
510622;201605;3787;11470;2679;9137;686;2514;331;1024;1017;3538
510623;201605;3241;9229;2563;8043;638;2199;892;2643;1530;4842
510624;201605;1483;4290;947;3215;179;692;188;585;367;1277
510625;201605;2059;5767;1571;4949;412;1446;264;830;676;2276
510626;201605;1577;4190;1033;3428;319;1204;218;730;537;1934
510627;201605;717;2049;481;1542;118;421;92;284;210;705
510628;201605;1545;3806;1101;3216;121;357;762;2269;883;2626
510629;201605;1752;5660;1410;4914;426;1656;389;1317;815;2973
510630;201605;2469;8317;1803;6913;438;1869;280;1101;718;2970
510631;201605;356;1013;306;931;21;51;237;729;258;780
510637;201605;2681;7831;2307;7240;739;2554;778;2400;1517;4954
510642;201605;4635;15277;4004;14370;1198;4756;1662;6190;2860;10946
510645;201605;963;2163;614;1695;205;558;149;450;354;1008
510650;201605;6275;20676;5656;19955;1432;5290;3440;12651;4872;17941
510665;201605;1703;4417;1031;3181;186;589;355;1139;541;1728
510670;201605;399;903;226;662;21;84;112;313;133;397
510675;201605;6404;19978;5116;17483;1477;5647;1121;3750;2598;9397
510677;201605;1909;5197;1580;4773;173;523;1162;3691;1335;4214
510680;201605;719;2156;532;1785;120;427;96;294;216;721
510682;201605;2103;6633;1633;5747;449;1784;293;983;742;2767
510685;201605;942;2519;767;2274;83;287;492;1427;575;1714
510700;201605;4299;11063;2923;9150;639;2032;1320;4308;1959;6340
510704;201605;9401;24786;7505;21753;1401;4443;3398;9543;4799;13986
510706;201605;1878;5552;1283;4670;269;1001;640;2500;909;3501
510710;201605;3327;9148;2341;7179;503;1600;601;1704;1104;3304
510715;201605;716;1755;479;1352;82;251;170;488;252;739
510718;201605;2293;5671;1492;4743;665;2183;334;1254;999;3437
510719;201605;401;924;258;735;20;82;129;353;149;435
510720;201605;1132;2763;839;2377;231;745;293;730;524;1475
510724;201605;714;2157;560;1878;111;402;218;696;329;1098
510726;201605;626;1556;482;1336;64;207;270;675;334;882
510729;201605;728;1816;415;1240;93;318;139;408;232;726
510730;201605;2713;7793;2020;6534;561;1974;498;1587;1059;3561
510735;201605;1000;3291;772;2936;165;704;367;1415;532;2119
510740;201605;1075;2650;779;2214;155;422;400;1204;555;1626
510757;201605;688;2298;569;2070;223;818;153;566;376;1384
510760;201605;31418;79950;21142;63441;5789;19076;4297;12406;10086;31482
510770;201605;4227;10825;3599;10067;330;889;2372;7410;2702;8299
510774;201605;352;985;318;930;56;192;160;499;216;691
510775;201605;703;2073;579;1858;172;619;151;435;323;1054
510776;201605;535;1473;419;1234;95;306;171;499;266;805
510777;201605;1577;4609;1161;4057;152;565;883;3131;1035;3696
510779;201605;632;1903;484;1620;66;225;226;796;292;1021
510780;201605;3678;10846;2995;9804;733;2504;1166;4123;1899;6627
510785;201605;1726;5007;1277;4219;385;1328;219;755;604;2083
510787;201605;2255;6723;1782;5905;761;2697;285;892;1046;3589
510788;201605;562;1443;404;1216;156;492;91;321;247;813
510790;201605;15834;45665;10863;36318;2139;8278;1045;3564;3184;11842
510792;201605;8011;23405;5539;18736;1066;4062;819;2625;1885;6687
510794;201605;1184;3693;956;3243;295;1124;259;827;554;1951
510795;201605;8045;23831;5913;19910;1510;5620;1134;4058;2644;9678
510800;201605;1550;4324;1226;3864;273;937;506;1495;779;2432
510805;201605;1936;5347;1499;4675;294;1021;768;2317;1062;3338
510810;201605;649;1586;502;1387;139;386;222;594;361;980
510820;201605;728;1720;482;1356;81;273;181;445;262;718
510830;201605;675;2068;553;1886;134;495;286;1041;420;1536
510835;201605;629;1860;481;1586;101;372;183;565;284;937
510840;201605;46771;116414;37151;104009;8923;26383;16537;47778;25460;74161
510850;201605;1501;4267;1029;3397;255;903;136;409;391;1312
510860;201605;2654;8214;1922;6795;661;2620;120;396;781;3016
510880;201605;621;2046;529;1886;172;664;191;696;363;1360
510885;201605;637;1787;512;1617;99;343;197;622;296;965
510890;201605;832;2603;680;2382;178;707;304;1038;482;1745
510895;201605;1074;3302;901;2965;213;800;338;1038;551;1838
520005;201605;1421;4501;1259;4268;330;1148;603;2132;933;3280
520010;201605;1699;5675;1373;5007;518;2166;229;740;747;2906
520013;201605;3382;9435;2501;7793;578;1895;778;2465;1356;4360
520015;201605;469;1338;378;1208;79;279;135;440;214;719
520017;201605;1056;3119;878;2827;218;781;330;986;548;1767
520020;201605;454;1158;347;1011;77;238;150;430;227;668
520025;201605;26455;81647;24951;79879;2841;9742;19757;63382;22598;73124
520030;201605;4604;14222;3864;13012;712;2677;1940;6545;2652;9222
520050;201605;420;1062;289;854;18;45;182;563;200;608
520055;201605;739;2227;651;2044;100;305;362;1168;462;1473
520060;201605;1333;4156;1136;3766;251;938;389;1240;640;2178
520080;201605;1820;5262;1529;4886;292;889;854;2954;1146;3843
520082;201605;1079;2922;954;2728;122;320;645;1924;767;2244
520085;201605;832;2511;722;2319;160;517;241;765;401;1282
520090;201605;979;2258;707;1922;156;376;356;1076;512;1452
520110;201605;41512;119427;32291;105536;11571;43099;4668;14802;16239;57901
520120;201605;189;494;122;382;22;81;29;92;51;173
520130;201605;3401;9515;3078;9064;648;2102;1624;4901;2272;7003
520140;201605;36845;118538;31523;108904;10927;41117;4987;17009;15914;58126
520145;201605;358;967;253;780;56;187;74;216;130;403
520150;201605;472;1238;381;1135;54;187;212;628;266;815
520160;201605;885;2379;717;2129;202;605;190;589;392;1194
520170;201605;4324;9914;3370;8829;259;703;2717;7279;2976;7982
520180;201605;2090;6099;1734;5566;284;1081;862;2731;1146;3812
520215;201605;1952;4997;1622;4480;162;452;1075;3027;1237;3479
520235;201605;693;1792;505;1511;93;316;204;582;297;898
520250;201605;1537;4366;1148;3733;304;1129;237;750;541;1879
520260;201605;785;1983;524;1499;80;257;185;492;265;749
520280;201605;563;1625;497;1539;163;527;186;648;349;1175
520310;201605;1199;2861;845;2294;229;669;269;789;498;1458
520320;201605;1862;5759;1543;5162;116;402;1018;3494;1134;3896
520330;201605;2695;8213;2056;7132;517;1947;312;1040;829;2987
520340;201605;1818;4566;1394;4018;197;510;908;2820;1105;3330
520350;201605;3205;8725;2484;7436;656;2175;880;2555;1536;4730
520355;201605;1061;3504;951;3332;288;1103;380;1287;668;2390
520357;201605;862;2315;720;2083;61;192;498;1453;559;1645
520360;201605;669;1952;573;1794;145;477;226;734;371;1211
520380;201605;1290;3464;876;2660;121;391;361;1076;482;1467
520390;201605;1091;2549;638;1954;176;632;205;560;381;1192
520393;201605;500;1216;394;1067;53;149;234;624;287;773
520396;201605;699;2252;573;2003;66;269;362;1239;428;1508
520400;201605;1677;4796;1432;4448;239;796;883;2722;1122;3518
520410;201605;1472;3554;1078;3005;213;672;579;1586;792;2258
520420;201605;319;881;235;710;40;132;76;198;116;330
520425;201605;1092;3027;904;2697;236;723;413;1259;649;1982
520430;201605;1882;4980;1200;3703;235;731;197;535;432;1266
520440;201605;3695;9469;2485;7323;722;2342;483;1412;1205;3754
520450;201605;10372;28541;7083;22541;1409;4858;424;1299;1833;6157
520455;201605;660;1958;529;1734;133;465;193;636;326;1101
520460;201605;879;2472;721;2212;116;423;390;1150;506;1573
520465;201605;808;2245;699;2111;84;282;445;1326;529;1608
520470;201605;1753;5612;1571;5327;350;1209;954;3374;1304;4583
520480;201605;938;2712;665;2221;118;431;232;714;350;1145
520485;201605;1296;4050;1130;3794;265;992;621;2077;886;3069
520490;201605;3993;12367;3179;11110;976;3469;1332;4910;2308;8379
520495;201605;1305;3542;1115;3297;83;253;894;2722;977;2975
520500;201605;1306;3660;1082;3344;280;945;436;1335;716;2280
520505;201605;736;2089;628;1921;140;431;323;1000;463;1431
520510;201605;8929;24895;6425;20984;1532;5521;2024;6813;3556;12334
520520;201605;1068;2946;847;2629;268;881;236;757;504;1638
520530;201605;1978;6456;1616;5845;572;2078;435;1744;1007;3822
520540;201605;2826;7934;2086;6571;548;1813;342;1112;890;2925
520545;201605;1076;3223;895;2895;171;595;272;830;443;1425
520547;201605;647;2034;558;1867;193;665;167;527;360;1192
520549;201605;9470;27732;7928;25663;2325;7833;3459;11495;5784;19328
520551;201605;3530;10739;3252;10350;850;3019;1914;5999;2764;9018
520552;201605;769;2295;693;2198;100;328;482;1564;582;1892
520570;201605;559;1573;416;1335;153;528;117;349;270;877
520580;201605;3222;7884;2241;6533;544;1805;1006;2875;1550;4680
520590;201605;1365;3859;1051;3334;235;751;203;629;438;1380
520620;201605;7444;22835;6718;21829;1665;5618;3655;12073;5320;17691
520630;201605;917;2359;663;1989;107;319;275;832;382;1151
520640;201605;2778;7621;2271;6777;597;1817;838;2609;1435;4426
520650;201605;844;2255;621;1845;119;400;326;955;445;1355
520660;201605;340;965;269;872;95;342;84;275;179;617
520670;201605;911;2681;822;2556;61;191;661;2066;722;2257
520680;201605;746;1958;590;1728;140;395;259;778;399;1173
520690;201605;316;858;244;746;55;146;109;350;164;496
520710;201605;546;1412;341;1015;7;19;206;611;213;630
520725;201605;1578;4056;1180;3394;180;558;709;2024;889;2582
520735;201605;762;2140;541;1714;124;446;168;515;292;961
520740;201605;1619;4474;1301;4081;238;829;671;2101;909;2930
520750;201605;590;1592;472;1412;95;273;225;720;320;993
520753;201605;1468;3968;1320;3767;162;459;873;2668;1035;3127
520760;201605;816;2163;716;2033;81;227;504;1505;585;1732
520780;201605;1915;4685;1503;4128;142;398;993;2716;1135;3114
520790;201605;2796;7176;2211;6348;219;575;1558;4721;1777;5296
520800;201605;15817;44860;13647;42295;2927;8607;7925;26656;10852;35263
520810;201605;1035;2571;824;2320;106;277;599;1811;705;2088
520815;201605;582;1851;434;1535;184;740;14;40;198;780
520830;201605;1622;4171;1323;3844;39;110;1136;3303;1175;3413
520840;201605;1606;5179;1354;4751;502;1911;250;935;752;2846
520850;201605;587;1800;444;1545;111;433;138;477;249;910
520860;201605;6526;19072;4916;16432;1192;4274;1584;5438;2776;9712
520870;201605;100956;268757;71160;221098;19751;67626;14882;44851;34633;112477
520880;201605;6938;19895;5258;17476;1845;6873;577;1901;2422;8774
520890;201605;3798;10617;3053;9407;592;1997;1456;4491;2048;6488
520910;201605;3842;11015;2793;9029;942;3271;477;1483;1419;4754
520915;201605;649;1932;526;1695;120;413;231;740;351;1153
520920;201605;3417;9131;2450;7629;429;1451;964;3100;1393;4551
520929;201605;533;1468;414;1287;79;242;237;766;316;1008
520940;201605;1056;3026;851;2727;98;353;601;1907;699;2260
520945;201605;649;1570;519;1361;133;313;242;634;375;947
520960;201605;1027;2993;809;2587;71;224;416;1374;487;1598
520970;201605;2828;8519;2448;7863;610;2133;625;1947;1235;4080
520980;201605;752;2165;665;2036;220;715;321;989;541;1704
520990;201605;2942;9470;2773;9238;422;1458;1871;6543;2293;8001
520993;201605;934;2376;747;2112;47;137;545;1576;592;1713
520995;201605;2323;6117;2027;5770;353;901;1364;4074;1717;4975
521000;201605;6895;20796;5658;18493;1772;6363;1381;4268;3153;10631
521010;201605;3968;11512;3114;9982;755;2408;1147;3733;1902;6141
521015;201605;682;1881;585;1731;124;348;322;971;446;1319
521020;201605;3018;8651;2095;6767;562;1961;209;632;771;2593
521030;201605;654;1644;493;1374;94;253;197;577;291;830
521040;201605;5988;16192;5031;14770;1717;5230;1590;4953;3307;10183
521056;201605;850;2585;708;2356;248;874;201;744;449;1618
521060;201605;1116;2886;897;2557;166;450;441;1350;607;1800
521080;201605;1132;2708;672;1965;67;243;250;624;317;867
521090;201605;2931;7847;2304;7048;732;2340;655;2083;1387;4423
521100;201605;1979;4412;1507;3852;268;625;968;2649;1236;3274
521120;201605;4513;11943;3556;10711;803;2597;1457;4651;2260;7248
521130;201605;1005;2712;753;2237;93;341;433;1264;526;1605
521140;201605;1032;3113;845;2759;218;741;270;899;488;1640
521150;201605;11982;30026;7678;22593;2725;8500;1687;5065;4412;13565
521160;201605;847;1990;538;1471;111;312;224;604;335;916
521170;201605;1137;2780;858;2374;173;499;476;1292;649;1791
521180;201605;6370;20538;5733;19452;1660;6060;1738;5901;3398;11961
521190;201605;9322;26575;6266;20936;1515;5568;1184;3919;2699;9487
521200;201605;745;2026;609;1803;77;258;355;1035;432;1293
521205;201605;603;1700;467;1456;40;134;266;833;306;967
521210;201605;932;2586;615;1960;178;663;124;323;302;986
521220;201605;4259;10867;3197;9476;763;2503;1392;4182;2155;6685
521225;201605;374;913;305;837;29;74;219;636;248;710
521230;201605;1163;3698;1073;3529;340;1205;512;1640;852;2845
521250;201605;28169;88661;24732;83465;10663;38136;6119;21222;16782;59358
521260;201605;694;1684;576;1519;99;304;315;808;414;1112
521270;201605;1884;5379;1719;5155;173;446;1274;4000;1447;4446
521280;201605;1821;5517;1488;4877;426;1481;392;1254;818;2735
521290;201605;494;1365;368;1172;90;335;162;489;252;824
521295;201605;1172;2868;988;2628;137;345;706;1988;843;2333
521300;201605;1917;5373;1642;4934;204;573;1004;3088;1208;3661
521305;201605;743;2092;609;1885;117;335;330;1071;447;1406
521308;201605;4357;12820;3440;11049;912;2973;1254;4047;2166;7020
521310;201605;7754;22833;5600;18685;1366;4927;1077;3413;2443;8340
521340;201605;309;794;291;774;15;45;247;647;262;692
521350;201605;1958;5381;1613;4844;233;653;1065;3330;1298;3983
521370;201605;939;2742;710;2341;236;852;137;439;373;1291
521375;201605;1150;3512;965;3184;219;782;398;1264;617;2046
521377;201605;1092;2735;1010;2648;62;110;890;2419;952;2529
521380;201605;5452;15409;3920;12538;584;1986;939;3120;1523;5106
521385;201605;501;1336;446;1266;118;360;217;626;335;986
521390;201605;789;2206;649;2019;167;617;216;639;383;1256
521400;201605;1936;5563;1792;5387;213;710;1385;4192;1598;4902
521405;201605;1380;3868;1076;3315;304;1001;423;1328;727;2329
521410;201605;699;2146;656;2079;229;677;283;985;512;1662
521440;201605;1358;3952;1125;3467;175;585;426;1149;601;1734
521450;201605;3884;12508;3153;11095;1009;3783;574;1966;1583;5749
521460;201605;6625;19081;5539;17265;1387;4686;2485;7607;3872;12293
521470;201605;693;1997;516;1652;109;376;83;267;192;643
521480;201605;376;1130;254;863;53;186;80;261;133;447
521483;201605;2821;7356;2147;6211;547;1598;598;1701;1145;3299
521486;201605;1595;4067;1300;3643;116;297;941;2668;1057;2965
521487;201605;578;1481;411;1213;110;346;79;225;189;571
521490;201605;783;2245;631;1997;42;180;417;1273;459;1453
521500;201605;1342;4218;1021;3531;189;747;236;724;425;1471
521520;201605;883;2097;671;1815;157;449;319;921;476;1370
521523;201605;13031;46627;12210;45235;4275;17242;1533;6371;5808;23613
521525;201605;1046;2719;894;2494;111;368;572;1555;683;1923
521530;201605;1726;4889;1083;3579;232;806;144;479;376;1285
521540;201605;935;2501;644;2017;135;504;215;642;350;1146
521550;201605;1375;3528;931;2630;200;596;424;1167;624;1763
521560;201605;3620;11836;3030;11011;1174;4684;949;3408;2123;8092
521565;201605;598;1527;503;1409;91;212;310;893;401;1105
521570;201605;4593;12636;2948;9383;646;2271;524;1698;1170;3969
521580;201605;553;1275;354;991;85;237;82;222;167;459
521590;201605;630;1746;516;1571;144;479;142;415;286;894
521600;201605;490;1348;354;1120;86;296;80;245;166;541
521630;201605;1363;3417;975;2862;227;798;191;477;418;1275
521640;201605;2058;5225;1591;4589;430;1270;664;1978;1094;3248
521645;201605;579;1707;438;1418;66;231;152;455;218;686
521680;201605;1351;4310;1140;3904;541;1991;134;438;675;2429
521690;201605;575;1675;507;1560;124;439;228;644;352;1083
521710;201605;2877;8413;2303;7431;479;1621;788;2607;1267;4228
521720;201605;1882;5310;1521;4688;307;946;811;2446;1118;3392
521730;201605;3624;11815;3155;10889;1142;4385;608;1829;1750;6214
521740;201605;3577;9809;2827;8743;658;2209;1256;4149;1914;6358
521760;201605;13280;42886;11724;40271;3038;11351;4688;16325;7726;27676
521770;201605;2599;7530;2096;6614;757;2569;546;1631;1303;4200
521800;201605;6969;21037;5985;19371;1836;6298;2068;7003;3904;13301
521805;201605;927;2079;668;1711;151;349;357;1006;508;1355
521810;201605;806;2005;588;1695;113;356;247;754;360;1110
521830;201605;5223;16476;4666;15654;739;2710;3103;10420;3842;13130
521839;201605;725;1988;552;1674;105;336;199;577;304;913
521850;201605;6840;18261;5239;15551;1228;3882;1494;4154;2722;8036
521860;201605;1986;5347;1525;4644;346;1178;438;1317;784;2495
521870;201605;479;1580;394;1398;98;364;125;429;223;793
521878;201605;778;2227;553;1758;78;276;223;670;301;946
521880;201605;23288;59514;15732;47474;4053;13125;4473;14058;8526;27183
521890;201605;3357;9974;2623;8595;743;2598;469;1499;1212;4097
521900;201605;1444;3785;1016;3155;235;771;338;976;573;1747
521910;201605;902;2452;802;2335;136;414;466;1452;602;1866
521920;201605;297;942;246;850;90;347;48;153;138;500
521925;201605;674;2053;566;1863;116;419;192;594;308;1013
521930;201605;3612;11615;3114;10669;1050;3751;521;1832;1571;5583
521935;201605;589;1667;505;1515;129;397;234;683;363;1080
521940;201605;997;2757;814;2482;177;597;401;1194;578;1791
521945;201605;675;2115;587;1979;98;329;327;1194;425;1523
521950;201605;641;1668;520;1493;68;209;334;971;402;1180
521960;201605;660;1987;534;1738;108;392;227;722;335;1114
521970;201605;2611;6837;2162;6294;210;589;1682;5087;1892;5676
521971;201605;1013;2691;708;2129;126;384;171;496;297;880
521973;201605;936;2878;789;2615;145;501;371;1239;516;1740
521975;201605;12193;33557;11136;32326;2016;6160;7440;21528;9456;27688
521980;201605;2009;5560;1719;5204;244;629;1326;4210;1570;4839
521990;201605;1183;3306;949;2940;85;280;627;1991;712;2271
522000;201605;2261;6176;1637;5380;199;724;907;3144;1106;3868
522005;201605;397;963;273;776;79;216;89;264;168;480
522010;201605;3418;9750;2862;8835;1007;3170;614;1939;1621;5109
522015;201605;887;2627;748;2407;162;519;367;1200;529;1719
522020;201605;5119;13218;3975;11490;955;2836;1921;5509;2876;8345
522026;201605;608;1644;446;1457;104;372;152;539;256;911
522028;201605;522;1490;419;1262;59;181;247;747;306;928
522040;201605;2402;5834;1890;5204;392;1081;1139;3202;1531;4283
522045;201605;15052;48841;12504;43704;3379;12986;2224;7704;5603;20690
522050;201605;1158;3256;826;2642;190;634;219;625;409;1259
522060;201605;2659;7826;2089;6969;601;2190;871;2942;1472;5132
522068;201605;1694;5281;1522;5082;146;423;1194;4213;1340;4636
522070;201605;709;2132;633;2009;73;287;447;1404;520;1691
522100;201605;508;1527;441;1429;162;579;174;541;336;1120
522108;201605;859;2651;718;2437;61;267;540;1792;601;2059
522119;201605;1368;4190;1148;3852;276;984;507;1756;783;2740
522130;201605;353;997;288;922;89;294;164;535;253;829
522140;201605;17495;48702;14052;42827;4008;13073;3433;9969;7441;23042
522145;201605;806;2225;695;2058;254;765;251;806;505;1571
522150;201605;885;2454;759;2251;209;617;283;860;492;1477
522155;201605;822;2321;716;2159;136;365;437;1411;573;1776
522157;201605;656;1812;558;1673;37;131;433;1303;470;1434
522160;201605;5860;16668;4260;13798;1181;4248;379;1194;1560;5442
522170;201605;2305;6730;1857;5907;588;1974;386;1210;974;3184
522180;201605;336;979;251;836;74;269;64;225;138;494
522185;201605;15085;43049;12500;39752;3373;11318;6341;20619;9714;31937
522190;201605;881;2192;674;1899;106;312;330;987;436;1299
522200;201605;1690;5425;1384;4775;352;1310;325;1075;677;2385
522205;201605;1396;3911;1127;3491;216;721;565;1725;781;2446
522220;201605;1378;3625;1116;3307;250;726;578;1865;828;2591
522230;201605;1215;3388;1024;3090;111;410;645;1925;756;2335
530010;201605;220677;686168;194772;641510;51040;185873;65262;210086;116302;395959
110001;201604;3298;10974;2931;10400;696;2579;1412;5098;2108;7677
110002;201604;12852;37794;10100;32987;2993;10593;3027;9752;6020;20345
110003;201604;732;2386;658;2246;194;697;142;465;336;1162
110004;201604;9828;30659;7989;27006;2375;8659;1388;4856;3763;13515
110005;201604;1794;5709;1550;5257;501;1742;611;2081;1112;3823
110006;201604;1891;5764;1303;4614;357;1386;140;440;497;1826
110007;201604;1315;4051;1221;3861;368;1245;464;1653;832;2898
110008;201604;2317;7923;2175;7724;375;1239;1552;5782;1927;7021
110009;201604;4534;13683;3568;12159;1032;3801;1033;3568;2065;7369
110010;201604;7474;22350;6579;21173;1767;5655;3240;11526;5007;17181
110011;201604;7413;22991;6335;20927;2187;7565;1934;6421;4121;13986
110012;201604;14182;41822;11550;37235;3277;11043;2893;9683;6170;20726
110013;201604;5210;16565;4491;15271;1738;6105;1109;4032;2847;10137
110014;201604;3984;11788;3486;10992;875;2847;1780;5659;2655;8506
110015;201604;4717;14126;3400;11625;953;3526;589;1995;1542;5521
110018;201604;4002;11297;2995;9802;764;2809;1027;3216;1791;6025
110020;201604;61722;169141;46018;147959;10226;34977;19819;65979;30045;100956
110025;201604;4188;12043;3426;10713;577;1916;2030;6267;2607;8183
110026;201604;613;1897;564;1823;138;428;307;1040;445;1468
110028;201604;6637;20041;5231;17303;1429;5181;617;2013;2046;7194
110029;201604;1324;3861;1081;3469;316;1056;415;1345;731;2401
110030;201604;10095;27456;7760;24286;2020;6988;3002;9603;5022;16591
110032;201604;3790;11922;3309;11018;1058;3597;915;3035;1973;6632
110033;201604;5186;16518;4673;15663;1510;5067;1700;6079;3210;11146
110034;201604;3351;9049;2771;8262;823;2524;1480;4411;2303;6935
110037;201604;1941;6537;1662;5993;431;1655;691;2482;1122;4137
110040;201604;3379;10626;2886;9730;836;3040;1038;3425;1874;6465
110045;201604;4924;16004;4245;15138;1376;5357;1918;6840;3294;12197
110050;201604;1601;5148;1360;4712;461;1663;549;1916;1010;3579
110060;201604;796;2635;651;2337;226;912;116;392;342;1304
110070;201604;1927;6457;1783;6159;549;2051;736;2447;1285;4498
110080;201604;4212;11582;3657;10952;605;1713;2582;8155;3187;9868
110090;201604;716;2119;563;1845;125;465;244;760;369;1225
110092;201604;1275;4269;1171;4123;200;755;744;2689;944;3444
110094;201604;3548;10625;3081;9988;1025;3546;1206;3929;2231;7475
110100;201604;2111;6711;1923;6358;582;2036;889;2952;1471;4988
110110;201604;1595;5112;1423;4884;580;2007;352;1305;932;3312
110120;201604;1780;5631;1390;4791;400;1457;265;898;665;2355
110130;201604;2357;6870;1765;5826;564;1969;304;1008;868;2977
110140;201604;2301;7515;1922;6765;561;2162;490;1599;1051;3761
110143;201604;1212;3773;915;3259;284;1053;353;1296;637;2349
110145;201604;985;2835;791;2525;201;705;384;1200;585;1905
110146;201604;429;1324;362;1220;72;240;197;685;269;925
110147;201604;689;2037;548;1786;142;476;172;532;314;1008
110148;201604;1198;3643;862;2888;143;491;79;247;222;738
110149;201604;3247;9775;2617;8742;890;2959;1013;3582;1903;6541
110150;201604;2358;6920;1968;6348;540;1848;699;2359;1239;4207
110155;201604;829;2554;739;2348;187;639;308;928;495;1567
110160;201604;1902;6092;1593;5496;562;1975;504;1768;1066;3743
110170;201604;2808;7909;2035;6489;442;1470;957;3049;1399;4519
110175;201604;1595;4894;1290;4489;216;790;687;2524;903;3314
110180;201604;1275;3739;1070;3430;263;820;582;1923;845;2743
120001;201604;2718;9370;2519;9055;505;1896;1531;5663;2036;7559
120005;201604;1483;6242;1392;6061;156;751;1029;4648;1185;5399
120010;201604;4548;15491;4349;15195;542;1892;3311;11858;3853;13750
120013;201604;1780;7132;1699;7016;387;1578;1005;4421;1392;5999
120017;201604;1950;7125;1824;6897;521;2010;788;3325;1309;5335
120020;201604;13891;62354;13440;61478;1917;9098;9648;45618;11565;54716
120025;201604;2398;8412;2308;8286;451;1709;1444;5281;1895;6990
120030;201604;6228;24402;6082;24236;212;1018;5530;22134;5742;23152
120032;201604;1453;7080;1398;6954;167;1026;1020;5065;1187;6091
120033;201604;3480;14044;3397;13895;241;1021;3016;12480;3257;13501
120034;201604;2100;8770;2010;8598;139;805;1651;6991;1790;7796
120035;201604;3074;13974;2999;13830;215;1118;2557;11924;2772;13042
120038;201604;2588;9440;2448;9176;638;2437;1266;4918;1904;7355
120039;201604;1638;8308;1599;8221;153;937;1239;6447;1392;7384
120040;201604;43993;157489;40287;150626;9537;38573;19643;74898;29180;113471
120042;201604;2941;12506;2799;12192;326;1616;2040;8980;2366;10596
120043;201604;894;4208;863;4158;72;347;693;3470;765;3817
120045;201604;4159;14266;4053;14138;515;1907;3313;11614;3828;13521
120050;201604;7892;32712;7525;31927;1029;4698;5194;22723;6223;27421
120060;201604;7522;33756;7370;33491;687;3671;5869;26931;6556;30602
120070;201604;2625;9861;2553;9704;415;1567;1670;6552;2085;8119
120080;201604;3517;13390;3364;13125;606;2494;2339;9308;2945;11802
130002;201604;3042;12547;2863;12273;164;835;2453;10572;2617;11407
130006;201604;1959;8317;1726;7898;250;1302;1198;5509;1448;6811
130008;201604;2126;8456;1985;8205;160;710;1600;6686;1760;7396
130010;201604;2935;9725;2684;9441;161;620;2370;8356;2531;8976
130014;201604;3071;10118;2706;9534;481;1792;1680;6015;2161;7807
130020;201604;2647;9807;2563;9660;66;347;2230;8294;2296;8641
130030;201604;7339;27885;7077;27585;393;1346;6333;25290;6726;26636
130040;201604;3748;11622;3336;11076;286;1012;2676;9050;2962;10062
130050;201604;5902;24309;5601;23878;375;1611;4728;20769;5103;22380
130060;201604;5583;26395;5363;26039;522;3059;4201;20371;4723;23430
130063;201604;3658;16322;3536;16176;281;1383;3074;14211;3355;15594
130068;201604;3136;13152;2836;12525;332;1614;1898;8507;2230;10121
130070;201604;6842;21907;6064;20995;607;2121;4734;16765;5341;18886
130080;201604;5240;23267;4973;22856;712;3664;3529;16437;4241;20101
130083;201604;2108;8348;1988;8177;283;1308;1395;5753;1678;7061
130090;201604;2601;9408;2498;9253;99;464;2227;8236;2326;8700
130100;201604;5624;20922;5486;20754;151;646;5155;19557;5306;20203
130110;201604;6627;21366;6230;20902;688;2134;5008;17346;5696;19480
130115;201604;4413;15693;4199;15366;171;699;3705;13609;3876;14308
130120;201604;14556;55211;13649;54067;1347;5421;11130;45169;12477;50590
130130;201604;3812;15634;3760;15537;213;1085;3283;13539;3496;14624
130140;201604;6250;24289;6139;24165;225;896;5772;22805;5997;23701
130150;201604;3335;13303;3259;13211;154;865;2915;11689;3069;12554
130160;201604;4135;17253;3988;17059;440;2187;3245;13844;3685;16031
130165;201604;2842;11772;2706;11545;241;1205;2179;9327;2420;10532
130170;201604;9129;32597;8044;31268;999;4175;6069;24049;7068;28224
130180;201604;3444;11386;3376;11293;123;297;3145;10680;3268;10977
130185;201604;11247;35856;10061;34510;878;2714;8208;29542;9086;32256
130190;201604;16510;56977;14495;54392;2609;9930;9403;36824;12012;46754
130195;201604;1931;8116;1864;8027;105;477;1641;7174;1746;7651
130200;201604;2009;7060;1831;6789;442;1624;1098;4228;1540;5852
130210;201604;1219;4878;1152;4788;113;580;955;3935;1068;4515
130220;201604;1977;8114;1808;7795;296;1462;1037;4455;1333;5917
130230;201604;3613;16587;3391;16223;365;1857;2576;12711;2941;14568
130240;201604;8513;32246;7800;31272;378;2027;6740;27069;7118;29096
130250;201604;19325;67755;18195;66331;2720;9673;13241;50446;15961;60119
130255;201604;4194;14591;3916;14161;178;727;3449;12593;3627;13320
130260;201604;239821;786475;216049;746350;62310;229646;90861;316872;153171;546518
130270;201604;6974;29438;6499;28683;894;4065;4711;21538;5605;25603
130280;201604;3243;13454;3139;13331;122;548;2886;12421;3008;12969
130290;201604;11143;39637;10656;39071;218;698;10078;37570;10296;38268
130300;201604;4328;16888;4137;16590;234;1115;3603;14500;3837;15615
130310;201604;4936;18874;4571;18397;322;1413;3836;15669;4158;17082
130320;201604;2922;10499;2675;10159;358;1462;1853;7217;2211;8679
130330;201604;3531;12911;3236;12536;213;1015;2693;10416;2906;11431
130340;201604;17664;67700;16421;66163;2543;10234;12433;51705;14976;61939
130350;201604;3207;13494;3135;13388;271;1543;2596;10923;2867;12466
130353;201604;5965;18296;5233;17372;1122;3649;3157;11332;4279;14981
130356;201604;4524;16346;4261;15965;433;1576;3288;12793;3721;14369
130360;201604;3229;9198;2856;8800;134;359;2595;8183;2729;8542
130370;201604;5379;20853;4686;19960;219;1255;3937;16799;4156;18054
130380;201604;7780;32400;7511;32044;435;2175;6523;27983;6958;30158
130390;201604;4914;21991;4622;21451;491;2610;3452;16126;3943;18736
130395;201604;2115;7520;1898;7106;228;925;1296;4806;1524;5731
130400;201604;2079;7915;1989;7790;141;672;1736;6799;1877;7471
130406;201604;10448;39908;9519;38593;2123;8926;6001;24928;8124;33854
130410;201604;3863;14749;3481;14109;1054;4570;1496;6315;2550;10885
130420;201604;10479;44394;10022;43738;2194;9449;6791;30942;8985;40391
130423;201604;3212;12537;3003;12252;269;1335;2487;10085;2756;11420
130426;201604;2212;9599;2145;9493;217;1027;1709;7720;1926;8747
130430;201604;3366;11980;3233;11786;291;1110;2636;9734;2927;10844
130440;201604;3453;12702;3270;12494;248;1006;2795;10783;3043;11789
140002;201604;1610;5313;1486;5138;118;488;1101;3800;1219;4288
140005;201604;3186;9133;3070;9005;64;160;2950;8713;3014;8873
140010;201604;54564;158705;45187;145018;11115;37861;18792;63452;29907;101313
140015;201604;2786;9083;2624;8885;231;631;2193;7727;2424;8358
140017;201604;3084;9809;2802;9456;270;864;2131;7501;2401;8365
140020;201604;4303;14711;3910;14160;556;2200;2711;9874;3267;12074
140023;201604;2125;7175;1854;6776;195;779;1327;4942;1522;5721
140028;201604;2074;5739;1927;5544;260;845;1392;3831;1652;4676
140030;201604;3624;11524;3379;11207;438;1253;2489;8579;2927;9832
140040;201604;1657;7799;1624;7742;95;567;1443;6839;1538;7406
140045;201604;2421;8987;2206;8692;434;1612;1425;6058;1859;7670
140047;201604;5483;16480;4843;15522;1257;4103;2190;7602;3447;11705
140050;201604;1348;4315;1215;4140;269;929;715;2502;984;3431
140060;201604;1441;4417;1285;4174;231;812;834;2719;1065;3531
140070;201604;1487;8153;1438;8003;120;830;1127;6274;1247;7104
150010;201604;35205;106699;33156;103987;2113;7060;27015;85207;29128;92267
150013;201604;1705;4976;1547;4795;171;506;1200;3826;1371;4332
150020;201604;12276;41309;11857;40736;1361;4371;9540;33663;10901;38034
150030;201604;7078;30133;6854;29794;765;3037;5544;24954;6309;27991
150034;201604;4194;11625;3962;11336;159;475;3562;10235;3721;10710
150040;201604;12714;40864;10981;38783;1804;5705;7854;29808;9658;35513
150050;201604;5595;21978;5346;21563;283;1419;4572;18441;4855;19860
150060;201604;17448;54510;15868;52053;2998;9791;9991;33937;12989;43728
150070;201604;5902;24102;5282;23452;294;1482;4706;21085;5000;22567
150080;201604;71557;185393;61143;171902;12067;33562;33447;99064;45514;132626
150085;201604;5343;18159;5084;17829;455;1376;4256;15459;4711;16835
150090;201604;10089;38753;9549;37969;841;3465;7491;30429;8332;33894
150095;201604;5218;17158;4769;16511;372;1196;3799;13666;4171;14862
150100;201604;3186;11971;2995;11654;169;821;2404;9205;2573;10026
150110;201604;3260;16284;3250;16264;231;1155;2825;14375;3056;15530
150120;201604;6371;23607;6222;23380;519;1899;5079;19678;5598;21577
150125;201604;691;2045;605;1943;107;383;388;1246;495;1629
150130;201604;21855;66392;20241;64191;2379;7238;14918;48723;17297;55961
150140;201604;159340;447649;149639;435124;17335;49664;113438;335706;130773;385370
150145;201604;4452;14262;4059;13761;534;1968;3102;10652;3636;12620
150150;201604;11856;36095;10906;34701;1903;6400;6980;22507;8883;28907
150157;201604;3083;9247;2695;8701;355;1297;1857;6088;2212;7385
150160;201604;3077;9893;2895;9628;928;3148;1467;5049;2395;8197
150170;201604;21376;79043;20199;77173;3034;11839;14109;55027;17143;66866
150172;201604;3064;10459;2693;9849;401;1503;1834;6896;2235;8399
150175;201604;1899;5797;1780;5665;150;474;1447;4795;1597;5269
150178;201604;9946;30901;8788;29614;1094;3907;6255;21821;7349;25728
150180;201604;18334;73459;17639;72566;1317;6082;14854;61618;16171;67700
150190;201604;6889;23525;6624;23164;258;979;5969;21061;6227;22040
150195;201604;5150;17064;4807;16522;242;902;4158;14413;4400;15315
150200;201604;5264;16714;5023;16438;114;373;4697;15520;4811;15893
150210;201604;24573;92588;23771;91465;2068;7958;19427;76908;21495;84866
150215;201604;6823;21629;6018;20360;1772;6241;2423;8406;4195;14647
150220;201604;11879;37011;10641;35103;2446;8245;5301;17983;7747;26228
150230;201604;11660;36807;10187;34760;1415;5221;6719;23352;8134;28573
150240;201604;35001;103907;30700;96581;10048;32647;8827;29158;18875;61805
150250;201604;3998;16605;3858;16404;670;2872;2702;11919;3372;14791
150260;201604;2026;8071;1935;7913;400;1631;1153;4903;1553;6534
150270;201604;8446;25987;6720;23777;1771;6540;3590;13121;5361;19661
150275;201604;5824;21197;5530;20729;692;2527;4007;15419;4699;17946
150276;201604;2077;6256;1841;5943;385;1312;1232;4008;1617;5320
150277;201604;4760;14781;4126;14002;738;2613;2774;9697;3512;12310
150280;201604;5756;25845;5583;25485;1035;4795;3753;17623;4788;22418
150285;201604;2827;11057;2651;10742;441;1853;1713;7159;2154;9012
150290;201604;9763;28335;9342;27859;655;1603;8008;24728;8663;26331
150293;201604;9532;25994;7232;22848;2134;7161;2385;8343;4519;15504
150295;201604;7516;21919;6213;20407;1499;4982;3348;12178;4847;17160
150300;201604;1916;6436;1805;6290;113;489;1439;4988;1552;5477
150304;201604;4054;12868;3520;12042;569;1960;2248;7989;2817;9949
150307;201604;6422;21575;5972;20944;406;1384;4945;17500;5351;18884
150309;201604;5977;20757;5417;19965;1198;4379;3218;12544;4416;16923
150310;201604;6020;26168;5808;25850;587;2833;4628;20865;5215;23698
150320;201604;9398;22878;8678;22110;570;1252;7388;19214;7958;20466
150330;201604;13654;46755;12790;45497;1792;6395;9244;33969;11036;40364
150340;201604;2427;7841;2243;7557;255;884;1654;5605;1909;6489
150345;201604;6537;21804;6114;21245;561;1939;4856;17285;5417;19224
150350;201604;7886;24426;7326;23706;1229;3332;5288;18043;6517;21375
150360;201604;20838;64867;18278;61602;3113;10444;11984;42250;15097;52694
150370;201604;9797;35748;9139;34880;1304;4721;6800;27230;8104;31951
150375;201604;2861;12574;2767;12446;227;1012;2366;10829;2593;11841
150380;201604;9895;28583;8752;27008;528;1657;7263;22747;7791;24404
150390;201604;7743;33499;7259;32648;1278;5584;4681;22022;5959;27606
150400;201604;5793;22871;5574;22447;461;1869;4425;18191;4886;20060
150405;201604;8126;24554;7223;23446;1279;3300;4876;17538;6155;20838
150410;201604;1582;6021;1462;5776;207;934;877;3464;1084;4398
150420;201604;36217;121398;30641;112378;9545;38177;9231;36010;18776;74187
150430;201604;7263;24577;6907;24024;908;3036;5082;18205;5990;21241
150440;201604;5382;18677;5171;18390;798;2780;3781;13866;4579;16646
150442;201604;21241;61542;18883;58009;3490;10722;11224;35802;14714;46524
150445;201604;5123;17837;4770;17244;603;2174;3480;12903;4083;15077
150450;201604;4205;20472;4064;20257;357;1842;3341;16970;3698;18812
150460;201604;6803;25635;6269;24990;325;1651;5275;21613;5600;23264
150470;201604;16979;52412;16321;51639;436;1151;15328;49096;15764;50247
150475;201604;3116;10797;2882;10495;265;1003;2322;8615;2587;9618
150480;201604;13723;46745;12708;45216;1266;4690;10026;36270;11292;40960
150490;201604;6902;26683;6747;26461;272;1184;5959;23603;6231;24787
150495;201604;4864;18158;4725;17975;178;731;4340;16622;4518;17353
150497;201604;2655;9817;2392;9310;799;3268;997;3960;1796;7228
150500;201604;3096;8608;2884;8310;239;678;2272;6544;2511;7222
150503;201604;3616;11117;3100;10472;1063;3694;1551;5496;2614;9190
150506;201604;10944;38300;9956;36894;2411;8563;5901;23593;8312;32156
150510;201604;9522;37498;8744;35953;1414;5883;5655;24270;7069;30153
150520;201604;6636;26199;6520;26049;250;977;6041;24399;6291;25376
150530;201604;12140;41363;10962;39578;1138;3906;8363;30873;9501;34779
150540;201604;4626;14081;4124;13390;272;891;3358;10960;3630;11851
150543;201604;5612;17409;4997;16532;1017;3501;3001;10254;4018;13755
150548;201604;8911;28794;8358;28090;477;1512;7486;25548;7963;27060
150549;201604;2027;6602;1874;6430;72;261;1699;5897;1771;6158
150550;201604;19864;62870;17413;58820;5221;18096;6483;22991;11704;41087
150553;201604;22659;77926;18978;70461;6850;27247;4288;16374;11138;43621
150555;201604;1675;5095;1425;4685;93;334;1082;3592;1175;3926
150560;201604;1935;6324;1817;6083;289;964;1116;3757;1405;4721
150563;201604;2660;8821;2464;8491;629;2355;1275;4378;1904;6733
150565;201604;3766;12993;3444;12492;199;909;2828;10317;3027;11226
150570;201604;5768;21110;5630;20878;399;1774;4537;16860;4936;18634
150580;201604;9371;39652;9125;39373;555;2450;8048;35372;8603;37822
150590;201604;5645;22589;5437;22326;169;794;5006;20609;5175;21403
150600;201604;7683;29974;7374;29528;374;1654;6514;26299;6888;27953
150610;201604;2381;8075;2178;7673;221;846;1511;5277;1732;6123
150611;201604;2710;9378;2551;9093;174;682;2062;7382;2236;8064
150613;201604;11846;35612;9832;32582;3163;11086;3711;12657;6874;23743
150616;201604;3019;9197;2344;8087;558;2132;761;2505;1319;4637
150618;201604;6230;21427;5646;20377;1614;5921;2727;10195;4341;16116
150619;201604;5096;17457;4716;16864;547;2172;3389;12138;3936;14310
150620;201604;6302;22626;5764;21938;714;2761;4443;17356;5157;20117
150630;201604;5676;17162;5378;16814;557;1800;4360;13898;4917;15698
150635;201604;3932;12876;3543;12099;866;3086;1545;5437;2411;8523
150640;201604;1811;5519;1740;5434;232;668;1386;4562;1618;5230
150650;201604;12240;36813;10935;34614;2928;9408;4615;15292;7543;24700
150655;201604;4981;16584;4682;16042;653;2277;3325;11558;3978;13835
150658;201604;4433;13394;3854;12595;887;3172;2225;7497;3112;10669
150660;201604;5499;17280;5030;16598;1228;4036;2571;8816;3799;12852
150670;201604;7216;19092;5940;17527;739;2298;4477;13597;5216;15895
150680;201604;56370;198613;49490;187063;14846;58397;19038;78193;33884;136590
150690;201604;2024;6197;1828;5899;274;836;1228;4075;1502;4911
150700;201604;6131;19121;5615;18451;971;3287;3655;12368;4626;15655
150710;201604;4235;14315;3805;13618;448;1667;2705;9912;3153;11579
150715;201604;4882;15446;4260;14509;481;1857;3132;10727;3613;12584
150720;201604;6465;26219;6118;25599;787;3466;4408;19013;5195;22479
150730;201604;9694;33004;9038;31920;1055;3864;6955;25146;8010;29010
150740;201604;3669;11736;3291;11060;676;2367;1731;5854;2407;8221
150745;201604;5088;16221;4599;15546;1187;4249;2648;8954;3835;13203
150746;201604;1373;4462;1310;4353;128;410;942;3173;1070;3583
150747;201604;5302;16480;4705;15733;364;1033;3584;12950;3948;13983
150750;201604;3240;10607;2997;10294;206;820;2440;8425;2646;9245
150760;201604;10844;35136;10104;34170;2037;7041;6516;22605;8553;29646
150770;201604;5755;22039;5473;21562;382;1410;4596;19133;4978;20543
150775;201604;1109;3395;965;3137;195;756;499;1584;694;2340
150780;201604;3276;10651;3177;10542;103;367;2921;9734;3024;10101
150790;201604;4924;16133;4596;15747;344;1241;3667;13358;4011;14599
150795;201604;15044;47685;13578;45472;3026;10008;7883;27664;10909;37672
150796;201604;3054;8988;2773;8655;365;1173;2076;6642;2441;7815
150797;201604;3636;12438;3368;11989;114;497;2852;10129;2966;10626
150800;201604;13582;44788;12496;43456;2718;8836;8133;30146;10851;38982
150803;201604;6587;23850;6191;23213;684;2674;4535;17261;5219;19935
150805;201604;2556;9197;2384;8912;326;1214;1707;6501;2033;7715
150808;201604;5665;18872;4697;17036;1812;7210;627;2301;2439;9511
150810;201604;18783;58076;15800;54478;2273;7530;10430;38317;12703;45847
150812;201604;5155;16297;4754;15627;494;1881;3331;10628;3825;12509
150815;201604;8471;27908;7619;26845;835;2942;5951;21528;6786;24470
150820;201604;11274;32544;10102;31246;774;1837;8274;26532;9048;28369
150830;201604;12837;48215;12056;47200;638;3136;9870;39752;10508;42888
150835;201604;2063;7255;1918;6987;456;1663;944;3556;1400;5219
150840;201604;6995;21450;5881;19619;1331;4851;2755;9151;4086;14002
160005;201604;772;2683;735;2609;72;292;589;2064;661;2356
160010;201604;1294;4351;1290;4346;48;99;1231;4223;1279;4322
160015;201604;1684;6203;1648;6155;82;297;1501;5691;1583;5988
160020;201604;1892;6866;1781;6721;208;824;1341;5175;1549;5999
160021;201604;1023;4382;981;4315;143;744;696;3080;839;3824
160023;201604;989;4006;981;3996;100;401;808;3338;908;3739
160025;201604;1287;3948;1272;3933;25;96;1227;3786;1252;3882
160027;201604;8079;24082;7467;23405;2059;6259;4480;14854;6539;21113
160030;201604;45584;160276;40755;152100;9795;36955;21293;84607;31088;121562
160040;201604;4292;16753;4194;16618;173;992;3833;14982;4006;15974
160050;201604;2973;11398;2663;10956;1373;5565;767;3539;2140;9104
160053;201604;2695;10451;2634;10363;533;2165;1764;7071;2297;9236
160055;201604;523;2110;516;2101;31;132;449;1836;480;1968
160060;201604;15294;52063;14262;50858;2518;8652;10039;36959;12557;45611
160070;201604;2482;9823;2341;9581;175;856;1978;8045;2153;8901
160080;201604;2501;9487;2459;9437;102;505;2290;8710;2392;9215
170025;201604;500;1650;459;1592;125;442;236;841;361;1283
170030;201604;1139;3748;992;3485;268;966;373;1353;641;2319
170035;201604;1413;4104;1163;3668;221;768;511;1615;732;2383
170040;201604;1883;5940;1663;5661;201;758;1016;3716;1217;4474
170070;201604;1641;4433;1289;3964;275;920;680;2062;955;2982
170100;201604;2332;6992;2036;6559;232;740;1549;5058;1781;5798
170105;201604;746;2321;589;2006;118;454;273;888;391;1342
170110;201604;936;3066;813;2843;183;683;341;1219;524;1902
170130;201604;1338;4246;1107;3803;301;1082;471;1668;772;2750
170190;201604;1528;4498;1169;3917;432;1398;208;848;640;2246
170200;201604;1572;4406;1026;3370;265;938;225;716;490;1654
170210;201604;31100;88360;25050;78762;7488;25500;6107;20330;13595;45830
170215;201604;1177;3648;997;3372;86;342;708;2389;794;2731
170220;201604;5536;19138;5109;18307;1259;4681;2534;9244;3793;13925
170230;201604;1354;4368;1126;3934;237;938;469;1595;706;2533
170240;201604;2672;8018;2202;7285;256;1000;1485;4873;1741;5873
170255;201604;3264;10494;2740;9578;849;3028;1078;3940;1927;6968
170270;201604;992;2492;695;2091;69;212;462;1376;531;1588
170290;201604;2768;8347;2496;8035;254;570;2030;7031;2284;7601
170300;201604;1898;5835;1584;5333;187;705;1018;3476;1205;4181
170305;201604;728;2192;592;1946;90;329;313;1034;403;1363
170307;201604;1015;3611;858;3324;180;792;397;1595;577;2387
170310;201604;1580;4382;1199;3744;313;1043;511;1628;824;2671
170320;201604;1113;3211;806;2680;196;709;262;886;458;1595
170330;201604;786;2556;713;2443;75;289;541;1823;616;2112
170360;201604;451;1429;373;1293;73;260;174;597;247;857
170370;201604;1337;3818;1048;3359;185;679;544;1709;729;2388
170380;201604;1707;5512;1382;4974;223;913;701;2539;924;3452
170382;201604;556;1851;473;1716;75;305;295;1086;370;1391
170384;201604;1544;6242;1411;5988;331;1484;724;3128;1055;4612
170386;201604;881;2637;767;2469;212;783;314;964;526;1747
170388;201604;639;1919;522;1730;110;411;189;610;299;1021
170389;201604;913;3081;830;2944;73;293;613;2168;686;2461
170390;201604;1241;3599;1059;3374;83;290;831;2689;914;2979
170410;201604;525;1676;442;1531;35;150;276;952;311;1102
170460;201604;483;1323;322;1036;70;259;102;326;172;585
170510;201604;746;2501;603;2242;81;361;297;1078;378;1439
170550;201604;6713;19074;4979;16062;1517;5407;590;1889;2107;7296
170555;201604;1321;3801;1063;3404;203;711;505;1678;708;2389
170560;201604;1040;3387;817;3095;166;692;450;1802;616;2494
170600;201604;1295;3816;1150;3617;303;943;681;2212;984;3155
170610;201604;1647;4953;1315;4427;149;552;816;2758;965;3310
170625;201604;412;1239;309;1036;49;161;90;295;139;456
170650;201604;1197;3899;1010;3561;255;949;362;1391;617;2340
170700;201604;4062;12702;3291;11429;687;2600;1404;5049;2091;7649
170710;201604;1729;5167;1398;4571;219;753;796;2643;1015;3396
170720;201604;1821;4930;1549;4501;216;524;1131;3482;1347;4006
170730;201604;959;2817;783;2542;204;693;302;1000;506;1693
170740;201604;2155;7643;1871;7121;289;1166;1171;4514;1460;5680
170755;201604;747;2353;602;2033;99;392;235;778;334;1170
170765;201604;1289;3531;979;3032;274;892;374;1212;648;2104
170770;201604;1647;5642;1505;5400;250;925;912;3325;1162;4250
170820;201604;3431;11149;3097;10599;671;2443;1478;5126;2149;7569
170825;201604;702;2110;585;1888;93;302;271;876;364;1178
170830;201604;1374;4041;1185;3764;97;239;990;3266;1087;3505
170900;201604;2468;8833;2327;8608;210;818;1864;7000;2074;7818
170930;201604;3564;10888;3108;10156;846;2912;1264;4288;2110;7200
170950;201604;13573;39465;10168;33505;3009;11273;1513;5008;4522;16281
170980;201604;494;1455;370;1256;68;261;151;495;219;756
171050;201604;1463;4969;1319;4696;83;391;1038;3650;1121;4041
171070;201604;1427;4542;1307;4370;330;1080;689;2419;1019;3499
171090;201604;1036;2828;857;2578;63;183;625;1883;688;2066
171110;201604;583;1708;437;1443;120;449;173;518;293;967
171150;201604;983;2717;667;2163;138;475;353;1164;491;1639
171180;201604;690;2089;481;1659;116;411;170;643;286;1054
171190;201604;1622;6022;1432;5616;283;1167;660;2739;943;3906
171195;201604;796;2852;691;2658;97;410;397;1559;494;1969
171200;201604;669;2109;538;1859;165;622;177;572;342;1194
171215;201604;456;1345;351;1133;56;201;158;520;214;721
171240;201604;697;2545;641;2436;69;329;422;1642;491;1971
171245;201604;610;2047;500;1789;103;412;159;554;262;966
171250;201604;1022;3007;821;2671;170;600;392;1242;562;1842
171270;201604;394;1619;369;1565;123;497;134;654;257;1151
171280;201604;862;2632;716;2384;182;611;298;1084;480;1695
171320;201604;3731;11282;3151;10299;881;2887;1301;4409;2182;7296
171330;201604;2773;8091;2253;7274;630;2144;953;3082;1583;5226
171360;201604;1298;4372;1181;4189;160;596;798;2872;958;3468
171370;201604;630;1833;543;1713;118;421;294;914;412;1335
171380;201604;1263;4089;1056;3721;408;1457;261;1009;669;2466
171395;201604;859;2616;671;2256;123;491;304;977;427;1468
171420;201604;2059;6389;1633;5612;394;1433;575;1992;969;3425
171430;201604;1039;3193;864;2910;184;631;442;1496;626;2127
171488;201604;2445;7521;2107;7033;473;1560;1124;3940;1597;5500
171500;201604;776;2347;664;2173;80;252;459;1549;539;1801
171510;201604;864;3037;778;2892;66;280;545;2066;611;2346
171515;201604;496;1419;384;1222;60;190;209;653;269;843
171525;201604;626;2012;534;1861;80;315;305;1018;385;1333
171550;201604;311;1058;241;926;81;343;47;187;128;530
171570;201604;1200;3806;1048;3509;205;658;668;2306;873;2964
171575;201604;1889;5339;1432;4515;280;922;644;2061;924;2983
171610;201604;5163;16519;4334;15092;1124;4379;1324;4663;2448;9042
171620;201604;2612;7583;2250;7105;109;446;1861;5884;1970;6330
171630;201604;861;2673;709;2432;216;789;300;1043;516;1832
171650;201604;2110;6618;1655;5697;448;1630;509;1776;957;3406
171660;201604;2398;6666;1864;5741;242;825;1044;3192;1286;4017
171665;201604;1456;4251;1169;3814;199;712;638;2179;837;2891
171670;201604;1885;5357;1563;4839;423;1426;631;1915;1054;3341
171700;201604;1065;3443;916;3165;119;460;580;1986;699;2446
171720;201604;708;2113;601;1943;188;630;248;834;436;1464
171750;201604;1136;3558;880;3053;254;879;244;906;498;1785
171780;201604;1117;3086;848;2701;93;319;499;1635;592;1954
171790;201604;1344;4729;1211;4490;274;994;702;2764;976;3758
171800;201604;627;1995;556;1894;69;263;383;1344;452;1607
171820;201604;9896;29423;8244;27004;1647;5783;4210;14036;5857;19819
171830;201604;1351;5039;1206;4722;311;1194;510;2099;821;3293
171840;201604;770;2122;657;1968;37;115;538;1621;575;1736
171845;201604;700;1940;547;1681;83;285;287;903;370;1188
171850;201604;911;3258;809;3060;100;435;505;1894;605;2329
171855;201604;1083;3467;992;3298;75;297;734;2405;809;2702
171865;201604;443;1466;383;1371;76;285;189;677;265;962
171870;201604;711;2141;575;1897;150;537;196;690;346;1227
171875;201604;1240;4010;1042;3693;98;417;697;2436;795;2853
171880;201604;795;3015;775;2987;84;329;613;2427;697;2756
171884;201604;957;2645;698;2266;168;597;175;680;343;1277
171886;201604;1374;4491;1110;3961;315;1228;237;849;552;2077
171888;201604;690;2094;532;1788;56;192;295;1019;351;1211
171889;201604;503;1595;451;1511;97;344;227;809;324;1153
171890;201604;1184;3696;992;3423;140;536;584;2012;724;2548
171900;201604;484;1784;410;1611;109;435;172;707;281;1142
172000;201604;530;1767;462;1641;78;294;254;892;332;1186
172010;201604;1166;4058;1080;3913;120;528;785;2831;905;3359
172015;201604;320;1269;269;1165;52;204;141;641;193;845
172020;201604;2244;7503;2090;7258;260;946;1459;5149;1719;6095
172025;201604;689;2010;507;1698;88;327;241;837;329;1164
172030;201604;1126;3680;997;3468;63;278;747;2577;810;2855
172049;201604;1330;3483;990;2911;147;406;707;2169;854;2575
172065;201604;1335;3521;1094;3248;63;164;984;3002;1047;3166
172080;201604;2365;7459;2044;6906;216;846;1314;4404;1530;5250
172085;201604;502;1398;359;1110;56;159;94;300;150;459
172090;201604;3458;9903;2845;8983;178;630;2270;7244;2448;7874
172093;201604;600;1807;479;1610;120;468;229;774;349;1242
172097;201604;592;1793;476;1601;103;359;171;582;274;941
172100;201604;33000;97478;25328;84193;6880;25501;6178;20766;13058;46267
172110;201604;1633;6142;1452;5849;179;810;1033;4260;1212;5070
172120;201604;4989;15613;4147;14426;772;2667;2465;8987;3237;11654
172125;201604;241;777;201;703;40;167;87;303;127;470
172130;201604;550;1520;429;1323;40;154;272;827;312;981
172208;201604;2070;6143;1857;5848;287;928;1119;3566;1406;4494
172210;201604;2486;7599;2179;7164;504;1805;1152;3747;1656;5552
210005;201604;21562;67138;18277;62121;5861;21293;6450;22482;12311;43775
210010;201604;1591;5703;1443;5449;103;449;1127;4302;1230;4751
210015;201604;3371;10654;3003;10103;193;514;2546;8861;2739;9375
210020;201604;7100;17097;6663;16594;216;558;6059;15033;6275;15591
210030;201604;5435;18176;5103;17724;323;1481;4192;14463;4515;15944
210040;201604;1875;5193;1734;5031;87;254;1524;4452;1611;4706
210043;201604;6668;18677;5730;17513;588;1663;4105;13343;4693;15006
210047;201604;6490;24389;5904;23485;579;2678;4427;17643;5006;20321
210050;201604;2261;8375;1898;7674;668;2773;636;2780;1304;5553
210055;201604;1735;5947;1576;5709;142;557;1195;4350;1337;4907
210060;201604;7178;27841;6671;26915;1014;4211;4334;18016;5348;22227
210070;201604;7055;20783;6520;20129;133;491;5895;18304;6028;18795
210080;201604;3635;12621;3543;12505;37;182;3365;11889;3402;12071
210083;201604;4307;15113;3961;14748;131;556;3701;13855;3832;14411
210087;201604;2949;8670;2687;8334;293;925;2112;6686;2405;7611
210090;201604;9825;32246;9310;31436;488;1747;8001;27184;8489;28931
210095;201604;5911;21447;5670;21115;346;1418;4750;17882;5096;19300
210100;201604;7228;21727;6628;20999;749;2576;5133;16194;5882;18770
210110;201604;2831;9908;2731;9773;102;467;2463;8786;2565;9253
210120;201604;25904;70651;22611;66865;2660;6544;16506;52437;19166;58981
210125;201604;3540;11301;3416;11172;190;466;3029;10213;3219;10679
210130;201604;4110;12225;3799;11790;280;888;3110;9673;3390;10561
210135;201604;1659;4900;1452;4606;98;324;1169;3740;1267;4064
210140;201604;16788;53697;14635;50809;2594;9482;9089;32778;11683;42260
210150;201604;4571;11273;4104;10704;60;164;3849;10036;3909;10200
210160;201604;17389;54832;16335;53322;1338;3966;13238;44475;14576;48441
210170;201604;13807;49181;13433;48715;687;2553;11956;43895;12643;46448
210173;201604;1963;8036;1889;7913;104;604;1635;6783;1739;7387
210177;201604;3037;9422;2883;9244;151;491;2578;8362;2729;8853
210180;201604;1468;4504;1372;4361;55;205;1160;3665;1215;3870
210190;201604;4835;15402;4449;14693;213;929;3445;11179;3658;12108
210193;201604;1383;4354;1245;4127;72;256;1023;3446;1095;3702
210197;201604;2079;6944;1918;6759;235;803;1477;5394;1712;6197
210200;201604;8294;27977;7682;27103;1048;3469;5704;20994;6752;24463
210203;201604;6495;20808;6167;20382;378;1095;5350;17990;5728;19085
210207;201604;3093;9973;2911;9647;294;945;2152;7288;2446;8233
210210;201604;8346;28194;7983;27715;75;350;7331;25988;7406;26338
210215;201604;1149;4803;1096;4720;92;448;874;3828;966;4276
210220;201604;6037;22990;5739;22512;340;1612;4779;18849;5119;20461
210230;201604;5139;16732;4812;16239;267;929;4119;14037;4386;14966
210232;201604;12777;41167;10753;38597;1483;5634;6991;27031;8474;32665
210235;201604;3629;11324;3249;10848;168;668;2768;9285;2936;9953
210237;201604;2329;8965;2264;8872;42;221;2142;8421;2184;8642
210240;201604;3007;9427;2811;9158;154;468;2361;7769;2515;8237
210250;201604;5198;16840;4890;16439;128;650;4455;14850;4583;15500
210255;201604;2554;8258;2335;7882;300;1063;1673;5704;1973;6767
210260;201604;5112;16715;4698;16092;577;1886;3463;12268;4040;14154
210270;201604;5369;15111;4718;14214;129;581;4141;12368;4270;12949
210275;201604;3563;8671;3377;8470;263;763;2889;7256;3152;8019
210280;201604;5551;16796;4802;15786;267;1146;3688;11948;3955;13094
210290;201604;5593;18647;5164;18136;313;1105;4391;15670;4704;16775
210300;201604;37540;104818;31184;97030;2040;6799;23648;76792;25688;83591
210310;201604;2893;8156;2652;7839;80;182;2338;7007;2418;7189
210312;201604;2177;6893;2072;6758;61;289;1830;5947;1891;6236
210315;201604;2606;8639;2417;8391;141;534;2078;7318;2219;7852
210317;201604;4143;12895;3948;12659;161;579;3592;11584;3753;12163
210320;201604;19149;62261;17614;60420;905;3252;15007;52464;15912;55716
210325;201604;3583;11199;3187;10603;244;921;2468;8333;2712;9254
210330;201604;35695;87082;28141;78952;3965;9452;18280;58845;22245;68297
210340;201604;11559;35029;10537;33705;1159;3224;7738;26542;8897;29766
210350;201604;9910;30674;8926;29317;606;1999;7168;23905;7774;25904
210355;201604;3881;14279;3571;13818;192;819;3061;12105;3253;12924
210360;201604;15866;48213;14399;46218;1082;3822;11265;36328;12347;40150
210370;201604;9347;22482;7836;20869;292;556;6899;19130;7191;19686
210375;201604;3087;9381;2610;8770;767;2662;1240;4313;2007;6975
210380;201604;6071;16873;5407;15972;439;1184;4380;13245;4819;14429
210390;201604;2863;10248;2607;9835;135;707;2203;8293;2338;9000
210400;201604;4774;15169;4573;14943;123;363;4322;14260;4445;14623
210405;201604;8314;22715;6681;20438;2177;6739;2272;7830;4449;14569
210407;201604;2017;7208;1746;6746;220;844;1220;4836;1440;5680
210408;201604;2397;9287;2243;9095;144;680;1896;7914;2040;8594
210409;201604;3690;13469;3481;13169;212;1016;2852;10817;3064;11833
210410;201604;3543;11887;3443;11765;326;966;2806;10079;3132;11045
210420;201604;4029;13328;3695;12765;259;861;2980;10500;3239;11361
210430;201604;2166;6698;2090;6612;118;357;1827;5833;1945;6190
210440;201604;3902;12314;3780;12161;198;573;3407;11124;3605;11697
210450;201604;2782;8764;2478;8322;142;514;1988;6654;2130;7168
210455;201604;3887;11422;3492;10841;546;1677;2429;7875;2975;9552
210460;201604;3567;11804;3316;11415;180;731;2713;9357;2893;10088
210462;201604;1448;5265;1350;5084;92;442;1067;4011;1159;4453
210465;201604;2513;8373;2349;8148;195;569;1960;7024;2155;7593
210467;201604;6148;20433;5738;19961;400;1414;4834;17095;5234;18509
210470;201604;2034;5518;1493;4724;86;238;1102;3563;1188;3801
210480;201604;14580;46637;12707;44255;2412;8238;8214;30785;10626;39023
210490;201604;3588;10063;3143;9450;130;451;2650;7943;2780;8394
210500;201604;6246;25860;6016;25459;658;2837;4580;19914;5238;22751
210510;201604;6469;22087;6122;21687;352;1038;5212;19106;5564;20144
210515;201604;3624;11670;3470;11496;83;246;3254;10950;3337;11196
210520;201604;2582;7912;2359;7597;155;473;1962;6473;2117;6946
210530;201604;36850;113430;29660;102595;7485;29132;12113;43284;19598;72416
210535;201604;3206;11115;3079;10947;96;319;2782;10038;2878;10357
210540;201604;13447;44032;11785;41693;2427;8403;6704;25640;9131;34043
210542;201604;5746;16703;5256;16171;296;712;4552;14441;4848;15153
210545;201604;2314;7510;2205;7330;56;294;1947;6392;2003;6686
210547;201604;3717;13295;3479;12907;291;980;2695;10312;2986;11292
210550;201604;6008;17936;5509;17417;258;612;5043;16403;5301;17015
210560;201604;4053;12755;3630;12069;176;672;3034;10081;3210;10753
210565;201604;1468;5241;1258;4905;101;508;924;3637;1025;4145
210570;201604;12295;34834;11160;33550;742;1685;9583;29810;10325;31495
210580;201604;3171;9405;2847;9005;301;679;2192;7566;2493;8245
210590;201604;4037;12781;3741;12409;299;1051;3151;10522;3450;11573
210592;201604;2464;7760;2369;7607;40;175;2099;6739;2139;6914
210594;201604;2654;7476;2155;6751;118;301;1663;5440;1781;5741
210596;201604;2671;9947;2531;9683;269;1112;1852;7213;2121;8325
210598;201604;1878;5837;1719;5643;93;349;1480;4833;1573;5182
210600;201604;3194;9274;2796;8747;181;585;2211;6937;2392;7522
210610;201604;2486;8245;2333;8049;122;554;2029;6897;2151;7451
210620;201604;1911;6262;1784;6109;51;132;1618;5682;1669;5814
210630;201604;3612;12789;3232;12174;339;1487;2235;8479;2574;9966
210632;201604;4498;15664;4169;15192;430;1707;3212;11737;3642;13444
210635;201604;1862;6528;1766;6384;104;362;1534;5653;1638;6015
210637;201604;2642;9013;2435;8733;158;622;1974;7147;2132;7769
210640;201604;4209;15662;4139;15584;7;32;4036;15347;4043;15379
210650;201604;6820;20871;6617;20624;217;667;6241;19550;6458;20217
210660;201604;7993;23897;7259;22824;246;884;6569;20614;6815;21498
210663;201604;2678;8045;2521;7863;170;594;2118;6659;2288;7253
210667;201604;1835;6411;1731;6247;80;371;1500;5428;1580;5799
210670;201604;4429;16447;4215;16098;227;1038;3495;13457;3722;14495
210675;201604;5067;14057;4684;13597;377;929;3868;11593;4245;12522
210680;201604;4044;11145;3585;10596;181;472;3075;9221;3256;9693
210690;201604;7277;24452;6979;24134;260;866;6179;22057;6439;22923
210700;201604;2616;7807;2422;7592;503;1308;1563;5646;2066;6954
210710;201604;4827;15902;4547;15473;211;900;3830;12984;4041;13884
210720;201604;2539;9259;2399;9065;138;642;2101;7889;2239;8531
210725;201604;1076;4079;966;3879;124;514;602;2507;726;3021
210730;201604;1117;3524;997;3351;90;274;777;2666;867;2940
210735;201604;4121;14306;3770;13732;616;2321;2573;9668;3189;11989
210740;201604;4947;14824;4665;14535;212;919;4224;12910;4436;13829
210745;201604;3944;11643;3698;11333;254;692;3117;9680;3371;10372
210750;201604;20188;54750;17817;52091;1902;5563;13675;41048;15577;46611
210760;201604;5841;16656;5433;16229;39;134;5279;15821;5318;15955
210770;201604;5876;16162;5122;15307;117;474;4634;13843;4751;14317
210780;201604;8161;27298;7480;26159;873;3055;5234;18854;6107;21909
210790;201604;4624;14598;4198;14110;268;687;3437;12203;3705;12890
210800;201604;4761;13541;4306;13005;136;430;3837;11691;3973;12121
210805;201604;3753;15614;3620;15383;173;901;3119;13352;3292;14253
210810;201604;5391;16443;4986;15932;338;654;4290;14361;4628;15015
210820;201604;7679;22341;7004;21383;1121;3310;4683;14742;5804;18052
210825;201604;5622;19431;5355;19071;632;2132;4147;15294;4779;17426
210830;201604;8317;24517;7887;24006;881;2276;6222;19789;7103;22065
210840;201604;3641;9987;3268;9438;149;399;2713;7852;2862;8251
210845;201604;5767;17654;5577;17448;82;191;5360;16994;5442;17185
210850;201604;6099;21689;5522;20735;668;2845;3849;14478;4517;17323
210860;201604;17657;52483;15873;50068;1266;4041;12507;40082;13773;44123
210870;201604;5837;19626;5333;18989;606;2092;4033;14713;4639;16805
210880;201604;4217;13776;4019;13522;314;1165;3315;11173;3629;12338
210890;201604;5162;15198;4689;14658;446;1279;3818;12452;4264;13731
210900;201604;4933;14776;4072;13383;1502;5211;1006;3546;2508;8757
210905;201604;1828;5762;1641;5503;120;317;1302;4547;1422;4864
210910;201604;8497;27096;7656;25720;1124;4015;5126;17380;6250;21395
210920;201604;2867;10371;2743;10164;168;781;2237;8282;2405;9063
210923;201604;1498;5124;1395;4975;145;582;939;3467;1084;4049
210927;201604;4732;15261;4483;14999;53;199;4301;14478;4354;14677
210930;201604;2454;8995;2315;8795;126;728;1953;7276;2079;8004
210940;201604;2830;10914;2762;10787;172;781;2346;9134;2518;9915
210945;201604;5874;17810;5672;17598;276;384;5291;16908;5567;17292
210950;201604;5267;16223;4551;15102;422;1425;3370;11424;3792;12849
210955;201604;1872;6065;1657;5744;173;598;1163;4216;1336;4814
210960;201604;8947;29178;8445;28520;2081;6719;4923;17848;7004;24567
210970;201604;1346;4790;1187;4535;153;661;823;3138;976;3799
210975;201604;1772;5920;1696;5795;111;400;1356;4665;1467;5065
210980;201604;10028;23732;9693;23391;696;1354;8547;21230;9243;22584
210990;201604;16586;50540;13504;46329;3133;11293;6640;23814;9773;35107
211000;201604;15247;49294;13557;47289;792;3362;11228;39748;12020;43110
211003;201604;4765;17034;4356;16480;307;1420;3302;12828;3609;14248
211010;201604;6447;23630;6185;23323;73;349;5897;22389;5970;22738
211020;201604;7371;23942;7148;23620;634;2263;5787;19143;6421;21406
211023;201604;2223;7542;2145;7416;179;684;1741;6031;1920;6715
211027;201604;2900;11199;2821;11078;295;1194;2249;8942;2544;10136
211030;201604;3827;11769;3577;11505;600;1396;2659;9379;3259;10775
211040;201604;4280;16253;4103;15984;138;749;3591;14073;3729;14822
211050;201604;10127;26264;9746;25849;266;664;9130;24272;9396;24936
211060;201604;6090;21631;5914;21389;455;1711;5066;18545;5521;20256
211065;201604;1906;6300;1760;6112;55;166;1633;5762;1688;5928
211070;201604;8006;27638;7364;26604;398;1565;6097;22348;6495;23913
211080;201604;1326;4074;1137;3787;76;368;877;2810;953;3178
211085;201604;1890;6472;1725;6197;291;1078;1119;4092;1410;5170
211090;201604;3497;10254;3267;9940;125;508;2812;8432;2937;8940
211100;201604;6600;17077;6457;16928;37;126;6291;16520;6328;16646
211102;201604;2983;11372;2812;11130;237;970;2352;9478;2589;10448
211105;201604;2642;8540;2259;7957;212;852;1667;5823;1879;6675
211107;201604;4406;14127;3980;13587;221;779;3238;11407;3459;12186
211110;201604;6334;18896;5103;17066;940;3090;3076;10788;4016;13878
211120;201604;35447;98805;31956;94722;5576;15807;21642;67060;27218;82867
211125;201604;2070;6603;1832;6227;115;451;1513;5147;1628;5598
211130;201604;138872;383228;127226;368969;22910;67519;75087;226931;97997;294450
211140;201604;5316;17346;4965;16827;181;731;4232;14354;4413;15085
211150;201604;9623;28026;8683;26854;428;1547;7317;22661;7745;24208
211153;201604;2839;8742;2584;8409;554;1807;1717;5772;2271;7579
211157;201604;1195;3852;1034;3614;86;391;687;2477;773;2868
211160;201604;4109;13498;3485;12459;254;1232;2418;8435;2672;9667
211163;201604;1665;5523;1567;5390;35;113;1421;5000;1456;5113
211167;201604;1500;5015;1438;4933;34;157;1341;4606;1375;4763
211170;201604;6309;16744;6044;16434;106;318;5600;15178;5706;15496
211172;201604;2428;7165;2207;6858;123;528;1871;5724;1994;6252
211174;201604;2765;8084;2496;7754;73;361;2249;6871;2322;7232
211176;201604;4254;13351;3651;12554;390;1499;2609;9092;2999;10591
211178;201604;3830;10197;3602;9952;64;169;3432;9478;3496;9647
211180;201604;4204;14696;3962;14340;297;1190;3266;11949;3563;13139
211190;201604;2803;9413;2599;9116;72;346;2274;7976;2346;8322
211195;201604;1462;4463;1223;4169;55;158;1033;3649;1088;3807
211200;201604;2154;7157;1895;6805;361;1215;1150;4441;1511;5656
211210;201604;6741;20783;6407;20340;427;1312;5386;17278;5813;18590
211220;201604;33838;98211;29390;92574;5603;18163;18318;59329;23921;77492
211223;201604;5040;14992;4611;14328;530;1684;3341;10475;3871;12159
211227;201604;1605;5704;1465;5486;139;558;1149;4358;1288;4916
211230;201604;8339;27242;7545;25946;785;2797;5640;19719;6425;22516
211240;201604;7975;27589;7555;27076;264;1214;6770;24076;7034;25290
211245;201604;5510;16248;5474;16210;116;189;5303;15912;5419;16101
211250;201604;13139;43262;12383;42386;1504;4318;9646;35034;11150;39352
211260;201604;8510;26483;8115;25957;511;1770;7154;22897;7665;24667
211270;201604;10239;35174;9179;33852;520;2361;7225;27209;7745;29570
211280;201604;12830;38220;11960;37169;1054;2729;9745;31546;10799;34275
211285;201604;1710;6295;1501;5843;269;1134;757;3071;1026;4205
211290;201604;7161;23557;6877;23197;467;1435;5871;20202;6338;21637
211300;201604;8202;24767;7690;24092;155;434;7168;22679;7323;23113
211400;201604;11755;36767;10364;34837;2774;9514;4901;18185;7675;27699
220005;201604;1831;5253;1680;5035;68;258;1368;4013;1436;4271
220010;201604;1349;3999;1205;3777;51;202;965;2975;1016;3177
220020;201604;3258;10387;3093;10119;589;1946;1906;6253;2495;8199
220025;201604;2240;5519;2032;5210;24;75;1739;4403;1763;4478
220027;201604;1365;3675;1225;3495;64;191;998;2867;1062;3058
220030;201604;3165;8798;3103;8708;146;508;2742;7588;2888;8096
220040;201604;7493;23452;6938;22466;1459;4712;4167;13557;5626;18269
220045;201604;1379;4559;1258;4329;54;245;971;3275;1025;3520
220050;201604;4412;13366;3871;12466;202;821;3098;9876;3300;10697
220060;201604;2025;5121;1902;4980;42;95;1736;4555;1778;4650
220070;201604;2392;7073;2196;6763;157;483;1765;5453;1922;5936
220080;201604;699;2118;650;2044;51;214;541;1646;592;1860
220090;201604;1762;4513;1488;4153;51;169;1291;3551;1342;3720
220095;201604;716;1949;668;1885;14;65;616;1708;630;1773
220100;201604;1341;4098;1135;3746;78;314;857;2798;935;3112
220105;201604;2236;7114;2008;6691;150;502;1481;4975;1631;5477
220110;201604;3363;9807;3162;9486;112;452;2773;8180;2885;8632
220115;201604;2430;8375;2335;8223;133;568;2063;7213;2196;7781
220117;201604;1290;3463;1076;3144;61;179;875;2575;936;2754
220120;201604;12124;35316;11239;34259;143;631;10557;32152;10700;32783
220130;201604;852;2935;770;2801;34;192;662;2365;696;2557
220140;201604;1650;4432;1463;4205;199;463;1156;3454;1355;3917
220150;201604;6974;21362;6602;20844;161;680;5831;18256;5992;18936
220155;201604;1106;3385;901;3012;52;211;592;1954;644;2165
220157;201604;1063;2693;946;2521;22;68;825;2170;847;2238
220160;201604;2589;7846;2313;7346;92;414;1854;5797;1946;6211
220170;201604;1357;4165;1172;3867;42;200;950;3110;992;3310
220173;201604;2047;6188;1699;5524;46;228;1347;4305;1393;4533
220177;201604;1761;5237;1732;5199;49;193;1624;4848;1673;5041
220180;201604;1109;3058;935;2733;23;86;654;1823;677;1909
220190;201604;4519;14903;4196;14464;555;1981;3128;10832;3683;12813
220191;201604;1410;4664;1331;4532;142;531;992;3324;1134;3855
220192;201604;1761;5008;1422;4409;95;302;1030;3213;1125;3515
220194;201604;1681;5085;1516;4812;107;399;1170;3626;1277;4025
220196;201604;1988;5855;1831;5593;141;499;1449;4392;1590;4891
220198;201604;1328;3801;1025;3404;11;41;961;3235;972;3276
220200;201604;4379;14670;4105;14288;543;1949;3057;10761;3600;12710
220202;201604;2135;6506;1912;6125;45;223;1651;5184;1696;5407
220205;201604;2750;7212;2472;6824;41;160;2212;6045;2253;6205
220207;201604;888;2701;762;2478;72;286;541;1733;613;2019
220208;201604;1798;5794;1557;5374;227;873;944;3266;1171;4139
220209;201604;1525;4634;1350;4345;45;201;1113;3539;1158;3740
220210;201604;1667;4537;1483;4255;36;156;1231;3452;1267;3608
220211;201604;1562;4501;1496;4426;55;227;1315;3835;1370;4062
220213;201604;1737;4925;1612;4700;34;135;1323;3758;1357;3893
220217;201604;1961;6336;1886;6253;38;140;1745;5862;1783;6002
220220;201604;10737;29843;9659;28260;734;1890;7088;21316;7822;23206
220225;201604;1080;3146;907;2915;34;128;751;2391;785;2519
220230;201604;5285;14649;4833;14005;153;437;4314;12566;4467;13003
220240;201604;2898;8978;2687;8608;141;525;2150;6864;2291;7389
220245;201604;1468;3990;1266;3705;22;72;1128;3357;1150;3429
220250;201604;3170;9086;2892;8673;81;317;2527;7576;2608;7893
220253;201604;1607;4838;1383;4432;175;635;955;3030;1130;3665
220255;201604;1725;4893;1500;4515;45;189;1215;3497;1260;3686
220260;201604;4602;14853;4094;13934;320;1134;2998;10313;3318;11447
220265;201604;1320;4575;1208;4403;119;489;784;2900;903;3389
220270;201604;6801;21958;6558;21538;364;1611;5442;17344;5806;18955
220271;201604;1472;4140;1324;3907;73;193;1106;3338;1179;3531
220272;201604;1780;5372;1624;5113;51;212;1291;3996;1342;4208
220273;201604;1192;3491;1061;3258;85;264;771;2374;856;2638
220275;201604;2073;5326;1730;4918;26;113;1560;4378;1586;4491
220277;201604;2211;6199;1959;5813;74;261;1577;4618;1651;4879
220280;201604;1557;4188;1373;3871;81;285;1105;3026;1186;3311
220285;201604;1588;4273;1321;3904;29;110;1183;3512;1212;3622
220290;201604;5838;19811;5101;18779;453;1950;3744;13840;4197;15790
220300;201604;1801;6102;1643;5868;79;427;1344;4702;1423;5129
220310;201604;2386;8186;2239;8024;77;327;1933;7071;2010;7398
220320;201604;3053;9316;2602;8491;258;948;1818;5897;2076;6845
220323;201604;1434;5134;1259;4880;138;584;963;3759;1101;4343
220325;201604;1156;3735;989;3401;76;317;713;2445;789;2762
220327;201604;1281;4158;1178;3982;34;186;964;3176;998;3362
220330;201604;3445;9596;3189;9280;98;286;2896;8494;2994;8780
220335;201604;1830;5658;1662;5470;34;98;1552;5172;1586;5270
220340;201604;1828;5082;1571;4690;95;315;1211;3584;1306;3899
220342;201604;1097;3647;1034;3552;59;259;834;2844;893;3103
220345;201604;2855;7361;2524;6868;61;141;2295;6267;2356;6408
220350;201604;3915;10416;3364;9570;193;586;2607;7369;2800;7955
220360;201604;1280;3570;1108;3302;101;328;840;2465;941;2793
220370;201604;9112;26370;8320;25360;325;1132;7394;22497;7719;23629
220375;201604;1480;4743;1389;4631;15;42;1335;4501;1350;4543
220380;201604;1365;3680;1149;3388;44;157;955;2759;999;2916
220385;201604;836;2154;677;1901;17;68;544;1493;561;1561
220390;201604;9388;28756;8319;26906;2107;7003;3162;10522;5269;17525
220400;201604;1502;3631;1212;3184;39;128;990;2519;1029;2647
220410;201604;1207;3530;1048;3284;68;262;821;2533;889;2795
220415;201604;877;2392;775;2257;54;164;557;1594;611;1758
220420;201604;2143;6204;1817;5564;75;230;1435;4386;1510;4616
220430;201604;2557;7252;2489;7163;130;437;2182;6215;2312;6652
220435;201604;1622;4843;1498;4639;37;156;1250;3834;1287;3990
220440;201604;2363;7849;2221;7663;147;542;1845;6307;1992;6849
220450;201604;2066;6407;1735;5925;387;1414;980;3373;1367;4787
220455;201604;1327;4175;1241;4051;47;157;1122;3701;1169;3858
220460;201604;878;2425;807;2344;37;116;703;2017;740;2133
220465;201604;2326;7728;2122;7415;392;1437;1377;4872;1769;6309
220470;201604;3781;11242;3456;10727;171;537;2712;8351;2883;8888
220480;201604;2485;7130;2206;6717;133;359;1717;5272;1850;5631
220490;201604;2271;6533;2096;6315;57;215;1856;5551;1913;5766
220500;201604;3223;8692;2754;7892;85;387;2200;6131;2285;6518
220510;201604;2734;7931;2232;7083;87;329;1652;5214;1739;5543
220515;201604;1860;4602;1664;4342;132;303;1360;3590;1492;3893
220520;201604;5164;14151;4714;13558;105;312;4243;12273;4348;12585
220525;201604;1263;3618;1201;3522;40;138;1037;3029;1077;3167
220527;201604;1363;4200;1209;3891;130;436;857;2814;987;3250
220530;201604;1242;3598;1099;3387;48;202;959;2889;1007;3091
220535;201604;859;2607;816;2550;71;236;623;1937;694;2173
220540;201604;3441;11166;3292;10935;118;526;2870;9455;2988;9981
220545;201604;1377;4620;1308;4488;140;542;984;3340;1124;3882
220550;201604;9123;29331;8467;28247;743;2647;6359;21190;7102;23837
220551;201604;1444;4638;1320;4447;69;321;1050;3475;1119;3796
220552;201604;1582;4946;1368;4537;58;303;1055;3374;1113;3677
220553;201604;1591;4650;1313;4225;48;202;1019;3336;1067;3538
220554;201604;787;2310;703;2179;55;176;552;1706;607;1882
220555;201604;2219;6788;2058;6567;47;239;1857;5850;1904;6089
220556;201604;1442;4470;1289;4179;50;200;984;3121;1034;3321
220557;201604;1554;5047;1391;4732;130;462;948;3232;1078;3694
220558;201604;1077;3300;967;3120;48;216;752;2358;800;2574
220559;201604;1543;4351;1400;4107;37;125;1208;3532;1245;3657
220560;201604;1636;4113;1377;3762;50;137;1167;3144;1217;3281
220570;201604;7249;23431;6811;22655;1268;4213;4241;14484;5509;18697
220580;201604;6449;20462;6309;20262;246;849;5746;18405;5992;19254
220585;201604;2040;7086;1911;6849;173;672;1502;5382;1675;6054
220590;201604;1312;3929;1179;3740;174;584;820;2660;994;3244
220595;201604;2320;6851;2163;6647;34;162;1975;6012;2009;6174
220600;201604;1288;3116;1073;2849;164;283;790;2266;954;2549
220605;201604;1941;5669;1693;5277;68;239;1379;4244;1447;4483
220610;201604;2682;8188;2568;8033;55;226;2348;7318;2403;7544
220620;201604;7541;25229;7261;24851;302;1465;6441;21774;6743;23239
220630;201604;392;1209;332;1100;44;160;176;598;220;758
220635;201604;1655;5811;1490;5453;81;399;1078;3854;1159;4253
220640;201604;2628;7721;2361;7349;105;371;1991;6156;2096;6527
220650;201604;2207;6460;1971;6040;111;378;1515;4652;1626;5030
220660;201604;2727;8296;2459;7941;139;666;2090;6522;2229;7188
220665;201604;1161;4006;1085;3874;20;105;961;3422;981;3527
220667;201604;1696;5606;1584;5422;81;288;1318;4521;1399;4809
220669;201604;1846;6067;1750;5902;245;1018;1198;3949;1443;4967
220670;201604;1941;5778;1723;5494;124;334;1423;4662;1547;4996
220672;201604;2476;7176;2318;6985;192;605;1933;5878;2125;6483
220675;201604;1259;3624;1176;3475;67;168;934;2783;1001;2951
220680;201604;2360;7400;2228;7229;149;485;1873;6119;2022;6604
220690;201604;1716;4749;1486;4385;114;329;1140;3439;1254;3768
220695;201604;926;2625;847;2494;32;102;671;1969;703;2071
220700;201604;8450;24149;7358;22470;513;1755;5580;16926;6093;18681
220710;201604;806;2394;682;2171;39;116;499;1600;538;1716
220720;201604;2080;5429;1969;5288;52;153;1751;4678;1803;4831
220730;201604;1369;3886;1170;3580;20;95;997;3018;1017;3113
220735;201604;1008;2594;815;2262;42;119;655;1800;697;1919
220740;201604;1363;4330;1186;4094;80;255;970;3446;1050;3701
220750;201604;3946;11242;3636;10770;324;833;2911;8794;3235;9627
220755;201604;1199;3390;1074;3191;48;173;863;2527;911;2700
220760;201604;2632;9076;2422;8796;137;682;2040;7315;2177;7997
220770;201604;21838;72528;19588;68250;6422;23480;6020;21857;12442;45337
220775;201604;1241;3338;1196;3288;18;53;1160;3191;1178;3244
220777;201604;1601;4408;1376;4074;66;157;1074;3182;1140;3339
220779;201604;1395;3603;1323;3510;47;165;1165;3040;1212;3205
220780;201604;5810;15688;5137;14688;380;1098;4113;11801;4493;12899
220785;201604;1289;3333;1217;3219;39;101;1115;2928;1154;3029
220790;201604;10085;30809;9345;29689;694;2483;7507;23694;8201;26177
220793;201604;821;2347;742;2233;36;131;618;1859;654;1990
220795;201604;1419;4100;1368;4030;59;174;1246;3690;1305;3864
220800;201604;16025;43911;14452;41704;884;2927;10916;31088;11800;34015
220810;201604;3331;9633;2894;8897;117;472;2307;6992;2424;7464
220820;201604;5427;14783;4958;14136;251;685;4299;12235;4550;12920
220830;201604;7488;21077;6965;20260;567;1684;5483;16022;6050;17706
220840;201604;13991;44310;12487;41370;2791;9395;5917;20048;8708;29443
220850;201604;2830;9763;2686;9579;104;473;2409;8611;2513;9084
220855;201604;615;1885;535;1742;28;118;405;1290;433;1408
220860;201604;941;2524;837;2361;32;113;714;1986;746;2099
220865;201604;2589;7151;2081;6263;65;311;1657;4825;1722;5136
220870;201604;2229;7496;1984;7176;51;230;1801;6525;1852;6755
220880;201604;4700;12840;4387;12475;80;241;4104;11722;4184;11963
220885;201604;1257;4571;1115;4308;85;408;836;3213;921;3621
220887;201604;1371;3421;1207;3190;15;63;1120;2940;1135;3003
220890;201604;1616;5596;1450;5291;113;397;1120;4194;1233;4591
220900;201604;1832;5212;1632;4913;53;152;1382;4131;1435;4283
220910;201604;1524;4669;1337;4390;41;124;1174;3918;1215;4042
220915;201604;1018;2873;872;2593;27;110;662;1904;689;2014
220920;201604;1344;4817;1217;4633;89;436;912;3401;1001;3837
220930;201604;1382;4555;1315;4451;52;229;1107;3742;1159;3971
220935;201604;1080;3283;949;3014;36;160;647;1978;683;2138
220937;201604;1501;4127;1270;3744;56;214;973;2798;1029;3012
220940;201604;1339;4245;1253;4083;74;318;929;2985;1003;3303
220945;201604;425;1577;387;1503;29;136;278;1065;307;1201
220950;201604;1315;3266;970;2718;23;97;717;1946;740;2043
220955;201604;1453;4179;1285;3889;79;229;973;2954;1052;3183
220960;201604;911;2366;724;2055;19;60;568;1600;587;1660
220965;201604;1627;4868;1537;4732;49;253;1310;3898;1359;4151
220970;201604;2164;5712;1617;4826;131;405;1133;3420;1264;3825
220975;201604;670;2185;623;2123;27;158;566;1866;593;2024
220980;201604;1272;3835;1118;3586;75;259;830;2674;905;2933
220985;201604;1184;3523;1121;3436;83;303;854;2554;937;2857
220987;201604;1484;4713;1338;4478;76;345;1036;3386;1112;3731
220990;201604;1813;5261;1574;4855;36;189;1250;3761;1286;3950
220995;201604;1268;3743;969;3267;97;348;666;2331;763;2679
220997;201604;2244;6947;2148;6811;44;208;2000;6291;2044;6499
221000;201604;4200;12873;3930;12412;294;1133;3072;9544;3366;10677
221005;201604;1449;4529;1328;4307;531;1575;519;1846;1050;3421
221010;201604;1148;3018;983;2816;41;124;848;2408;889;2532
221020;201604;1749;5461;1628;5237;64;270;1212;3837;1276;4107
221030;201604;1491;4441;1341;4192;57;239;1096;3391;1153;3630
221035;201604;1450;4003;1358;3884;58;123;1243;3639;1301;3762
221037;201604;619;1839;549;1726;14;54;402;1215;416;1269
221038;201604;602;1697;490;1503;35;107;313;969;348;1076
221039;201604;920;2605;831;2475;46;189;678;1947;724;2136
221040;201604;4515;14057;4232;13599;185;657;3455;11169;3640;11826
221050;201604;3455;10510;3241;10224;149;530;2797;8785;2946;9315
221060;201604;8058;23686;7030;22012;520;1765;5343;16717;5863;18482
221062;201604;1271;4473;1165;4263;47;245;952;3449;999;3694
221063;201604;1059;3485;963;3307;176;573;614;2210;790;2783
221065;201604;2797;7606;2515;7169;112;316;2082;5869;2194;6185
221070;201604;3731;11811;3293;11054;139;549;2619;8827;2758;9376
221080;201604;3466;8923;2944;8208;93;293;2510;6984;2603;7277
221090;201604;1408;3880;1201;3545;32;143;1001;2894;1033;3037
221093;201604;1626;4869;1536;4685;249;815;889;2635;1138;3450
221095;201604;954;2538;850;2385;15;46;729;2028;744;2074
221097;201604;798;2233;655;1982;29;120;466;1368;495;1488
221100;201604;111424;326101;102123;310783;20311;64821;57800;173448;78111;238269
221110;201604;10266;32357;9560;31492;390;1645;8102;26449;8492;28094
221120;201604;4023;13097;3816;12739;687;2398;2485;8327;3172;10725
221130;201604;4555;13193;3844;11732;1106;3371;1654;5123;2760;8494
221135;201604;1479;4561;1368;4414;110;424;1140;3636;1250;4060
221140;201604;1343;3289;1219;3127;37;84;1063;2713;1100;2797
221150;201604;1218;3115;1012;2768;30;122;784;2104;814;2226
221160;201604;826;2189;776;2119;34;94;613;1682;647;1776
221170;201604;1137;3491;1053;3353;51;169;849;2705;900;2874
230010;201604;3391;9137;2727;8008;197;667;2075;5988;2272;6655
230015;201604;2915;10003;2735;9619;378;1514;1679;5807;2057;7321
230020;201604;13613;44448;13230;43828;683;2575;11171;36931;11854;39506
230030;201604;11934;34287;10732;32413;449;1630;8783;26257;9232;27887
230040;201604;4519;12369;3799;11139;288;996;2734;7896;3022;8892
230050;201604;2649;9023;2100;7580;479;1775;641;2356;1120;4131
230060;201604;2211;6369;1902;5818;68;274;1460;4394;1528;4668
230070;201604;4178;11595;3594;10641;294;1017;2404;7156;2698;8173
230075;201604;8777;31259;8203;30135;536;2867;6355;22675;6891;25542
230080;201604;2394;6282;1943;5630;97;355;1574;4503;1671;4858
230090;201604;3862;11186;3423;10436;397;1356;2393;7297;2790;8653
230100;201604;16528;49224;15247;46950;2496;8262;9029;27990;11525;36252
230110;201604;13022;41371;11949;39121;2298;7767;6175;20062;8473;27829
230120;201604;7915;21942;6834;20351;765;2209;4531;14209;5296;16418
230125;201604;3047;8797;2524;7870;164;600;1826;5639;1990;6239
230130;201604;5778;18868;4950;17116;447;1722;3306;11318;3753;13040
230140;201604;3498;11144;2980;10194;296;1099;2018;6989;2314;8088
230150;201604;1696;5301;1469;4835;286;1015;764;2492;1050;3507
230160;201604;6176;18482;5528;17515;264;1048;4429;13940;4693;14988
230170;201604;6287;19725;5462;18174;322;1251;3897;12857;4219;14108
230180;201604;1706;5038;1495;4617;75;333;1085;3186;1160;3519
230185;201604;3917;12797;3530;12101;552;1942;2182;7676;2734;9618
230190;201604;12611;40265;11166;37372;2218;8002;5242;17472;7460;25474
230195;201604;5282;16086;4624;14974;340;1338;3523;11148;3863;12486
230200;201604;5123;14746;4607;13750;423;1326;3363;9949;3786;11275
230205;201604;4129;13381;3728;12683;243;1080;2642;8858;2885;9938
230210;201604;8870;25468;7772;23731;1322;4121;4643;14456;5965;18577
230220;201604;13192;37457;11892;35210;994;3320;8627;25133;9621;28453
230230;201604;7276;23286;6662;22112;805;2723;4465;14939;5270;17662
230240;201604;13820;38694;12169;35986;567;1883;9389;27465;9956;29348
230250;201604;9724;30170;9646;30045;530;1978;7609;23380;8139;25358
230260;201604;14186;47429;13190;45426;2129;7830;7420;26055;9549;33885
230270;201604;7517;22049;6452;20206;715;2498;4190;13202;4905;15700
230280;201604;19750;57963;17581;54292;1462;4734;12980;39900;14442;44634
230290;201604;4818;14517;4120;13113;551;1689;2720;8714;3271;10403
230300;201604;4387;13188;4186;12904;251;928;3390;10316;3641;11244
230310;201604;4803;14306;4228;13326;218;896;3048;9437;3266;10333
230320;201604;7043;21938;6411;20840;426;1692;4726;15164;5152;16856
230330;201604;4794;14006;4061;12570;319;1053;2833;8665;3152;9718
230340;201604;3349;11283;3046;10655;344;1356;1959;6723;2303;8079
230350;201604;18087;54811;16498;52129;1764;6480;9914;31789;11678;38269
230360;201604;3257;9298;2633;8162;219;753;1715;5255;1934;6008
230365;201604;2995;8139;2624;7501;109;411;2089;5915;2198;6326
230370;201604;53827;171734;48621;162912;12964;45438;20173;70271;33137;115709
230380;201604;6462;18951;5396;16964;273;941;3830;11960;4103;12901
230390;201604;3468;10974;3079;10319;212;947;2177;7135;2389;8082
230393;201604;3181;10430;2724;9530;172;858;1938;6536;2110;7394
230395;201604;5677;16604;5083;15595;767;2372;3015;9550;3782;11922
230400;201604;5463;16538;4813;15512;262;1196;3713;11711;3975;12907
230410;201604;14292;45370;12399;41444;1683;5933;7283;24396;8966;30329
230420;201604;24157;77328;21918;72950;4647;16545;10042;33267;14689;49812
230423;201604;4163;13715;3848;13103;244;1027;2887;9761;3131;10788
230425;201604;5504;18258;5058;17314;704;2481;3164;10890;3868;13371
230426;201604;2677;7513;2128;6489;69;298;1575;4682;1644;4980
230427;201604;1833;5448;1400;4493;175;583;793;2469;968;3052
230428;201604;8651;26884;8216;26101;1321;4608;4714;14808;6035;19416
230430;201604;4555;14443;4212;13829;308;1246;3032;9730;3340;10976
230435;201604;4941;15605;4425;14658;743;2805;2381;7783;3124;10588
230440;201604;352441;1037377;322048;986017;73446;235700;147599;455519;221045;691219
230445;201604;4529;12209;3860;11212;272;788;2718;7923;2990;8711
230450;201604;3570;11268;3117;10447;320;1369;2072;6807;2392;8176
230460;201604;1944;6337;1677;5849;158;620;1154;3993;1312;4613
230465;201604;4040;12018;3404;10855;231;959;2247;6966;2478;7925
230470;201604;10789;39340;9996;37705;1250;5242;6773;25540;8023;30782
230480;201604;1468;4590;1233;4138;150;591;814;2678;964;3269
230490;201604;2266;6916;1962;6324;287;981;965;3022;1252;4003
230495;201604;5747;18884;5149;17815;704;2904;2784;9497;3488;12401
230500;201604;8893;31536;8477;30715;585;2597;6333;22861;6918;25458
230510;201604;1499;5309;1160;4446;298;1213;338;1295;636;2508
230520;201604;4810;14632;4340;13800;435;1562;2771;8703;3206;10265
230523;201604;14630;47247;12825;43178;2912;10634;3100;10703;6012;21337
230526;201604;4048;12081;3466;11061;200;870;2639;8248;2839;9118
230530;201604;5355;17178;4839;16463;841;3063;3187;11150;4028;14213
230533;201604;4027;11158;3473;10110;425;1152;2380;7048;2805;8200
230535;201604;5539;16320;4846;15097;631;1936;2956;9572;3587;11508
230540;201604;17373;50792;15679;48131;567;2303;12989;39385;13556;41688
230550;201604;19384;57343;17233;53324;3020;10170;8921;26962;11941;37132
230560;201604;6767;19415;5915;17871;182;770;4537;13445;4719;14215
230565;201604;3430;9484;2783;8298;104;389;2060;6091;2164;6480
230570;201604;3637;9908;3232;9398;108;401;2689;7748;2797;8149
230580;201604;9959;30002;9213;28932;499;1857;7822;24455;8321;26312
230590;201604;9076;28042;7799;25651;570;2380;5450;17408;6020;19788
230600;201604;3839;10514;2936;8745;144;465;1886;5613;2030;6078
230610;201604;6133;19489;5620;18649;747;2481;3846;13001;4593;15482
230620;201604;2168;6179;1733;5261;206;674;961;2822;1167;3496
230625;201604;7820;25315;7054;23565;2017;7266;2039;6802;4056;14068
230630;201604;10892;34445;9995;32797;2635;8147;4506;15933;7141;24080
230640;201604;25773;83830;23724;80759;2624;9929;17468;59211;20092;69140
230650;201604;4862;14916;4393;14020;288;1142;3326;10361;3614;11503
230655;201604;9143;34464;8796;33811;757;3213;6851;26543;7608;29756
230660;201604;6094;18997;5217;17342;304;1381;3975;12901;4279;14282
230670;201604;6073;16140;4873;14074;145;497;3747;10522;3892;11019
230680;201604;2651;7804;2287;7100;339;1060;1325;4121;1664;5181
230690;201604;6322;20429;6127;20019;621;2328;3886;12398;4507;14726
230700;201604;9474;26469;8456;24669;614;2193;6015;17002;6629;19195
230710;201604;7491;24274;6515;22463;643;2276;4593;15952;5236;18228
230720;201604;1828;5805;1585;5299;205;722;929;3086;1134;3808
230725;201604;3674;12445;3205;11310;759;2744;1024;3621;1783;6365
230730;201604;56490;170575;47666;155892;12940;47541;10584;36306;23524;83847
230740;201604;6099;18151;5512;17169;211;869;4408;13523;4619;14392
230750;201604;8375;24112;7183;22158;368;1413;5433;16486;5801;17899
230760;201604;10696;31662;9887;30063;1058;3700;6702;19616;7760;23316
230763;201604;4263;13005;3806;12154;203;899;2867;8810;3070;9709
230765;201604;38417;121081;34440;113377;8799;30942;9946;33735;18745;64677
230770;201604;24892;68862;22426;65357;2894;8870;14617;42557;17511;51427
230780;201604;5914;22696;5666;22140;1387;5557;2715;11125;4102;16682
230790;201604;2790;8848;2569;8471;237;876;1898;6278;2135;7154
230800;201604;7449;26329;6788;24881;1445;5683;2939;10629;4384;16312
230810;201604;12171;39175;11440;37938;830;2996;8836;29264;9666;32260
230820;201604;3263;11261;2870;10412;404;1662;1575;5634;1979;7296
230830;201604;7458;22514;6600;20917;428;1670;4849;15122;5277;16792
230835;201604;3952;10436;3246;9378;177;577;2482;7140;2659;7717
230837;201604;3187;10728;2754;9849;261;1117;1855;6496;2116;7613
230840;201604;9115;29518;8346;28214;654;2524;6319;21445;6973;23969
230850;201604;9513;29609;8821;28421;1039;3414;5986;19478;7025;22892
230860;201604;5059;14413;4502;13612;199;748;3677;11033;3876;11781
230870;201604;18710;49054;16118;45207;690;2177;12370;34533;13060;36710
230880;201604;1959;6613;1859;6405;136;609;1302;4381;1438;4990
230890;201604;3928;14301;3645;13688;435;2007;2292;8339;2727;10346
230900;201604;2908;9636;2438;8620;506;1713;1083;3985;1589;5698
230910;201604;3136;9136;2584;8157;192;832;1872;5710;2064;6542
230920;201604;4645;13507;4322;13102;238;892;3605;10941;3843;11833
230930;201604;7260;21867;6417;20295;581;1949;4299;13622;4880;15571
230940;201604;7811;22246;6877;20792;284;983;5573;16881;5857;17864
230945;201604;6028;18333;5353;17264;422;1532;3651;12023;4073;13555
230950;201604;6408;17525;5801;16727;223;615;4967;14634;5190;15249
230960;201604;14217;43571;13031;41316;2480;8237;5993;19253;8473;27490
230970;201604;13633;41392;11983;38372;2356;8302;5179;16286;7535;24588
230980;201604;2922;9084;2559;8430;674;2205;1207;4210;1881;6415
230990;201604;1756;5186;1456;4607;113;477;923;2805;1036;3282
231000;201604;2687;7359;2147;6307;135;462;1366;3895;1501;4357
231010;201604;3131;8589;2548;7625;273;875;1651;4817;1924;5692
231020;201604;7811;26245;7402;25394;1278;4394;4466;15627;5744;20021
231025;201604;7942;24258;7217;23014;895;3014;4730;15291;5625;18305
231030;201604;7612;24588;6456;22256;1121;4081;3389;11770;4510;15851
231040;201604;3184;9986;2825;9278;148;655;2048;6517;2196;7172
231050;201604;11839;33650;10071;30548;739;2479;7259;21898;7998;24377
231060;201604;2367;7700;2197;7386;133;667;1603;5217;1736;5884
231070;201604;8635;27208;7758;25428;1401;4747;4054;13467;5455;18214
231080;201604;4016;12511;3665;11919;172;885;2802;8744;2974;9629
231085;201604;4792;14815;4601;14554;645;2065;3202;10450;3847;12515
231090;201604;4152;11609;3348;10029;177;610;2289;6757;2466;7367
231095;201604;2191;7074;1905;6492;208;795;1220;4162;1428;4957
231100;201604;3202;9875;2678;8881;190;747;1883;6186;2073;6933
231110;201604;3495;11659;3460;11595;323;1260;2391;7937;2714;9197
231120;201604;1972;6735;1868;6523;282;1050;1143;4042;1425;5092
231123;201604;2062;5665;1784;5196;132;369;1357;3954;1489;4323
231126;201604;6250;17742;5276;16110;260;1018;3841;11554;4101;12572
231130;201604;19095;58291;17264;55293;3206;10668;9955;33297;13161;43965
231135;201604;4141;12403;3545;11330;242;864;2477;7882;2719;8746
231140;201604;17040;53245;14986;49384;1182;5225;9872;31390;11054;36615
231150;201604;5740;16505;4922;15015;782;2502;2417;7448;3199;9950
231160;201604;5803;19122;5408;18333;947;3211;3094;10609;4041;13820
231170;201604;4255;13630;3801;12699;272;1146;2635;8558;2907;9704
231180;201604;14000;41621;12533;38714;2148;7101;6871;20868;9019;27969
231190;201604;4543;12794;3826;11702;233;849;2906;8695;3139;9544
231195;201604;4597;15312;3971;14092;391;1726;2675;9334;3066;11060
231200;201604;7789;26429;6815;24413;406;2083;4819;16771;5225;18854
231210;201604;4979;15604;4344;14713;274;1291;3345;11182;3619;12473
231220;201604;11764;33944;10371;31372;492;1879;7634;22621;8126;24500
231230;201604;9163;30427;8311;29123;760;3184;6067;21236;6827;24420
231240;201604;12052;37591;10876;35250;2255;7506;5158;16960;7413;24466
231250;201604;1968;5670;1379;4247;426;1302;295;896;721;2198
231260;201604;3458;10271;3112;9725;524;1632;1846;5905;2370;7537
231270;201604;7215;19789;6359;18456;296;1232;4793;13576;5089;14808
231280;201604;1736;5682;1623;5478;180;639;1090;3709;1270;4348
231290;201604;33584;113280;30360;106053;6299;24286;12291;41968;18590;66254
231300;201604;4494;12995;3643;11325;245;914;2422;7324;2667;8238
231310;201604;7370;20933;6140;18397;862;2611;3444;10232;4306;12843
231320;201604;6982;21302;5926;19246;293;1250;4189;13517;4482;14767
231325;201604;2769;8105;2430;7590;247;816;1607;5083;1854;5899
231330;201604;12131;38257;10491;35082;1716;5799;5890;19947;7606;25746
231335;201604;5368;15266;4650;13940;174;723;3679;10789;3853;11512
231340;201604;17350;57331;16022;55266;1074;3740;12574;44293;13648;48033
231350;201604;13793;41868;13093;40903;862;2569;11103;35148;11965;37717
231355;201604;4520;14316;4143;13682;251;1031;3037;9931;3288;10962
231360;201604;7641;24308;6783;22806;1132;3861;4161;14362;5293;18223
231370;201604;2404;6710;1878;5840;75;239;1392;4339;1467;4578
231375;201604;4215;14354;3948;13868;227;1063;3108;10787;3335;11850
231380;201604;5379;16571;5088;16197;406;1424;3834;12451;4240;13875
231390;201604;3431;10707;3152;10225;260;912;2214;7128;2474;8040
231395;201604;3817;12520;3477;11884;588;2002;1951;6773;2539;8775
231400;201604;8979;27677;8341;26414;524;2026;6147;19171;6671;21197
231410;201604;14223;48093;13094;46396;1213;4495;9861;35295;11074;39790
240010;201604;2436;7284;2042;6504;318;1126;1008;3108;1326;4234
240020;201604;10517;33065;9426;31028;1965;6874;4488;14922;6453;21796
240030;201604;2463;7065;2381;6941;112;409;2046;5861;2158;6270
240040;201604;838;2470;709;2212;25;124;500;1482;525;1606
240050;201604;3443;9317;2932;8431;105;351;2331;6600;2436;6951
240060;201604;1400;3993;1248;3707;49;188;993;2840;1042;3028
240070;201604;2544;7550;2369;7212;352;1125;1537;4595;1889;5720
240080;201604;3041;8137;2635;7581;159;460;2028;5834;2187;6294
240090;201604;2279;6139;1874;5415;39;147;1462;4132;1501;4279
240100;201604;8116;23319;7262;21598;599;2009;5151;14903;5750;16912
240110;201604;4760;14930;4268;13943;611;2295;2399;7557;3010;9852
240120;201604;2668;9180;2548;8944;367;1436;1598;5558;1965;6994
240130;201604;2729;7423;2402;6909;101;353;1951;5514;2052;5867
240140;201604;2218;6651;1898;6066;281;1083;1086;3339;1367;4422
240145;201604;5724;18106;5174;17109;1435;4945;2421;8264;3856;13209
240150;201604;971;2971;807;2625;71;286;520;1632;591;1918
240160;201604;1428;4587;1239;4261;155;588;762;2700;917;3288
240165;201604;895;2815;790;2602;109;328;474;1652;583;1980
240170;201604;2305;6991;2021;6464;485;1692;911;2879;1396;4571
240180;201604;2614;8301;2323;7697;408;1455;1348;4538;1756;5993
240185;201604;1401;4662;1308;4510;82;312;1035;3580;1117;3892
240190;201604;964;3039;867;2876;39;186;652;2141;691;2327
240200;201604;13402;35204;11230;32171;2521;7524;4729;13967;7250;21491
240210;201604;2894;8085;2618;7680;156;576;2144;6161;2300;6737
240220;201604;7290;24437;6764;23655;658;2947;5013;17258;5671;20205
240230;201604;5702;15088;4944;13912;146;459;4179;11752;4325;12211
240240;201604;1823;5528;1266;4181;242;874;217;626;459;1500
240250;201604;2643;7774;2485;7553;112;355;2129;6468;2241;6823
240260;201604;12097;40829;11491;39841;1763;6782;7320;25313;9083;32095
240270;201604;2237;7197;2062;6904;180;637;1565;5310;1745;5947
240280;201604;1550;4382;1381;4135;72;250;1102;3287;1174;3537
240290;201604;1251;3966;1114;3696;55;291;729;2274;784;2565
240300;201604;2262;6238;1682;5031;262;837;700;2038;962;2875
240310;201604;9434;26990;8572;25646;1099;3621;4816;14606;5915;18227
240320;201604;2023;6014;1629;5214;52;226;1154;3573;1206;3799
240325;201604;34079;94322;27411;83807;8261;27098;5918;19101;14179;46199
240330;201604;1483;4511;1255;4028;71;285;793;2457;864;2742
240340;201604;2014;5309;1706;4819;168;493;1247;3499;1415;3992
240350;201604;1933;5629;1823;5498;95;344;1606;4822;1701;5166
240360;201604;6994;21225;6246;20106;1440;4812;3122;10432;4562;15244
240370;201604;2018;5565;1620;4833;184;515;1003;3038;1187;3553
240375;201604;842;2288;740;2112;71;241;507;1360;578;1601
240380;201604;2416;7220;1864;5988;243;804;932;2964;1175;3768
240390;201604;925;2558;786;2305;40;143;557;1588;597;1731
240400;201604;1327;3630;1089;3201;79;279;755;2155;834;2434
240410;201604;481;1596;432;1497;77;329;240;798;317;1127
240420;201604;4607;17726;4336;17122;865;3844;2311;9141;3176;12985
240430;201604;3273;9278;2995;8773;129;526;2357;6668;2486;7194
240440;201604;2466;6447;2211;6069;486;1405;1199;3260;1685;4665
240450;201604;3756;11238;3244;10267;295;1252;2009;6010;2304;7262
240460;201604;2884;8883;2725;8671;171;761;2206;6830;2377;7591
240470;201604;3560;11170;2841;9610;794;2557;1288;4484;2082;7041
240480;201604;522;1398;409;1181;32;107;208;577;240;684
240485;201604;1945;6162;1720;5709;240;864;1078;3598;1318;4462
240490;201604;1684;4314;1415;3896;37;136;1179;3184;1216;3320
240500;201604;2138;6117;1937;5819;124;431;1515;4516;1639;4947
240510;201604;1774;5258;1665;5094;122;399;1337;4087;1459;4486
240520;201604;1213;3564;1103;3372;111;400;821;2441;932;2841
240530;201604;1974;6409;1818;6163;354;1258;1157;3909;1511;5167
240540;201604;1732;5201;1655;5078;110;365;1364;4163;1474;4528
240550;201604;794;2282;685;2092;40;142;510;1529;550;1671
240560;201604;3194;9265;2984;8949;349;1007;2246;6793;2595;7800
240570;201604;3045;8547;2290;6862;494;1579;761;2028;1255;3607
240580;201604;7579;23721;7044;22782;748;2695;5329;17007;6077;19702
240590;201604;773;2180;680;2009;28;105;516;1491;544;1596
240600;201604;1606;4724;1260;3995;134;493;701;2134;835;2627
240610;201604;4576;13205;4014;12130;456;1486;2513;7443;2969;8929
240615;201604;1026;3013;826;2629;167;569;434;1342;601;1911
240620;201604;1776;5497;1574;5162;171;537;1156;3831;1327;4368
240630;201604;2028;6206;1862;5923;161;449;1305;4269;1466;4718
240640;201604;895;2582;761;2364;51;242;533;1588;584;1830
240650;201604;3872;11565;3464;10962;178;635;2759;8703;2937;9338
240660;201604;2335;7533;2190;7321;177;670;1700;5655;1877;6325
240670;201604;2625;7829;2193;6930;278;929;1223;3816;1501;4745
240680;201604;1488;4378;1212;3883;96;342;774;2430;870;2772
240690;201604;954;2625;820;2395;46;171;649;1842;695;2013
240700;201604;2567;7704;2165;6969;81;350;1641;5176;1722;5526
240710;201604;18698;49116;16240;45465;3060;8511;8918;25601;11978;34112
240720;201604;5221;14958;4744;14084;1421;4410;2100;5995;3521;10405
240725;201604;1055;3182;856;2750;68;227;497;1558;565;1785
240730;201604;2110;6395;1841;5895;114;400;1361;4345;1475;4745
240740;201604;1947;5748;1743;5384;145;576;1226;3652;1371;4228
240750;201604;2102;7925;1967;7664;479;2051;904;3533;1383;5584
240760;201604;1322;3624;1111;3339;106;266;817;2628;923;2894
240770;201604;3126;8983;2801;8533;145;613;2308;6908;2453;7521
240780;201604;6053;16727;4901;14886;755;2325;2708;8358;3463;10683
240790;201604;897;2724;749;2455;33;129;526;1734;559;1863
240800;201604;35055;100518;31223;94156;7375;23010;12575;38543;19950;61553
240810;201604;84210;243110;77974;232601;20632;62599;34803;106173;55435;168772
240820;201604;6287;19197;5504;17960;1298;4579;2210;7523;3508;12102
240830;201604;8610;26813;8055;26006;362;1572;6756;21539;7118;23111
240840;201604;1214;3396;1033;3105;91;290;629;1831;720;2121
240850;201604;1274;3774;949;3019;116;389;485;1522;601;1911
240860;201604;1302;3720;1074;3309;48;181;814;2432;862;2613
240870;201604;1176;3214;964;2827;79;251;606;1694;685;1945
240880;201604;1161;3882;1096;3780;90;405;870;2901;960;3306
240890;201604;4971;14173;4212;12757;879;2772;1720;5099;2599;7871
240895;201604;2617;9057;2417;8702;255;1015;1731;6288;1986;7303
240910;201604;2854;8594;2529;7973;142;536;1925;6006;2067;6542
240920;201604;752;2449;655;2241;120;461;315;1052;435;1513
240930;201604;3445;9005;3040;8509;136;371;2497;7099;2633;7470
240933;201604;1414;4011;1260;3754;82;302;974;2816;1056;3118
240940;201604;6482;17487;5256;15416;760;2241;3100;9012;3860;11253
240950;201604;960;3177;895;3059;60;285;674;2229;734;2514
240960;201604;793;2475;705;2308;66;232;496;1645;562;1877
240970;201604;1897;5276;1599;4770;92;352;1218;3510;1310;3862
240980;201604;2936;9748;2724;9356;490;1779;1615;5580;2105;7359
240990;201604;2747;8210;2584;7899;426;1405;1563;4685;1989;6090
241000;201604;1052;2936;893;2658;42;151;619;1820;661;1971
241010;201604;2796;9482;2612;9127;319;1350;1819;6124;2138;7474
241020;201604;2031;5681;1661;4938;185;542;1000;2920;1185;3462
241025;201604;1627;4945;1448;4622;64;281;1037;3256;1101;3537
241030;201604;2489;8214;2231;7703;215;903;1548;5271;1763;6174
241040;201604;2202;7516;2019;7191;174;716;1451;5185;1625;5901
241050;201604;1278;3774;1119;3499;62;246;838;2551;900;2797
241060;201604;862;2497;774;2355;49;161;566;1697;615;1858
241070;201604;770;2237;698;2112;60;213;508;1478;568;1691
241080;201604;1135;3384;945;3011;35;157;688;2155;723;2312
241090;201604;2150;6387;1816;5810;113;511;1359;4268;1472;4779
241100;201604;1186;3535;1035;3184;97;325;665;2025;762;2350
241105;201604;1160;3558;1019;3299;229;745;464;1579;693;2324
241110;201604;816;2552;689;2292;52;212;431;1389;483;1601
241120;201604;7261;22293;6628;21253;1511;4816;3560;11944;5071;16760
241140;201604;3401;9325;2947;8438;294;823;2025;5706;2319;6529
241142;201604;720;2151;538;1751;132;490;199;602;331;1092
241150;201604;5392;15990;4820;15007;509;1691;3218;10017;3727;11708
241160;201604;972;2851;876;2687;137;417;544;1673;681;2090
241170;201604;1140;3364;1062;3227;90;277;825;2501;915;2778
241180;201604;941;2641;767;2308;95;306;395;1156;490;1462
241190;201604;1190;3274;948;2780;54;194;608;1702;662;1896
241200;201604;18781;54902;16709;51697;4108;13424;6861;21745;10969;35169
241210;201604;1432;4040;1149;3454;162;563;612;1769;774;2332
241220;201604;7785;25663;7258;24690;1863;6550;3482;12157;5345;18707
241230;201604;3000;8825;2776;8467;155;597;2302;6895;2457;7492
241240;201604;1213;3589;830;2699;86;314;355;1152;441;1466
241250;201604;6009;18520;5032;16642;204;1094;3808;12173;4012;13267
241255;201604;1670;6411;1548;6129;342;1489;756;2992;1098;4481
241260;201604;5106;13830;4120;12288;180;770;3046;8874;3226;9644
241270;201604;1856;5694;1637;5258;115;454;1113;3507;1228;3961
241280;201604;1846;5356;1688;5056;155;480;1224;3645;1379;4125
241290;201604;2999;8412;2552;7647;202;710;1798;5284;2000;5994
241300;201604;1445;4166;1252;3824;55;180;880;2698;935;2878
241310;201604;1613;4811;1478;4584;108;404;1132;3470;1240;3874
241320;201604;913;3134;836;2977;103;422;522;1848;625;2270
241330;201604;1425;4456;1342;4347;91;393;1121;3555;1212;3948
241335;201604;2741;8328;2535;7960;140;512;2087;6497;2227;7009
241340;201604;1831;5675;1575;5117;365;1290;665;2066;1030;3356
241350;201604;1904;6066;1728;5725;130;556;1278;4114;1408;4670
241355;201604;1421;3957;1168;3527;49;176;925;2783;974;2959
241360;201604;2071;5621;1714;4931;75;221;1230;3439;1305;3660
241370;201604;1354;4068;1121;3598;125;458;656;2051;781;2509
241380;201604;652;1859;558;1682;79;255;319;938;398;1193
241390;201604;2734;9021;2553;8708;248;1007;1898;6420;2146;7427
241400;201604;3701;10733;3374;10270;388;1281;2509;7697;2897;8978
241410;201604;2474;7578;2239;7250;417;1449;1341;4314;1758;5763
241415;201604;1640;4974;1487;4736;89;342;1191;3725;1280;4067
241420;201604;2264;7809;1999;7352;616;2490;452;1623;1068;4113
241430;201604;571;1697;445;1415;43;157;250;751;293;908
241440;201604;6193;22392;5827;21803;985;3994;3932;14809;4917;18803
241445;201604;992;2898;946;2844;81;211;763;2442;844;2653
241450;201604;3004;8221;2638;7709;299;955;1816;5252;2115;6207
241460;201604;3388;9879;3013;9148;228;816;2165;6402;2393;7218
241470;201604;1382;3851;1133;3520;124;432;794;2444;918;2876
241475;201604;1244;3742;1046;3348;36;173;775;2400;811;2573
241480;201604;2774;9186;2557;8809;998;3590;550;2100;1548;5690
241490;201604;679;1793;587;1668;36;93;366;1021;402;1114
241500;201604;761;2420;654;2251;35;150;508;1731;543;1881
250010;201604;2744;8577;2350;7717;110;487;1756;5628;1866;6115
250020;201604;1655;4752;1285;4080;74;291;845;2585;919;2876
250030;201604;6899;20141;6442;19501;434;1390;5294;15965;5728;17355
250040;201604;4126;13815;3811;13131;571;2024;2335;8066;2906;10090
250050;201604;3420;10764;3193;10410;474;1583;2120;6871;2594;8454
250053;201604;1227;3684;1124;3538;139;464;775;2471;914;2935
250057;201604;620;2686;610;2675;9;14;579;2621;588;2635
250060;201604;5105;15257;4787;14797;400;1391;3791;11613;4191;13004
250070;201604;3974;12349;3691;11873;138;668;2900;9018;3038;9686
250073;201604;772;2320;680;2164;38;140;553;1744;591;1884
250077;201604;2151;6267;1803;5721;131;442;1240;3969;1371;4411
250080;201604;4136;12066;3947;11747;304;955;3082;9020;3386;9975
250090;201604;2550;7408;2422;7204;101;296;1988;5862;2089;6158
250100;201604;3823;12567;3618;12197;312;1185;2762;9165;3074;10350
250110;201604;5046;15114;4777;14735;409;1517;3794;11500;4203;13017
250115;201604;524;1681;471;1572;28;149;316;987;344;1136
250120;201604;1968;5978;1696;5457;92;334;1299;4164;1391;4498
250130;201604;5266;16550;4875;15895;232;992;4088;13235;4320;14227
250135;201604;1061;3192;975;3047;39;139;771;2415;810;2554
250140;201604;1995;6722;1915;6597;163;678;1478;5092;1641;5770
250150;201604;5009;16828;4557;15995;261;1166;3389;11743;3650;12909
250153;201604;1426;3912;1256;3674;45;204;1071;3056;1116;3260
250157;201604;1714;5621;1582;5371;169;653;1142;3858;1311;4511
250160;201604;3237;9754;3112;9570;120;457;2829;8675;2949;9132
250170;201604;1575;4664;1439;4458;153;532;1064;3299;1217;3831
250180;201604;15655;46051;14772;44714;1393;4922;10812;31872;12205;36794
250190;201604;4173;12053;3815;11501;614;1878;2303;6876;2917;8754
250200;201604;2007;5876;1682;5399;96;369;1378;4393;1474;4762
250205;201604;867;3004;813;2896;46;234;600;2122;646;2356
250210;201604;1437;4767;1350;4638;110;468;1036;3480;1146;3948
250215;201604;1354;4443;1280;4329;88;374;854;2871;942;3245
250220;201604;739;2249;653;2132;36;153;530;1729;566;1882
250230;201604;1521;3900;1271;3499;48;170;1037;2737;1085;2907
250240;201604;2299;7724;2176;7498;113;450;1753;6031;1866;6481
250250;201604;4287;13003;3967;12585;173;592;3416;10895;3589;11487
250260;201604;1690;5168;1474;4827;69;246;1153;3788;1222;4034
250270;201604;1247;3940;1140;3808;89;298;871;3003;960;3301
250280;201604;3596;10657;3181;10010;341;1092;2361;7453;2702;8545
250290;201604;1896;5084;1604;4705;35;142;1429;4206;1464;4348
250300;201604;5488;16123;5214;15801;503;2037;4271;12525;4774;14562
250310;201604;1154;3550;1037;3362;74;290;797;2543;871;2833
250320;201604;7987;24303;7553;23605;856;3032;5236;15961;6092;18993
250330;201604;2379;7476;2067;7020;133;550;1587;5323;1720;5873
250340;201604;1092;3230;984;3050;32;121;838;2564;870;2685
250350;201604;4081;11436;3671;10945;131;485;3174;9487;3305;9972
250355;201604;1877;6072;1730;5867;63;319;1478;4927;1541;5246
250360;201604;1856;5457;1735;5278;60;162;1490;4566;1550;4728
250370;201604;11426;33584;10367;32411;808;2595;8876;27942;9684;30537
250375;201604;1070;3278;990;3164;29;119;857;2745;886;2864
250380;201604;1646;4752;1568;4656;90;352;1342;3906;1432;4258
250390;201604;1864;5054;1514;4468;167;471;994;2974;1161;3445
250400;201604;72068;191842;57544;168988;14567;45174;21306;63703;35873;108877
250403;201604;1493;4906;1382;4757;219;896;871;2913;1090;3809
250407;201604;1186;3351;1020;3088;71;210;748;2214;819;2424
250410;201604;542;1773;509;1717;25;127;401;1315;426;1442
250415;201604;1807;5462;1640;5169;98;322;1227;3829;1325;4151
250420;201604;1248;3711;1137;3548;28;118;1005;3112;1033;3230
250430;201604;6060;16679;5628;16042;252;845;4671;13070;4923;13915
250435;201604;1355;4180;1223;3946;122;457;852;2732;974;3189
250440;201604;4387;12752;4070;12315;154;490;3448;10420;3602;10910
250450;201604;1918;5481;1716;5216;60;205;1446;4352;1506;4557
250460;201604;6359;19242;5945;18690;535;1798;4660;14833;5195;16631
250470;201604;1553;4219;1320;3902;124;438;895;2532;1019;2970
250480;201604;3733;11377;3479;11035;94;417;3067;9725;3161;10142
250485;201604;661;1660;550;1494;31;95;438;1158;469;1253
250490;201604;3763;11899;3675;11774;732;2306;2566;8307;3298;10613
250500;201604;1735;5308;1568;5039;268;824;1030;3419;1298;4243
250510;201604;4796;13669;4299;12941;166;551;3753;11324;3919;11875
250520;201604;1735;5249;1623;5076;220;735;983;3020;1203;3755
250523;201604;1594;5043;1548;4977;177;656;1203;3809;1380;4465
250527;201604;1390;4192;1322;4111;23;116;1215;3725;1238;3841
250530;201604;604;1871;527;1777;23;70;471;1610;494;1680
250535;201604;1298;4103;1226;3959;43;195;994;3139;1037;3334
250540;201604;2380;6859;2226;6682;43;184;1973;5830;2016;6014
250550;201604;902;2982;822;2861;45;227;651;2209;696;2436
250560;201604;1637;5163;1579;5082;74;323;1396;4421;1470;4744
250570;201604;2581;8254;2265;7640;135;591;1726;5687;1861;6278
250580;201604;1135;3033;978;2794;76;269;772;2132;848;2401
250590;201604;854;2684;804;2623;73;291;666;2124;739;2415
250600;201604;7262;21183;6821;20563;696;1999;5247;16003;5943;18002
250610;201604;3126;9041;2903;8704;236;767;2213;6602;2449;7369
250620;201604;689;2027;610;1867;88;288;380;1145;468;1433
250625;201604;2375;7658;2328;7600;70;175;2205;7299;2275;7474
250630;201604;9352;29157;8605;27680;2016;6494;4299;13986;6315;20480
250640;201604;3405;10517;3251;10328;158;676;2834;8871;2992;9547
250650;201604;814;2328;714;2179;41;151;525;1526;566;1677
250660;201604;1796;4878;1645;4680;21;45;1555;4460;1576;4505
250670;201604;2334;7939;2217;7734;133;636;1827;6245;1960;6881
250680;201604;4786;13647;4550;13366;222;670;4011;11836;4233;12506
250690;201604;5957;15594;5683;15274;404;1084;5006;13424;5410;14508
250700;201604;4691;13921;4311;13365;676;2191;2828;8714;3504;10905
250710;201604;4171;13374;3919;13017;483;1709;2735;9214;3218;10923
250720;201604;2641;7708;2480;7474;79;347;2175;6480;2254;6827
250730;201604;3443;10488;3233;10199;242;835;2485;7708;2727;8543
250740;201604;1883;5518;1640;5145;157;602;1244;3776;1401;4378
250750;201604;98528;278871;90923;267888;11906;38432;61006;177457;72912;215889
250760;201604;2233;6391;2013;6079;116;453;1679;5003;1795;5456
250770;201604;3845;12909;3649;12654;469;1840;2532;8731;3001;10571
250780;201604;1815;5320;1578;4892;162;601;1014;3035;1176;3636
250790;201604;2381;7779;2264;7590;473;1579;1345;4653;1818;6232
250800;201604;2620;7366;2328;6902;81;261;1925;5599;2006;5860
250810;201604;1290;3780;1128;3530;69;287;883;2714;952;3001
250820;201604;1831;5788;1756;5695;68;279;1591;5128;1659;5407
250830;201604;5587;18080;5182;17274;535;2063;3553;11601;4088;13664
250840;201604;895;2922;762;2638;54;226;517;1790;571;2016
250850;201604;1968;6086;1789;5794;90;427;1402;4443;1492;4870
250855;201604;1047;3143;953;3014;56;229;711;2177;767;2406
250860;201604;3151;10291;2748;9569;671;2532;933;3302;1604;5834
250870;201604;1058;3097;956;2903;32;127;739;2196;771;2323
250880;201604;1418;3950;1232;3686;152;468;917;2763;1069;3231
250890;201604;9139;27811;8646;27139;1062;4068;6174;18732;7236;22800
250900;201604;2802;9097;2473;8461;240;797;1795;6179;2035;6976
250905;201604;1990;6359;1911;6257;261;891;1444;4742;1705;5633
250910;201604;4904;14366;4645;13976;223;771;3854;11524;4077;12295
250915;201604;1383;4317;1360;4284;89;228;1178;3805;1267;4033
250920;201604;3236;9265;3036;8963;293;847;2214;6567;2507;7414
250930;201604;1979;6150;1864;5968;171;702;1371;4268;1542;4970
250933;201604;1117;3666;1046;3530;92;351;695;2299;787;2650
250937;201604;657;2035;598;1925;55;214;425;1328;480;1542
250939;201604;1521;4690;1425;4533;131;466;1001;3145;1132;3611
250940;201604;3719;11115;3505;10782;111;416;2993;9238;3104;9654
250950;201604;1263;3879;1121;3695;51;219;900;2965;951;3184
250960;201604;1063;3493;1018;3424;59;228;822;2752;881;2980
250970;201604;8335;23188;7346;21655;685;2158;5318;15574;6003;17732
250980;201604;2535;7503;2326;7139;105;444;1719;5069;1824;5513
250990;201604;1909;6520;1719;6111;255;1037;1035;3557;1290;4594
251000;201604;2078;6268;1885;5983;62;290;1574;4930;1636;5220
251010;201604;2741;8075;2465;7639;66;227;2147;6667;2213;6894
251020;201604;1613;4613;1481;4444;72;228;1334;4008;1406;4236
251030;201604;1077;3057;990;2907;61;207;728;2090;789;2297
251040;201604;1776;5574;1611;5301;83;391;1197;3796;1280;4187
251050;201604;1062;3098;928;2859;115;382;587;1767;702;2149
251060;201604;1004;2328;770;2029;40;138;602;1566;642;1704
251065;201604;465;1408;414;1331;29;99;283;860;312;959
251070;201604;617;1740;558;1663;36;144;446;1276;482;1420
251080;201604;19302;54570;17542;51723;4308;13288;8095;24537;12403;37825
251090;201604;2952;9179;2629;8576;198;727;1885;6047;2083;6774
251100;201604;966;3026;874;2869;78;302;584;1850;662;2152
251110;201604;1934;5685;1700;5231;134;387;1157;3569;1291;3956
251120;201604;6065;20546;5797;20084;646;2623;4236;14432;4882;17055
251130;201604;3927;10335;3626;10014;10;29;3574;9892;3584;9921
251140;201604;4209;12821;3979;12463;114;496;3359;10461;3473;10957
251150;201604;2501;8170;2342;7923;185;836;1757;5789;1942;6625
251160;201604;1815;5932;1756;5856;55;231;1608;5359;1663;5590
251170;201604;1400;4273;1327;4184;85;342;1119;3463;1204;3805
251180;201604;2521;7648;2298;7307;370;1183;1417;4514;1787;5697
251190;201604;4304;11955;4148;11780;153;466;3863;10942;4016;11408
251200;201604;3782;12266;3639;12089;84;353;3348;11118;3432;11471
251203;201604;1018;3430;994;3383;49;246;789;2646;838;2892
251207;201604;1088;3392;943;3134;55;250;637;2043;692;2293
251210;201604;7823;22278;6738;20859;674;2056;5176;16470;5850;18526
251220;201604;1153;3077;956;2789;84;252;712;2086;796;2338
251230;201604;4458;13512;4113;13102;203;806;3685;11613;3888;12419
251240;201604;3245;9852;3001;9540;370;1203;2226;7048;2596;8251
251250;201604;10281;30297;9529;29190;787;2833;7161;21481;7948;24314
251260;201604;479;1533;439;1477;20;83;333;1108;353;1191
251270;201604;4202;13601;3900;13235;132;630;3476;11774;3608;12404
251272;201604;1359;3949;1302;3875;74;246;1160;3438;1234;3684
251274;201604;900;2833;817;2693;78;328;560;1799;638;2127
251275;201604;1243;3622;1175;3511;65;289;904;2576;969;2865
251276;201604;1216;3727;1145;3605;70;282;849;2598;919;2880
251278;201604;586;1854;521;1740;60;241;338;1115;398;1356
251280;201604;2300;6950;2164;6726;97;396;1743;5252;1840;5648
251290;201604;5588;15454;5282;15088;549;1996;4162;11514;4711;13510
251300;201604;762;2554;720;2489;39;170;572;1958;611;2128
251310;201604;2947;8841;2715;8513;113;468;2203;6756;2316;7224
251315;201604;1612;5577;1539;5454;163;607;1103;3927;1266;4534
251320;201604;1861;5221;1452;4555;52;188;1055;3307;1107;3495
251330;201604;1748;4773;1502;4454;63;266;1303;3783;1366;4049
251335;201604;1017;3454;937;3311;81;372;664;2296;745;2668
251340;201604;3368;9554;2983;8991;194;778;2264;6604;2458;7382
251350;201604;1272;4089;1189;3938;81;324;912;2934;993;3258
251360;201604;1805;5728;1594;5454;60;259;1386;4769;1446;5028
251365;201604;799;2360;646;2042;18;77;454;1413;472;1490
251370;201604;21700;68373;21081;67555;1780;7062;16719;52078;18499;59140
251380;201604;1336;4164;1151;3852;37;197;958;3080;995;3277
251385;201604;783;2126;668;1950;75;211;439;1244;514;1455
251390;201604;5752;19763;5245;18830;1348;4978;2556;9317;3904;14295
251392;201604;1044;3118;932;2942;65;235;713;2222;778;2457
251394;201604;611;1915;504;1723;45;167;346;1174;391;1341
251396;201604;819;2336;711;2158;89;267;462;1394;551;1661
251398;201604;957;2802;841;2596;37;149;574;1725;611;1874
251400;201604;1149;3247;988;3018;83;298;719;2135;802;2433
251410;201604;1434;3775;1244;3456;49;198;1036;2800;1085;2998
251420;201604;1971;5697;1747;5435;203;660;1267;3906;1470;4566
251430;201604;1603;5669;1469;5453;70;366;1209;4416;1279;4782
251440;201604;1219;3633;1007;3230;50;194;750;2377;800;2571
251445;201604;1466;4554;1388;4445;99;394;1063;3290;1162;3684
251450;201604;4482;14424;4232;14091;104;465;3592;11983;3696;12448
251455;201604;1067;3468;965;3284;81;315;665;2271;746;2586
251460;201604;794;2504;743;2421;77;222;582;1953;659;2175
251465;201604;432;1381;383;1274;13;64;287;926;300;990
251470;201604;1160;3395;974;3033;80;281;599;1847;679;2128
251480;201604;925;2617;823;2450;27;124;661;1909;688;2033
251490;201604;1724;5185;1558;4931;147;553;1096;3430;1243;3983
251500;201604;1692;5462;1629;5348;126;506;1300;4175;1426;4681
251510;201604;2569;8419;2337;7961;408;1441;1319;4507;1727;5948
251520;201604;929;2565;822;2392;116;344;512;1471;628;1815
251530;201604;11887;33255;11245;32372;315;1366;9792;27561;10107;28927
251540;201604;2857;9190;2645;8787;171;702;2123;6995;2294;7697
251550;201604;3466;9074;2984;8446;73;308;2496;6969;2569;7277
251560;201604;688;2153;636;2061;84;318;379;1166;463;1484
251570;201604;1005;2975;810;2600;39;170;563;1733;602;1903
251580;201604;1894;5329;1742;5125;358;873;1105;3439;1463;4312
251590;201604;1481;4643;1418;4562;52;207;1177;3761;1229;3968
251593;201604;982;3067;914;2976;130;448;560;1781;690;2229
251597;201604;1861;5785;1794;5702;58;252;1589;4973;1647;5225
251600;201604;6404;18928;5978;18255;340;1146;4841;14691;5181;15837
251610;201604;3274;9840;3002;9386;250;773;2249;7113;2499;7886
251615;201604;1128;3267;922;2908;60;248;651;2001;711;2249
251620;201604;14834;41118;13171;39130;755;2306;10886;33155;11641;35461
251630;201604;4566;11889;3938;11013;307;877;3039;8415;3346;9292
251640;201604;2530;7435;2151;6810;104;444;1632;5098;1736;5542
251650;201604;3886;11318;3592;10939;221;706;3062;9311;3283;10017
251660;201604;3474;11248;3218;10798;113;560;2694;8812;2807;9372
251670;201604;4359;13010;3771;12253;47;168;3475;11442;3522;11610
251675;201604;715;2276;661;2201;119;438;403;1298;522;1736
251680;201604;2685;7763;2214;7030;85;368;1713;5363;1798;5731
251690;201604;3211;9761;3005;9365;128;449;2297;7017;2425;7466
251700;201604;1937;6298;1822;6156;97;453;1553;5162;1650;5615
251710;201604;905;2350;658;1886;95;304;329;883;424;1187
251720;201604;1404;4312;1231;4010;72;343;942;2963;1014;3306
251740;201604;770;2179;612;1911;69;228;372;1170;441;1398
260005;201604;25291;61389;21507;56177;4500;11673;11463;30297;15963;41970
260010;201604;9895;26699;8193;24499;1288;3920;4667;14561;5955;18481
260020;201604;5908;16544;4999;15183;230;821;3979;12158;4209;12979
260030;201604;6036;17361;5422;16433;388;1342;4165;12585;4553;13927
260040;201604;9908;24152;8196;22188;690;1760;6214;17485;6904;19245
260050;201604;11226;34725;10494;33876;566;2010;9020;29498;9586;31508
260060;201604;3823;10822;3412;10087;325;970;2478;7450;2803;8420
260070;201604;9715;28172;8938;26962;1296;4264;5833;17318;7129;21582
260080;201604;5696;15158;5053;14273;548;1652;3585;9995;4133;11647
260090;201604;5065;14128;4732;13643;735;2107;3326;9683;4061;11790
260100;201604;3293;9117;2861;8507;152;637;2357;6948;2509;7585
260105;201604;4916;13814;4656;13371;228;853;3871;10855;4099;11708
260110;201604;20730;58607;19143;56727;806;2484;16907;50279;17713;52763
260120;201604;11640;35580;10508;33609;2405;7932;5192;17184;7597;25116
260130;201604;3207;9034;3009;8723;455;1334;2068;5991;2523;7325
260140;201604;13209;32729;11354;30490;791;2360;8999;24337;9790;26697
260150;201604;3139;8833;2804;8387;190;722;2198;6515;2388;7237
260160;201604;5524;17510;4857;16640;263;1176;3983;13627;4246;14803
260170;201604;16158;45621;15391;44527;1067;3437;12617;36187;13684;39624
260180;201604;3215;9804;2928;9404;181;651;2442;7841;2623;8492
260190;201604;15939;37292;14545;35587;409;1129;12649;30579;13058;31708
260200;201604;10812;28872;10019;27843;571;1835;8500;23713;9071;25548
260210;201604;11531;34914;10296;33056;546;2197;8395;26905;8941;29102
260220;201604;9477;27333;9167;26942;409;1519;8128;23593;8537;25112
260230;201604;9559;27388;8804;26342;402;1500;7190;21490;7592;22990
260240;201604;2961;8890;2574;8334;345;1244;1788;5817;2133;7061
260250;201604;2268;6268;2036;5963;104;293;1730;5095;1834;5388
260260;201604;12138;34230;11065;32720;1525;4875;7874;23517;9399;28392
260270;201604;3598;10446;3327;10039;255;1052;2497;7215;2752;8267
260280;201604;12878;41635;11810;40046;699;2476;9833;33734;10532;36210
260290;201604;30844;92671;29137;89713;5055;16541;17740;53970;22795;70511
260300;201604;8508;26087;7540;24655;429;1802;5767;18945;6196;20747
260310;201604;4578;13520;4203;12978;1138;3240;2249;7478;3387;10718
260320;201604;7115;22946;6610;22135;381;1457;5476;18387;5857;19844
260330;201604;2598;8361;2404;8013;112;486;1876;6118;1988;6604
260340;201604;1843;5440;1703;5219;51;176;1507;4613;1558;4789
260345;201604;22691;70507;21273;67871;5512;19332;7977;24263;13489;43595
260350;201604;4750;12874;4425;12414;200;728;3752;10381;3952;11109
260360;201604;2309;6730;2104;6376;152;588;1450;4370;1602;4958
260370;201604;5688;17751;5023;16563;435;1749;3546;11620;3981;13369
260380;201604;4854;15892;4416;15210;284;1167;3312;11359;3596;12526
260390;201604;4254;13659;3750;12670;318;1228;2650;8824;2968;10052
260392;201604;3467;11064;3175;10694;193;858;2721;9044;2914;9902
260400;201604;13578;38522;12859;37355;1649;5370;8767;24873;10416;30243
260410;201604;60716;172993;53104;161075;14869;47717;19257;59922;34126;107639
260415;201604;3827;12044;3307;11022;270;1140;2103;6758;2373;7898
260420;201604;12028;27352;10690;25908;221;719;9721;23320;9942;24039
260430;201604;2861;9315;2535;8715;242;862;1710;5931;1952;6793
260440;201604;3276;9872;2907;9124;398;1374;1775;5430;2173;6804
260450;201604;4886;14504;4674;14201;171;605;4156;12676;4327;13281
260460;201604;5551;17499;5077;16619;945;3320;2761;8883;3706;12203
260470;201604;4463;13633;4131;13233;189;589;3613;11893;3802;12482
260480;201604;4038;11573;3557;10902;568;1899;2253;6982;2821;8881
260490;201604;4999;13223;4340;12111;250;805;3494;9543;3744;10348
260500;201604;5831;16777;5192;15756;792;2400;3304;10095;4096;12495
260510;201604;8693;23327;8041;22483;361;1196;7063;19596;7424;20792
260515;201604;4747;14406;3695;12315;231;873;2323;7727;2554;8600
260520;201604;15793;41410;15107;40494;1878;5104;11317;30269;13195;35373
260530;201604;9667;29539;8591;27907;383;1410;7244;23614;7627;25024
260540;201604;6024;14861;5479;14287;835;1574;4175;11581;5010;13155
260545;201604;71;254;48;187;8;33;11;38;19;71
260550;201604;2709;8863;2310;8012;432;1642;951;3292;1383;4934
260560;201604;6157;16334;5557;15481;149;585;4892;13410;5041;13995
260570;201604;6821;22351;6240;21413;618;2406;4470;15281;5088;17687
260580;201604;3661;10331;3397;9888;158;557;2835;8057;2993;8614
260590;201604;6105;15329;5750;14920;298;788;4973;12916;5271;13704
260600;201604;27491;80700;24741;76164;2041;7484;17849;54450;19890;61934
260610;201604;6521;19600;6177;19058;861;2806;4234;12908;5095;15714
260620;201604;15533;47035;14832;45842;2404;8195;9194;27764;11598;35959
260630;201604;2191;6511;1964;6149;109;462;1580;4811;1689;5273
260640;201604;17041;46952;15941;45476;2485;7334;10218;29242;12703;36576
260650;201604;5327;16875;4731;15864;375;1374;3623;12282;3998;13656
260660;201604;7816;21801;7035;20817;302;1071;6043;17788;6345;18859
260670;201604;2358;6304;1928;5704;150;493;1350;3996;1500;4489
260680;201604;21165;59664;19400;56612;3895;11708;9236;26989;13131;38697
260690;201604;3677;9958;3093;9005;226;636;2340;6841;2566;7477
260700;201604;5667;16891;5535;16754;39;95;5413;16544;5452;16639
260710;201604;1303;3841;1207;3717;90;314;910;2825;1000;3139
260720;201604;17182;55159;16219;53393;3633;12320;8518;28332;12151;40652
260730;201604;6624;22251;6214;21578;931;3379;4288;14885;5219;18264
260740;201604;1274;3812;1126;3557;101;371;801;2513;902;2884
260750;201604;6738;20467;6016;19541;388;1237;5057;16749;5445;17986
260760;201604;4681;12643;4393;12277;238;741;3638;10223;3876;10964
260765;201604;7699;25978;7314;25339;1005;4465;4921;16336;5926;20801
260770;201604;3747;9980;3453;9547;117;388;2852;7787;2969;8175
260775;201604;4989;14532;4698;14100;434;1590;3318;9678;3752;11268
260780;201604;3613;11672;3372;11208;649;2421;1743;5549;2392;7970
260790;201604;109108;275615;101165;263908;20456;54751;57165;148229;77621;202980
260795;201604;3018;9039;2711;8576;224;816;1942;6165;2166;6981
260800;201604;4787;12928;4465;12495;142;538;3959;10771;4101;11309
260805;201604;3824;11206;3352;10479;355;1280;2276;6999;2631;8279
260810;201604;6823;19179;6594;18890;293;919;5811;16620;6104;17539
260820;201604;4094;11641;3684;11039;856;2655;1875;5586;2731;8241
260825;201604;2859;9168;2559;8673;167;663;1960;6668;2127;7331
260830;201604;3664;11823;3283;11086;605;2015;1964;6808;2569;8823
260840;201604;4199;12059;3730;11373;241;893;3009;9069;3250;9962
260845;201604;4144;12035;3914;11630;467;1445;2809;8377;3276;9822
260850;201604;4897;16017;4355;14812;800;2986;2011;6751;2811;9737
260860;201604;3472;10726;3062;9916;145;561;2354;7582;2499;8143
260870;201604;4149;11446;3694;10879;461;1260;2727;8230;3188;9490
260875;201604;6407;17831;5694;16729;805;2393;3774;11167;4579;13560
260880;201604;9440;28869;8657;27597;631;2075;6791;21864;7422;23939
260890;201604;12939;37155;12065;35814;765;2677;9155;26993;9920;29670
260900;201604;5805;17896;5019;16393;433;1760;3163;10162;3596;11922
260910;201604;2969;9004;2701;8586;187;678;2030;6467;2217;7145
260915;201604;4498;15166;4262;14845;73;357;3927;13692;4000;14049
260920;201604;3206;9779;2974;9470;204;780;2367;7600;2571;8380
260930;201604;3893;12701;3475;12021;398;1448;2395;8347;2793;9795
260940;201604;13776;36631;12616;34793;1549;4761;8257;22194;9806;26955
260950;201604;6271;19372;5673;18196;834;3124;2968;9078;3802;12202
260960;201604;54881;152303;50282;144932;9725;29656;25880;73993;35605;103649
260970;201604;4878;15026;4452;14469;248;1050;3509;11381;3757;12431
260980;201604;3855;12541;3626;12253;114;491;3237;10919;3351;11410
260990;201604;16665;52358;15208;50361;995;3832;12131;40299;13126;44131
261000;201604;15948;43236;13058;38831;2380;7476;6525;20127;8905;27603
261010;201604;2526;7038;2316;6791;125;283;2038;6146;2163;6429
261020;201604;6118;17873;5413;16693;575;1836;3854;11754;4429;13590
261030;201604;3492;11106;3169;10535;198;815;2487;8121;2685;8936
261040;201604;5089;16448;4449;15164;366;1482;3197;10770;3563;12252
261050;201604;7795;22932;7307;22054;962;2907;4789;14557;5751;17464
261060;201604;12135;35731;11238;34133;957;3451;8298;24578;9255;28029
261070;201604;50550;124348;44835;116360;6255;16626;28840;74815;35095;91441
261080;201604;5623;16456;5299;15975;317;897;4537;13908;4854;14805
261090;201604;16368;45004;15055;43211;1286;3618;11799;34231;13085;37849
261100;201604;7974;25176;7177;23784;1236;4461;4028;13512;5264;17973
261110;201604;60224;178038;53771;168514;12432;41230;26374;84653;38806;125883
261120;201604;3737;9905;3282;9370;92;359;2903;8269;2995;8628
261130;201604;6943;17823;6466;17292;166;531;5894;15730;6060;16261
261140;201604;3226;9041;2935;8607;365;1236;1807;5166;2172;6402
261150;201604;5328;15524;4923;14888;370;1346;3997;11993;4367;13339
261153;201604;2131;6172;1752;5595;71;297;1296;4143;1367;4440
261160;201604;194486;509389;180331;489160;43610;123354;83262;228293;126872;351647
261170;201604;5788;15830;5267;15069;497;1461;3998;11575;4495;13036
261180;201604;9515;26459;8897;25605;972;3091;6042;17192;7014;20283
261190;201604;5078;15700;4720;15260;489;2052;3322;10348;3811;12400
261200;201604;3536;8951;3177;8529;372;967;2455;6714;2827;7681
261210;201604;1895;5013;1767;4853;125;334;1544;4275;1669;4609
261220;201604;13121;40728;11114;36509;1660;6009;5699;18520;7359;24529
261230;201604;4556;14354;4211;13931;131;546;3718;12396;3849;12942
261240;201604;4839;14252;4436;13582;591;1706;3019;9443;3610;11149
261245;201604;3528;10923;3050;10051;146;670;2388;7687;2534;8357
261247;201604;3235;9953;2765;9118;196;819;1968;6523;2164;7342
261250;201604;19350;51737;18167;50158;3369;8881;12163;34776;15532;43657
261255;201604;4005;12468;3601;11746;205;816;2909;9378;3114;10194
261260;201604;12064;33969;10852;32499;559;1760;9090;27464;9649;29224
261270;201604;3571;10641;3221;10078;384;1353;2153;6605;2537;7958
261280;201604;2489;7648;2314;7393;123;474;1878;5942;2001;6416
261290;201604;2898;8313;2641;7976;141;527;2146;6504;2287;7031
261300;201604;10664;34346;9355;31986;1418;5513;5610;18939;7028;24452
261310;201604;7232;22256;6805;21486;1648;5276;3622;11506;5270;16782
261320;201604;5646;17628;5199;16827;210;801;4224;13601;4434;14402
261330;201604;5444;15666;5140;15255;414;1367;4120;12102;4534;13469
261340;201604;3836;12894;3640;12579;387;1682;2410;8191;2797;9873
261350;201604;7978;26372;7505;25574;253;1302;6077;20237;6330;21539
261360;201604;8129;21369;7257;20150;559;1676;5739;15679;6298;17355
261370;201604;19398;57101;18076;55044;3701;11779;9984;30499;13685;42278
261380;201604;4070;13942;3770;13309;555;2170;2400;8456;2955;10626
261390;201604;16025;48788;14548;46371;2073;7135;8677;27710;10750;34845
261400;201604;4640;15976;4177;15013;324;1379;2948;10555;3272;11934
261410;201604;8705;24239;7827;22905;808;2421;5886;17299;6694;19720
261420;201604;7289;24636;6973;24206;1644;6432;3986;13538;5630;19970
261430;201604;3375;10596;2965;9995;252;907;2272;7787;2524;8694
261440;201604;1520;4830;1367;4600;51;267;1032;3378;1083;3645
261450;201604;14023;39732;13524;39139;308;1144;12309;35466;12617;36610
261460;201604;7083;20838;6610;20205;402;1149;5684;17659;6086;18808
261470;201604;3919;10739;3563;10279;94;306;3234;9394;3328;9700
261480;201604;3647;12998;3360;12470;305;1246;2431;8910;2736;10156
261485;201604;4853;14979;4389;14166;689;2566;2592;8156;3281;10722
261500;201604;5604;15591;4994;14783;453;1249;3700;11303;4153;12552
261510;201604;1874;6001;1711;5743;124;455;1251;4217;1375;4672
261520;201604;2649;8624;2476;8302;119;454;1684;5893;1803;6347
261530;201604;11610;37300;10340;34789;2029;7681;4367;14560;6396;22241
261540;201604;7054;22892;6668;22221;1465;4881;3862;13173;5327;18054
261550;201604;3397;9624;3199;9346;227;850;2516;7168;2743;8018
261560;201604;6975;23055;6333;22189;876;3487;4515;15903;5391;19390
261570;201604;3351;10208;2943;9545;415;1427;1837;5955;2252;7382
261580;201604;5953;18111;5389;17226;325;1348;4467;14131;4792;15479
261590;201604;2392;6825;2108;6396;170;502;1551;4764;1721;5266
261600;201604;5256;14279;4544;13284;319;966;3564;10494;3883;11460
261610;201604;2370;6846;2080;6461;100;417;1681;5171;1781;5588
261618;201604;2483;6927;2255;6643;172;534;1725;5021;1897;5555
261620;201604;4074;12657;3796;12190;623;2031;2469;8080;3092;10111
261630;201604;7610;22336;6421;20140;787;2860;3595;11046;4382;13906
261640;201604;33183;83334;31052;80792;2070;5144;24994;67502;27064;72646
261650;201604;3650;11127;3389;10768;313;1171;2494;7946;2807;9117
270010;201604;4368;16453;3991;15735;392;1849;2750;10846;3142;12695
270020;201604;3783;10769;3520;10388;340;1101;2726;7938;3066;9039
270030;201604;39025;116736;36419;112589;8614;27252;19464;60853;28078;88105
270040;201604;10509;32233;9697;31174;1925;6299;5855;19358;7780;25657
270050;201604;4245;12021;3878;11565;396;1323;3018;8960;3414;10283
270060;201604;1832;5442;1705;5281;297;955;1120;3532;1417;4487
270070;201604;4294;13231;3946;12773;187;888;3387;10715;3574;11603
270080;201604;1250;3966;1093;3657;154;575;671;2191;825;2766
270090;201604;2101;6530;1930;6197;58;318;1613;4988;1671;5306
270100;201604;5613;17437;5287;16878;724;2597;3597;11282;4321;13879
270110;201604;3142;8646;2772;8245;352;1072;1837;5855;2189;6927
270120;201604;3068;8766;2718;8339;86;332;2442;7514;2528;7846
270130;201604;5013;15220;4646;14804;578;1904;3553;11592;4131;13496
270135;201604;1745;4649;1610;4489;168;328;1361;3980;1529;4308
270140;201604;10152;24572;8733;22797;750;2894;6790;16519;7540;19413
270150;201604;2671;8875;2593;8777;61;221;2471;8396;2532;8617
270160;201604;5047;16705;4626;16168;202;862;3965;13789;4167;14651
270170;201604;3733;12110;3438;11722;568;2251;2029;6831;2597;9082
270180;201604;2230;7413;2047;7154;100;520;1686;5776;1786;6296
270190;201604;1764;5828;1677;5715;101;399;1397;4794;1498;5193
270200;201604;2571;8566;2398;8324;202;869;1838;6268;2040;7137
270210;201604;4599;13933;4321;13548;268;1121;3598;11048;3866;12169
270220;201604;1307;4327;1215;4160;229;846;686;2319;915;3165
270230;201604;10781;33875;9460;31833;1186;4920;5743;18707;6929;23627
270235;201604;6337;20487;5914;19815;370;1589;4810;15930;5180;17519
270240;201604;9312;28062;7838;26181;1968;6810;3564;12267;5532;19077
270250;201604;3221;8451;2928;8089;458;1242;2201;6098;2659;7340
270255;201604;4918;14797;3870;12918;233;978;2736;8945;2969;9923
270260;201604;5828;18790;5642;18531;416;1750;4757;15312;5173;17062
270270;201604;1166;3353;1070;3216;208;660;611;1804;819;2464
270280;201604;3458;9857;3053;9271;342;925;2121;6560;2463;7485
270290;201604;8041;27996;7514;27086;607;2731;5766;20506;6373;23237
270300;201604;3552;11459;3179;11023;325;1269;2316;8003;2641;9272
270310;201604;7418;22394;6519;21067;242;1256;5450;17204;5692;18460
270320;201604;5771;18263;5493;17818;758;2853;3914;12444;4672;15297
270330;201604;4254;14451;3982;14080;407;1542;3090;11045;3497;12587
270340;201604;1735;5299;1530;5028;129;406;1181;3901;1310;4307
270350;201604;1860;5087;1676;4869;139;468;1227;3567;1366;4035
270360;201604;1928;6044;1845;5949;165;481;1551;5135;1716;5616
270370;201604;1492;4954;1365;4742;108;446;987;3442;1095;3888
270375;201604;2795;7777;2501;7389;169;597;2045;5957;2214;6554
270380;201604;5556;17252;5195;16762;430;1462;4063;13323;4493;14785
270390;201604;1232;3410;1086;3202;67;255;823;2339;890;2594
270400;201604;6266;18785;5602;17826;361;1397;4108;12746;4469;14143
270410;201604;4770;14895;4401;14223;426;1521;3112;9937;3538;11458
270420;201604;5738;18441;5520;18142;250;1146;4531;14573;4781;15719
270430;201604;132175;383450;119489;364509;32675;105543;46029;143790;78704;249333
270440;201604;4617;13923;4270;13461;191;791;3499;11013;3690;11804
270450;201604;6171;19150;5907;18811;302;1315;4909;15360;5211;16675
270460;201604;3367;9019;3025;8602;151;512;2621;7360;2772;7872
270470;201604;10198;32508;9387;31219;1141;4121;6169;20716;7310;24837
270480;201604;2802;8771;2484;8197;252;1049;1696;5356;1948;6405
270490;201604;956;3079;887;2983;37;160;717;2388;754;2548
270500;201604;4811;16447;4538;16110;292;1303;3755;13268;4047;14571
270510;201604;5818;17396;5223;16564;623;2585;3857;11668;4480;14253
270520;201604;3530;11231;3237;10741;975;3562;1120;3845;2095;7407
270530;201604;1356;4202;1255;4052;126;435;858;2821;984;3256
270540;201604;2040;6794;1867;6540;101;522;1517;5164;1618;5686
270550;201604;7115;20695;6194;19531;792;2673;4235;13648;5027;16321
270560;201604;3025;9150;2815;8829;280;1082;2068;6323;2348;7405
270570;201604;3875;12523;3545;11962;307;1310;2715;8969;3022;10279
270580;201604;1995;6337;1901;6211;171;581;1485;4930;1656;5511
270590;201604;1355;4558;1299;4465;11;47;1253;4322;1264;4369
270600;201604;2767;9243;2517;8824;141;699;1996;6831;2137;7530
270610;201604;3145;9896;2918;9573;171;631;2400;7823;2571;8454
270620;201604;1362;4637;1285;4513;84;408;1025;3470;1109;3878
270630;201604;16174;47243;14806;45033;2154;6460;9922;30994;12076;37454
270640;201604;5631;17425;5106;16629;320;1371;4074;12994;4394;14365
270642;201604;2254;7988;2110;7782;219;1027;1583;5736;1802;6763
270644;201604;2625;7731;2333;7345;230;685;1800;5798;2030;6483
270650;201604;3621;11492;3449;11251;473;2135;2377;7260;2850;9395
270660;201604;2316;5919;1810;5192;78;322;1311;3695;1389;4017
270670;201604;16106;41645;13990;39266;1816;4926;10089;29407;11905;34333
270680;201604;4253;12567;4068;12360;120;331;3775;11572;3895;11903
270690;201604;8770;24309;7845;23274;2456;6945;4085;12926;6541;19871
270700;201604;636;1997;572;1892;74;306;387;1233;461;1539
270710;201604;5846;18712;5545;18330;398;1585;4633;15146;5031;16731
270720;201604;3282;11152;2989;10625;146;804;2420;8418;2566;9222
270730;201604;6251;18390;5934;18053;590;1859;4858;14987;5448;16846
270740;201604;2249;6464;2120;6277;239;826;1611;4664;1850;5490
270750;201604;5009;15652;4659;15113;632;2253;3302;10656;3934;12909
270760;201604;3307;10038;2959;9464;160;642;2336;7380;2496;8022
270770;201604;18673;48567;15341;44558;3299;9591;8175;25129;11474;34720
270780;201604;1768;5751;1680;5611;180;702;1236;4081;1416;4783
270790;201604;1510;4751;1387;4574;326;1155;698;2270;1024;3425
270800;201604;11278;33150;10492;32134;713;2713;8656;26079;9369;28792
270810;201604;3303;10030;2580;8737;263;1075;1569;5330;1832;6405
270820;201604;1765;5811;1595;5536;255;974;969;3350;1224;4324
270830;201604;5463;14972;4969;14382;362;1108;3992;11833;4354;12941
270840;201604;7746;25189;7204;24493;310;1625;6261;20843;6571;22468
270850;201604;7223;22708;6949;22348;1032;4113;4815;14650;5847;18763
270860;201604;10980;30773;9298;28626;1072;3940;6210;18692;7282;22632
270870;201604;2110;6429;1769;5723;237;817;1111;3551;1348;4368
270880;201604;8095;25900;7529;25066;458;1952;6127;20108;6585;22060
270890;201604;2347;7173;2203;6920;222;857;1613;4925;1835;5782
270895;201604;2823;10505;2700;10327;143;713;2325;8848;2468;9561
270900;201604;1920;5203;1563;4707;93;302;1163;3455;1256;3757
270910;201604;3529;11545;3258;11059;227;1030;2511;8277;2738;9307
270915;201604;9373;31330;8449;29703;1327;5462;4906;16827;6233;22289
270920;201604;6068;19148;5851;18848;204;1071;5262;16512;5466;17583
270930;201604;17122;45495;14172;42006;2679;8006;8264;25468;10943;33474
270940;201604;5601;18601;5314;18291;464;2095;4204;14260;4668;16355
280010;201604;645;1917;562;1774;52;234;360;1055;412;1289
280020;201604;4749;13809;4113;12735;684;2321;2484;7606;3168;9927
280030;201604;73487;192121;63467;177355;17863;52091;23642;67863;41505;119954
280040;201604;3085;9442;2737;8928;233;898;2024;6537;2257;7435
280050;201604;3759;12001;3470;11519;1131;3991;1317;4483;2448;8474
280060;201604;4651;14839;4180;14011;835;3022;2119;7261;2954;10283
280067;201604;7246;20440;6252;18961;909;2718;3889;12015;4798;14733
280070;201604;1884;6231;1797;6107;230;859;1314;4445;1544;5304
280100;201604;3766;11673;3410;11056;562;2017;2089;6785;2651;8802
280110;201604;1409;4241;1298;4077;59;251;1089;3381;1148;3632
280120;201604;7692;24190;7067;23176;1193;3561;4649;16009;5842;19570
280130;201604;7384;20621;6753;19719;1069;3408;4386;12863;5455;16271
280140;201604;5629;15131;5136;14432;370;1109;4126;11637;4496;12746
280150;201604;3362;10082;3144;9722;276;969;2271;6863;2547;7832
280160;201604;1363;3963;1195;3696;152;513;790;2405;942;2918
280170;201604;4728;14055;4283;13408;443;1412;3172;10079;3615;11491
280190;201604;1086;2980;977;2800;58;215;756;2102;814;2317
280200;201604;1161;3469;1061;3323;116;445;761;2311;877;2756
280210;201604;13636;40270;12248;38366;2274;7572;6918;22003;9192;29575
280220;201604;1554;4787;1455;4629;79;318;1199;3744;1278;4062
280230;201604;3415;10181;3071;9657;346;1179;2016;6374;2362;7553
280240;201604;3450;9996;3131;9498;254;747;2421;7385;2675;8132
280250;201604;814;2130;667;1890;115;392;333;856;448;1248
280260;201604;2018;5406;1882;5238;68;215;1691;4734;1759;4949
280270;201604;2224;6907;1989;6554;114;466;1550;5017;1664;5483
280280;201604;4119;13354;3734;12724;783;2181;2102;8018;2885;10199
280290;201604;17377;52410;15748;49943;2060;7277;9891;31528;11951;38805
280300;201604;9375;28501;8839;27847;781;2734;6929;22335;7710;25069
280310;201604;1355;3793;1194;3525;56;235;852;2453;908;2688
280320;201604;8529;27025;7810;25829;1416;5056;4020;13212;5436;18268
280330;201604;4459;12669;4068;12042;407;1435;3036;8651;3443;10086
280340;201604;3800;10687;3560;10364;323;1055;2809;8242;3132;9297
280350;201604;21703;60879;19455;57517;2858;8909;12437;37065;15295;45974
280360;201604;5649;17631;5279;17036;1004;3677;2866;9003;3870;12680
280370;201604;1855;5198;1611;4790;158;461;1102;3284;1260;3745
280380;201604;1028;3161;927;2997;92;342;650;2054;742;2396
280390;201604;3106;9146;2674;8356;352;1178;1707;5337;2059;6515
280400;201604;4162;11769;3803;11251;1238;3628;1652;5160;2890;8788
280410;201604;2200;6960;1877;6339;239;928;1073;3492;1312;4420
280420;201604;4075;11906;3779;11440;210;703;3189;9643;3399;10346
280430;201604;2251;5748;2032;5448;100;342;1597;4198;1697;4540
280440;201604;4631;13694;4330;13337;366;1233;3485;10637;3851;11870
280445;201604;2487;6947;2313;6659;77;290;1838;5201;1915;5491
280450;201604;8997;24030;8383;23270;579;1360;7073;20217;7652;21577
280460;201604;6867;18035;6213;17111;739;2131;4472;12471;5211;14602
280470;201604;1785;5419;1625;5145;175;556;1159;3725;1334;4281
280480;201604;30750;89598;28972;87003;4859;16288;18271;53734;23130;70022
280490;201604;3825;11369;3364;10600;239;898;2473;7656;2712;8554
280500;201604;917;2445;828;2334;41;114;693;1937;734;2051
280510;201604;2637;7635;2290;7183;182;658;1673;5260;1855;5918
280520;201604;1790;4854;1636;4670;142;382;1342;3885;1484;4267
280530;201604;2438;6597;2262;6389;136;372;1870;5355;2006;5727
280540;201604;9329;25412;8652;24482;227;933;7582;21012;7809;21945
280550;201604;6865;17977;5810;16394;584;1667;4044;11441;4628;13108
280560;201604;7541;22221;7131;21629;366;1262;5970;17898;6336;19160
280570;201604;6440;17345;5624;16254;570;1837;3797;10850;4367;12687
280580;201604;5526;17054;4700;15613;757;2557;2764;9430;3521;11987
280590;201604;2372;7067;2201;6847;226;958;1518;4567;1744;5525
280600;201604;3639;11147;3399;10793;289;1036;2563;8045;2852;9081
280610;201604;2468;6876;2262;6577;186;663;1632;4605;1818;5268
280620;201604;5178;15266;4547;14186;547;1664;3037;9829;3584;11493
280630;201604;3645;11835;3429;11513;319;1052;2728;9379;3047;10431
280640;201604;2213;6610;2115;6499;78;205;1977;6157;2055;6362
280650;201604;1109;3449;1002;3278;102;381;697;2268;799;2649
280660;201604;2681;7478;2570;7342;371;1004;2016;5836;2387;6840
280670;201604;16092;42095;14886;40472;2523;7368;9475;25397;11998;32765
280680;201604;2776;7486;2468;7016;184;591;1930;5394;2114;5985
280690;201604;952;2707;844;2557;117;369;576;1757;693;2126
280700;201604;1063;3166;950;2989;67;218;682;2139;749;2357
280710;201604;11937;31162;10875;29952;694;1680;9177;25935;9871;27615
280720;201604;2320;6261;2112;6019;247;731;1435;4249;1682;4980
280730;201604;922;2767;861;2681;81;296;676;2075;757;2371
280740;201604;13084;35376;11379;32808;1487;4216;7285;21369;8772;25585
280750;201604;3483;10587;3194;10103;312;1062;2221;7072;2533;8134
280760;201604;5612;17064;5115;16341;784;2709;3093;10142;3877;12851
290010;201604;2989;6735;2175;5490;43;182;1707;4088;1750;4270
290020;201604;4339;14428;4244;14300;372;1013;3546;12218;3918;13231
290030;201604;3127;9681;2950;9421;491;1567;2078;6676;2569;8243
290035;201604;4642;11792;4015;10965;205;692;3089;8701;3294;9393
290040;201604;4053;10845;3475;10191;219;795;2698;7873;2917;8668
290050;201604;2461;8009;2204;7589;147;605;1636;5634;1783;6239
290060;201604;1289;3356;1091;3122;152;502;815;2273;967;2775
290070;201604;33602;82956;28723;76889;6041;16052;13576;38850;19617;54902
290080;201604;6050;17935;5149;16733;638;2103;3599;12033;4237;14136
290090;201604;2129;4637;1675;4154;139;329;1409;3556;1548;3885
290100;201604;9530;27204;8400;25454;1049;3324;5280;16417;6329;19741
290110;201604;4785;14196;4537;13776;684;2264;2891;8567;3575;10831
290115;201604;4777;14393;4244;13701;230;734;3463;11457;3693;12191
290120;201604;6739;17579;5575;16196;234;838;4613;13280;4847;14118
290130;201604;4616;12090;3823;11114;183;695;3057;8648;3240;9343
290135;201604;4500;11244;3843;10254;306;933;2730;6996;3036;7929
290140;201604;4180;12893;3613;12124;246;949;2941;9916;3187;10865
290150;201604;2185;6554;2079;6405;210;671;1633;4955;1843;5626
290160;201604;3329;8751;3184;8573;306;656;2623;7147;2929;7803
290170;201604;2740;8974;2480;8601;163;763;2056;7029;2219;7792
290180;201604;2938;8524;2539;7907;170;631;1957;6065;2127;6696
290190;201604;3746;12464;3588;12231;191;846;2808;9433;2999;10279
290195;201604;2165;5882;1818;5367;74;330;1493;4318;1567;4648
290200;201604;3843;11892;3398;11211;263;904;2641;8741;2904;9645
290205;201604;3187;9288;2877;8819;219;851;2153;6465;2372;7316
290210;201604;15034;42048;13588;40204;2370;6283;8920;28350;11290;34633
290220;201604;2300;6798;2176;6603;122;519;1725;5089;1847;5608
290225;201604;2915;7236;2626;6917;135;353;2357;6221;2492;6574
290230;201604;2250;7293;2131;7152;122;505;1763;5894;1885;6399
290240;201604;3569;9664;3259;9208;290;873;2451;6842;2741;7715
290250;201604;3800;11997;3455;11505;168;527;2857;9942;3025;10469
290260;201604;5027;14219;4210;13005;314;1104;3208;9902;3522;11006
290265;201604;3357;10485;2984;9823;153;657;2305;7530;2458;8187
290270;201604;11950;43400;11382;42515;1417;5669;8231;31067;9648;36736
290280;201604;5258;17113;4874;16490;422;1590;3611;12253;4033;13843
290290;201604;9764;30491;8702;28751;1279;4274;5725;19288;7004;23562
290300;201604;4640;13019;3355;10640;232;748;2205;7177;2437;7925
290310;201604;1447;4331;1262;4039;233;790;681;2202;914;2992
290320;201604;28530;80843;24231;75267;5584;18504;11474;36784;17058;55288
290323;201604;3858;10411;3392;9884;163;491;2799;8186;2962;8677
290327;201604;4417;13299;3799;12191;523;1728;2422;7787;2945;9515
290330;201604;1814;4444;1672;4294;121;325;1452;3754;1573;4079
290340;201604;4940;15171;4618;14770;1317;4269;2510;8170;3827;12439
290350;201604;4350;13463;3806;12669;337;1179;2685;9148;3022;10327
290360;201604;4545;13718;3929;12896;161;629;3274;10847;3435;11476
290370;201604;4716;13039;4060;12201;331;956;3232;9857;3563;10813
290380;201604;5566;16056;4845;14967;300;997;3796;11931;4096;12928
290390;201604;14516;44192;13147;42200;2125;7027;7966;26570;10091;33597
290395;201604;2556;8364;2284;7851;131;601;1699;5833;1830;6434
290400;201604;3596;10514;3048;9684;260;837;2136;6761;2396;7598
290405;201604;4655;14604;3955;13331;538;1841;2374;8207;2912;10048
290410;201604;5947;17506;4846;15797;401;1591;3410;10821;3811;12412
290420;201604;3259;9408;2724;8647;191;669;2117;6721;2308;7390
290430;201604;3088;9650;2764;9082;498;1703;1611;5372;2109;7075
290440;201604;2977;7854;2398;7041;157;566;1849;5467;2006;6033
290450;201604;3283;9539;2800;8830;290;1012;1901;5988;2191;7000
290460;201604;12813;37045;11529;34910;3223;9895;4414;13569;7637;23464
290470;201604;4383;12052;3339;10506;748;2556;1422;4663;2170;7219
290475;201604;5367;17406;4804;16377;269;1262;3625;12063;3894;13325
290480;201604;2444;6563;2256;6322;251;716;1588;4678;1839;5394
290485;201604;4785;15122;4155;14182;279;1348;3300;11041;3579;12389
290490;201604;8001;20999;7587;20460;598;1698;6205;16582;6803;18280
290500;201604;4163;13033;3427;11586;496;1832;1796;6058;2292;7890
290510;201604;3324;9470;2908;8911;150;540;2408;7411;2558;7951
290515;201604;3475;9752;2930;9038;241;747;2331;7330;2572;8077
290520;201604;12155;36988;9838;32665;830;3234;5907;19432;6737;22666
290530;201604;5085;14984;4456;14013;318;979;3465;10996;3783;11975
290540;201604;3907;11178;3706;10935;373;1107;2975;8877;3348;9984
290550;201604;4593;11927;4030;11291;116;306;3681;10394;3797;10700
290560;201604;6298;18225;5536;17145;1249;3952;3112;9860;4361;13812
290570;201604;42401;115540;38705;110522;3720;11051;27778;79287;31498;90338
290580;201604;6968;23605;6545;22934;745;2741;4741;16966;5486;19707
290590;201604;7266;23135;6271;21374;269;1146;5022;17095;5291;18241
290600;201604;17511;52578;16245;50794;2061;6215;11851;38348;13912;44563
290610;201604;2467;8306;2051;7480;142;668;1431;5113;1573;5781
290620;201604;6447;19404;5890;18547;360;1171;4785;15069;5145;16240
290630;201604;7952;20742;6985;19685;588;1706;5757;16417;6345;18123
290640;201604;2685;7743;2170;6920;128;512;1633;5114;1761;5626
290650;201604;10868;31047;10244;30221;2208;6397;6128;18717;8336;25114
290660;201604;3680;10174;3160;9434;123;401;2397;7452;2520;7853
290670;201604;6858;20879;6137;19688;660;2154;4294;14011;4954;16165
290680;201604;10347;30528;9323;29275;417;1644;7704;24009;8121;25653
290682;201604;4529;12889;4011;12157;133;533;3444;10304;3577;10837
290685;201604;3754;8849;2468;7060;284;855;1487;4360;1771;5215
290687;201604;7524;21142;5894;18672;1357;4353;2724;9146;4081;13499
290689;201604;3157;9098;2778;8525;236;780;2074;6592;2310;7372
290690;201604;5431;15362;4793;14516;731;2259;3135;9591;3866;11850
290700;201604;2342;7220;2209;7027;143;524;1740;5540;1883;6064
290710;201604;7653;24036;7174;23334;406;1336;5938;19430;6344;20766
290720;201604;18414;53795;16864;51861;1262;3659;13766;43333;15028;46992
290730;201604;7201;19710;6431;18707;935;2618;4354;12880;5289;15498
290740;201604;945;2766;762;2453;72;257;517;1667;589;1924
290750;201604;10116;28025;8684;25426;1375;4480;4757;13434;6132;17914
290755;201604;2339;6603;1898;5868;88;328;1393;4259;1481;4587
290760;201604;4206;12685;3423;11265;445;1336;2056;7024;2501;8360
290770;201604;2503;8798;2358;8608;93;441;1914;7013;2007;7454
290780;201604;8933;22543;7736;20825;780;1618;5826;16426;6606;18044
290790;201604;4335;12945;3994;12481;228;722;3380;10599;3608;11321
290800;201604;7226;15317;5747;13742;524;1025;4369;11082;4893;12107
290810;201604;5227;15989;4406;14681;173;631;3363;11318;3536;11949
290820;201604;5659;15661;5026;14845;450;1472;3793;11346;4243;12818
290830;201604;4361;11515;4007;11031;203;676;3017;8137;3220;8813
290840;201604;17587;49581;15548;46567;2301;6712;9970;31193;12271;37905
290850;201604;6120;17605;5891;17333;716;1855;4651;14302;5367;16157
290860;201604;5060;16902;4717;16494;402;1527;3693;13201;4095;14728
290870;201604;4691;13725;3781;12190;247;990;2699;8646;2946;9636
290880;201604;1427;3843;1136;3391;100;272;758;2309;858;2581
290890;201604;7082;18176;6025;17007;598;1480;4826;13988;5424;15468
290900;201604;2428;6966;1838;5940;255;880;962;3102;1217;3982
290910;201604;4684;12503;3885;11348;95;378;3281;9479;3376;9857
290920;201604;4779;13377;4375;12826;247;717;3663;10770;3910;11487
290930;201604;7963;24135;6928;22459;363;1598;5398;17217;5761;18815
290940;201604;3471;10996;3157;10543;103;354;2600;8907;2703;9261
290950;201604;1553;4293;1354;3991;146;428;918;2756;1064;3184
290960;201604;5752;16208;5218;15542;173;624;4358;13048;4531;13672
290970;201604;3654;11482;3187;10727;287;985;2158;7405;2445;8390
290980;201604;10512;29735;8913;26794;2376;7355;2544;7716;4920;15071
290990;201604;9059;26968;7836;24973;714;2466;5750;18111;6464;20577
291000;201604;3035;8967;2732;8618;123;452;2433;7698;2556;8150
291005;201604;14344;37128;12642;34912;1571;4434;8762;24583;10333;29017
291010;201604;3274;10085;2579;8625;234;797;1663;5639;1897;6436
291020;201604;1351;3528;1047;3010;104;299;569;1553;673;1852
291030;201604;2247;6109;1653;4946;155;510;972;2855;1127;3365
291040;201604;5540;16496;4928;15619;315;1232;3849;12160;4164;13392
291050;201604;7781;25201;7071;23921;1622;6129;3630;11895;5252;18024
291060;201604;5979;21846;5640;21316;887;3742;3595;13437;4482;17179
291070;201604;16110;46032;14091;43150;951;3320;10799;33069;11750;36389
291072;201604;22995;67513;18665;59013;4541;15475;6101;19615;10642;35090
291075;201604;5105;14353;4547;13544;237;637;3546;10780;3783;11417
291077;201604;1455;4134;1186;3697;94;314;754;2349;848;2663
291080;201604;77750;240538;69949;225965;24009;78665;14163;46005;38172;124670
291085;201604;5705;14877;4905;13821;396;1178;3959;11208;4355;12386
291090;201604;1603;3787;1453;3614;45;135;1295;3211;1340;3346
291100;201604;2606;6623;2097;6065;94;368;1646;4695;1740;5063
291110;201604;4813;17289;4360;16616;511;2228;3075;11518;3586;13746
291120;201604;7216;19499;6657;18668;822;2324;4647;13169;5469;15493
291125;201604;1898;3786;1445;3301;92;229;1141;2656;1233;2885
291130;201604;2818;8849;2387;8092;118;521;1768;5862;1886;6383
291140;201604;4145;12277;3619;11312;478;1419;2234;7138;2712;8557
291150;201604;1938;5125;1822;4988;102;323;1508;4075;1610;4398
291160;201604;5242;16353;4594;15288;969;3300;2420;8076;3389;11376
291165;201604;2537;7069;1940;5964;41;174;1403;4208;1444;4382
291170;201604;21797;56475;18652;52250;1651;5041;12120;34034;13771;39075
291180;201604;6183;16166;5024;14424;412;1316;3569;10295;3981;11611
291185;201604;3718;10064;3317;9458;199;598;2706;7652;2905;8250
291190;201604;7057;19250;6218;18090;443;1558;5007;14360;5450;15918
291200;201604;2889;8616;2310;7523;146;496;1545;5120;1691;5616
291210;201604;6816;16354;5741;15137;260;815;4366;11486;4626;12301
291220;201604;4183;12896;3813;12312;484;1804;2555;8116;3039;9920
291230;201604;3941;10007;3596;9632;85;159;3372;9175;3457;9334
291240;201604;4583;12424;3968;11346;124;401;3197;9003;3321;9404
291250;201604;3537;10826;2826;9509;268;928;1853;6344;2121;7272
291260;201604;1064;3095;978;2986;54;231;820;2417;874;2648
291270;201604;4490;14259;4028;13388;1226;4269;1892;6330;3118;10599
291280;201604;2028;5918;1641;5247;323;1156;785;2422;1108;3578
291290;201604;5544;15394;4810;14443;773;2319;2898;8901;3671;11220
291300;201604;4365;12331;3383;10690;196;726;2462;7635;2658;8361
291310;201604;5326;15161;4646;13922;275;871;3590;10737;3865;11608
291320;201604;6064;18930;4972;16848;1164;4046;2257;7795;3421;11841
291330;201604;1596;4769;1424;4487;108;386;1012;3149;1120;3535
291340;201604;3900;10973;3221;10011;123;428;2592;8046;2715;8474
291345;201604;3355;10626;3115;10338;188;639;2618;8862;2806;9501
291350;201604;5670;16514;4960;15318;287;980;3798;11897;4085;12877
291360;201604;33014;90003;29145;84652;6996;20518;15260;45771;22256;66289
291370;201604;8257;23486;7747;22854;500;1572;6039;17961;6539;19533
291380;201604;3661;11015;3134;10161;192;712;2327;7650;2519;8362
291390;201604;10141;27322;9377;26423;1224;3354;6901;19643;8125;22997
291400;201604;13623;37805;11974;35306;2249;6087;7338;22974;9587;29061
291410;201604;3272;8572;2429;7241;120;511;1753;5048;1873;5559
291420;201604;2082;5693;1801;5362;84;301;1501;4436;1585;4737
291430;201604;3231;9418;2868;8927;128;619;2338;7022;2466;7641
291440;201604;6601;19921;5585;18231;511;1785;4099;13516;4610;15301
291450;201604;8259;24118;7222;22693;306;958;5794;19034;6100;19992
291460;201604;13145;39507;11839;37475;1593;5515;7435;23695;9028;29210
291465;201604;7976;22598;7006;21499;418;1582;5757;17507;6175;19089
291470;201604;15780;42131;13868;39865;1024;2809;10415;31068;11439;33877
291480;201604;34574;88281;29273;81098;4087;12402;16515;45858;20602;58260
291490;201604;4239;13510;4010;13199;438;1446;2988;10028;3426;11474
291500;201604;4293;12231;3641;11273;190;718;2903;8931;3093;9649
291510;201604;3623;10864;3321;10458;69;233;2949;9438;3018;9671
291520;201604;3778;10316;3234;9586;291;968;2230;6606;2521;7574
291530;201604;2185;5920;1725;5238;387;1189;848;2779;1235;3968
291535;201604;3752;11384;3388;10826;195;683;2649;8543;2844;9226
291540;201604;2123;5037;1772;4677;117;218;1559;4255;1676;4473
291550;201604;5088;13669;4422;12753;808;2245;2597;7694;3405;9939
291560;201604;18543;43570;13297;37471;912;2624;9780;28869;10692;31493
291570;201604;2203;5919;2025;5708;128;259;1725;5068;1853;5327
291580;201604;5441;16510;4827;15640;472;1898;3443;11095;3915;12993
291590;201604;1739;5496;1570;5223;147;546;1171;3914;1318;4460
291600;201604;5354;14588;3985;12428;1031;3390;1608;4899;2639;8289
291610;201604;4853;15626;4671;15422;128;424;4271;14281;4399;14705
291620;201604;2945;6996;2328;6350;134;399;1849;5201;1983;5600
291630;201604;3104;7485;2574;6873;225;616;1993;5419;2218;6035
291640;201604;16901;45864;13508;40854;3292;10383;4040;12818;7332;23201
291650;201604;8099;23896;7468;23126;600;1568;6181;19668;6781;21236
291660;201604;2138;5641;1740;5032;132;488;1116;3046;1248;3534
291670;201604;1831;5101;1653;4863;92;257;1315;3953;1407;4210
291680;201604;4009;11630;3477;10753;592;1996;2042;6291;2634;8287
291685;201604;4767;11954;3957;10911;649;1713;2546;7321;3195;9034
291690;201604;3875;10366;3048;9017;216;611;2114;6243;2330;6854
291700;201604;9067;28109;8084;26410;874;2826;5883;19520;6757;22346
291710;201604;5197;13515;4214;12280;307;914;3068;8971;3375;9885
291720;201604;4458;14515;3806;13163;313;1257;2635;8898;2948;10155
291730;201604;6029;17859;5483;17135;500;1684;4256;13485;4756;15169
291733;201604;2663;7589;2290;7093;195;651;1501;4822;1696;5473
291735;201604;2890;7971;2415;7286;122;438;1952;5852;2074;6290
291740;201604;3631;10571;3115;9855;215;781;2454;7758;2669;8539
291750;201604;22389;57211;17460;49699;3718;10931;8279;24256;11997;35187
291760;201604;10900;34703;9689;32640;3881;14528;2291;7677;6172;22205
291770;201604;7643;22022;6459;19893;771;2592;4081;12338;4852;14930
291780;201604;4470;13453;4177;12969;235;779;3483;10798;3718;11577
291790;201604;2663;8057;2528;7878;81;347;2152;6595;2233;6942
291800;201604;30298;81783;26574;76675;4117;11978;16263;48391;20380;60369
291810;201604;10615;28947;8939;26894;346;1280;7275;21916;7621;23196
291820;201604;3766;11048;3363;10451;180;660;2592;8100;2772;8760
291830;201604;4067;10893;3751;10441;400;1174;2767;7778;3167;8952
291835;201604;6294;19523;5066;17332;1359;4994;2357;8167;3716;13161
291840;201604;47169;131734;41458;125225;6362;18721;28006;88124;34368;106845
291845;201604;2642;7709;2464;7484;112;290;2230;6936;2342;7226
291850;201604;4546;12972;3748;11705;354;1002;2689;8716;3043;9718
291855;201604;1808;4486;1561;4182;150;520;1151;2976;1301;3496
291860;201604;2169;6103;1755;5320;74;275;1173;3463;1247;3738
291870;201604;1414;3785;1015;3068;71;277;634;1833;705;2110
291875;201604;2792;8780;2536;8385;103;418;1827;5934;1930;6352
291880;201604;4935;15795;4602;15188;439;1500;3392;11279;3831;12779
291890;201604;1270;3293;1042;3011;247;672;647;1979;894;2651
291900;201604;1256;3352;1013;2959;54;194;756;2182;810;2376
291905;201604;2722;7347;2057;6134;140;499;1450;4141;1590;4640
291910;201604;2740;7312;2295;6783;111;425;1933;5674;2044;6099
291915;201604;7010;21297;5863;19230;309;1107;4512;14934;4821;16041
291920;201604;25361;74620;23336;71780;3471;11264;14556;44964;18027;56228
291930;201604;2604;7660;2303;7184;187;699;1639;5002;1826;5701
291940;201604;3345;9420;2463;7883;285;999;1426;4460;1711;5459
291950;201604;8721;28878;7877;27301;1249;4344;4525;16209;5774;20553
291955;201604;10893;30979;10048;29937;2431;7253;5259;16683;7690;23936
291960;201604;3124;9140;2559;8288;223;739;1856;6226;2079;6965
291970;201604;3878;11937;3582;11448;364;1305;2448;7916;2812;9221
291980;201604;11925;33714;9123;29714;971;3184;6049;20244;7020;23428
291990;201604;2173;6568;1981;6318;80;272;1686;5504;1766;5776
291992;201604;2750;8363;2687;8255;374;1149;2001;6144;2375;7293
291995;201604;2054;5848;1782;5474;84;322;1503;4592;1587;4914
292000;201604;2423;6750;2178;6430;204;704;1551;4636;1755;5340
292010;201604;6392;15993;5003;14047;491;1258;3577;10336;4068;11594
292020;201604;3959;13693;3740;13332;563;2142;2674;9506;3237;11648
292030;201604;2027;6227;1809;5917;222;769;1054;3428;1276;4197
292040;201604;4389;11777;3783;11145;243;515;3182;9973;3425;10488
292045;201604;3218;10308;2935;9920;104;403;2681;9011;2785;9414
292050;201604;6326;19207;5405;17372;457;1743;3429;10879;3886;12622
292060;201604;12368;31495;11471;30401;867;2075;9402;24940;10269;27015
292070;201604;4577;14216;4303;13900;394;1213;3537;11569;3931;12782
292080;201604;3528;9142;2893;8343;172;542;2435;7067;2607;7609
292090;201604;3927;10273;3362;9615;194;700;2817;8072;3011;8772
292100;201604;11268;30143;9635;27941;2271;6842;4553;13785;6824;20627
292105;201604;3037;9298;2714;8783;121;518;2191;7064;2312;7582
292110;201604;6444;17221;5024;14982;1317;3928;2309;7100;3626;11028
292120;201604;7488;20984;6277;18738;1213;3528;3315;10253;4528;13781
292130;201604;2886;7891;2477;7324;395;1055;1533;4745;1928;5800
292140;201604;4966;13001;4123;11813;686;1813;2715;8034;3401;9847
292145;201604;2385;7295;2118;6844;256;796;1421;4785;1677;5581
292150;201604;12391;37890;11426;36366;521;1940;9304;29635;9825;31575
292160;201604;2452;7105;2098;6647;91;383;1834;5749;1925;6132
292170;201604;8757;24748;7221;22137;918;3080;4487;13746;5405;16826
292180;201604;2964;8612;2335;7523;423;1291;1245;4181;1668;5472
292190;201604;3282;9299;2762;8509;534;1731;1499;4694;2033;6425
292200;201604;6711;20615;5730;18920;1657;5883;1958;6521;3615;12404
292205;201604;3850;11536;3460;10976;159;664;2762;8592;2921;9256
292210;201604;6421;17139;5360;15743;306;1070;4394;12854;4700;13924
292220;201604;1854;5071;1657;4779;428;1194;809;2345;1237;3539
292225;201604;3177;9834;2890;9400;150;621;2371;7661;2521;8282
292230;201604;6677;19129;6289;18520;311;1313;4956;14045;5267;15358
292240;201604;4790;14382;4290;13393;469;1510;2898;9028;3367;10538
292250;201604;5001;15348;4654;14750;1054;3472;2174;6995;3228;10467
292260;201604;3137;9231;2924;8947;170;515;2453;7571;2623;8086
292265;201604;3162;9531;2728;8811;121;550;2061;6508;2182;7058
292270;201604;4088;10325;3299;9401;160;550;2760;7884;2920;8434
292273;201604;2754;6341;2106;5545;170;405;1576;4360;1746;4765
292275;201604;1575;4307;1394;4047;148;415;1044;3125;1192;3540
292280;201604;2157;6020;1888;5718;171;478;1429;4592;1600;5070
292285;201604;2488;6680;2050;6057;108;386;1593;4693;1701;5079
292290;201604;6938;20814;5772;19252;377;1503;4374;14751;4751;16254
292300;201604;8155;24282;7068;22956;1791;6135;3725;12461;5516;18596
292303;201604;2836;8575;2565;8207;96;383;2184;6896;2280;7279
292305;201604;2885;7788;2713;7547;60;237;2461;6759;2521;6996
292310;201604;5852;17244;5408;16573;156;557;4471;13672;4627;14229
292320;201604;6682;18681;5655;16961;398;1262;4326;12928;4724;14190
292330;201604;2197;5856;2016;5617;148;475;1628;4495;1776;4970
292335;201604;5118;13424;4567;12706;423;1120;3645;10328;4068;11448
292340;201604;6333;17815;5399;16306;435;1324;3896;11835;4331;13159
292350;201604;2293;6704;1986;6271;133;508;1589;5006;1722;5514
292360;201604;5275;13717;4990;13234;200;380;4155;11553;4355;11933
292370;201604;8247;23617;7399;22487;660;1733;5827;18099;6487;19832
292380;201604;7229;21296;6578;20250;632;1798;4995;15604;5627;17402
292390;201604;3450;7839;2915;7261;86;189;2637;6663;2723;6852
292400;201604;20642;62865;19296;60757;2659;8391;13241;42213;15900;50604
292405;201604;4542;11271;3659;10136;196;466;2914;8194;3110;8660
292410;201604;1968;5257;1827;5099;137;336;1521;4303;1658;4639
292420;201604;3761;12127;3552;11830;218;878;2906;9657;3124;10535
292430;201604;5554;16336;4202;14430;353;1363;2763;9562;3116;10925
292440;201604;8374;27786;7741;26845;188;814;6918;24182;7106;24996
292450;201604;3975;11904;3271;10727;329;1081;2258;7526;2587;8607
292460;201604;4861;14572;4179;13430;506;1739;2742;8832;3248;10571
292465;201604;2398;7111;2017;6490;197;692;1273;4181;1470;4873
292467;201604;1845;5897;1764;5775;300;1056;1139;3812;1439;4868
292470;201604;2891;7701;2383;6857;104;350;1855;5287;1959;5637
292480;201604;6172;16366;5279;15218;139;475;4749;13663;4888;14138
292490;201604;2396;6508;1963;5880;140;434;1467;4379;1607;4813
292500;201604;6530;19300;5583;17644;674;2173;3625;11643;4299;13816
292510;201604;12703;36063;10932;33496;736;2689;8320;25659;9056;28348
292520;201604;5521;15656;4812;14624;1049;3232;2534;7841;3583;11073
292525;201604;5284;13737;4498;12819;165;535;3800;10865;3965;11400
292530;201604;26631;75744;23316;71273;6158;19493;10320;32740;16478;52233
292540;201604;2852;7807;2519;7409;251;831;1947;5686;2198;6517
292550;201604;6411;19715;5563;18617;636;2261;4118;14166;4754;16427
292560;201604;4015;11199;3490;10404;180;681;2648;7780;2828;8461
292570;201604;4162;11768;3838;11429;70;160;3618;11042;3688;11202
292575;201604;6252;20547;6049;20237;478;1651;4976;16804;5454;18455
292580;201604;6710;19856;6291;19286;335;1097;5307;16290;5642;17387
292590;201604;7386;21536;6872;20798;433;1359;5723;17170;6156;18529
292593;201604;3014;7758;2495;6951;359;933;1668;4643;2027;5576
292595;201604;5780;15982;5106;15126;360;1133;3975;11854;4335;12987
292600;201604;10649;30007;9540;28575;830;1983;7410;23009;8240;24992
292610;201604;4633;12889;3781;11518;284;868;2340;7459;2624;8327
292620;201604;6201;18633;5443;17761;108;351;5063;16720;5171;17071
292630;201604;9268;23355;7683;20932;701;1895;5335;14799;6036;16694
292640;201604;7802;25169;7225;24279;408;1538;5505;18718;5913;20256
292650;201604;4754;12601;4446;12205;372;844;3702;10319;4074;11163
292660;201604;10742;32098;9842;30803;1032;3356;7337;23239;8369;26595
292665;201604;2402;7439;2280;7280;37;100;2102;6796;2139;6896
292670;201604;3716;10419;2893;8964;183;629;1834;5688;2017;6317
292680;201604;3647;10808;3293;10222;448;1287;2272;7125;2720;8412
292690;201604;2850;7733;2064;6483;170;533;1389;4515;1559;5048
292700;201604;9276;27538;8166;25907;1188;3500;5154;17297;6342;20797
292710;201604;2105;6886;1984;6726;59;224;1763;6005;1822;6229
292720;201604;9197;23423;7943;22040;301;974;6763;19039;7064;20013
292730;201604;3623;10774;3474;10559;236;756;2776;8453;3012;9209
292740;201604;326351;870477;305516;839688;53749;156374;185199;504127;238948;660501
292750;201604;6530;17428;5598;16149;278;888;4479;12977;4757;13865
292760;201604;3979;12397;3587;11709;390;1372;2428;7948;2818;9320
292770;201604;5890;17187;5165;16159;909;2994;3061;9873;3970;12867
292780;201604;1886;4408;1433;3827;107;363;1026;2665;1133;3028
292790;201604;3298;8026;3164;7886;65;114;3034;7649;3099;7763
292800;201604;9138;26775;8396;25560;488;1616;6702;20340;7190;21956
292805;201604;2989;8420;2616;7896;280;908;1907;5745;2187;6653
292810;201604;9428;27974;7808;25699;949;3161;5289;17904;6238;21065
292820;201604;7315;20859;5533;18266;278;1201;4349;14304;4627;15505
292830;201604;1741;5044;1574;4813;62;260;1378;4172;1440;4432
292840;201604;7813;23691;7335;23054;310;1224;6450;19990;6760;21214
292850;201604;3119;8258;2528;7355;293;894;1577;4485;1870;5379
292860;201604;15077;38789;13784;37116;1088;3044;10684;28725;11772;31769
292870;201604;19176;52176;16782;48502;1868;6073;9990;28404;11858;34477
292880;201604;12590;35337;11165;33382;912;3107;8028;23581;8940;26688
292890;201604;5325;17827;4812;16912;628;2361;3105;11037;3733;13398
292895;201604;2821;6794;2172;5809;231;591;1492;4020;1723;4611
292900;201604;2743;8464;2607;8257;158;720;1949;5898;2107;6618
292905;201604;4053;11969;3293;10787;274;953;2280;7536;2554;8489
292910;201604;4951;14664;4480;13827;546;1767;2687;8320;3233;10087
292920;201604;9165;26645;8712;25995;488;1820;7189;20845;7677;22665
292925;201604;5116;15452;4624;14742;342;1117;3594;11553;3936;12670
292930;201604;6423;20492;6055;19846;422;1890;4352;13870;4774;15760
292935;201604;2014;5877;1700;5534;83;294;1447;4875;1530;5169
292937;201604;3233;8198;2689;7526;176;520;2142;6017;2318;6537
292940;201604;3274;8886;2611;8006;259;804;1761;5621;2020;6425
292950;201604;8029;23373;7438;22388;477;1769;5480;16101;5957;17870
292960;201604;5209;13354;4483;12388;281;840;3325;9131;3606;9971
292970;201604;4251;12646;3741;11972;135;621;3073;9798;3208;10419
292975;201604;3505;9268;3275;8979;346;860;2753;7686;3099;8546
292980;201604;3298;8741;2579;7727;214;736;1839;5481;2053;6217
292990;201604;11763;33718;10258;31461;393;1408;8340;25518;8733;26926
293000;201604;2800;7231;2576;6966;51;150;2052;5955;2103;6105
293010;201604;17805;49226;15129;44980;2311;7249;8661;25616;10972;32865
293015;201604;7457;25354;6596;23668;694;2826;4308;15387;5002;18213
293020;201604;8951;29835;8426;29095;296;1384;7290;25010;7586;26394
293030;201604;5564;15832;4430;14065;232;792;3120;10331;3352;11123
293040;201604;3730;12164;3561;11852;168;543;3136;10484;3304;11027
293050;201604;20314;55781;17810;52577;3354;10127;9027;28217;12381;38344
293060;201604;3604;9597;2982;8585;233;734;2159;6129;2392;6863
293070;201604;22681;62791;19171;57708;4474;13610;8616;27236;13090;40846
293075;201604;3202;10930;2953;10549;198;855;2312;8288;2510;9143
293076;201604;3755;10274;3376;9769;175;471;2809;8328;2984;8799
293077;201604;4880;15179;4388;14511;842;2913;2630;8954;3472;11867
293080;201604;4595;14425;4171;13756;188;890;3418;11073;3606;11963
293090;201604;3289;10459;2726;9595;258;962;1956;7017;2214;7979
293100;201604;5785;16943;4792;15199;455;1508;3401;10925;3856;12433
293105;201604;3991;13025;3473;12035;483;1684;2217;7837;2700;9521
293110;201604;2020;5722;1778;5371;66;224;1459;4424;1525;4648
293120;201604;3746;12240;3567;11961;301;964;2800;9560;3101;10524
293130;201604;4043;11338;3480;10722;140;497;3038;9544;3178;10041
293135;201604;31608;79360;24004;68697;4837;15536;8986;25790;13823;41326
293140;201604;1972;5546;1877;5414;125;457;1520;4254;1645;4711
293150;201604;5455;17952;4681;16467;699;2528;2848;10277;3547;12805
293160;201604;3791;9669;3455;9281;527;1054;2529;7347;3056;8401
293170;201604;3329;9790;3043;9387;260;952;2181;6776;2441;7728
293180;201604;5228;14655;4175;12952;147;607;3244;9867;3391;10474
293190;201604;13747;41277;12621;39607;424;1974;10802;33315;11226;35289
293200;201604;7147;19582;6257;18479;175;671;4881;14577;5056;15248
293210;201604;5083;14474;4475;13449;279;898;3365;10102;3644;11000
293220;201604;4967;14585;4254;13346;1130;3575;1492;4853;2622;8428
293230;201604;3734;11379;3364;10805;452;1597;2274;7308;2726;8905
293240;201604;4375;12000;3505;10558;133;431;2585;7815;2718;8246
293245;201604;4239;12025;3827;11444;249;737;3011;9114;3260;9851
293250;201604;5593;15301;5020;14461;529;1591;3470;9953;3999;11544
293260;201604;4500;13421;3820;12429;246;859;2868;9447;3114;10306
293270;201604;5536;14688;5035;14150;399;974;4263;12231;4662;13205
293280;201604;5223;14591;4424;13539;202;625;3480;10793;3682;11418
293290;201604;14492;47919;13463;45993;3274;11484;5965;21035;9239;32519
293300;201604;6907;16162;5777;14856;337;778;4447;11696;4784;12474
293305;201604;4854;11975;4086;10966;135;425;3426;9160;3561;9585
293310;201604;2504;6508;2008;5657;199;563;1320;3695;1519;4258
293315;201604;4215;10727;3589;9794;334;834;2656;7380;2990;8214
293317;201604;2454;7045;2211;6605;196;559;1492;4526;1688;5085
293320;201604;7701;25425;7488;25153;851;2966;5778;19588;6629;22554
293325;201604;1796;5093;1472;4601;178;602;971;3028;1149;3630
293330;201604;50480;161067;45448;152305;9952;35309;20735;70503;30687;105812
293340;201604;2648;7488;2074;6507;269;877;1152;3644;1421;4521
293345;201604;3288;9741;2870;9184;244;650;2198;7395;2442;8045
293350;201604;6441;18842;6075;18419;239;533;5480;17149;5719;17682
293360;201604;12866;39156;11650;37623;926;3422;9805;31571;10731;34993
310010;201604;915;2476;718;2175;99;376;329;931;428;1307
310020;201604;2876;8981;2387;8051;543;1998;312;982;855;2980
310030;201604;2297;7100;1884;6398;396;1494;992;3327;1388;4821
310040;201604;965;2573;803;2353;56;200;621;1790;677;1990
310050;201604;1857;6324;1687;5950;345;1371;712;2434;1057;3805
310060;201604;3203;10006;2786;9469;295;1142;2135;7234;2430;8376
310070;201604;331;939;253;794;17;77;158;464;175;541
310080;201604;719;2147;594;1931;105;423;221;668;326;1091
310090;201604;4557;13513;3923;12417;449;1572;2545;8041;2994;9613
310100;201604;3420;10280;2879;9389;168;675;2201;7135;2369;7810
310110;201604;4732;13345;4068;12268;651;2225;2184;6356;2835;8581
310120;201604;610;1862;470;1586;127;537;176;476;303;1013
310130;201604;399;1212;364;1160;89;337;184;530;273;867
310140;201604;210;697;175;644;57;261;48;141;105;402
310150;201604;4662;14174;4033;12993;973;3427;1349;4251;2322;7678
310160;201604;7170;22481;5942;20219;1788;6602;922;3030;2710;9632
310163;201604;1021;3267;863;2956;270;974;214;718;484;1692
310170;201604;9045;25286;8053;23912;1098;3474;5345;16078;6443;19552
310180;201604;1622;4686;1388;4324;263;894;702;2116;965;3010
310190;201604;2798;9180;2481;8595;666;2535;403;1376;1069;3911
310200;201604;1826;5904;1550;5354;318;1226;538;1844;856;3070
310205;201604;1109;3192;854;2804;136;451;471;1586;607;2037
310210;201604;2691;7772;2385;7316;163;534;1867;5752;2030;6286
310220;201604;1042;3119;920;2923;165;582;548;1700;713;2282
310230;201604;2499;7719;2117;6899;320;1248;1106;3391;1426;4639
310240;201604;895;3236;813;3070;119;489;442;1718;561;2207
310250;201604;803;2645;776;2600;151;618;445;1378;596;1996
310260;201604;3174;9984;2447;8530;571;2273;504;1563;1075;3836
310270;201604;2519;7141;2088;6529;160;612;1621;5032;1781;5644
310280;201604;2291;6028;1864;5386;208;772;1062;2922;1270;3694
310285;201604;2027;7177;1875;6947;208;923;1394;5203;1602;6126
310290;201604;1126;3392;1056;3281;252;878;530;1495;782;2373
310300;201604;1678;5631;1595;5484;416;1629;784;2574;1200;4203
310310;201604;363;987;263;805;33;97;124;391;157;488
310320;201604;390;1231;324;1107;41;198;155;499;196;697
310330;201604;519;1290;349;980;35;109;141;344;176;453
310340;201604;8300;24810;6812;22262;1325;4414;3294;11276;4619;15690
310350;201604;13518;35687;9850;29671;2344;7876;2483;7243;4827;15119
310360;201604;434;1281;401;1236;26;119;290;846;316;965
310370;201604;1392;4625;1254;4373;358;1258;569;2014;927;3272
310375;201604;1192;3253;782;2508;103;372;289;919;392;1291
310380;201604;367;951;247;772;80;271;80;225;160;496
310390;201604;447;1541;388;1430;85;335;67;204;152;539
310400;201604;10151;27932;7607;23710;1754;5952;1799;5674;3553;11626
310410;201604;727;2415;508;2031;108;470;93;372;201;842
310420;201604;5476;15300;3629;11496;642;2231;494;1338;1136;3569
310430;201604;1323;4293;1015;3694;240;952;151;528;391;1480
310440;201604;547;1566;415;1324;68;252;166;519;234;771
310445;201604;1229;4011;1026;3633;125;486;663;2337;788;2823
310450;201604;4517;12676;3663;11453;355;1185;2505;7955;2860;9140
310460;201604;1519;4533;1265;4147;363;1323;264;939;627;2262
310470;201604;4062;9168;3465;8454;268;588;2935;7276;3203;7864
310480;201604;1234;3589;918;2964;185;613;369;1133;554;1746
310490;201604;2846;9232;2479;8526;599;2412;973;3224;1572;5636
310500;201604;1277;4265;1119;3927;252;975;430;1461;682;2436
310510;201604;2018;6314;1589;5384;374;1351;245;831;619;2182
310520;201604;1404;3589;1066;3071;76;213;721;2079;797;2292
310530;201604;992;2961;526;1798;63;248;63;186;126;434
310540;201604;2906;9418;2608;8883;643;2288;1118;3837;1761;6125
310550;201604;1187;3335;950;2968;199;754;459;1317;658;2071
310560;201604;15305;46340;12967;41910;3386;12183;3649;11012;7035;23195
310570;201604;1136;3416;968;3131;151;579;627;1985;778;2564
310590;201604;4251;12356;3490;10954;590;1970;1513;4662;2103;6632
310600;201604;1386;4547;1247;4266;271;1079;496;1586;767;2665
310610;201604;460;1552;402;1425;78;345;119;375;197;720
310620;201604;139585;426120;120010;389733;27632;100130;43884;132697;71516;232827
310630;201604;4076;12256;3744;11716;341;1201;2746;8488;3087;9689
310640;201604;1273;3848;1035;3448;291;1076;259;803;550;1879
310650;201604;2669;8344;2104;7352;332;1201;1169;4123;1501;5324
310660;201604;1319;3990;1163;3790;119;397;839;2710;958;3107
310665;201604;1251;3786;1122;3611;98;341;872;2876;970;3217
310670;201604;39433;120540;35112;111708;8959;30132;12354;38502;21313;68634
310680;201604;672;1904;601;1804;91;303;398;1172;489;1475
310690;201604;1410;4513;1145;4053;227;962;409;1353;636;2315
310700;201604;527;1273;408;1124;69;229;246;654;315;883
310710;201604;6229;20247;4825;17903;939;4105;629;2119;1568;6224
310720;201604;765;2296;699;2180;86;311;450;1377;536;1688
310730;201604;9273;28615;8262;26944;1429;5086;4713;15303;6142;20389
310740;201604;4934;15561;3927;13608;916;3458;820;2705;1736;6163
310750;201604;1469;3643;1106;3154;208;634;526;1413;734;2047
310760;201604;600;1805;500;1634;88;314;178;576;266;890
310770;201604;893;2794;688;2479;158;644;270;914;428;1558
310780;201604;3727;10237;3144;9216;480;1416;1954;5722;2434;7138
310790;201604;1935;6189;1760;5879;450;1558;754;2654;1204;4212
310800;201604;2786;8771;2151;7553;617;2508;162;516;779;3024
310810;201604;1133;3187;1005;2954;169;570;555;1535;724;2105
310820;201604;1289;3696;916;2987;205;728;223;736;428;1464
310825;201604;2520;8436;1986;7501;132;700;1441;5373;1573;6073
310830;201604;1325;4276;1063;3774;296;1118;289;989;585;2107
310840;201604;2100;6364;1631;5557;334;1225;422;1362;756;2587
310850;201604;1515;4480;1287;4185;154;546;911;2977;1065;3523
310855;201604;2909;9110;2500;8486;386;1437;1615;5523;2001;6960
310860;201604;7405;22611;6220;20478;755;2668;3626;12112;4381;14780
310870;201604;1027;2813;797;2436;148;491;412;1259;560;1750
310880;201604;1049;3264;866;2933;142;561;458;1527;600;2088
310890;201604;2546;7679;1962;6671;460;1763;393;1193;853;2956
310900;201604;4034;12628;3152;10811;671;2558;1018;3251;1689;5809
310910;201604;1909;5383;1267;4145;221;830;148;395;369;1225
310920;201604;1863;5447;1470;4839;326;1228;630;2042;956;3270
310925;201604;909;2965;819;2809;294;1115;300;995;594;2110
310930;201604;6098;17100;4885;15330;815;2777;2744;8877;3559;11654
310940;201604;6124;17110;5104;15564;819;2600;2805;8499;3624;11099
310945;201604;1116;3270;991;3094;121;448;617;1857;738;2305
310950;201604;2038;6434;1508;5297;376;1536;439;1441;815;2977
310960;201604;382;1235;313;1105;90;343;110;401;200;744
310970;201604;1429;4697;1055;3847;245;1008;147;463;392;1471
310980;201604;431;1050;265;770;36;120;123;319;159;439
310990;201604;1141;3695;940;3268;207;810;259;829;466;1639
311000;201604;3503;11828;3193;11245;897;3534;1044;3424;1941;6958
311010;201604;714;2419;663;2328;220;828;288;1006;508;1834
311020;201604;903;2645;709;2310;135;499;325;1010;460;1509
311030;201604;1598;4330;1115;3472;279;1008;333;919;612;1927
311040;201604;458;1532;392;1376;84;298;89;291;173;589
311050;201604;2146;6577;1866;6161;481;1771;806;2647;1287;4418
311060;201604;2341;6871;1759;5677;326;1184;506;1510;832;2694
311070;201604;1386;4735;1218;4418;260;1067;497;1787;757;2854
311080;201604;806;2480;690;2255;138;497;279;848;417;1345
311090;201604;1544;5786;1346;5379;418;1829;301;1165;719;2994
311100;201604;2033;6783;1643;5950;546;2147;222;797;768;2944
311110;201604;3429;8262;2486;6934;389;1178;1244;3459;1633;4637
311115;201604;1211;3506;1015;3219;88;370;686;2122;774;2492
311120;201604;7816;21865;6042;18789;1349;4711;1585;4571;2934;9282
311130;201604;2009;6173;1663;5661;329;1355;685;2208;1014;3563
311140;201604;1278;3410;1028;3086;86;297;701;2096;787;2393
311150;201604;1723;5934;1584;5715;275;1109;965;3469;1240;4578
311160;201604;3987;13309;3268;12008;1119;4482;724;2665;1843;7147
311170;201604;784;2347;622;2055;63;233;294;1004;357;1237
311180;201604;1174;3382;917;2897;267;909;205;608;472;1517
311190;201604;1094;3068;814;2524;161;571;210;598;371;1169
311200;201604;1990;6048;1611;5266;424;1520;271;799;695;2319
311205;201604;990;3275;846;2983;117;476;382;1361;499;1837
311210;201604;934;3003;861;2907;154;515;572;2009;726;2524
311220;201604;861;2683;704;2356;153;556;226;725;379;1281
311230;201604;8203;25756;6445;22202;1290;4735;2115;7616;3405;12351
311240;201604;1022;3079;800;2721;209;785;231;773;440;1558
311250;201604;753;2451;673;2328;195;752;207;638;402;1390
311260;201604;2388;6338;1795;5376;415;1381;598;1768;1013;3149
311265;201604;1222;3438;963;3012;184;627;495;1562;679;2189
311270;201604;3340;10582;2918;9992;293;1401;2020;6636;2313;8037
311280;201604;1258;3511;807;2578;162;604;186;566;348;1170
311290;201604;1972;6572;1851;6305;374;1270;1041;3605;1415;4875
311300;201604;4274;14231;3813;13401;419;1780;2650;9214;3069;10994
311310;201604;566;1886;513;1792;90;349;186;594;276;943
311320;201604;3784;12520;3410;11713;629;2445;1206;3888;1835;6333
311330;201604;4566;13634;3949;12598;1023;3632;1657;5291;2680;8923
311340;201604;11729;36756;10242;33950;3019;10735;2605;8549;5624;19284
311350;201604;2292;6413;1780;5461;278;995;799;2244;1077;3239
311360;201604;1098;3032;852;2718;367;1218;126;431;493;1649
311370;201604;3663;10969;3048;9880;657;2462;1107;3256;1764;5718
311380;201604;404;1339;352;1243;95;359;117;413;212;772
311390;201604;1751;6347;1603;6140;684;2970;448;1609;1132;4579
311400;201604;1430;4491;1180;4019;212;855;478;1495;690;2350
311410;201604;1776;6015;1587;5774;422;1723;758;2807;1180;4530
311420;201604;1869;6010;1298;4623;235;919;153;415;388;1334
311430;201604;3777;11280;2629;8796;485;1780;283;928;768;2708
311440;201604;2393;7581;1774;6470;555;2344;268;952;823;3296
311450;201604;1913;6582;1609;5929;443;1820;301;1018;744;2838
311455;201604;1121;2981;884;2595;213;663;375;1015;588;1678
311460;201604;624;2018;473;1711;102;429;106;354;208;783
311470;201604;479;1583;383;1380;105;437;80;247;185;684
311480;201604;781;2054;727;1981;165;424;448;1230;613;1654
311490;201604;225;822;203;761;58;243;71;238;129;481
311500;201604;431;1250;344;1089;83;312;137;417;220;729
311510;201604;2936;8993;2371;7968;703;2792;498;1604;1201;4396
311520;201604;604;1972;559;1881;172;641;214;689;386;1330
311530;201604;11506;29481;8258;24267;1877;6573;2121;5986;3998;12559
311535;201604;797;2310;518;1755;111;432;83;260;194;692
311540;201604;607;2104;564;2036;201;716;232;837;433;1553
311545;201604;2083;6321;1849;6034;167;612;1330;4296;1497;4908
311547;201604;1478;4146;1241;3776;81;267;831;2523;912;2790
311550;201604;2884;9109;2425;8205;394;1539;867;2850;1261;4389
311560;201604;262;681;221;635;28;82;125;341;153;423
311570;201604;1999;5071;1547;4454;111;356;1124;3325;1235;3681
311580;201604;2331;4727;1759;4067;431;901;960;2393;1391;3294
311590;201604;447;1358;380;1254;92;345;150;494;242;839
311600;201604;1188;3608;1009;3376;175;572;623;2143;798;2715
311610;201604;2893;10133;2595;9633;838;3043;1010;4029;1848;7072
311615;201604;3062;9511;2563;8723;244;984;1796;6099;2040;7083
311620;201604;407;1267;365;1192;66;244;206;664;272;908
311630;201604;1367;3978;1132;3584;227;687;648;2060;875;2747
311640;201604;765;2446;634;2231;129;495;300;1046;429;1541
311650;201604;2241;6373;1898;5842;250;843;1057;3267;1307;4110
311660;201604;2287;7573;1790;6422;313;1166;162;494;475;1660
311670;201604;1652;4732;1334;4198;415;1429;401;1247;816;2676
311680;201604;2059;6442;1736;5901;375;1335;912;3126;1287;4461
311690;201604;477;1224;406;1138;30;89;326;931;356;1020
311700;201604;2173;5833;1782;5310;130;431;1338;3936;1468;4367
311710;201604;1639;4957;1208;4149;424;1635;280;916;704;2551
311720;201604;390;1295;350;1216;62;234;153;523;215;757
311730;201604;5768;14375;3332;10201;913;3215;629;1513;1542;4728
311740;201604;786;2348;745;2295;177;518;499;1582;676;2100
311750;201604;3976;12823;3452;12009;597;2417;1850;6302;2447;8719
311760;201604;698;2323;613;2133;136;526;158;473;294;999
311770;201604;2206;6986;1822;6266;415;1586;530;1756;945;3342
311780;201604;1116;3930;945;3562;262;1159;219;752;481;1911
311783;201604;1933;6357;1631;5768;93;475;1207;4204;1300;4679
311787;201604;587;2011;435;1570;80;319;103;307;183;626
311790;201604;1509;4438;1126;3719;233;880;373;1175;606;2055
311800;201604;4510;15030;3884;13523;813;3079;292;855;1105;3934
311810;201604;1059;3433;923;3179;66;309;585;1990;651;2299
311820;201604;607;1869;497;1624;125;450;237;721;362;1171
311830;201604;8150;26994;6693;23559;1991;7665;695;2228;2686;9893
311840;201604;2919;8770;2610;8309;672;2393;1225;3809;1897;6202
311850;201604;280;866;247;810;39;140;132;424;171;564
311860;201604;47682;139748;40604;127472;7854;27068;19610;59735;27464;86803
311870;201604;2104;6118;1557;5083;302;1116;477;1444;779;2560
311880;201604;6749;19275;5973;18314;686;1951;4268;13634;4954;15585
311890;201604;1456;4298;1175;3787;271;947;494;1569;765;2516
311900;201604;741;2221;648;2085;77;277;388;1275;465;1552
311910;201604;4235;12375;3467;11246;814;2860;1457;4741;2271;7601
311920;201604;1870;6126;1639;5701;199;754;990;3443;1189;4197
311930;201604;3473;9826;2924;8975;1122;3593;734;2230;1856;5823
311940;201604;12254;36503;9852;31676;2313;8092;2167;6534;4480;14626
311950;201604;2186;6399;1795;5825;150;557;1260;4049;1410;4606
311960;201604;378;1172;337;1088;68;263;137;368;205;631
311970;201604;342;1185;287;1062;53;229;70;247;123;476
311980;201604;602;1669;408;1319;61;210;139;463;200;673
311990;201604;418;1215;343;1100;118;417;113;340;231;757
311995;201604;1170;3550;725;2497;44;163;67;168;111;331
312000;201604;602;1816;542;1726;69;235;331;1079;400;1314
312010;201604;879;2835;743;2545;125;473;289;951;414;1424
312015;201604;1352;4344;1207;4082;129;520;786;2619;915;3139
312020;201604;1064;3351;939;3152;187;662;435;1476;622;2138
312030;201604;1777;5160;1597;4937;92;326;1359;4193;1451;4519
312040;201604;729;2653;608;2335;135;568;114;424;249;992
312050;201604;1230;4293;1050;3870;241;999;148;473;389;1472
312060;201604;745;2240;644;2090;188;648;287;900;475;1548
312070;201604;1018;3112;685;2398;151;577;235;806;386;1383
312080;201604;2608;7177;2086;6374;287;1053;1124;3208;1411;4261
312083;201604;887;2513;770;2342;95;319;551;1652;646;1971
312087;201604;2130;6489;1921;6186;205;737;1396;4559;1601;5296
312090;201604;8799;27001;7464;24743;2132;7454;2682;8751;4814;16205
312100;201604;1351;4512;1130;4172;247;1051;483;1744;730;2795
312110;201604;1032;3598;903;3320;270;1135;157;500;427;1635
312120;201604;711;2301;600;2078;127;530;208;626;335;1156
312125;201604;1079;3486;959;3263;219;736;495;1775;714;2511
312130;201604;842;2374;657;2023;90;305;235;687;325;992
312140;201604;790;2515;692;2290;154;559;189;546;343;1105
312150;201604;498;1435;435;1310;21;76;284;812;305;888
312160;201604;7242;24317;6425;22641;1644;6356;2326;8045;3970;14401
312170;201604;912;2634;776;2410;67;225;488;1496;555;1721
312180;201604;1346;4120;1170;3774;247;854;458;1399;705;2253
312190;201604;580;1854;446;1592;146;570;64;228;210;798
312200;201604;4653;13341;3910;12172;709;2164;2130;6731;2839;8895
312210;201604;1063;2843;807;2464;204;694;347;988;551;1682
312220;201604;1897;6348;1744;6180;172;521;1451;5393;1623;5914
312230;201604;12156;37137;9472;32064;3018;11328;1204;3944;4222;15272
312235;201604;1539;4589;1357;4320;157;599;948;2974;1105;3573
312240;201604;910;3043;734;2672;173;669;186;665;359;1334
312245;201604;2156;6419;1935;6131;97;344;1582;5011;1679;5355
312247;201604;783;2334;605;2028;165;595;247;850;412;1445
312250;201604;1170;3213;885;2724;156;548;353;1025;509;1573
312260;201604;885;2789;738;2542;123;494;447;1496;570;1990
312270;201604;638;1900;532;1701;65;274;256;745;321;1019
312280;201604;407;1354;361;1253;128;474;43;141;171;615
312290;201604;755;2463;694;2376;173;693;227;755;400;1448
312300;201604;871;2885;690;2459;166;642;63;172;229;814
312310;201604;844;3141;791;3034;219;933;297;1108;516;2041
312320;201604;1923;5502;1486;4661;367;1262;250;670;617;1932
312330;201604;982;2854;817;2622;130;500;572;1817;702;2317
312340;201604;309;826;262;753;39;139;156;404;195;543
312350;201604;284;724;250;684;23;76;204;535;227;611
312352;201604;1609;5070;1450;4836;294;1035;927;3172;1221;4207
312360;201604;3006;9559;2512;8582;519;1961;722;2455;1241;4416
312370;201604;1668;5226;1514;4981;480;1799;505;1552;985;3351
312380;201604;1841;5132;1626;4839;66;188;1371;4190;1437;4378
312385;201604;1295;3822;1114;3535;101;411;779;2397;880;2808
312390;201604;2118;6798;1723;6033;437;1645;292;938;729;2583
312400;201604;3110;9899;2598;8891;935;3315;621;2211;1556;5526
312410;201604;9498;30956;8456;28974;1837;6831;3530;11941;5367;18772
312420;201604;3833;11727;3626;11464;514;1622;2508;8103;3022;9725
312430;201604;7875;23250;6774;21292;968;3093;4217;13402;5185;16495
312440;201604;749;2323;626;2112;193;723;255;907;448;1630
312450;201604;1095;3592;843;3074;273;1041;231;875;504;1916
312460;201604;348;1044;310;1000;75;277;157;507;232;784
312470;201604;651;1765;421;1323;78;278;124;370;202;648
312480;201604;1187;3104;897;2787;200;688;479;1416;679;2104
312490;201604;1965;5159;1542;4536;216;704;867;2459;1083;3163
312500;201604;664;1986;579;1855;97;349;210;664;307;1013
312510;201604;3355;9709;2702;8393;398;1424;1309;3796;1707;5220
312520;201604;255;857;205;771;55;220;59;235;114;455
312530;201604;593;1754;528;1662;68;273;330;1011;398;1284
312540;201604;1429;4478;1098;3839;212;800;514;1802;726;2602
312550;201604;677;2063;580;1850;111;371;264;796;375;1167
312560;201604;2026;5351;1672;4903;81;306;1365;3952;1446;4258
312570;201604;2337;6897;1957;6263;530;1830;606;1906;1136;3736
312580;201604;518;1705;437;1529;64;264;158;535;222;799
312590;201604;1654;5479;1441;5039;240;1040;627;2033;867;3073
312595;201604;1899;6353;1699;5893;325;1158;908;3174;1233;4332
312600;201604;783;2539;603;2183;93;429;274;923;367;1352
312610;201604;6997;19538;5171;16261;1146;3991;996;2936;2142;6927
312620;201604;2166;6245;1671;5561;136;519;1224;4216;1360;4735
312630;201604;333;1074;287;992;77;302;105;339;182;641
312640;201604;536;1729;434;1518;92;338;123;400;215;738
312650;201604;2119;6193;1576;5126;144;532;915;2965;1059;3497
312660;201604;1388;3643;1122;3258;103;362;754;2150;857;2512
312670;201604;5514;16323;4689;15199;1263;4497;1641;5192;2904;9689
312675;201604;1225;3954;1042;3557;139;535;617;2097;756;2632
312680;201604;1457;4396;1241;4108;183;727;749;2395;932;3122
312690;201604;2109;5601;1718;5049;248;775;1060;3016;1308;3791
312695;201604;802;2840;768;2794;148;527;501;1905;649;2432
312700;201604;1843;5532;1461;4776;190;701;719;2309;909;3010
312705;201604;1237;3545;1042;3198;78;267;736;2223;814;2490
312707;201604;1531;4854;1205;4226;157;664;603;2023;760;2687
312710;201604;6722;16898;4400;13184;1163;3911;794;2306;1957;6217
312720;201604;746;2540;651;2346;147;590;236;813;383;1403
312730;201604;1876;4444;1296;3758;151;484;732;2115;883;2599
312733;201604;1615;4312;1222;3609;54;177;749;2166;803;2343
312735;201604;809;2219;703;2078;146;487;411;1154;557;1641
312737;201604;826;2078;603;1766;181;536;202;608;383;1144
312738;201604;502;1521;370;1261;90;348;110;335;200;683
312740;201604;374;948;231;783;71;267;55;175;126;442
312750;201604;1235;4377;1169;4266;227;983;562;1977;789;2960
312760;201604;1948;6233;1521;5369;352;1369;336;1161;688;2530
312770;201604;40004;109292;30980;94408;7761;25571;8095;23951;15856;49522
312780;201604;2621;9042;2337;8564;395;1609;1228;4619;1623;6228
312790;201604;315;796;188;581;35;128;51;122;86;250
312800;201604;4854;15721;3962;13956;1177;4518;916;3232;2093;7750
312810;201604;2042;6231;1428;5026;320;1208;236;781;556;1989
312820;201604;1849;5296;1629;4938;83;298;1142;3382;1225;3680
312825;201604;1314;3611;1143;3387;92;308;875;2593;967;2901
312830;201604;2515;7697;1769;6224;419;1615;272;941;691;2556
312840;201604;1212;3868;1002;3463;150;591;313;981;463;1572
312850;201604;677;2110;535;1834;86;360;165;557;251;917
312860;201604;1116;3270;863;2830;231;834;231;686;462;1520
312870;201604;5526;17014;3913;13621;718;2741;747;2498;1465;5239
312880;201604;1254;3764;1114;3555;129;455;698;2294;827;2749
312890;201604;1628;4928;1069;3661;249;917;344;1202;593;2119
312900;201604;1199;3502;1051;3296;135;449;733;2357;868;2806
312910;201604;1618;3238;980;2421;147;415;464;1063;611;1478
312920;201604;860;2723;702;2429;182;722;271;874;453;1596
312930;201604;2113;6079;1841;5681;404;1291;873;2763;1277;4054
312940;201604;884;2869;773;2689;195;761;211;690;406;1451
312950;201604;3052;8530;2360;7504;793;2716;532;1689;1325;4405
312960;201604;1932;5557;1675;5233;192;560;1278;4144;1470;4704
312965;201604;1775;5634;1522;5183;189;767;915;3110;1104;3877
312970;201604;985;3269;813;2975;215;891;185;661;400;1552
312980;201604;16551;55200;15569;53219;4771;17842;5596;18484;10367;36326
312990;201604;459;1347;330;1130;95;372;100;346;195;718
313000;201604;498;1632;406;1452;95;451;162;493;257;944
313005;201604;2569;8215;2272;7674;476;1584;1208;4148;1684;5732
313010;201604;3516;11172;2962;10220;770;2864;1247;4246;2017;7110
313020;201604;936;3051;738;2557;145;581;136;380;281;961
313030;201604;1485;3960;1089;3411;219;840;475;1427;694;2267
313040;201604;807;2630;701;2384;97;405;288;893;385;1298
313050;201604;1763;5430;1320;4752;290;1175;329;1077;619;2252
313055;201604;1584;4958;1441;4760;69;250;1188;3956;1257;4206
313060;201604;734;2355;582;2001;153;550;59;174;212;724
313065;201604;1907;6157;1636;5734;306;1195;1053;3688;1359;4883
313070;201604;1031;2997;844;2673;179;652;355;1072;534;1724
313080;201604;441;1377;335;1162;71;288;96;290;167;578
313090;201604;5184;14846;4471;13700;1043;3411;2224;6854;3267;10265
313100;201604;1102;3337;993;3163;90;287;766;2481;856;2768
313110;201604;1712;4868;1287;4059;196;703;554;1635;750;2338
313115;201604;2396;8030;2259;7748;510;1986;989;3164;1499;5150
313120;201604;3462;9106;2948;8438;647;2101;1645;4611;2292;6712
313130;201604;25045;75278;21754;68705;4655;16233;8354;24890;13009;41123
313140;201604;571;1479;440;1287;27;97;315;904;342;1001
313150;201604;1301;4100;1105;3758;485;1757;208;711;693;2468
313160;201604;929;2823;806;2580;125;459;451;1404;576;1863
313170;201604;7733;25975;6152;22312;1419;5466;1197;4259;2616;9725
313180;201604;2337;6369;1875;5721;455;1559;694;2041;1149;3600
313190;201604;3305;11140;2644;9497;567;2212;610;2043;1177;4255
313200;201604;1130;3677;983;3399;112;430;678;2313;790;2743
313210;201604;4138;12832;3450;11780;752;2786;1508;4995;2260;7781
313220;201604;1473;4335;1059;3479;241;882;224;619;465;1501
313230;201604;2257;7965;2093;7745;300;1187;1453;5385;1753;6572
313240;201604;7887;23890;6178;20741;1177;4529;2260;7209;3437;11738
313250;201604;6834;21345;5955;19863;775;2696;3384;11372;4159;14068
313260;201604;610;1796;438;1432;67;245;105;337;172;582
313270;201604;5303;15810;4419;14323;847;2962;2226;7145;3073;10107
313280;201604;375;1235;275;1019;51;210;59;200;110;410
313290;201604;805;2805;662;2555;234;1008;90;313;324;1321
313300;201604;1792;5899;1479;5166;400;1533;188;557;588;2090
313310;201604;1041;3584;933;3354;201;836;174;557;375;1393
313320;201604;2291;6526;1715;5609;302;1099;716;2353;1018;3452
313330;201604;3932;12085;3274;10957;364;1478;1917;6240;2281;7718
313340;201604;1887;4647;1492;4069;271;741;793;2175;1064;2916
313350;201604;2874;8893;2305;7671;452;1676;449;1361;901;3037
313360;201604;1216;3459;927;2991;215;851;473;1435;688;2286
313370;201604;1138;3826;1071;3651;164;668;549;1750;713;2418
313375;201604;2282;5905;1571;4865;279;1070;490;1451;769;2521
313380;201604;4847;14977;4088;13470;1023;3706;1263;3904;2286;7610
313390;201604;859;2940;814;2878;90;366;550;1926;640;2292
313400;201604;3645;9881;3182;9344;268;730;2687;8089;2955;8819
313410;201604;1205;3422;1010;3122;237;798;537;1626;774;2424
313420;201604;18652;44252;11583;32574;2109;6728;1798;5007;3907;11735
313430;201604;1031;3198;787;2691;146;590;285;897;431;1487
313440;201604;6132;13827;4206;11593;255;691;2726;7686;2981;8377
313450;201604;619;1839;503;1617;101;375;155;462;256;837
313460;201604;2095;7108;1805;6613;465;1975;572;1883;1037;3858
313470;201604;3075;8495;2729;8006;385;1179;1797;5210;2182;6389
313480;201604;1037;2952;802;2578;114;433;285;846;399;1279
313490;201604;1478;4301;858;3300;251;1066;88;325;339;1391
313500;201604;391;1271;323;1102;58;216;101;341;159;557
313505;201604;9024;26324;8299;25505;337;735;7595;23879;7932;24614
313507;201604;1371;3758;1185;3485;106;345;796;2355;902;2700
313510;201604;15188;43413;13257;40579;1924;6132;7366;22732;9290;28864
313520;201604;14069;43177;11840;39183;1314;4910;7432;24426;8746;29336
313530;201604;595;1809;495;1634;41;161;172;538;213;699
313535;201604;2443;7270;2211;6848;172;583;1624;4981;1796;5564
313540;201604;1060;3307;788;2612;198;721;174;533;372;1254
313545;201604;1261;4608;1132;4350;160;761;650;2354;810;3115
313550;201604;1781;5703;1565;5282;387;1346;669;2231;1056;3577
313560;201604;2157;5049;1779;4622;244;600;1272;3421;1516;4021
313570;201604;862;2990;741;2756;227;915;227;827;454;1742
313580;201604;5700;16293;4551;14638;757;2627;2532;8270;3289;10897
313590;201604;970;2735;756;2436;346;1233;145;427;491;1660
313600;201604;3770;11282;3246;10450;379;1338;2203;7115;2582;8453
313610;201604;963;2893;823;2629;161;575;408;1270;569;1845
313620;201604;5286;16215;4575;14954;1219;4262;1550;5075;2769;9337
313630;201604;7964;22172;5993;19356;1031;3797;2649;9060;3680;12857
313640;201604;762;2203;573;1913;176;651;162;527;338;1178
313650;201604;1910;6273;1687;5904;265;1067;1075;3682;1340;4749
313652;201604;924;3245;846;3099;131;554;515;1833;646;2387
313655;201604;927;2958;778;2708;104;429;471;1606;575;2035
313657;201604;1319;3911;1085;3556;104;482;785;2394;889;2876
313660;201604;805;2638;711;2467;153;621;316;1039;469;1660
313665;201604;3618;11570;3115;10518;648;2449;1375;4468;2023;6917
313670;201604;43884;128033;32608;106373;7488;26888;9690;30845;17178;57733
313680;201604;1037;3082;921;2893;138;528;552;1683;690;2211
313690;201604;830;2985;728;2746;167;643;256;983;423;1626
313695;201604;1329;4313;1142;3964;102;415;792;2758;894;3173
313700;201604;3423;11734;3013;11209;467;1783;2116;8074;2583;9857
313710;201604;1296;3490;1000;3037;168;554;537;1597;705;2151
313720;201604;5186;16466;4163;14275;787;2994;1329;4239;2116;7233
313730;201604;1269;3385;965;3004;153;529;546;1705;699;2234
313740;201604;2021;7261;1722;6555;477;2046;121;392;598;2438
313750;201604;2160;6521;1817;5870;465;1611;544;1614;1009;3225
313753;201604;1783;5129;1421;4528;283;1019;628;1973;911;2992
313760;201604;4227;13587;3499;12158;955;3586;914;2988;1869;6574
313770;201604;3250;10411;2855;9823;829;3099;1227;4203;2056;7302
313780;201604;3835;10538;3008;9322;451;1661;1227;3846;1678;5507
313790;201604;479;1664;452;1617;96;342;249;927;345;1269
313800;201604;1236;3323;1058;3059;99;329;720;2108;819;2437
313810;201604;1518;4349;1386;4166;73;194;1166;3632;1239;3826
313820;201604;12617;33446;10350;29982;1729;5738;4589;12803;6318;18541
313830;201604;417;1373;352;1244;88;355;129;457;217;812
313835;201604;874;2934;807;2830;143;587;438;1476;581;2063
313840;201604;7418;21273;5859;18656;1417;4978;1348;4209;2765;9187
313850;201604;1161;3137;1013;2877;187;635;512;1325;699;1960
313860;201604;2684;8097;2048;6735;449;1586;478;1489;927;3075
313862;201604;1216;3047;856;2465;106;296;448;1378;554;1674
313865;201604;2230;6871;2007;6536;183;710;1494;4811;1677;5521
313867;201604;1093;3741;947;3425;267;1043;263;992;530;2035
313868;201604;1610;5392;1382;4931;119;548;934;3249;1053;3797
313870;201604;771;2421;703;2308;199;743;192;549;391;1292
313880;201604;1382;4266;1190;3961;262;972;546;1689;808;2661
313890;201604;1855;5001;1531;4576;308;876;915;2921;1223;3797
313900;201604;3913;14023;3490;13085;1030;4329;928;3411;1958;7740
313910;201604;726;2431;612;2208;207;806;64;220;271;1026
313920;201604;3267;10845;2832;10033;471;1763;1557;5693;2028;7456
313925;201604;1848;5008;1394;4176;75;253;842;2525;917;2778
313930;201604;5812;20100;4856;18386;733;2758;2810;11324;3543;14082
313940;201604;8391;27586;6958;25326;1922;7859;2112;8132;4034;15991
313950;201604;4055;11491;3132;10014;969;3546;950;2741;1919;6287
313960;201604;5394;13791;3895;11666;1041;3405;1010;2848;2051;6253
313970;201604;1423;4086;1244;3882;137;477;759;2494;896;2971
313980;201604;1223;3763;946;3289;241;950;391;1368;632;2318
313990;201604;1749;6441;1500;5856;474;2031;284;975;758;3006
314000;201604;7873;24972;7112;23506;1207;4728;4067;12884;5274;17612
314010;201604;1138;3152;941;2901;87;309;602;1795;689;2104
314015;201604;1233;4202;1032;3826;262;1092;373;1320;635;2412
314020;201604;501;1515;361;1227;85;324;74;230;159;554
314030;201604;822;2662;664;2308;98;381;241;818;339;1199
314040;201604;678;1925;567;1727;239;774;118;334;357;1108
314050;201604;1681;5193;1343;4524;283;1114;473;1468;756;2582
314053;201604;1564;4889;1376;4641;205;686;875;3125;1080;3811
314055;201604;2158;6410;1880;6005;77;315;1486;4771;1563;5086
314060;201604;1145;3513;906;3104;59;272;585;1957;644;2229
314070;201604;4063;12547;3204;10876;788;2851;685;2210;1473;5061
314080;201604;1890;5855;1326;4568;211;836;273;821;484;1657
314085;201604;1956;6518;1723;6192;437;1717;652;2350;1089;4067
314090;201604;3258;11171;2872;10415;654;2694;976;3622;1630;6316
314100;201604;3261;8302;2870;7789;173;381;2441;6864;2614;7245
314110;201604;3921;12442;3467;11527;637;2461;1443;4389;2080;6850
314120;201604;1039;2485;517;1650;106;373;122;389;228;762
314130;201604;713;2048;374;1269;48;182;68;210;116;392
314140;201604;4847;15002;4032;13416;859;3117;1754;5794;2613;8911
314150;201604;1551;4224;1241;3693;180;586;631;1846;811;2432
314160;201604;2539;6504;1998;5794;187;596;1200;3687;1387;4283
314170;201604;1064;3175;880;2794;103;347;472;1458;575;1805
314180;201604;5195;16513;4600;15542;1257;4546;1838;6339;3095;10885
314190;201604;712;2029;548;1766;126;502;199;566;325;1068
314200;201604;2928;9062;2550;8387;258;1003;1744;5631;2002;6634
314210;201604;1957;5687;1744;5334;198;731;1077;3168;1275;3899
314220;201604;1576;4871;1214;4187;362;1367;213;632;575;1999
314225;201604;1331;3841;1219;3700;86;265;1008;3123;1094;3388
314230;201604;657;2121;606;2036;122;463;300;992;422;1455
314240;201604;1111;3359;934;3098;141;490;522;1827;663;2317
314250;201604;555;1640;427;1375;91;324;125;358;216;682
314260;201604;1015;3592;906;3353;217;887;269;958;486;1845
314270;201604;2850;9216;2375;8367;220;882;1563;5539;1783;6421
314280;201604;3083;8455;2111;6606;486;1775;641;1740;1127;3515
314290;201604;4735;13052;4069;11972;971;2971;2122;6167;3093;9138
314300;201604;1492;4942;1271;4438;348;1273;361;1232;709;2505
314310;201604;5332;15754;4564;14392;1185;4065;1633;4943;2818;9008
314315;201604;802;3128;731;2986;71;362;495;1995;566;2357
314320;201604;2953;8214;2113;7049;535;1953;993;3411;1528;5364
314330;201604;53526;160293;45867;148116;12659;43918;14429;46073;27088;89991
314340;201604;2899;7812;1688;5486;334;1207;127;268;461;1475
314345;201604;1201;4056;1082;3860;242;899;633;2266;875;3165
314350;201604;1285;3711;1003;3259;310;1090;189;590;499;1680
314360;201604;665;2129;450;1624;96;394;83;310;179;704
314370;201604;545;1830;506;1776;121;471;319;1106;440;1577
314380;201604;1278;3810;890;3049;238;897;112;375;350;1272
314390;201604;13585;39140;10246;33027;2394;8364;2350;7054;4744;15418
314400;201604;4401;12904;3733;11979;1308;4389;1150;3860;2458;8249
314410;201604;2608;8051;2082;7052;587;2213;596;2025;1183;4238
314420;201604;750;2124;585;1882;27;143;401;1225;428;1368
314430;201604;6308;18803;5494;17292;1544;5324;1553;4962;3097;10286
314435;201604;1307;4170;1147;3896;105;461;746;2495;851;2956
314437;201604;1072;2790;885;2505;31;91;698;1984;729;2075
314440;201604;636;1848;498;1656;163;619;93;256;256;875
314450;201604;1586;4623;1334;4272;295;1108;609;1817;904;2925
314460;201604;4056;13533;3284;11882;765;3088;568;1961;1333;5049
314465;201604;2229;7010;2085;6761;115;528;1619;5103;1734;5631
314467;201604;981;2804;825;2538;59;176;591;1849;650;2025
314470;201604;2233;6922;1877;6215;357;1441;690;2046;1047;3487
314480;201604;5813;19185;4185;14966;594;2295;462;1462;1056;3757
314490;201604;893;2641;695;2243;160;561;304;936;464;1497
314500;201604;1962;5553;1465;4679;333;1125;472;1439;805;2564
314505;201604;1754;5131;1605;4928;222;764;1071;3319;1293;4083
314510;201604;1863;5018;1264;4188;388;1430;289;952;677;2382
314520;201604;2907;10418;2225;8809;448;2004;237;828;685;2832
314530;201604;5891;20760;5574;20203;1049;3645;3291;12481;4340;16126
314535;201604;2731;7580;2302;6982;210;728;1725;5221;1935;5949
314537;201604;1126;3558;903;3157;118;503;532;1817;650;2320
314540;201604;415;1243;345;1100;65;240;107;315;172;555
314545;201604;1392;4214;1204;3946;113;421;888;2955;1001;3376
314550;201604;617;1672;459;1447;88;366;169;465;257;831
314560;201604;4333;14831;3679;13302;668;2721;1079;3705;1747;6426
314570;201604;296;870;228;743;59;205;96;300;155;505
314580;201604;515;1706;407;1488;97;415;50;175;147;590
314585;201604;828;2674;604;2194;133;561;146;501;279;1062
314587;201604;1938;5878;1660;5404;335;1052;806;2697;1141;3749
314590;201604;3138;10580;2346;8567;438;1818;272;890;710;2708
314600;201604;1727;5636;1287;4715;295;1186;162;515;457;1701
314610;201604;6839;23067;6145;21471;1327;5174;2547;8419;3874;13593
314620;201604;1570;4688;1417;4468;135;442;1056;3322;1191;3764
314625;201604;1434;4885;1321;4690;181;804;911;3092;1092;3896
314630;201604;4792;14223;4190;13293;278;1118;3059;9638;3337;10756
314640;201604;571;1553;447;1342;112;371;121;301;233;672
314650;201604;1057;2932;759;2450;102;397;264;774;366;1171
314655;201604;1561;4631;1170;3878;297;952;421;1434;718;2386
314660;201604;289;783;208;617;23;71;100;287;123;358
314670;201604;1622;4309;1168;3518;179;602;645;1904;824;2506
314675;201604;1768;5338;1524;4897;160;578;1047;3343;1207;3921
314690;201604;2318;7379;1904;6665;522;2076;411;1373;933;3449
314700;201604;8787;29701;6448;24468;1796;7678;818;3026;2614;10704
314710;201604;8983;26974;6297;21218;1157;4401;809;2451;1966;6852
314720;201604;2379;7773;1966;6896;481;1893;571;2020;1052;3913
314730;201604;2173;6520;1794;5954;473;1750;675;2153;1148;3903
314740;201604;2849;9061;2458;8311;409;1583;1137;3688;1546;5271
314750;201604;347;1082;278;922;46;182;116;359;162;541
314760;201604;1722;5693;1299;4674;200;844;258;798;458;1642
314770;201604;1099;3405;642;2157;72;283;95;245;167;528
314780;201604;268;721;202;630;48;186;92;269;140;455
314790;201604;11011;32648;8441;28187;3332;12499;625;1652;3957;14151
314795;201604;1649;4733;1398;4345;98;395;1010;3028;1108;3423
314800;201604;10904;31499;7724;25240;2067;7352;846;2611;2913;9963
314810;201604;11550;33385;8903;28781;2482;8816;1685;5445;4167;14261
314820;201604;917;2542;642;2085;158;564;217;694;375;1258
314830;201604;1624;5349;1431;5032;412;1601;581;2059;993;3660
314840;201604;921;3294;763;3065;125;644;459;1773;584;2417
314850;201604;1883;5397;1510;4737;187;726;980;2967;1167;3693
314860;201604;3212;10646;2848;9982;628;2457;1390;4768;2018;7225
314870;201604;5490;17154;4699;16105;456;1953;3396;11577;3852;13530
314875;201604;1744;5667;1668;5564;237;762;1310;4454;1547;5216
314880;201604;871;2339;719;2145;37;99;534;1689;571;1788
314890;201604;604;1798;416;1391;75;307;143;421;218;728
314900;201604;518;1548;427;1415;90;320;213;686;303;1006
314910;201604;1671;5408;1347;4868;400;1641;409;1376;809;3017
314915;201604;2480;7841;2164;7314;168;694;1563;5167;1731;5861
314920;201604;553;1521;394;1284;37;142;211;634;248;776
314930;201604;4497;15036;3928;13835;1029;3880;933;3140;1962;7020
314940;201604;395;1157;363;1106;61;204;208;600;269;804
314950;201604;336;973;250;847;42;158;68;217;110;375
314960;201604;730;2249;570;1927;136;512;159;483;295;995
314970;201604;543;1856;454;1682;107;443;112;419;219;862
314980;201604;1461;4505;1214;4092;334;1267;85;262;419;1529
314990;201604;2544;7983;1947;6701;513;2033;353;1029;866;3062
314995;201604;1590;4828;1385;4519;142;564;897;2862;1039;3426
315000;201604;1052;3003;862;2699;90;320;542;1691;632;2011
315010;201604;439;1331;344;1146;82;342;111;316;193;658
315015;201604;2076;6329;1870;6089;245;827;1350;4623;1595;5450
315020;201604;808;2504;614;2090;96;374;250;796;346;1170
315030;201604;684;2033;551;1809;146;518;113;350;259;868
315040;201604;883;2699;831;2606;141;461;516;1603;657;2064
315050;201604;1351;3894;1096;3503;212;772;485;1541;697;2313
315053;201604;1041;3096;937;2919;143;560;444;1397;587;1957
315057;201604;1677;5727;1474;5400;245;921;845;3163;1090;4084
315060;201604;831;2696;603;2189;119;472;87;305;206;777
315070;201604;742;2222;626;2032;175;615;284;874;459;1489
315080;201604;2836;9350;2447;8500;617;2306;1005;3446;1622;5752
315090;201604;780;2759;673;2510;157;670;164;582;321;1252
315100;201604;1168;3883;849;3146;188;803;198;663;386;1466
315110;201604;1402;4233;1194;3844;277;963;414;1307;691;2270
315120;201604;14224;33205;9787;27532;1434;4222;4893;14731;6327;18953
315130;201604;1373;4528;1249;4301;329;1279;390;1300;719;2579
315140;201604;2709;8523;2213;7528;480;1891;735;2273;1215;4164
315150;201604;4588;12394;3484;10577;649;2212;1289;3868;1938;6080
315160;201604;1218;3528;993;3094;214;713;390;1182;604;1895
315170;201604;1502;4521;1184;3944;265;964;317;1112;582;2076
315180;201604;16702;46810;9774;32275;1672;6237;1572;4785;3244;11022
315190;201604;2012;5222;1683;4720;424;1230;899;2521;1323;3751
315200;201604;3811;12745;3156;11344;965;3761;643;2297;1608;6058
315210;201604;7702;22643;6201;19580;1190;4224;2188;6581;3378;10805
315213;201604;1076;3405;1005;3306;52;198;817;2687;869;2885
315217;201604;2397;8230;2004;7514;224;1036;1169;4313;1393;5349
315220;201604;9763;28038;8225;25594;2347;7286;3277;10822;5624;18108
315230;201604;2928;7762;2645;7433;171;246;2259;6836;2430;7082
315240;201604;3028;9243;2568;8516;698;2533;1177;3771;1875;6304
315250;201604;9956;30264;7690;25961;1834;6861;2160;7246;3994;14107
315260;201604;991;3073;689;2425;137;530;98;300;235;830
315270;201604;712;2289;556;1987;107;437;120;380;227;817
315280;201604;3026;8617;1938;6296;413;1433;293;884;706;2317
315290;201604;1340;3725;970;3130;292;1025;169;543;461;1568
315300;201604;521;1352;347;1136;145;498;125;421;270;919
315310;201604;1240;3936;1031;3560;135;562;642;2113;777;2675
315320;201604;775;2325;618;2127;107;431;280;969;387;1400
315330;201604;721;2598;468;1927;114;516;52;213;166;729
315340;201604;3529;10103;2875;9133;600;2078;1124;3471;1724;5549
315350;201604;1849;5061;1385;4384;245;839;782;2528;1027;3367
315360;201604;1663;5502;1378;4857;254;990;438;1455;692;2445
315370;201604;494;1504;427;1399;80;267;214;726;294;993
315380;201604;201;688;159;588;36;161;37;112;73;273
315390;201604;1302;4311;975;3543;217;894;164;547;381;1441
315400;201604;4193;12625;3437;11189;698;2493;1504;4813;2202;7306
315410;201604;2064;5403;1735;4950;173;601;1205;3456;1378;4057
315415;201604;995;3238;891;3077;337;1216;340;1215;677;2431
315420;201604;1222;3884;962;3372;217;804;135;442;352;1246
315430;201604;3610;9764;2729;8345;719;2454;585;1700;1304;4154
315440;201604;894;2756;773;2557;155;587;335;1045;490;1632
315445;201604;2076;5803;1635;5125;186;653;1125;3506;1311;4159
315450;201604;2384;7485;2123;7082;409;1287;1262;4366;1671;5653
315460;201604;32349;105087;28742;97770;9520;34556;4859;15837;14379;50393
315470;201604;466;1403;382;1247;48;192;194;615;242;807
315480;201604;1708;5175;1137;3878;190;707;175;615;365;1322
315490;201604;3052;8160;2341;7225;347;1216;887;2610;1234;3826
315500;201604;495;1454;332;1082;44;163;131;375;175;538
315510;201604;1379;3928;1162;3589;109;358;813;2461;922;2819
315520;201604;1005;3026;827;2737;110;400;516;1653;626;2053
315530;201604;591;1991;486;1738;172;651;128;425;300;1076
315540;201604;1091;3402;901;3044;172;687;311;1048;483;1735
315550;201604;1710;4778;1333;4237;327;1150;405;1249;732;2399
315560;201604;6455;21465;5825;20570;559;2215;3925;14046;4484;16261
315570;201604;1915;6054;1777;5838;285;1090;965;3080;1250;4170
315580;201604;2477;7221;1943;6268;485;1793;508;1534;993;3327
315590;201604;863;2520;768;2379;124;420;409;1245;533;1665
315600;201604;2451;8659;1967;7731;346;1411;1006;4136;1352;5547
315610;201604;989;2811;800;2432;150;578;301;766;451;1344
315620;201604;317;1112;300;1083;88;300;166;636;254;936
315630;201604;861;2743;717;2447;165;583;155;495;320;1078
315640;201604;480;1378;392;1240;78;300;166;482;244;782
315645;201604;855;2584;697;2248;248;861;157;483;405;1344
315650;201604;1813;5000;1439;4464;85;364;1056;3256;1141;3620
315660;201604;2542;6626;2096;5933;311;865;1332;3771;1643;4636
315670;201604;10366;34068;9238;31922;2555;9525;3211;10884;5766;20409
315680;201604;3004;9967;2348;8643;741;2885;513;1881;1254;4766
315690;201604;3340;9435;2317;7630;554;2010;403;1420;957;3430
315700;201604;7166;22292;6053;20098;1049;3860;2738;8727;3787;12587
315710;201604;1783;5135;1411;4546;110;463;908;2826;1018;3289
315720;201604;3597;11299;3191;10558;388;1539;1807;5720;2195;7259
315725;201604;1452;4588;1303;4361;254;892;832;2832;1086;3724
315727;201604;588;1813;486;1606;98;370;178;554;276;924
315730;201604;789;2448;725;2320;101;366;404;1261;505;1627
315733;201604;981;2938;868;2741;258;890;262;766;520;1656
315737;201604;1246;3799;969;3303;69;304;610;2117;679;2421
315740;201604;991;3025;829;2704;147;583;427;1291;574;1874
315750;201604;1102;3421;1004;3245;56;225;735;2364;791;2589
315760;201604;1028;2729;989;2680;15;54;918;2467;933;2521
315765;201604;1447;4496;1291;4293;61;238;1051;3555;1112;3793
315770;201604;1393;4479;1204;4147;312;1180;292;1000;604;2180
315780;201604;21602;70175;19503;65699;4672;16928;5947;19781;10619;36709
315790;201604;3573;11791;3121;10891;292;977;2086;7498;2378;8475
315800;201604;1441;5574;1147;4723;262;1175;163;639;425;1814
315810;201604;1348;3626;1135;3300;181;517;688;1972;869;2489
315820;201604;2432;8166;2123;7629;672;2501;820;3051;1492;5552
315830;201604;1183;3910;994;3524;125;544;298;938;423;1482
315840;201604;845;2210;594;1774;98;334;157;429;255;763
315850;201604;997;3520;971;3473;232;917;517;1769;749;2686
315860;201604;511;1749;384;1478;88;401;68;231;156;632
315870;201604;452;1332;369;1201;82;294;161;499;243;793
315880;201604;1200;3087;953;2778;213;770;317;847;530;1617
315890;201604;1459;4962;1295;4689;476;1847;494;1759;970;3606
315895;201604;5159;16051;4458;14514;980;3491;1507;4636;2487;8127
315900;201604;728;2177;696;2122;65;268;547;1573;612;1841
315910;201604;502;1688;467;1629;145;568;262;873;407;1441
315920;201604;1569;4291;915;2925;179;638;153;399;332;1037
315930;201604;1063;2869;795;2403;196;650;197;579;393;1229
315935;201604;932;3081;834;2875;225;859;205;668;430;1527
315940;201604;619;1954;537;1786;114;437;248;794;362;1231
315950;201604;1180;3613;1058;3386;236;717;609;2018;845;2735
315960;201604;3454;10840;2375;8674;812;3437;102;222;914;3659
315970;201604;737;2002;566;1773;40;106;401;1324;441;1430
315980;201604;3973;9666;2463;7158;615;2018;560;1386;1175;3404
315990;201604;3965;11411;3271;10260;549;2063;1603;4870;2152;6933
316000;201604;557;1661;470;1542;138;556;180;557;318;1113
316010;201604;615;2033;496;1803;71;305;213;706;284;1011
316020;201604;1030;3251;898;3044;112;446;594;1952;706;2398
316030;201604;3120;9137;2312;7683;192;756;1388;4696;1580;5452
316040;201604;3433;10814;2610;9101;409;1652;465;1364;874;3016
316045;201604;2038;6332;1870;6051;249;780;1287;4313;1536;5093
316050;201604;350;1097;279;985;54;215;122;400;176;615
316060;201604;725;2178;580;1971;79;345;332;1052;411;1397
316070;201604;6040;18849;5207;17042;1151;4202;2035;6348;3186;10550
316080;201604;726;2658;643;2458;144;626;73;292;217;918
316090;201604;575;1710;384;1305;70;265;93;304;163;569
316095;201604;1429;4520;1232;4175;181;618;766;2610;947;3228
316100;201604;2751;9040;2098;7455;491;1943;397;1289;888;3232
316105;201604;933;2659;705;2279;178;598;259;867;437;1465
316110;201604;12157;41116;10797;38821;1274;4925;7048;26095;8322;31020
316120;201604;1124;3604;903;3083;215;780;217;635;432;1415
316130;201604;1482;3340;922;2569;129;419;392;1040;521;1459
316140;201604;930;2720;737;2423;100;331;416;1404;516;1735
316150;201604;1499;4069;1305;3736;187;632;773;2187;960;2819
316160;201604;1239;3623;956;3094;175;626;393;1252;568;1878
316165;201604;920;2440;768;2224;140;470;410;1180;550;1650
316170;201604;1330;3824;998;3267;159;598;414;1235;573;1833
316180;201604;1370;4262;971;3374;191;754;173;515;364;1269
316190;201604;2784;8626;1495;5279;260;889;206;640;466;1529
316200;201604;3815;12057;2953;10360;624;2515;722;2444;1346;4959
316210;201604;4577;14657;3885;13320;1404;5101;523;1810;1927;6911
316220;201604;790;2444;567;2011;111;447;67;254;178;701
316225;201604;1194;3281;993;2967;135;439;603;1747;738;2186
316230;201604;410;1167;336;1041;52;182;157;522;209;704
316240;201604;6578;20033;5736;18911;623;2046;4170;13929;4793;15975
316245;201604;3205;10996;2957;10593;203;1018;2319;8084;2522;9102
316250;201604;10550;30342;8225;25847;2063;7058;1972;5917;4035;12975
316255;201604;2538;7618;2220;7233;370;1325;1473;4818;1843;6143
316257;201604;1340;3687;1005;3088;165;578;357;1026;522;1604
316260;201604;1771;4995;1402;4443;83;300;788;2655;871;2955
316265;201604;1319;3719;976;3053;105;388;564;1725;669;2113
316270;201604;3942;13114;3623;12475;917;3419;1407;4723;2324;8142
316280;201604;3174;10279;2883;9737;438;1673;1608;5334;2046;7007
316290;201604;3340;10391;2834;9425;523;2051;1133;3631;1656;5682
316292;201604;3333;10544;2957;9940;556;2089;1656;5340;2212;7429
316294;201604;830;2650;617;2202;114;490;48;166;162;656
316295;201604;1760;5813;1643;5588;205;866;1063;3482;1268;4348
316300;201604;1003;3100;851;2847;67;245;548;1865;615;2110
316310;201604;701;2012;474;1605;86;344;130;410;216;754
316320;201604;604;1908;483;1684;86;363;82;249;168;612
316330;201604;928;2860;731;2410;78;291;465;1497;543;1788
316340;201604;927;2986;754;2627;166;693;326;1055;492;1748
316350;201604;1298;4118;1160;3893;187;655;650;2229;837;2884
316360;201604;731;1940;579;1718;66;208;410;1228;476;1436
316370;201604;4436;14271;3831;13075;1056;3954;539;1811;1595;5765
316380;201604;1599;4204;1264;3741;78;264;891;2663;969;2927
316390;201604;884;2555;740;2334;179;614;299;970;478;1584
316400;201604;1283;3939;987;3420;216;810;375;1265;591;2075
316410;201604;1046;3450;964;3330;189;698;595;2061;784;2759
316420;201604;1907;6113;1692;5829;134;578;1205;4032;1339;4610
316430;201604;930;2847;676;2323;160;601;137;426;297;1027
316440;201604;664;2166;547;1990;194;806;102;386;296;1192
316443;201604;680;2005;561;1796;120;444;215;646;335;1090
316447;201604;1558;4662;1419;4479;94;319;1202;3814;1296;4133
316450;201604;2084;7020;1776;6430;212;869;1184;4300;1396;5169
316460;201604;708;2198;640;2077;168;577;319;1017;487;1594
316470;201604;7171;22960;5730;19963;1442;5789;1458;4904;2900;10693
316480;201604;180;604;159;560;30;111;45;149;75;260
316490;201604;299;931;247;807;54;179;95;288;149;467
316500;201604;1139;4019;783;2965;139;559;34;123;173;682
316510;201604;752;2772;671;2602;229;941;160;611;389;1552
316520;201604;1065;3202;858;2880;150;553;281;845;431;1398
316530;201604;1021;3312;866;3017;182;781;289;842;471;1623
316540;201604;862;2728;765;2570;104;435;237;742;341;1177
316550;201604;1159;3874;1084;3751;215;846;640;2219;855;3065
316553;201604;1854;6487;1460;5518;393;1675;299;1086;692;2761
316555;201604;2744;9565;2446;9197;162;705;1873;7136;2035;7841
316556;201604;614;1586;480;1379;47;163;317;864;364;1027
316557;201604;772;2764;730;2696;275;1083;179;591;454;1674
316560;201604;309;1091;263;991;64;291;52;179;116;470
316570;201604;1239;3929;1089;3648;126;449;546;1854;672;2303
316580;201604;293;811;198;624;44;164;46;131;90;295
316590;201604;1454;3934;1037;3235;239;788;450;1313;689;2101
316600;201604;1042;3376;925;3146;255;941;334;1111;589;2052
316610;201604;573;2078;503;1936;94;434;309;1152;403;1586
316620;201604;2129;6448;1818;5927;263;1028;1074;3436;1337;4464
316630;201604;1396;4662;1203;4248;476;1769;290;1050;766;2819
316640;201604;176;555;157;518;32;136;67;185;99;321
316650;201604;884;3225;785;3065;112;439;492;2010;604;2449
316660;201604;197;515;95;295;6;26;19;43;25;69
316670;201604;1857;5294;1515;4710;599;1989;274;807;873;2796
316680;201604;1902;5167;1536;4662;183;597;1069;3257;1252;3854
316690;201604;1142;3861;1018;3582;287;1144;302;1037;589;2181
316695;201604;1075;3374;928;3091;119;428;547;1815;666;2243
316700;201604;354;1071;319;1015;41;175;198;569;239;744
316710;201604;2878;10712;2471;9829;877;3644;598;2558;1475;6202
316720;201604;15778;50307;12977;44364;3433;12464;2704;8992;6137;21456
316730;201604;357;1097;308;1001;76;279;128;380;204;659
316740;201604;660;2230;600;2129;97;401;353;1258;450;1659
316750;201604;392;1308;330;1172;50;213;115;367;165;580
316760;201604;3403;11271;2944;10653;1542;5790;781;2912;2323;8702
316770;201604;1257;3564;1137;3410;90;343;909;2705;999;3048
316780;201604;570;1875;505;1750;140;564;81;242;221;806
316790;201604;847;2426;633;2066;152;526;184;616;336;1142
316800;201604;5118;16789;4541;15670;830;3245;2279;7414;3109;10659
316805;201604;780;2016;752;1978;53;145;645;1755;698;1900
316810;201604;606;1847;506;1652;140;510;194;582;334;1092
316820;201604;388;1010;221;726;35;138;29;89;64;227
316830;201604;561;1930;534;1881;163;629;214;738;377;1367
316840;201604;2784;8515;2451;7899;528;1978;1060;3235;1588;5213
316850;201604;2009;5883;1668;5320;245;882;918;2908;1163;3790
316860;201604;17303;54470;14813;49903;3337;12931;5803;18687;9140;31618
316870;201604;5872;18859;4766;16311;1327;4987;686;2239;2013;7226
316880;201604;847;2573;732;2379;213;820;226;700;439;1520
316890;201604;1243;3048;992;2729;280;909;531;1359;811;2268
316900;201604;2512;7495;1996;6447;435;1577;588;1696;1023;3273
316905;201604;452;1505;391;1366;134;499;123;428;257;927
316910;201604;798;2506;583;2082;155;588;101;372;256;960
316920;201604;1579;4280;1137;3684;317;1170;377;1179;694;2349
316930;201604;8260;27867;6559;24189;1385;5591;775;2625;2160;8216
316935;201604;4916;14348;3327;11193;843;3138;603;1975;1446;5113
316940;201604;6866;22241;5632;19657;1228;4500;1107;3734;2335;8234
316950;201604;1513;4205;1275;3870;114;415;907;2703;1021;3118
316960;201604;4736;11942;3730;10560;685;2105;2033;5681;2718;7786
316970;201604;3196;10120;3014;9816;646;2446;1189;3563;1835;6009
316980;201604;933;2853;675;2351;205;796;99;337;304;1133
316990;201604;9725;30749;8198;27353;2420;8785;637;1994;3057;10779
317000;201604;2762;9362;2651;9239;335;1072;1938;7598;2273;8670
317005;201604;2526;7799;2236;7344;446;1481;1234;4108;1680;5589
317010;201604;30076;74555;18620;56769;4330;14883;3378;10954;7708;25837
317020;201604;60237;164306;36334;116263;7006;24700;6833;20209;13839;44909
317030;201604;707;2079;591;1900;58;242;354;1115;412;1357
317040;201604;10189;29392;8169;25906;2037;6938;2912;9236;4949;16174
317043;201604;701;1922;601;1794;84;245;376;1134;460;1379
317047;201604;1120;2972;824;2491;99;329;412;1254;511;1583
317050;201604;1478;5026;1155;4267;226;893;402;1382;628;2275
317052;201604;2285;7388;2097;7096;163;646;1535;5141;1698;5787
317057;201604;1657;4631;1260;3933;113;453;742;2233;855;2686
317060;201604;405;1178;267;872;57;205;72;212;129;417
317065;201604;1243;4004;1126;3817;108;485;826;2739;934;3224
317070;201604;9597;29599;6642;23008;1336;5203;814;2739;2150;7942
317075;201604;1072;3241;855;2785;202;702;177;549;379;1251
317080;201604;6095;16658;5156;15087;1508;4571;1487;4306;2995;8877
317090;201604;4769;15850;4434;15322;531;1852;3082;10850;3613;12702
317100;201604;2913;7974;2183;6753;669;2231;683;2038;1352;4269
317103;201604;1975;6709;1681;6163;244;1149;836;2955;1080;4104
317107;201604;1308;4001;1135;3656;163;638;710;2150;873;2788
317110;201604;645;1615;372;1150;65;245;126;406;191;651
317115;201604;1125;3515;964;3187;102;338;672;2256;774;2594
317120;201604;10427;34488;8503;29988;1905;7414;2981;10289;4886;17703
317130;201604;7285;21674;6109;19553;1257;4513;2468;7824;3725;12337
317140;201604;556;1774;513;1710;68;238;334;1136;402;1374
317150;201604;959;2657;830;2507;88;318;608;1786;696;2104
317160;201604;3475;9112;2621;7973;199;634;1816;5519;2015;6153
317170;201604;1890;5108;1477;4420;114;425;713;1972;827;2397
317180;201604;1768;5966;1440;5260;364;1405;346;1265;710;2670
317190;201604;1352;3870;1076;3476;117;414;716;2299;833;2713
317200;201604;4429;13790;3806;12537;978;3589;1140;3614;2118;7203
317210;201604;1026;3062;851;2825;140;585;482;1554;622;2139
317220;201604;278;966;265;947;81;320;107;357;188;677
320010;201604;4880;15274;4238;13964;745;2623;2167;7054;2912;9677
320013;201604;1827;5595;1365;4641;221;772;551;1959;772;2731
320016;201604;3058;8663;2633;8031;323;947;1832;5644;2155;6591
320020;201604;3801;11826;3236;10665;910;3240;988;3269;1898;6509
320030;201604;1705;5386;1346;4648;396;1451;394;1317;790;2768
320035;201604;1772;5254;1543;4906;515;1787;511;1534;1026;3321
320040;201604;3238;10387;2672;9263;559;2122;791;2692;1350;4814
320050;201604;1719;4649;1478;4214;328;1000;636;1723;964;2723
320060;201604;11541;36333;8854;30266;1997;7409;2140;6943;4137;14352
320070;201604;1401;4508;1137;3923;254;961;276;860;530;1821
320080;201604;5663;16426;4379;13884;1022;3296;1233;4157;2255;7453
320090;201604;7981;23230;6331;19923;1704;5697;2106;6379;3810;12076
320100;201604;2759;8541;2209;7415;625;2181;693;2328;1318;4509
320110;201604;1251;3731;1092;3419;263;823;313;989;576;1812
320115;201604;1732;6166;1565;5861;851;3311;328;1305;1179;4616
320120;201604;16031;48240;12440;41387;3017;10995;3286;10975;6303;21970
320130;201604;35501;113531;31949;106494;6519;24229;14402;46445;20921;70674
320140;201604;3627;11453;2610;9150;639;2472;294;1040;933;3512
320150;201604;15782;43721;11542;35698;2730;9103;1481;4395;4211;13498
320160;201604;4846;15297;4197;13970;1041;3895;1335;4075;2376;7970
320170;201604;1704;5425;1384;4728;356;1289;495;1676;851;2965
320180;201604;745;2492;661;2341;257;947;150;559;407;1506
320190;201604;3618;12394;2876;10589;791;3046;461;1694;1252;4740
320200;201604;1014;3108;848;2829;220;801;263;919;483;1720
320210;201604;4690;13218;3995;11898;841;2825;1778;4900;2619;7725
320220;201604;2410;7456;1975;6599;509;1840;713;2416;1222;4256
320225;201604;1339;4522;1070;3885;365;1428;136;495;501;1923
320230;201604;4120;13285;3555;12324;1139;4216;1206;4276;2345;8492
320240;201604;12173;35672;9684;31184;2439;8577;2381;7631;4820;16208
320245;201604;3395;11556;3132;10924;1034;3831;732;2473;1766;6304
320250;201604;1816;5538;1287;4320;338;1310;201;575;539;1885
320255;201604;1742;5835;1522;5451;619;2384;483;1849;1102;4233
320260;201604;1058;3256;824;2731;201;710;218;646;419;1356
320265;201604;2339;7373;2036;6936;509;1799;1061;3734;1570;5533
320270;201604;2668;7884;1976;6554;437;1566;773;2597;1210;4163
320280;201604;6657;20240;5798;18511;1351;4754;1859;5481;3210;10235
320290;201604;1395;4555;1028;3666;312;1179;134;495;446;1674
320300;201604;4184;13924;3708;12873;1204;4456;773;2663;1977;7119
320305;201604;4389;14156;3790;12808;913;3377;1506;4872;2419;8249
320310;201604;1924;5738;1634;5169;411;1364;572;1767;983;3131
320313;201604;2203;6351;1526;4807;319;1196;261;717;580;1913
320316;201604;1722;5173;1400;4511;438;1492;390;1221;828;2713
320320;201604;20060;60395;15774;52539;4125;15139;4831;15695;8956;30834
320330;201604;2994;8822;2521;8034;668;2096;1072;3650;1740;5746
320332;201604;5035;16536;4398;15331;1553;5755;1249;4359;2802;10114
320334;201604;1876;5934;1318;4731;346;1410;222;758;568;2168
320335;201604;2349;6915;1499;4942;372;1346;165;462;537;1808
320340;201604;5876;15812;4879;14174;1049;3313;2047;6048;3096;9361
320350;201604;5079;13542;3829;11276;773;2432;1558;4539;2331;6971
320360;201604;1704;4493;1250;3620;210;652;454;1239;664;1891
320370;201604;2984;9687;2412;8403;675;2420;699;2422;1374;4842
320380;201604;2192;6460;1929;5995;368;1260;1051;3172;1419;4432
320390;201604;7283;21903;5934;19082;1691;5886;1493;4565;3184;10451
320400;201604;3500;10762;3122;10095;887;3182;1079;3282;1966;6464
320405;201604;4035;11880;3536;11078;819;2740;1760;5403;2579;8143
320410;201604;5494;14510;4040;12575;984;3298;1708;5353;2692;8651
320420;201604;2121;6427;1664;5600;489;1847;368;1233;857;3080
320425;201604;1902;5115;1592;4597;191;592;966;2733;1157;3325
320430;201604;2396;6679;2068;6030;407;1269;1070;3002;1477;4271
320435;201604;2815;9160;2321;8155;1091;3983;565;2114;1656;6097
320440;201604;1036;3430;912;3114;191;736;294;947;485;1683
320450;201604;1977;6181;1613;5464;434;1629;630;2043;1064;3672
320455;201604;4085;13390;3031;10853;849;3270;613;2107;1462;5377
320460;201604;2633;8445;2029;7093;501;1880;500;1683;1001;3563
320465;201604;1597;4970;1215;4128;217;800;527;1783;744;2583
320470;201604;4343;13033;2981;9960;802;2982;433;1331;1235;4313
320480;201604;1767;5498;1556;5098;415;1482;514;1631;929;3113
320490;201604;15775;48139;13217;43505;3825;13807;3622;11899;7447;25706
320495;201604;1286;3731;855;2841;264;934;93;327;357;1261
320500;201604;46585;140068;40492;129128;9480;32723;18112;56444;27592;89167
320501;201604;4300;13414;3645;12427;1212;4641;1141;3713;2353;8354
320503;201604;1851;6274;1508;5550;595;2382;359;1184;954;3566
320506;201604;3946;12188;2820;9517;817;2993;182;527;999;3520
320510;201604;8085;25210;6976;23087;1626;5800;3072;10068;4698;15868
320515;201604;1867;5375;1531;4637;391;1234;251;707;642;1941
320517;201604;2142;6907;1753;6145;578;2227;330;1100;908;3327
320520;201604;37537;111808;30653;99231;7755;27611;10079;32175;17834;59786
320530;201604;26664;80659;22181;72056;4407;16521;10146;30901;14553;47422
330010;201604;20018;60795;18021;56974;3782;12942;9347;29077;13129;42019
330015;201604;1643;4564;1414;4132;229;777;612;1732;841;2509
330020;201604;17212;50308;15707;47880;2991;10014;8958;26663;11949;36677
330022;201604;1843;5508;1549;5019;293;1081;776;2438;1069;3519
330023;201604;3152;9716;2763;9088;757;2688;827;2615;1584;5303
330025;201604;4476;12046;3534;10484;779;2531;1784;5236;2563;7767
330030;201604;7924;26139;6981;24283;1428;5477;3277;10918;4705;16395
330040;201604;12011;35391;10610;32844;2331;7702;5134;15417;7465;23119
330045;201604;69711;191392;60869;178984;7831;24818;40470;117129;48301;141947
330050;201604;2404;7518;2132;6974;612;2213;635;1923;1247;4136
330060;201604;5688;16390;4940;15315;1179;4130;2436;7428;3615;11558
330070;201604;21608;65203;19279;61261;4198;14321;8529;27017;12727;41338
330080;201604;7874;22461;7298;21583;830;2470;4972;14783;5802;17253
330090;201604;2643;7132;2386;6732;430;1330;1287;3528;1717;4858
330093;201604;2025;5999;1688;5404;387;1281;600;2001;987;3282
330095;201604;982;3305;849;3005;224;926;230;748;454;1674
330100;201604;56107;177350;51172;169310;8742;32629;27348;90092;36090;122721
330110;201604;2346;7343;2081;6883;514;1801;581;1906;1095;3707
330115;201604;1902;5439;1670;5091;302;1040;858;2507;1160;3547
330120;201604;2568;7125;2260;6659;469;1556;1193;3381;1662;4937
330130;201604;3522;11305;3121;10600;806;2947;1339;4486;2145;7433
330140;201604;3028;9364;2758;8964;606;2181;1434;4633;2040;6814
330150;201604;2319;6827;1831;5846;419;1454;404;1307;823;2761
330160;201604;1157;3694;1014;3451;277;1096;456;1444;733;2540
330170;201604;99344;297316;90614;283693;16885;56059;50959;158495;67844;214554
330180;201604;2014;5874;1675;5254;142;558;1013;2975;1155;3533
330185;201604;7952;24660;6893;22631;1503;5360;3434;11001;4937;16361
330187;201604;3783;10810;3254;9929;449;1553;2136;6411;2585;7964
330190;201604;25147;71518;23405;68780;4370;13477;14935;43616;19305;57093
330200;201604;13918;43693;12386;41083;3173;10903;5822;19569;8995;30472
330205;201604;2159;5897;1875;5419;325;1034;1029;2882;1354;3916
330210;201604;3431;9516;2825;8336;819;2534;694;1990;1513;4524
330220;201604;10175;30946;8847;28134;2292;7910;2219;6475;4511;14385
330225;201604;3789;11741;3398;11032;417;1613;2066;6595;2483;8208
330227;201604;17002;48775;15316;46326;3816;11824;7887;24261;11703;36085
330230;201604;1341;4006;1218;3809;282;1014;533;1568;815;2582
330240;201604;16972;52015;14544;47466;4641;16433;3294;10266;7935;26699
330245;201604;1277;3935;1002;3433;253;955;174;564;427;1519
330250;201604;35769;104344;32619;99227;9841;30218;12407;39161;22248;69379
330260;201604;3692;11596;3239;10699;631;2320;1315;4106;1946;6426
330270;201604;18631;43536;12596;35312;2992;9319;4161;11715;7153;21034
330280;201604;2182;6471;1817;5757;316;1105;829;2449;1145;3554
330285;201604;17995;51517;16258;48985;2763;8994;9877;29492;12640;38486
330290;201604;3376;9553;2992;8980;487;1656;1731;4974;2218;6630
330300;201604;3255;10547;2968;10016;436;1702;1732;5661;2168;7363
330310;201604;2299;6535;1978;5998;302;982;1110;3313;1412;4295
330320;201604;13061;39151;12233;37884;1787;6030;8727;26790;10514;32820
330330;201604;27245;75128;23833;69789;3904;12872;14289;40425;18193;53297
330340;201604;14382;41813;11370;36325;2778;9493;3306;10416;6084;19909
330350;201604;85032;252247;78080;242181;11609;37897;53052;164818;64661;202715
330360;201604;5760;17149;5541;16848;338;1168;4753;14377;5091;15545
330370;201604;3384;11977;3079;11317;1052;4005;977;3636;2029;7641
330380;201604;4881;15767;4140;14284;916;3513;1514;5025;2430;8538
330385;201604;3934;13525;3606;12881;1101;4233;1262;4518;2363;8751
330390;201604;22792;74281;20114;68941;4814;18064;8282;27743;13096;45807
330395;201604;2981;8744;2694;8271;257;936;1781;5337;2038;6273
330400;201604;2486;7843;2243;7432;302;1222;1328;4044;1630;5266
330410;201604;2795;8605;2327;7713;503;1835;998;3201;1501;5036
330411;201604;2329;7257;2021;6612;232;893;1157;3627;1389;4520
330412;201604;1323;4466;1106;4035;235;996;463;1567;698;2563
330414;201604;23992;67855;21179;63920;4312;12976;12122;37001;16434;49977
330415;201604;3501;10688;3056;9919;778;2612;1091;3571;1869;6183
330420;201604;9592;27645;6601;22124;1434;5227;1084;3504;2518;8731
330430;201604;7254;21507;6443;20005;1343;4516;2946;8906;4289;13422
330440;201604;1632;5456;1423;5019;431;1686;285;897;716;2583
330450;201604;1341;4440;1198;4187;271;1139;576;1931;847;3070
330452;201604;13547;39558;10750;34185;2728;9437;3715;11403;6443;20840
330455;201604;482887;1328506;398730;1196152;90135;287904;189929;563714;280064;851618
330460;201604;1175;3811;1045;3584;221;873;454;1504;675;2377
330470;201604;4363;13190;3885;12318;900;3116;1678;5170;2578;8286
330475;201604;7785;24114;6861;22565;2034;7286;2430;7806;4464;15092
330480;201604;5753;16917;5282;16245;963;3242;3089;9330;4052;12572
330490;201604;105433;279641;95305;264845;9608;27793;69707;193987;79315;221780
330500;201604;5513;16909;5248;16427;683;2330;3521;10889;4204;13219
330510;201604;36690;112077;33000;106342;10331;33699;13837;45754;24168;79453
330513;201604;1482;4425;1347;4183;397;1237;530;1690;927;2927
330515;201604;3004;9261;2643;8573;805;2643;746;2408;1551;5051
330520;201604;11332;33926;10109;31793;2085;6887;4584;14278;6669;21165
330530;201604;1491;4439;1326;4134;332;1127;512;1546;844;2673
330540;201604;2879;8535;2410;7706;558;1910;935;2910;1493;4820
330550;201604;7724;25805;6825;24106;2926;10774;977;3477;3903;14251
330555;201604;10109;29602;8955;27964;1708;5415;5232;16829;6940;22244
330560;201604;4238;12701;3838;11949;717;2503;1979;5892;2696;8395
330570;201604;3376;9854;2891;9038;747;2488;1344;4186;2091;6674
330575;201604;5103;14705;4568;13745;693;2363;2873;8291;3566;10654
330580;201604;13792;43346;11740;39186;3048;10689;4392;14710;7440;25399
330590;201604;1596;4884;1478;4694;287;988;898;2816;1185;3804
330600;201604;10799;31084;8732;27630;1259;4471;4385;13618;5644;18089
330610;201604;8767;27446;7966;26028;1335;4962;4587;14634;5922;19596
330615;201604;1655;5800;1500;5477;661;2588;294;1090;955;3678
330620;201604;3418;11819;3072;11154;1074;4225;689;2538;1763;6763
330630;201604;22633;66246;18641;59247;3152;11438;9650;29484;12802;40922
350010;201604;1976;5866;1320;4543;298;1104;161;506;459;1610
350020;201604;451;1223;315;958;49;158;152;438;201;596
350030;201604;4278;13438;3365;11607;1170;4396;686;2260;1856;6656
350040;201604;456;1573;345;1323;77;315;82;298;159;613
350050;201604;882;2681;718;2384;167;643;244;719;411;1362
350055;201604;642;1915;546;1759;106;346;302;970;408;1316
350060;201604;112;326;88;289;23;86;38;116;61;202
350070;201604;3610;10842;2363;8208;446;1679;430;1330;876;3009
350075;201604;454;1509;358;1338;137;521;77;278;214;799
350080;201604;567;1615;396;1274;76;277;142;438;218;715
350090;201604;593;1535;387;1171;97;279;135;421;232;700
350100;201604;1803;5642;1315;4651;284;1127;370;1228;654;2355
350110;201604;454;1360;348;1140;39;150;178;567;217;717
350115;201604;1214;3715;1093;3472;184;672;599;1765;783;2437
350120;201604;587;1547;314;973;61;196;44;134;105;330
350130;201604;3163;9443;2790;8706;398;1419;1487;4384;1885;5803
350140;201604;565;1833;482;1697;69;282;239;834;308;1116
350150;201604;380;1278;328;1167;116;437;72;258;188;695
350160;201604;7721;22418;5278;17615;1207;4527;1881;5742;3088;10269
350170;201604;1636;5614;1408;5048;353;1343;291;982;644;2325
350180;201604;1034;2890;672;2064;101;310;302;930;403;1240
350190;201604;2935;9137;2435;8135;516;2056;1122;3307;1638;5363
350200;201604;340;1094;294;1011;38;137;159;553;197;690
350210;201604;4795;12810;3590;10846;1006;3320;1381;4069;2387;7389
350220;201604;2538;8053;2208;7359;531;2089;805;2428;1336;4517
350230;201604;632;2080;576;1984;134;506;235;790;369;1296
350240;201604;452;1407;382;1234;68;221;210;668;278;889
350250;201604;1960;7122;1835;6881;645;2618;583;2147;1228;4765
350260;201604;947;2547;663;2033;111;369;285;827;396;1196
350270;201604;4925;15111;4175;13495;783;2702;1661;5154;2444;7856
350275;201604;1896;6234;1720;5926;479;1766;628;2066;1107;3832
350280;201604;21721;53186;13521;39430;2812;8776;2791;8140;5603;16916
350290;201604;1749;5639;1379;4855;302;1177;365;1213;667;2390
350300;201604;418;1218;339;1055;83;251;177;549;260;800
350310;201604;807;2681;710;2474;98;394;299;1013;397;1407
350315;201604;499;1578;399;1361;61;253;97;293;158;546
350320;201604;10571;32894;9347;30606;2586;8998;1333;4516;3919;13514
350330;201604;13779;38498;9315;28382;1853;5574;2948;8546;4801;14120
350335;201604;337;1083;297;997;22;63;213;738;235;801
350340;201604;1078;3213;759;2574;136;520;212;708;348;1228
350350;201604;705;2196;607;2035;114;428;209;678;323;1106
350360;201604;771;2623;664;2395;178;669;247;928;425;1597
350370;201604;604;1800;450;1465;84;293;86;258;170;551
350380;201604;4064;11618;2728;9269;681;2575;630;1926;1311;4501
350390;201604;8597;26708;7672;24972;2268;7688;2771;8850;5039;16538
350395;201604;357;1000;186;639;25;100;38;120;63;220
350400;201604;7632;21865;6182;19296;1384;4782;2363;7104;3747;11886
350410;201604;7978;26515;6211;22898;1618;6577;918;3238;2536;9815
350420;201604;527;1599;379;1331;73;312;25;82;98;394
350430;201604;680;2097;557;1875;112;427;260;832;372;1259
350440;201604;1187;3723;1062;3472;255;847;466;1517;721;2364
350450;201604;7402;22574;5861;19435;1325;4764;1295;4125;2620;8889
350460;201604;1379;3784;866;2770;161;579;244;708;405;1287
350470;201604;231;631;190;559;31;117;109;299;140;416
350480;201604;776;2324;536;1805;73;287;89;260;162;547
350490;201604;1789;5349;1542;4968;378;1336;579;1728;957;3064
350500;201604;552;1625;485;1514;94;339;254;765;348;1104
350510;201604;1040;3139;822;2690;135;524;321;966;456;1490
350520;201604;1322;4878;1039;4140;237;1045;173;692;410;1737
350530;201604;2295;6748;1900;5932;547;1751;578;1702;1125;3453
350535;201604;1229;3970;1154;3840;156;636;748;2380;904;3016
350540;201604;1742;4950;1377;4298;369;1205;438;1405;807;2610
350550;201604;10856;28895;7520;23420;1536;5379;2434;7186;3970;12565
350560;201604;3121;10354;2801;9662;389;1413;1515;5267;1904;6680
350570;201604;17416;57604;15597;53890;4520;16838;5506;18117;10026;34955
350580;201604;1593;4976;1147;3973;238;905;128;387;366;1292
350590;201604;3972;12276;3092;10510;779;2954;1063;3312;1842;6266
350600;201604;40173;98530;26694;75688;4311;13168;11297;30231;15608;43399
350610;201604;6886;20140;5502;17726;1137;3991;2322;7396;3459;11387
350620;201604;397;1130;297;975;54;211;124;381;178;592
350630;201604;1547;4566;1187;3887;238;942;382;1103;620;2045
350635;201604;6059;18041;4704;15652;1079;3899;1750;5745;2829;9644
350640;201604;713;2223;502;1721;83;318;92;291;175;609
350650;201604;7443;22514;4587;15742;1036;3959;519;1615;1555;5574
350660;201604;4428;13008;3726;11856;731;2567;1935;6005;2666;8572
350670;201604;1589;4916;1471;4702;295;972;827;2609;1122;3581
350680;201604;1030;3114;809;2685;170;631;321;1042;491;1673
350690;201604;824;2706;665;2393;142;545;194;671;336;1216
350700;201604;4121;12170;2769;9683;731;2775;638;1982;1369;4757
350710;201604;2576;8014;2266;7430;325;1179;1356;4377;1681;5556
350715;201604;770;2363;673;2169;201;684;241;717;442;1401
350720;201604;119;356;106;336;32;104;38;121;70;225
350730;201604;385;1446;373;1416;92;398;153;561;245;959
350740;201604;1792;5524;1321;4430;231;873;359;1088;590;1961
350745;201604;473;1490;294;1010;41;146;129;402;170;548
350750;201604;9723;29285;7744;25442;1732;6220;1639;4978;3371;11198
350760;201604;12762;37110;10227;32608;2485;8730;2974;8648;5459;17378
350770;201604;704;2009;489;1598;62;226;246;787;308;1013
350775;201604;552;1494;464;1363;62;224;259;745;321;969
350780;201604;1808;5552;1407;4747;386;1426;205;706;591;2132
350790;201604;1887;5821;1397;4850;316;1179;256;792;572;1971
350800;201604;2849;9492;2670;9193;412;1658;1649;5528;2061;7186
350810;201604;1964;5558;1634;5095;453;1501;637;2019;1090;3520
350820;201604;549;1481;407;1217;63;235;188;519;251;754
350830;201604;835;2591;562;1968;77;284;128;396;205;680
350840;201604;2361;8348;1949;7398;578;2318;373;1317;951;3635
350850;201604;5753;19090;4871;17168;1501;5569;1011;3494;2512;9063
350860;201604;3109;9639;2983;9459;221;893;2323;7281;2544;8174
350870;201604;2659;8394;2209;7685;500;1990;1252;4366;1752;6356
350880;201604;1208;4006;1016;3608;232;882;229;791;461;1673
350890;201604;618;1753;408;1292;53;191;93;227;146;418
350900;201604;3630;11731;2737;9695;694;2695;285;942;979;3637
350910;201604;799;2377;696;2169;219;725;262;778;481;1503
350920;201604;9933;28368;8923;26624;1004;3329;6112;17567;7116;20896
350925;201604;4508;14013;3697;12378;904;3234;1218;3651;2122;6885
350930;201604;1553;4242;1234;3668;135;439;766;2198;901;2637
350940;201604;1742;5689;1588;5455;298;1194;901;3005;1199;4199
350945;201604;916;2879;790;2650;109;459;442;1415;551;1874
350950;201604;68168;205042;55014;177892;12065;42725;21927;67282;33992;110007
350960;201604;4471;14787;3836;13482;671;2678;2082;6979;2753;9657
350970;201604;4212;14461;3557;12909;1115;4379;628;1980;1743;6359
350980;201604;570;1872;514;1784;212;785;161;563;373;1348
350990;201604;1731;5852;1430;5296;417;1667;368;1347;785;3014
350995;201604;728;2507;698;2453;97;448;451;1491;548;1939
351000;201604;2971;8858;2474;7927;335;1206;1114;3375;1449;4581
351010;201604;327;923;205;669;46;163;66;219;112;382
351015;201604;791;2693;664;2455;136;575;303;1083;439;1658
351020;201604;7912;24667;6844;23010;1686;5932;2980;10188;4666;16120
351030;201604;1688;5981;1495;5520;335;1434;459;1552;794;2986
351040;201604;3291;9869;3010;9410;419;1482;1997;6031;2416;7513
351050;201604;13894;39462;9931;32472;2410;8603;2505;8150;4915;16753
351060;201604;34235;100029;28036;88911;5855;20308;12532;38682;18387;58990
351070;201604;1451;4060;969;3170;265;949;98;276;363;1225
351080;201604;2533;7322;1942;6577;490;1837;836;2715;1326;4552
351090;201604;350;1197;280;1048;57;244;47;174;104;418
351100;201604;2047;6252;1646;5419;447;1530;414;1420;861;2950
351110;201604;7071;17575;3922;12466;805;2929;794;2384;1599;5313
351120;201604;625;1804;496;1550;57;217;241;648;298;865
351130;201604;986;2742;536;1811;88;318;93;289;181;607
351140;201604;1641;5509;1355;4920;410;1600;295;1023;705;2623
351150;201604;1478;5170;1101;4188;190;776;167;557;357;1333
351160;201604;1223;4226;1077;3887;272;1086;328;1077;600;2163
351170;201604;1374;4358;1142;3859;195;717;495;1596;690;2313
351190;201604;767;2453;604;2031;95;333;153;507;248;840
351200;201604;1965;5799;1661;5237;300;1056;574;1658;874;2714
351210;201604;1061;3142;780;2560;163;595;263;787;426;1382
351220;201604;3129;10497;2856;9940;518;1998;1372;4667;1890;6665
351230;201604;1645;5141;1390;4663;254;1003;688;2223;942;3226
351240;201604;1030;3207;760;2627;210;768;196;617;406;1385
351250;201604;928;2677;605;1973;104;369;199;612;303;981
351260;201604;908;2652;791;2418;177;559;308;906;485;1465
351270;201604;311;1081;273;1001;60;255;99;319;159;574
351280;201604;4691;13692;3567;11387;721;2509;1211;3677;1932;6186
351290;201604;951;2707;703;2232;159;516;276;864;435;1380
351300;201604;12329;39924;9274;33410;2139;8502;2650;9343;4789;17845
351310;201604;3031;9174;2451;8146;453;1738;1105;3381;1558;5119
351320;201604;856;2833;734;2567;142;570;230;727;372;1297
351330;201604;255;705;208;635;79;243;43;124;122;367
351340;201604;5569;18592;4832;17126;1344;5035;1689;5957;3033;10992
351350;201604;7302;23359;6281;21256;1721;6055;1984;6406;3705;12461
351360;201604;4008;12451;3662;11789;862;3056;1189;3512;2051;6568
351370;201604;2171;6665;1720;5729;343;1299;663;2009;1006;3308
351380;201604;36651;106940;33061;100436;6465;21120;14019;41627;20484;62747
351385;201604;205;636;184;597;37;134;83;250;120;384
351390;201604;1118;3622;938;3255;238;962;350;1087;588;2049
351400;201604;837;2783;797;2692;285;1032;272;906;557;1938
351410;201604;2467;7382;2156;6827;339;1128;1254;3900;1593;5028
351420;201604;313;895;215;707;45;152;50;164;95;316
351430;201604;799;2513;747;2429;105;384;543;1745;648;2129
351440;201604;3274;9761;2522;8144;535;1773;369;1099;904;2872
351450;201604;1567;4394;1288;3970;317;1023;477;1545;794;2568
351460;201604;677;2022;579;1857;313;1024;130;415;443;1439
351470;201604;975;2930;865;2715;177;635;383;1148;560;1783
351480;201604;2661;8642;2449;8296;387;1676;1373;4411;1760;6087
351490;201604;1746;5729;1554;5327;179;752;911;2972;1090;3724
351492;201604;207;644;166;552;13;54;101;331;114;385
351495;201604;173;545;137;449;32;131;50;144;82;275
351500;201604;24512;69825;18889;59509;4651;16111;7085;21242;11736;37353
351510;201604;8576;26250;7024;23116;1617;5762;3222;10422;4839;16184
351512;201604;455;1307;348;1078;52;153;176;545;228;698
351515;201604;2189;6863;1571;5492;369;1409;384;1202;753;2611
351518;201604;2026;6267;1396;5097;326;1378;413;1353;739;2731
351519;201604;773;2272;567;1822;104;402;157;380;261;782
351520;201604;762;2050;384;1319;55;224;58;178;113;402
351530;201604;371;1131;268;884;39;125;66;175;105;300
351535;201604;2310;5922;1798;5175;141;479;1185;3296;1326;3775
351540;201604;1716;5160;1373;4508;435;1563;186;599;621;2162
351550;201604;4962;14516;3519;11456;660;2415;1247;3888;1907;6303
351560;201604;356;1151;312;1070;66;270;44;143;110;413
351565;201604;166;553;151;517;25;90;66;226;91;316
351570;201604;11736;35542;9810;31673;2094;7310;5039;15724;7133;23034
351580;201604;319;846;194;584;51;150;49;152;100;302
351590;201604;431;1121;286;851;29;94;125;356;154;450
351600;201604;1699;4701;1434;4248;190;642;798;2229;988;2871
351610;201604;650;1784;499;1526;59;215;225;614;284;829
351620;201604;18010;57188;13948;48964;2795;10981;3412;10686;6207;21667
351630;201604;19071;59725;17161;56663;3837;13456;9387;30706;13224;44162
351640;201604;12001;35669;9785;31654;1721;6074;5383;17087;7104;23161
351650;201604;448;1344;223;761;40;154;26;74;66;228
351660;201604;760;2437;572;1951;116;415;118;357;234;772
351670;201604;3800;11808;3139;10378;568;2111;1383;4272;1951;6383
351680;201604;604;1869;387;1365;70;249;63;225;133;474
351685;201604;373;1140;330;1065;88;267;155;513;243;780
351690;201604;1070;3186;771;2541;130;458;245;729;375;1187
351700;201604;1132;3307;971;2996;242;727;362;1110;604;1837
351710;201604;553;1815;470;1640;74;250;178;611;252;861
351720;201604;1570;4787;1083;3608;199;702;298;949;497;1651
351730;201604;1048;2991;852;2709;221;811;335;1038;556;1849
351740;201604;3962;10827;3186;9302;651;2018;1160;3236;1811;5254
351750;201604;1086;3453;732;2636;172;669;164;585;336;1254
351760;201604;3483;10837;2849;9473;751;2693;894;2776;1645;5469
351770;201604;2104;6620;1798;6093;504;1802;745;2427;1249;4229
351780;201604;1482;4143;890;2846;139;482;212;665;351;1147
351790;201604;1003;2924;877;2724;244;726;391;1266;635;1992
351800;201604;435;976;275;739;31;94;117;302;148;396
351810;201604;968;2756;846;2576;102;325;601;1819;703;2144
351820;201604;2398;7536;1814;6342;439;1613;168;555;607;2168
351830;201604;3824;11911;2918;9905;505;1923;1306;4242;1811;6165
351840;201604;6729;22311;5851;20573;1466;5574;2006;6851;3472;12425
351850;201604;1865;5138;1337;4204;192;751;630;1790;822;2541
351860;201604;3239;10337;2809;9452;745;2697;1052;3392;1797;6089
351870;201604;27698;82543;23280;74597;6618;22287;9210;29278;15828;51565
351880;201604;108396;339175;92261;306379;26119;92230;22500;71378;48619;163608
351885;201604;584;2013;529;1904;143;540;214;765;357;1305
351890;201604;612;1882;487;1640;111;419;79;229;190;648
351900;201604;1187;3612;996;3309;264;930;305;1005;569;1935
351905;201604;443;1377;362;1226;49;187;195;617;244;804
351907;201604;17523;51479;14496;45814;1633;6208;8889;27102;10522;33310
351910;201604;977;3059;816;2696;157;557;334;1081;491;1638
351920;201604;984;2683;857;2498;116;388;507;1440;623;1828
351925;201604;865;2701;730;2434;117;417;321;1021;438;1438
351930;201604;2533;8176;2403;7932;437;1817;1631;5027;2068;6844
351940;201604;946;2857;795;2568;163;579;325;1022;488;1601
351950;201604;1442;3963;1023;3182;138;459;494;1532;632;1991
351960;201604;4181;11956;3056;9872;646;2353;1258;4007;1904;6360
351970;201604;4881;17483;4319;16399;1207;4917;1457;5411;2664;10328
351980;201604;843;2528;656;2134;118;426;212;607;330;1033
351990;201604;1473;4166;1181;3621;235;857;237;614;472;1471
352000;201604;2218;7101;2007;6678;429;1530;942;2952;1371;4482
352010;201604;1624;5433;1426;4991;343;1301;275;964;618;2265
352020;201604;1371;4247;1176;3897;265;952;442;1399;707;2351
352030;201604;4756;13892;3940;12695;877;2980;1966;6368;2843;9348
352040;201604;1914;6212;1556;5438;316;1206;280;909;596;2115
352042;201604;3241;9043;2060;6459;404;1369;887;2702;1291;4071
352044;201604;1592;4941;1084;3848;187;728;178;571;365;1299
352050;201604;9817;29640;6732;22875;1506;5722;1254;3816;2760;9538
352060;201604;705;2108;572;1851;114;428;225;670;339;1098
352070;201604;784;2020;624;1753;133;401;206;573;339;974
352080;201604;411;1181;294;962;50;172;105;323;155;495
352090;201604;1156;3964;956;3453;168;677;214;715;382;1392
352100;201604;2578;7811;1962;6676;482;1794;685;2199;1167;3993
352110;201604;471;1623;398;1479;110;427;147;511;257;938
352115;201604;420;1335;363;1232;58;205;177;582;235;787
352120;201604;895;2800;740;2518;124;512;365;1162;489;1674
352130;201604;1753;5036;1174;3859;300;1023;260;805;560;1828
352140;201604;1722;4922;1037;3473;159;554;354;1139;513;1693
352150;201604;732;2249;580;1963;148;522;255;853;403;1375
352160;201604;980;2698;766;2308;156;509;242;639;398;1148
352170;201604;2614;7860;2352;7331;431;1443;1233;3622;1664;5065
352180;201604;3192;9166;2678;8160;647;2102;916;2675;1563;4777
352190;201604;1133;3373;904;2894;135;526;299;761;434;1287
352200;201604;363;1259;287;1097;54;236;118;431;172;667
352210;201604;15800;42690;12908;38514;2324;7364;7419;22437;9743;29801
352215;201604;547;1686;499;1614;62;229;295;929;357;1158
352220;201604;12017;38471;9986;34295;3226;11862;2276;7818;5502;19680
352230;201604;12010;40100;10395;37089;2848;11138;3557;12237;6405;23375
352240;201604;11995;34562;9328;29946;2635;9540;2720;7781;5355;17321
352250;201604;21857;70009;19014;64236;5557;19936;5589;18839;11146;38775
352260;201604;5127;14577;3339;10863;621;2260;1113;3319;1734;5579
352265;201604;846;2672;718;2449;60;285;453;1457;513;1742
352270;201604;1697;5801;1427;5219;359;1386;337;1223;696;2609
352280;201604;2135;6461;1774;5839;411;1554;640;1996;1051;3550
352290;201604;1058;3356;902;3028;200;796;323;967;523;1763
352300;201604;935;2733;735;2355;171;604;302;892;473;1496
352310;201604;39832;117706;32519;105219;8291;28272;15662;50781;23953;79053
352320;201604;5383;16562;4640;15158;1249;4346;1369;4053;2618;8399
352330;201604;1926;6125;1635;5714;521;1947;441;1524;962;3471
352340;201604;5211;16518;3995;14150;1014;3915;700;2261;1714;6176
352350;201604;1590;5399;1428;5059;278;1117;515;1740;793;2857
352360;201604;1024;3129;894;2881;177;689;553;1665;730;2354
352370;201604;829;2820;748;2637;121;486;382;1302;503;1788
352380;201604;936;2964;805;2722;243;936;175;549;418;1485
352390;201604;17974;48056;12004;36832;2060;7176;5495;15719;7555;22895
352400;201604;3727;10556;2455;8070;689;2360;594;1817;1283;4177
352410;201604;2848;8623;2427;7921;575;1987;923;2924;1498;4911
352420;201604;863;2450;735;2205;174;565;309;894;483;1459
352430;201604;6162;18347;5142;16728;1715;6081;1502;4783;3217;10864
352440;201604;14899;45038;12097;39667;2862;9967;4168;13388;7030;23355
352450;201604;641;1954;440;1532;97;378;108;336;205;714
352460;201604;2303;7456;1919;6707;538;2088;486;1538;1024;3626
352470;201604;3961;10878;2580;8306;397;1409;877;2616;1274;4025
352480;201604;4273;11679;3303;9874;676;2297;1136;3042;1812;5339
352490;201604;644;2231;513;1894;91;374;110;375;201;749
352500;201604;8270;23862;7235;22346;3512;11578;1734;4714;5246;16292
352510;201604;2809;8818;2219;7712;644;2440;508;1691;1152;4131
352520;201604;1962;6889;1740;6344;450;1772;683;2434;1133;4206
352530;201604;8087;25653;6110;21208;1520;5697;786;2297;2306;7994
352540;201604;461;1431;339;1151;45;166;95;312;140;478
352550;201604;846;2801;601;2219;135;573;100;327;235;900
352560;201604;629;1876;451;1479;71;227;116;347;187;574
352570;201604;1771;5823;1348;4867;286;1183;231;714;517;1897
352580;201604;826;2434;711;2247;148;507;373;1166;521;1673
352585;201604;206;666;172;605;55;210;31;115;86;325
352590;201604;12025;36667;9631;32020;2800;10004;3543;10990;6343;20994
352600;201604;1545;4730;1362;4403;324;1136;565;1727;889;2863
352610;201604;3225;9857;2663;8908;753;2842;721;2277;1474;5119
352620;201604;5099;15592;4632;14895;987;3411;2466;7763;3453;11174
352630;201604;608;1940;573;1856;123;464;232;697;355;1161
352640;201604;2608;7975;2175;7122;246;924;1243;3972;1489;4896
352650;201604;788;2348;589;1918;115;395;172;528;287;923
352660;201604;1003;3381;805;2940;148;614;193;686;341;1300
352670;201604;10333;30876;6441;22341;1426;5399;536;1776;1962;7175
352680;201604;2791;9335;2144;7852;487;1991;628;2101;1115;4092
352690;201604;29917;82247;21386;65350;3322;11238;10183;29710;13505;40948
352700;201604;584;1752;487;1602;142;520;202;638;344;1158
352710;201604;5154;14846;3844;12220;910;3198;1311;3929;2221;7127
352720;201604;7396;23881;6602;22142;1972;6677;1920;6424;3892;13101
352725;201604;389;1089;235;777;33;132;84;257;117;389
352730;201604;2091;6954;1890;6431;390;1429;656;1978;1046;3407
352740;201604;2014;5515;1611;4874;232;848;924;2641;1156;3489
352750;201604;470;1365;243;846;29;107;44;146;73;253
352760;201604;1138;3882;952;3422;285;1063;278;943;563;2006
352770;201604;744;2334;645;2139;133;487;258;822;391;1309
352780;201604;590;1964;473;1696;97;374;139;472;236;846
352790;201604;614;1761;450;1475;83;289;105;343;188;632
352800;201604;918;3245;667;2587;140;598;184;645;324;1243
352810;201604;1136;2958;748;2208;135;433;230;637;365;1070
352820;201604;618;1684;442;1402;95;332;92;297;187;629
352830;201604;501;1441;308;1000;47;181;42;106;89;287
352840;201604;3564;12064;3188;11273;959;3512;1050;3637;2009;7149
352850;201604;8451;25522;6820;22833;1799;6404;2261;7434;4060;13838
352860;201604;762;2534;697;2395;163;600;246;803;409;1403
352870;201604;917;2313;639;1745;63;232;356;870;419;1102
352880;201604;2215;6232;1633;5089;290;928;542;1586;832;2514
352885;201604;211;719;200;691;21;78;133;448;154;526
352890;201604;659;1743;466;1357;61;216;213;555;274;771
352900;201604;19730;57351;14534;46964;2953;10398;5056;15576;8009;25974
352910;201604;355;1032;210;701;20;75;37;115;57;190
352920;201604;2271;6826;1741;5738;337;1259;696;2094;1033;3353
352930;201604;5528;17077;4365;14556;1020;3610;1054;3355;2074;6965
352940;201604;21538;69437;17945;61205;5673;20837;2025;6198;7698;27035
352950;201604;307;894;194;686;41;172;36;106;77;278
352960;201604;583;1757;358;1245;48;179;61;199;109;378
352965;201604;365;1029;233;738;55;183;32;88;87;271
352970;201604;3106;7814;2513;6940;298;855;1645;4569;1943;5424
352980;201604;1106;3402;926;3112;200;663;520;1846;720;2509
352990;201604;3968;12466;3492;11647;903;3379;1400;4418;2303;7797
353000;201604;445;1257;245;790;28;95;36;110;64;205
353010;201604;2949;8198;2159;6673;494;1741;580;1557;1074;3298
353020;201604;4050;11023;2575;7873;367;1277;906;2481;1273;3758
353030;201604;3672;10812;2974;9516;837;2879;559;1711;1396;4590
353040;201604;526;1449;445;1326;109;360;136;378;245;738
353050;201604;4650;15502;3881;13918;1105;4224;1326;4590;2431;8814
353060;201604;35545;106089;32037;100512;3369;12775;23050;69747;26419;82522
353070;201604;10148;31152;7271;25097;1678;6174;1703;5884;3381;12058
353080;201604;5021;15809;3503;12510;730;2890;737;2433;1467;5323
353090;201604;499;1693;450;1593;45;194;261;867;306;1061
353100;201604;255;692;125;413;19;63;20;61;39;124
353110;201604;7238;22097;6202;20421;1416;5018;3317;10970;4733;15988
353120;201604;652;1916;415;1367;85;311;97;260;182;571
353130;201604;2390;6893;1922;6177;594;2049;572;1792;1166;3841
353140;201604;2234;6082;1721;5099;398;1265;678;1900;1076;3165
353150;201604;1596;4791;1289;4256;348;1197;342;1126;690;2323
353160;201604;659;1864;422;1368;92;309;60;147;152;456
353170;201604;403;1319;366;1261;112;483;152;472;264;955
353180;201604;8025;22818;6408;19970;1117;3805;3279;9962;4396;13767
353190;201604;3578;10819;2966;9508;508;1824;1502;4522;2010;6346
353200;201604;909;3025;739;2639;229;902;181;599;410;1501
353205;201604;355;1160;313;1079;71;248;125;435;196;683
353210;201604;968;2459;690;1968;38;138;453;1257;491;1395
353215;201604;368;1155;321;1054;51;196;120;340;171;536
353220;201604;631;1971;517;1730;131;470;108;333;239;803
353230;201604;782;2524;714;2406;170;637;187;591;357;1228
353240;201604;1950;6271;1724;5830;357;1358;872;2834;1229;4192
353250;201604;1035;2787;784;2332;103;330;381;1081;484;1411
353260;201604;845;2328;607;1896;97;347;215;647;312;994
353270;201604;599;1757;526;1621;123;402;189;557;312;959
353280;201604;558;1825;462;1606;114;438;92;307;206;745
353282;201604;1617;5189;1496;4949;208;760;894;2842;1102;3602
353284;201604;337;905;191;594;33;102;46;145;79;247
353286;201604;140;422;101;337;16;49;18;63;34;112
353290;201604;623;1927;498;1702;80;341;271;864;351;1205
353300;201604;1362;4233;1141;3766;259;971;399;1190;658;2161
353310;201604;177;549;150;501;46;161;49;158;95;319
353320;201604;517;1482;454;1378;82;279;245;709;327;988
353325;201604;578;1892;481;1698;81;305;100;330;181;635
353330;201604;595;1723;405;1282;70;256;179;529;249;785
353340;201604;2619;7469;1740;5809;485;1715;415;1365;900;3080
353350;201604;3072;9208;2504;8113;758;2584;782;2407;1540;4991
353360;201604;387;1252;346;1164;42;164;224;723;266;887
353370;201604;609;2005;530;1823;68;275;286;949;354;1224
353380;201604;320;1063;265;946;51;216;84;272;135;488
353390;201604;5549;15141;3966;12338;746;2489;1331;3966;2077;6455
353400;201604;464;1408;398;1279;93;336;85;226;178;562
353410;201604;586;1702;488;1535;92;317;274;856;366;1173
353420;201604;575;1619;392;1202;113;350;100;288;213;638
353430;201604;2168;7308;1578;5835;370;1452;217;755;587;2207
353440;201604;55862;176416;46279;155227;12330;43281;15562;50508;27892;93789
353450;201604;405;1205;332;1055;69;240;121;369;190;609
353460;201604;3211;9046;2666;8083;351;1203;1309;4046;1660;5249
353470;201604;7903;23700;5790;19447;1240;4595;1214;3773;2454;8368
353475;201604;1535;4292;1072;3295;190;629;294;807;484;1436
353480;201604;1347;4087;1197;3792;191;664;694;2121;885;2785
353490;201604;927;2678;727;2283;148;487;249;740;397;1227
353500;201604;943;2525;775;2254;241;709;341;962;582;1671
353510;201604;958;3037;716;2445;154;562;146;460;300;1022
353520;201604;1073;3071;840;2688;144;521;343;1051;487;1572
353530;201604;2446;7163;2134;6607;337;1228;1136;3360;1473;4588
353540;201604;1838;5616;1584;5183;421;1463;629;1999;1050;3462
353550;201604;5890;16270;4919;14732;544;1917;3048;8671;3592;10588
353560;201604;1942;6422;1613;5840;418;1704;394;1317;812;3021
353570;201604;426;1320;356;1174;60;206;212;662;272;868
353580;201604;2210;6666;1984;6296;315;1132;1267;3975;1582;5107
353590;201604;706;2044;523;1675;133;455;157;513;290;968
353600;201604;1673;4628;1502;4343;216;687;780;2201;996;2888
353610;201604;525;1750;395;1472;69;303;68;217;137;520
353620;201604;2106;6817;1789;6173;448;1680;509;1618;957;3298
353625;201604;342;948;209;691;42;153;64;211;106;364
353630;201604;1455;5071;1170;4350;213;852;135;430;348;1282
353640;201604;1252;3738;987;3166;111;381;487;1544;598;1925
353650;201604;7281;21373;5422;17483;999;3365;1792;5583;2791;8948
353657;201604;284;896;251;830;38;142;84;260;122;402
353660;201604;1065;2771;800;2326;298;934;107;209;405;1143
353670;201604;3410;10976;2910;9915;919;3513;882;2699;1801;6212
353680;201604;679;2183;574;1997;194;774;191;605;385;1379
353690;201604;507;1359;283;924;48;166;56;138;104;304
353700;201604;1883;5779;1615;5250;279;965;710;2208;989;3173
353710;201604;2936;7069;1421;4620;311;1027;223;734;534;1761
353715;201604;476;1374;350;1110;32;119;91;260;123;379
353720;201604;1927;6024;1658;5611;320;1291;810;2568;1130;3859
353730;201604;4234;12751;3352;10942;652;2331;1039;3106;1691;5437
353740;201604;1770;5273;1372;4500;359;1221;318;1017;677;2238
353750;201604;816;2732;624;2281;128;521;143;538;271;1059
353760;201604;9467;26119;7684;23599;1263;4401;4509;13549;5772;17950
353770;201604;734;2285;459;1611;63;232;22;47;85;279
353780;201604;3956;13671;3446;12627;1091;4214;914;3332;2005;7546
353790;201604;2038;6951;1688;6235;440;1859;342;1234;782;3093
353800;201604;15490;47153;12352;41593;3179;11731;4175;13714;7354;25445
353810;201604;996;3164;770;2674;154;598;232;789;386;1387
353820;201604;1278;4292;1153;3998;225;910;583;1874;808;2784
353830;201604;655;1752;516;1532;91;301;275;795;366;1096
353850;201604;1634;5126;1439;4738;320;1111;558;1799;878;2910
353860;201604;2387;7907;2022;7074;525;1972;504;1703;1029;3675
353870;201604;28062;80607;19542;64085;3811;13731;5789;17258;9600;30989
353880;201604;2559;8053;2157;7347;303;1216;1134;3810;1437;5026
353890;201604;2604;6381;1819;5112;288;874;861;2309;1149;3183
353900;201604;957;2957;704;2454;142;549;186;601;328;1150
353910;201604;1081;3843;1022;3721;267;997;546;2003;813;3000
353920;201604;2231;6566;1570;5180;325;1190;261;752;586;1942
353930;201604;4378;13147;3057;10727;741;2817;565;1969;1306;4786
353940;201604;1152;3633;913;3089;146;556;283;887;429;1443
353950;201604;3164;10080;2827;9431;476;1777;1581;5061;2057;6838
353960;201604;582;1820;441;1509;96;339;83;244;179;583
353970;201604;502;1452;435;1364;50;163;283;896;333;1059
353980;201604;12330;36986;10616;33751;2280;7704;5071;15591;7351;23295
353990;201604;342;1077;308;1006;44;177;156;474;200;651
354000;201604;2115;5938;1402;4502;255;881;127;373;382;1254
354010;201604;352;1064;293;967;65;212;162;551;227;763
354020;201604;4134;13006;3616;11868;916;3187;1141;3517;2057;6704
354025;201604;860;2391;627;1960;123;415;209;631;332;1046
354030;201604;446;1253;308;997;47;163;126;393;173;556
354040;201604;733;2022;510;1598;58;196;248;718;306;914
354050;201604;918;2928;747;2576;190;710;163;542;353;1252
354060;201604;4777;14711;3370;11575;817;2990;837;2735;1654;5725
354070;201604;2627;8771;2247;7911;543;2055;421;1405;964;3460
354075;201604;1825;6699;1696;6415;397;1667;759;2805;1156;4472
354080;201604;1485;4560;1052;3605;204;708;208;656;412;1364
354085;201604;313;796;278;745;13;48;227;598;240;646
354090;201604;1280;3808;1223;3714;132;452;861;2626;993;3078
354100;201604;14090;46859;11599;42204;2957;11468;4549;16303;7506;27771
354105;201604;802;2440;716;2300;113;406;458;1440;571;1846
354110;201604;686;1903;551;1718;206;712;78;185;284;897
354120;201604;1842;5079;1400;4253;242;812;577;1636;819;2448
354130;201604;6010;17341;4567;14550;1651;5537;436;1194;2087;6731
354140;201604;25697;64370;15875;46835;3188;10072;4586;12498;7774;22570
354150;201604;3765;10203;2878;8583;457;1494;1340;3845;1797;5339
354160;201604;3240;10476;2700;9253;720;2654;959;3187;1679;5841
354165;201604;442;1534;381;1403;101;404;129;471;230;875
354170;201604;1289;4023;1036;3462;200;746;378;1148;578;1894
354180;201604;451;1341;395;1227;50;187;216;599;266;786
354190;201604;1516;4823;1274;4324;328;1209;388;1258;716;2467
354200;201604;971;2754;778;2415;107;385;343;974;450;1359
354210;201604;578;1842;492;1688;71;291;262;843;333;1134
354220;201604;2787;8128;2370;7379;495;1643;1053;3213;1548;4856
354230;201604;597;1962;541;1857;101;395;223;737;324;1132
354240;201604;1182;3862;891;3192;161;643;185;632;346;1275
354250;201604;658;1874;438;1485;140;510;102;369;242;879
354260;201604;6735;20379;5734;18679;1624;5637;1763;5766;3387;11403
354270;201604;1118;3770;937;3365;197;770;300;1062;497;1832
354280;201604;656;1999;599;1904;83;334;400;1191;483;1525
354290;201604;865;3012;782;2843;190;755;329;1200;519;1955
354300;201604;3426;11323;3255;10998;916;3181;1494;4995;2410;8176
354310;201604;829;2542;658;2203;126;446;322;1080;448;1526
354320;201604;687;2064;573;1844;141;520;174;508;315;1028
354323;201604;429;1189;321;994;62;209;106;291;168;500
354325;201604;1192;3924;936;3309;190;759;330;1074;520;1833
354330;201604;6245;18790;5081;16514;1021;3699;2285;6969;3306;10668
354340;201604;22811;69888;18541;62350;5419;19718;6434;20973;11853;40691
354350;201604;1024;3025;946;2880;261;901;467;1292;728;2193
354360;201604;442;1408;278;1005;41;154;11;42;52;196
354370;201604;1112;3710;966;3428;99;431;565;1962;664;2393
354380;201604;811;2432;647;2135;183;716;100;272;283;988
354390;201604;12455;36621;8733;29395;1764;6444;1634;5347;3398;11791
354400;201604;1507;5241;1238;4570;247;971;351;1254;598;2225
354410;201604;5161;15932;4319;14347;1056;3740;1726;5660;2782;9400
354420;201604;1123;3385;840;2741;207;727;297;930;504;1657
354425;201604;2232;6456;1891;5822;592;1916;377;1172;969;3088
354430;201604;1264;4076;1157;3871;241;925;476;1540;717;2465
354440;201604;514;1552;381;1254;46;165;159;495;205;660
354450;201604;402;1160;238;813;35;147;36;96;71;243
354460;201604;880;2408;631;1964;164;556;246;751;410;1307
354470;201604;557;1520;434;1273;42;150;222;594;264;744
354480;201604;683;1888;583;1739;94;316;340;978;434;1294
354490;201604;676;2258;525;1893;79;301;187;642;266;943
354500;201604;2070;6724;1818;6283;621;2388;329;1129;950;3517
354510;201604;711;2047;641;1931;86;240;413;1285;499;1525
354515;201604;264;884;207;758;39;167;73;247;112;414
354520;201604;7227;23394;4087;14252;783;3097;1500;4848;2283;7945
354530;201604;2895;9980;2582;9293;699;2754;999;3499;1698;6253
354540;201604;1171;3527;957;3148;336;1198;137;406;473;1604
354550;201604;442;1315;364;1160;61;211;172;520;233;731
354560;201604;1558;4369;1026;3212;168;528;413;1228;581;1756
354570;201604;907;2567;522;1692;76;273;73;211;149;484
354580;201604;10348;29014;7488;23802;1307;4512;2831;8529;4138;13041
354600;201604;1492;4906;1320;4552;268;1123;644;2076;912;3199
354610;201604;372;1072;219;710;22;60;53;159;75;219
354620;201604;370;1193;293;1064;70;311;140;487;210;798
354625;201604;269;850;195;692;31;117;53;174;84;291
354630;201604;2001;6674;1768;6181;708;2611;250;808;958;3419
354640;201604;3312;10820;2642;9361;538;2202;516;1660;1054;3862
354650;201604;833;2500;723;2282;91;322;465;1453;556;1775
354660;201604;2191;6275;1648;5325;196;734;932;2979;1128;3713
354670;201604;1299;4108;1005;3401;243;897;210;630;453;1527
354680;201604;4261;13887;3861;13101;1023;3701;1575;5257;2598;8958
354690;201604;746;2395;497;1782;92;340;112;396;204;736
354700;201604;1122;3188;791;2489;147;545;319;863;466;1408
354710;201604;497;1491;390;1255;45;165;162;452;207;617
354720;201604;222;589;134;420;38;118;33;100;71;218
354730;201604;7652;24811;5909;21224;1287;5073;2334;8110;3621;13183
354740;201604;236;734;143;520;17;68;27;100;44;168
354750;201604;2277;6982;1777;6046;478;1807;603;1964;1081;3771
354760;201604;1841;5819;1503;5099;429;1560;183;600;612;2160
354765;201604;287;790;143;471;15;57;16;39;31;96
354770;201604;2233;6210;1704;5315;582;1934;461;1379;1043;3313
354780;201604;49165;137490;41976;122625;6773;22265;22773;62551;29546;84816
354790;201604;744;2454;670;2298;126;477;341;1110;467;1587
354800;201604;2036;5936;1798;5627;410;1461;895;2715;1305;4176
354805;201604;968;2909;704;2334;62;211;150;446;212;657
354810;201604;579;1883;368;1360;66;301;58;169;124;470
354820;201604;932;3203;801;2912;165;704;202;649;367;1353
354830;201604;393;1097;305;942;80;263;120;340;200;603
354840;201604;598;1678;474;1460;104;321;219;680;323;1001
354850;201604;15911;48725;11877;40653;2524;9687;4661;14705;7185;24392
354860;201604;1326;4149;1138;3837;229;878;425;1343;654;2221
354870;201604;42731;125876;38008;116248;8663;28340;16106;48295;24769;76635
354880;201604;4134;11369;2364;7690;344;1311;667;1801;1011;3112
354890;201604;15651;45316;13012;40616;2933;9936;4942;14841;7875;24777
354900;201604;411;1264;314;1055;65;230;67;217;132;447
354910;201604;6212;18544;3635;12931;567;2265;160;549;727;2814
354920;201604;405;1188;270;927;48;191;61;202;109;393
354925;201604;306;912;190;649;27;108;22;61;49;169
354930;201604;290;712;156;485;21;71;66;199;87;270
354940;201604;1778;6328;1467;5513;510;2050;166;577;676;2627
354950;201604;1410;4490;1212;4174;130;567;694;2327;824;2894
354960;201604;750;2331;653;2178;124;473;280;898;404;1371
354970;201604;3713;12109;3278;11213;569;2251;1749;5753;2318;8004
354980;201604;32901;81932;20212;61056;3449;11707;6372;17712;9821;29419
354990;201604;49581;144223;39396;124291;6866;23467;18903;57793;25769;81260
354995;201604;1669;5077;1409;4669;323;1101;706;2354;1029;3455
355000;201604;1355;4370;1203;4094;360;1417;231;681;591;2098
355010;201604;3460;10636;2685;8868;731;2535;810;2739;1541;5274
355020;201604;2777;9203;2141;7906;800;3243;434;1529;1234;4772
355030;201604;1045279;2865412;887752;2563035;194412;609775;382448;1056360;576860;1666135
355040;201604;2464;7536;2175;7037;500;1733;1181;3756;1681;5489
355050;201604;1102;3354;886;2945;280;945;134;434;414;1379
355060;201604;4206;13955;3425;12334;756;3056;952;3130;1708;6186
355070;201604;6196;19183;5487;18032;1152;4350;2661;8147;3813;12497
355080;201604;942;3251;675;2631;104;474;41;148;145;622
355090;201604;1078;3660;913;3301;162;619;356;1294;518;1913
355100;201604;16713;52192;14056;47769;3769;14120;6212;20506;9981;34626
355110;201604;1153;3745;992;3448;290;1084;217;744;507;1828
355120;201604;603;1899;506;1714;95;385;188;598;283;983
355130;201604;608;1549;302;899;45;136;92;242;137;378
355140;201604;1078;3578;1023;3488;221;849;536;1862;757;2711
355150;201604;3185;9199;2662;8376;551;1816;1340;4274;1891;6090
355160;201604;1552;4840;1304;4438;415;1570;354;1152;769;2722
355170;201604;8112;22581;6131;19297;1956;6574;1433;4631;3389;11205
355180;201604;2766;8589;2271;7685;565;2244;695;2130;1260;4374
355190;201604;1227;4129;1045;3766;372;1439;332;1171;704;2610
355200;201604;715;2555;663;2444;274;1099;139;474;413;1573
355210;201604;2554;8084;2241;7432;379;1468;1195;3737;1574;5205
355220;201604;31875;96195;26115;84795;8518;29241;6017;18367;14535;47608
355230;201604;1393;3845;782;2513;140;469;168;486;308;955
355240;201604;24811;70534;17513;55903;3650;12361;5459;16959;9109;29320
355250;201604;26157;82867;22380;75601;6166;22278;7988;26388;14154;48666
355255;201604;840;2324;538;1717;98;331;135;412;233;743
355260;201604;1206;3527;1029;3225;225;807;421;1191;646;1998
355270;201604;1554;4520;1438;4340;126;422;1087;3266;1213;3688
355280;201604;24409;70785;19838;62067;3656;12808;8534;25334;12190;38142
355290;201604;877;2773;711;2380;125;439;245;742;370;1181
355300;201604;1155;3733;967;3345;189;697;311;1027;500;1724
355310;201604;969;2957;818;2669;147;522;400;1301;547;1823
355320;201604;558;1724;481;1562;82;323;179;504;261;827
355330;201604;1829;5627;1320;4606;274;1050;506;1722;780;2772
355340;201604;2436;6359;2184;5949;364;999;1312;3527;1676;4526
355350;201604;1283;4325;1035;3766;253;1019;258;885;511;1904
355360;201604;1083;3447;971;3220;149;523;626;2142;775;2665
355365;201604;296;861;196;689;40;146;48;168;88;314
355370;201604;7506;18408;5471;15891;1476;4640;2123;6554;3599;11194
355380;201604;3162;9490;2482;8004;525;1858;525;1439;1050;3297
355385;201604;782;2523;718;2407;250;909;206;632;456;1541
355390;201604;830;2374;630;1967;137;483;226;598;363;1081
355395;201604;1864;5574;1377;4465;207;697;574;1739;781;2436
355400;201604;8630;28319;7474;25926;2207;8304;2025;6759;4232;15063
355410;201604;15777;51177;12668;44987;3754;14638;2241;8055;5995;22693
355420;201604;710;2515;649;2391;198;813;160;589;358;1402
355430;201604;3387;9465;2800;8457;541;1732;1357;3956;1898;5688
355440;201604;906;2781;683;2291;124;437;199;615;323;1052
355450;201604;3661;10479;2127;7055;371;1271;590;1841;961;3112
355460;201604;586;1587;389;1235;77;294;111;283;188;577
355465;201604;328;1063;282;978;55;202;74;257;129;459
355470;201604;735;2278;604;2022;129;467;263;853;392;1320
355475;201604;150;524;141;498;35;127;67;230;102;357
355480;201604;2667;9277;2438;8818;574;2233;1114;3938;1688;6171
355490;201604;941;2701;615;2020;110;369;139;430;249;799
355495;201604;700;2343;616;2154;114;425;185;628;299;1053
355500;201604;7279;21003;4842;15783;777;2759;791;2418;1568;5177
355510;201604;1961;5242;1119;3554;152;574;325;918;477;1492
355520;201604;414;963;215;584;29;93;92;220;121;313
355530;201604;411;970;171;530;19;68;31;79;50;147
355535;201604;651;1996;524;1766;152;580;117;330;269;910
355540;201604;7848;24712;7387;23970;1892;6558;3707;11645;5599;18203
355550;201604;685;2081;589;1939;126;494;267;867;393;1361
355560;201604;1200;3586;771;2627;146;567;65;163;211;730
355570;201604;184;576;124;443;20;82;10;33;30;115
355580;201604;1240;3475;855;2688;148;520;313;989;461;1509
355590;201604;226;591;178;507;24;81;97;261;121;342
355600;201604;1085;3317;909;2958;282;991;263;805;545;1796
355610;201604;1489;4137;1183;3583;212;698;506;1482;718;2180
355620;201604;3827;11931;3106;10346;512;1946;1398;4338;1910;6284
355630;201604;3205;9178;2055;6862;390;1394;503;1674;893;3068
355635;201604;876;2863;757;2668;87;347;502;1795;589;2142
355640;201604;2870;9097;2102;7537;339;1358;215;725;554;2083
355645;201604;3229;10918;2864;10335;474;1911;1646;5916;2120;7827
355650;201604;6586;19904;5622;18149;986;3674;3171;9566;4157;13240
355660;201604;1203;3808;970;3335;176;729;396;1270;572;1999
355670;201604;2574;7800;1883;6289;336;1308;770;2271;1106;3579
355680;201604;1614;5315;1189;4305;307;1193;172;603;479;1796
355690;201604;431;1354;324;1173;183;698;20;61;203;759
355695;201604;276;865;158;544;8;27;7;14;15;41
355700;201604;5116;16815;4363;15132;1059;3851;1594;5365;2653;9216
355710;201604;9901;24525;5948;17362;1347;4198;1386;3813;2733;8011
355715;201604;288;861;190;645;45;162;29;90;74;252
355720;201604;1514;5008;1251;4422;335;1286;357;1125;692;2411
355730;201604;771;2530;647;2249;206;726;142;491;348;1217
410010;201604;1351;4206;1167;3807;245;864;228;733;473;1597
410020;201604;1116;3654;970;3330;245;884;392;1326;637;2210
410030;201604;1114;3767;932;3321;209;805;161;558;370;1363
410040;201604;9189;30156;8029;27912;1952;7583;2257;7767;4209;15350
410045;201604;999;2818;710;2268;152;510;150;448;302;958
410050;201604;2529;6986;1621;5209;405;1396;124;314;529;1710
410060;201604;2219;6752;1955;6249;415;1382;860;2805;1275;4187
410070;201604;1663;4715;1279;3975;385;1312;270;782;655;2094
410080;201604;1345;3825;1070;3335;175;630;458;1329;633;1959
410090;201604;967;3010;898;2868;206;741;304;971;510;1712
410100;201604;2667;8097;2027;6623;426;1565;206;606;632;2171
410105;201604;366;1144;252;869;40;172;26;72;66;244
410110;201604;2722;7893;2176;6855;343;1194;663;2076;1006;3270
410115;201604;508;1375;399;1176;61;192;124;326;185;518
410120;201604;2376;8205;2213;7907;754;2874;702;2511;1456;5385
410130;201604;1011;3206;943;3034;420;1377;205;654;625;2031
410140;201604;16376;42849;11143;33591;2303;7554;2729;7963;5032;15517
410150;201604;16241;40762;8526;25481;1593;5092;1194;3277;2787;8369
410160;201604;2919;8981;2632;8484;669;2414;914;2974;1583;5388
410165;201604;715;2093;558;1729;120;383;218;620;338;1003
410170;201604;2210;6349;1704;5271;468;1625;264;780;732;2405
410180;201604;10187;32214;8753;29087;2037;7338;3282;10153;5319;17491
410185;201604;525;1452;390;1194;86;267;79;212;165;479
410190;201604;2009;5906;1584;4946;290;989;243;687;533;1676
410200;201604;3696;10359;2756;8550;563;1972;342;1012;905;2984
410210;201604;2518;7420;1863;6000;310;1173;382;1009;692;2182
410220;201604;634;1767;471;1467;76;276;143;440;219;716
410230;201604;1327;4168;1150;3828;259;991;426;1391;685;2382
410240;201604;4189;12695;3801;11887;1229;4370;567;1666;1796;6036
410250;201604;2601;7175;1810;5545;402;1334;316;906;718;2240
410260;201604;1486;4400;1226;3951;274;959;474;1518;748;2477
410270;201604;534;1492;396;1215;58;189;145;422;203;611
410275;201604;840;2538;575;1931;75;275;262;884;337;1159
410280;201604;2189;6323;1625;5207;327;1203;431;1292;758;2495
410290;201604;3313;9848;2772;8820;656;2198;1035;3346;1691;5544
410300;201604;696;1948;587;1727;94;302;248;652;342;954
410302;201604;406;1097;263;838;29;98;127;420;156;518
410304;201604;1203;3843;1088;3599;300;1023;376;1302;676;2325
410305;201604;1814;4966;1493;4412;310;1023;779;2289;1089;3312
410310;201604;2217;7137;1998;6745;433;1619;719;2453;1152;4072
410315;201604;626;1825;408;1383;68;246;111;355;179;601
410320;201604;1184;3601;768;2633;103;413;60;181;163;594
410322;201604;522;1530;337;1124;56;185;83;281;139;466
410330;201604;1357;3715;1106;3238;237;728;287;835;524;1563
410335;201604;938;2782;810;2544;144;493;317;952;461;1445
410337;201604;796;2078;585;1687;80;273;201;515;281;788
410340;201604;511;1508;355;1104;46;163;132;355;178;518
410345;201604;1768;5131;1249;4004;279;953;300;939;579;1892
410347;201604;690;1871;485;1474;62;225;142;402;204;627
410350;201604;1031;3092;757;2535;145;543;134;393;279;936
410360;201604;3591;9876;2842;8550;435;1501;1347;3934;1782;5435
410370;201604;11607;33947;8536;26768;1497;5267;2280;6211;3777;11478
410380;201604;1263;3713;1143;3461;139;506;546;1609;685;2115
410390;201604;2420;7239;1969;6279;580;1975;462;1320;1042;3295
410395;201604;843;2794;745;2581;192;741;303;1048;495;1789
410400;201604;4366;13414;3712;12176;758;2784;1341;4255;2099;7039
410405;201604;836;2438;677;2142;148;518;222;705;370;1223
410410;201604;1262;3900;1215;3835;319;1233;537;1570;856;2803
410420;201604;6615;21397;5447;18761;1294;4830;664;1956;1958;6786
410425;201604;2794;8841;2023;7117;323;1204;180;612;503;1816
410430;201604;13984;37601;10174;30601;1930;6356;2839;8192;4769;14548
410440;201604;2714;8676;2425;8116;636;2353;920;2995;1556;5348
410442;201604;2613;8732;2307;8043;662;2399;620;2192;1282;4591
410445;201604;2276;7505;1965;6941;510;2027;598;2183;1108;4210
410450;201604;2039;5782;1587;4897;420;1363;162;402;582;1765
410460;201604;1875;5538;1479;4778;373;1224;296;924;669;2148
410465;201604;1986;6544;1676;5884;363;1398;600;1991;963;3389
410470;201604;1672;5385;1358;4685;278;1101;308;1056;586;2157
410480;201604;29029;81797;18669;60079;3242;11191;1757;4874;4999;16065
410490;201604;10641;33028;8288;28124;1879;7147;2036;6321;3915;13468
410500;201604;1498;4721;1212;4074;440;1658;225;689;665;2347
410510;201604;2443;6401;1725;5001;318;919;607;1630;925;2549
410520;201604;3013;10414;2837;10068;834;3130;1095;3936;1929;7066
410530;201604;1521;4180;1089;3288;197;643;277;790;474;1433
410540;201604;2984;8804;2085;6898;404;1388;570;1864;974;3252
410550;201604;5910;17074;4127;13198;750;2641;493;1456;1243;4097
410560;201604;1215;3595;931;3012;206;759;246;688;452;1447
410570;201604;2563;8188;2309;7761;658;2389;704;2667;1362;5056
410580;201604;20433;61634;16716;54273;4016;14387;4485;13647;8501;28034
410590;201604;1339;4129;862;2881;122;411;166;500;288;911
410600;201604;1793;5230;1440;4545;361;1155;497;1590;858;2745
410610;201604;759;2126;595;1812;73;231;217;651;290;882
410620;201604;1669;5662;1248;4622;287;1159;108;382;395;1541
410630;201604;2426;7167;1718;5577;391;1397;201;536;592;1933
410640;201604;4417;12160;3278;10001;817;2890;477;1360;1294;4250
410645;201604;1103;3835;1037;3733;491;1853;207;797;698;2650
410650;201604;2052;6345;1655;5512;511;1808;222;690;733;2498
410655;201604;829;2366;624;1965;106;390;208;617;314;1007
410657;201604;726;2015;517;1581;92;321;162;421;254;742
410660;201604;2649;7668;1597;5290;332;1171;165;493;497;1664
410670;201604;917;2508;607;1843;111;362;164;450;275;812
410680;201604;2837;9232;2317;7974;672;2229;595;2234;1267;4463
410685;201604;635;1820;548;1673;58;192;359;1103;417;1295
410690;201604;111408;320246;79036;253223;15704;55500;16993;47663;32697;103163
410700;201604;2181;6567;1998;6224;514;1700;805;2413;1319;4113
410710;201604;888;2618;614;2024;138;476;136;393;274;869
410712;201604;791;2382;680;2167;244;838;166;545;410;1383
410715;201604;888;2823;663;2279;124;471;177;560;301;1031
410720;201604;3233;9501;2375;7699;457;1679;453;1312;910;2991
410725;201604;1037;2934;738;2350;108;336;107;305;215;641
410730;201604;507;1424;411;1269;121;404;94;315;215;719
410740;201604;907;2694;654;2183;97;375;271;883;368;1258
410750;201604;1771;5164;1455;4499;292;989;446;1298;738;2287
410752;201604;307;838;160;517;36;125;41;114;77;239
410753;201604;409;1184;256;829;32;120;73;219;105;339
410754;201604;1068;3159;909;2887;62;193;582;1984;644;2177
410755;201604;799;1983;603;1676;83;276;336;872;419;1148
410760;201604;2339;7076;2016;6485;529;1868;559;1764;1088;3632
410765;201604;14966;44606;11306;37436;1789;6649;821;2625;2610;9274
410770;201604;895;2460;638;1944;163;545;105;305;268;850
410773;201604;1287;3697;1121;3441;173;613;695;2070;868;2683
410775;201604;1382;3987;1274;3835;300;998;453;1341;753;2339
410780;201604;527;1446;373;1158;93;288;109;387;202;675
410785;201604;736;2329;617;2062;173;644;142;461;315;1105
410790;201604;428;1387;383;1271;88;308;37;84;125;392
410800;201604;2783;6967;2176;5944;377;1218;752;1894;1129;3112
410810;201604;331;1014;279;907;51;190;97;309;148;499
410820;201604;818;2444;613;1981;137;476;87;264;224;740
410830;201604;30188;85488;24085;75035;6655;23088;7483;22293;14138;45381
410832;201604;951;2778;832;2547;91;339;466;1356;557;1695
410840;201604;6588;19233;4329;14397;849;3030;287;735;1136;3765
410845;201604;1214;3592;1032;3225;213;727;399;1217;612;1944
410850;201604;2682;7910;2398;7458;526;1800;969;3067;1495;4867
410855;201604;566;1580;408;1250;66;213;136;398;202;611
410860;201604;3823;10775;3030;9238;565;1875;965;2830;1530;4705
410865;201604;1452;4925;1387;4801;350;1305;764;2720;1114;4025
410870;201604;1193;3626;1111;3496;195;647;709;2266;904;2913
410880;201604;3616;11476;3021;10234;588;2204;515;1701;1103;3905
410890;201604;890;2908;703;2511;181;735;64;214;245;949
410895;201604;1066;3658;952;3404;337;1289;202;677;539;1966
410900;201604;916;2493;597;1873;93;317;170;485;263;802
410910;201604;403;1065;308;895;34;107;157;445;191;552
410920;201604;802;2225;640;1955;166;585;204;608;370;1193
410930;201604;1597;4725;1341;4220;333;1230;407;1253;740;2483
410940;201604;20224;64745;17251;59242;5190;19383;3807;13222;8997;32605
410950;201604;1721;5629;1595;5402;188;686;1143;3868;1331;4554
410960;201604;7170;19811;4525;14775;1304;4723;808;2464;2112;7187
410965;201604;1031;3133;862;2802;226;758;337;1088;563;1846
410970;201604;4394;12885;3443;11037;910;3365;543;1670;1453;5035
410975;201604;1593;4544;1262;3909;214;762;443;1322;657;2084
410980;201604;5570;15618;3567;11638;669;2421;732;2288;1401;4709
410990;201604;884;2565;554;1849;165;607;57;143;222;750
411000;201604;477;1432;344;1132;54;201;65;173;119;374
411005;201604;475;1402;289;950;56;196;28;78;84;274
411007;201604;2231;6989;1927;6344;561;1958;522;1702;1083;3660
411010;201604;3849;13118;3461;12254;892;3464;439;1500;1331;4964
411020;201604;2484;7640;2156;7093;685;2504;641;2041;1326;4545
411030;201604;645;1743;467;1401;67;228;112;306;179;534
411040;201604;651;1887;302;1015;50;182;54;189;104;371
411050;201604;1961;6754;1762;6319;491;1942;239;764;730;2706
411060;201604;1469;4427;1158;3751;224;839;127;363;351;1202
411065;201604;361;1070;288;926;53;170;97;308;150;478
411070;201604;5692;16939;4475;14479;1154;4145;904;2654;2058;6799
411080;201604;2115;6304;1878;5866;441;1526;451;1353;892;2879
411090;201604;808;1998;557;1606;68;252;109;288;177;540
411095;201604;1469;4168;1113;3436;153;530;271;760;424;1290
411100;201604;1290;3734;938;3000;158;629;156;444;314;1073
411110;201604;576;1698;317;1084;38;144;32;90;70;234
411120;201604;1597;4820;1213;3978;296;1117;354;1062;650;2179
411125;201604;4063;13286;3876;12927;1116;3937;1403;4662;2519;8599
411130;201604;679;2025;510;1657;112;389;128;453;240;842
411140;201604;2109;7229;1800;6494;488;1841;624;2327;1112;4168
411150;201604;4023;11303;3066;9410;652;2165;385;1031;1037;3196
411155;201604;912;2492;667;2038;93;322;268;785;361;1107
411160;201604;230;647;177;549;37;121;38;105;75;226
411170;201604;683;2146;563;1864;124;451;179;565;303;1016
411180;201604;5473;16295;4493;14436;976;3458;1427;4587;2403;8045
411190;201604;1368;3917;1139;3481;274;957;234;615;508;1572
411200;201604;4191;12352;3354;10887;836;3053;999;3078;1835;6131
411210;201604;1903;5459;1512;4755;393;1362;158;438;551;1800
411220;201604;1096;3076;876;2679;204;737;303;806;507;1543
411230;201604;1229;3421;791;2553;156;543;231;713;387;1256
411240;201604;1415;3416;790;2334;132;406;244;664;376;1070
411250;201604;2134;6270;1774;5608;480;1678;420;1335;900;3013
411260;201604;295;813;198;643;28;93;73;228;101;321
411270;201604;1708;5299;1509;4921;269;1024;650;2010;919;3034
411275;201604;1293;3821;1055;3297;254;827;220;648;474;1475
411280;201604;1460;4252;1004;3282;171;604;174;531;345;1135
411290;201604;734;2136;562;1780;133;444;139;420;272;864
411295;201604;954;2664;853;2464;154;480;320;946;474;1426
411300;201604;1204;3058;844;2377;77;239;323;851;400;1090
411310;201604;826;2240;650;1955;69;250;204;600;273;850
411320;201604;5328;15355;3962;12800;1007;3407;658;1925;1665;5332
411325;201604;1510;4735;1323;4339;272;949;628;2097;900;3046
411330;201604;3028;9351;2558;8434;804;2940;580;1934;1384;4874
411340;201604;915;2685;588;1911;56;215;196;599;252;814
411342;201604;699;1995;573;1734;156;503;182;504;338;1007
411345;201604;876;2732;783;2558;208;758;321;1035;529;1793
411350;201604;2651;7943;1950;6483;504;1863;187;604;691;2467
411360;201604;571;1444;391;1131;53;188;162;402;215;590
411370;201604;43902;123529;34616;106419;5462;19290;14038;40057;19500;59347
411373;201604;1452;4475;1259;4127;255;957;285;941;540;1898
411375;201604;1108;3045;816;2480;151;474;207;595;358;1069
411380;201604;1198;3261;711;2137;117;371;189;513;306;884
411390;201604;1796;5281;1485;4638;267;928;411;1152;678;2080
411400;201604;2062;5865;1584;4866;296;995;406;1164;702;2159
411410;201604;1985;5990;1548;4993;329;1173;364;1034;693;2207
411420;201604;3916;11130;2695;8519;367;1296;388;995;755;2291
411430;201604;3103;9300;2588;8458;630;2268;1179;3769;1809;6037
411435;201604;423;1388;357;1221;80;294;138;457;218;751
411440;201604;2609;8409;2323;7829;712;2523;481;1744;1193;4267
411450;201604;2244;6866;2035;6460;412;1309;980;3270;1392;4579
411460;201604;3194;9296;1754;6007;259;969;88;275;347;1244
411470;201604;810;2426;549;1807;79;280;73;211;152;491
411480;201604;4378;13136;3305;11079;829;3093;439;1373;1268;4466
411490;201604;1419;4303;1199;3906;236;827;270;811;506;1638
411500;201604;1808;4784;1254;3800;230;776;337;1003;567;1779
411510;201604;1981;5952;1624;5214;429;1517;247;719;676;2236
411520;201604;25716;69990;15809;49414;2718;9173;3109;9256;5827;18429
411530;201604;1006;2797;725;2309;162;604;122;337;284;941
411535;201604;503;1539;277;997;28;126;25;79;53;205
411540;201604;2935;7947;2139;6324;501;1667;545;1436;1046;3103
411545;201604;948;3155;861;2995;150;552;531;1901;681;2453
411550;201604;778;2098;631;1872;213;698;114;344;327;1042
411560;201604;2330;6893;1671;5389;274;987;159;443;433;1430
411570;201604;6591;17491;4883;14746;1112;3853;970;3008;2082;6861
411573;201604;842;2492;788;2399;127;397;468;1468;595;1865
411575;201604;1517;4659;1270;4136;255;861;433;1422;688;2283
411580;201604;3848;10927;2594;8427;310;1220;330;940;640;2160
411585;201604;723;2321;398;1399;88;313;64;220;152;533
411590;201604;351;1075;306;1000;44;172;132;404;176;576
411600;201604;304;870;210;718;46;180;80;279;126;459
411605;201604;1658;4555;1152;3511;183;635;400;1193;583;1828
411610;201604;2146;6017;1745;5248;353;1167;801;2320;1154;3487
411620;201604;2603;8217;2381;7853;627;2238;1053;3526;1680;5764
411630;201604;497;1297;311;1021;53;223;47;134;100;357
411640;201604;447;1368;356;1169;53;176;109;331;162;507
411650;201604;190;616;152;543;28;118;28;95;56;213
411660;201604;887;2368;671;1979;99;308;306;893;405;1201
411670;201604;1082;3028;891;2617;184;579;288;797;472;1376
411680;201604;1381;4182;1226;3899;211;718;687;2252;898;2970
411690;201604;3259;9553;2577;8286;670;2238;522;1781;1192;4019
411695;201604;773;2514;624;2185;138;538;179;626;317;1164
411700;201604;1682;4884;1190;3882;220;787;171;503;391;1290
411705;201604;1850;6389;1622;5932;375;1344;789;3083;1164;4427
411710;201604;1617;4779;1314;4157;328;1115;210;666;538;1781
411720;201604;868;2454;672;2057;89;305;190;526;279;831
411721;201604;712;2119;587;1865;153;519;65;189;218;708
411722;201604;653;1955;440;1469;91;363;103;290;194;653
411725;201604;1365;4387;880;3149;188;702;150;543;338;1245
411727;201604;1770;5221;1333;4266;324;1083;245;769;569;1852
411729;201604;572;1509;401;1189;121;366;59;143;180;509
411730;201604;5438;15611;4526;13852;1599;4947;1089;3341;2688;8288
411740;201604;636;1813;404;1301;66;228;127;382;193;610
411745;201604;886;2551;734;2246;140;458;227;699;367;1157
411750;201604;4682;13916;3578;11429;700;2434;1057;3258;1757;5692
411760;201604;7564;22115;6507;20307;2070;6889;1514;4805;3584;11694
411770;201604;3310;10838;2749;9554;772;2910;473;1553;1245;4463
411780;201604;2799;8628;2554;8214;466;1635;1497;5011;1963;6646
411790;201604;3197;9082;2315;7263;603;2125;531;1584;1134;3709
411800;201604;1143;3284;794;2551;117;423;112;317;229;740
411810;201604;1619;4647;1331;4075;257;859;467;1321;724;2180
411820;201604;13154;42374;11092;38136;3765;13413;2367;8319;6132;21732
411830;201604;516;1345;403;1162;109;361;11;45;120;406
411840;201604;10107;28844;7527;23890;1684;5875;1257;3922;2941;9797
411845;201604;499;1523;315;1037;46;163;41;116;87;279
411850;201604;6858;20444;5669;17973;1390;4803;1408;4347;2798;9150
411860;201604;872;2657;703;2291;167;577;213;652;380;1229
411870;201604;847;2737;580;2019;109;448;101;304;210;752
411880;201604;2241;6432;1788;5638;420;1523;343;979;763;2502
411885;201604;880;2425;733;2172;126;460;222;608;348;1068
411890;201604;1065;3249;723;2429;116;444;55;140;171;584
411900;201604;938;2934;672;2294;147;503;91;315;238;818
411910;201604;1180;3890;918;3264;256;957;196;651;452;1608
411915;201604;15823;43284;10210;32178;1849;6273;2041;5861;3890;12134
411920;201604;831;2821;726;2572;181;750;73;202;254;952
411925;201604;598;1700;398;1315;87;289;95;289;182;578
411930;201604;5844;19058;5142;17664;2252;8247;713;2423;2965;10670
411940;201604;3150;10497;2732;9589;672;2454;555;1908;1227;4362
411950;201604;11700;36935;9956;33551;2340;8421;4235;14045;6575;22466
411960;201604;5330;15793;4925;15043;1060;3634;1989;5895;3049;9529
411965;201604;564;1607;405;1336;70;276;116;403;186;679
411970;201604;728;2053;607;1865;163;517;240;811;403;1328
411980;201604;1625;4863;1409;4434;301;1020;437;1376;738;2396
411990;201604;28621;91800;23860;81688;6021;22845;6355;20972;12376;43817
411995;201604;2392;7310;2031;6651;608;2238;433;1308;1041;3546
412000;201604;2141;5447;1657;4624;247;822;801;2020;1048;2842
412010;201604;699;2353;562;2051;88;341;115;394;203;735
412015;201604;639;1875;522;1637;88;285;240;760;328;1045
412020;201604;358;1052;239;782;42;145;63;190;105;335
412030;201604;700;2189;503;1741;77;299;113;375;190;674
412033;201604;768;2246;531;1686;77;274;120;370;197;644
412035;201604;975;2719;646;2114;129;444;206;673;335;1117
412040;201604;573;1800;452;1532;78;274;102;343;180;617
412050;201604;1705;4911;1305;4133;221;769;298;906;519;1675
412060;201604;6710;22871;6102;21657;1895;7300;1626;5682;3521;12982
412065;201604;802;2401;624;2023;128;457;164;491;292;948
412070;201604;1334;3579;980;2846;147;463;333;960;480;1423
412080;201604;1366;4247;846;3052;94;380;18;62;112;442
412085;201604;435;1252;155;536;25;93;20;60;45;153
412090;201604;4309;13399;4037;12923;741;2504;2216;7329;2957;9833
412100;201604;1884;5805;1544;5131;444;1620;342;1136;786;2756
412110;201604;1061;2981;715;2259;155;511;117;386;272;897
412120;201604;1653;5599;1426;5088;367;1449;412;1292;779;2741
412125;201604;627;2036;570;1925;132;482;196;630;328;1112
412130;201604;589;1748;430;1383;98;344;63;184;161;528
412135;201604;458;1287;303;969;62;206;88;269;150;475
412140;201604;1537;4616;1269;4058;272;930;236;707;508;1637
412150;201604;2847;8231;2463;7455;323;1091;1459;4312;1782;5403
412160;201604;1141;3623;729;2558;166;645;82;251;248;896
412170;201604;4458;13699;3657;12150;975;3519;1244;3935;2219;7454
412175;201604;1386;4617;1200;4207;269;1048;523;1816;792;2864
412180;201604;1603;4906;1198;4130;258;1019;336;1084;594;2103
412190;201604;3147;8944;2382;7586;524;1884;682;2259;1206;4143
412200;201604;2088;6646;1501;5133;287;1058;426;1454;713;2512
412210;201604;675;1847;405;1290;56;206;33;79;89;285
412215;201604;3541;10827;3182;10192;725;2335;1718;5692;2443;8027
412217;201604;1066;3007;941;2786;114;422;622;1729;736;2151
412220;201604;5514;18005;5267;17557;1545;5254;2402;8162;3947;13416
412230;201604;2721;8955;2369;8249;488;1926;633;2039;1121;3965
412240;201604;8595;21796;4987;15124;850;2880;854;2336;1704;5216
412250;201604;1856;5417;1584;4884;396;1309;202;519;598;1828
412260;201604;1296;3569;848;2624;117;409;284;786;401;1195
412265;201604;993;3027;877;2831;222;815;345;1113;567;1928
412270;201604;831;2619;553;1915;96;372;150;479;246;851
412280;201604;604;1863;448;1523;150;555;23;61;173;616
412290;201604;998;2846;765;2406;138;478;235;671;373;1149
412300;201604;1838;5537;1548;4987;393;1381;314;966;707;2347
412310;201604;998;2901;874;2708;113;415;430;1378;543;1793
412320;201604;842;2250;613;1851;105;383;196;582;301;965
412330;201604;1496;4291;1142;3551;190;666;491;1506;681;2172
412340;201604;914;2837;614;2074;78;286;84;242;162;528
412350;201604;2149;6646;1696;5667;337;1192;101;284;438;1476
412360;201604;292;865;181;587;19;75;57;160;76;235
412370;201604;900;2659;671;2238;149;548;123;405;272;953
412380;201604;1480;4734;1220;4093;295;1050;238;781;533;1831
412382;201604;660;1847;458;1430;77;249;93;251;170;500
412385;201604;2344;7244;2085;6655;685;2297;428;1340;1113;3637
412390;201604;2072;5914;1855;5562;480;1572;708;2189;1188;3761
412395;201604;798;2275;632;1999;77;280;343;1049;420;1329
412400;201604;886;2790;753;2495;201;717;155;528;356;1245
412402;201604;1813;5369;1465;4667;339;1212;264;756;603;1968
412405;201604;3514;10167;2201;7251;330;1238;114;327;444;1565
412410;201604;4761;14484;3916;12868;1080;4118;663;2060;1743;6178
412420;201604;355;1047;246;789;39;129;74;197;113;326
412430;201604;527;1469;390;1208;54;179;136;393;190;572
412440;201604;3172;9632;2537;8493;553;2040;692;2335;1245;4375
412450;201604;303;969;231;779;34;107;17;43;51;150
412460;201604;712;2202;588;1929;162;575;107;340;269;915
412470;201604;1816;6176;1553;5496;513;1910;308;1144;821;3054
412480;201604;1125;3387;817;2637;130;447;91;220;221;667
412490;201604;854;2539;723;2275;135;438;191;586;326;1024
412500;201604;1910;5491;1581;4837;289;1008;358;950;647;1958
412510;201604;2198;7145;1817;6225;551;2058;503;1675;1054;3733
412520;201604;1482;4182;1109;3424;273;888;191;545;464;1433
412530;201604;591;1734;456;1420;88;283;91;267;179;550
412535;201604;702;2046;474;1508;103;348;98;286;201;634
412540;201604;1217;3493;961;2984;129;471;266;814;395;1285
412545;201604;752;2145;561;1727;93;326;154;391;247;717
412550;201604;28275;84881;19795;65882;4390;15604;3712;11638;8102;27242
412555;201604;257;776;175;583;30;100;35;99;65;199
412560;201604;5106;15592;3983;13186;727;2864;1067;3367;1794;6231
412570;201604;4121;12078;2800;9228;613;2263;428;1427;1041;3690
412575;201604;851;2606;660;2147;131;483;170;496;301;979
412580;201604;1188;3300;852;2652;140;462;262;755;402;1217
412590;201604;407;1191;268;878;53;192;67;213;120;405
412600;201604;1383;4191;1061;3484;215;770;260;790;475;1560
412610;201604;718;2139;462;1475;112;373;108;312;220;685
412620;201604;1188;3778;943;3246;217;867;130;379;347;1246
412625;201604;9528;27292;7206;22756;1410;4798;815;2426;2225;7224
412627;201604;907;2822;643;2204;195;737;50;158;245;895
412630;201604;3224;10176;2592;8791;513;1780;717;2350;1230;4130
412635;201604;466;1371;323;1054;68;228;12;23;80;251
412640;201604;882;2643;591;1969;83;281;38;110;121;391
412650;201604;1676;4994;1407;4474;273;996;391;1121;664;2117
412660;201604;2666;7697;2107;6563;402;1392;394;1079;796;2471
412665;201604;627;1639;351;1095;88;282;65;192;153;474
412667;201604;1642;4754;1284;4040;280;945;281;807;561;1752
412670;201604;533;1662;412;1409;102;392;63;196;165;588
412680;201604;1316;3940;824;2839;134;507;152;459;286;966
412690;201604;768;2312;578;1899;161;557;99;319;260;876
412700;201604;1802;5488;1509;5036;511;1947;377;1197;888;3144
412710;201604;6780;21294;5739;19183;1199;4487;1265;3913;2464;8400
412720;201604;1346;4147;955;3188;152;551;160;440;312;991
412730;201604;2030;6094;1233;4254;228;843;106;320;334;1163
412740;201604;1367;4342;1035;3611;228;889;134;510;362;1399
412750;201604;3938;11989;3510;11276;467;1801;2129;6723;2596;8524
412760;201604;2299;7337;2158;7084;393;1498;1224;3890;1617;5388
412770;201604;10766;29481;6185;19812;841;2946;988;2782;1829;5728
412780;201604;1224;3812;1055;3464;231;825;348;1101;579;1926
412785;201604;2279;6466;1707;5298;486;1567;692;2175;1178;3742
412788;201604;1362;4352;1191;4000;295;1122;332;1010;627;2132
412790;201604;1094;3257;808;2646;152;564;156;418;308;982
412795;201604;900;2507;719;2155;140;439;247;737;387;1176
412796;201604;2652;8163;2432;7756;579;2059;901;2686;1480;4745
412800;201604;2935;8440;2305;7089;360;1225;790;2319;1150;3544
412810;201604;10963;29721;6428;20039;827;2898;1309;3346;2136;6244
412820;201604;7157;20905;5315;17304;1179;4090;1175;3868;2354;7958
412830;201604;336;1043;266;877;44;168;63;175;107;343
412840;201604;1750;5013;1409;4315;254;849;261;779;515;1628
412850;201604;2782;8187;2303;7377;455;1694;768;2291;1223;3985
412853;201604;1662;4789;1475;4417;156;551;785;2204;941;2755
412855;201604;1447;4171;1127;3465;233;777;278;748;511;1525
412860;201604;1168;3347;956;2966;239;820;374;1142;613;1962
412862;201604;740;1921;506;1504;68;228;140;399;208;627
412863;201604;1153;3930;1123;3877;181;699;755;2552;936;3251
412865;201604;678;2075;517;1714;113;391;163;567;276;958
412870;201604;885;2502;699;2186;251;889;109;299;360;1188
412880;201604;868;2511;679;2140;150;523;78;204;228;727
420005;201604;530;1580;331;1130;51;180;107;364;158;544
420010;201604;3056;8676;2484;7876;361;1181;1659;5378;2020;6559
420020;201604;742;2408;425;1573;40;175;39;141;79;316
420030;201604;501;1302;255;841;45;180;28;88;73;268
420040;201604;709;2253;449;1683;83;339;28;89;111;428
420050;201604;675;1966;456;1508;127;448;145;486;272;934
420055;201604;204;620;117;409;20;76;19;66;39;142
420060;201604;241;784;164;598;23;106;30;82;53;188
420070;201604;1340;4225;1017;3440;166;647;372;1232;538;1879
420075;201604;170;449;89;271;16;54;15;38;31;92
420080;201604;589;1848;471;1619;147;544;112;386;259;930
420090;201604;470;1556;327;1240;78;316;51;204;129;520
420100;201604;1182;3682;1052;3503;240;833;579;1945;819;2778
420110;201604;320;1086;289;1013;65;240;102;358;167;598
420120;201604;261;910;210;792;65;272;33;115;98;387
420125;201604;250;926;222;864;59;242;87;319;146;561
420127;201604;541;1583;206;749;47;184;20;69;67;253
420130;201604;1800;6049;1461;5374;345;1400;290;958;635;2358
420140;201604;4452;13085;3156;10574;675;2500;407;1215;1082;3715
420150;201604;719;2009;435;1453;73;261;146;460;219;721
420160;201604;272;747;164;536;26;87;46;148;72;235
420165;201604;212;659;128;443;24;89;23;75;47;164
420170;201604;192;585;129;461;40;163;13;40;53;203
420180;201604;404;1237;225;817;38;143;42;145;80;288
420190;201604;455;1293;236;804;35;137;14;41;49;178
420195;201604;1292;3781;1055;3394;235;804;309;970;544;1774
420200;201604;2451;7662;1444;5341;246;1058;145;496;391;1554
420205;201604;943;3085;796;2827;175;679;409;1466;584;2145
420207;201604;1516;4430;1057;3497;286;1077;204;624;490;1701
420208;201604;570;1577;313;1120;98;382;59;234;157;616
420209;201604;316;963;206;703;32;121;76;252;108;373
420210;201604;1654;5039;1098;4120;272;1211;342;1228;614;2439
420213;201604;776;2790;732;2686;160;626;404;1497;564;2123
420215;201604;316;1021;211;770;49;189;16;68;65;257
420220;201604;151;529;122;465;29;119;28;96;57;215
420230;201604;4179;12098;3078;10147;578;2280;1172;3698;1750;5978
420240;201604;10488;29037;6576;21648;1033;4079;2540;7527;3573;11606
420243;201604;588;1784;466;1540;89;320;162;520;251;840
420245;201604;1100;3351;760;2621;115;448;224;715;339;1163
420250;201604;522;1672;471;1573;128;505;188;593;316;1098
420253;201604;489;1311;375;1156;56;181;211;670;267;851
420257;201604;307;851;194;643;36;120;92;308;128;428
420260;201604;1203;3783;985;3383;200;765;381;1300;581;2065
420270;201604;590;1801;200;718;30;124;46;143;76;267
420280;201604;2215;6008;1362;4467;268;964;439;1378;707;2342
420285;201604;155;462;75;283;10;43;3;15;13;58
420287;201604;515;1540;426;1399;125;423;130;436;255;859
420290;201604;6131;18165;4108;13542;748;2632;1128;3472;1876;6104
420300;201604;6566;19723;4281;14842;857;3235;639;2140;1496;5375
420310;201604;758;2087;674;1955;107;341;472;1335;579;1676
420315;201604;943;2997;733;2577;202;769;237;814;439;1583
420320;201604;4696;14398;3822;12850;1039;3810;1332;4475;2371;8285
420325;201604;235;794;209;730;40;156;75;249;115;405
420330;201604;960;3327;703;2677;165;692;155;543;320;1235
420340;201604;1420;4384;1077;3604;189;716;113;328;302;1044
420350;201604;1446;4316;1063;3573;278;987;363;1219;641;2206
420360;201604;3022;9152;1875;6654;379;1536;140;414;519;1950
420370;201604;1818;5196;1413;4487;168;554;985;3109;1153;3663
420380;201604;5005;15362;3390;11656;783;2921;725;2450;1508;5371
420390;201604;1385;3846;717;2433;112;447;109;296;221;743
420395;201604;1371;4224;952;3275;119;483;117;353;236;836
420400;201604;1248;3593;869;2858;206;788;190;550;396;1338
420410;201604;746;1998;518;1623;111;394;293;897;404;1291
420415;201604;455;1423;329;1121;93;339;89;295;182;634
420417;201604;707;2263;585;1967;101;352;283;958;384;1310
420419;201604;365;1104;238;853;79;320;17;67;96;387
420420;201604;10518;31621;8369;27504;2835;10327;1846;5586;4681;15913
420425;201604;1206;3249;831;2549;70;282;362;1035;432;1317
420430;201604;3244;9825;2061;7040;425;1566;588;2047;1013;3613
420435;201604;293;858;178;602;39;145;72;232;111;377
420440;201604;892;2768;507;1774;207;776;85;281;292;1057
420445;201604;366;1079;254;813;52;171;86;272;138;443
420450;201604;795;2406;530;1825;109;403;97;318;206;721
420455;201604;1908;5693;1632;5226;282;1123;756;2297;1038;3420
420460;201604;8557;24828;6447;21114;1403;5286;2285;7092;3688;12378
420470;201604;1052;2838;644;2032;143;516;176;510;319;1026
420475;201604;122;357;64;220;16;54;7;23;23;77
420480;201604;4802;13909;3510;11491;975;3444;625;2032;1600;5476
420490;201604;646;1675;348;1172;78;294;73;245;151;539
420500;201604;1525;4836;1165;4129;346;1374;366;1292;712;2666
420510;201604;82;316;71;300;16;74;33;135;49;209
420515;201604;106;356;84;312;13;57;16;59;29;116
420517;201604;830;2586;731;2419;142;522;383;1223;525;1745
420519;201604;550;1437;393;1166;63;200;103;288;166;488
420520;201604;644;1606;391;1236;79;262;120;315;199;577
420530;201604;1038;3441;762;2813;178;758;157;520;335;1278
420535;201604;256;737;135;481;33;124;3;12;36;136
420540;201604;19851;56414;14325;44935;3318;11387;3430;9324;6748;20711
420543;201604;387;1024;300;885;23;81;184;584;207;665
420545;201604;1504;4726;1205;4071;267;1009;360;1141;627;2150
420550;201604;4061;12790;2968;10532;730;3080;486;1575;1216;4655
420555;201604;355;1071;263;879;64;241;77;242;141;483
420560;201604;522;1502;385;1254;66;240;189;597;255;837
420570;201604;2091;6619;1619;5562;406;1608;515;1622;921;3230
420580;201604;1420;4342;1133;3855;276;1060;448;1497;724;2557
420590;201604;3094;9276;2046;6864;378;1389;292;865;670;2254
420600;201604;858;2805;779;2646;118;421;433;1531;551;1952
420610;201604;503;1533;277;1020;67;287;61;219;128;506
420620;201604;543;1664;482;1542;119;411;138;446;257;857
420630;201604;985;3018;699;2352;144;512;231;732;375;1244
420640;201604;775;2340;383;1403;78;334;19;58;97;392
420650;201604;2505;7251;1593;5387;257;989;381;1191;638;2180
420660;201604;455;1306;323;1033;60;214;102;317;162;531
420665;201604;688;1938;443;1467;66;241;116;342;182;583
420670;201604;1608;4739;1130;3748;212;825;276;836;488;1661
420675;201604;203;648;144;509;29;101;38;133;67;234
420680;201604;499;1176;287;849;42;138;94;267;136;405
420690;201604;842;2888;627;2301;109;427;99;305;208;732
420700;201604;3096;9064;2359;7599;475;1724;688;2071;1163;3795
420710;201604;575;1932;437;1628;112;470;132;475;244;945
420720;201604;1702;4828;1310;4313;340;1192;642;2118;982;3310
420730;201604;3182;9495;2573;8422;613;2195;972;3055;1585;5250
420740;201604;824;2536;678;2270;223;827;241;739;464;1566
420750;201604;2293;7316;1656;5822;258;1053;472;1507;730;2560
420757;201604;102;243;44;153;9;41;18;60;27;101
420760;201604;356;1104;199;669;37;135;36;102;73;237
420765;201604;559;1768;294;1099;52;226;52;178;104;404
420768;201604;1151;3995;895;3451;332;1315;280;1118;612;2433
420770;201604;627;1826;342;1256;75;322;63;231;138;553
420775;201604;626;1869;370;1246;81;288;54;160;135;448
420780;201604;1509;4517;908;3060;172;588;128;395;300;983
420785;201604;271;824;194;635;29;102;43;131;72;233
420790;201604;1259;4298;997;3694;286;1167;335;1164;621;2331
420800;201604;846;2414;412;1401;94;344;86;288;180;632
420810;201604;1999;6744;1579;5827;470;1974;312;1042;782;3016
420820;201604;7913;23441;5412;19189;1321;5304;1193;4155;2514;9459
420830;201604;2514;7944;2062;7094;612;2285;695;2387;1307;4672
420840;201604;988;2914;494;1778;110;469;73;225;183;694
420845;201604;1294;3893;926;3244;248;1008;184;608;432;1616
420850;201604;1611;5000;974;3638;206;884;61;205;267;1089
420860;201604;448;1257;273;925;71;277;70;239;141;516
420870;201604;1120;3101;874;2716;293;1059;224;590;517;1649
420880;201604;999;3304;771;2720;146;561;129;415;275;976
420890;201604;10227;26928;5166;16947;827;2966;1147;3295;1974;6261
420895;201604;243;657;131;420;38;120;12;30;50;150
420900;201604;1833;5164;1171;3874;222;855;290;882;512;1737
420910;201604;23236;68756;15788;53883;2859;11041;4392;13897;7251;24938
420915;201604;551;2181;405;1741;87;401;163;653;250;1054
420917;201604;469;1450;212;717;39;154;75;213;114;367
420920;201604;186;518;74;256;10;38;14;52;24;90
420930;201604;17553;50459;13717;44001;2985;10680;4963;15413;7948;26093
420940;201604;2798;8440;2146;7121;562;2059;167;468;729;2527
420945;201604;202;625;132;463;24;105;30;90;54;195
420950;201604;614;1725;287;1062;38;191;41;139;79;330
420960;201604;895;2562;721;2260;143;494;296;881;439;1375
420970;201604;2463;7733;2030;6941;606;2316;526;1753;1132;4069
420980;201604;463;1342;341;1140;117;439;110;400;227;839
420985;201604;496;1415;232;837;42;190;46;138;88;328
420990;201604;884;2373;490;1650;80;303;93;255;173;558
421000;201604;555;1855;355;1340;68;273;55;176;123;449
421003;201604;718;1945;272;908;29;104;30;56;59;160
421005;201604;155;478;117;413;22;87;57;206;79;293
421010;201604;5278;14953;3653;12061;890;3289;687;2014;1577;5303
421020;201604;474;1465;367;1284;38;134;197;723;235;857
421030;201604;716;2614;647;2433;183;750;101;369;284;1119
421040;201604;881;2241;557;1737;95;356;266;782;361;1138
421050;201604;1646;4645;976;3239;171;624;196;563;367;1187
421055;201604;195;564;108;352;25;83;21;57;46;140
421060;201604;493;1667;328;1204;69;286;107;379;176;665
421070;201604;693;2215;437;1567;100;404;58;191;158;595
421080;201604;513;1546;432;1422;88;279;266;890;354;1169
421085;201604;546;1459;301;1013;58;224;84;296;142;520
421090;201604;404;1129;200;672;24;94;62;185;86;279
421100;201604;914;2494;493;1587;126;410;57;176;183;586
421105;201604;1455;4453;1179;3979;264;954;397;1412;661;2366
421110;201604;981;3556;892;3352;315;1257;186;643;501;1900
421120;201604;1297;4147;872;3108;121;503;209;686;330;1189
421125;201604;402;1111;297;928;82;299;91;257;173;556
421130;201604;3015;9855;2559;8998;848;3307;741;2613;1589;5920
421140;201604;342;994;253;812;50;160;81;243;131;403
421145;201604;553;1746;342;1179;50;173;102;345;152;518
421150;201604;582;1698;415;1417;77;293;155;515;232;808
421160;201604;1207;3307;572;1880;110;396;170;527;280;923
421165;201604;278;947;222;787;33;118;89;322;122;440
421170;201604;1293;3779;1039;3382;207;741;591;1909;798;2650
421175;201604;1212;3406;880;2867;191;786;295;842;486;1628
421180;201604;568;1603;298;1027;61;242;47;155;108;397
421185;201604;395;1089;278;866;45;124;127;423;172;547
421187;201604;273;810;203;666;35;118;85;263;120;381
421189;201604;409;1256;347;1126;73;258;102;306;175;564
421190;201604;11520;32900;6989;23887;1366;5195;905;2926;2271;8121
421200;201604;897;2976;761;2699;164;625;205;682;369;1307
421205;201604;243;736;182;620;37;148;40;115;77;263
421210;201604;1487;4533;1112;3659;258;879;271;897;529;1776
421220;201604;1919;6481;1662;5909;477;1908;269;839;746;2747
421223;201604;513;1643;391;1383;101;379;111;389;212;768
421225;201604;1063;3366;898;3034;195;745;331;1109;526;1854
421227;201604;786;2539;697;2396;141;533;389;1304;530;1837
421230;201604;433;1416;380;1322;96;377;160;531;256;908
421240;201604;433;1387;252;919;31;137;38;131;69;268
421250;201604;1696;4886;1101;3836;286;1079;216;757;502;1836
421260;201604;353;1010;98;356;22;80;18;61;40;141
421265;201604;703;2164;613;2017;127;457;304;971;431;1428
421270;201604;807;2159;416;1374;81;286;75;280;156;566
421280;201604;1558;4898;1247;4377;352;1410;401;1350;753;2760
421290;201604;1189;3310;704;2289;120;426;104;296;224;722
421300;201604;302;918;235;777;68;257;88;271;156;528
421310;201604;230;722;180;606;35;128;53;165;88;293
421315;201604;358;1030;192;681;41;148;15;52;56;200
421320;201604;536;1700;360;1264;55;210;46;107;101;317
421330;201604;541;1759;413;1516;129;526;72;261;201;787
421335;201604;507;1666;417;1488;98;400;81;303;179;703
421340;201604;1745;4994;1391;4429;194;756;784;2471;978;3227
421350;201604;957;3153;800;2814;151;620;365;1218;516;1838
421360;201604;2967;8535;1892;6456;374;1488;504;1570;878;3058
421370;201604;673;2232;515;1882;142;587;146;515;288;1102
421380;201604;963;2727;794;2402;125;434;377;1108;502;1542
421390;201604;141;423;72;255;10;37;31;116;41;153
421400;201604;258;841;173;672;45;183;44;155;89;338
421410;201604;332;942;214;717;23;76;93;311;116;387
421415;201604;347;1138;162;608;37;146;25;85;62;231
421420;201604;856;2589;622;2063;110;396;179;564;289;960
421430;201604;238;737;180;621;28;105;37;134;65;239
421440;201604;824;2386;546;1876;125;492;210;701;335;1193
421450;201604;492;1518;305;1120;60;245;29;111;89;356
421460;201604;633;1725;331;1163;54;223;66;238;120;461
421470;201604;429;1422;337;1217;96;383;97;333;193;716
421480;201604;3023;8499;1879;6423;471;1891;295;830;766;2721
421490;201604;276;840;128;496;26;122;16;51;42;173
421500;201604;2150;7287;1783;6525;555;2285;220;767;775;3052
421505;201604;354;1192;308;1086;70;250;137;488;207;738
421507;201604;525;1577;335;1171;61;218;89;329;150;547
421510;201604;172;554;148;513;23;103;76;223;99;326
421520;201604;876;2318;593;1755;67;248;246;638;313;886
421530;201604;408;1244;244;879;41;191;60;212;101;403
421535;201604;680;2003;372;1368;56;242;150;517;206;759
421540;201604;320;881;251;767;53;179;88;243;141;422
421545;201604;813;2597;594;2169;130;537;131;467;261;1004
421550;201604;1940;6218;1624;5667;462;1811;457;1521;919;3332
421555;201604;327;954;114;404;19;74;14;45;33;119
421560;201604;208;640;94;329;18;68;17;58;35;126
421565;201604;839;2435;732;2283;253;884;286;895;539;1779
421567;201604;646;2385;572;2215;297;1183;113;435;410;1618
421568;201604;507;1562;335;1158;70;244;88;309;158;553
421569;201604;231;687;111;399;19;74;20;65;39;139
421570;201604;1350;4047;749;2612;175;684;120;388;295;1072
421575;201604;445;1467;390;1356;68;255;231;810;299;1065
421580;201604;3001;9457;2261;7823;545;2101;526;1640;1071;3741
421590;201604;217;671;176;596;19;59;93;311;112;370
421600;201604;548;1647;417;1367;98;347;79;225;177;572
421605;201604;609;1858;437;1538;85;363;109;353;194;716
421610;201604;1387;3770;1049;3196;150;513;508;1493;658;2006
421620;201604;4315;13072;2902;10150;792;2959;806;2822;1598;5781
421625;201604;372;1027;152;523;22;76;15;57;37;133
421630;201604;2928;8716;1659;5689;362;1360;205;646;567;2006
421635;201604;243;725;128;430;15;59;39;105;54;164
421640;201604;1020;3056;740;2487;158;552;296;981;454;1533
421650;201604;2023;6505;1573;5493;396;1597;191;548;587;2145
421660;201604;7563;24373;6155;21540;1416;5560;1798;5826;3214;11386
421670;201604;1058;3248;736;2530;199;780;196;638;395;1418
421680;201604;1126;3623;923;3193;303;1112;164;540;467;1652
421690;201604;1619;5275;1236;4421;244;960;112;361;356;1321
421700;201604;498;1598;278;1029;45;184;60;178;105;362
421710;201604;221;736;112;409;27;102;28;92;55;194
421715;201604;260;690;138;440;35;125;34;91;69;216
421720;201604;1863;5488;1165;4050;291;1128;179;539;470;1667
421725;201604;105;346;95;323;26;94;21;66;47;160
421730;201604;582;1674;289;994;45;166;47;137;92;303
421740;201604;732;2326;503;1789;111;460;76;219;187;679
421750;201604;985;2613;601;1863;113;395;248;698;361;1093
421755;201604;321;929;186;606;39;138;56;176;95;314
421760;201604;752;2316;400;1416;79;312;109;349;188;661
421770;201604;2893;8731;2197;7333;555;1939;685;2368;1240;4307
421775;201604;490;1426;341;1158;63;242;98;313;161;555
421780;201604;1205;4047;923;3386;220;899;256;888;476;1787
421790;201604;774;2100;441;1545;110;442;118;384;228;826
421795;201604;347;1017;220;704;37;138;56;175;93;313
421800;201604;2659;7907;1992;6645;431;1652;729;2258;1160;3910
421810;201604;597;1864;422;1503;109;421;41;144;150;565
421820;201604;1041;3014;647;2195;107;385;118;347;225;732
421825;201604;1442;4612;1342;4408;162;638;911;2879;1073;3517
421830;201604;2395;8209;2129;7659;483;1984;864;2945;1347;4929
421835;201604;156;461;112;397;21;96;69;233;90;329
421840;201604;278;899;202;727;50;211;52;167;102;378
421850;201604;398;1244;237;837;44;196;43;140;87;336
421860;201604;325;983;212;756;35;136;44;132;79;268
421870;201604;3836;10782;2670;8498;795;2747;420;1312;1215;4059
421875;201604;420;1255;191;705;35;150;14;47;49;197
421880;201604;860;2633;645;2175;135;517;140;449;275;966
421885;201604;294;951;236;850;80;315;76;271;156;586
421890;201604;852;2899;737;2666;238;1012;233;777;471;1789
421895;201604;361;1147;320;1075;75;266;168;569;243;835
421900;201604;934;2587;575;1846;148;510;140;402;288;912
421910;201604;501;1592;343;1231;70;297;47;142;117;439
421915;201604;504;1506;313;1061;60;206;65;202;125;408
421917;201604;560;1614;401;1376;139;554;106;341;245;895
421920;201604;755;2099;478;1725;251;954;97;352;348;1306
421930;201604;3101;8148;1699;5678;372;1363;226;671;598;2034
421935;201604;648;2131;475;1758;103;449;145;497;248;946
421940;201604;258;861;133;489;18;76;15;39;33;115
421950;201604;3581;9780;1706;5777;379;1420;202;681;581;2101
421960;201604;195;577;145;480;31;113;30;85;61;198
421970;201604;2200;6095;1370;4376;427;1448;342;1001;769;2449
421985;201604;497;1282;279;861;40;155;86;263;126;418
422000;201604;1133;3384;953;3048;247;866;362;1187;609;2053
430003;201604;799;2329;613;2015;164;607;159;506;323;1113
430005;201604;324;963;237;802;42;157;102;330;144;487
430010;201604;2141;5758;1600;4847;389;1258;648;1970;1037;3228
430020;201604;713;1768;594;1613;80;236;359;943;439;1179
430030;201604;1020;2687;750;2195;252;807;123;330;375;1137
430040;201604;11067;28906;8403;24263;2240;7054;1288;3523;3528;10577
430045;201604;694;1865;520;1514;99;302;229;654;328;956
430047;201604;288;692;154;465;21;59;58;176;79;235
430050;201604;1246;3334;742;2329;135;446;165;487;300;933
430055;201604;302;810;160;498;25;90;65;192;90;282
430057;201604;72;166;34;96;5;12;6;9;11;21
430060;201604;16235;51595;14012;47786;3861;14156;5452;18837;9313;32993
430063;201604;992;2925;805;2539;192;636;391;1269;583;1905
430064;201604;1375;4108;1109;3620;273;917;393;1309;666;2226
430066;201604;166;395;119;324;8;28;67;175;75;203
430070;201604;595;1590;178;577;24;92;24;62;48;154
430080;201604;670;1878;405;1351;85;310;111;333;196;643
430085;201604;875;2282;571;1741;111;373;198;619;309;992
430087;201604;940;2872;866;2735;124;474;525;1548;649;2022
430090;201604;894;2342;353;1143;34;122;55;190;89;312
430100;201604;828;2185;426;1350;100;335;112;307;212;642
430105;201604;976;2860;656;2258;167;642;197;666;364;1308
430107;201604;259;844;188;643;35;128;44;139;79;267
430110;201604;1888;5394;1549;4871;392;1286;675;2071;1067;3357
430120;201604;1758;5183;1295;4225;269;916;569;1836;838;2752
430130;201604;3843;9951;3298;9168;794;2362;1303;3563;2097;5925
430140;201604;1203;3647;805;2742;220;776;230;782;450;1558
430150;201604;744;1990;504;1540;117;378;128;396;245;774
430155;201604;402;1108;222;721;31;120;61;194;92;314
430160;201604;16996;48993;14850;45416;3267;10998;6280;19271;9547;30269
430163;201604;1869;5491;1518;4880;237;856;741;2370;978;3226
430165;201604;456;1126;133;450;15;49;19;57;34;106
430170;201604;946;2662;371;1329;46;164;32;97;78;261
430175;201604;918;2847;753;2462;205;628;276;992;481;1620
430180;201604;839;2309;682;2056;149;497;332;971;481;1468
430185;201604;586;1518;333;1042;52;175;95;239;147;414
430187;201604;652;1926;508;1638;115;424;161;483;276;907
430190;201604;1693;5001;1474;4578;282;965;811;2496;1093;3461
430192;201604;197;598;93;303;6;20;18;51;24;71
430195;201604;368;1125;91;313;9;31;4;11;13;42
430200;201604;1404;4473;1202;4060;347;1236;277;919;624;2155
430205;201604;561;1614;430;1371;43;167;299;956;342;1123
430210;201604;6205;16500;3675;11366;594;2021;839;2313;1433;4334
430215;201604;363;1002;247;752;41;131;99;285;140;416
430220;201604;752;1893;268;909;42;170;43;141;85;311
430222;201604;276;837;217;710;33;132;100;304;133;436
430223;201604;346;977;295;901;67;210;167;533;234;743
430225;201604;35;86;15;43;5;14;5;15;10;29
430230;201604;1647;4892;1585;4828;201;470;1344;4283;1545;4753
430235;201604;279;910;226;785;49;185;66;212;115;397
430237;201604;524;1360;381;1119;40;142;241;678;281;820
430240;201604;993;2588;676;2056;103;379;320;920;423;1299
430245;201604;866;2667;655;2228;173;602;257;924;430;1526
430250;201604;1203;3421;1053;3180;365;1148;159;489;524;1637
430258;201604;163;455;120;380;10;34;52;172;62;206
430260;201604;784;2229;560;1789;60;197;300;1010;360;1207
430265;201604;272;832;210;707;42;132;9;34;51;166
430270;201604;2953;8196;2538;7507;347;1180;1458;4137;1805;5317
430280;201604;4692;12643;3784;11078;936;2808;1529;4505;2465;7313
430290;201604;2444;6410;2236;6119;146;412;1916;5264;2062;5676
430300;201604;9114;26830;7568;23912;1815;6197;3096;9995;4911;16192
430310;201604;6352;19085;4914;16350;1162;4229;1700;5325;2862;9554
430320;201604;849;2479;544;1826;100;290;241;867;341;1157
430330;201604;669;1796;519;1514;141;392;203;574;344;966
430340;201604;704;1783;381;1254;66;236;200;644;266;880
430350;201604;6208;18924;5294;17015;1838;6137;1596;5029;3434;11166
430355;201604;386;952;152;464;23;77;19;54;42;131
430360;201604;1057;2781;871;2457;174;567;349;897;523;1464
430367;201604;274;720;166;518;47;170;50;146;97;316
430370;201604;545;1522;363;1152;94;324;71;194;165;518
430380;201604;865;2234;486;1570;139;490;128;419;267;909
430390;201604;3944;11058;2645;8439;498;1709;405;1250;903;2959
430400;201604;1410;3364;1001;2717;314;878;338;871;652;1749
430410;201604;623;1671;447;1374;84;283;207;631;291;914
430420;201604;3608;10451;2841;8786;749;2374;1034;3156;1783;5530
430430;201604;758;2019;475;1503;130;448;110;353;240;801
430435;201604;2024;5473;1525;4587;385;1235;531;1602;916;2837
430440;201604;3964;12487;3110;10529;626;2199;1403;4950;2029;7149
430450;201604;7572;20953;6052;18095;1962;6224;1339;4025;3301;10249
430460;201604;28207;83141;21743;71665;5816;21067;6034;19532;11850;40599
430461;201604;510;1362;165;531;23;76;37;115;60;191
430462;201604;277;790;185;633;33;130;26;90;59;220
430463;201604;4118;13068;3550;12025;769;2796;1587;5511;2356;8307
430465;201604;645;1730;537;1553;165;521;262;735;427;1256
430466;201604;3570;9817;3123;9133;630;1995;1686;4795;2316;6790
430467;201604;509;1505;438;1374;88;296;179;535;267;831
430468;201604;1406;3925;1207;3630;327;1060;449;1293;776;2353
430469;201604;463;1235;59;204;7;28;9;22;16;50
430470;201604;7613;20312;5414;16649;1530;5088;843;2529;2373;7617
430471;201604;582;1918;509;1763;154;528;115;432;269;960
430480;201604;969;2530;492;1561;73;257;112;336;185;593
430485;201604;213;586;98;312;13;43;18;48;31;91
430490;201604;316;894;208;670;46;159;90;291;136;450
430495;201604;374;1110;243;835;46;172;51;152;97;324
430500;201604;1190;3299;963;2925;251;854;416;1241;667;2095
430510;201604;20517;59871;16545;52425;5342;18547;4355;12824;9697;31371
430511;201604;403;1236;177;625;27;104;17;43;44;147
430512;201604;1159;2976;982;2668;246;706;299;852;545;1558
430513;201604;796;2072;471;1397;99;307;168;490;267;797
430515;201604;475;1376;344;1107;50;169;153;513;203;682
430517;201604;1173;3690;973;3279;187;646;509;1762;696;2408
430520;201604;1539;4240;1053;3261;259;878;284;794;543;1672
430530;201604;1107;2978;538;1726;67;263;128;368;195;631
430535;201604;2239;6772;1714;5739;375;1385;577;1873;952;3258
430537;201604;481;1531;414;1396;39;124;294;1009;333;1133
430540;201604;740;1644;491;1305;92;256;273;728;365;984
430543;201604;486;1264;424;1200;79;232;297;861;376;1093
430544;201604;654;2090;553;1884;109;396;274;920;383;1316
430545;201604;1295;4110;1111;3885;378;1412;435;1558;813;2970
430550;201604;630;1821;379;1269;83;301;79;257;162;558
430558;201604;90;257;46;156;9;41;10;33;19;74
430560;201604;379;911;185;563;13;45;59;164;72;209
430570;201604;1108;2849;708;2060;169;581;259;627;428;1208
430580;201604;1255;3122;762;2314;157;538;294;902;451;1440
430583;201604;166;459;53;175;3;12;5;19;8;31
430585;201604;334;866;215;617;51;174;80;195;131;369
430587;201604;190;596;163;540;49;171;42;150;91;321
430590;201604;1215;3466;1133;3325;154;506;781;2249;935;2755
430593;201604;25;95;23;88;6;28;9;30;15;58
430595;201604;260;717;79;268;8;34;6;16;14;50
430597;201604;336;978;242;756;28;95;59;157;87;252
430600;201604;2093;5598;1180;3574;215;696;349;1006;564;1702
430605;201604;1351;4055;1061;3462;224;857;417;1361;641;2218
430607;201604;763;1853;566;1562;74;214;344;984;418;1198
430610;201604;8206;21882;6318;18963;1741;5646;1634;4852;3375;10498
430613;201604;275;658;119;353;21;59;21;49;42;108
430620;201604;704;2018;564;1727;155;502;200;582;355;1084
430630;201604;432;1343;217;738;37;123;22;66;59;189
430632;201604;698;1945;362;1142;54;190;124;340;178;530
430635;201604;598;1721;459;1430;88;314;244;731;332;1045
430637;201604;484;1374;426;1261;63;220;251;700;314;920
430640;201604;1624;4340;741;2450;69;221;27;54;96;275
430642;201604;463;1228;289;906;58;187;104;329;162;516
430645;201604;274;641;108;311;14;39;25;71;39;110
430650;201604;1829;5892;1553;5341;337;1195;826;2898;1163;4093
430655;201604;161;408;137;360;20;72;74;162;94;234
430660;201604;5676;15971;4525;13950;1087;3669;1765;5401;2852;9070
430670;201604;501;1453;457;1376;36;115;346;1072;382;1187
430673;201604;726;1723;345;1039;74;221;96;294;170;515
430675;201604;259;758;101;340;13;52;40;131;53;183
430676;201604;3492;10431;2870;9285;747;2594;828;2732;1575;5326
430680;201604;1198;3421;744;2453;136;457;159;468;295;925
430690;201604;4334;12150;3433;10406;1081;3416;797;2409;1878;5825
430692;201604;275;916;205;780;18;87;137;502;155;589
430693;201604;1287;3562;849;2669;167;606;180;523;347;1129
430695;201604;578;1602;391;1224;72;248;152;445;224;693
430697;201604;482;1360;357;1133;96;318;124;404;220;722
430700;201604;10293;26329;5140;16557;849;3119;305;902;1154;4021
430705;201604;275;843;236;766;84;294;54;160;138;454
430710;201604;1775;4513;1331;3767;277;876;497;1419;774;2295
430720;201604;896;2178;575;1712;133;426;179;534;312;960
430730;201604;1624;4235;1099;3388;257;774;410;1365;667;2139
430740;201604;549;1533;313;1057;74;274;50;173;124;447
430745;201604;506;1435;260;834;39;142;32;92;71;234
430750;201604;1569;4300;1236;3747;228;775;647;1913;875;2688
430755;201604;503;1350;333;1001;30;94;132;380;162;474
430760;201604;3021;7333;2050;5937;459;1583;725;2175;1184;3758
430770;201604;6271;18116;4939;15650;927;3214;2541;7928;3468;11142
430780;201604;2474;6548;1491;4726;281;957;422;1297;703;2254
430781;201604;538;1546;354;1169;69;226;87;296;156;522
430783;201604;546;1336;342;991;61;188;145;387;206;575
430786;201604;72;238;48;178;7;29;11;35;18;64
430790;201604;4703;12784;3290;10001;712;2393;1162;3283;1874;5676
430800;201604;914;2575;615;1906;133;445;199;585;332;1030
430805;201604;547;1520;353;1122;39;119;172;549;211;668
430807;201604;425;1229;286;914;62;232;64;190;126;422
430810;201604;736;1949;293;972;46;175;63;187;109;362
430820;201604;1277;3849;826;2794;169;610;193;650;362;1260
430825;201604;404;1047;154;467;24;62;24;51;48;113
430830;201604;1745;5390;1611;5195;248;882;1030;3290;1278;4172
430840;201604;971;2938;883;2780;229;725;413;1349;642;2074
430843;201604;84;220;41;127;4;15;13;38;17;53
430845;201604;307;930;254;814;108;371;23;58;131;429
430850;201604;2477;7273;2077;6523;496;1715;789;2418;1285;4133
430860;201604;1021;2735;521;1702;128;491;161;484;289;975
430865;201604;635;1671;565;1559;194;563;256;688;450;1251
430870;201604;716;1972;398;1296;97;322;60;152;157;474
430880;201604;1181;3330;836;2651;224;753;205;703;429;1456
430885;201604;245;591;139;431;14;47;93;291;107;338
430890;201604;1773;4690;1257;3795;173;664;327;884;500;1548
430900;201604;2841;7458;2314;6581;479;1615;1049;2774;1528;4389
430905;201604;1055;2992;671;2184;151;518;124;387;275;905
430910;201604;1528;4462;1032;3400;227;836;356;1048;583;1884
430912;201604;471;1332;365;1149;48;171;224;702;272;873
430915;201604;581;1824;403;1482;128;507;88;352;216;859
430920;201604;16122;48695;14220;45169;2809;9943;7886;24298;10695;34241
430925;201604;125;286;55;163;11;36;19;55;30;91
430930;201604;9802;27639;6726;21917;1766;6192;1434;4929;3200;11121
430940;201604;1261;3782;742;2508;166;600;113;359;279;959
430950;201604;994;2728;655;2029;149;519;231;632;380;1151
430955;201604;150;453;73;239;12;46;20;59;32;105
430957;201604;258;848;209;758;48;169;100;392;148;561
430960;201604;1385;3711;1133;3270;267;860;532;1572;799;2432
430965;201604;1519;4294;1301;3936;75;286;1013;3004;1088;3290
430970;201604;510;1395;299;954;49;164;78;240;127;404
430975;201604;598;1932;468;1636;86;317;201;722;287;1039
430980;201604;441;1094;263;829;64;213;80;249;144;462
430990;201604;559;1775;386;1319;73;266;89;292;162;558
430995;201604;603;1743;472;1475;147;488;156;451;303;939
431000;201604;1598;4064;813;2502;127;429;62;165;189;594
431010;201604;2642;7412;1612;5402;272;1010;222;667;494;1677
431020;201604;11202;27398;7217;20454;1708;5019;1708;4759;3416;9778
431030;201604;327;942;159;568;35;137;22;77;57;214
431033;201604;2411;7015;2127;6610;563;1880;1005;3196;1568;5076
431036;201604;202;514;80;268;15;51;14;35;29;86
431040;201604;934;2640;742;2312;154;559;359;1060;513;1619
431041;201604;527;1426;473;1356;153;440;182;550;335;990
431043;201604;478;1356;270;948;115;443;52;155;167;598
431046;201604;111;316;78;247;8;32;23;68;31;100
431050;201604;1682;4271;1278;3596;284;858;644;1789;928;2647
431053;201604;594;1905;483;1661;142;529;99;348;241;877
431055;201604;664;1770;615;1691;64;166;459;1279;523;1445
431057;201604;373;1091;227;769;43;157;56;172;99;329
431060;201604;5570;16431;4951;15485;1550;4941;1774;5762;3324;10703
431065;201604;553;1575;411;1299;74;261;156;464;230;725
431070;201604;706;2010;418;1364;89;298;67;181;156;479
431075;201604;291;879;206;693;36;131;58;209;94;340
431080;201604;637;1937;473;1551;89;328;127;396;216;724
431085;201604;841;2289;653;1890;105;319;346;998;451;1317
431087;201604;589;1657;503;1487;58;164;334;1005;392;1169
431090;201604;518;1272;249;752;57;183;48;138;105;321
431100;201604;3664;10147;2953;8948;758;2488;930;2765;1688;5253
431110;201604;1547;4081;1148;3298;262;789;396;1054;658;1843
431112;201604;564;1826;521;1742;134;453;247;813;381;1266
431113;201604;507;1449;399;1247;101;331;111;359;212;690
431115;201604;1382;3975;1207;3685;229;736;673;2065;902;2801
431120;201604;2656;8087;2072;6952;640;2467;635;1919;1275;4386
431123;201604;457;1308;305;1016;59;201;160;540;219;741
431125;201604;1386;4159;1005;3356;294;978;216;799;510;1777
431127;201604;261;701;63;209;4;9;8;19;12;28
431130;201604;3314;9452;2404;7755;465;1650;757;2419;1222;4069
431140;201604;4802;11790;2704;8285;393;1327;678;1854;1071;3181
431142;201604;452;1331;392;1219;40;127;259;828;299;955
431150;201604;1109;3305;847;2781;184;676;281;911;465;1587
431160;201604;901;2632;746;2328;137;403;364;1256;501;1659
431162;201604;509;1291;222;738;28;109;22;51;50;160
431164;201604;171;470;51;186;8;33;4;16;12;49
431170;201604;719;1986;511;1614;144;481;131;406;275;887
431171;201604;777;2285;672;2080;204;665;198;593;402;1258
431173;201604;463;1338;386;1206;118;398;154;472;272;870
431175;201604;1033;2886;867;2611;256;821;243;706;499;1527
431177;201604;820;2656;638;2306;206;833;244;863;450;1696
431179;201604;373;812;100;295;16;51;18;47;34;98
431180;201604;2259;6450;1557;5033;375;1299;304;920;679;2219
431190;201604;634;1759;376;1204;53;192;78;227;131;419
431198;201604;360;1176;325;1107;120;429;82;294;202;723
431200;201604;409;1161;122;419;16;53;4;10;20;63
431205;201604;292;876;138;477;33;105;36;135;69;240
431210;201604;759;2040;629;1818;178;510;303;906;481;1416
431213;201604;231;705;180;607;29;112;84;280;113;392
431215;201604;281;833;154;536;25;84;9;25;34;109
431217;201604;173;535;130;441;38;137;45;157;83;294
431220;201604;906;2430;547;1685;54;183;237;673;291;856
431225;201604;1357;3748;1077;3252;237;754;413;1220;650;1974
431230;201604;860;2473;651;2049;81;268;319;989;400;1257
431235;201604;113;314;32;101;5;16;5;11;10;27
431237;201604;495;1440;390;1286;79;317;213;682;292;999
431238;201604;42;135;34;117;9;35;8;28;17;63
431240;201604;2986;8803;2650;8314;811;2742;894;2775;1705;5517
431242;201604;369;1160;322;1072;96;331;109;379;205;710
431244;201604;384;878;230;625;27;90;118;292;145;382
431245;201604;1173;3053;826;2429;124;383;411;1187;535;1570
431247;201604;197;562;141;445;36;112;28;78;64;190
431250;201604;1503;4802;1307;4531;359;1360;495;1725;854;3085
431260;201604;348;980;170;600;24;105;50;162;74;267
431261;201604;244;830;212;757;35;165;84;268;119;433
431262;201604;421;1134;190;609;23;89;87;286;110;375
431265;201604;1439;3687;777;2355;143;481;189;472;332;953
431267;201604;179;498;141;439;31;110;81;236;112;346
431270;201604;2772;6948;1809;5385;439;1448;584;1756;1023;3204
431275;201604;225;683;125;459;34;128;14;52;48;180
431280;201604;331;926;136;456;16;61;23;52;39;113
431290;201604;318;968;233;772;50;193;38;108;88;301
431295;201604;91;251;45;141;3;10;14;40;17;50
431300;201604;401;1006;72;270;8;29;2;7;10;36
431301;201604;267;819;114;391;21;73;17;50;38;123
431303;201604;754;1995;435;1335;56;196;124;358;180;554
431306;201604;2317;5980;1472;4491;161;600;400;1042;561;1642
431308;201604;41;140;37;126;22;80;9;29;31;109
431310;201604;753;2235;463;1576;84;297;128;459;212;756
431320;201604;794;2175;410;1355;66;231;75;224;141;455
431330;201604;2858;6996;1425;4450;364;1296;79;204;443;1500
431333;201604;422;1136;174;533;22;77;35;92;57;169
431335;201604;54;166;38;132;13;48;6;13;19;61
431337;201604;2395;7282;1811;6125;401;1472;271;876;672;2348
431339;201604;597;1619;406;1232;80;249;183;553;263;802
431340;201604;23938;63700;17583;52713;3906;12685;4236;12567;8142;25252
431342;201604;539;1359;419;1168;132;420;204;520;336;940
431344;201604;356;978;254;796;11;28;189;610;200;638
431346;201604;317;808;131;401;28;88;17;50;45;138
431349;201604;727;2051;470;1449;86;278;162;469;248;747
431350;201604;4074;11877;3308;10475;676;2430;1165;3442;1841;5872
431360;201604;648;1660;426;1289;97;316;135;417;232;733
431365;201604;1235;3661;1055;3363;235;804;530;1737;765;2541
431370;201604;4876;13659;3800;11805;1073;3595;1054;3374;2127;6969
431380;201604;922;2869;854;2727;121;439;512;1601;633;2040
431390;201604;3080;8052;1835;5687;327;1136;464;1271;791;2407
431395;201604;1241;3695;1048;3358;235;823;485;1532;720;2355
431400;201604;360;1128;176;602;36;131;26;78;62;209
431402;201604;1284;3008;750;2087;153;443;332;889;485;1332
431403;201604;254;733;186;618;58;209;33;107;91;316
431405;201604;3960;11116;3257;10076;606;2077;1675;5113;2281;7190
431406;201604;741;2262;553;1877;143;513;241;816;384;1329
431407;201604;536;1530;354;1179;73;240;95;297;168;537
431410;201604;13928;39649;9473;31084;2656;9803;1078;3378;3734;13181
431413;201604;218;537;92;292;6;21;27;77;33;98
431415;201604;724;2034;511;1636;120;423;158;457;278;880
431417;201604;565;1431;467;1296;59;178;281;773;340;951
431420;201604;1364;3741;1199;3487;247;734;521;1620;768;2354
431430;201604;533;1392;326;982;59;186;110;292;169;478
431440;201604;22507;62701;18412;56191;5334;17274;5395;17469;10729;34743
431442;201604;124;360;76;244;10;35;5;11;15;46
431445;201604;525;1491;234;760;31;96;77;237;108;333
431446;201604;418;1240;302;1000;71;247;92;298;163;545
431447;201604;571;1632;441;1371;90;276;195;630;285;906
431449;201604;783;2171;622;1895;60;187;354;1098;414;1285
431450;201604;2183;5395;1903;4994;279;817;1333;3391;1612;4208
431454;201604;64;226;56;205;12;44;22;87;34;131
431455;201604;717;1796;382;1079;96;278;91;231;187;509
431460;201604;3337;9206;2842;8265;740;2192;860;2639;1600;4831
431470;201604;1747;5160;1328;4233;301;955;438;1426;739;2381
431475;201604;202;591;47;188;7;29;1;3;8;32
431477;201604;730;1901;482;1395;59;195;244;665;303;860
431478;201604;281;715;95;279;14;39;15;31;29;70
431480;201604;2952;8193;2253;6963;567;1920;835;2471;1402;4391
431490;201604;109334;294094;93143;269984;11203;38173;62978;177752;74181;215925
431500;201604;599;1659;468;1398;93;279;239;714;332;993
431505;201604;504;1209;337;964;23;58;205;600;228;658
431507;201604;358;884;215;606;43;117;110;310;153;427
431510;201604;1886;5276;1473;4448;328;1050;484;1363;812;2413
431513;201604;300;811;145;460;18;58;67;213;85;271
431514;201604;110;293;44;156;3;13;9;35;12;48
431515;201604;651;1884;445;1407;99;344;148;422;247;766
431517;201604;78;247;61;204;11;37;10;27;21;64
431520;201604;519;1308;244;785;43;164;28;81;71;245
431530;201604;4294;10078;3219;8815;1055;3140;913;2612;1968;5752
431531;201604;267;772;184;594;29;97;57;185;86;282
431532;201604;491;1358;411;1195;92;284;153;430;245;714
431535;201604;348;911;152;472;25;86;51;136;76;222
431540;201604;2035;6714;1788;6344;175;641;1159;4323;1334;4964
431545;201604;344;955;51;169;6;17;5;17;11;34
431550;201604;2229;6537;1962;6071;392;1367;847;2519;1239;3886
431555;201604;682;1716;517;1453;69;196;311;902;380;1098
431560;201604;20223;59637;14430;48640;3393;12803;3050;10866;6443;23669
431570;201604;5835;14971;4672;13475;1264;3767;1974;5838;3238;9605
431575;201604;405;1030;294;860;44;147;64;167;108;314
431580;201604;620;1751;385;1255;77;271;108;329;185;600
431590;201604;956;2576;588;1848;104;326;179;584;283;910
431595;201604;441;1257;349;1069;39;120;213;663;252;783
431600;201604;1982;5442;1418;4440;310;1131;324;959;634;2090
431610;201604;1462;4195;1067;3443;182;603;411;1349;593;1952
431620;201604;480;1408;243;771;54;172;88;254;142;426
431630;201604;1417;3803;896;2724;248;801;248;709;496;1510
431640;201604;6164;17283;5503;16314;1232;3859;3007;9001;4239;12860
431642;201604;502;1346;392;1156;52;169;183;526;235;695
431643;201604;289;754;159;456;20;66;53;126;73;192
431645;201604;1709;4884;1456;4453;256;883;833;2505;1089;3388
431647;201604;153;443;103;339;17;64;13;35;30;99
431650;201604;323;984;224;773;27;111;51;152;78;263
431660;201604;1142;3215;716;2359;133;469;132;376;265;845
431670;201604;1264;3327;946;2769;201;672;377;1018;578;1690
431673;201604;236;655;123;404;23;77;14;41;37;118
431675;201604;610;1604;146;486;22;79;24;62;46;141
431680;201604;9684;26235;7333;21971;1978;6340;1667;5066;3645;11406
431690;201604;23379;64817;18363;56517;4935;16203;5751;18296;10686;34499
431695;201604;138;424;96;318;19;61;22;55;41;116
431697;201604;447;1281;395;1182;103;317;179;551;282;868
431700;201604;1540;4379;1316;3958;214;674;703;2076;917;2750
431710;201604;12537;35988;10235;32349;3280;11197;2245;7730;5525;18927
431720;201604;7096;19553;5394;16310;1170;3817;1766;5260;2936;9077
431725;201604;22;63;10;36;1;4;3;9;4;13
431730;201604;3895;11296;3087;9882;792;2805;793;2669;1585;5474
431740;201604;5236;14517;4153;12594;1340;4462;657;1802;1997;6264
431750;201604;8995;25456;7798;23534;1784;5868;3513;10698;5297;16566
431755;201604;334;911;82;279;13;46;13;39;26;85
431760;201604;3879;11041;3118;9670;630;2140;1231;3624;1861;5764
431770;201604;2009;5324;1651;4786;291;876;935;2682;1226;3558
431775;201604;208;560;140;431;37;114;12;29;49;143
431780;201604;2428;6533;1836;5437;440;1397;389;1069;829;2466
431790;201604;1171;3548;958;3137;146;531;508;1677;654;2208
431795;201604;378;1018;225;679;36;115;70;208;106;323
431800;201604;8677;25433;6922;22188;2089;7267;958;2968;3047;10235
431805;201604;336;817;108;357;17;65;16;51;33;116
431810;201604;3209;8818;2488;7419;455;1484;1066;3091;1521;4575
431820;201604;2496;7760;2157;7106;420;1506;891;2843;1311;4349
431830;201604;10755;26192;8343;22659;2323;6869;2966;8146;5289;15015
431840;201604;2652;7937;2295;7333;575;1985;975;3160;1550;5145
431842;201604;808;2029;340;1043;44;148;71;189;115;337
431843;201604;352;1015;288;896;42;148;139;416;181;564
431844;201604;283;771;91;301;21;76;19;49;40;125
431845;201604;484;1431;378;1204;24;82;237;759;261;841
431846;201604;324;991;279;923;24;92;194;640;218;732
431848;201604;253;677;145;461;15;50;33;95;48;145
431849;201604;467;1139;103;309;15;44;15;34;30;78
431850;201604;4760;13878;4156;12730;990;3228;1476;4494;2466;7722
431860;201604;784;2067;577;1690;96;321;278;768;374;1089
431861;201604;95;269;49;165;6;18;6;15;12;33
431862;201604;475;1551;383;1382;106;445;107;356;213;801
431870;201604;17911;51716;14273;45244;3425;11791;4495;14298;7920;26089
431880;201604;4255;12660;3423;10942;811;2851;1141;3435;1952;6286
431890;201604;5078;13704;3695;11237;1104;3556;816;2597;1920;6153
431900;201604;1067;2978;704;2239;178;650;268;778;446;1428
431910;201604;1019;2433;494;1424;71;200;134;364;205;564
431912;201604;499;1445;408;1281;118;351;148;484;266;835
431915;201604;1297;3511;999;2979;224;699;359;1090;583;1789
431920;201604;1286;3614;1110;3333;134;416;768;2285;902;2701
431930;201604;1241;3376;864;2752;227;694;379;1294;606;1988
431935;201604;53;164;44;143;12;46;14;36;26;82
431936;201604;383;1109;286;898;63;203;111;361;174;564
431937;201604;329;856;185;562;40;138;26;69;66;207
431940;201604;2546;6906;1692;5223;358;1197;418;1265;776;2462
431950;201604;1599;4878;1403;4523;253;919;661;2056;914;2975
431960;201604;2856;8250;2500;7572;635;1991;780;2349;1415;4340
431970;201604;477;1318;223;748;37;143;43;127;80;270
431971;201604;95;274;62;210;5;19;13;39;18;58
431973;201604;466;1606;412;1495;64;231;246;934;310;1165
431975;201604;107;253;22;88;7;33;4;13;11;46
431980;201604;1383;4041;1121;3524;257;858;335;1006;592;1864
431990;201604;7172;19951;5405;17019;924;3331;1597;4766;2521;8097
432000;201604;9844;27433;7824;24015;2451;7853;2411;7343;4862;15196
432010;201604;2191;6159;1784;5438;365;1198;829;2508;1194;3706
432020;201604;2304;5540;1719;4736;239;723;1130;3064;1369;3787
432023;201604;511;1454;332;1063;66;230;102;284;168;514
432026;201604;1202;3633;888;2975;148;484;431;1452;579;1936
432030;201604;409;1189;304;956;54;161;147;454;201;615
432032;201604;603;1552;396;1182;69;225;168;459;237;684
432035;201604;823;2478;736;2332;277;949;232;754;509;1703
432040;201604;971;2264;432;1365;77;258;126;392;203;650
432045;201604;248;698;143;490;21;72;39;132;60;204
432050;201604;630;1738;540;1583;81;241;300;907;381;1148
432055;201604;943;2655;676;2178;127;423;351;1116;478;1539
432057;201604;410;989;308;822;52;133;189;494;241;627
432060;201604;533;1405;202;691;35;135;41;125;76;260
432065;201604;216;629;165;538;42;159;60;175;102;334
432067;201604;967;2963;719;2446;138;481;325;1124;463;1605
432070;201604;2345;6468;1556;4873;319;1088;288;838;607;1926
432080;201604;3707;10465;3118;9455;972;3189;978;2954;1950;6143
432085;201604;308;849;199;671;44;157;95;317;139;474
432090;201604;1430;4062;1106;3431;310;1035;396;1165;706;2200
432100;201604;1332;3823;651;2213;90;308;43;104;133;412
432110;201604;2655;7974;1971;6582;461;1759;195;591;656;2350
432120;201604;4721;13840;3967;12562;1439;4840;955;2959;2394;7799
432130;201604;2624;7337;2142;6714;735;2536;741;2328;1476;4864
432132;201604;396;1100;195;665;25;96;57;185;82;281
432135;201604;661;2073;628;2012;82;293;457;1438;539;1731
432140;201604;1907;6079;1500;5290;340;1266;601;2234;941;3500
432143;201604;1371;4002;1143;3621;206;663;533;1772;739;2435
432145;201604;1232;3736;768;2679;119;460;108;343;227;803
432146;201604;171;562;121;444;28;111;22;86;50;197
432147;201604;643;2033;484;1689;128;482;122;446;250;928
432149;201604;362;1011;230;699;49;148;77;238;126;386
432150;201604;3655;10215;2737;8564;571;1998;774;2338;1345;4336
432160;201604;4389;13764;3823;12768;1163;4121;1269;4357;2432;8478
432162;201604;399;948;75;235;11;38;10;23;21;61
432163;201604;364;972;95;303;5;18;4;12;9;30
432166;201604;674;1986;555;1747;75;279;260;780;335;1059
432170;201604;1083;3351;727;2589;141;519;127;437;268;956
432180;201604;2770;7419;1818;5607;407;1312;385;1133;792;2445
432183;201604;414;1279;322;1088;129;467;56;179;185;646
432185;201604;890;2376;568;1795;112;374;230;732;342;1106
432190;201604;3320;9019;2176;6556;471;1478;566;1596;1037;3074
432195;201604;1099;2971;845;2574;118;357;463;1381;581;1738
432200;201604;3061;9110;2446;8069;596;2143;1025;3424;1621;5567
432210;201604;422;1163;306;972;76;273;115;347;191;620
432215;201604;843;2570;715;2367;143;429;403;1445;546;1874
432218;201604;274;695;175;505;27;77;64;162;91;239
432220;201604;4193;11068;3442;9887;407;1382;2079;5779;2486;7161
432225;201604;76;243;66;224;26;94;19;63;45;157
432230;201604;1039;2777;627;1878;129;417;147;360;276;777
432232;201604;519;1464;406;1243;69;229;161;483;230;712
432234;201604;366;1013;240;742;50;154;59;172;109;326
432235;201604;109;310;39;130;9;32;1;1;10;33
432237;201604;466;1256;424;1190;17;70;314;853;331;923
432240;201604;13815;42994;11543;40039;1754;7201;6693;24006;8447;31207
432250;201604;4678;15881;4234;15004;1327;5104;1285;4625;2612;9729
432252;201604;399;1076;270;869;48;166;135;456;183;622
432253;201604;1314;4143;783;2739;175;666;66;225;241;891
432254;201604;844;2283;247;818;53;195;31;90;84;285
432255;201604;196;529;121;397;24;85;37;112;61;197
432260;201604;7587;18806;5314;15135;1156;3368;2069;6213;3225;9581
432270;201604;2559;7562;2144;6851;612;2026;695;2308;1307;4334
432280;201604;1391;3778;745;2386;111;374;153;434;264;808
432285;201604;192;606;27;95;4;16;3;6;7;22
432290;201604;564;1636;356;1169;83;269;94;303;177;572
432300;201604;23227;68484;20296;63508;3855;13112;11091;34302;14946;47414
432310;201604;805;2335;634;2054;143;498;317;1008;460;1506
432320;201604;219;554;110;342;18;57;19;49;37;106
432330;201604;329;858;124;405;14;45;10;27;24;72
432335;201604;153;436;63;224;15;56;10;29;25;85
432340;201604;309;749;163;493;26;91;51;146;77;237
432345;201604;640;1773;584;1684;76;281;356;940;432;1221
432350;201604;392;1062;211;697;30;92;54;173;84;265
432360;201604;186;574;43;152;11;48;10;27;21;75
432370;201604;422;1170;340;1017;40;116;211;640;251;756
432375;201604;757;1894;577;1600;73;202;327;922;400;1124
432377;201604;182;607;41;157;8;27;5;11;13;38
432380;201604;911;2950;771;2677;259;1001;276;909;535;1910
500020;201604;2228;6594;1696;5667;367;1445;656;2100;1023;3545
500025;201604;1347;3108;831;2230;95;262;450;1181;545;1443
500060;201604;6846;20262;5417;17846;662;2243;3403;11692;4065;13935
500070;201604;4342;12394;3454;10818;724;2559;1381;4266;2105;6825
500080;201604;1475;4348;1100;3663;287;1073;348;1155;635;2228
500085;201604;2233;5725;1563;4741;148;477;914;2703;1062;3180
500090;201604;2357;6758;1703;5579;346;1183;726;2504;1072;3687
500100;201604;2619;7554;2199;6831;490;1734;804;2360;1294;4094
500110;201604;8232;24177;6556;21587;1111;3973;3017;10577;4128;14550
500124;201604;2020;6415;1748;5965;362;1173;881;3361;1243;4534
500150;201604;1406;3536;970;2825;193;655;348;862;541;1517
500190;201604;4838;12498;3737;11002;704;2206;1920;5813;2624;8019
500200;201604;2431;6090;1844;5046;388;1144;720;1831;1108;2975
500210;201604;4751;14119;3951;12872;906;3131;1764;5852;2670;8983
500215;201604;1552;4736;1208;4064;196;718;432;1441;628;2159
500220;201604;2953;9211;2444;8337;475;1714;1006;3528;1481;5242
500230;201604;2781;7039;1954;5742;418;1341;884;2658;1302;3999
500240;201604;4566;14221;3303;11634;518;1989;980;3717;1498;5706
500260;201604;2732;6941;1970;5784;310;1020;945;2648;1255;3668
500270;201604;123361;314852;78444;237620;17532;57625;16295;48855;33827;106480
500280;201604;1367;3508;1154;3235;88;266;885;2517;973;2783
500290;201604;4465;10123;2574;7392;531;1696;831;2323;1362;4019
500295;201604;2664;7766;1661;5547;255;936;383;1105;638;2041
500310;201604;766;2002;628;1805;139;461;303;829;442;1290
500315;201604;3072;9576;2526;8689;363;1289;1517;5456;1880;6745
500320;201604;16911;53753;13365;47205;3774;14583;3504;13123;7278;27706
500325;201604;4065;10372;2952;8645;566;1792;1519;4508;2085;6300
500330;201604;6713;17623;4694;13936;848;2839;2003;5820;2851;8659
500345;201604;2168;5634;1679;4893;365;1152;768;2232;1133;3384
500348;201604;2276;6559;1967;6077;128;474;1414;4332;1542;4806
500350;201604;1255;3711;722;2454;92;325;214;750;306;1075
500370;201604;23336;69766;17744;59696;3730;14195;4823;16341;8553;30536
500375;201604;2898;7930;2144;6495;440;1400;542;1571;982;2971
500380;201604;3064;8506;2425;7400;624;2003;902;2775;1526;4778
500390;201604;581;1283;335;906;51;160;168;425;219;585
500400;201604;1333;4010;986;3196;227;811;224;655;451;1466
500410;201604;2196;6129;1775;5520;422;1441;812;2574;1234;4015
500430;201604;2646;7284;1975;6330;414;1496;748;2508;1162;4004
500440;201604;1485;3905;997;3059;169;570;428;1307;597;1877
500450;201604;1655;4884;1182;3977;231;855;191;555;422;1410
500460;201604;3697;11006;2777;9241;700;2551;532;1715;1232;4266
500470;201604;3060;8902;2134;6938;522;1892;311;920;833;2812
500480;201604;2220;6723;2045;6509;197;549;1537;5331;1734;5880
500490;201604;959;2635;711;2204;207;730;149;487;356;1217
500500;201604;3802;11626;2983;10398;983;3960;955;3406;1938;7366
500510;201604;846;2186;533;1629;67;228;213;590;280;818
500515;201604;1878;4979;1548;4551;231;708;884;2833;1115;3541
500520;201604;3156;10782;2814;10200;399;1593;1768;6512;2167;8105
500525;201604;1164;3692;929;3247;150;589;429;1560;579;2149
500540;201604;6318;17160;3745;12367;953;3707;442;1259;1395;4966
500560;201604;4619;15073;4183;14398;567;2127;2892;10012;3459;12139
500568;201604;4300;10456;2923;8424;575;2009;955;2567;1530;4576
500570;201604;7610;20109;5000;15262;1267;4170;898;2651;2165;6821
500580;201604;3688;10326;2948;9145;257;813;2071;6546;2328;7359
500600;201604;3916;10301;2557;7804;592;1962;684;2091;1276;4053
500620;201604;7699;21974;5872;18540;1055;3629;2341;7487;3396;11116
500625;201604;786;2276;443;1497;80;292;131;440;211;732
500627;201604;572;1624;441;1394;83;266;118;393;201;659
500630;201604;6053;16384;4327;13514;1079;3684;1254;3841;2333;7525
500635;201604;2716;10046;2224;9286;297;1196;1448;6623;1745;7819
500640;201604;1632;3914;1239;3358;80;257;886;2362;966;2619
500660;201604;19187;54503;14845;47584;4347;15772;4111;13092;8458;28864
500690;201604;2563;7541;2063;6839;955;3315;509;1848;1464;5163
500710;201604;3536;10427;2962;9477;662;2379;1188;3777;1850;6156
500720;201604;6107;16067;3879;12266;969;3379;773;2390;1742;5769
500730;201604;981;2691;677;2097;160;517;186;547;346;1064
500740;201604;4241;11451;3390;9895;388;1361;1547;4622;1935;5983
500750;201604;933;2553;783;2323;135;434;408;1190;543;1624
500755;201604;1172;3409;792;2631;167;587;158;429;325;1016
500769;201604;5252;13866;3034;9315;502;1713;565;1501;1067;3214
500770;201604;1713;4968;1224;4050;295;1035;299;1028;594;2063
500780;201604;1109;3187;872;2764;227;733;216;678;443;1411
500790;201604;9727;26345;8027;23520;1364;4573;4261;12237;5625;16810
500793;201604;2236;6374;1708;5475;457;1562;342;973;799;2535
500795;201604;2382;7065;2020;6555;252;672;1397;4897;1649;5569
500797;201604;830;2249;575;1806;95;326;212;649;307;975
500800;201604;2841;7555;2177;6618;828;2891;488;1556;1316;4447
500830;201604;19226;50997;13469;40457;2537;8368;4364;12479;6901;20847
500840;201604;1327;3674;897;2823;104;352;337;1024;441;1376
510010;201604;1245;3661;1024;3310;266;852;497;1653;763;2505
510020;201604;3354;9434;2081;6889;452;1609;485;1539;937;3148
510025;201604;7507;21760;5705;18426;1260;4394;1593;4847;2853;9241
510030;201604;1677;4500;1361;4014;252;837;663;1875;915;2712
510035;201604;828;2363;619;2060;130;444;329;1137;459;1581
510040;201604;1697;4620;1311;4036;204;673;696;2165;900;2838
510050;201604;1838;5318;1335;4362;332;1186;371;1180;703;2366
510060;201604;1569;4459;1196;3764;213;720;474;1458;687;2178
510080;201604;1073;3355;845;2919;237;914;121;361;358;1275
510100;201604;676;1771;481;1379;54;178;226;602;280;780
510120;201604;308;663;195;518;12;40;130;348;142;388
510125;201604;3113;8130;2376;6858;401;1387;911;2432;1312;3819
510130;201604;1752;4817;1430;4290;388;1243;441;1297;829;2540
510140;201604;2791;8880;2227;8033;948;3830;394;1217;1342;5047
510160;201604;1312;4395;1192;4210;194;745;756;2667;950;3412
510170;201604;5083;15329;4197;13822;770;2807;1904;6103;2674;8910
510180;201604;12159;31389;8433;25560;2337;7469;2366;8186;4703;15655
510185;201604;1320;3931;1098;3626;148;482;690;2550;838;3032
510190;201604;2304;6642;1628;5630;315;1195;735;2698;1050;3893
510250;201604;13504;41013;11704;38272;3473;12236;4165;14156;7638;26392
510260;201604;2119;8740;1790;8084;398;1799;827;4359;1225;6158
510263;201604;4026;10768;2970;9089;708;2301;726;2132;1434;4433
510267;201604;5561;15947;3900;12470;773;2693;890;2698;1663;5391
510268;201604;827;2440;706;2267;146;507;372;1201;518;1708
510269;201604;1009;3083;750;2593;243;868;170;600;413;1468
510270;201604;2679;8702;2235;7799;430;1542;882;3046;1312;4588
510279;201604;1800;5555;1466;4865;373;1327;397;1170;770;2497
510285;201604;1235;3607;953;3127;278;1001;273;847;551;1848
510300;201604;3304;9612;2721;8784;199;752;2016;6586;2215;7338
510305;201604;1491;4616;1157;4004;281;1057;346;1204;627;2261
510310;201604;771;2372;650;2142;216;765;188;595;404;1360
510320;201604;3503;9994;2744;8653;629;2335;757;2266;1386;4601
510325;201604;5158;16161;4365;15092;1222;4406;2421;8740;3643;13146
510330;201604;2664;8382;2111;7392;551;2102;665;2367;1216;4469
510335;201604;4859;14447;3916;13274;487;1610;2703;9793;3190;11403
510336;201604;577;1779;428;1501;82;304;206;731;288;1035
510337;201604;2028;6635;1620;5861;626;2387;243;910;869;3297
510340;201604;75378;200578;52638;165247;16611;58219;8893;29208;25504;87427
510343;201604;1103;3182;884;2804;106;359;583;1876;689;2235
510345;201604;1610;4758;1297;4224;325;1147;456;1448;781;2595
510350;201604;3173;8568;2400;7481;576;1901;1038;3404;1614;5305
510360;201604;1762;4298;1111;3512;105;417;760;2365;865;2782
510370;201604;1220;4023;1023;3705;225;856;552;2111;777;2967
510380;201604;516;1513;315;1104;112;431;24;78;136;509
510385;201604;918;3457;673;2903;86;409;301;1440;387;1849
510390;201604;1070;3302;980;3191;264;680;593;2189;857;2869
510395;201604;737;1819;531;1524;79;256;210;705;289;961
510410;201604;3720;12081;3252;11180;799;2878;1563;5530;2362;8408
510420;201604;2395;6052;1778;5046;172;619;923;2574;1095;3193
510450;201604;651;1703;457;1404;96;330;139;425;235;755
510452;201604;627;2005;476;1664;77;291;246;877;323;1168
510454;201604;827;2602;704;2371;95;355;443;1520;538;1875
510455;201604;962;2929;723;2435;129;496;230;732;359;1228
510460;201604;2253;5866;1712;5120;212;757;964;2776;1176;3533
510480;201604;4383;11541;3128;9307;632;1996;795;2259;1427;4255
510490;201604;1586;4919;1338;4546;281;1094;713;2354;994;3448
510500;201604;1509;4473;1028;3528;231;924;409;1331;640;2255
510510;201604;2582;8970;2231;8346;684;2744;644;2465;1328;5209
510515;201604;6089;18384;4481;14937;961;3547;953;2963;1914;6510
510517;201604;1620;4841;1320;4285;387;1315;305;979;692;2294
510520;201604;2067;4746;1485;4043;59;178;1017;2973;1076;3151
510523;201604;989;2914;870;2706;112;344;609;1965;721;2309
510525;201604;7949;20596;5434;16723;1055;3352;1879;5809;2934;9161
510530;201604;506;1451;422;1333;50;227;269;803;319;1030
510550;201604;2695;8723;2113;7581;564;2219;669;2394;1233;4613
510558;201604;1853;5308;1577;4917;253;871;844;2738;1097;3609
510560;201604;1653;4971;1064;3989;284;1181;194;742;478;1923
510562;201604;5353;15687;4091;13196;1153;4062;977;3246;2130;7308
510590;201604;2981;7925;2488;7300;467;1355;1412;4374;1879;5729
510600;201604;1604;4103;1076;3242;184;582;407;1200;591;1782
510610;201604;2895;8196;2335;7348;197;697;1529;4808;1726;5505
510615;201604;2012;6087;1693;5580;494;1703;717;2476;1211;4179
510617;201604;603;1775;500;1601;35;95;395;1325;430;1420
510618;201604;1455;4203;1057;3440;177;680;465;1465;642;2145
510619;201604;797;2201;481;1604;54;202;52;133;106;335
510620;201604;1400;3497;797;2571;191;690;94;262;285;952
510621;201604;881;3056;791;2873;201;804;232;808;433;1612
510622;201604;3750;11361;2649;9035;671;2468;301;929;972;3397
510623;201604;3226;9188;2551;8010;637;2193;889;2651;1526;4844
510624;201604;1476;4277;957;3251;183;709;204;637;387;1346
510625;201604;2057;5780;1574;4969;416;1457;264;838;680;2295
510626;201604;1547;4106;1011;3359;315;1188;220;742;535;1930
510627;201604;714;2037;479;1533;114;405;93;289;207;694
510628;201604;1540;3803;1099;3217;119;352;760;2267;879;2619
510629;201604;1744;5625;1404;4888;421;1633;392;1333;813;2966
510630;201604;2467;8317;1810;6931;444;1896;289;1141;733;3037
510631;201604;352;1009;305;932;26;70;234;717;260;787
510637;201604;2664;7791;2292;7204;728;2489;773;2408;1501;4897
510642;201604;4613;15200;3991;14309;1192;4731;1660;6166;2852;10897
510645;201604;959;2152;611;1686;203;554;149;448;352;1002
510650;201604;6235;20604;5620;19888;1448;5393;3389;12496;4837;17889
510665;201604;1673;4358;1016;3145;193;611;337;1083;530;1694
510670;201604;395;895;224;659;21;85;109;305;130;390
510675;201604;6342;19803;5075;17351;1461;5604;1118;3737;2579;9341
510677;201604;1901;5198;1576;4781;173;531;1157;3686;1330;4217
510680;201604;718;2150;532;1780;123;436;99;302;222;738
510682;201604;2096;6619;1627;5737;446;1783;290;969;736;2752
510685;201604;942;2525;772;2292;83;286;506;1480;589;1766
510700;201604;4248;10960;2898;9088;636;2030;1311;4294;1947;6324
510704;201604;9329;24678;7516;21796;1399;4421;3458;9767;4857;14188
510706;201604;1864;5504;1273;4625;263;963;639;2502;902;3465
510710;201604;3313;9119;2347;7191;513;1624;590;1672;1103;3296
510715;201604;713;1750;477;1346;84;258;169;482;253;740
510718;201604;2285;5655;1492;4738;671;2203;332;1249;1003;3452
510719;201604;403;934;260;744;21;86;133;364;154;450
510720;201604;1117;2734;833;2357;238;767;299;752;537;1519
510724;201604;711;2155;560;1880;115;418;216;688;331;1106
510726;201604;620;1546;478;1328;68;227;261;640;329;867
510729;201604;726;1794;418;1237;91;298;145;431;236;729
510730;201604;2686;7748;2012;6531;561;1993;495;1577;1056;3570
510735;201604;1005;3315;778;2961;166;708;370;1428;536;2136
510740;201604;1075;2656;785;2230;159;433;401;1207;560;1640
510757;201604;685;2287;566;2059;218;797;157;583;375;1380
510760;201604;31079;79271;20965;63031;5780;19037;4258;12418;10038;31455
510770;201604;4216;10819;3594;10071;330;910;2366;7395;2696;8305
510774;201604;356;1001;322;948;61;208;160;501;221;709
510775;201604;700;2058;576;1843;169;599;151;441;320;1040
510776;201604;537;1476;420;1235;97;308;170;497;267;805
510777;201604;1559;4585;1166;4063;147;544;890;3151;1037;3695
510779;201604;630;1909;483;1628;66;231;226;798;292;1029
510780;201604;3645;10783;2970;9748;723;2488;1159;4095;1882;6583
510785;201604;1710;4946;1265;4172;394;1352;218;747;612;2099
510787;201604;2240;6687;1775;5883;739;2613;297;936;1036;3549
510788;201604;554;1423;397;1197;155;491;88;304;243;795
510790;201604;15705;45313;10808;36124;2150;8322;1042;3560;3192;11882
510792;201604;7900;23135;5477;18568;1056;4049;801;2561;1857;6610
510794;201604;1170;3674;950;3238;301;1143;261;844;562;1987
510795;201604;7988;23740;5893;19884;1505;5605;1112;4006;2617;9611
510800;201604;1539;4306;1217;3846;277;966;498;1464;775;2430
510805;201604;1924;5326;1493;4662;290;1006;790;2396;1080;3402
510810;201604;649;1588;502;1389;140;388;221;594;361;982
510820;201604;725;1715;480;1352;82;277;178;436;260;713
510830;201604;671;2071;550;1890;135;503;281;1033;416;1536
510835;201604;622;1833;476;1560;103;370;178;549;281;919
510840;201604;46541;115867;36991;103565;8905;26313;16465;47599;25370;73912
510850;201604;1492;4231;1019;3359;253;893;135;402;388;1295
510860;201604;2640;8219;1938;6856;685;2701;114;361;799;3062
510880;201604;624;2060;532;1900;174;671;194;713;368;1384
510885;201604;633;1769;510;1602;98;342;196;611;294;953
510890;201604;831;2597;680;2378;182;718;296;1008;478;1726
510895;201604;1068;3281;898;2954;216;805;333;1028;549;1833
520005;201604;1412;4481;1252;4250;324;1134;604;2131;928;3265
520010;201604;1679;5624;1355;4962;513;2160;224;728;737;2888
520013;201604;3382;9435;2500;7793;571;1872;783;2486;1354;4358
520015;201604;467;1327;375;1193;76;267;134;439;210;706
520017;201604;1052;3108;878;2828;212;762;330;986;542;1748
520020;201604;450;1149;343;1002;77;240;148;425;225;665
520025;201604;26095;80797;24652;79101;2861;9872;19471;62547;22332;72419
520030;201604;4546;14081;3828;12908;718;2687;1911;6467;2629;9154
520050;201604;418;1057;288;852;18;45;181;561;199;606
520055;201604;737;2216;649;2033;99;303;358;1156;457;1459
520060;201604;1328;4142;1136;3761;249;926;387;1229;636;2155
520080;201604;1799;5232;1515;4865;297;914;845;2924;1142;3838
520082;201604;1076;2916;951;2723;121;323;644;1920;765;2243
520085;201604;831;2506;721;2314;155;501;243;768;398;1269
520090;201604;975;2244;704;1909;157;379;350;1055;507;1434
520110;201604;41342;119071;32214;105326;11520;42947;4713;14954;16233;57901
520120;201604;190;502;124;391;23;85;29;94;52;179
520130;201604;3402;9489;3075;9031;645;2094;1625;4887;2270;6981
520140;201604;36565;117855;31385;108509;10866;40881;5013;17169;15879;58050
520145;201604;353;956;252;777;58;189;76;219;134;408
520150;201604;470;1232;379;1129;53;184;211;628;264;812
520160;201604;880;2371;714;2126;208;626;185;576;393;1202
520170;201604;4286;9843;3344;8773;263;721;2696;7222;2959;7943
520180;201604;2075;6057;1723;5531;286;1089;848;2691;1134;3780
520215;201604;1931;4967;1602;4448;164;464;1049;2966;1213;3430
520235;201604;683;1768;500;1498;92;311;202;578;294;889
520250;201604;1527;4346;1140;3713;297;1115;236;742;533;1857
520260;201604;776;1968;521;1491;75;240;191;513;266;753
520280;201604;562;1624;495;1537;163;529;184;644;347;1173
520310;201604;1196;2854;853;2310;226;656;270;793;496;1449
520320;201604;1854;5735;1539;5148;114;397;1017;3485;1131;3882
520330;201604;2689;8190;2045;7098;517;1956;309;1028;826;2984
520340;201604;1808;4537;1389;3997;197;506;907;2816;1104;3322
520350;201604;3169;8651;2463;7397;648;2156;875;2549;1523;4705
520355;201604;1054;3485;944;3312;289;1105;370;1253;659;2358
520357;201604;839;2254;706;2035;56;178;494;1433;550;1611
520360;201604;661;1930;566;1773;142;468;222;720;364;1188
520380;201604;1285;3454;871;2651;122;396;352;1057;474;1453
520390;201604;1082;2523;632;1933;176;630;205;562;381;1192
520393;201604;499;1214;393;1065;55;152;231;619;286;771
520396;201604;698;2249;574;2004;67;273;363;1242;430;1515
520400;201604;1676;4791;1431;4443;235;780;887;2734;1122;3514
520410;201604;1462;3536;1073;2993;211;669;576;1578;787;2247
520420;201604;323;890;239;719;41;129;80;215;121;344
520425;201604;1061;2922;878;2607;232;708;412;1250;644;1958
520430;201604;1871;4964;1208;3727;245;761;208;572;453;1333
520440;201604;3674;9405;2468;7261;720;2337;475;1384;1195;3721
520450;201604;10233;28327;6995;22373;1396;4863;443;1367;1839;6230
520455;201604;654;1947;525;1725;137;475;185;614;322;1089
520460;201604;875;2463;717;2202;118;430;384;1133;502;1563
520465;201604;796;2227;691;2099;92;311;427;1282;519;1593
520470;201604;1744;5590;1563;5306;350;1214;945;3346;1295;4560
520480;201604;936;2700;670;2233;120;435;245;765;365;1200
520485;201604;1288;4033;1122;3777;270;1006;611;2055;881;3061
520490;201604;3959;12304;3156;11064;977;3482;1307;4834;2284;8316
520495;201604;1264;3478;1097;3266;76;240;888;2718;964;2958
520500;201604;1306;3663;1081;3344;283;954;428;1314;711;2268
520505;201604;737;2095;631;1934;143;440;321;999;464;1439
520510;201604;8887;24802;6395;20917;1538;5535;1971;6664;3509;12199
520520;201604;1061;2930;844;2618;262;860;237;760;499;1620
520530;201604;1957;6425;1608;5836;562;2050;438;1757;1000;3807
520540;201604;2816;7920;2091;6601;547;1808;349;1137;896;2945
520545;201604;1063;3193;883;2865;168;581;273;845;441;1426
520547;201604;647;2041;558;1874;197;678;164;522;361;1200
520549;201604;9457;27681;7920;25620;2343;7878;3432;11393;5775;19271
520551;201604;3515;10705;3237;10316;846;3008;1905;5984;2751;8992
520552;201604;762;2286;686;2186;98;323;478;1558;576;1881
520570;201604;552;1558;411;1323;149;518;116;347;265;865
520580;201604;3226;7915;2236;6554;555;1852;977;2810;1532;4662
520590;201604;1352;3824;1047;3318;235;758;199;604;434;1362
520620;201604;7347;22628;6652;21670;1672;5649;3611;11965;5283;17614
520630;201604;911;2354;660;1987;111;338;270;819;381;1157
520640;201604;2769;7614;2268;6781;597;1826;833;2589;1430;4415
520650;201604;842;2246;621;1839;121;400;320;938;441;1338
520660;201604;338;960;269;871;93;334;85;278;178;612
520670;201604;908;2675;821;2553;57;181;670;2096;727;2277
520680;201604;733;1931;582;1713;141;403;258;780;399;1183
520690;201604;316;858;244;746;55;146;109;350;164;496
520710;201604;546;1407;341;1010;8;20;203;598;211;618
520725;201604;1561;4009;1170;3363;181;565;699;1991;880;2556
520735;201604;747;2099;529;1680;126;455;157;474;283;929
520740;201604;1613;4459;1298;4071;239;833;663;2073;902;2906
520750;201604;579;1568;464;1392;96;273;220;713;316;986
520753;201604;1442;3894;1297;3695;159;448;856;2609;1015;3057
520760;201604;812;2149;713;2020;81;227;503;1496;584;1723
520780;201604;1908;4668;1502;4120;144;396;983;2687;1127;3083
520790;201604;2795;7202;2213;6379;226;601;1555;4729;1781;5330
520800;201604;15625;44520;13493;41998;2888;8531;7919;26735;10807;35266
520810;201604;1024;2545;816;2299;113;298;584;1769;697;2067
520815;201604;579;1834;432;1521;183;739;14;35;197;774
520830;201604;1592;4133;1303;3816;40;117;1116;3273;1156;3390
520840;201604;1594;5140;1344;4717;499;1903;242;903;741;2806
520850;201604;585;1803;445;1553;106;412;140;485;246;897
520860;201604;6486;18979;4888;16357;1189;4260;1572;5404;2761;9664
520870;201604;100049;266749;70622;219665;19524;66953;14803;44709;34327;111662
520880;201604;6864;19672;5196;17271;1787;6664;590;1956;2377;8620
520890;201604;3751;10528;3030;9358;585;1984;1462;4517;2047;6501
520910;201604;3820;10956;2786;9010;936;3257;474;1473;1410;4730
520915;201604;649;1934;526;1697;119;409;233;748;352;1157
520920;201604;3400;9098;2436;7598;438;1484;951;3056;1389;4540
520929;201604;531;1466;411;1284;74;229;235;762;309;991
520940;201604;1044;3001;842;2705;97;350;592;1880;689;2230
520945;201604;647;1567;517;1358;133;315;240;631;373;946
520960;201604;1011;2949;794;2546;71;225;398;1316;469;1541
520970;201604;2813;8487;2433;7830;603;2122;626;1959;1229;4081
520980;201604;727;2112;644;1992;214;711;311;959;525;1670
520990;201604;2925;9453;2759;9225;439;1529;1851;6479;2290;8008
520993;201604;935;2382;748;2117;47;137;546;1581;593;1718
520995;201604;2330;6150;2034;5803;353;902;1372;4107;1725;5009
521000;201604;6817;20576;5616;18354;1732;6225;1391;4305;3123;10530
521010;201604;3955;11483;3104;9958;774;2476;1130;3679;1904;6155
521015;201604;670;1857;576;1709;124;351;310;938;434;1289
521020;201604;3013;8630;2094;6751;556;1927;207;626;763;2553
521030;201604;649;1628;490;1360;92;246;196;574;288;820
521040;201604;5955;16090;5011;14696;1719;5228;1573;4905;3292;10133
521056;201604;846;2573;704;2345;247;865;199;746;446;1611
521060;201604;1106;2867;890;2545;169;457;437;1345;606;1802
521080;201604;1129;2707;666;1956;67;247;243;607;310;854
521090;201604;2909;7818;2289;7025;727;2336;659;2104;1386;4440
521100;201604;1963;4397;1503;3856;273;644;968;2654;1241;3298
521120;201604;4456;11880;3524;10672;822;2691;1424;4533;2246;7224
521130;201604;1003;2707;752;2234;93;341;431;1257;524;1598
521140;201604;1026;3104;842;2759;225;771;268;900;493;1671
521150;201604;11906;29875;7636;22479;2704;8447;1661;4988;4365;13435
521160;201604;836;1966;526;1448;109;305;217;592;326;897
521170;201604;1131;2766;856;2368;174;499;472;1282;646;1781
521180;201604;6280;20358;5653;19283;1690;6202;1627;5571;3317;11773
521190;201604;9223;26281;6239;20848;1514;5538;1185;3921;2699;9459
521200;201604;748;2038;615;1824;79;264;358;1046;437;1310
521205;201604;591;1678;458;1441;40;133;260;823;300;956
521210;201604;923;2555;611;1940;177;660;124;322;301;982
521220;201604;4209;10781;3158;9397;779;2570;1339;4029;2118;6599
521225;201604;373;909;304;833;31;78;218;633;249;711
521230;201604;1152;3671;1062;3502;336;1198;512;1638;848;2836
521250;201604;27785;87828;24492;82853;10531;37724;6089;21198;16620;58922
521260;201604;671;1643;572;1501;92;283;343;865;435;1148
521270;201604;1854;5354;1701;5145;180;470;1253;3970;1433;4440
521280;201604;1823;5526;1490;4886;429;1490;393;1259;822;2749
521290;201604;490;1360;366;1168;93;347;157;475;250;822
521295;201604;1178;2897;992;2655;142;363;702;1988;844;2351
521300;201604;1910;5362;1637;4928;213;610;997;3066;1210;3676
521305;201604;739;2094;605;1887;116;335;329;1075;445;1410
521308;201604;4283;12634;3374;10886;903;2946;1183;3849;2086;6795
521310;201604;7688;22658;5565;18579;1371;4964;1050;3326;2421;8290
521340;201604;304;784;286;764;15;45;241;634;256;679
521350;201604;1946;5357;1608;4831;233;653;1065;3331;1298;3984
521370;201604;929;2727;707;2338;235;847;138;447;373;1294
521375;201604;1158;3544;973;3216;223;796;400;1273;623;2069
521377;201604;1085;2718;1004;2633;61;106;886;2413;947;2519
521380;201604;5414;15309;3900;12476;585;1976;922;3078;1507;5054
521385;201604;505;1350;449;1279;120;367;217;628;337;995
521390;201604;842;2300;666;2079;164;606;225;667;389;1273
521400;201604;1895;5463;1756;5291;216;721;1347;4092;1563;4813
521405;201604;1366;3829;1065;3283;295;971;422;1325;717;2296
521410;201604;691;2120;648;2053;227;674;280;972;507;1646
521440;201604;1353;3946;1129;3479;175;590;442;1191;617;1781
521450;201604;3826;12341;3110;10962;1019;3835;562;1940;1581;5775
521460;201604;6558;18951;5504;17187;1378;4662;2490;7664;3868;12326
521470;201604;690;1989;514;1647;112;388;76;243;188;631
521480;201604;373;1121;252;856;52;181;81;264;133;445
521483;201604;2824;7372;2153;6235;549;1592;605;1728;1154;3320
521486;201604;1582;4037;1292;3621;120;313;931;2639;1051;2952
521487;201604;575;1472;409;1204;107;335;80;228;187;563
521490;201604;778;2239;628;1995;47;207;410;1253;457;1460
521500;201604;1331;4206;1022;3541;188;745;236;725;424;1470
521520;201604;877;2088;667;1809;160;460;312;905;472;1365
521523;201604;13001;46663;12205;45317;4274;17299;1524;6355;5798;23654
521525;201604;1048;2728;897;2505;115;383;571;1551;686;1934
521530;201604;1719;4867;1084;3575;233;819;145;477;378;1296
521540;201604;932;2492;643;2010;133;497;214;636;347;1133
521550;201604;1341;3430;922;2596;203;607;420;1145;623;1752
521560;201604;3602;11828;3031;11027;1178;4681;945;3409;2123;8090
521565;201604;596;1518;499;1398;92;214;307;887;399;1101
521570;201604;4569;12567;2933;9324;640;2251;524;1691;1164;3942
521580;201604;547;1261;351;982;84;236;85;232;169;468
521590;201604;626;1733;515;1562;145;482;138;401;283;883
521600;201604;484;1333;351;1113;87;295;79;245;166;540
521630;201604;1356;3401;969;2847;229;806;189;469;418;1275
521640;201604;2037;5190;1575;4558;426;1279;652;1946;1078;3225
521645;201604;572;1687;434;1401;62;215;154;465;216;680
521680;201604;1345;4291;1138;3891;541;1991;139;456;680;2447
521690;201604;574;1669;506;1554;123;435;228;644;351;1079
521710;201604;2864;8379;2298;7410;485;1635;799;2642;1284;4277
521720;201604;1863;5273;1510;4664;312;955;800;2423;1112;3378
521730;201604;3609;11764;3146;10854;1137;4379;622;1861;1759;6240
521740;201604;3541;9698;2801;8657;659;2208;1245;4115;1904;6323
521760;201604;13054;42367;11556;39854;3000;11264;4634;16225;7634;27489
521770;201604;2585;7489;2083;6575;750;2546;540;1615;1290;4161
521800;201604;6925;20934;5955;19290;1830;6295;2061;6965;3891;13260
521805;201604;929;2085;671;1718;153;355;357;1004;510;1359
521810;201604;805;2001;587;1691;115;362;245;745;360;1107
521830;201604;5206;16447;4656;15636;743;2733;3084;10355;3827;13088
521839;201604;717;1969;547;1662;102;329;194;563;296;892
521850;201604;6786;18151;5210;15483;1241;3928;1474;4083;2715;8011
521860;201604;1955;5291;1503;4599;342;1164;427;1283;769;2447
521870;201604;480;1576;396;1398;97;359;125;427;222;786
521878;201604;772;2217;551;1756;80;286;221;666;301;952
521880;201604;23200;59321;15697;47375;4047;13126;4445;13962;8492;27088
521890;201604;3338;9929;2612;8559;739;2588;475;1515;1214;4103
521900;201604;1442;3785;1015;3154;234;769;338;977;572;1746
521910;201604;898;2444;801;2332;137;416;466;1452;603;1868
521920;201604;297;937;246;845;89;341;48;153;137;494
521925;201604;671;2039;562;1846;114;415;189;581;303;996
521930;201604;3619;11637;3123;10691;1053;3759;528;1859;1581;5618
521935;201604;592;1677;508;1525;129;397;236;688;365;1085
521940;201604;1000;2775;818;2501;182;614;400;1196;582;1810
521945;201604;670;2122;586;1991;89;290;342;1260;431;1550
521950;201604;638;1661;517;1486;69;213;329;957;398;1170
521960;201604;653;1967;529;1722;113;410;223;709;336;1119
521970;201604;2577;6799;2142;6270;205;583;1669;5069;1874;5652
521971;201604;1042;2743;727;2174;137;417;173;496;310;913
521973;201604;930;2861;783;2597;145;506;355;1173;500;1679
521975;201604;12105;33346;11074;32149;2027;6180;7416;21489;9443;27669
521980;201604;1994;5528;1711;5177;249;640;1314;4174;1563;4814
521990;201604;1174;3283;944;2924;84;276;629;2001;713;2277
522000;201604;2236;6109;1621;5327;196;715;898;3113;1094;3828
522005;201604;398;967;274;780;82;225;89;266;171;491
522010;201604;3398;9698;2843;8783;1007;3174;605;1914;1612;5088
522015;201604;886;2632;746;2411;160;514;367;1208;527;1722
522020;201604;5095;13191;3970;11486;949;2820;1930;5535;2879;8355
522026;201604;609;1647;447;1460;104;372;153;542;257;914
522028;201604;519;1487;417;1262;59;181;244;738;303;919
522040;201604;2366;5803;1876;5195;399;1101;1122;3178;1521;4279
522045;201604;14925;48500;12427;43482;3393;13056;2212;7668;5605;20724
522050;201604;1152;3228;818;2605;189;629;222;632;411;1261
522060;201604;2602;7709;2030;6849;574;2134;865;2926;1439;5060
522068;201604;1687;5262;1517;5066;149;431;1190;4200;1339;4631
522070;201604;708;2134;632;2011;74;295;448;1409;522;1704
522100;201604;507;1526;440;1428;166;594;171;528;337;1122
522108;201604;855;2646;716;2438;62;271;535;1779;597;2050
522119;201604;1352;4147;1134;3817;270;961;499;1737;769;2698
522130;201604;348;993;286;921;89;293;163;537;252;830
522140;201604;17436;48547;14022;42746;3994;13029;3480;10160;7474;23189
522145;201604;799;2212;691;2048;253;765;248;797;501;1562
522150;201604;881;2444;756;2243;206;610;286;871;492;1481
522155;201604;817;2301;712;2140;136;363;437;1405;573;1768
522157;201604;659;1822;561;1683;39;140;434;1306;473;1446
522160;201604;5829;16615;4240;13762;1188;4278;369;1160;1557;5438
522170;201604;2289;6685;1846;5873;581;1956;382;1204;963;3160
522180;201604;327;951;245;813;73;266;62;216;135;482
522185;201604;14984;42818;12437;39579;3352;11245;6326;20596;9678;31841
522190;201604;876;2185;669;1892;103;306;327;981;430;1287
522200;201604;1667;5351;1369;4723;349;1298;328;1091;677;2389
522205;201604;1391;3898;1123;3479;215;719;558;1700;773;2419
522220;201604;1361;3599;1104;3287;255;747;562;1826;817;2573
522230;201604;1214;3389;1022;3090;110;405;642;1925;752;2330
530010;201604;219571;683803;194106;639983;51145;186541;64651;208315;115796;394856
110001;201603;3256;10902;2924;10374;697;2575;1407;5076;2104;7651
110002;201603;12713;37529;10056;32886;2977;10558;3033;9785;6010;20343
110003;201603;726;2388;661;2260;192;689;145;477;337;1166
110004;201603;9823;30666;7996;27040;2379;8686;1396;4885;3775;13571
110005;201603;1783;5690;1541;5240;500;1746;607;2071;1107;3817
110006;201603;1868;5734;1313;4651;368;1428;140;440;508;1868
110007;201603;1306;4037;1215;3857;352;1200;468;1673;820;2873
110008;201603;2309;7899;2171;7704;375;1244;1546;5752;1921;6996
110009;201603;4508;13588;3570;12122;1041;3828;1035;3562;2076;7390
110010;201603;7435;22139;6555;21000;1750;5544;3244;11519;4994;17063
110011;201603;7375;22915;6304;20851;2168;7500;1924;6409;4092;13909
110012;201603;13923;41403;11438;37057;3280;11107;2886;9701;6166;20808
110013;201603;5169;16467;4456;15189;1711;6036;1122;4083;2833;10119
110014;201603;3929;11707;3459;10950;861;2810;1781;5687;2642;8497
110015;201603;4679;14009;3398;11588;985;3651;624;2142;1609;5793
110018;201603;3960;11216;2978;9771;766;2826;1036;3265;1802;6091
110020;201603;60679;166920;45445;146435;10162;34823;19712;65784;29874;100607
110025;201603;4155;11985;3406;10678;606;1994;1986;6172;2592;8166
110026;201603;613;1897;564;1823;138;430;310;1049;448;1479
110028;201603;6634;20055;5241;17345;1423;5147;605;1975;2028;7122
110029;201603;1294;3809;1070;3443;315;1051;409;1331;724;2382
110030;201603;10065;27396;7750;24257;2021;6978;3008;9640;5029;16618
110032;201603;3754;11874;3302;11015;1052;3616;930;3087;1982;6703
110033;201603;5182;16527;4690;15717;1508;5066;1727;6166;3235;11232
110034;201603;3308;8947;2743;8184;804;2469;1481;4409;2285;6878
110037;201603;1932;6519;1653;5973;433;1662;686;2468;1119;4130
110040;201603;3354;10583;2874;9713;837;3061;1045;3446;1882;6507
110045;201603;4895;15939;4222;15086;1372;5336;1916;6865;3288;12201
110050;201603;1593;5152;1358;4726;441;1592;571;2011;1012;3603
110060;201603;787;2605;645;2313;228;921;115;387;343;1308
110070;201603;1911;6418;1776;6145;546;2043;741;2474;1287;4517
110080;201603;4165;11511;3637;10909;591;1672;2575;8143;3166;9815
110090;201603;707;2097;556;1827;126;470;237;737;363;1207
110092;201603;1266;4267;1167;4132;193;732;747;2711;940;3443
110094;201603;3528;10599;3085;9988;1033;3576;1206;3919;2239;7495
110100;201603;2104;6708;1916;6356;617;2159;838;2791;1455;4950
110110;201603;1587;5066;1423;4852;582;2007;368;1339;950;3346
110120;201603;1777;5635;1390;4805;406;1482;274;940;680;2422
110130;201603;2361;6884;1770;5842;564;1970;306;1012;870;2982
110140;201603;2289;7508;1925;6805;575;2220;519;1724;1094;3944
110143;201603;1200;3737;909;3233;279;1029;352;1299;631;2328
110145;201603;974;2809;785;2507;197;689;386;1209;583;1898
110146;201603;418;1295;359;1204;71;238;198;690;269;928
110147;201603;688;2039;546;1785;143;475;172;539;315;1014
110148;201603;1202;3651;884;2958;156;546;85;268;241;814
110149;201603;3211;9680;2593;8664;876;2908;1003;3551;1879;6459
110150;201603;2329;6863;1959;6315;544;1851;692;2330;1236;4181
110155;201603;818;2528;735;2339;191;649;305;926;496;1575
110160;201603;1898;6078;1590;5484;566;1988;499;1747;1065;3735
110170;201603;2809;7922;2044;6523;445;1483;965;3074;1410;4557
110175;201603;1586;4887;1285;4484;221;813;678;2504;899;3317
110180;201603;1250;3695;1063;3420;265;834;580;1918;845;2752
120001;201603;2702;9339;2509;9032;504;1909;1519;5625;2023;7534
120005;201603;1481;6240;1391;6062;155;748;1028;4648;1183;5396
120010;201603;4517;15450;4319;15155;545;1916;3276;11784;3821;13700
120013;201603;1782;7138;1701;7022;391;1590;1005;4425;1396;6015
120017;201603;1942;7106;1817;6880;517;1997;783;3322;1300;5319
120020;201603;13853;62179;13405;61312;1977;9298;9547;45210;11524;54508
120025;201603;2387;8380;2296;8253;446;1701;1438;5259;1884;6960
120030;201603;6168;24210;6024;24046;221;1056;5473;21938;5694;22994
120032;201603;1434;7006;1380;6882;171;1052;1000;4980;1171;6032
120033;201603;3456;13993;3375;13848;259;1095;2974;12358;3233;13453
120034;201603;2082;8629;1997;8480;144;829;1647;6907;1791;7736
120035;201603;3041;13913;2970;13775;220;1156;2524;11828;2744;12984
120038;201603;2551;9369;2420;9117;640;2459;1241;4845;1881;7304
120039;201603;1637;8304;1598;8217;157;949;1236;6436;1393;7385
120040;201603;43881;157190;40204;150375;9585;38803;19512;74411;29097;113214
120042;201603;2916;12457;2777;12149;347;1706;1995;8836;2342;10542
120043;201603;896;4220;865;4170;72;347;694;3477;766;3824
120045;201603;4108;14143;4010;14024;534;1975;3243;11412;3777;13387
120050;201603;7842;32620;7480;31836;1057;4827;5133;22533;6190;27360
120060;201603;7437;33588;7282;33311;695;3713;5767;26636;6462;30349
120070;201603;2621;9853;2550;9697;420;1584;1661;6522;2081;8106
120080;201603;3471;13259;3318;12992;618;2537;2280;9119;2898;11656
130002;201603;3020;12528;2846;12260;173;883;2422;10492;2595;11375
130006;201603;1960;8320;1727;7901;250;1301;1199;5513;1449;6814
130008;201603;2100;8406;1967;8172;168;741;1572;6622;1740;7363
130010;201603;2870;9615;2635;9349;173;678;2314;8219;2487;8897
130014;201603;3073;10144;2711;9566;484;1805;1681;6029;2165;7834
130020;201603;2649;9812;2565;9665;66;347;2232;8299;2298;8646
130030;201603;7241;27601;6986;27306;427;1482;6185;24810;6612;26292
130040;201603;3719;11513;3329;10993;285;1012;2673;8983;2958;9995
130050;201603;5853;24151;5552;23721;388;1666;4663;20538;5051;22204
130060;201603;5541;26241;5325;25889;516;3002;4157;20207;4673;23209
130063;201603;3608;16067;3501;15943;298;1471;3012;13856;3310;15327
130068;201603;3113;13091;2819;12478;342;1637;1858;8375;2200;10012
130070;201603;6732;21651;5970;20754;641;2221;4588;16378;5229;18599
130080;201603;5159;23063;4917;22682;750;3855;3454;16139;4204;19994
130083;201603;2079;8273;1964;8112;281;1299;1365;5664;1646;6963
130090;201603;2585;9378;2485;9227;106;509;2209;8171;2315;8680
130100;201603;5576;20771;5439;20604;158;683;5097;19351;5255;20034
130110;201603;6569;21259;6176;20798;707;2194;4931;17163;5638;19357
130115;201603;4358;15533;4147;15211;169;683;3651;13455;3820;14138
130120;201603;14377;54740;13503;53644;1382;5555;10962;44639;12344;50194
130130;201603;3758;15473;3707;15377;213;1091;3225;13345;3438;14436
130140;201603;6242;24246;6135;24126;232;934;5759;22723;5991;23657
130150;201603;3286;13164;3212;13074;165;931;2858;11482;3023;12413
130160;201603;4129;17227;3982;17033;445;2216;3238;13797;3683;16013
130165;201603;2805;11686;2674;11466;253;1238;2128;9175;2381;10413
130170;201603;8959;32279;7921;30998;1037;4367;5895;23538;6932;27905
130180;201603;3423;11337;3357;11246;140;327;3108;10599;3248;10926
130185;201603;11096;35527;9956;34231;889;2788;8108;29220;8997;32008
130190;201603;16405;56686;14422;54146;2627;10032;9332;36515;11959;46547
130195;201603;1895;7963;1830;7876;112;513;1600;6985;1712;7498
130200;201603;1966;7012;1803;6758;450;1664;1070;4167;1520;5831
130210;201603;1214;4855;1150;4772;116;591;954;3918;1070;4509
130220;201603;1963;8068;1793;7747;302;1481;1005;4336;1307;5817
130230;201603;3582;16470;3363;16114;370;1889;2540;12553;2910;14442
130240;201603;8432;32085;7732;31126;394;2124;6661;26823;7055;28947
130250;201603;19123;67202;18009;65798;2650;9510;13159;50152;15809;59662
130255;201603;4148;14513;3885;14105;187;784;3407;12475;3594;13259
130260;201603;237893;781551;214529;742072;62140;228744;89970;314857;152110;543601
130270;201603;6754;28946;6292;28214;855;4096;4547;21010;5402;25106
130280;201603;3212;13347;3107;13223;130;592;2843;12260;2973;12852
130290;201603;11140;39750;10659;39188;225;724;10070;37642;10295;38366
130300;201603;4284;16788;4097;16495;240;1146;3554;14357;3794;15503
130310;201603;4880;18704;4523;18237;326;1416;3796;15552;4122;16968
130320;201603;2887;10384;2645;10051;363;1491;1832;7130;2195;8621
130330;201603;3494;12821;3206;12455;219;1036;2653;10297;2872;11333
130340;201603;17459;67183;16224;65655;2588;10445;12193;50976;14781;61421
130350;201603;3177;13438;3107;13336;277;1578;2559;10820;2836;12398
130353;201603;5916;18214;5188;17293;1129;3687;3109;11224;4238;14911
130356;201603;4501;16264;4242;15896;424;1550;3283;12773;3707;14323
130360;201603;3231;9204;2862;8810;139;370;2595;8181;2734;8551
130370;201603;5266;20662;4596;19794;250;1425;3797;16366;4047;17791
130380;201603;7542;31600;7278;31249;451;2257;6272;27088;6723;29345
130390;201603;4794;21654;4512;21122;480;2562;3347;15812;3827;18374
130395;201603;2088;7457;1874;7049;242;980;1253;4658;1495;5638
130400;201603;2065;7906;1978;7784;140;674;1726;6789;1866;7463
130406;201603;10370;39704;9446;38391;2151;9061;5902;24584;8053;33645
130410;201603;3836;14716;3465;14091;1052;4557;1486;6305;2538;10862
130420;201603;10345;43936;9896;43289;2369;10055;6470;29806;8839;39861
130423;201603;3216;12557;3007;12272;269;1335;2491;10104;2760;11439
130426;201603;2161;9434;2098;9332;239;1125;1637;7445;1876;8570
130430;201603;3322;11870;3196;11688;299;1148;2587;9575;2886;10723
130440;201603;3421;12614;3243;12412;255;1041;2766;10671;3021;11712
140002;201603;1600;5271;1478;5100;116;477;1093;3766;1209;4243
140005;201603;3112;9037;2995;8908;66;164;2873;8605;2939;8769
140010;201603;53976;157521;44821;144159;11191;38286;18543;62665;29734;100951
140015;201603;2752;9017;2591;8821;245;708;2141;7570;2386;8278
140017;201603;3077;9804;2794;9449;272;870;2120;7483;2392;8353
140020;201603;4252;14617;3868;14084;570;2275;2662;9742;3232;12017
140023;201603;2109;7126;1841;6731;201;805;1298;4845;1499;5650
140028;201603;2063;5732;1919;5540;264;861;1376;3795;1640;4656
140030;201603;3595;11444;3360;11138;449;1274;2464;8501;2913;9775
140040;201603;1654;7790;1620;7730;97;580;1433;6796;1530;7376
140045;201603;2391;8922;2181;8631;433;1608;1398;5994;1831;7602
140047;201603;5446;16336;4819;15413;1264;4109;2180;7539;3444;11648
140050;201603;1347;4304;1216;4131;278;958;706;2460;984;3418
140060;201603;1435;4420;1280;4178;241;839;822;2706;1063;3545
140070;201603;1433;7913;1384;7760;121;832;1074;6026;1195;6858
150010;201603;34785;106022;32767;103353;2108;7082;26636;84510;28744;91592
150013;201603;1679;4924;1525;4749;159;483;1190;3804;1349;4287
150020;201603;12248;41220;11840;40661;1343;4315;9543;33656;10886;37971
150030;201603;7002;29929;6782;29598;795;3139;5439;24643;6234;27782
150034;201603;4117;11427;3892;11146;167;491;3476;10007;3643;10498
150040;201603;12640;40815;10927;38761;1885;6024;7713;29454;9598;35478
150050;201603;5569;21884;5333;21492;296;1473;4551;18319;4847;19792
150060;201603;17187;53879;15647;51492;2972;9751;9793;33357;12765;43108
150070;201603;5882;24052;5264;23406;304;1532;4677;20982;4981;22514
150080;201603;70425;183000;60335;169946;11896;33122;33158;98257;45054;131379
150085;201603;5247;17954;4999;17634;476;1451;4151;15193;4627;16644
150090;201603;10018;38611;9493;37848;872;3586;7409;30212;8281;33798
150095;201603;5175;17130;4733;16489;388;1259;3746;13564;4134;14823
150100;201603;3152;11905;2966;11589;166;818;2381;9149;2547;9967
150110;201603;3241;16211;3232;16192;240;1202;2798;14247;3038;15449
150120;201603;6311;23495;6162;23265;551;2029;4993;19428;5544;21457
150125;201603;679;2015;600;1920;106;381;383;1220;489;1601
150130;201603;21726;66016;20131;63841;2431;7423;14753;48196;17184;55619
150140;201603;157699;444001;148218;431780;17196;49451;112403;333034;129599;382485
150145;201603;4395;14168;4016;13684;558;2039;3037;10526;3595;12565
150150;201603;11737;35867;10803;34500;1920;6442;6869;22257;8789;28699
150157;201603;3055;9201;2670;8657;362;1338;1828;6011;2190;7349
150160;201603;3065;9862;2884;9599;938;3175;1438;4965;2376;8140
150170;201603;21354;79053;20185;77194;3093;12082;14036;54793;17129;66875
150172;201603;3032;10386;2668;9786;412;1539;1795;6792;2207;8331
150175;201603;1897;5782;1780;5653;153;483;1438;4763;1591;5246
150178;201603;9833;30664;8712;29424;1140;4091;6124;21412;7264;25503
150180;201603;18191;72967;17505;72083;1346;6229;14693;60992;16039;67221
150190;201603;6843;23353;6578;22991;270;1026;5909;20832;6179;21858
150195;201603;5106;16999;4762;16456;263;996;4085;14223;4348;15219
150200;201603;5230;16659;4996;16391;120;403;4659;15433;4779;15836
150210;201603;24414;92215;23629;91119;2163;8248;19204;76237;21367;84485
150215;201603;6729;21357;5941;20120;1728;6092;2400;8346;4128;14438
150220;201603;11846;36982;10617;35091;2405;8150;5310;18056;7715;26206
150230;201603;11499;36605;10064;34602;1382;5191;6683;23341;8065;28532
150240;201603;34761;103295;30589;96237;10102;32844;8868;29273;18970;62117
150250;201603;3941;16453;3804;16256;657;2820;2669;11848;3326;14668
150260;201603;2026;8076;1935;7918;404;1650;1148;4888;1552;6538
150270;201603;8419;25980;6712;23792;1776;6583;3592;13132;5368;19715
150275;201603;5820;21185;5530;20724;703;2581;3990;15341;4693;17922
150276;201603;2055;6230;1824;5920;408;1392;1190;3892;1598;5284
150277;201603;4729;14735;4108;13970;748;2668;2737;9578;3485;12246
150280;201603;5752;25837;5579;25477;1061;4909;3718;17482;4779;22391
150285;201603;2797;10992;2626;10683;450;1906;1676;7040;2126;8946
150290;201603;9630;28184;9217;27718;682;1682;7847;24490;8529;26172
150293;201603;9457;25921;7208;22830;2153;7269;2350;8228;4503;15497
150295;201603;7444;21804;6164;20315;1512;5051;3319;12048;4831;17099
150300;201603;1874;6392;1767;6250;121;524;1393;4916;1514;5440
150304;201603;4030;12804;3502;11986;573;1974;2226;7913;2799;9887
150307;201603;6321;21477;5876;20859;405;1428;4858;17413;5263;18841
150309;201603;5973;20780;5434;20044;1193;4354;3306;12915;4499;17269
150310;201603;5976;25998;5769;25677;632;3011;4537;20501;5169;23512
150320;201603;9354;22713;8642;21956;573;1245;7368;19098;7941;20343
150330;201603;13532;46487;12687;45262;1781;6352;9183;33851;10964;40203
150340;201603;2392;7774;2212;7496;266;932;1605;5468;1871;6400
150345;201603;6467;21640;6050;21089;577;2003;4789;17105;5366;19108
150350;201603;7801;24335;7264;23643;1215;3338;5235;17952;6450;21290
150360;201603;20651;64445;18131;61225;3101;10418;11855;41873;14956;52291
150370;201603;9749;35705;9109;34856;1312;4767;6779;27217;8091;31984
150375;201603;2841;12463;2748;12336;236;1039;2341;10698;2577;11737
150380;201603;9786;28409;8663;26855;556;1783;7144;22462;7700;24245
150390;201603;7696;33332;7218;32488;1287;5658;4635;21808;5922;27466
150400;201603;5752;22787;5534;22368;478;1951;4378;18060;4856;20011
150405;201603;8069;24456;7172;23354;1295;3427;4810;17331;6105;20758
150410;201603;1582;6027;1462;5782;203;922;885;3496;1088;4418
150420;201603;35977;120896;30517;112080;9435;37775;9319;36352;18754;74127
150430;201603;7192;24429;6841;23882;908;3086;5014;18002;5922;21088
150440;201603;5366;18698;5156;18412;829;2880;3734;13773;4563;16653
150442;201603;20922;60864;18662;57462;3512;10835;11065;35337;14577;46172
150445;201603;5063;17675;4718;17095;618;2232;3426;12747;4044;14979
150450;201603;4207;20492;4071;20287;343;1772;3364;17072;3707;18844
150460;201603;6703;25394;6172;24754;341;1759;5172;21291;5513;23050
150470;201603;16844;51993;16191;51226;436;1145;15197;48685;15633;49830
150475;201603;3054;10585;2821;10285;266;1006;2265;8418;2531;9424
150480;201603;13646;46534;12646;45030;1269;4719;9970;36076;11239;40795
150490;201603;6879;26645;6728;26429;279;1204;5936;23562;6215;24766
150495;201603;4820;18138;4686;17962;190;772;4286;16537;4476;17309
150497;201603;2649;9833;2401;9354;800;3280;1006;3997;1806;7277
150500;201603;3072;8551;2860;8253;245;707;2246;6463;2491;7170
150503;201603;3617;11116;3099;10471;1054;3671;1559;5522;2613;9193
150506;201603;10941;38327;9952;36920;2434;8670;5866;23474;8300;32144
150510;201603;9440;37308;8694;35839;1404;5896;5636;24227;7040;30123
150520;201603;6628;26156;6513;26007;253;999;6030;24329;6283;25328
150530;201603;12043;41160;10884;39407;1125;3884;8287;30692;9412;34576
150540;201603;4582;14009;4097;13343;272;907;3336;10904;3608;11811
150543;201603;5565;17330;4975;16486;1021;3510;2975;10205;3996;13715
150548;201603;8855;28667;8321;27983;511;1618;7409;25305;7920;26923
150549;201603;2002;6534;1850;6363;75;277;1668;5797;1743;6074
150550;201603;19693;62435;17280;58444;5170;18004;6411;22735;11581;40739
150553;201603;22518;77565;18907;70233;6841;27242;4260;16266;11101;43508
150555;201603;1651;5043;1416;4654;92;336;1079;3575;1171;3911
150560;201603;1936;6333;1820;6099;285;947;1125;3790;1410;4737
150563;201603;2627;8758;2440;8441;627;2361;1259;4344;1886;6705
150565;201603;3734;12931;3416;12436;212;967;2786;10195;2998;11162
150570;201603;5670;20949;5536;20717;401;1760;4451;16724;4852;18484
150580;201603;9316;39526;9083;39263;567;2498;7996;35203;8563;37701
150590;201603;5620;22523;5413;22262;169;794;4983;20544;5152;21338
150600;201603;7658;29940;7361;29515;374;1650;6499;26278;6873;27928
150610;201603;2367;8049;2167;7650;226;872;1502;5256;1728;6128
150611;201603;2693;9343;2535;9058;183;714;2032;7297;2215;8011
150613;201603;11747;35422;9789;32481;3177;11133;3711;12685;6888;23818
150616;201603;2987;9135;2330;8065;565;2159;758;2508;1323;4667
150618;201603;6198;21405;5632;20387;1596;5896;2726;10197;4322;16093
150619;201603;5077;17425;4702;16840;562;2224;3367;12082;3929;14306
150620;201603;6258;22518;5736;21846;732;2828;4395;17188;5127;20016
150630;201603;5631;17091;5343;16752;578;1882;4305;13758;4883;15640
150635;201603;3900;12825;3527;12089;858;3076;1551;5477;2409;8553
150640;201603;1795;5461;1725;5377;224;647;1382;4534;1606;5181
150650;201603;12174;36668;10881;34492;2913;9348;4625;15370;7538;24718
150655;201603;4914;16407;4622;15875;679;2347;3251;11361;3930;13708
150658;201603;4331;13238;3790;12493;905;3227;2170;7374;3075;10601
150660;201603;5469;17254;5005;16577;1191;3930;2628;9043;3819;12973
150670;201603;6998;18712;5817;17252;777;2402;4311;13195;5088;15597
150680;201603;55880;197605;49190;186359;14797;58468;18877;77590;33674;136058
150690;201603;2020;6204;1828;5909;290;888;1213;4038;1503;4926
150700;201603;6125;19107;5616;18448;965;3286;3674;12429;4639;15715
150710;201603;4214;14261;3788;13572;453;1690;2686;9854;3139;11544
150715;201603;4847;15358;4228;14425;495;1905;3089;10589;3584;12494
150720;201603;6429;26197;6085;25581;792;3489;4368;18960;5160;22449
150730;201603;9615;32821;8980;31761;1048;3810;6928;25095;7976;28905
150740;201603;3647;11708;3270;11036;678;2390;1719;5839;2397;8229
150745;201603;5064;16148;4583;15484;1144;4054;2698;9142;3842;13196
150746;201603;1379;4480;1316;4371;129;414;944;3172;1073;3586
150747;201603;5296;16558;4703;15818;365;1042;3587;13039;3952;14081
150750;201603;3191;10505;2958;10210;204;825;2406;8339;2610;9164
150760;201603;10710;34938;9995;33999;2127;7377;6286;21948;8413;29325
150770;201603;5731;21894;5449;21417;415;1537;4530;18832;4945;20369
150775;201603;1099;3364;955;3107;198;772;490;1549;688;2321
150780;201603;3200;10464;3105;10359;101;356;2853;9568;2954;9924
150790;201603;4890;16026;4563;15641;343;1224;3646;13274;3989;14498
150795;201603;15038;47591;13580;45407;3060;10129;7879;27614;10939;37743
150796;201603;3001;8885;2726;8559;364;1177;2030;6543;2394;7720
150797;201603;3603;12339;3340;11900;116;501;2822;10031;2938;10532
150800;201603;13486;44623;12426;43320;2737;8974;8066;29967;10803;38941
150803;201603;6512;23692;6129;23071;690;2730;4462;17029;5152;19759
150805;201603;2529;9136;2370;8869;325;1215;1700;6472;2025;7687
150808;201603;5607;18746;4658;16944;1819;7236;637;2356;2456;9592
150810;201603;18587;57686;15696;54200;2259;7455;10412;38283;12671;45738
150812;201603;5114;16221;4719;15562;502;1920;3284;10512;3786;12432
150815;201603;8287;27404;7443;26350;805;2877;5821;21164;6626;24041
150820;201603;11206;32395;10046;31108;749;1794;8258;26458;9007;28252
150830;201603;12799;48107;12026;47109;660;3262;9814;39518;10474;42780
150835;201603;2018;7128;1878;6869;450;1643;905;3435;1355;5078
150840;201603;6791;20899;5706;19128;1310;4803;2664;8917;3974;13720
160005;201603;734;2577;698;2505;68;278;554;1962;622;2240
160010;201603;1289;4345;1285;4340;47;96;1225;4215;1272;4311
160015;201603;1671;6168;1635;6120;93;341;1475;5608;1568;5949
160020;201603;1887;6861;1777;6717;211;840;1334;5155;1545;5995
160021;201603;979;4187;937;4120;144;744;651;2883;795;3627
160023;201603;994;4018;986;4008;102;413;811;3338;913;3751
160025;201603;1281;3943;1267;3929;27;102;1221;3777;1248;3879
160027;201603;7971;23831;7370;23166;2176;6563;4252;14269;6428;20832
160030;201603;45324;159753;40618;151743;9804;37000;21240;84465;31044;121465
160040;201603;4286;16729;4188;16594;170;976;3837;15001;4007;15977
160050;201603;2974;11408;2663;10965;1377;5579;765;3536;2142;9115
160053;201603;2668;10402;2607;10314;518;2131;1759;7073;2277;9204
160055;201603;523;2105;516;2096;32;135;448;1828;480;1963
160060;201603;15175;51702;14173;50553;2650;9069;9830;36304;12480;45373
160070;201603;2435;9629;2295;9387;177;879;1933;7832;2110;8711
160080;201603;2487;9452;2446;9403;101;500;2278;8682;2379;9182
170025;201603;492;1628;451;1570;126;444;229;824;355;1268
170030;201603;1133;3723;993;3474;274;975;366;1344;640;2319
170035;201603;1413;4123;1164;3691;227;796;506;1604;733;2400
170040;201603;1871;5951;1658;5679;196;773;1055;3800;1251;4573
170070;201603;1624;4406;1284;3950;275;918;683;2074;958;2992
170100;201603;2303;6903;2012;6477;224;719;1532;4987;1756;5706
170105;201603;739;2305;582;1988;118;457;272;887;390;1344
170110;201603;926;3040;810;2838;180;683;344;1226;524;1909
170130;201603;1332;4236;1105;3802;307;1110;467;1651;774;2761
170190;201603;1515;4482;1162;3909;426;1389;204;833;630;2222
170200;201603;1559;4386;1016;3350;262;935;231;736;493;1671
170210;201603;30984;88146;24974;78606;7394;25167;6231;20821;13625;45988
170215;201603;1165;3624;988;3353;86;346;700;2361;786;2707
170220;201603;5519;19121;5099;18306;1275;4742;2518;9232;3793;13974
170230;201603;1338;4343;1115;3916;236;934;465;1593;701;2527
170240;201603;2612;7924;2169;7242;258;1017;1459;4820;1717;5837
170255;201603;3267;10534;2749;9634;848;3021;1105;4066;1953;7087
170270;201603;981;2482;693;2091;71;226;464;1387;535;1613
170290;201603;2771;8391;2502;8082;236;514;2053;7121;2289;7635
170300;201603;1887;5815;1573;5311;191;724;1000;3420;1191;4144
170305;201603;736;2198;598;1955;98;352;306;1009;404;1361
170307;201603;1015;3621;859;3335;178;786;397;1601;575;2387
170310;201603;1570;4368;1189;3730;307;1019;511;1643;818;2662
170320;201603;1100;3180;800;2663;197;706;252;858;449;1564
170330;201603;779;2538;706;2425;76;292;528;1786;604;2078
170360;201603;443;1406;367;1274;85;298;158;546;243;844
170370;201603;1323;3790;1038;3336;191;707;536;1684;727;2391
170380;201603;1687;5450;1365;4918;224;918;696;2516;920;3434
170382;201603;549;1832;469;1703;81;335;285;1042;366;1377
170384;201603;1514;6180;1388;5938;330;1484;720;3141;1050;4625
170386;201603;874;2616;760;2447;199;728;312;967;511;1695
170388;201603;614;1851;502;1671;107;409;182;581;289;990
170389;201603;906;3062;823;2924;82;336;599;2111;681;2447
170390;201603;1226;3563;1052;3349;82;289;822;2657;904;2946
170410;201603;526;1679;444;1536;38;162;278;957;316;1119
170460;201603;477;1306;321;1033;73;269;99;321;172;590
170510;201603;740;2494;599;2240;76;332;295;1090;371;1422
170550;201603;6641;18918;4943;15991;1513;5407;597;1929;2110;7336
170555;201603;1279;3728;1030;3339;209;724;481;1619;690;2343
170560;201603;1037;3390;813;3098;170;713;446;1796;616;2509
170600;201603;1281;3786;1141;3593;283;887;693;2247;976;3134
170610;201603;1602;4873;1280;4363;144;550;789;2700;933;3250
170625;201603;408;1243;309;1051;50;161;90;311;140;472
170650;201603;1174;3842;998;3526;261;984;356;1363;617;2347
170700;201603;4032;12664;3275;11408;689;2613;1389;5013;2078;7626
170710;201603;1734;5185;1404;4590;219;751;799;2655;1018;3406
170720;201603;1810;4914;1543;4492;226;560;1103;3399;1329;3959
170730;201603;940;2771;772;2510;195;662;305;1005;500;1667
170740;201603;2131;7553;1847;7037;288;1145;1151;4467;1439;5612
170755;201603;749;2364;605;2047;104;413;233;769;337;1182
170765;201603;1278;3499;971;3003;271;887;363;1168;634;2055
170770;201603;1644;5636;1503;5395;247;914;914;3335;1161;4249
170820;201603;3417;11114;3090;10580;687;2498;1465;5072;2152;7570
170825;201603;691;2079;574;1860;100;333;248;796;348;1129
170830;201603;1360;4013;1172;3737;117;298;958;3184;1075;3482
170900;201603;2462;8818;2324;8597;207;795;1863;7007;2070;7802
170930;201603;3507;10833;3073;10126;862;2988;1206;4124;2068;7112
170950;201603;13511;39316;10143;33441;3009;11312;1520;5061;4529;16373
170980;201603;486;1445;366;1251;73;279;147;483;220;762
171050;201603;1460;4959;1319;4701;85;390;1036;3657;1121;4047
171070;201603;1427;4557;1307;4385;340;1116;664;2352;1004;3468
171090;201603;1030;2822;853;2574;66;188;616;1867;682;2055
171110;201603;579;1695;435;1432;120;443;171;516;291;959
171150;201603;938;2625;663;2149;123;425;362;1194;485;1619
171180;201603;687;2083;480;1660;115;424;173;646;288;1070
171190;201603;1600;5974;1414;5573;285;1183;652;2719;937;3902
171195;201603;791;2838;688;2644;106;440;386;1526;492;1966
171200;201603;664;2094;535;1847;164;627;178;565;342;1192
171215;201603;452;1338;348;1128;55;197;155;512;210;709
171240;201603;698;2546;643;2440;73;344;420;1636;493;1980
171245;201603;603;2022;495;1768;101;410;154;535;255;945
171250;201603;1014;2992;816;2662;158;560;407;1306;565;1866
171270;201603;388;1608;366;1559;122;496;135;658;257;1154
171280;201603;866;2646;721;2400;184;611;300;1098;484;1709
171320;201603;3716;11274;3140;10296;885;2918;1299;4413;2184;7331
171330;201603;2762;8068;2250;7265;640;2178;938;3026;1578;5204
171360;201603;1300;4385;1183;4202;156;582;800;2883;956;3465
171370;201603;625;1818;540;1701;120;418;287;898;407;1316
171380;201603;1254;4072;1052;3711;420;1484;268;1032;688;2516
171395;201603;858;2625;670;2266;127;506;306;999;433;1505
171420;201603;2056;6392;1635;5622;394;1430;578;2012;972;3442
171430;201603;1035;3187;861;2905;187;646;433;1466;620;2112
171488;201603;2440;7501;2106;7022;482;1580;1110;3901;1592;5481
171500;201603;751;2312;654;2157;82;264;447;1520;529;1784
171510;201603;865;3049;779;2904;69;295;553;2098;622;2393
171515;201603;484;1388;378;1200;54;169;211;659;265;828
171525;201603;618;1996;528;1851;83;325;298;1009;381;1334
171550;201603;309;1051;238;915;81;343;44;176;125;519
171570;201603;1195;3801;1043;3505;199;636;669;2319;868;2955
171575;201603;1860;5272;1413;4468;272;888;630;2035;902;2923
171610;201603;5103;16379;4290;14986;1129;4401;1308;4635;2437;9036
171620;201603;2548;7483;2216;7041;94;398;1857;5910;1951;6308
171630;201603;851;2663;701;2423;221;815;289;1018;510;1833
171650;201603;2085;6565;1638;5653;446;1638;499;1753;945;3391
171660;201603;2364;6587;1844;5682;228;784;1074;3309;1302;4093
171665;201603;1443;4232;1161;3803;190;684;645;2207;835;2891
171670;201603;1868;5352;1555;4840;431;1456;620;1894;1051;3350
171700;201603;1067;3452;920;3178;120;466;586;1998;706;2464
171720;201603;706;2101;597;1925;195;641;234;793;429;1434
171750;201603;1131;3539;880;3045;254;884;244;894;498;1778
171780;201603;1113;3094;853;2723;93;318;499;1643;592;1961
171790;201603;1332;4698;1205;4471;262;935;724;2856;986;3791
171800;201603;623;1983;553;1886;72;271;381;1339;453;1610
171820;201603;9768;29047;8160;26706;1631;5760;4181;13893;5812;19653
171830;201603;1333;5024;1202;4735;313;1208;515;2134;828;3342
171840;201603;767;2113;656;1962;37;115;541;1625;578;1740
171845;201603;697;1931;547;1678;87;294;285;898;372;1192
171850;201603;908;3262;807;3065;101;442;503;1897;604;2339
171855;201603;1078;3458;989;3296;78;314;729;2388;807;2702
171865;201603;440;1456;382;1365;77;289;188;667;265;956
171870;201603;705;2123;569;1880;142;515;198;697;340;1212
171875;201603;1240;4002;1044;3693;103;445;695;2418;798;2863
171880;201603;793;3010;773;2982;87;338;610;2419;697;2757
171884;201603;956;2664;704;2294;167;601;183;712;350;1313
171886;201603;1364;4464;1103;3937;319;1246;234;835;553;2081
171888;201603;678;2039;521;1739;53;180;288;988;341;1168
171889;201603;497;1574;444;1488;96;337;221;790;317;1127
171890;201603;1167;3656;985;3396;143;550;570;1956;713;2506
171900;201603;483;1790;417;1648;111;448;190;783;301;1231
172000;201603;529;1774;461;1648;79;303;252;891;331;1194
172010;201603;1159;4050;1075;3910;126;557;775;2803;901;3360
172015;201603;313;1241;266;1148;55;222;146;671;201;893
172020;201603;2219;7441;2066;7198;269;977;1430;5069;1699;6046
172025;201603;691;2013;510;1703;88;321;242;841;330;1162
172030;201603;1127;3687;999;3476;68;298;746;2574;814;2872
172049;201603;1322;3480;988;2916;149;419;709;2175;858;2594
172065;201603;1289;3449;1065;3196;56;161;965;2957;1021;3118
172080;201603;2345;7426;2030;6882;215;844;1301;4372;1516;5216
172085;201603;495;1375;357;1103;57;163;94;294;151;457
172090;201603;3382;9775;2785;8875;194;710;2191;7046;2385;7756
172093;201603;596;1799;475;1602;123;483;224;756;347;1239
172097;201603;571;1746;468;1588;106;358;189;665;295;1023
172100;201603;32503;96530;25089;83680;6840;25443;6125;20646;12965;46089
172110;201603;1631;6138;1452;5851;178;802;1032;4259;1210;5061
172120;201603;4942;15456;4113;14290;686;2360;2535;9223;3221;11583
172125;201603;242;785;202;711;39;165;89;313;128;478
172130;201603;541;1512;425;1323;40;155;272;839;312;994
172208;201603;2026;6075;1823;5788;285;931;1086;3500;1371;4431
172210;201603;2457;7554;2161;7131;529;1883;1098;3595;1627;5478
210005;201603;21416;66813;18174;61868;5799;21095;6446;22479;12245;43574
210010;201603;1579;5682;1435;5434;115;493;1103;4229;1218;4722
210015;201603;3334;10579;2970;10033;196;540;2515;8774;2711;9314
210020;201603;7050;17038;6630;16552;216;566;6023;14976;6239;15542
210030;201603;5428;18187;5095;17734;324;1477;4194;14505;4518;15982
210040;201603;1861;5181;1721;5020;90;264;1504;4417;1594;4681
210043;201603;6654;18692;5730;17546;590;1668;4096;13355;4686;15023
210047;201603;6497;24424;5911;23521;581;2686;4431;17667;5012;20353
210050;201603;2252;8357;1894;7667;675;2785;621;2744;1296;5529
210055;201603;1715;5895;1559;5662;158;609;1172;4301;1330;4910
210060;201603;7142;27768;6641;26854;1018;4236;4300;17917;5318;22153
210070;201603;7019;20740;6489;20091;142;536;5853;18215;5995;18751
210080;201603;3620;12567;3528;12451;40;197;3347;11818;3387;12015
210083;201603;4280;15082;3945;14728;136;585;3688;13848;3824;14433
210087;201603;2914;8618;2651;8279;291;927;2086;6638;2377;7565
210090;201603;9813;32192;9300;31385;512;1814;7968;27071;8480;28885
210095;201603;5869;21417;5638;21098;357;1465;4703;17803;5060;19268
210100;201603;7157;21604;6570;20893;790;2707;5034;15947;5824;18654
210110;201603;2808;9854;2713;9725;104;476;2443;8728;2547;9204
210120;201603;25789;70505;22516;66744;2681;6658;16387;52172;19068;58830
210125;201603;3521;11272;3398;11144;196;500;3002;10144;3198;10644
210130;201603;4085;12167;3783;11744;287;911;3086;9606;3373;10517
210135;201603;1649;4878;1442;4584;100;334;1159;3711;1259;4045
210140;201603;16691;53473;14559;50612;2625;9606;8968;32403;11593;42009
210150;201603;4525;11181;4065;10619;60;164;3809;9949;3869;10113
210160;201603;17357;54779;16313;53282;1371;4075;13193;44362;14564;48437
210170;201603;13640;48796;13282;48350;695;2609;11806;43484;12501;46093
210173;201603;1952;7996;1878;7873;108;619;1622;6730;1730;7349
210177;201603;3037;9445;2884;9268;152;497;2579;8379;2731;8876
210180;201603;1462;4498;1370;4362;60;218;1157;3659;1217;3877
210190;201603;4797;15300;4423;14616;227;977;3402;11049;3629;12026
210193;201603;1372;4338;1238;4119;72;256;1015;3434;1087;3690
210197;201603;2072;6906;1913;6723;235;801;1470;5351;1705;6152
210200;201603;8296;28000;7688;27132;1059;3506;5695;20972;6754;24478
210203;201603;6478;20787;6156;20369;379;1105;5332;17952;5711;19057
210207;201603;3042;9725;2865;9409;316;1016;2079;6957;2395;7973
210210;201603;8339;28204;7978;27727;77;370;7321;25972;7398;26342
210215;201603;1150;4823;1099;4742;95;462;876;3843;971;4305
210220;201603;6008;22905;5714;22436;352;1631;4741;18746;5093;20377
210230;201603;5022;16535;4723;16080;270;955;4019;13822;4289;14777
210232;201603;12710;41006;10707;38461;1507;5723;6937;26837;8444;32560
210235;201603;3591;11262;3216;10793;170;684;2737;9222;2907;9906
210237;201603;2318;8947;2254;8855;41;215;2130;8394;2171;8609
210240;201603;2998;9397;2801;9127;158;474;2345;7723;2503;8197
210250;201603;5130;16614;4829;16223;130;654;4382;14596;4512;15250
210255;201603;2530;8190;2314;7815;310;1104;1643;5590;1953;6694
210260;201603;5075;16640;4670;16030;592;1936;3407;12105;3999;14041
210270;201603;5327;15049;4680;14156;130;594;4112;12329;4242;12923
210275;201603;3560;8656;3394;8479;53;80;3250;8243;3303;8323
210280;201603;5525;16734;4783;15735;269;1137;3669;11927;3938;13064
210290;201603;5535;18500;5117;18002;323;1140;4331;15479;4654;16619
210300;201603;37277;104526;31022;96872;2088;7008;23450;76435;25538;83443
210310;201603;2877;8123;2640;7811;76;175;2331;6983;2407;7158
210312;201603;2178;6900;2074;6766;63;293;1829;5943;1892;6236
210315;201603;2592;8605;2406;8361;152;582;2055;7232;2207;7814
210317;201603;4088;12528;3896;12295;171;606;3520;11160;3691;11766
210320;201603;19039;61571;17523;59752;920;3301;14892;51711;15812;55012
210325;201603;3568;11191;3175;10597;250;950;2448;8286;2698;9236
210330;201603;35595;86747;28063;78652;4017;9589;18148;58428;22165;68017
210340;201603;11512;34936;10496;33620;1172;3267;7693;26425;8865;29692
210350;201603;9856;30552;8900;29227;643;2112;7098;23681;7741;25793
210355;201603;3846;14166;3544;13716;204;877;3021;11940;3225;12817
210360;201603;15762;48050;14384;46172;1084;3818;11272;36336;12356;40154
210370;201603;9267;22306;7787;20727;294;567;6847;18961;7141;19528
210375;201603;3060;9353;2598;8757;768;2665;1223;4285;1991;6950
210380;201603;6036;16767;5377;15872;444;1190;4347;13144;4791;14334
210390;201603;2840;10208;2588;9806;136;720;2181;8250;2317;8970
210400;201603;4739;15083;4539;14858;122;372;4284;14150;4406;14522
210405;201603;8277;22649;6662;20393;2195;6775;2247;7760;4442;14535
210407;201603;2008;7173;1743;6723;215;815;1236;4902;1451;5717
210408;201603;2388;9275;2236;9085;145;681;1885;7891;2030;8572
210409;201603;3667;13451;3461;13155;214;1029;2830;10785;3044;11814
210410;201603;3487;11714;3388;11595;336;1009;2750;9879;3086;10888
210420;201603;3983;13235;3655;12679;267;902;2929;10367;3196;11269
210430;201603;2144;6640;2069;6555;115;367;1808;5764;1923;6131
210440;201603;3893;12302;3773;12151;198;570;3399;11111;3597;11681
210450;201603;2784;8760;2480;8318;144;517;1985;6632;2129;7149
210455;201603;3862;11351;3473;10776;558;1711;2395;7760;2953;9471
210460;201603;3538;11753;3300;11379;184;748;2704;9330;2888;10078
210462;201603;1453;5286;1355;5105;92;442;1071;4029;1163;4471
210465;201603;2513;8372;2349;8147;199;582;1956;7011;2155;7593
210467;201603;6100;20358;5693;19889;400;1434;4785;16978;5185;18412
210470;201603;2024;5512;1520;4774;83;226;1119;3592;1202;3818
210480;201603;14297;46165;12522;43889;2500;8576;7993;30110;10493;38686
210490;201603;3569;10040;3129;9433;139;474;2622;7885;2761;8359
210500;201603;6230;25811;6003;25414;694;2949;4529;19749;5223;22698
210510;201603;6441;22037;6098;21641;357;1069;5183;19017;5540;20086
210515;201603;3593;11552;3441;11381;85;261;3222;10816;3307;11077
210520;201603;2568;7890;2348;7581;160;485;1954;6453;2114;6938
210530;201603;36382;112423;29414;101941;7471;29123;11950;42808;19421;71931
210535;201603;3182;11055;3057;10889;99;336;2758;9965;2857;10301
210540;201603;13331;43835;11693;41532;2509;8700;6503;25075;9012;33775
210542;201603;5698;16597;5226;16084;305;736;4525;14355;4830;15091
210545;201603;2300;7509;2189;7324;57;299;1930;6379;1987;6678
210547;201603;3711;13273;3474;12886;288;976;2695;10301;2983;11277
210550;201603;5999;17957;5507;17446;265;632;5037;16409;5302;17041
210560;201603;4039;12735;3618;12051;186;704;3014;10034;3200;10738
210565;201603;1463;5223;1254;4893;100;505;918;3613;1018;4118
210570;201603;12243;34722;11116;33446;776;1755;9506;29638;10282;31393
210580;201603;3137;9353;2817;8958;312;715;2151;7483;2463;8198
210590;201603;4024;12752;3730;12383;305;1071;3133;10461;3438;11532
210592;201603;2439;7712;2349;7567;41;182;2076;6687;2117;6869
210594;201603;2637;7430;2140;6708;109;292;1670;5421;1779;5713
210596;201603;2652;9898;2513;9635;277;1128;1834;7165;2111;8293
210598;201603;1862;5807;1703;5613;96;361;1462;4786;1558;5147
210600;201603;3160;9201;2773;8689;177;578;2192;6886;2369;7464
210610;201603;2477;8216;2325;8021;122;542;2019;6874;2141;7416
210620;201603;1888;6157;1768;6013;52;145;1597;5555;1649;5700
210630;201603;3589;12745;3213;12137;347;1536;2213;8407;2560;9943
210632;201603;4467;15639;4149;15182;432;1735;3195;11711;3627;13446
210635;201603;1851;6506;1755;6362;126;424;1500;5555;1626;5979
210637;201603;2618;8906;2414;8630;160;635;1949;7027;2109;7662
210640;201603;4143;15203;4074;15126;7;32;3970;14885;3977;14917
210650;201603;6796;20802;6595;20557;234;733;6200;19409;6434;20142
210660;201603;7937;23778;7364;22964;268;949;6693;20833;6961;21782
210663;201603;2679;8053;2519;7864;179;622;2102;6619;2281;7241
210667;201603;1821;6378;1720;6221;84;382;1484;5389;1568;5771
210670;201603;4387;16371;4174;16023;226;1035;3460;13393;3686;14428
210675;201603;5060;14020;4681;13567;372;919;3873;11587;4245;12506
210680;201603;4036;11144;3589;10610;190;495;3069;9203;3259;9698
210690;201603;7240;24375;6948;24066;264;870;6159;22010;6423;22880
210700;201603;2594;7775;2403;7567;399;960;1665;6032;2064;6992
210710;201603;4805;15847;4535;15432;208;894;3822;12949;4030;13843
210720;201603;2532;9250;2392;9056;141;656;2090;7861;2231;8517
210725;201603;1074;4076;964;3876;118;508;605;2504;723;3012
210730;201603;1110;3510;990;3336;102;295;761;2637;863;2932
210735;201603;4116;14315;3766;13742;621;2341;2562;9651;3183;11992
210740;201603;4929;14758;4652;14474;206;891;4211;12841;4417;13732
210745;201603;3901;11574;3658;11269;252;695;3076;9595;3328;10290
210750;201603;20182;54757;17817;52104;1944;5689;13634;40944;15578;46633
210760;201603;5826;16582;5421;16158;39;138;5266;15744;5305;15882
210770;201603;5839;16118;5106;15285;122;502;4614;13783;4736;14285
210780;201603;8111;27209;7443;26097;833;2986;5249;18902;6082;21888
210790;201603;4610;14570;4189;14088;271;699;3426;12168;3697;12867
210800;201603;4738;13493;4289;12964;147;453;3808;11624;3955;12077
210805;201603;3699;15500;3570;15276;170;896;3068;13225;3238;14121
210810;201603;5350;16401;4963;15913;354;714;4250;14276;4604;14990
210820;201603;7651;22281;6984;21335;1149;3373;4637;14628;5786;18001
210825;201603;5581;19310;5321;18957;639;2182;4108;15129;4747;17311
210830;201603;8275;24439;7852;23937;874;2285;6203;19733;7077;22018
210840;201603;3617;9954;3249;9415;158;404;2678;7793;2836;8197
210845;201603;5729;17584;5548;17387;84;198;5328;16923;5412;17121
210850;201603;5991;21429;5431;20502;705;2983;3720;14093;4425;17076
210860;201603;17567;52299;15804;49919;1326;4222;12350;39646;13676;43868
210870;201603;5798;19536;5302;18909;590;2059;4015;14648;4605;16707
210880;201603;4207;13751;4010;13498;317;1174;3300;11131;3617;12305
210890;201603;5147;15191;4681;14659;486;1376;3777;12372;4263;13748
210900;201603;4907;14707;4057;13337;1470;5091;1015;3588;2485;8679
210905;201603;1809;5746;1626;5494;133;351;1276;4500;1409;4851
210910;201603;8478;27061;7652;25709;1117;4008;5138;17404;6255;21412
210920;201603;2864;10348;2741;10142;171;794;2235;8260;2406;9054
210923;201603;1489;5135;1386;4986;145;588;931;3472;1076;4060
210927;201603;4733;15259;4487;15000;54;204;4302;14463;4356;14667
210930;201603;2428;8955;2291;8757;129;738;1928;7233;2057;7971
210940;201603;2807;10880;2744;10760;174;787;2319;9078;2493;9865
210945;201603;5832;17694;5639;17491;272;372;5259;16803;5531;17175
210950;201603;5259;16208;4556;15109;422;1420;3371;11430;3793;12850
210955;201603;1865;6045;1652;5728;178;619;1153;4176;1331;4795
210960;201603;8683;28860;8311;28361;2075;6774;4876;17787;6951;24561
210970;201603;1334;4777;1180;4533;153;675;816;3130;969;3805
210975;201603;1759;5893;1686;5771;118;429;1341;4617;1459;5046
210980;201603;9931;23600;9599;23262;748;1455;8397;20993;9145;22448
210990;201603;16543;50383;13465;46187;3117;11244;6646;23819;9763;35063
211000;201603;15185;49151;13515;47166;806;3404;11177;39596;11983;43000
211003;201603;4726;16932;4326;16387;307;1432;3278;12733;3585;14165
211010;201603;6433;23508;6174;23206;76;353;5881;22253;5957;22606
211020;201603;7343;23877;7124;23560;626;2224;5776;19116;6402;21340
211023;201603;2214;7517;2136;7389;180;675;1735;6022;1915;6697
211027;201603;2894;11195;2817;11077;299;1212;2242;8929;2541;10141
211030;201603;3824;11772;3578;11512;596;1389;2669;9400;3265;10789
211040;201603;4247;16167;4080;15912;148;803;3552;13919;3700;14722
211050;201603;10056;26129;9682;25722;285;718;9046;24078;9331;24796
211060;201603;6062;21566;5886;21324;456;1725;5035;18459;5491;20184
211065;201603;1885;6249;1741;6065;66;206;1603;5674;1669;5880
211070;201603;7987;27567;7350;26543;408;1606;6083;22271;6491;23877
211080;201603;1325;4079;1138;3794;78;375;877;2815;955;3190
211085;201603;1852;6386;1691;6116;293;1083;1073;3966;1366;5049
211090;201603;3482;10227;3256;9919;127;521;2800;8394;2927;8915
211100;201603;6585;17037;6442;16888;37;126;6276;16480;6313;16606
211102;201603;2986;11323;2818;11085;237;962;2353;9417;2590;10379
211105;201603;2638;8528;2256;7947;213;854;1663;5808;1876;6662
211107;201603;4356;14020;3947;13501;230;796;3200;11313;3430;12109
211110;201603;6288;18770;5072;16957;967;3162;3000;10552;3967;13714
211120;201603;35198;98196;31736;94153;5678;16071;21289;66139;26967;82210
211125;201603;2072;6620;1836;6248;119;460;1515;5165;1634;5625
211130;201603;135581;375576;124012;361406;22734;67116;74594;225678;97328;292794
211140;201603;5324;17259;4976;16749;186;743;4238;14267;4424;15010
211150;201603;9567;27944;8644;26796;442;1608;7260;22524;7702;24132
211153;201603;2816;8682;2576;8371;393;1217;1911;6442;2304;7659
211157;201603;1194;3841;1034;3604;88;393;685;2467;773;2860
211160;201603;4094;13480;3481;12462;258;1249;2408;8410;2666;9659
211163;201603;1646;5478;1553;5352;37;118;1405;4952;1442;5070
211167;201603;1484;4999;1422;4916;36;170;1324;4580;1360;4750
211170;201603;6313;16756;6048;16446;106;316;5604;15189;5710;15505
211172;201603;2424;7172;2204;6868;124;540;1867;5723;1991;6263
211174;201603;2745;8032;2476;7701;73;360;2229;6819;2302;7179
211176;201603;4201;13230;3616;12460;402;1525;2550;8925;2952;10450
211178;201603;3806;10168;3583;9929;66;176;3412;9452;3478;9628
211180;201603;4169;14653;3932;14305;294;1205;3236;11884;3530;13089
211190;201603;2780;9360;2576;9062;73;354;2251;7916;2324;8270
211195;201603;1459;4462;1221;4169;56;170;1030;3639;1086;3809
211200;201603;2139;7129;1883;6780;369;1247;1127;4371;1496;5618
211210;201603;6704;20705;6381;20282;443;1354;5335;17146;5778;18500
211220;201603;33532;97589;29175;92069;5678;18469;18028;58501;23706;76970
211223;201603;4990;14840;4571;14185;560;1788;3268;10215;3828;12003
211227;201603;1597;5702;1458;5483;144;588;1132;4310;1276;4898
211230;201603;8308;27193;7525;25918;817;2910;5594;19586;6411;22496
211240;201603;7946;27520;7532;27012;262;1199;6747;24011;7009;25210
211245;201603;5393;16163;5358;16126;120;197;5183;15819;5303;16016
211250;201603;13031;43143;12293;42291;1572;4405;9475;34838;11047;39243
211260;201603;8461;26344;8085;25844;539;1888;7088;22632;7627;24520
211270;201603;10162;35032;9108;33718;532;2423;7138;27000;7670;29423
211280;201603;12731;37951;11904;36963;1094;2835;9654;31233;10748;34068
211285;201603;1703;6262;1495;5814;274;1146;746;3031;1020;4177
211290;201603;7132;23522;6855;23169;491;1489;5821;20099;6312;21588
211300;201603;8181;24733;7669;24058;157;444;7140;22618;7297;23062
211400;201603;11683;36616;10324;34735;2820;9684;4819;17888;7639;27572
220005;201603;1823;5238;1680;5032;72;281;1363;3985;1435;4266
220010;201603;1328;3947;1188;3733;53;214;946;2916;999;3130
220020;201603;3235;10319;3070;10051;599;1968;1881;6187;2480;8155
220025;201603;2224;5484;2021;5185;24;75;1725;4366;1749;4441
220027;201603;1353;3662;1219;3489;63;193;993;2859;1056;3052
220030;201603;3135;8751;3075;8664;147;514;2714;7540;2861;8054
220040;201603;7421;23297;6909;22394;1453;4688;4166;13574;5619;18262
220045;201603;1368;4512;1247;4281;55;250;961;3232;1016;3482
220050;201603;4373;13278;3844;12397;203;831;3069;9782;3272;10613
220060;201603;1975;5056;1864;4929;49;99;1695;4502;1744;4601
220070;201603;2383;7060;2189;6753;161;493;1753;5430;1914;5923
220080;201603;699;2121;650;2047;53;222;540;1644;593;1866
220090;201603;1744;4471;1473;4116;50;163;1279;3521;1329;3684
220095;201603;711;1935;664;1872;14;65;611;1690;625;1755
220100;201603;1327;4074;1124;3725;79;320;842;2767;921;3087
220105;201603;2224;7105;1997;6683;158;525;1461;4933;1619;5458
220110;201603;3332;9758;3134;9443;112;462;2741;8110;2853;8572
220115;201603;2408;8323;2315;8176;138;590;2038;7139;2176;7729
220117;201603;1282;3444;1068;3124;67;196;863;2540;930;2736
220120;201603;12051;35120;11178;34083;144;635;10488;31950;10632;32585
220130;201603;823;2897;748;2776;34;201;642;2328;676;2529
220140;201603;1640;4413;1453;4187;194;454;1149;3435;1343;3889
220150;201603;6933;21328;6567;20817;164;691;5787;18179;5951;18870
220155;201603;1098;3377;897;3012;54;221;587;1940;641;2161
220157;201603;1054;2682;939;2512;23;73;815;2150;838;2223
220160;201603;2584;7834;2310;7338;92;414;1849;5780;1941;6194
220170;201603;1350;4150;1166;3854;50;242;932;3047;982;3289
220173;201603;2039;6177;1692;5514;46;222;1338;4286;1384;4508
220177;201603;1750;5202;1721;5164;50;197;1613;4811;1663;5008
220180;201603;1113;3078;939;2752;23;86;654;1831;677;1917
220190;201603;4466;14838;4154;14415;582;2079;3059;10678;3641;12757
220191;201603;1404;4650;1324;4517;154;560;968;3260;1122;3820
220192;201603;1748;4985;1411;4389;97;320;1018;3174;1115;3494
220194;201603;1634;4979;1475;4715;106;398;1123;3504;1229;3902
220196;201603;1957;5807;1801;5545;144;505;1410;4316;1554;4821
220198;201603;1320;3794;1022;3402;12;42;956;3230;968;3272
220200;201603;4341;14566;4070;14188;587;2083;2975;10503;3562;12586
220202;201603;2111;6445;1891;6068;45;222;1629;5121;1674;5343
220205;201603;2735;7184;2462;6803;38;154;2203;6021;2241;6175
220207;201603;882;2689;755;2463;71;287;535;1717;606;2004
220208;201603;1790;5770;1552;5357;229;886;935;3225;1164;4111
220209;201603;1517;4623;1365;4382;49;215;1116;3540;1165;3755
220210;201603;1662;4536;1478;4254;35;155;1228;3454;1263;3609
220211;201603;1546;4510;1481;4436;61;255;1293;3811;1354;4066
220213;201603;1718;4901;1598;4682;34;135;1310;3742;1344;3877
220217;201603;1947;6305;1875;6225;43;168;1729;5802;1772;5970
220220;201603;10696;29819;9641;28264;750;1946;7052;21248;7802;23194
220225;201603;1076;3142;904;2913;36;136;747;2385;783;2521
220230;201603;5250;14603;4802;13962;154;444;4280;12505;4434;12949
220240;201603;2853;8895;2644;8526;146;544;2095;6736;2241;7280
220245;201603;1458;3968;1259;3693;23;80;1119;3329;1142;3409
220250;201603;3141;9039;2874;8640;84;335;2507;7529;2591;7864
220253;201603;1604;4852;1384;4452;174;632;956;3047;1130;3679
220255;201603;1714;4877;1490;4499;48;206;1201;3465;1249;3671
220260;201603;4591;14846;4093;13943;317;1122;2993;10309;3310;11431
220265;201603;1317;4564;1205;4392;125;507;774;2873;899;3380
220270;201603;6741;21756;6510;21356;359;1602;5422;17252;5781;18854
220271;201603;1465;4114;1321;3889;80;205;1092;3292;1172;3497
220272;201603;1770;5359;1617;5105;54;225;1280;3970;1334;4195
220273;201603;1185;3472;1053;3239;86;267;763;2353;849;2620
220275;201603;2053;5292;1714;4888;27;118;1541;4333;1568;4451
220277;201603;2191;6168;1943;5787;81;275;1553;4567;1634;4842
220280;201603;1540;4172;1358;3858;84;296;1083;2990;1167;3286
220285;201603;1573;4245;1311;3881;32;120;1171;3483;1203;3603
220290;201603;5821;19797;5091;18780;467;2012;3726;13796;4193;15808
220300;201603;1789;6090;1640;5870;81;431;1340;4691;1421;5122
220310;201603;2352;8122;2219;7975;78;337;1916;7024;1994;7361
220320;201603;3054;9331;2605;8510;261;965;1818;5897;2079;6862
220323;201603;1432;5136;1259;4884;139;582;959;3759;1098;4341
220325;201603;1147;3722;983;3396;76;323;704;2418;780;2741
220327;201603;1280;4157;1178;3984;33;174;965;3190;998;3364
220330;201603;3414;9526;3161;9215;99;291;2866;8429;2965;8720
220335;201603;1822;5632;1655;5445;36;106;1543;5137;1579;5243
220340;201603;1820;5073;1566;4684;96;312;1211;3602;1307;3914
220342;201603;1099;3665;1036;3570;61;271;836;2856;897;3127
220345;201603;2838;7334;2508;6842;63;149;2276;6232;2339;6381
220350;201603;3898;10402;3362;9575;195;588;2598;7357;2793;7945
220360;201603;1269;3550;1099;3284;104;333;826;2433;930;2766
220370;201603;9013;26230;8236;25240;339;1203;7297;22310;7636;23513
220375;201603;1465;4698;1375;4587;14;41;1322;4458;1336;4499
220380;201603;1362;3671;1149;3383;45;158;953;2751;998;2909
220385;201603;829;2136;673;1889;16;62;539;1483;555;1545
220390;201603;9314;28659;8281;26871;2107;7038;3114;10394;5221;17432
220400;201603;1506;3595;1218;3153;42;144;1001;2511;1043;2655
220410;201603;1199;3527;1047;3290;70;270;819;2532;889;2802
220415;201603;869;2383;766;2246;53;165;549;1579;602;1744
220420;201603;2130;6190;1809;5558;77;235;1423;4369;1500;4604
220430;201603;2541;7234;2473;7145;134;454;2161;6177;2295;6631
220435;201603;1613;4814;1489;4610;38;157;1240;3806;1278;3963
220440;201603;2353;7824;2213;7641;144;536;1840;6293;1984;6829
220450;201603;2050;6385;1727;5919;389;1417;970;3357;1359;4774
220455;201603;1310;4154;1225;4032;53;189;1104;3659;1157;3848
220460;201603;879;2415;810;2337;39;117;701;2005;740;2122
220465;201603;2300;7682;2102;7376;463;1704;1274;4531;1737;6235
220470;201603;3764;11234;3445;10724;174;558;2696;8322;2870;8880
220480;201603;2471;7086;2209;6716;149;404;1704;5233;1853;5637
220490;201603;2252;6503;2079;6288;57;220;1839;5519;1896;5739
220500;201603;3206;8668;2742;7879;87;396;2188;6107;2275;6503
220510;201603;2710;7887;2214;7048;96;369;1617;5110;1713;5479
220515;201603;1857;4597;1661;4337;140;327;1348;3563;1488;3890
220520;201603;5121;14067;4684;13494;109;323;4206;12188;4315;12511
220525;201603;1259;3612;1198;3517;40;138;1032;3017;1072;3155
220527;201603;1359;4190;1205;3881;130;437;853;2801;983;3238
220530;201603;1230;3574;1094;3374;49;203;951;2867;1000;3070
220535;201603;858;2609;816;2553;76;254;617;1920;693;2174
220540;201603;3411;11107;3266;10881;121;536;2837;9373;2958;9909
220545;201603;1365;4595;1298;4468;149;577;964;3285;1113;3862
220550;201603;9040;29166;8405;28116;771;2766;6271;20910;7042;23676
220551;201603;1438;4633;1315;4443;69;314;1047;3485;1116;3799
220552;201603;1573;4931;1364;4529;60;305;1049;3361;1109;3666
220553;201603;1590;4658;1313;4235;48;202;1015;3339;1063;3541
220554;201603;785;2316;701;2185;58;194;548;1698;606;1892
220555;201603;2207;6740;2047;6519;47;239;1851;5819;1898;6058
220556;201603;1430;4443;1281;4160;51;203;973;3090;1024;3293
220557;201603;1551;5039;1391;4729;135;472;942;3214;1077;3686
220558;201603;1068;3277;959;3098;50;227;741;2322;791;2549
220559;201603;1519;4297;1381;4060;28;101;1202;3517;1230;3618
220560;201603;1617;4083;1366;3748;54;151;1148;3104;1202;3255
220570;201603;7196;23316;6768;22558;1349;4479;4108;14098;5457;18577
220580;201603;6427;20451;6286;20250;251;868;5719;18369;5970;19237
220585;201603;2025;7077;1898;6845;175;678;1489;5371;1664;6049
220590;201603;1307;3935;1176;3749;173;584;808;2642;981;3226
220595;201603;2286;6803;2133;6602;35;165;1943;5960;1978;6125
220600;201603;1266;3080;1052;2814;162;282;771;2229;933;2511
220605;201603;1928;5656;1682;5266;71;244;1361;4211;1432;4455
220610;201603;2676;8159;2565;8007;57;226;2340;7282;2397;7508
220620;201603;7474;25101;7198;24729;309;1508;6374;21618;6683;23126
220630;201603;390;1211;331;1104;44;158;177;608;221;766
220635;201603;1652;5812;1489;5459;81;401;1077;3853;1158;4254
220640;201603;2629;7720;2363;7349;107;377;1987;6141;2094;6518
220650;201603;2200;6457;1968;6042;119;410;1506;4629;1625;5039
220660;201603;2625;8140;2364;7796;148;712;1985;6319;2133;7031
220665;201603;1150;3989;1076;3860;22;118;950;3395;972;3513
220667;201603;1681;5576;1573;5403;81;281;1305;4497;1386;4778
220669;201603;1849;6072;1753;5907;249;1028;1197;3940;1446;4968
220670;201603;1934;5771;1722;5493;127;345;1420;4656;1547;5001
220672;201603;2456;7116;2303;6934;204;643;1909;5794;2113;6437
220675;201603;1258;3622;1176;3474;67;168;931;2775;998;2943
220680;201603;2325;7359;2194;7188;152;496;1837;6070;1989;6566
220690;201603;1693;4703;1469;4349;114;339;1135;3421;1249;3760
220695;201603;923;2617;844;2486;32;103;669;1964;701;2067
220700;201603;8409;24077;7322;22408;513;1758;5549;16865;6062;18623
220710;201603;804;2396;683;2186;41;122;496;1597;537;1719
220720;201603;2043;5391;1936;5255;52;157;1717;4634;1769;4791
220730;201603;1360;3859;1162;3553;21;100;992;3001;1013;3101
220735;201603;1000;2581;807;2249;41;122;648;1784;689;1906
220740;201603;1362;4341;1186;4107;87;289;964;3426;1051;3715
220750;201603;3915;11187;3627;10747;361;900;2848;8663;3209;9563
220755;201603;1198;3380;1074;3182;50;177;862;2514;912;2691
220760;201603;2611;9063;2406;8790;147;723;2013;7263;2160;7986
220770;201603;21759;72370;19553;68186;6364;23259;6101;22218;12465;45477
220775;201603;1241;3345;1197;3296;17;48;1161;3200;1178;3248
220777;201603;1591;4381;1370;4052;67;163;1069;3161;1136;3324
220779;201603;1376;3568;1308;3478;48;169;1150;3008;1198;3177
220780;201603;5785;15628;5119;14641;371;1070;4105;11781;4476;12851
220785;201603;1282;3328;1210;3214;40;105;1107;2915;1147;3020
220790;201603;9989;30619;9251;29502;716;2552;7404;23459;8120;26011
220793;201603;810;2338;732;2225;37;137;607;1842;644;1979
220795;201603;1410;4083;1361;4017;62;184;1237;3673;1299;3857
220800;201603;15921;43770;14360;41591;898;3011;10803;30863;11701;33874
220810;201603;3314;9592;2878;8860;116;469;2293;6958;2409;7427
220820;201603;5376;14720;4917;14085;246;688;4268;12188;4514;12876
220830;201603;7454;21022;6935;20210;571;1690;5445;15950;6016;17640
220840;201603;13934;44230;12449;41328;2841;9567;5815;19764;8656;29331
220850;201603;2812;9743;2669;9560;108;499;2388;8565;2496;9064
220855;201603;618;1891;538;1748;33;136;400;1268;433;1404
220860;201603;931;2510;828;2347;34;120;703;1968;737;2088
220865;201603;2569;7122;2076;6263;62;305;1656;4826;1718;5131
220870;201603;2218;7460;1976;7143;56;262;1789;6463;1845;6725
220880;201603;4700;12833;4390;12471;86;260;4100;11694;4186;11954
220885;201603;1246;4560;1109;4302;90;430;825;3179;915;3609
220887;201603;1374;3419;1211;3189;16;64;1122;2935;1138;2999
220890;201603;1604;5571;1440;5268;117;416;1109;4151;1226;4567
220900;201603;1808;5181;1609;4880;51;145;1362;4108;1413;4253
220910;201603;1514;4643;1327;4365;43;127;1165;3901;1208;4028
220915;201603;1021;2884;876;2604;26;109;668;1922;694;2031
220920;201603;1337;4797;1209;4612;92;446;900;3373;992;3819
220930;201603;1374;4542;1312;4448;53;235;1103;3732;1156;3967
220935;201603;1070;3267;948;3015;40;170;646;1980;686;2150
220937;201603;1496;4115;1264;3729;57;217;967;2784;1024;3001
220940;201603;1328;4225;1243;4064;76;326;915;2949;991;3275
220945;201603;425;1578;387;1504;29;136;278;1064;307;1200
220950;201603;1302;3242;969;2714;24;101;710;1927;734;2028
220955;201603;1420;4146;1256;3863;81;249;944;2906;1025;3155
220960;201603;906;2355;722;2050;18;56;566;1596;584;1652
220965;201603;1619;4860;1528;4723;51;262;1298;3874;1349;4136
220970;201603;2152;5698;1608;4817;135;422;1108;3354;1243;3776
220975;201603;662;2172;616;2111;27;160;559;1851;586;2011
220980;201603;1263;3826;1112;3581;74;258;824;2666;898;2924
220985;201603;1176;3513;1114;3428;84;313;847;2534;931;2847
220987;201603;1470;4697;1326;4465;76;347;1022;3365;1098;3712
220990;201603;1808;5257;1578;4873;35;186;1246;3753;1281;3939
220995;201603;1268;3733;967;3253;105;370;658;2301;763;2671
220997;201603;2205;6899;2111;6766;46;214;1959;6231;2005;6445
221000;201603;4181;12848;3913;12389;302;1165;3043;9472;3345;10637
221005;201603;1445;4520;1327;4302;534;1584;513;1826;1047;3410
221010;201603;1130;2996;968;2795;42;129;834;2388;876;2517
221020;201603;1745;5447;1625;5226;64;273;1209;3823;1273;4096
221030;201603;1472;4406;1327;4164;64;268;1076;3337;1140;3605
221035;201603;1440;3977;1352;3862;58;123;1238;3623;1296;3746
221037;201603;625;1848;558;1741;14;54;406;1218;420;1272
221038;201603;599;1686;488;1495;38;116;307;948;345;1064
221039;201603;916;2607;828;2478;46;189;674;1945;720;2134
221040;201603;4503;14030;4223;13576;186;653;3443;11138;3629;11791
221050;201603;3448;10507;3240;10228;157;568;2795;8783;2952;9351
221060;201603;8016;23586;7026;21993;545;1860;5302;16560;5847;18420
221062;201603;1259;4448;1161;4258;49;246;947;3454;996;3700
221063;201603;1044;3450;955;3279;201;651;584;2121;785;2772
221065;201603;2780;7581;2504;7151;116;323;2066;5841;2182;6164
221070;201603;3718;11787;3281;11034;140;551;2610;8815;2750;9366
221080;201603;3411;8859;2897;8156;94;294;2461;6920;2555;7214
221090;201603;1392;3844;1189;3514;31;140;985;2850;1016;2990
221093;201603;1620;4858;1532;4680;253;823;881;2627;1134;3450
221095;201603;945;2524;842;2372;15;46;722;2017;737;2063
221097;201603;784;2215;642;1964;31;129;453;1346;484;1475
221100;201603;110889;324868;101759;309846;20170;64427;57698;173256;77868;237683
221110;201603;10184;32178;9491;31329;403;1698;8009;26177;8412;27875
221120;201603;3991;13017;3787;12664;710;2469;2430;8167;3140;10636
221130;201603;4510;13108;3826;11708;1110;3395;1652;5139;2762;8534
221135;201603;1480;4563;1369;4416;109;418;1141;3638;1250;4056
221140;201603;1330;3262;1211;3108;38;85;1053;2690;1091;2775
221150;201603;1209;3100;1008;2760;28;121;780;2093;808;2214
221160;201603;818;2173;770;2106;35;95;606;1665;641;1760
221170;201603;1134;3484;1050;3346;51;170;845;2695;896;2865
230010;201603;3386;9136;2721;8004;201;679;2063;5962;2264;6641
230015;201603;2908;10022;2729;9637;390;1570;1665;5774;2055;7344
230020;201603;13558;44378;13180;43764;696;2640;11112;36805;11808;39445
230030;201603;11891;34222;10703;32371;459;1668;8750;26202;9209;27870
230040;201603;4501;12341;3795;11130;285;978;2723;7861;3008;8839
230050;201603;2626;8982;2090;7589;452;1701;692;2545;1144;4246
230060;201603;2188;6308;1879;5757;69;277;1438;4336;1507;4613
230070;201603;4153;11551;3585;10628;292;1016;2407;7160;2699;8176
230075;201603;8720;31202;8162;30099;542;2890;6316;22628;6858;25518
230080;201603;2376;6268;1931;5625;100;361;1568;4526;1668;4887
230090;201603;3833;11134;3401;10393;405;1392;2371;7239;2776;8631
230100;201603;16376;48856;15094;46579;2489;8288;8920;27705;11409;35993
230110;201603;12953;41246;11909;39053;2269;7724;6213;20200;8482;27924
230120;201603;7866;21850;6792;20267;765;2212;4495;14139;5260;16351
230125;201603;3032;8759;2513;7841;163;599;1817;5607;1980;6206
230130;201603;5756;18821;4947;17121;441;1720;3314;11359;3755;13079
230140;201603;3487;11138;2968;10187;298;1120;2010;6975;2308;8095
230150;201603;1677;5250;1453;4794;287;1021;750;2446;1037;3467
230160;201603;6161;18477;5513;17515;267;1069;4410;13911;4677;14980
230170;201603;6247;19653;5430;18116;328;1284;3849;12731;4177;14015
230180;201603;1700;5026;1492;4609;82;356;1076;3158;1158;3514
230185;201603;3910;12780;3525;12090;560;1972;2167;7640;2727;9612
230190;201603;12565;40182;11126;37301;2218;8058;5213;17354;7431;25412
230195;201603;5244;16020;4591;14920;353;1381;3477;11041;3830;12422
230200;201603;5096;14690;4578;13690;427;1344;3337;9897;3764;11241
230205;201603;4112;13340;3711;12641;243;1096;2625;8807;2868;9903
230210;201603;8833;25449;7739;23723;1359;4252;4561;14277;5920;18529
230220;201603;13070;37261;11805;35095;1075;3602;8484;24793;9559;28395
230230;201603;7233;23212;6632;22059;830;2817;4409;14799;5239;17616
230240;201603;13757;38597;12136;35934;575;1929;9351;27369;9926;29298
230250;201603;9662;30079;9584;29955;540;2021;7533;23221;8073;25242
230260;201603;14107;47300;13124;45323;2134;7871;7362;25948;9496;33819
230270;201603;7466;21981;6419;20169;725;2542;4153;13152;4878;15694
230280;201603;19651;57823;17516;54205;1501;4866;12867;39659;14368;44525
230290;201603;4789;14472;4097;13079;563;1731;2696;8679;3259;10410
230300;201603;4384;13193;4186;12914;254;941;3387;10315;3641;11256
230310;201603;4772;14255;4220;13332;227;932;3039;9432;3266;10364
230320;201603;6953;21749;6340;20677;430;1721;4657;15004;5087;16725
230330;201603;4756;13947;4039;12539;323;1072;2808;8620;3131;9692
230340;201603;3310;11204;3019;10599;354;1387;1920;6624;2274;8011
230350;201603;17978;54643;16415;52003;1795;6602;9810;31533;11605;38135
230360;201603;3251;9287;2632;8156;219;756;1713;5241;1932;5997
230365;201603;2975;8105;2605;7470;114;436;2067;5865;2181;6301
230370;201603;53619;171439;48491;162743;12930;45427;20155;70305;33085;115732
230380;201603;6412;18870;5365;16919;289;986;3797;11912;4086;12898
230390;201603;3452;10934;3067;10284;224;1000;2156;7065;2380;8065
230393;201603;3173;10414;2726;9535;179;884;1934;6517;2113;7401
230395;201603;5612;16464;5026;15468;768;2397;2971;9434;3739;11831
230400;201603;5424;16460;4777;15439;264;1208;3675;11618;3939;12826
230410;201603;14226;45284;12382;41453;1720;6069;7237;24293;8957;30362
230420;201603;23998;77113;21805;72826;4675;16758;9978;33146;14653;49904
230423;201603;4123;13640;3813;13033;246;1040;2857;9699;3103;10739
230425;201603;5485;18241;5046;17313;711;2513;3153;10882;3864;13395
230426;201603;2668;7492;2124;6478;69;300;1572;4670;1641;4970
230427;201603;1821;5427;1398;4494;179;596;784;2447;963;3043
230428;201603;8595;26751;8169;25983;1312;4584;4677;14698;5989;19282
230430;201603;4517;14332;4181;13729;302;1229;3004;9634;3306;10863
230435;201603;4910;15571;4404;14644;756;2872;2351;7690;3107;10562
230440;201603;349665;1031929;319901;981635;73707;237035;145475;450288;219182;687323
230445;201603;4487;12135;3823;11148;276;798;2681;7847;2957;8645
230450;201603;3545;11229;3095;10408;331;1422;2040;6719;2371;8141
230460;201603;1926;6307;1665;5828;162;636;1139;3963;1301;4599
230465;201603;4025;11983;3398;10849;229;957;2243;6964;2472;7921
230470;201603;10754;39247;9964;37617;1274;5340;6729;25398;8003;30738
230480;201603;1461;4579;1233;4149;148;582;812;2679;960;3261
230490;201603;2250;6890;1955;6314;294;1012;956;3002;1250;4014
230495;201603;5731;18889;5135;17823;701;2913;2786;9525;3487;12438
230500;201603;8851;31447;8442;30643;589;2596;6295;22799;6884;25395
230510;201603;1496;5307;1170;4478;301;1234;346;1317;647;2551
230520;201603;4796;14609;4335;13804;442;1603;2764;8683;3206;10286
230523;201603;14493;46934;12726;42968;2892;10609;3062;10621;5954;21230
230526;201603;4042;12067;3460;11046;201;876;2632;8228;2833;9104
230530;201603;5331;17147;4823;16441;871;3156;3146;11041;4017;14197
230533;201603;4017;11134;3466;10098;444;1206;2345;6952;2789;8158
230535;201603;5522;16278;4834;15071;653;2005;2930;9497;3583;11502
230540;201603;17310;50653;15633;48021;597;2388;12914;39194;13511;41582
230550;201603;19242;57084;17159;53213;3027;10234;8855;26802;11882;37036
230560;201603;6737;19368;5907;17873;195;808;4533;13465;4728;14273
230565;201603;3406;9451;2763;8270;115;431;2033;6032;2148;6463
230570;201603;3608;9900;3214;9402;104;407;2677;7749;2781;8156
230580;201603;9916;29937;9177;28877;483;1816;7810;24465;8293;26281
230590;201603;8994;27912;7737;25559;574;2414;5404;17341;5978;19755
230600;201603;3840;10553;2953;8821;147;488;1897;5661;2044;6149
230610;201603;6086;19423;5592;18624;764;2549;3804;12912;4568;15461
230620;201603;2159;6167;1729;5255;206;666;954;2816;1160;3482
230625;201603;7776;25187;7022;23461;2012;7250;2035;6786;4047;14036
230630;201603;10858;34396;9968;32767;2626;8107;4546;16098;7172;24205
230640;201603;25679;83561;23660;80554;2640;10010;17420;59023;20060;69033
230650;201603;4838;14884;4377;14007;292;1164;3307;10323;3599;11487
230655;201603;9061;34285;8724;33659;747;3200;6798;26423;7545;29623
230660;201603;6038;18909;5172;17270;313;1411;3919;12781;4232;14192
230670;201603;6062;16163;4868;14109;148;522;3735;10521;3883;11043
230680;201603;2647;7798;2281;7092;345;1093;1316;4091;1661;5184
230690;201603;6303;20448;6116;20053;623;2353;3893;12465;4516;14818
230700;201603;9382;26283;8391;24550;625;2253;5945;16836;6570;19089
230710;201603;7446;24187;6480;22394;665;2362;4539;15803;5204;18165
230720;201603;1825;5793;1584;5293;204;713;924;3072;1128;3785
230725;201603;3661;12413;3193;11275;760;2748;1021;3606;1781;6354
230730;201603;56278;170206;47546;155709;12927;47546;10646;36569;23573;84115
230740;201603;6078;18107;5499;17140;214;890;4389;13473;4603;14363
230750;201603;8334;24040;7154;22107;380;1440;5403;16452;5783;17892
230760;201603;10609;31466;9814;29903;1059;3691;6631;19450;7690;23141
230763;201603;4258;13036;3801;12181;208;926;2860;8828;3068;9754
230765;201603;38192;120656;34298;113103;8787;30923;9907;33658;18694;64581
230770;201603;24769;68609;22353;65197;2853;8748;14683;42807;17536;51555
230780;201603;5892;22681;5645;22125;1381;5585;2706;11101;4087;16686
230790;201603;2763;8819;2545;8450;240;898;1869;6228;2109;7126
230800;201603;7426;26312;6770;24869;1454;5699;2920;10613;4374;16312
230810;201603;12091;39040;11380;37848;820;2980;8794;29211;9614;32191
230820;201603;3265;11263;2874;10413;408;1674;1574;5623;1982;7297
230830;201603;7397;22418;6555;20847;454;1756;4778;14973;5232;16729
230835;201603;3939;10428;3243;9385;177;578;2480;7143;2657;7721
230837;201603;3172;10752;2782;9988;281;1223;1834;6451;2115;7674
230840;201603;9043;29403;8300;28136;663;2585;6264;21302;6927;23887
230850;201603;9470;29526;8789;28362;1036;3420;5958;19413;6994;22833
230860;201603;5052;14435;4495;13636;204;759;3652;11002;3856;11761
230870;201603;18644;48931;16077;45117;700;2219;12324;34412;13024;36631
230880;201603;1947;6578;1847;6370;138;614;1287;4348;1425;4962
230890;201603;3908;14240;3625;13625;440;2037;2278;8281;2718;10318
230900;201603;2898;9637;2453;8699;513;1747;1085;3991;1598;5738
230910;201603;3124;9118;2572;8136;195;858;1863;5689;2058;6547
230920;201603;4617;13418;4293;13010;258;970;3545;10726;3803;11696
230930;201603;7245;21850;6409;20294;592;1987;4283;13589;4875;15576
230940;201603;7752;22128;6826;20691;289;991;5509;16741;5798;17732
230945;201603;6002;18319;5333;17250;424;1548;3630;11962;4054;13510
230950;201603;6365;17478;5768;16689;236;666;4917;14533;5153;15199
230960;201603;14155;43450;12971;41200;2498;8305;5919;19048;8417;27353
230970;201603;13557;41244;11929;38268;2351;8314;5141;16188;7492;24502
230980;201603;2910;9094;2548;8439;675;2216;1187;4178;1862;6394
230990;201603;1747;5172;1456;4616;117;496;923;2802;1040;3298
231000;201603;2679;7336;2140;6286;137;472;1356;3859;1493;4331
231010;201603;3119;8547;2543;7598;266;857;1661;4838;1927;5695
231020;201603;7779;26184;7380;25356;1277;4401;4453;15605;5730;20006
231025;201603;7899;24172;7197;22977;883;3008;4722;15287;5605;18295
231030;201603;7558;24521;6428;22259;1120;4129;3373;11750;4493;15879
231040;201603;3166;9994;2812;9294;157;699;2031;6496;2188;7195
231050;201603;11786;33600;10065;30584;754;2548;7251;21907;8005;24455
231060;201603;2340;7646;2172;7335;136;689;1582;5165;1718;5854
231070;201603;8587;27173;7762;25507;1355;4654;4141;13757;5496;18411
231080;201603;4030;12527;3660;11917;173;884;2795;8731;2968;9615
231085;201603;4748;14713;4559;14456;656;2082;3146;10305;3802;12387
231090;201603;4150;11619;3349;10045;178;618;2298;6794;2476;7412
231095;201603;2177;7038;1896;6470;207;791;1211;4138;1418;4929
231100;201603;3183;9842;2673;8869;186;741;1887;6201;2073;6942
231110;201603;3508;11703;3473;11639;337;1303;2390;7949;2727;9252
231120;201603;1968;6723;1865;6512;282;1042;1137;4030;1419;5072
231123;201603;2045;5657;1770;5193;136;390;1341;3932;1477;4322
231126;201603;6232;17736;5274;16135;268;1050;3842;11606;4110;12656
231130;201603;18999;58162;17177;55177;3264;10845;9828;33029;13092;43874
231135;201603;4110;12329;3523;11272;245;857;2457;7841;2702;8698
231140;201603;16916;53083;14890;49268;1202;5330;9774;31234;10976;36564
231150;201603;5728;16473;4908;14980;788;2524;2404;7399;3192;9923
231160;201603;5794;19092;5401;18303;963;3264;3070;10517;4033;13781
231170;201603;4223;13548;3790;12672;271;1134;2627;8548;2898;9682
231180;201603;13907;41463;12472;38626;2113;7023;6882;20939;8995;27962
231190;201603;4530;12770;3818;11689;241;867;2891;8658;3132;9525
231195;201603;4559;15286;3952;14099;403;1792;2650;9310;3053;11102
231200;201603;7765;26440;6799;24438;422;2167;4788;16719;5210;18886
231210;201603;4912;15506;4290;14639;280;1343;3297;11101;3577;12444
231220;201603;11712;33860;10328;31297;497;1914;7596;22547;8093;24461
231230;201603;9092;30343;8261;29065;763;3217;6025;21172;6788;24389
231240;201603;11985;37466;10834;35177;2273;7581;5089;16760;7362;24341
231250;201603;1974;5696;1393;4294;433;1317;294;897;727;2214
231260;201603;3454;10268;3108;9722;537;1665;1834;5886;2371;7551
231270;201603;7177;19767;6343;18463;307;1287;4766;13517;5073;14804
231280;201603;1737;5685;1625;5483;178;632;1093;3714;1271;4346
231290;201603;33414;113101;30210;105903;6317;24471;12164;41652;18481;66123
231300;201603;4479;12985;3639;11341;245;927;2421;7329;2666;8256
231310;201603;7323;20831;6104;18315;869;2643;3405;10112;4274;12755
231320;201603;6963;21306;5920;19271;303;1309;4172;13493;4475;14802
231325;201603;2752;8082;2419;7576;259;858;1597;5068;1856;5926
231330;201603;12102;38253;10491;35139;1664;5618;5984;20331;7648;25949
231335;201603;5334;15250;4635;13963;180;762;3643;10713;3823;11475
231340;201603;17275;57167;15966;55136;1090;3805;12518;44150;13608;47955
231350;201603;13633;41650;12961;40722;887;2662;10940;34831;11827;37493
231355;201603;4468;14212;4107;13610;266;1078;2997;9840;3263;10918
231360;201603;7625;24266;6768;22766;1155;3939;4120;14219;5275;18158
231370;201603;2402;6702;1878;5834;74;234;1391;4327;1465;4561
231375;201603;4218;14366;3955;13886;230;1071;3105;10769;3335;11840
231380;201603;5301;16547;5017;16182;465;1634;3666;12101;4131;13735
231390;201603;3415;10683;3139;10204;260;914;2202;7106;2462;8020
231395;201603;3787;12458;3455;11835;585;2009;1932;6726;2517;8735
231400;201603;8958;27666;8336;26437;521;2023;6141;19182;6662;21205
231410;201603;14137;47930;13037;46299;1235;4600;9821;35244;11056;39844
240010;201603;2423;7262;2031;6485;328;1157;985;3041;1313;4198
240020;201603;10468;32969;9403;30990;1997;6997;4418;14690;6415;21687
240030;201603;2439;7024;2359;6904;118;438;2016;5782;2134;6220
240040;201603;834;2457;706;2200;25;124;496;1468;521;1592
240050;201603;3428;9276;2920;8405;106;363;2321;6577;2427;6940
240060;201603;1395;3992;1244;3711;50;191;987;2836;1037;3027
240070;201603;2528;7498;2357;7171;369;1185;1509;4502;1878;5687
240080;201603;3028;8116;2628;7569;170;485;2010;5795;2180;6280
240090;201603;2270;6124;1868;5408;38;143;1457;4120;1495;4263
240100;201603;8095;23265;7247;21555;608;2023;5146;14907;5754;16930
240110;201603;4737;14893;4253;13925;629;2354;2367;7474;2996;9828
240120;201603;2660;9172;2540;8935;375;1455;1585;5543;1960;6998
240130;201603;2711;7384;2385;6872;104;353;1930;5479;2034;5832
240140;201603;2206;6627;1889;6053;288;1125;1071;3296;1359;4421
240145;201603;5697;18085;5162;17111;1431;4936;2402;8217;3833;13153
240150;201603;966;2967;804;2623;76;309;514;1621;590;1930
240160;201603;1432;4603;1245;4280;157;594;764;2709;921;3303
240165;201603;898;2825;793;2612;109;329;476;1657;585;1986
240170;201603;2301;7014;2021;6497;491;1730;904;2874;1395;4604
240180;201603;2594;8269;2312;7684;430;1523;1310;4433;1740;5956
240185;201603;1398;4660;1307;4510;82;314;1032;3571;1114;3885
240190;201603;959;3027;861;2863;45;214;640;2097;685;2311
240200;201603;13375;35149;11204;32129;2519;7510;4745;14028;7264;21538
240210;201603;2881;8058;2604;7650;163;601;2123;6107;2286;6708
240220;201603;7251;24353;6741;23594;641;2888;5010;17248;5651;20136
240230;201603;5665;15024;4915;13861;145;461;4147;11686;4292;12147
240240;201603;1819;5527;1275;4224;253;922;223;648;476;1570
240250;201603;2637;7744;2480;7525;113;359;2121;6431;2234;6790
240260;201603;12051;40745;11447;39756;1802;6951;7236;25047;9038;31998
240270;201603;2230;7170;2056;6879;182;639;1561;5296;1743;5935
240280;201603;1542;4358;1374;4112;74;258;1096;3267;1170;3525
240290;201603;1243;3964;1108;3701;56;297;721;2262;777;2559
240300;201603;2257;6230;1677;5020;285;917;668;1950;953;2867
240310;201603;9416;26985;8555;25643;1128;3720;4775;14497;5903;18217
240320;201603;2014;6001;1628;5225;52;233;1158;3592;1210;3825
240325;201603;33911;93937;27305;83537;8306;27345;5818;18719;14124;46064
240330;201603;1478;4508;1252;4032;72;290;789;2453;861;2743
240340;201603;2002;5303;1694;4812;173;509;1228;3464;1401;3973
240350;201603;1906;5588;1796;5457;102;373;1569;4741;1671;5114
240360;201603;6942;21068;6202;19965;1427;4785;3099;10350;4526;15135
240370;201603;2002;5527;1605;4798;190;530;977;2973;1167;3503
240375;201603;840;2293;740;2123;90;302;490;1320;580;1622
240380;201603;2410;7214;1863;5992;245;821;926;2947;1171;3768
240390;201603;916;2545;778;2296;38;145;550;1573;588;1718
240400;201603;1320;3626;1086;3204;84;295;749;2149;833;2444
240410;201603;480;1593;432;1496;78;333;235;777;313;1110
240420;201603;4596;17695;4327;17089;873;3880;2287;9050;3160;12930
240430;201603;3246;9232;2968;8725;130;535;2333;6626;2463;7161
240440;201603;2467;6451;2214;6078;506;1458;1180;3211;1686;4669
240450;201603;3821;11420;3291;10422;300;1265;2038;6098;2338;7363
240460;201603;2878;8868;2718;8655;175;773;2202;6810;2377;7583
240470;201603;3541;11115;2824;9556;791;2552;1273;4426;2064;6978
240480;201603;519;1386;408;1174;32;104;206;573;238;677
240485;201603;1931;6134;1707;5682;253;904;1048;3529;1301;4433
240490;201603;1662;4287;1397;3871;36;132;1163;3160;1199;3292
240500;201603;2119;6096;1921;5802;129;445;1491;4471;1620;4916
240510;201603;1750;5232;1641;5068;113;391;1319;4056;1432;4447
240520;201603;1207;3554;1099;3366;115;411;808;2407;923;2818
240530;201603;1951;6348;1796;6104;376;1316;1118;3807;1494;5123
240540;201603;1709;5164;1636;5047;112;367;1344;4132;1456;4499
240550;201603;795;2283;686;2093;40;140;512;1536;552;1676
240560;201603;3163;9208;2954;8892;365;1069;2191;6652;2556;7721
240570;201603;3043;8544;2304;6899;501;1605;769;2045;1270;3650
240580;201603;7516;23655;6992;22733;758;2735;5267;16912;6025;19647
240590;201603;769;2173;675;2000;28;105;510;1479;538;1584
240600;201603;1617;4775;1274;4053;139;517;703;2147;842;2664
240610;201603;4565;13176;4004;12104;466;1523;2497;7389;2963;8912
240615;201603;1026;3019;828;2640;170;584;431;1330;601;1914
240620;201603;1750;5457;1550;5125;177;555;1129;3786;1306;4341
240630;201603;2015;6184;1850;5900;166;463;1287;4228;1453;4691
240640;201603;894;2582;761;2367;55;255;528;1571;583;1826
240650;201603;3825;11475;3429;10894;180;645;2725;8632;2905;9277
240660;201603;2326;7519;2181;7307;180;679;1691;5637;1871;6316
240670;201603;2616;7826;2187;6932;279;935;1213;3810;1492;4745
240680;201603;1482;4372;1205;3879;108;376;748;2372;856;2748
240690;201603;947;2609;815;2384;47;177;645;1832;692;2009
240700;201603;2556;7693;2154;6956;77;342;1634;5167;1711;5509
240710;201603;18678;49066;16236;45444;3072;8550;8927;25615;11999;34165
240720;201603;5184;14905;4714;14043;1459;4508;2022;5807;3481;10315
240725;201603;1050;3171;853;2740;71;238;493;1547;564;1785
240730;201603;2102;6379;1836;5881;115;408;1355;4324;1470;4732
240740;201603;1933;5719;1729;5354;146;582;1215;3624;1361;4206
240750;201603;2093;7900;1958;7638;487;2071;879;3448;1366;5519
240760;201603;1321;3614;1112;3333;107;261;816;2622;923;2883
240770;201603;3101;8948;2776;8498;148;620;2282;6869;2430;7489
240780;201603;6007;16636;4869;14816;767;2359;2661;8247;3428;10606
240790;201603;893;2714;747;2449;33;128;525;1731;558;1859
240800;201603;34882;100213;31101;93925;7393;23072;12458;38282;19851;61354
240810;201603;83915;242647;77752;232248;20535;62413;34800;106306;55335;168719
240820;201603;6275;19154;5495;17924;1302;4581;2200;7511;3502;12092
240830;201603;8578;26733;8021;25924;378;1629;6715;21422;7093;23051
240840;201603;1197;3369;1019;3083;86;277;626;1837;712;2114
240850;201603;1268;3753;948;3013;129;429;475;1501;604;1930
240860;201603;1289;3700;1064;3296;49;180;805;2429;854;2609
240870;201603;1163;3209;952;2822;81;267;591;1678;672;1945
240880;201603;1156;3875;1091;3773;89;403;865;2893;954;3296
240890;201603;4947;14146;4192;12735;896;2832;1703;5069;2599;7901
240895;201603;2599;9012;2401;8660;257;1021;1705;6206;1962;7227
240910;201603;2830;8546;2511;7937;148;564;1902;5943;2050;6507
240920;201603;749;2445;652;2236;121;472;301;1003;422;1475
240930;201603;3430;8996;3028;8503;140;388;2479;7068;2619;7456
240933;201603;1396;3988;1244;3734;86;312;949;2774;1035;3086
240940;201603;6394;17343;5190;15307;802;2364;2985;8762;3787;11126
240950;201603;956;3164;892;3048;59;280;674;2230;733;2510
240960;201603;788;2465;701;2299;66;232;491;1633;557;1865
240970;201603;1889;5281;1592;4776;96;367;1207;3496;1303;3863
240980;201603;2924;9712;2712;9320;495;1787;1603;5542;2098;7329
240990;201603;2733;8187;2573;7879;428;1402;1549;4663;1977;6065
241000;201603;1050;2935;892;2658;44;164;619;1818;663;1982
241010;201603;2786;9461;2607;9114;320;1353;1813;6117;2133;7470
241020;201603;2020;5678;1655;4945;175;516;1002;2941;1177;3457
241025;201603;1628;4951;1457;4647;70;313;1034;3238;1104;3551
241030;201603;2461;8165;2210;7668;211;909;1541;5266;1752;6175
241040;201603;2185;7501;2003;7177;179;756;1428;5137;1607;5893
241050;201603;1265;3763;1111;3495;64;254;825;2528;889;2782
241060;201603;857;2490;771;2350;51;166;563;1690;614;1856
241070;201603;773;2240;702;2116;62;218;509;1476;571;1694
241080;201603;1133;3384;943;3010;35;157;685;2151;720;2308
241090;201603;2144;6372;1816;5804;124;572;1354;4232;1478;4804
241100;201603;1177;3518;1025;3166;98;329;657;2013;755;2342
241105;201603;1156;3533;1015;3275;232;760;461;1559;693;2319
241110;201603;808;2534;681;2272;54;220;422;1366;476;1586
241120;201603;7225;22251;6599;21225;1501;4802;3560;11969;5061;16771
241140;201603;3386;9298;2934;8413;306;868;2000;5644;2306;6512
241142;201603;716;2136;534;1735;137;504;191;574;328;1078
241150;201603;5372;15950;4804;14971;529;1754;3196;9950;3725;11704
241160;201603;968;2837;873;2675;134;414;541;1660;675;2074
241170;201603;1140;3367;1063;3232;90;277;826;2506;916;2783
241180;201603;937;2630;764;2298;96;308;395;1156;491;1464
241190;201603;1186;3273;946;2781;58;206;600;1682;658;1888
241200;201603;18617;54557;16594;51424;4098;13435;6823;21669;10921;35104
241210;201603;1434;4051;1151;3465;164;573;614;1777;778;2350
241220;201603;7738;25594;7223;24646;1828;6456;3493;12237;5321;18693
241230;201603;2981;8801;2762;8454;159;614;2288;6880;2447;7494
241240;201603;1207;3575;826;2689;88;320;353;1152;441;1472
241250;201603;5983;18476;5013;16604;200;1078;3794;12150;3994;13228
241255;201603;1656;6373;1535;6091;347;1519;734;2903;1081;4422
241260;201603;5081;13765;4104;12237;177;763;3031;8820;3208;9583
241270;201603;1840;5681;1626;5250;118;460;1096;3482;1214;3942
241280;201603;1840;5341;1682;5042;165;505;1208;3603;1373;4108
241290;201603;2983;8402;2537;7634;211;737;1770;5230;1981;5967
241300;201603;1443;4161;1251;3821;54;179;881;2697;935;2876
241310;201603;1608;4810;1475;4585;109;408;1126;3463;1235;3871
241320;201603;910;3131;833;2974;105;431;518;1838;623;2269
241330;201603;1421;4455;1339;4348;92;396;1117;3552;1209;3948
241335;201603;2718;8298;2515;7937;140;517;2068;6473;2208;6990
241340;201603;1822;5660;1567;5104;366;1303;658;2046;1024;3349
241350;201603;1889;6042;1715;5708;135;574;1263;4080;1398;4654
241355;201603;1409;3948;1157;3521;50;184;919;2778;969;2962
241360;201603;2043;5580;1697;4912;73;213;1218;3433;1291;3646
241370;201603;1347;4049;1116;3583;129;478;649;2028;778;2506
241380;201603;646;1846;552;1668;77;252;316;929;393;1181
241390;201603;2721;8990;2540;8677;254;1029;1876;6361;2130;7390
241400;201603;3728;10798;3407;10357;396;1293;2520;7726;2916;9019
241410;201603;2467;7574;2233;7247;465;1614;1283;4135;1748;5749
241415;201603;1632;4947;1480;4710;92;352;1182;3692;1274;4044
241420;201603;2261;7813;1998;7361;611;2463;457;1665;1068;4128
241430;201603;568;1695;445;1417;46;163;244;735;290;898
241440;201603;6182;22373;5821;21795;1035;4163;3873;14621;4908;18784
241445;201603;995;2909;949;2855;82;214;764;2447;846;2661
241450;201603;2996;8214;2633;7706;303;974;1805;5231;2108;6205
241460;201603;3377;9874;3001;9142;238;842;2142;6361;2380;7203
241470;201603;1364;3817;1116;3489;129;448;772;2398;901;2846
241475;201603;1239;3732;1043;3343;36;173;770;2386;806;2559
241480;201603;2747;9136;2531;8755;1013;3664;527;2016;1540;5680
241490;201603;672;1782;580;1657;36;93;359;1007;395;1100
241500;201603;758;2422;648;2248;38;169;493;1690;531;1859
250010;201603;2719;8544;2333;7694;111;500;1737;5592;1848;6092
250020;201603;1643;4729;1277;4061;73;284;835;2562;908;2846
250030;201603;6885;20113;6437;19482;459;1471;5264;15868;5723;17339
250040;201603;4110;13772;3802;13108;575;2043;2327;8038;2902;10081
250050;201603;3397;10724;3180;10392;468;1585;2126;6910;2594;8495
250053;201603;1212;3654;1111;3515;138;470;761;2439;899;2909
250057;201603;619;2656;608;2644;10;17;576;2587;586;2604
250060;201603;5063;15173;4750;14718;408;1442;3753;11505;4161;12947
250070;201603;3949;12303;3666;11825;140;679;2876;8965;3016;9644
250073;201603;753;2300;667;2152;38;146;535;1705;573;1851
250077;201603;2131;6247;1793;5713;136;454;1223;3942;1359;4396
250080;201603;4115;12027;3931;11720;312;981;3052;8940;3364;9921
250090;201603;2531;7366;2406;7166;103;300;1971;5819;2074;6119
250100;201603;3806;12547;3602;12178;321;1223;2744;9140;3065;10363
250110;201603;5031;15089;4762;14710;421;1550;3770;11449;4191;12999
250115;201603;518;1670;466;1561;28;150;310;972;338;1122
250120;201603;1919;5898;1678;5434;95;346;1277;4123;1372;4469
250130;201603;5233;16465;4850;15826;232;994;4065;13172;4297;14166
250135;201603;1049;3183;965;3040;41;147;759;2401;800;2548
250140;201603;1981;6696;1904;6574;167;699;1469;5068;1636;5767
250150;201603;4986;16796;4537;15969;275;1233;3350;11629;3625;12862
250153;201603;1412;3888;1245;3653;46;207;1054;3013;1100;3220
250157;201603;1708;5606;1577;5357;170;670;1138;3839;1308;4509
250160;201603;3232;9753;3109;9573;120;457;2827;8676;2947;9133
250170;201603;1519;4582;1390;4387;161;576;1002;3159;1163;3735
250180;201603;15538;45846;14668;44519;1375;4913;10748;31752;12123;36665
250190;201603;4163;12048;3809;11503;616;1888;2301;6886;2917;8774
250200;201603;2002;5868;1677;5390;100;387;1370;4366;1470;4753
250205;201603;860;2986;808;2885;48;245;593;2106;641;2351
250210;201603;1415;4775;1329;4647;113;478;1007;3437;1120;3915
250215;201603;1349;4438;1276;4325;93;390;846;2847;939;3237
250220;201603;731;2231;647;2116;34;144;530;1727;564;1871
250230;201603;1513;3884;1266;3486;49;175;1031;2722;1080;2897
250240;201603;2293;7715;2170;7489;115;455;1743;6013;1858;6468
250250;201603;4250;12953;3936;12542;174;604;3390;10850;3564;11454
250260;201603;1692;5171;1477;4831;73;264;1152;3777;1225;4041
250270;201603;1242;3929;1135;3797;93;311;865;2989;958;3300
250280;201603;3577;10646;3166;10003;354;1130;2334;7408;2688;8538
250290;201603;1877;5046;1596;4681;35;143;1433;4211;1468;4354
250300;201603;5430;15988;5160;15670;540;2223;4183;12205;4723;14428
250310;201603;1148;3534;1033;3351;74;288;792;2531;866;2819
250320;201603;7923;24218;7522;23559;876;3098;5188;15844;6064;18942
250330;201603;2377;7479;2068;7029;138;574;1578;5291;1716;5865
250340;201603;1089;3242;984;3069;32;124;842;2594;874;2718
250350;201603;4053;11395;3647;10912;134;498;3143;9424;3277;9922
250355;201603;1867;6046;1722;5844;66;336;1471;4902;1537;5238
250360;201603;1847;5464;1728;5287;66;184;1476;4550;1542;4734
250370;201603;11353;33478;10317;32334;824;2668;8803;27763;9627;30431
250375;201603;1063;3271;983;3156;29;120;847;2722;876;2842
250380;201603;1634;4724;1556;4628;92;361;1329;3873;1421;4234
250390;201603;1870;5080;1520;4494;167;471;1000;2999;1167;3470
250400;201603;71760;191153;57326;168458;14458;44880;21300;63744;35758;108624
250403;201603;1489;4897;1378;4747;222;878;851;2877;1073;3755
250407;201603;1168;3331;1017;3087;68;206;745;2207;813;2413
250410;201603;540;1769;507;1713;26;128;399;1312;425;1440
250415;201603;1804;5468;1639;5178;99;334;1231;3848;1330;4182
250420;201603;1229;3679;1124;3522;28;117;992;3085;1020;3202
250430;201603;5988;16583;5585;15989;264;898;4633;13021;4897;13919
250435;201603;1348;4158;1218;3929;127;477;848;2711;975;3188
250440;201603;4331;12643;4020;12213;168;526;3379;10265;3547;10791
250450;201603;1918;5483;1718;5219;64;229;1450;4351;1514;4580
250460;201603;6300;19104;5895;18570;558;1857;4578;14621;5136;16478
250470;201603;1550;4226;1319;3911;129;453;887;2522;1016;2975
250480;201603;3708;11326;3465;11000;100;436;3046;9662;3146;10098
250485;201603;655;1651;545;1486;30;94;434;1151;464;1245
250490;201603;3742;11850;3655;11727;741;2337;2525;8201;3266;10538
250500;201603;1728;5296;1563;5033;294;898;996;3327;1290;4225
250510;201603;4720;13530;4245;12831;170;576;3697;11198;3867;11774
250520;201603;1718;5204;1610;5036;222;733;969;2978;1191;3711
250523;201603;1571;5034;1526;4969;190;705;1152;3698;1342;4403
250527;201603;1373;4164;1306;4084;22;114;1199;3696;1221;3810
250530;201603;596;1858;522;1768;22;68;463;1595;485;1663
250535;201603;1298;4101;1230;3966;48;218;994;3133;1042;3351
250540;201603;2369;6838;2217;6663;43;184;1964;5809;2007;5993
250550;201603;893;2969;813;2848;48;231;639;2189;687;2420
250560;201603;1638;5162;1580;5081;74;323;1396;4416;1470;4739
250570;201603;2578;8260;2263;7652;138;606;1720;5684;1858;6290
250580;201603;1122;3009;968;2775;82;283;753;2093;835;2376
250590;201603;846;2671;798;2612;73;290;659;2109;732;2399
250600;201603;7226;21103;6790;20487;708;2026;5205;15903;5913;17929
250610;201603;3105;9007;2884;8675;236;769;2199;6575;2435;7344
250620;201603;687;2026;609;1867;94;308;368;1110;462;1418
250625;201603;2353;7613;2311;7565;89;209;2173;7242;2262;7451
250630;201603;9303;29040;8574;27606;2034;6566;4243;13827;6277;20393
250640;201603;3389;10468;3238;10283;159;688;2819;8809;2978;9497
250650;201603;792;2306;710;2179;46;174;517;1506;563;1680
250660;201603;1783;4846;1635;4653;22;49;1543;4426;1565;4475
250670;201603;2333;7945;2216;7740;135;641;1825;6248;1960;6889
250680;201603;4738;13583;4507;13306;236;715;3948;11709;4184;12424
250690;201603;5917;15501;5645;15185;427;1096;4945;13324;5372;14420
250700;201603;4680;13901;4306;13351;690;2214;2812;8690;3502;10904
250710;201603;4155;13347;3904;12992;510;1789;2700;9125;3210;10914
250720;201603;2642;7710;2483;7477;83;358;2173;6464;2256;6822
250730;201603;3409;10432;3200;10144;245;848;2441;7608;2686;8456
250740;201603;1873;5501;1633;5133;161;612;1229;3738;1390;4350
250750;201603;97788;277373;90399;266759;12039;38952;60726;177030;72765;215982
250760;201603;2218;6378;1999;6067;120;458;1661;4983;1781;5441
250770;201603;3818;12862;3626;12611;475;1853;2502;8659;2977;10512
250780;201603;1810;5312;1575;4888;162;604;1008;3020;1170;3624
250790;201603;2366;7756;2248;7566;463;1541;1329;4632;1792;6173
250800;201603;2622;7375;2329;6907;87;286;1923;5593;2010;5879
250810;201603;1279;3767;1119;3518;70;290;873;2701;943;2991
250820;201603;1823;5769;1747;5675;66;275;1584;5113;1650;5388
250830;201603;5577;18053;5174;17253;544;2094;3533;11524;4077;13618
250840;201603;891;2910;758;2626;52;219;514;1778;566;1997
250850;201603;1951;6060;1775;5773;90;429;1389;4421;1479;4850
250855;201603;1042;3163;956;3044;56;239;721;2220;777;2459
250860;201603;3126;10212;2726;9494;674;2537;907;3213;1581;5750
250870;201603;1052;3077;953;2890;32;127;734;2176;766;2303
250880;201603;1394;3913;1220;3663;152;466;903;2737;1055;3203
250890;201603;9087;27778;8599;27114;1064;4129;6122;18635;7186;22764
250900;201603;2787;9085;2469;8469;240;799;1789;6185;2029;6984
250905;201603;1968;6312;1891;6212;278;931;1401;4635;1679;5566
250910;201603;4872;14296;4622;13919;234;806;3818;11419;4052;12225
250915;201603;1381;4321;1358;4288;94;245;1171;3791;1265;4036
250920;201603;3235;9287;3036;8987;324;932;2180;6496;2504;7428
250930;201603;1960;6117;1847;5937;180;748;1335;4159;1515;4907
250933;201603;1115;3656;1046;3525;94;353;693;2292;787;2645
250937;201603;655;2033;596;1923;54;209;424;1331;478;1540
250939;201603;1513;4693;1419;4541;129;464;1002;3167;1131;3631
250940;201603;3683;11043;3473;10716;121;465;2951;9116;3072;9581
250950;201603;1245;3834;1107;3659;53;227;886;2921;939;3148
250960;201603;1066;3527;1024;3461;69;270;823;2781;892;3051
250970;201603;8264;23076;7284;21557;709;2217;5216;15365;5925;17582
250980;201603;2526;7506;2321;7150;111;459;1701;5038;1812;5497
250990;201603;1907;6520;1721;6125;256;1039;1031;3544;1287;4583
251000;201603;2067;6255;1887;5994;61;285;1585;4979;1646;5264
251010;201603;2734;8047;2458;7611;69;234;2138;6638;2207;6872
251020;201603;1574;4555;1448;4395;77;245;1295;3939;1372;4184
251030;201603;1068;3036;983;2892;60;203;723;2084;783;2287
251040;201603;1767;5553;1604;5284;84;399;1189;3773;1273;4172
251050;201603;1055;3079;923;2846;112;381;593;1780;705;2161
251060;201603;990;2310;763;2019;41;142;594;1551;635;1693
251065;201603;461;1402;411;1326;30;102;279;852;309;954
251070;201603;615;1739;558;1664;35;140;445;1274;480;1414
251080;201603;19251;54507;17513;51683;4335;13345;8073;24514;12408;37859
251090;201603;2941;9157;2624;8564;197;732;1878;6026;2075;6758
251100;201603;952;3005;860;2846;79;306;570;1820;649;2126
251110;201603;1927;5665;1695;5215;142;411;1143;3525;1285;3936
251120;201603;6051;20528;5784;20069;693;2758;4189;14353;4882;17111
251130;201603;3912;10306;3616;9991;10;30;3564;9867;3574;9897
251140;201603;4158;12734;3930;12376;121;523;3307;10361;3428;10884
251150;201603;2483;8146;2328;7906;186;845;1748;5788;1934;6633
251160;201603;1787;5891;1728;5815;61;253;1575;5299;1636;5552
251170;201603;1397;4269;1326;4182;86;347;1116;3453;1202;3800
251180;201603;2505;7620;2286;7284;381;1211;1395;4459;1776;5670
251190;201603;4274;11905;4120;11732;161;496;3825;10862;3986;11358
251200;201603;3818;12350;3673;12173;96;428;3370;11131;3466;11559
251203;201603;1011;3408;987;3361;50;252;783;2626;833;2878
251207;201603;1079;3384;936;3128;60;273;628;2028;688;2301
251210;201603;7788;22233;6711;20820;672;2046;5148;16426;5820;18472
251220;201603;1145;3060;948;2772;86;258;707;2072;793;2330
251230;201603;4394;13402;4054;12998;205;818;3623;11494;3828;12312
251240;201603;3223;9811;2988;9511;404;1272;2180;6944;2584;8216
251250;201603;10213;30187;9468;29090;813;2934;7095;21351;7908;24285
251260;201603;476;1532;436;1476;22;93;329;1101;351;1194
251270;201603;4178;13543;3885;13187;143;680;3450;11674;3593;12354
251272;201603;1342;3925;1287;3853;75;247;1145;3414;1220;3661
251274;201603;896;2824;813;2684;79;333;555;1786;634;2119
251275;201603;1233;3614;1170;3511;67;301;893;2548;960;2849
251276;201603;1200;3710;1129;3588;75;308;830;2561;905;2869
251278;201603;585;1852;520;1738;61;244;337;1112;398;1356
251280;201603;2278;6932;2145;6711;105;417;1715;5206;1820;5623
251290;201603;5522;15327;5219;14963;565;2051;4079;11317;4644;13368
251300;201603;740;2513;697;2449;37;167;556;1932;593;2099
251310;201603;2941;8814;2710;8489;114;472;2198;6733;2312;7205
251315;201603;1600;5555;1527;5432;161;607;1089;3883;1250;4490
251320;201603;1853;5193;1448;4531;52;187;1052;3291;1104;3478
251330;201603;1735;4753;1495;4441;66;279;1294;3760;1360;4039
251335;201603;1016;3454;937;3315;81;372;660;2288;741;2660
251340;201603;3347;9535;2964;8975;199;792;2233;6544;2432;7336
251350;201603;1273;4099;1190;3948;81;324;911;2938;992;3262
251360;201603;1779;5690;1582;5430;61;265;1376;4740;1437;5005
251365;201603;796;2352;644;2036;18;77;451;1404;469;1481
251370;201603;21537;68055;20948;67280;1771;7086;16626;51831;18397;58917
251380;201603;1323;4151;1137;3837;39;211;944;3051;983;3262
251385;201603;777;2118;665;1948;78;217;431;1228;509;1445
251390;201603;5753;19781;5263;18895;1352;4984;2584;9417;3936;14401
251392;201603;1039;3105;928;2930;66;238;709;2210;775;2448
251394;201603;608;1902;503;1712;50;178;340;1152;390;1330
251396;201603;814;2324;707;2148;92;276;456;1378;548;1654
251398;201603;951;2791;837;2588;38;152;569;1714;607;1866
251400;201603;1142;3234;985;3016;83;299;715;2128;798;2427
251410;201603;1377;3677;1219;3428;55;220;1014;2773;1069;2993
251420;201603;1959;5687;1743;5433;209;676;1258;3890;1467;4566
251430;201603;1608;5693;1475;5478;71;367;1213;4435;1284;4802
251440;201603;1207;3624;998;3222;51;197;739;2357;790;2554
251445;201603;1467;4563;1389;4454;100;399;1062;3289;1162;3688
251450;201603;4441;14347;4201;14024;109;493;3555;11877;3664;12370
251455;201603;1064;3463;962;3279;86;331;658;2251;744;2582
251460;201603;789;2489;739;2408;80;236;577;1935;657;2171
251465;201603;425;1369;377;1263;14;69;280;909;294;978
251470;201603;1152;3385;968;3026;79;280;594;1838;673;2118
251480;201603;923;2614;821;2447;28;128;660;1907;688;2035
251490;201603;1713;5163;1548;4911;146;557;1085;3401;1231;3958
251500;201603;1684;5451;1624;5341;131;518;1282;4125;1413;4643
251510;201603;2557;8401;2326;7948;405;1433;1308;4492;1713;5925
251520;201603;924;2556;821;2392;118;347;508;1466;626;1813
251530;201603;11805;33163;11169;32287;320;1397;9707;27410;10027;28807
251540;201603;2823;9141;2615;8743;172;721;2094;6931;2266;7652
251550;201603;3434;8993;2956;8370;74;325;2467;6872;2541;7197
251560;201603;685;2147;633;2055;83;318;378;1163;461;1481
251570;201603;997;2960;804;2589;39;170;559;1725;598;1895
251580;201603;1889;5320;1741;5120;378;910;1079;3389;1457;4299
251590;201603;1479;4663;1417;4584;53;191;1177;3806;1230;3997
251593;201603;984;3078;917;2990;131;451;562;1792;693;2243
251597;201603;1852;5745;1786;5663;58;253;1578;4923;1636;5176
251600;201603;6375;18878;5951;18209;344;1173;4814;14627;5158;15800
251610;201603;3222;9755;2965;9335;279;877;2186;6959;2465;7836
251615;201603;1123;3257;918;2901;64;265;642;1978;706;2243
251620;201603;14723;40895;13061;38909;792;2459;10793;32820;11585;35279
251630;201603;4520;11808;3909;10955;288;839;3041;8427;3329;9266
251640;201603;2515;7416;2137;6792;107;453;1614;5067;1721;5520
251650;201603;3874;11293;3581;10917;223;726;3053;9291;3276;10017
251660;201603;3441;11176;3197;10747;113;564;2674;8763;2787;9327
251670;201603;4338;12914;3755;12161;47;168;3460;11347;3507;11515
251675;201603;713;2278;659;2203;125;463;394;1275;519;1738
251680;201603;2660;7707;2193;6982;88;384;1695;5317;1783;5701
251690;201603;3188;9710;2986;9321;130;456;2298;7040;2428;7496
251700;201603;1927;6279;1813;6140;102;475;1538;5123;1640;5598
251710;201603;909;2347;668;1903;81;257;367;1009;448;1266
251720;201603;1391;4284;1220;3985;74;352;930;2932;1004;3284
251740;201603;770;2180;614;1914;75;241;367;1157;442;1398
260005;201603;25146;61176;21403;56025;4532;11776;11337;30075;15869;41851
260010;201603;9816;26533;8125;24357;1358;4103;4556;14311;5914;18414
260020;201603;5798;16440;4918;15119;241;874;3884;12034;4125;12908
260030;201603;6019;17363;5418;16454;384;1349;4163;12598;4547;13947
260040;201603;9913;24181;8199;22220;722;1847;6183;17434;6905;19281
260050;201603;11172;34630;10448;33795;566;2008;8979;29406;9545;31414
260060;201603;3801;10805;3400;10093;326;972;2472;7458;2798;8430
260070;201603;9680;28120;8908;26916;1344;4384;5743;17096;7087;21480
260080;201603;5652;15121;5014;14238;574;1705;3524;9913;4098;11618
260090;201603;5016;14067;4684;13581;824;2345;3190;9375;4014;11720
260100;201603;3257;9029;2827;8421;155;650;2327;6868;2482;7518
260105;201603;4823;13651;4575;13225;255;937;3753;10613;4008;11550
260110;201603;20517;58311;18962;56471;829;2580;16676;49834;17505;52414
260120;201603;11532;35363;10420;33424;2378;7858;5143;17100;7521;24958
260130;201603;3185;9004;2986;8692;460;1326;2040;5967;2500;7293
260140;201603;13137;32615;11286;30379;807;2399;8910;24168;9717;26567
260150;201603;3120;8808;2787;8365;196;734;2173;6472;2369;7206
260160;201603;5473;17438;4818;16586;271;1240;3936;13495;4207;14735
260170;201603;15984;45251;15237;44182;1099;3515;12441;35771;13540;39286
260180;201603;3203;9770;2922;9380;186;668;2427;7783;2613;8451
260190;201603;15838;37168;14463;35487;421;1155;12572;30480;12993;31635
260200;201603;10630;28783;9864;27792;588;1903;8330;23593;8918;25496
260210;201603;11396;34699;10251;32966;560;2243;8348;26798;8908;29041
260220;201603;9408;27276;9103;26889;410;1570;8054;23472;8464;25042
260230;201603;9460;27254;8721;26226;409;1518;7101;21366;7510;22884
260240;201603;2935;8847;2552;8296;350;1263;1768;5777;2118;7040
260250;201603;2262;6267;2034;5968;105;303;1733;5116;1838;5419
260260;201603;12063;34126;10998;32623;1617;5134;7717;23167;9334;28301
260270;201603;3586;10421;3315;10014;265;1089;2477;7159;2742;8248
260280;201603;12818;41503;11765;39933;711;2508;9784;33627;10495;36135
260290;201603;30432;91562;28766;88687;5040;16510;17415;53024;22455;69534
260300;201603;8495;26036;7531;24609;441;1896;5768;18887;6209;20783
260310;201603;4558;13482;4189;12952;1193;3388;2170;7284;3363;10672
260320;201603;7046;22827;6549;22032;379;1463;5407;18227;5786;19690
260330;201603;2571;8310;2392;7989;112;491;1869;6111;1981;6602
260340;201603;1837;5429;1703;5219;55;189;1501;4594;1556;4783
260345;201603;22590;70286;21187;67672;5532;19380;7922;24134;13454;43514
260350;201603;4717;12810;4395;12354;210;764;3704;10268;3914;11032
260360;201603;2289;6725;2085;6373;162;630;1425;4316;1587;4946
260370;201603;5697;17808;5031;16618;445;1784;3546;11649;3991;13433
260380;201603;4833;15862;4397;15186;292;1222;3289;11289;3581;12511
260390;201603;4234;13607;3736;12631;328;1281;2617;8697;2945;9978
260392;201603;3449;11011;3161;10645;194;858;2704;8982;2898;9840
260400;201603;13497;38421;12784;37264;1697;5525;8648;24620;10345;30145
260410;201603;60340;172303;52813;160544;14975;48152;18975;59242;33950;107394
260415;201603;3810;12038;3295;11031;283;1187;2080;6725;2363;7912
260420;201603;11905;27196;10585;25774;222;739;9607;23128;9829;23867
260430;201603;2825;9237;2510;8664;250;869;1691;5910;1941;6779
260440;201603;3243;9790;2882;9063;408;1403;1744;5357;2152;6760
260450;201603;4849;14442;4637;14140;173;619;4114;12586;4287;13205
260460;201603;5535;17399;5071;16540;942;3291;2759;8853;3701;12144
260470;201603;4420;13559;4099;13172;203;647;3568;11762;3771;12409
260480;201603;4019;11539;3541;10872;551;1880;2261;7002;2812;8882
260490;201603;4961;13204;4312;12102;258;842;3465;9516;3723;10358
260500;201603;5790;16711;5157;15703;797;2417;3291;10065;4088;12482
260510;201603;8622;23209;7993;22398;376;1250;7007;19481;7383;20731
260515;201603;4716;14338;3673;12263;234;888;2298;7653;2532;8541
260520;201603;15691;41315;15027;40424;1985;5350;11103;29884;13088;35234
260530;201603;9602;29430;8542;27822;389;1442;7193;23496;7582;24938
260540;201603;6008;14868;5466;14295;797;1522;4207;11653;5004;13175
260545;201603;71;254;48;187;8;33;11;38;19;71
260550;201603;2700;8848;2302;7997;443;1689;926;3203;1369;4892
260560;201603;6116;16249;5528;15415;152;597;4858;13322;5010;13919
260570;201603;6800;22335;6224;21403;625;2436;4442;15216;5067;17652
260580;201603;3645;10329;3387;9893;166;581;2812;8020;2978;8601
260590;201603;6028;15207;5675;14799;294;811;4909;12788;5203;13599
260600;201603;27277;80287;24570;75824;2064;7592;17689;54074;19753;61666
260610;201603;6511;19565;6170;19036;881;2858;4212;12854;5093;15712
260620;201603;15457;46929;14766;45748;2454;8364;9085;27545;11539;35909
260630;201603;2169;6484;1950;6130;111;478;1564;4769;1675;5247
260640;201603;16888;46715;15820;45278;2534;7467;10035;28856;12569;36323
260650;201603;5305;16867;4718;15870;396;1451;3589;12212;3985;13663
260660;201603;7782;21755;7007;20778;325;1143;5996;17681;6321;18824
260670;201603;2338;6299;1913;5709;161;538;1336;3995;1497;4533
260680;201603;21101;59540;19353;56528;3944;11851;9155;26788;13099;38639
260690;201603;3659;9940;3092;9017;235;665;2344;6862;2579;7527
260700;201603;5628;16797;5495;16659;39;99;5374;16445;5413;16544
260710;201603;1291;3819;1196;3694;91;315;901;2805;992;3120
260720;201603;16881;54592;15960;52888;3638;12419;8290;27768;11928;40187
260730;201603;6574;22183;6172;21524;976;3529;4200;14679;5176;18208
260740;201603;1256;3784;1110;3532;109;403;784;2499;893;2902
260750;201603;6722;20483;6000;19554;427;1372;5001;16625;5428;17997
260760;201603;4640;12558;4352;12192;238;749;3603;10145;3841;10894
260765;201603;7647;25861;7266;25232;1023;4544;4869;16194;5892;20738
260770;201603;3743;9968;3451;9540;116;383;2859;7804;2975;8187
260775;201603;4981;14493;4698;14075;443;1603;3314;9671;3757;11274
260780;201603;3588;11631;3352;11173;645;2418;1717;5478;2362;7896
260790;201603;108286;273879;100521;262466;20436;54635;56711;147317;77147;201952
260795;201603;2988;9010;2681;8544;226;833;1906;6098;2132;6931
260800;201603;4737;12862;4418;12435;151;584;3914;10715;4065;11299
260805;201603;3802;11128;3338;10417;365;1313;2251;6896;2616;8209
260810;201603;6817;19170;6590;18885;293;922;5807;16602;6100;17524
260820;201603;4076;11618;3671;11023;854;2631;1876;5609;2730;8240
260825;201603;2850;9155;2552;8663;180;702;1943;6625;2123;7327
260830;201603;3644;11791;3263;11055;640;2135;1919;6696;2559;8831
260840;201603;4177;12031;3711;11353;242;908;2987;9033;3229;9941
260845;201603;4114;11994;3884;11589;471;1467;2771;8301;3242;9768
260850;201603;4866;15974;4331;14784;801;3016;2000;6705;2801;9721
260860;201603;3429;10665;3034;9881;154;606;2326;7536;2480;8142
260870;201603;4139;11442;3689;10880;477;1279;2707;8206;3184;9485
260875;201603;6360;17737;5658;16657;805;2397;3744;11099;4549;13496
260880;201603;9387;28762;8611;27501;669;2197;6707;21640;7376;23837
260890;201603;12855;36993;11992;35674;789;2752;9056;26756;9845;29508
260900;201603;5768;17808;4988;16317;456;1840;3118;10023;3574;11863
260910;201603;2959;9005;2697;8598;201;743;2019;6449;2220;7192
260915;201603;4480;15129;4251;14815;75;363;3910;13641;3985;14004
260920;201603;3211;9755;2980;9450;213;822;2365;7550;2578;8372
260930;201603;3893;12752;3477;12075;397;1444;2399;8412;2796;9856
260940;201603;13688;36445;12540;34628;1571;4835;8156;21950;9727;26785
260950;201603;6233;19245;5656;18122;836;3123;2958;9052;3794;12175
260960;201603;54353;151232;49878;144063;9661;29566;25618;73425;35279;102991
260970;201603;4828;14932;4408;14380;248;1048;3471;11291;3719;12339
260980;201603;3815;12412;3590;12132;117;495;3197;10788;3314;11283
260990;201603;16478;52084;15050;50130;1014;3931;11981;40030;12995;43961
261000;201603;15892;43141;13010;38745;2378;7480;6472;20007;8850;27487
261010;201603;2505;7024;2301;6783;134;299;2013;6118;2147;6417
261020;201603;6067;17797;5371;16640;580;1848;3811;11711;4391;13559
261030;201603;3449;11047;3141;10506;206;838;2448;8052;2654;8890
261040;201603;5062;16420;4427;15139;376;1525;3181;10756;3557;12281
261050;201603;7764;22909;7285;22045;1003;3022;4713;14389;5716;17411
261060;201603;12025;35442;11142;33861;980;3534;8174;24196;9154;27730
261070;201603;49978;123285;44351;115430;6339;16856;28263;73662;34602;90518
261080;201603;5603;16409;5291;15948;336;937;4506;13830;4842;14767
261090;201603;16256;44848;14977;43107;1290;3645;11735;34144;13025;37789
261100;201603;7918;25080;7131;23707;1260;4536;3954;13333;5214;17869
261110;201603;59693;176843;53376;167503;12378;41046;26256;84400;38634;125446
261120;201603;3717;9874;3265;9342;91;361;2889;8242;2980;8603
261130;201603;6890;17719;6417;17192;171;550;5844;15613;6015;16163
261140;201603;3214;9024;2925;8592;374;1267;1780;5096;2154;6363
261150;201603;5263;15424;4868;14804;381;1377;3920;11839;4301;13216
261153;201603;2123;6154;1744;5579;72;299;1288;4123;1360;4422
261160;201603;193389;507215;179489;487409;43300;122529;83252;228529;126552;351058
261170;201603;5752;15781;5236;15026;518;1531;3938;11432;4456;12963
261180;201603;9431;26332;8818;25480;987;3145;5967;17042;6954;20187
261190;201603;5029;15614;4676;15180;491;2087;3267;10199;3758;12286
261200;201603;3525;8987;3164;8561;390;1029;2437;6749;2827;7778
261210;201603;1887;4997;1761;4841;124;337;1539;4261;1663;4598
261220;201603;13041;40638;11056;36447;1735;6294;5569;18186;7304;24480
261230;201603;4327;13151;3987;12733;139;578;3484;11154;3623;11732
261240;201603;4813;14221;4418;13561;603;1738;2991;9385;3594;11123
261245;201603;3493;10855;3023;10000;154;696;2358;7631;2512;8327
261247;201603;3232;9962;2766;9133;200;832;1961;6509;2161;7341
261250;201603;19277;51587;18108;50025;3443;9096;12056;34488;15499;43584
261255;201603;3931;12339;3537;11634;199;776;2872;9389;3071;10165
261260;201603;11987;33873;10792;32422;571;1812;9009;27301;9580;29113
261270;201603;3557;10614;3207;10051;387;1383;2140;6562;2527;7945
261280;201603;2471;7630;2303;7384;124;484;1867;5926;1991;6410
261290;201603;2894;8298;2639;7965;145;536;2140;6486;2285;7022
261300;201603;10598;34257;9305;31923;1435;5586;5565;18848;7000;24434
261310;201603;7193;22189;6782;21446;1650;5302;3616;11510;5266;16812
261320;201603;5566;17427;5131;16641;208;799;4164;13428;4372;14227
261330;201603;5380;15616;5083;15214;435;1426;4032;11973;4467;13399
261340;201603;3818;12861;3628;12553;389;1695;2395;8146;2784;9841
261350;201603;7913;26256;7447;25468;266;1360;6016;20115;6282;21475
261360;201603;8064;21293;7204;20090;558;1708;5695;15601;6253;17309
261370;201603;19311;56909;18006;54889;3775;11989;9854;30179;13629;42168
261380;201603;4054;13915;3754;13281;567;2227;2369;8360;2936;10587
261390;201603;15953;48656;14500;46281;2091;7218;8639;27632;10730;34850
261400;201603;4616;15945;4163;15001;335;1419;2934;10537;3269;11956
261410;201603;8623;24071;7751;22740;855;2548;5765;17010;6620;19558
261420;201603;7260;24619;6944;24188;1669;6541;3953;13466;5622;20007
261430;201603;3373;10585;2969;9996;262;937;2258;7734;2520;8671
261440;201603;1510;4812;1361;4587;57;303;1032;3379;1089;3682
261450;201603;13944;39506;13452;38924;317;1178;12222;35190;12539;36368
261460;201603;7051;20812;6586;20190;409;1174;5657;17631;6066;18805
261470;201603;3878;10649;3524;10187;102;323;3202;9307;3304;9630
261480;201603;3604;12898;3325;12386;313;1289;2377;8748;2690;10037
261485;201603;4843;14959;4389;14171;700;2576;2568;8104;3268;10680
261500;201603;5585;15580;4983;14784;452;1259;3689;11292;4141;12551
261510;201603;1855;5964;1696;5715;123;448;1240;4198;1363;4646
261520;201603;2639;8597;2466;8275;135;516;1671;5845;1806;6361
261530;201603;11793;37786;10476;35215;2116;7999;4350;14494;6466;22493
261540;201603;7028;22826;6645;22157;1443;4812;3875;13228;5318;18040
261550;201603;3383;9607;3185;9326;237;901;2498;7108;2735;8009
261560;201603;6920;22929;6291;22081;911;3599;4442;15699;5353;19298
261570;201603;3321;10161;2923;9515;411;1415;1831;5961;2242;7376
261580;201603;5862;18012;5304;17135;334;1377;4370;13998;4704;15375
261590;201603;2366;6796;2089;6380;173;520;1541;4758;1714;5278
261600;201603;5213;14221;4516;13250;325;984;3532;10442;3857;11426
261610;201603;2354;6816;2066;6434;104;437;1650;5070;1754;5507
261618;201603;2459;6906;2232;6623;185;578;1693;4963;1878;5541
261620;201603;4066;12648;3789;12183;636;2073;2444;8006;3080;10079
261630;201603;7581;22262;6401;20097;814;2978;3551;10911;4365;13889
261640;201603;32964;82913;30816;80347;2116;5326;24685;66740;26801;72066
261650;201603;3610;11072;3352;10718;332;1242;2436;7807;2768;9049
270010;201603;4297;16318;3944;15649;421;1986;2678;10650;3099;12636
270020;201603;3734;10688;3473;10312;386;1236;2628;7703;3014;8939
270030;201603;38978;116908;36398;112806;8830;28069;19293;60533;28123;88602
270040;201603;10452;32150;9642;31095;2000;6497;5699;18982;7699;25479
270050;201603;4202;11935;3847;11495;419;1380;2954;8802;3373;10182
270060;201603;1808;5397;1681;5236;295;964;1099;3486;1394;4450
270070;201603;4272;13210;3926;12756;188;901;3360;10663;3548;11564
270080;201603;1250;3965;1097;3664;155;578;674;2197;829;2775
270090;201603;2096;6507;1925;6174;57;311;1609;4971;1666;5282
270100;201603;5617;17503;5298;16958;778;2746;3526;11111;4304;13857
270110;201603;3129;8634;2760;8234;365;1115;1814;5807;2179;6922
270120;201603;3047;8727;2702;8307;87;332;2425;7481;2512;7813
270130;201603;4964;15122;4606;14718;589;1950;3515;11473;4104;13423
270135;201603;1735;4621;1603;4464;175;338;1350;3953;1525;4291
270140;201603;10088;24590;8695;22847;752;2950;6755;16508;7507;19458
270150;201603;2644;8825;2571;8732;65;230;2442;8323;2507;8553
270160;201603;5012;16669;4600;16149;214;898;3930;13743;4144;14641
270170;201603;3723;12098;3427;11707;582;2293;2005;6774;2587;9067
270180;201603;2208;7384;2025;7125;100;523;1663;5741;1763;6264
270190;201603;1749;5796;1666;5688;100;398;1388;4770;1488;5168
270200;201603;2553;8510;2380;8268;204;873;1816;6206;2020;7079
270210;201603;4532;13792;4262;13416;275;1165;3530;10867;3805;12032
270220;201603;1310;4341;1218;4175;226;832;689;2338;915;3170
270230;201603;10735;33809;9431;31790;1203;4969;5700;18602;6903;23571
270235;201603;6311;20448;5890;19777;380;1644;4784;15861;5164;17505
270240;201603;9264;27952;7821;26106;1987;6861;3520;12126;5507;18987
270250;201603;3208;8436;2919;8078;477;1272;2177;6059;2654;7331
270255;201603;4899;14778;3859;12914;238;1008;2724;8925;2962;9933
270260;201603;5797;18754;5613;18497;422;1779;4722;15241;5144;17020
270270;201603;1165;3369;1071;3234;202;647;615;1828;817;2475
270280;201603;3435;9852;3046;9292;331;943;2128;6563;2459;7506
270290;201603;8028;27983;7507;27090;636;2833;5747;20458;6383;23291
270300;201603;3528;11511;3167;11089;323;1294;2300;8003;2623;9297
270310;201603;7332;22222;6439;20900;250;1298;5362;16986;5612;18284
270320;201603;5732;18237;5462;17807;763;2903;3872;12353;4635;15256
270330;201603;4246;14444;3979;14077;411;1542;3077;11029;3488;12571
270340;201603;1726;5303;1523;5036;137;430;1167;3885;1304;4315
270350;201603;1840;5060;1659;4846;136;465;1211;3538;1347;4003
270360;201603;1934;6060;1852;5966;182;524;1539;5103;1721;5627
270370;201603;1489;4954;1364;4744;115;476;978;3411;1093;3887
270375;201603;2763;7755;2475;7370;180;625;1993;5857;2173;6482
270380;201603;5522;17204;5178;16734;449;1512;4028;13252;4477;14764
270390;201603;1236;3443;1091;3238;72;274;822;2355;894;2629
270400;201603;6222;18681;5585;17792;370;1433;4076;12675;4446;14108
270410;201603;4745;14853;4384;14196;438;1578;3092;9870;3530;11448
270420;201603;5713;18409;5498;18113;252;1164;4516;14553;4768;15717
270430;201603;130909;380747;118994;362994;32208;103956;47359;147677;79567;251633
270440;201603;4597;13889;4252;13431;199;818;3473;10952;3672;11770
270450;201603;6162;19148;5898;18809;304;1331;4904;15367;5208;16698
270460;201603;3344;8997;3006;8584;169;573;2582;7281;2751;7854
270470;201603;10120;32383;9324;31117;1287;4548;5925;20072;7212;24620
270480;201603;2790;8771;2479;8211;236;985;1697;5384;1933;6369
270490;201603;945;3061;883;2974;37;160;710;2365;747;2525
270500;201603;4811;16447;4543;16119;303;1342;3750;13247;4053;14589
270510;201603;5776;17347;5192;16527;644;2661;3804;11544;4448;14205
270520;201603;3519;11208;3234;10735;965;3525;1133;3872;2098;7397
270530;201603;1354;4200;1252;4049;138;463;845;2807;983;3270
270540;201603;2011;6751;1842;6504;107;559;1486;5083;1593;5642
270550;201603;7085;20654;6174;19503;808;2717;4172;13494;4980;16211
270560;201603;3002;9100;2796;8783;284;1105;2042;6249;2326;7354
270570;201603;3938;12747;3607;12184;336;1419;2727;9020;3063;10439
270580;201603;1979;6330;1885;6204;176;598;1460;4896;1636;5494
270590;201603;1344;4520;1289;4430;12;52;1240;4276;1252;4328
270600;201603;2734;9191;2492;8784;145;716;1967;6774;2112;7490
270610;201603;3113;9853;2885;9527;180;660;2361;7755;2541;8415
270620;201603;1352;4624;1277;4502;86;422;1015;3444;1101;3866
270630;201603;16110;47085;14765;44904;2207;6597;9835;30773;12042;37370
270640;201603;5589;17386;5065;16593;325;1393;4040;12963;4365;14356
270642;201603;2241;7961;2102;7761;225;1046;1567;5692;1792;6738
270644;201603;2607;7674;2319;7298;243;721;1773;5715;2016;6436
270650;201603;3597;11452;3428;11213;489;2172;2330;7155;2819;9327
270660;201603;2363;6027;1842;5283;84;333;1322;3722;1406;4055
270670;201603;16059;41651;13975;39308;1848;5016;10043;29361;11891;34377
270680;201603;4209;12495;4026;12291;123;349;3729;11488;3852;11837
270690;201603;8565;23745;7681;22759;2424;6895;3932;12383;6356;19278
270700;201603;635;1993;572;1890;75;306;387;1231;462;1537
270710;201603;5781;18610;5493;18242;408;1620;4565;15009;4973;16629
270720;201603;3255;11088;2965;10568;147;802;2394;8351;2541;9153
270730;201603;6099;18204;5803;17888;587;1929;4736;14742;5323;16671
270740;201603;2245;6445;2116;6257;242;833;1598;4623;1840;5456
270750;201603;4968;15588;4632;15070;641;2296;3264;10556;3905;12852
270760;201603;3291;10010;2946;9438;164;660;2316;7331;2480;7991
270770;201603;18609;48485;15310;44519;3281;9537;8158;25108;11439;34645
270780;201603;1742;5716;1656;5578;179;692;1213;4059;1392;4751
270790;201603;1512;4758;1390;4583;331;1171;692;2249;1023;3420
270800;201603;11187;33069;10416;32066;744;2831;8549;25893;9293;28724
270810;201603;3290;10004;2571;8723;263;1083;1555;5301;1818;6384
270820;201603;1752;5805;1588;5538;263;1004;953;3319;1216;4323
270830;201603;5429;14930;4939;14343;372;1157;3953;11741;4325;12898
270840;201603;7720;25128;7183;24438;321;1666;6230;20752;6551;22418
270850;201603;7180;22700;6913;22352;1075;4259;4725;14458;5800;18717
270860;201603;10965;30703;9280;28556;1074;3949;6197;18644;7271;22593
270870;201603;2102;6407;1762;5702;249;853;1092;3496;1341;4349
270880;201603;8055;25865;7509;25062;483;2042;6067;19957;6550;21999
270890;201603;2332;7130;2188;6877;229;879;1597;4878;1826;5757
270895;201603;2773;10380;2653;10207;147;727;2270;8696;2417;9423
270900;201603;1916;5192;1561;4698;94;313;1161;3440;1255;3753
270910;201603;3496;11470;3230;10992;243;1100;2473;8171;2716;9271
270915;201603;9376;31389;8454;29770;1344;5535;4903;16855;6247;22390
270920;201603;6030;19077;5819;18784;208;1099;5224;16415;5432;17514
270930;201603;17002;45317;14087;41872;2637;7966;8226;25411;10863;33377
270940;201603;5591;18611;5304;18301;465;2104;4198;14278;4663;16382
280010;201603;639;1911;557;1770;54;239;348;1032;402;1271
280020;201603;4719;13762;4085;12689;709;2386;2437;7500;3146;9886
280030;201603;73150;191645;63324;177162;17870;52187;23673;68011;41543;120198
280040;201603;3066;9405;2719;8888;233;886;2012;6521;2245;7407
280050;201603;3705;11941;3444;11496;1149;4071;1291;4407;2440;8478
280060;201603;4597;14749;4150;13955;844;3056;2097;7202;2941;10258
280067;201603;7200;20374;6218;18917;890;2667;3883;12044;4773;14711
280070;201603;1872;6206;1785;6082;235;875;1292;4395;1527;5270
280100;201603;3740;11633;3384;11016;590;2117;2033;6636;2623;8753
280110;201603;1394;4231;1284;4070;64;273;1070;3353;1134;3626
280120;201603;7643;24143;7031;23147;1223;3653;4590;15898;5813;19551
280130;201603;7241;20484;6656;19638;1081;3466;4300;12739;5381;16205
280140;201603;5517;15002;5034;14317;372;1152;4032;11494;4404;12646
280150;201603;3331;10021;3117;9666;287;1002;2235;6781;2522;7783
280160;201603;1358;3953;1190;3685;154;517;785;2396;939;2913
280170;201603;4712;14048;4272;13408;450;1442;3154;10053;3604;11495
280190;201603;1074;2963;965;2783;59;218;742;2079;801;2297
280200;201603;1140;3437;1042;3292;118;457;737;2258;855;2715
280210;201603;13448;39994;12097;38138;2275;7627;6875;21996;9150;29623
280220;201603;1543;4774;1446;4619;78;317;1187;3726;1265;4043
280230;201603;3381;10150;3041;9635;353;1228;1978;6297;2331;7525
280240;201603;3424;9987;3108;9492;260;769;2393;7359;2653;8128
280250;201603;806;2124;660;1886;116;392;324;841;440;1233
280260;201603;2000;5371;1865;5203;73;227;1669;4687;1742;4914
280270;201603;2218;6902;1985;6551;114;467;1544;4999;1658;5466
280280;201603;4108;13348;3726;12725;789;2213;2094;8010;2883;10223
280290;201603;17242;52287;15641;49854;2138;7561;9735;31267;11873;38828
280300;201603;9327;28411;8800;27767;804;2812;6862;22161;7666;24973
280310;201603;1345;3786;1193;3538;60;242;843;2448;903;2690
280320;201603;8425;26912;7725;25739;1463;5336;3905;12888;5368;18224
280330;201603;4435;12615;4044;11984;411;1473;3018;8594;3429;10067
280340;201603;3737;10610;3500;10289;328;1071;2763;8136;3091;9207
280350;201603;21595;60755;19362;57422;2857;8929;12352;36958;15209;45887
280360;201603;5597;17540;5244;16975;989;3642;2855;8990;3844;12632
280370;201603;1845;5189;1602;4779;150;458;1102;3278;1252;3736
280380;201603;1023;3157;922;2993;87;331;654;2078;741;2409
280390;201603;3093;9141;2666;8356;366;1226;1682;5281;2048;6507
280400;201603;4131;11746;3780;11239;1277;3748;1615;5090;2892;8838
280410;201603;2188;6930;1872;6325;241;936;1067;3484;1308;4420
280420;201603;4036;11869;3748;11411;222;741;3145;9578;3367;10319
280430;201603;2229;5699;2015;5406;99;337;1592;4181;1691;4518
280440;201603;4589;13650;4305;13313;375;1259;3453;10589;3828;11848
280445;201603;2474;6939;2302;6653;76;290;1828;5192;1904;5482
280450;201603;8889;23877;8291;23136;578;1392;6985;20049;7563;21441
280460;201603;6847;18033;6196;17115;779;2261;4408;12326;5187;14587
280470;201603;1779;5406;1618;5130;178;563;1148;3696;1326;4259
280480;201603;30290;88720;28582;86220;4887;16482;17922;52881;22809;69363
280490;201603;3781;11309;3320;10538;239;921;2436;7567;2675;8488
280500;201603;916;2448;827;2337;46;137;682;1898;728;2035
280510;201603;2629;7609;2287;7163;192;681;1670;5250;1862;5931
280520;201603;1759;4808;1611;4628;147;399;1315;3833;1462;4232
280530;201603;2371;6521;2203;6318;141;392;1811;5267;1952;5659
280540;201603;9251;25294;8584;24379;221;933;7517;20884;7738;21817
280550;201603;6822;17970;5777;16405;600;1738;4006;11415;4606;13153
280560;201603;7488;22141;7091;21565;368;1285;5935;17817;6303;19102
280570;201603;6400;17271;5594;16193;573;1862;3765;10763;4338;12625
280580;201603;5501;17028;4683;15606;778;2634;2712;9307;3490;11941
280590;201603;2340;7064;2170;6845;218;954;1504;4569;1722;5523
280600;201603;3639;11159;3400;10807;301;1074;2551;8014;2852;9088
280610;201603;2436;6839;2232;6543;193;701;1592;4520;1785;5221
280620;201603;5150;15274;4528;14204;553;1676;3014;9813;3567;11489
280630;201603;3637;11830;3426;11516;314;1001;2727;9420;3041;10421
280640;201603;2190;6584;2091;6472;84;226;1946;6106;2030;6332
280650;201603;1098;3433;994;3265;101;381;688;2244;789;2625
280660;201603;2646;7430;2534;7293;390;1052;1963;5732;2353;6784
280670;201603;15937;41848;14754;40257;2625;7668;9202;24790;11827;32458
280680;201603;2743;7412;2442;6950;192;628;1900;5304;2092;5932
280690;201603;940;2685;836;2538;120;375;566;1727;686;2102
280700;201603;1056;3155;943;2978;70;232;675;2128;745;2360
280710;201603;11787;30948;10754;29780;696;1720;9076;25752;9772;27472
280720;201603;2286;6240;2079;5999;260;779;1418;4195;1678;4974
280730;201603;920;2759;859;2673;83;297;674;2069;757;2366
280740;201603;12950;35155;11273;32631;1481;4219;7210;21222;8691;25441
280750;201603;3471;10561;3185;10081;318;1081;2202;7013;2520;8094
280760;201603;5560;16945;5068;16232;770;2673;3080;10119;3850;12792
290010;201603;2956;6701;2146;5460;46;189;1676;4050;1722;4239
290020;201603;4318;14409;4226;14285;370;1008;3525;12185;3895;13193
290030;201603;3083;9629;2913;9382;510;1617;2015;6555;2525;8172
290035;201603;4631;11769;4008;10951;214;711;3079;8696;3293;9407
290040;201603;4007;10797;3435;10155;201;767;2687;7873;2888;8640
290050;201603;2450;7989;2194;7572;152;625;1621;5590;1773;6215
290060;201603;1280;3356;1083;3123;155;512;804;2260;959;2772
290070;201603;33213;82495;28468;76611;6077;16217;13348;38400;19425;54617
290080;201603;5981;17845;5094;16665;627;2076;3572;12036;4199;14112
290090;201603;2131;4631;1680;4153;146;345;1407;3541;1553;3886
290100;201603;9487;27141;8367;25408;1065;3388;5239;16333;6304;19721
290110;201603;4737;14067;4496;13661;688;2285;2855;8458;3543;10743
290115;201603;4745;14337;4223;13658;220;715;3453;11433;3673;12148
290120;201603;6721;17556;5566;16183;245;861;4597;13251;4842;14112
290130;201603;4602;12065;3818;11098;185;708;3048;8615;3233;9323
290135;201603;4476;11255;3831;10289;258;824;2788;7189;3046;8013
290140;201603;4126;12793;3578;12047;249;963;2897;9800;3146;10763
290150;201603;2165;6517;2059;6370;216;695;1605;4891;1821;5586
290160;201603;3319;8747;3175;8570;341;704;2581;7089;2922;7793
290170;201603;2731;8962;2473;8591;165;783;2050;7003;2215;7786
290180;201603;2910;8490;2516;7881;172;642;1938;6050;2110;6692
290190;201603;3708;12410;3551;12178;184;830;2775;9370;2959;10200
290195;201603;2161;5884;1818;5372;77;345;1481;4287;1558;4632
290200;201603;3793;11826;3363;11171;272;946;2597;8651;2869;9597
290205;201603;3165;9252;2853;8778;232;886;2109;6365;2341;7251
290210;201603;15005;42074;13583;40261;2392;6342;8915;28475;11307;34817
290220;201603;2273;6741;2151;6549;129;536;1694;5019;1823;5555
290225;201603;2853;7319;2578;7016;130;379;2314;6297;2444;6676
290230;201603;2249;7289;2132;7152;126;523;1760;5877;1886;6400
290240;201603;3521;9585;3217;9137;297;902;2393;6702;2690;7604
290250;201603;3760;11915;3412;11418;173;560;2809;9803;2982;10363
290260;201603;4984;14157;4182;12963;325;1147;3169;9815;3494;10962
290265;201603;3322;10428;2954;9774;156;678;2275;7458;2431;8136
290270;201603;11894;43320;11330;42439;1456;5778;8150;30918;9606;36696
290280;201603;5236;17093;4855;16476;438;1644;3598;12262;4036;13906
290290;201603;9696;30415;8654;28708;1294;4351;5666;19174;6960;23525
290300;201603;4595;12936;3324;10595;235;752;2168;7112;2403;7864
290310;201603;1440;4325;1263;4053;231;791;677;2192;908;2983
290320;201603;28413;80669;24147;75130;5669;18817;11250;36136;16919;54953
290323;201603;3824;10347;3359;9821;166;509;2773;8125;2939;8634
290327;201603;4393;13266;3778;12162;540;1784;2375;7665;2915;9449
290330;201603;1784;4404;1645;4257;120;330;1427;3711;1547;4041
290340;201603;4846;14991;4527;14591;1301;4277;2444;7988;3745;12265
290350;201603;4301;13391;3775;12621;359;1251;2638;9046;2997;10297
290360;201603;4500;13665;3892;12852;164;640;3235;10790;3399;11430
290370;201603;4682;12961;4030;12128;333;967;3198;9765;3531;10732
290380;201603;5579;16066;4854;14972;314;1043;3788;11878;4102;12921
290390;201603;14373;43998;13039;42053;2196;7301;7782;26135;9978;33436
290395;201603;2541;8333;2271;7825;131;599;1685;5801;1816;6400
290400;201603;3575;10477;3034;9661;272;880;2117;6724;2389;7604
290405;201603;4621;14577;3930;13315;570;1980;2316;8057;2886;10037
290410;201603;5936;17493;4842;15794;422;1660;3389;10764;3811;12424
290420;201603;3244;9384;2716;8636;198;694;2108;6702;2306;7396
290430;201603;3079;9640;2762;9090;508;1749;1608;5371;2116;7120
290440;201603;2956;7824;2390;7027;162;582;1838;5443;2000;6025
290450;201603;3267;9528;2795;8833;302;1042;1888;5970;2190;7012
290460;201603;12727;36818;11457;34718;3237;9937;4410;13570;7647;23507
290470;201603;4362;12003;3327;10470;770;2641;1373;4501;2143;7142
290475;201603;5278;17262;4749;16297;282;1330;3567;11949;3849;13279
290480;201603;2422;6520;2236;6281;257;736;1564;4620;1821;5356
290485;201603;4754;15069;4129;14135;286;1381;3265;10944;3551;12325
290490;201603;7944;20918;7542;20390;625;1770;6112;16397;6737;18167
290500;201603;4147;13010;3419;11582;504;1865;1781;6017;2285;7882
290510;201603;3295;9434;2880;8876;149;546;2382;7373;2531;7919
290515;201603;3419;9664;2889;8977;245;776;2291;7251;2536;8027
290520;201603;12083;36870;9803;32616;847;3305;5858;19337;6705;22642
290530;201603;5051;14931;4430;13972;319;963;3441;10983;3760;11946
290540;201603;3873;11128;3673;10885;405;1204;2896;8679;3301;9883
290550;201603;4550;11893;3998;11269;119;317;3644;10354;3763;10671
290560;201603;6247;18111;5494;17037;1267;3970;3058;9738;4325;13708
290570;201603;42257;115324;38587;110332;3782;11220;27555;78825;31337;90045
290580;201603;6897;23513;6490;22861;776;2851;4655;16766;5431;19617
290590;201603;7232;23094;6243;21339;275;1174;4992;17031;5267;18205
290600;201603;17402;52388;16146;50614;2143;6486;11683;37927;13826;44413
290610;201603;2442;8243;2036;7443;142;670;1419;5093;1561;5763
290620;201603;6406;19339;5854;18490;369;1204;4733;14951;5102;16155
290630;201603;7807;20483;6869;19460;581;1701;5643;16166;6224;17867
290640;201603;2661;7716;2151;6898;132;527;1611;5075;1743;5602
290650;201603;10811;30901;10194;30082;2191;6336;6115;18684;8306;25020
290660;201603;3644;10131;3140;9412;126;415;2377;7402;2503;7817
290670;201603;6814;20771;6110;19613;666;2179;4271;13943;4937;16122
290680;201603;10267;30446;9255;29215;430;1694;7629;23937;8059;25631
290682;201603;4453;12764;3969;12081;133;540;3399;10199;3532;10739
290685;201603;3746;8854;2468;7081;288;865;1480;4355;1768;5220
290687;201603;7506;21090;5888;18644;1369;4397;2713;9091;4082;13488
290689;201603;3135;9046;2761;8480;242;796;2053;6530;2295;7326
290690;201603;5385;15314;4758;14483;764;2366;3067;9431;3831;11797
290700;201603;2337;7227;2204;7034;149;549;1727;5517;1876;6066
290710;201603;7605;24022;7139;23342;374;1258;5981;19693;6355;20951
290720;201603;18227;53483;16700;51577;1279;3751;13582;42957;14861;46708
290730;201603;7148;19643;6385;18649;986;2801;4246;12604;5232;15405
290740;201603;927;2720;753;2424;74;259;506;1636;580;1895
290750;201603;10001;27757;8582;25188;1396;4552;4630;13103;6026;17655
290755;201603;2327;6575;1894;5856;87;328;1387;4236;1474;4564
290760;201603;4201;12675;3428;11275;443;1322;2061;7040;2504;8362
290770;201603;2492;8770;2353;8590;94;440;1909;6999;2003;7439
290780;201603;8889;22464;7703;20766;793;1672;5780;16307;6573;17979
290790;201603;4277;12853;3945;12397;229;730;3325;10494;3554;11224
290800;201603;7202;15263;5725;13690;558;1097;4304;10938;4862;12035
290810;201603;5174;15877;4361;14580;178;669;3317;11188;3495;11857
290820;201603;5631;15584;4996;14766;463;1527;3759;11228;4222;12755
290830;201603;4328;11463;3978;10980;207;696;2992;8077;3199;8773
290840;201603;17515;49413;15492;46429;2359;6905;9870;30883;12229;37788
290850;201603;6063;17522;5844;17261;713;1872;4610;14216;5323;16088
290860;201603;5034;16895;4697;16493;414;1571;3659;13145;4073;14716
290870;201603;4661;13665;3763;12152;250;1003;2676;8595;2926;9598
290880;201603;1418;3833;1130;3384;103;280;746;2284;849;2564
290890;201603;7031;18111;5987;16955;623;1554;4747;13797;5370;15351
290900;201603;2410;6915;1824;5897;260;892;941;3047;1201;3939
290910;201603;4638;12441;3851;11302;98;389;3256;9449;3354;9838
290920;201603;4636;13265;4246;12733;267;777;3494;10552;3761;11329
290930;201603;7876;23997;6876;22366;380;1672;5316;17013;5696;18685
290940;201603;3439;10943;3156;10545;112;388;2618;8961;2730;9349
290950;201603;1539;4261;1343;3966;151;448;901;2711;1052;3159
290960;201603;5712;16142;5185;15486;176;644;4324;12964;4500;13608
290970;201603;3627;11434;3171;10694;294;1005;2139;7362;2433;8367
290980;201603;10561;29949;8980;27040;2377;7377;2646;8001;5023;15378
290990;201603;9003;26917;7801;24956;758;2606;5671;17952;6429;20558
291000;201603;2990;8916;2697;8578;136;506;2389;7619;2525;8125
291005;201603;14255;36961;12559;34751;1630;4585;8589;24189;10219;28774
291010;201603;3267;10072;2579;8632;241;818;1653;5615;1894;6433
291020;201603;1342;3509;1040;2994;102;290;562;1538;664;1828
291030;201603;2239;6099;1653;4958;167;551;962;2841;1129;3392
291040;201603;5508;16430;4905;15570;332;1275;3818;12090;4150;13365
291050;201603;7697;24993;6998;23739;1638;6191;3549;11650;5187;17841
291060;201603;5930;21769;5595;21244;903;3814;3549;13339;4452;17153
291070;201603;15982;45901;13991;43049;985;3423;10661;32830;11646;36253
291072;201603;22855;67238;18592;58876;4536;15500;6095;19613;10631;35113
291075;201603;5090;14369;4543;13582;239;629;3561;10895;3800;11524
291077;201603;1443;4115;1177;3684;93;306;743;2337;836;2643
291080;201603;77307;239447;69609;225046;23915;78466;14266;46385;38181;124851
291085;201603;5668;14811;4878;13769;406;1209;3928;11142;4334;12351
291090;201603;1552;3748;1410;3583;43;131;1252;3182;1295;3313
291100;201603;2605;6633;2097;6076;96;376;1650;4715;1746;5091
291110;201603;4726;17158;4297;16520;518;2299;3008;11350;3526;13649
291120;201603;7141;19388;6584;18561;845;2381;4555;13017;5400;15398
291125;201603;1884;3775;1431;3290;92;229;1128;2646;1220;2875
291130;201603;2808;8821;2380;8069;123;544;1758;5826;1881;6370
291140;201603;4134;12287;3621;11339;482;1461;2240;7159;2722;8620
291150;201603;1922;5101;1808;4967;105;335;1489;4037;1594;4372
291160;201603;5218;16306;4583;15262;1010;3429;2381;7960;3391;11389
291165;201603;2523;7054;1935;5962;42;176;1400;4207;1442;4383
291170;201603;21648;56200;18518;51997;1675;5092;11972;33712;13647;38804
291180;201603;6134;16081;4990;14366;423;1344;3514;10170;3937;11514
291185;201603;3702;10066;3305;9465;238;702;2663;7576;2901;8278
291190;201603;7007;19172;6172;18017;466;1630;4935;14210;5401;15840
291200;201603;2884;8606;2307;7512;151;512;1538;5099;1689;5611
291210;201603;6787;16312;5720;15104;268;845;4345;11452;4613;12297
291220;201603;4150;12850;3780;12269;482;1803;2528;8088;3010;9891
291230;201603;3942;10024;3599;9650;84;159;3376;9195;3460;9354
291240;201603;4579;12432;3970;11363;129;418;3193;9000;3322;9418
291250;201603;3521;10797;2821;9498;288;995;1830;6285;2118;7280
291260;201603;1059;3089;974;2981;62;238;806;2395;868;2633
291270;201603;4422;14153;3999;13369;1242;4355;1852;6225;3094;10580
291280;201603;2095;5998;1677;5300;348;1235;784;2368;1132;3603
291290;201603;5498;15287;4771;14350;768;2312;2863;8798;3631;11110
291300;201603;4343;12314;3374;10685;199;746;2452;7631;2651;8377
291310;201603;5299;15113;4625;13886;283;899;3563;10684;3846;11583
291320;201603;6041;18938;4965;16897;1161;4075;2256;7804;3417;11879
291330;201603;1576;4741;1404;4459;116;414;989;3107;1105;3521
291340;201603;3870;10930;3204;9989;127;443;2567;7987;2694;8430
291345;201603;3355;10653;3116;10366;197;685;2625;8906;2822;9591
291350;201603;5660;16571;4957;15385;287;995;3812;11992;4099;12987
291360;201603;32586;89383;28978;84412;7022;20636;15373;46198;22395;66834
291370;201603;8250;23472;7743;22844;497;1579;6033;17937;6530;19516
291380;201603;3654;11028;3132;10183;195;728;2312;7626;2507;8354
291390;201603;10054;27231;9296;26338;1304;3578;6729;19287;8033;22865
291400;201603;13520;37634;11928;35221;2283;6214;7248;22738;9531;28952
291410;201603;3256;8546;2419;7229;121;517;1745;5034;1866;5551
291420;201603;2074;5681;1796;5352;86;314;1490;4399;1576;4713
291430;201603;3218;9411;2859;8926;133;635;2325;7012;2458;7647
291440;201603;6559;19871;5560;18206;511;1799;4087;13528;4598;15327
291450;201603;8240;24037;7208;22621;316;993;5767;18912;6083;19905
291460;201603;13075;39345;11785;37332;1626;5626;7354;23461;8980;29087
291465;201603;7916;22463;6960;21377;430;1623;5698;17334;6128;18957
291470;201603;15676;42003;13782;39754;1044;2881;10328;30903;11372;33784
291480;201603;34160;87598;28999;80588;4045;12350;16460;45816;20505;58166
291490;201603;4225;13516;3999;13212;444;1486;2967;9975;3411;11461
291500;201603;4255;12192;3611;11249;195;751;2868;8874;3063;9625
291510;201603;3598;10815;3299;10414;70;246;2932;9398;3002;9644
291520;201603;3757;10283;3233;9578;297;985;2218;6577;2515;7562
291530;201603;2176;5901;1720;5225;391;1201;835;2738;1226;3939
291535;201603;3728;11335;3366;10778;193;682;2635;8511;2828;9193
291540;201603;2106;4995;1757;4637;121;226;1539;4207;1660;4433
291550;201603;5068;13680;4413;12779;854;2380;2545;7579;3399;9959
291560;201603;18325;43285;13182;37297;949;2723;9657;28640;10606;31363
291570;201603;2186;5894;2009;5682;137;299;1703;5009;1840;5308
291580;201603;5415;16499;4815;15643;495;1995;3415;11012;3910;13007
291590;201603;1719;5453;1554;5189;149;556;1155;3883;1304;4439
291600;201603;5336;14760;3990;12644;1052;3465;1583;4987;2635;8452
291610;201603;4826;15452;4642;15246;133;451;4239;14078;4372;14529
291620;201603;2922;6937;2312;6300;132;386;1840;5174;1972;5560
291630;201603;3089;7496;2566;6893;229;636;1978;5410;2207;6046
291640;201603;16824;45722;13468;40790;3302;10422;4005;12663;7307;23085
291650;201603;8015;23805;7399;23050;615;1617;6100;19553;6715;21170
291660;201603;2144;5670;1747;5062;134;487;1121;3072;1255;3559
291670;201603;1819;5083;1640;4843;86;249;1307;3931;1393;4180
291680;201603;3984;11598;3463;10740;602;2021;2005;6200;2607;8221
291685;201603;4749;11913;3946;10878;653;1726;2528;7261;3181;8987
291690;201603;3866;10346;3045;9009;222;624;2108;6239;2330;6863
291700;201603;9015;28021;8035;26325;888;2872;5829;19413;6717;22285
291710;201603;5155;13437;4174;12209;306;947;3033;8882;3339;9829
291720;201603;4436;14478;3788;13131;326;1305;2611;8857;2937;10162
291730;201603;5995;17786;5455;17066;507;1711;4219;13389;4726;15100
291733;201603;2650;7553;2279;7063;196;655;1487;4774;1683;5429
291735;201603;2856;7910;2384;7229;119;423;1920;5791;2039;6214
291740;201603;3590;10495;3081;9788;221;804;2419;7686;2640;8490
291750;201603;22311;57088;17417;49634;3743;11003;8246;24173;11989;35176
291760;201603;10875;34667;9676;32628;3866;14487;2323;7801;6189;22288
291770;201603;7594;21941;6431;19858;764;2573;4072;12349;4836;14922
291780;201603;4450;13409;4158;12926;248;827;3441;10670;3689;11497
291790;201603;2648;8046;2517;7872;87;380;2134;6558;2221;6938
291800;201603;30015;81231;26355;76214;4177;12165;16026;47842;20203;60007
291810;201603;10536;28896;8906;26898;374;1364;7213;21830;7587;23194
291820;201603;3726;11000;3337;10421;195;687;2553;8033;2748;8720
291830;201603;4013;10811;3702;10366;439;1280;2662;7541;3101;8821
291835;201603;6264;19513;5058;17382;1376;5087;2341;8138;3717;13225
291840;201603;46879;131198;41255;124798;6458;19081;27775;87479;34233;106560
291845;201603;2621;7694;2446;7474;112;296;2211;6914;2323;7210
291850;201603;4478;12814;3689;11563;346;987;2644;8588;2990;9575
291855;201603;1796;4492;1550;4189;155;540;1135;2957;1290;3497
291860;201603;2161;6100;1749;5319;78;285;1166;3457;1244;3742
291870;201603;1413;3774;1016;3065;71;275;633;1830;704;2105
291875;201603;2781;8756;2526;8365;109;439;1815;5903;1924;6342
291880;201603;4892;15704;4562;15099;439;1508;3359;11214;3798;12722
291890;201603;1258;3265;1036;2993;264;704;620;1912;884;2616
291900;201603;1246;3336;1006;2952;62;225;747;2160;809;2385
291905;201603;2706;7325;2045;6116;161;578;1425;4070;1586;4648
291910;201603;2725;7276;2282;6751;117;445;1908;5601;2025;6046
291915;201603;6988;21244;5848;19189;307;1104;4515;14938;4822;16042
291920;201603;25060;74040;23073;71256;3565;11625;14161;43953;17726;55578
291930;201603;2575;7608;2283;7152;194;730;1608;4920;1802;5650
291940;201603;3326;9396;2456;7878;292;1033;1408;4405;1700;5438
291950;201603;8667;28770;7837;27216;1251;4356;4499;16140;5750;20496
291955;201603;10760;30760;9932;29737;2407;7240;5192;16501;7599;23741
291960;201603;3120;9107;2553;8252;233;766;1843;6178;2076;6944
291970;201603;3865;11938;3573;11458;376;1348;2419;7840;2795;9188
291980;201603;11906;33699;9120;29726;1005;3341;6041;20236;7046;23577
291990;201603;2147;6547;1959;6301;82;277;1660;5474;1742;5751
291992;201603;2741;8346;2679;8241;362;1126;2007;6163;2369;7289
291995;201603;2007;5784;1751;5431;93;358;1460;4499;1553;4857
292000;201603;2396;6710;2156;6394;215;738;1528;4586;1743;5324
292010;201603;6353;15942;4971;14002;492;1271;3552;10277;4044;11548
292020;201603;3920;13620;3710;13266;596;2256;2628;9378;3224;11634
292030;201603;2019;6208;1804;5911;216;759;1058;3443;1274;4202
292040;201603;4362;11757;3765;11135;262;568;3142;9910;3404;10478
292045;201603;3194;10261;2925;9892;101;394;2668;8962;2769;9356
292050;201603;6291;19147;5390;17347;453;1720;3424;10897;3877;12617
292060;201603;12026;31233;11147;30158;928;2250;8988;24409;9916;26659
292070;201603;4554;14162;4284;13849;396;1228;3519;11521;3915;12749
292080;201603;3506;9131;2880;8345;174;564;2429;7067;2603;7631
292090;201603;3901;10234;3341;9581;189;690;2809;8068;2998;8758
292100;201603;11201;30011;9569;27807;2312;6975;4422;13448;6734;20423
292105;201603;2976;9245;2660;8744;119;516;2135;7002;2254;7518
292110;201603;6422;17163;5016;14951;1331;3953;2298;7077;3629;11030
292120;201603;7466;20967;6260;18728;1212;3528;3302;10235;4514;13763
292130;201603;2879;7882;2473;7320;417;1110;1501;4672;1918;5782
292140;201603;4942;12945;4107;11767;711;1875;2678;7937;3389;9812
292145;201603;2370;7282;2113;6846;272;852;1398;4720;1670;5572
292150;201603;12656;38669;11664;37103;587;2169;9348;29819;9935;31988
292160;201603;2436;7083;2085;6626;93;389;1818;5720;1911;6109
292170;201603;8703;24709;7187;22122;902;3046;4472;13761;5374;16807
292180;201603;2947;8615;2337;7557;402;1229;1277;4301;1679;5530
292190;201603;3280;9318;2758;8522;545;1764;1483;4665;2028;6429
292200;201603;6653;20510;5690;18848;1642;5834;1944;6503;3586;12337
292205;201603;3827;11500;3441;10947;162;671;2737;8537;2899;9208
292210;201603;6389;17118;5329;15726;314;1116;4355;12792;4669;13908
292220;201603;1855;5079;1660;4791;473;1331;766;2223;1239;3554
292225;201603;3138;9764;2856;9338;155;644;2329;7568;2484;8212
292230;201603;6592;19008;6214;18410;319;1339;4872;13893;5191;15232
292240;201603;4760;14338;4278;13384;482;1585;2888;8982;3370;10567
292250;201603;4978;15315;4629;14709;1100;3622;2090;6739;3190;10361
292260;201603;3130;9238;2918;8955;183;560;2434;7533;2617;8093
292265;201603;3152;9527;2720;8810;121;546;2056;6509;2177;7055
292270;201603;4030;10225;3247;9310;160;543;2702;7785;2862;8328
292273;201603;2740;6315;2101;5533;183;435;1559;4324;1742;4759
292275;201603;1553;4269;1372;4009;154;456;1014;3040;1168;3496
292280;201603;2098;5945;1833;5647;170;483;1377;4524;1547;5007
292285;201603;2480;6671;2045;6052;109;388;1587;4679;1696;5067
292290;201603;6926;20802;5763;19245;390;1550;4354;14704;4744;16254
292300;201603;8045;24071;6998;22795;1766;6056;3707;12424;5473;18480
292303;201603;2828;8567;2560;8207;96;387;2181;6891;2277;7278
292305;201603;2876;7788;2708;7551;62;248;2453;6751;2515;6999
292310;201603;5809;17172;5368;16504;160;574;4429;13582;4589;14156
292320;201603;6616;18583;5608;16898;407;1291;4270;12837;4677;14128
292330;201603;2176;5825;1998;5589;152;498;1602;4427;1754;4925
292335;201603;5073;13353;4531;12649;450;1188;3586;10213;4036;11401
292340;201603;6259;17753;5342;16260;463;1407;3799;11653;4262;13060
292350;201603;2271;6668;1970;6240;134;516;1570;4961;1704;5477
292360;201603;5224;13642;4949;13170;203;387;4118;11487;4321;11874
292370;201603;8021;23312;7204;22224;623;1703;5663;17818;6286;19521
292380;201603;7196;21271;6552;20243;583;1668;5047;15833;5630;17501
292390;201603;3415;7799;2886;7227;82;184;2612;6636;2694;6820
292400;201603;20491;62467;19190;60449;2593;8136;13245;42270;15838;50406
292405;201603;4507;11223;3630;10100;193;467;2885;8150;3078;8617
292410;201603;1958;5239;1816;5081;133;341;1516;4282;1649;4623
292420;201603;3741;12096;3539;11809;221;862;2896;9663;3117;10525
292430;201603;5534;16290;4199;14416;352;1361;2753;9518;3105;10879
292440;201603;8300;27646;7682;26726;204;883;6854;24035;7058;24918
292450;201603;3955;11846;3256;10685;331;1080;2241;7479;2572;8559
292460;201603;4937;14813;4260;13677;542;1850;2783;8951;3325;10801
292465;201603;2393;7093;2017;6485;198;703;1276;4178;1474;4881
292467;201603;1833;5870;1752;5748;300;1058;1131;3792;1431;4850
292470;201603;2863;7642;2361;6807;104;363;1837;5241;1941;5604
292480;201603;6107;16268;5237;15143;136;482;4705;13566;4841;14048
292490;201603;2384;6491;1962;5882;142;446;1468;4385;1610;4831
292500;201603;6484;19204;5543;17562;681;2198;3574;11528;4255;13726
292510;201603;12630;35875;10902;33389;735;2696;8322;25667;9057;28363
292520;201603;5491;15609;4790;14594;1082;3340;2479;7697;3561;11037
292525;201603;5240;13673;4462;12763;167;542;3768;10799;3935;11341
292530;201603;26447;75353;23143;70893;6167;19548;10086;32136;16253;51684
292540;201603;2820;7783;2487;7385;257;864;1906;5614;2163;6478
292550;201603;6364;19617;5530;18538;638;2259;4099;14118;4737;16377
292560;201603;4000;11162;3480;10381;181;693;2644;7775;2825;8468
292570;201603;4100;11698;3787;11370;67;154;3574;10998;3641;11152
292575;201603;6225;20497;6020;20185;503;1761;4919;16618;5422;18379
292580;201603;6701;19819;6287;19256;344;1130;5292;16228;5636;17358
292590;201603;7280;21459;6770;20726;459;1425;5592;17011;6051;18436
292593;201603;2992;7718;2479;6918;368;969;1647;4588;2015;5557
292595;201603;5743;15930;5071;15082;374;1194;3925;11735;4299;12929
292600;201603;10577;29867;9486;28469;848;2036;7334;22849;8182;24885
292610;201603;4594;12847;3752;11485;285;880;2306;7398;2591;8278
292620;201603;6107;18154;5364;17297;114;384;4972;16200;5086;16584
292630;201603;9205;23264;7636;20870;746;2020;5250;14614;5996;16634
292640;201603;7777;25112;7209;24235;413;1571;5477;18620;5890;20191
292650;201603;4721;12551;4414;12157;365;832;3680;10288;4045;11120
292660;201603;10669;31958;9783;30691;1046;3382;7268;23123;8314;26505
292665;201603;2414;7438;2295;7283;39;106;2119;6799;2158;6905
292670;201603;3691;10371;2879;8930;182;626;1828;5679;2010;6305
292680;201603;3611;10778;3263;10200;470;1355;2225;7027;2695;8382
292690;201603;2832;7711;2062;6489;164;524;1393;4530;1557;5054
292700;201603;9263;27471;8156;25842;1184;3482;5159;17275;6343;20757
292710;201603;2090;6831;1971;6673;65;258;1748;5929;1813;6187
292720;201603;9129;23319;7879;21940;312;1009;6705;18931;7017;19940
292730;201603;3596;10711;3450;10501;250;793;2731;8341;2981;9134
292740;201603;323645;864484;303186;834371;53471;155824;183858;501356;237329;657180
292750;201603;6471;17310;5550;16055;281;897;4437;12888;4718;13785
292760;201603;3937;12349;3548;11656;393;1386;2386;7871;2779;9257
292770;201603;5859;17122;5149;16118;921;3039;3042;9821;3963;12860
292780;201603;1879;4419;1431;3844;113;387;1016;2648;1129;3035
292790;201603;3249;7962;3118;7825;69;118;2980;7575;3049;7693
292800;201603;9081;26695;8347;25486;492;1639;6655;20248;7147;21887
292805;201603;2945;8322;2580;7807;287;944;1874;5657;2161;6601
292810;201603;9342;27864;7780;25684;956;3217;5290;17923;6246;21140
292820;201603;7223;20725;5481;18189;281;1221;4301;14227;4582;15448
292830;201603;1734;5037;1567;4806;65;277;1367;4143;1432;4420
292840;201603;7767;23636;7296;23006;315;1255;6403;19888;6718;21143
292850;201603;3106;8261;2525;7368;318;975;1554;4438;1872;5413
292860;201603;14857;38522;13631;36943;1068;3041;10585;28584;11653;31625
292870;201603;19067;51938;16684;48280;1931;6251;9829;27979;11760;34230
292880;201603;12530;35229;11117;33291;959;3246;7920;23296;8879;26542
292890;201603;5237;17647;4743;16765;639;2410;3042;10892;3681;13302
292895;201603;2796;6758;2159;5794;239;610;1477;4010;1716;4620
292900;201603;2727;8441;2593;8238;161;733;1927;5844;2088;6577
292905;201603;4001;11831;3272;10700;275;960;2260;7458;2535;8418
292910;201603;4924;14616;4455;13783;560;1811;2646;8216;3206;10027
292920;201603;9045;26411;8602;25779;519;1931;7040;20486;7559;22417
292925;201603;5081;15393;4592;14689;356;1165;3542;11412;3898;12577
292930;201603;6372;20397;6020;19778;437;1922;4307;13754;4744;15676
292935;201603;2015;5899;1703;5558;89;331;1441;4856;1530;5187
292937;201603;3213;8168;2674;7502;179;540;2123;5966;2302;6506
292940;201603;3255;8872;2597;8002;262;822;1744;5598;2006;6420
292950;201603;7948;23211;7380;22268;492;1822;5412;15923;5904;17745
292960;201603;5180;13318;4457;12357;287;856;3289;9060;3576;9916
292970;201603;4215;12577;3712;11912;132;614;3045;9732;3177;10346
292975;201603;3489;9248;3258;8959;347;877;2733;7644;3080;8521
292980;201603;3284;8729;2570;7720;216;742;1823;5455;2039;6197
292990;201603;11722;33703;10242;31477;405;1453;8319;25513;8724;26966
293000;201603;2785;7204;2560;6938;51;150;2039;5927;2090;6077
293010;201603;17704;48994;15053;44797;2326;7327;8610;25484;10936;32811
293015;201603;7420;25279;6583;23642;714;2903;4279;15297;4993;18200
293020;201603;8908;29787;8385;29052;299;1398;7249;24966;7548;26364
293030;201603;5511;15737;4399;14011;242;846;3102;10275;3344;11121
293040;201603;3672;12096;3508;11792;162;545;3092;10421;3254;10966
293050;201603;20117;55344;17695;52266;3415;10278;8954;28034;12369;38312
293060;201603;3711;9848;3052;8784;242;754;2179;6181;2421;6935
293070;201603;22106;61892;18885;57187;4479;13697;8545;27111;13024;40808
293075;201603;3171;10889;2924;10511;206;895;2272;8193;2478;9088
293076;201603;3727;10228;3352;9731;175;473;2785;8285;2960;8758
293077;201603;4842;15101;4361;14446;856;2966;2581;8824;3437;11790
293080;201603;4548;14341;4138;13693;201;953;3380;10975;3581;11928
293090;201603;3281;10455;2725;9604;264;993;1946;6979;2210;7972
293100;201603;5757;16915;4773;15183;454;1520;3384;10887;3838;12407
293105;201603;3960;12975;3458;12003;506;1747;2182;7745;2688;9492
293110;201603;2014;5707;1778;5369;67;218;1450;4406;1517;4624
293120;201603;3703;12197;3532;11934;317;1000;2746;9483;3063;10483
293130;201603;4013;11299;3456;10689;137;502;3023;9520;3160;10022
293135;201603;31315;78700;23799;68178;4804;15491;9022;25855;13826;41346
293140;201603;1959;5528;1865;5396;128;469;1503;4218;1631;4687
293150;201603;5425;17898;4657;16419;723;2639;2814;10177;3537;12816
293160;201603;3764;9617;3437;9241;542;1068;2496;7283;3038;8351
293170;201603;3293;9751;3014;9356;263;972;2142;6689;2405;7661
293180;201603;5167;14558;4133;12889;147;625;3199;9777;3346;10402
293190;201603;13693;41184;12589;39550;427;1998;10779;33261;11206;35259
293200;201603;7095;19481;6223;18414;186;706;4853;14515;5039;15221
293210;201603;5046;14426;4441;13408;284;917;3326;10031;3610;10948
293220;201603;4936;14504;4231;13277;1131;3594;1482;4824;2613;8418
293230;201603;3701;11329;3340;10768;465;1651;2244;7235;2709;8886
293240;201603;4366;11994;3506;10568;136;450;2581;7810;2717;8260
293245;201603;4197;11957;3808;11403;254;745;2981;9043;3235;9788
293250;201603;5590;15389;5028;14565;530;1610;3495;10088;4025;11698
293260;201603;4467;13348;3800;12373;249;873;2847;9376;3096;10249
293270;201603;5460;14561;4981;14046;404;978;4219;12161;4623;13139
293280;201603;5176;14564;4389;13531;200;625;3446;10776;3646;11401
293290;201603;14464;47881;13451;45976;3282;11543;5956;21002;9238;32545
293300;201603;6875;16128;5745;14825;344;801;4420;11663;4764;12464
293305;201603;4835;11930;4070;10926;135;423;3406;9110;3541;9533
293310;201603;2490;6501;2008;5676;202;560;1310;3689;1512;4249
293315;201603;4180;10672;3559;9747;345;881;2616;7285;2961;8166
293317;201603;2439;7019;2201;6591;206;595;1474;4487;1680;5082
293320;201603;7677;25423;7470;25155;823;2894;5793;19665;6616;22559
293325;201603;1781;5075;1461;4596;184;631;964;3026;1148;3657
293330;201603;50309;160619;45317;151942;9969;35430;20687;70387;30656;105817
293340;201603;2629;7456;2060;6485;286;933;1124;3570;1410;4503
293345;201603;3257;9648;2844;9099;241;648;2179;7322;2420;7970
293350;201603;6391;18705;6026;18282;245;553;5421;16977;5666;17530
293360;201603;12785;39095;11584;37582;1000;3706;9656;31221;10656;34927
310010;201603;911;2463;717;2167;105;402;326;915;431;1317
310020;201603;2886;9034;2397;8099;544;2001;313;990;857;2991
310030;201603;2286;7095;1881;6403;404;1533;979;3281;1383;4814
310040;201603;957;2552;797;2336;56;197;617;1779;673;1976
310050;201603;1854;6320;1683;5944;346;1374;700;2392;1046;3766
310060;201603;3181;9975;2765;9439;326;1238;2074;7069;2400;8307
310070;201603;329;933;252;790;19;84;160;468;179;552
310080;201603;710;2140;586;1925;104;426;218;670;322;1096
310090;201603;4530;13474;3903;12387;453;1593;2510;7942;2963;9535
310100;201603;3389;10224;2854;9339;167;663;2177;7101;2344;7764
310110;201603;4694;13248;4042;12193;663;2266;2171;6323;2834;8589
310120;201603;599;1829;464;1564;123;522;174;469;297;991
310130;201603;398;1211;363;1159;90;336;182;530;272;866
310140;201603;206;679;171;626;53;242;47;138;100;380
310150;201603;4632;14131;4016;12974;960;3396;1389;4402;2349;7798
310160;201603;7149;22435;5932;20203;1764;6518;963;3173;2727;9691
310163;201603;1014;3249;860;2945;259;932;214;715;473;1647
310170;201603;8997;25206;8017;23851;1123;3561;5262;15875;6385;19436
310180;201603;1597;4621;1368;4266;272;925;670;2025;942;2950
310190;201603;2789;9167;2472;8579;680;2580;389;1341;1069;3921
310200;201603;1808;5861;1535;5313;320;1238;517;1778;837;3016
310205;201603;1102;3183;852;2804;138;461;465;1574;603;2035
310210;201603;2665;7745;2376;7316;184;610;1852;5724;2036;6334
310220;201603;1028;3107;913;2922;169;595;537;1678;706;2273
310230;201603;2483;7690;2102;6870;333;1308;1077;3301;1410;4609
310240;201603;889;3230;808;3065;120;499;438;1719;558;2218
310250;201603;799;2645;772;2600;147;607;446;1386;593;1993
310260;201603;3151;9922;2438;8499;566;2259;514;1587;1080;3846
310270;201603;2500;7122;2081;6528;163;624;1607;5000;1770;5624
310280;201603;2276;5998;1857;5369;209;774;1054;2901;1263;3675
310285;201603;2021;7190;1872;6965;212;941;1389;5209;1601;6150
310290;201603;1126;3394;1057;3286;251;880;528;1486;779;2366
310300;201603;1670;5622;1587;5475;418;1641;777;2566;1195;4207
310310;201603;361;983;262;804;33;97;122;387;155;484
310320;201603;386;1221;320;1097;41;198;152;492;193;690
310330;201603;514;1284;345;973;36;114;140;345;176;459
310340;201603;8271;24752;6793;22224;1320;4412;3318;11350;4638;15762
310350;201603;13466;35574;9833;29633;2350;7916;2480;7228;4830;15144
310360;201603;431;1266;399;1222;25;109;288;835;313;944
310370;201603;1389;4609;1258;4380;366;1279;579;2059;945;3338
310375;201603;1179;3217;772;2478;108;394;272;865;380;1259
310380;201603;360;942;243;768;81;277;77;219;158;496
310390;201603;448;1560;390;1450;87;353;70;220;157;573
310400;201603;10041;27694;7573;23584;1735;5877;1786;5621;3521;11498
310410;201603;721;2403;505;2025;106;466;89;358;195;824
310420;201603;5447;15237;3624;11480;628;2190;515;1411;1143;3601
310430;201603;1315;4283;1013;3693;242;969;148;514;390;1483
310440;201603;543;1561;412;1321;71;262;161;505;232;767
310445;201603;1215;3970;1019;3608;123;475;656;2317;779;2792
310450;201603;4488;12661;3654;11470;370;1224;2481;7917;2851;9141
310460;201603;1502;4495;1248;4107;352;1284;261;936;613;2220
310470;201603;3865;9026;3273;8318;283;628;2727;7076;3010;7704
310480;201603;1229;3571;913;2945;183;608;359;1097;542;1705
310490;201603;2838;9218;2474;8518;609;2457;956;3161;1565;5618
310500;201603;1238;4165;1098;3878;248;963;418;1429;666;2392
310510;201603;2004;6273;1578;5351;373;1354;240;810;613;2164
310520;201603;1388;3562;1059;3056;81;227;713;2062;794;2289
310530;201603;991;2952;526;1795;64;253;60;179;124;432
310540;201603;2884;9356;2587;8822;645;2282;1106;3804;1751;6086
310550;201603;1186;3341;954;2981;202;759;458;1322;660;2081
310560;201603;15160;45967;12883;41646;3392;12234;3637;10965;7029;23199
310570;201603;1136;3418;967;3129;151;579;625;1981;776;2560
310590;201603;4228;12287;3458;10864;595;1976;1462;4492;2057;6468
310600;201603;1369;4497;1232;4226;278;1107;474;1508;752;2615
310610;201603;455;1545;399;1422;78;349;110;348;188;697
310620;201603;138132;422600;118866;386844;27397;99509;43387;131631;70784;231140
310630;201603;3993;12079;3684;11580;350;1237;2680;8327;3030;9564
310640;201603;1259;3813;1022;3414;293;1079;255;787;548;1866
310650;201603;2646;8318;2099;7360;335;1219;1163;4112;1498;5331
310660;201603;1315;3976;1161;3778;122;406;831;2684;953;3090
310665;201603;1237;3759;1115;3592;98;343;862;2840;960;3183
310670;201603;38999;119350;34759;110709;9014;30394;12049;37603;21063;67997
310680;201603;663;1896;594;1798;94;311;388;1154;482;1465
310690;201603;1403;4497;1141;4045;242;1031;394;1290;636;2321
310700;201603;526;1281;410;1135;73;240;245;655;318;895
310710;201603;6191;20177;4827;17923;947;4136;643;2177;1590;6313
310720;201603;760;2282;694;2166;87;320;440;1339;527;1659
310730;201603;9230;28555;8240;26928;1460;5209;4650;15137;6110;20346
310740;201603;4896;15462;3903;13546;933;3532;809;2680;1742;6212
310750;201603;1468;3654;1110;3172;207;629;538;1460;745;2089
310760;201603;601;1818;501;1648;93;343;176;571;269;914
310770;201603;888;2780;684;2465;158;643;268;905;426;1548
310780;201603;3679;10160;3110;9157;475;1412;1915;5631;2390;7043
310790;201603;1919;6149;1746;5842;441;1537;754;2652;1195;4189
310800;201603;2768;8731;2136;7520;619;2521;163;520;782;3041
310810;201603;1121;3162;993;2928;171;571;539;1497;710;2068
310820;201603;1285;3689;915;2990;209;736;221;735;430;1471
310825;201603;2487;8367;1957;7441;131;696;1414;5308;1545;6004
310830;201603;1317;4266;1059;3774;300;1138;276;945;576;2083
310840;201603;2092;6372;1626;5570;335;1238;416;1348;751;2586
310850;201603;1506;4466;1282;4174;168;590;894;2928;1062;3518
310855;201603;2882;9061;2480;8443;396;1473;1584;5439;1980;6912
310860;201603;7381;22594;6204;20477;774;2755;3597;12047;4371;14802
310870;201603;1014;2792;790;2420;147;489;402;1232;549;1721
310880;201603;1045;3254;864;2926;148;570;443;1483;591;2053
310890;201603;2518;7614;1945;6631;458;1774;392;1199;850;2973
310900;201603;3952;12410;3090;10632;684;2601;942;3038;1626;5639
310910;201603;1896;5347;1270;4142;221;831;151;403;372;1234
310920;201603;1860;5452;1469;4848;329;1239;621;2026;950;3265
310925;201603;899;2945;811;2793;295;1124;292;970;587;2094
310930;201603;6036;16956;4829;15187;827;2805;2668;8680;3495;11485
310940;201603;6082;17074;5076;15551;833;2652;2747;8366;3580;11018
310945;201603;1112;3279;985;3101;124;456;606;1846;730;2302
310950;201603;2017;6390;1497;5275;390;1592;402;1311;792;2903
310960;201603;377;1226;308;1096;88;349;106;380;194;729
310970;201603;1410;4634;1042;3794;244;1000;136;430;380;1430
310980;201603;431;1054;265;774;38;130;121;314;159;444
310990;201603;1130;3677;929;3253;206;814;258;840;464;1654
311000;201603;3467;11732;3160;11149;869;3439;1041;3419;1910;6858
311010;201603;702;2374;651;2283;213;798;288;1006;501;1804
311020;201603;890;2618;701;2293;139;517;308;954;447;1471
311030;201603;1577;4283;1103;3441;279;1000;331;930;610;1930
311040;201603;458;1532;392;1376;84;298;89;291;173;589
311050;201603;2097;6490;1842;6102;482;1772;784;2593;1266;4365
311060;201603;2316;6806;1742;5628;332;1208;483;1431;815;2639
311070;201603;1379;4720;1211;4402;270;1116;487;1745;757;2861
311080;201603;796;2451;683;2233;139;502;283;863;422;1365
311090;201603;1528;5749;1332;5348;412;1818;282;1103;694;2921
311100;201603;2029;6771;1645;5955;558;2193;222;790;780;2983
311110;201603;3416;8240;2477;6916;389;1169;1235;3453;1624;4622
311115;201603;1191;3482;998;3199;91;386;668;2091;759;2477
311120;201603;7792;21826;6035;18773;1370;4780;1570;4528;2940;9308
311130;201603;1876;5897;1587;5480;312;1314;671;2164;983;3478
311140;201603;1257;3369;1021;3063;87;300;697;2075;784;2375
311150;201603;1713;5899;1574;5679;264;1062;967;3481;1231;4543
311160;201603;3980;13301;3274;12022;1134;4554;722;2649;1856;7203
311170;201603;781;2339;619;2047;63;228;293;1006;356;1234
311180;201603;1171;3375;915;2890;265;905;204;602;469;1507
311190;201603;1090;3056;808;2511;163;583;201;563;364;1146
311200;201603;1984;6037;1607;5258;425;1525;267;789;692;2314
311205;201603;989;3267;844;2973;120;482;376;1340;496;1822
311210;201603;930;2989;857;2893;154;512;572;2008;726;2520
311220;201603;859;2683;703;2359;154;559;225;724;379;1283
311230;201603;8173;25679;6437;22186;1283;4723;2139;7678;3422;12401
311240;201603;1020;3070;796;2708;203;771;222;734;425;1505
311250;201603;751;2458;672;2336;192;746;205;632;397;1378
311260;201603;2379;6331;1787;5371;420;1410;580;1720;1000;3130
311265;201603;1210;3397;956;2980;180;607;488;1533;668;2140
311270;201603;3308;10516;2887;9928;305;1441;1972;6512;2277;7953
311280;201603;1241;3458;800;2548;158;590;186;564;344;1154
311290;201603;1968;6579;1848;6315;373;1271;1036;3604;1409;4875
311300;201603;4244;14199;3793;13382;434;1839;2611;9130;3045;10969
311310;201603;563;1884;510;1790;88;354;192;616;280;970
311320;201603;3755;12445;3388;11656;633;2471;1190;3853;1823;6324
311330;201603;4543;13586;3928;12550;1038;3694;1615;5160;2653;8854
311340;201603;11670;36656;10198;33876;3014;10730;2628;8651;5642;19381
311350;201603;2262;6371;1762;5447;278;994;776;2200;1054;3194
311360;201603;1095;3031;847;2714;355;1176;127;437;482;1613
311370;201603;3652;10962;3052;9899;648;2461;1199;3571;1847;6032
311380;201603;404;1343;352;1247;95;360;115;405;210;765
311390;201603;1730;6302;1586;6100;671;2948;443;1586;1114;4534
311400;201603;1411;4453;1165;3986;207;841;472;1478;679;2319
311410;201603;1758;5969;1576;5736;424;1730;751;2776;1175;4506
311420;201603;1858;5974;1283;4577;237;928;153;412;390;1340
311430;201603;3751;11238;2608;8759;471;1720;265;884;736;2604
311440;201603;2368;7512;1753;6408;533;2255;263;943;796;3198
311450;201603;1911;6583;1611;5934;441;1806;304;1029;745;2835
311455;201603;1120;2984;885;2598;213;665;382;1040;595;1705
311460;201603;619;2005;471;1703;101;427;107;355;208;782
311470;201603;483;1594;387;1391;103;434;85;259;188;693
311480;201603;769;2030;715;1957;165;429;436;1202;601;1631
311490;201603;222;814;201;755;59;246;69;234;128;480
311500;201603;422;1229;337;1070;81;306;132;404;213;710
311510;201603;2908;8927;2359;7937;694;2764;493;1580;1187;4344
311520;201603;604;1978;560;1889;170;629;216;697;386;1326
311530;201603;11468;29404;8244;24242;1849;6492;2165;6134;4014;12626
311535;201603;796;2308;517;1751;119;463;74;230;193;693
311540;201603;605;2097;563;2030;206;730;227;819;433;1549
311545;201603;2072;6295;1841;6012;171;632;1319;4260;1490;4892
311547;201603;1470;4136;1231;3762;88;290;820;2502;908;2792
311550;201603;2865;9089;2412;8198;409;1599;847;2807;1256;4406
311560;201603;260;675;219;629;26;76;124;338;150;414
311570;201603;2013;5092;1578;4506;115;372;1160;3395;1275;3767
311580;201603;2314;4697;1745;4041;449;946;928;2321;1377;3267
311590;201603;433;1318;366;1211;89;334;142;468;231;802
311600;201603;1181;3598;1005;3370;174;572;621;2138;795;2710
311610;201603;2886;10142;2594;9653;836;3055;1007;4025;1843;7080
311615;201603;3030;9417;2534;8632;249;1002;1759;5982;2008;6984
311620;201603;402;1257;358;1178;66;244;201;656;267;900
311630;201603;1362;3965;1127;3568;230;698;640;2035;870;2733
311640;201603;763;2443;632;2228;127;492;306;1063;433;1555
311650;201603;2223;6368;1883;5839;258;868;1025;3200;1283;4068
311660;201603;2249;7459;1761;6335;320;1192;152;459;472;1651
311670;201603;1635;4712;1325;4189;421;1450;390;1220;811;2670
311680;201603;2051;6419;1727;5875;375;1337;906;3104;1281;4441
311690;201603;478;1235;408;1151;31;92;326;939;357;1031
311700;201603;2153;5810;1774;5298;139;452;1326;3912;1465;4364
311710;201603;1629;4929;1202;4127;420;1614;281;921;701;2535
311720;201603;389;1291;349;1212;67;245;155;533;222;778
311730;201603;5739;14318;3317;10169;901;3176;638;1551;1539;4727
311740;201603;778;2342;738;2290;202;610;462;1466;664;2076
311750;201603;3925;12734;3413;11947;610;2464;1802;6199;2412;8663
311760;201603;696;2313;614;2131;138;542;169;505;307;1047
311770;201603;2185;6915;1804;6206;402;1538;529;1753;931;3291
311780;201603;1112;3914;943;3552;262;1155;219;753;481;1908
311783;201603;1918;6328;1622;5753;96;490;1196;4181;1292;4671
311787;201603;588;2014;435;1567;77;302;101;306;178;608
311790;201603;1489;4363;1108;3651;232;870;361;1131;593;2001
311800;201603;4453;14879;3841;13393;807;3048;275;796;1082;3844
311810;201603;1050;3408;918;3161;65;305;584;1987;649;2292
311820;201603;601;1859;491;1613;124;451;230;704;354;1155
311830;201603;8116;26918;6689;23554;2016;7760;688;2203;2704;9963
311840;201603;2913;8772;2606;8317;679;2417;1210;3787;1889;6204
311850;201603;273;839;241;786;49;176;116;361;165;537
311860;201603;46960;138105;40131;126244;7976;27504;19061;58206;27037;85710
311870;201603;2084;6092;1547;5076;310;1154;462;1412;772;2566
311880;201603;6710;19211;5942;18258;705;2016;4219;13506;4924;15522
311890;201603;1442;4250;1163;3742;273;954;481;1521;754;2475
311900;201603;740;2223;646;2086;76;280;387;1272;463;1552
311910;201603;4200;12310;3443;11191;801;2824;1442;4688;2243;7512
311920;201603;1863;6112;1634;5690;206;786;968;3372;1174;4158
311930;201603;3444;9782;2907;8950;1118;3602;732;2229;1850;5831
311940;201603;12223;36444;9844;31678;2344;8211;2092;6303;4436;14514
311950;201603;2173;6390;1791;5828;148;550;1257;4050;1405;4600
311960;201603;374;1163;333;1079;71;272;130;349;201;621
311970;201603;341;1185;288;1068;52;228;70;247;122;475
311980;201603;600;1671;405;1319;59;200;139;471;198;671
311990;201603;412;1203;341;1093;118;417;113;340;231;757
311995;201603;1163;3535;723;2495;47;171;66;170;113;341
312000;201603;596;1793;536;1703;66;227;329;1067;395;1294
312010;201603;876;2828;741;2541;123;460;290;966;413;1426
312015;201603;1349;4337;1204;4072;129;522;784;2621;913;3143
312020;201603;1042;3272;917;3071;179;637;423;1428;602;2065
312030;201603;1743;5113;1567;4894;97;347;1316;4094;1413;4441
312040;201603;720;2626;610;2338;149;630;121;456;270;1086
312050;201603;1230;4295;1050;3871;240;996;147;469;387;1465
312060;201603;742;2237;642;2091;215;740;252;784;467;1524
312070;201603;1008;3082;677;2372;150;574;230;797;380;1371
312080;201603;2576;7125;2061;6335;287;1058;1097;3156;1384;4214
312083;201603;875;2502;762;2335;94;317;541;1636;635;1953
312087;201603;2093;6446;1886;6144;215;773;1343;4444;1558;5217
312090;201603;8750;26891;7435;24666;2164;7577;2625;8554;4789;16131
312100;201603;1343;4518;1127;4185;247;1061;481;1743;728;2804
312110;201603;1026;3577;897;3302;270;1137;155;497;425;1634
312120;201603;708;2293;597;2070;128;532;206;622;334;1154
312125;201603;1076;3473;958;3255;212;708;497;1782;709;2490
312130;201603;841;2385;655;2032;93;328;233;682;326;1010
312140;201603;790;2525;692;2302;147;532;191;557;338;1089
312150;201603;494;1435;435;1314;22;81;284;814;306;895
312160;201603;7201;24247;6398;22599;1653;6416;2293;7954;3946;14370
312170;201603;911;2633;776;2410;70;235;486;1495;556;1730
312180;201603;1334;4088;1160;3749;250;865;447;1368;697;2233
312190;201603;570;1845;439;1585;139;553;70;258;209;811
312200;201603;4640;13337;3905;12184;699;2136;2145;6784;2844;8920
312210;201603;1045;2808;800;2449;207;702;338;965;545;1667
312220;201603;1883;6319;1733;6154;177;542;1427;5321;1604;5863
312230;201603;12055;36861;9419;31897;3003;11273;1208;3970;4211;15243
312235;201603;1527;4587;1348;4321;157;597;934;2959;1091;3556
312240;201603;893;2984;718;2616;171;668;187;675;358;1343
312245;201603;2134;6392;1918;6109;97;346;1567;4990;1664;5336
312247;201603;785;2345;608;2040;165;594;250;863;415;1457
312250;201603;1163;3205;883;2724;158;559;348;1012;506;1571
312260;201603;883;2781;735;2533;129;515;438;1470;567;1985
312270;201603;644;1933;543;1743;67;283;258;753;325;1036
312280;201603;399;1329;355;1234;126;470;41;131;167;601
312290;201603;748;2443;687;2356;176;707;223;743;399;1450
312300;201603;866;2875;688;2458;164;639;60;164;224;803
312310;201603;838;3125;786;3019;223;948;289;1079;512;2027
312320;201603;1888;5414;1446;4552;340;1153;214;558;554;1711
312330;201603;963;2824;806;2600;131;508;560;1786;691;2294
312340;201603;304;814;258;741;36;132;161;418;197;550
312350;201603;284;727;251;688;23;76;204;538;227;614
312352;201603;1595;5044;1437;4813;296;1041;914;3147;1210;4188
312360;201603;2981;9503;2491;8534;498;1896;739;2525;1237;4421
312370;201603;1645;5183;1495;4945;484;1820;493;1519;977;3339
312380;201603;1830;5130;1617;4839;70;206;1356;4166;1426;4372
312385;201603;1290;3809;1109;3522;102;415;772;2377;874;2792
312390;201603;2113;6787;1720;6026;445;1675;284;905;729;2580
312400;201603;3102;9875;2597;8885;938;3311;638;2279;1576;5590
312410;201603;9360;30599;8344;28685;1836;6853;3448;11706;5284;18559
312420;201603;3796;11640;3592;11381;534;1691;2467;7983;3001;9674
312430;201603;7805;23141;6716;21200;1064;3418;4083;13025;5147;16443
312440;201603;737;2284;621;2083;175;657;272;949;447;1606
312450;201603;1085;3564;838;3055;266;1011;236;895;502;1906
312460;201603;343;1029;305;985;79;293;148;474;227;767
312470;201603;648;1759;419;1318;78;276;123;374;201;650
312480;201603;1174;3076;888;2763;200;690;468;1382;668;2072
312490;201603;1952;5140;1531;4519;211;695;861;2451;1072;3146
312500;201603;654;1970;573;1847;103;382;202;627;305;1009
312510;201603;3300;9554;2654;8248;400;1435;1258;3646;1658;5081
312520;201603;250;847;202;763;55;220;57;228;112;448
312530;201603;585;1737;522;1652;72;290;327;1001;399;1291
312540;201603;1431;4479;1105;3849;217;809;516;1802;733;2611
312550;201603;673;2058;584;1867;114;382;265;802;379;1184
312560;201603;2014;5333;1661;4886;83;307;1347;3924;1430;4231
312570;201603;2334;6901;1955;6267;548;1887;582;1840;1130;3727
312580;201603;513;1693;432;1517;65;268;153;517;218;785
312590;201603;1637;5438;1428;5008;246;1065;616;2004;862;3069
312595;201603;1878;6294;1681;5841;342;1244;880;3060;1222;4304
312600;201603;770;2507;598;2168;94;436;272;914;366;1350
312610;201603;6881;19230;5065;15976;1104;3864;1012;3022;2116;6886
312620;201603;2154;6223;1658;5542;147;561;1199;4156;1346;4717
312630;201603;333;1074;287;992;77;302;104;335;181;637
312640;201603;531;1719;432;1516;90;333;122;400;212;733
312650;201603;2103;6182;1570;5129;143;530;914;2984;1057;3514
312660;201603;1389;3651;1122;3265;105;364;751;2150;856;2514
312670;201603;5510;16355;4689;15238;1269;4536;1635;5193;2904;9729
312675;201603;1220;3951;1038;3555;136;536;614;2090;750;2626
312680;201603;1454;4384;1238;4096;190;753;740;2361;930;3114
312690;201603;2086;5562;1700;5023;248;789;1045;2990;1293;3779
312695;201603;795;2827;763;2783;157;556;487;1867;644;2423
312700;201603;1833;5509;1456;4764;193;708;710;2281;903;2989
312705;201603;1235;3542;1045;3204;80;272;737;2225;817;2497
312707;201603;1531;4869;1207;4244;161;672;603;2048;764;2720
312710;201603;6685;16808;4383;13142;1150;3878;781;2272;1931;6150
312720;201603;737;2515;642;2320;145;585;233;801;378;1386
312730;201603;1858;4408;1278;3717;151;487;733;2135;884;2622
312733;201603;1607;4293;1223;3610;57;184;743;2151;800;2335
312735;201603;804;2208;698;2067;150;502;401;1123;551;1625
312737;201603;819;2065;599;1758;178;534;203;615;381;1149
312738;201603;496;1504;366;1247;87;334;112;346;199;680
312740;201603;371;942;227;776;71;274;51;165;122;439
312750;201603;1225;4342;1162;4234;230;998;551;1928;781;2926
312760;201603;1938;6203;1515;5348;358;1385;323;1121;681;2506
312770;201603;39696;108701;30840;94115;7778;25644;8033;23834;15811;49478
312780;201603;2593;9008;2312;8536;395;1610;1207;4580;1602;6190
312790;201603;310;787;184;573;34;130;47;109;81;239
312800;201603;4841;15697;3954;13945;1180;4513;927;3281;2107;7794
312810;201603;2034;6220;1421;5011;321;1217;232;768;553;1985
312820;201603;1834;5276;1621;4932;86;310;1128;3350;1214;3660
312825;201603;1305;3602;1137;3381;94;321;866;2567;960;2888
312830;201603;2513;7704;1775;6244;422;1630;259;902;681;2532
312840;201603;1201;3851;998;3455;147;583;314;986;461;1569
312850;201603;667;2091;529;1823;88;367;158;540;246;907
312860;201603;1099;3229;856;2803;230;836;227;675;457;1511
312870;201603;5504;16984;3918;13666;731;2807;763;2563;1494;5370
312880;201603;1248;3744;1108;3535;131;463;683;2245;814;2708
312890;201603;1599;4853;1052;3611;253;940;331;1154;584;2094
312900;201603;1192;3491;1046;3289;133;443;731;2359;864;2802
312910;201603;1598;3213;970;2407;148;414;462;1068;610;1482
312920;201603;847;2693;694;2409;187;750;257;826;444;1576
312930;201603;2101;6046;1832;5654;402;1279;868;2749;1270;4028
312940;201603;876;2843;765;2663;192;755;211;686;403;1441
312950;201603;3041;8518;2358;7503;791;2715;536;1704;1327;4419
312960;201603;1911;5510;1657;5191;195;560;1268;4116;1463;4676
312965;201603;1765;5614;1514;5166;190;774;907;3090;1097;3864
312970;201603;975;3254;811;2970;214;887;181;647;395;1534
312980;201603;16256;54301;15306;52410;4735;17702;5520;18312;10255;36014
312990;201603;456;1347;329;1132;97;379;99;345;196;724
313000;201603;497;1633;406;1456;95;447;160;491;255;938
313005;201603;2550;8183;2259;7649;498;1654;1161;4033;1659;5687
313010;201603;3456;11007;2909;10072;768;2871;1202;4106;1970;6977
313020;201603;930;3024;733;2538;140;564;138;387;278;951
313030;201603;1472;3924;1078;3377;225;861;453;1355;678;2216
313040;201603;804;2623;698;2377;97;405;287;894;384;1299
313050;201603;1763;5436;1321;4759;289;1180;326;1062;615;2242
313055;201603;1567;4922;1424;4724;74;267;1165;3899;1239;4166
313060;201603;722;2316;578;1983;155;547;68;215;223;762
313065;201603;1897;6136;1629;5718;310;1208;1048;3679;1358;4887
313070;201603;1027;2995;844;2679;186;678;347;1049;533;1727
313080;201603;439;1385;335;1173;71;290;99;312;170;602
313090;201603;5156;14802;4443;13659;1046;3410;2197;6805;3243;10215
313100;201603;1086;3313;976;3136;92;300;745;2428;837;2728
313110;201603;1693;4818;1276;4027;201;717;536;1585;737;2302
313115;201603;2368;7970;2236;7698;513;2021;966;3085;1479;5106
313120;201603;3428;9044;2927;8392;674;2189;1595;4466;2269;6655
313130;201603;24683;74366;21441;67889;4647;16271;8138;24309;12785;40580
313140;201603;568;1464;437;1272;28;98;311;887;339;985
313150;201603;1293;4075;1097;3733;482;1743;205;704;687;2447
313160;201603;923;2803;800;2559;124;454;454;1415;578;1869
313170;201603;7647;25738;6200;22442;1465;5668;1205;4266;2670;9934
313180;201603;2328;6368;1877;5735;472;1611;674;1995;1146;3606
313190;201603;3235;10959;2596;9371;553;2178;591;1978;1144;4156
313200;201603;1126;3673;981;3397;115;440;674;2303;789;2743
313210;201603;4112;12803;3432;11761;778;2853;1459;4868;2237;7721
313220;201603;1452;4278;1047;3440;237;869;217;592;454;1461
313230;201603;2246;7968;2081;7746;308;1208;1428;5347;1736;6555
313240;201603;7708;23384;6103;20517;1186;4576;2208;7063;3394;11639
313250;201603;6781;21236;5922;19795;798;2780;3364;11345;4162;14125
313260;201603;605;1785;435;1429;66;240;100;329;166;569
313270;201603;5261;15716;4388;14246;850;2984;2197;7067;3047;10051
313280;201603;371;1224;272;1009;50;208;57;190;107;398
313290;201603;797;2775;655;2528;228;971;83;294;311;1265
313300;201603;1775;5864;1470;5147;397;1520;184;547;581;2067
313310;201603;1035;3573;929;3345;200;840;173;556;373;1396
313320;201603;2268;6490;1703;5590;310;1128;694;2282;1004;3410
313330;201603;3906;12052;3258;10934;372;1500;1885;6168;2257;7668
313340;201603;1864;4580;1470;4005;271;740;769;2106;1040;2846
313350;201603;2866;8869;2298;7650;452;1678;440;1327;892;3005
313360;201603;1203;3429;918;2969;225;886;464;1404;689;2290
313370;201603;1123;3788;1056;3613;159;648;536;1712;695;2360
313375;201603;2272;5884;1567;4853;275;1057;492;1459;767;2516
313380;201603;4801;14862;4042;13352;1011;3663;1237;3836;2248;7499
313390;201603;857;2933;816;2879;93;375;549;1921;642;2296
313400;201603;3631;9871;3180;9351;282;766;2672;8068;2954;8834
313410;201603;1188;3384;1000;3098;239;806;526;1595;765;2401
313420;201603;18592;44125;11568;32531;2109;6712;1820;5099;3929;11811
313430;201603;1029;3191;784;2683;145;589;284;893;429;1482
313440;201603;6017;13608;4143;11444;255;683;2670;7546;2925;8229
313450;201603;611;1817;498;1600;102;377;151;444;253;821
313460;201603;2079;7080;1791;6595;469;1991;553;1848;1022;3839
313470;201603;3058;8458;2716;7976;392;1203;1784;5180;2176;6383
313480;201603;1035;2942;802;2573;112;423;289;860;401;1283
313490;201603;1444;4225;843;3257;248;1060;92;347;340;1407
313500;201603;383;1244;320;1088;59;226;103;341;162;567
313505;201603;8953;26153;8236;25342;345;766;7513;23649;7858;24415
313507;201603;1349;3724;1174;3467;110;357;785;2339;895;2696
313510;201603;15148;43344;13239;40556;1942;6192;7343;22694;9285;28886
313520;201603;14018;43192;11812;39236;1344;5046;7385;24393;8729;29439
313530;201603;599;1822;498;1645;42;166;176;556;218;722
313535;201603;2418;7231;2189;6813;177;619;1597;4905;1774;5524
313540;201603;1054;3283;783;2592;194;703;173;529;367;1232
313545;201603;1256;4603;1128;4347;153;739;651;2360;804;3099
313550;201603;1768;5672;1556;5256;394;1381;654;2169;1048;3550
313560;201603;2134;5015;1764;4600;269;663;1228;3326;1497;3989
313570;201603;860;2983;739;2749;231;927;219;801;450;1728
313580;201603;5690;16252;4553;14625;754;2603;2559;8357;3313;10960
313590;201603;964;2727;753;2436;345;1227;147;443;492;1670
313600;201603;3741;11226;3238;10450;382;1355;2188;7095;2570;8450
313610;201603;956;2884;815;2617;161;581;403;1257;564;1838
313620;201603;5272;16192;4561;14934;1218;4272;1532;5035;2750;9307
313630;201603;7895;22028;5940;19228;1044;3833;2579;8849;3623;12682
313640;201603;755;2185;566;1894;174;647;162;531;336;1178
313650;201603;1897;6231;1673;5859;262;1059;1068;3662;1330;4721
313652;201603;921;3247;844;3102;134;565;511;1825;645;2390
313655;201603;924;2948;776;2700;104;429;469;1595;573;2024
313657;201603;1305;3881;1081;3545;108;496;787;2409;895;2905
313660;201603;804;2639;710;2468;152;612;315;1041;467;1653
313665;201603;3539;11346;3053;10336;637;2416;1340;4373;1977;6789
313670;201603;43679;127594;32508;106153;7489;26894;9629;30725;17118;57619
313680;201603;1030;3074;915;2887;143;542;539;1649;682;2191
313690;201603;820;2951;718;2710;168;652;253;974;421;1626
313695;201603;1313;4281;1130;3946;100;403;783;2753;883;3156
313700;201603;3398;11692;3002;11190;469;1792;2100;8039;2569;9831
313710;201603;1265;3415;978;2983;166;554;521;1550;687;2104
313720;201603;5110;16237;4096;14060;772;2934;1294;4124;2066;7058
313730;201603;1249;3362;949;2986;150;526;533;1688;683;2214
313740;201603;2019;7255;1721;6554;486;2082;126;412;612;2494
313750;201603;2151;6490;1811;5843;460;1586;546;1630;1006;3216
313753;201603;1768;5115;1409;4521;301;1085;601;1902;902;2987
313760;201603;4200;13574;3499;12170;953;3604;904;2950;1857;6554
313770;201603;3225;10351;2834;9771;844;3164;1205;4116;2049;7280
313780;201603;3783;10418;2972;9226;436;1618;1216;3819;1652;5437
313790;201603;478;1660;451;1613;97;344;247;922;344;1266
313800;201603;1220;3290;1051;3036;100;332;713;2082;813;2414
313810;201603;1489;4286;1387;4145;72;194;1183;3649;1255;3843
313820;201603;12507;33243;10313;29898;1746;5851;4582;12750;6328;18601
313830;201603;412;1357;348;1229;88;353;124;439;212;792
313835;201603;868;2924;804;2824;147;603;438;1475;585;2078
313840;201603;7382;21188;5833;18594;1409;4955;1375;4325;2784;9280
313850;201603;1159;3137;1011;2877;189;640;506;1316;695;1956
313860;201603;2663;8044;2036;6698;461;1644;466;1447;927;3091
313862;201603;1194;3006;836;2426;111;314;423;1320;534;1634
313865;201603;2202;6795;1985;6471;198;764;1460;4699;1658;5463
313867;201603;1090;3730;945;3416;274;1067;255;963;529;2030
313868;201603;1597;5375;1376;4929;124;569;922;3220;1046;3789
313870;201603;770;2418;703;2308;199;744;193;553;392;1297
313880;201603;1380;4253;1192;3957;253;947;562;1731;815;2678
313890;201603;1837;4984;1523;4570;319;906;922;2945;1241;3851
313900;201603;3889;13956;3470;13021;1029;4329;915;3352;1944;7681
313910;201603;723;2429;609;2206;213;825;62;214;275;1039
313920;201603;3260;10820;2824;10008;476;1781;1554;5691;2030;7472
313925;201603;1842;4992;1395;4173;77;262;836;2502;913;2764
313930;201603;5295;17156;4351;15458;753;2850;2279;8261;3032;11111
313940;201603;8341;27476;6931;25261;1928;7839;2147;8286;4075;16125
313950;201603;4033;11438;3122;9987;969;3551;942;2723;1911;6274
313960;201603;5362;13729;3882;11655;1044;3422;989;2791;2033;6213
313970;201603;1415;4066;1239;3867;140;488;745;2444;885;2932
313980;201603;1208;3734;938;3273;241;964;399;1389;640;2353
313990;201603;1743;6419;1496;5840;476;2045;279;953;755;2998
314000;201603;7779;24757;7037;23339;1218;4811;3972;12605;5190;17416
314010;201603;1126;3127;933;2880;88;310;592;1772;680;2082
314015;201603;1200;4119;1007;3762;256;1063;359;1288;615;2351
314020;201603;501;1514;360;1224;85;327;72;221;157;548
314030;201603;803;2594;649;2258;89;339;238;816;327;1155
314040;201603;673;1913;565;1720;244;794;118;336;362;1130
314050;201603;1662;5145;1324;4475;288;1136;449;1394;737;2530
314053;201603;1545;4837;1360;4594;197;662;872;3113;1069;3775
314055;201603;2129;6356;1857;5957;77;322;1461;4710;1538;5032
314060;201603;1136;3488;900;3089;61;280;574;1922;635;2202
314070;201603;4046;12492;3195;10850;797;2897;690;2230;1487;5127
314080;201603;1905;5860;1340;4574;212;826;277;822;489;1648
314085;201603;1942;6489;1710;6163;432;1706;641;2323;1073;4029
314090;201603;3239;11122;2858;10373;670;2738;959;3574;1629;6312
314100;201603;3232;8257;2845;7751;179;393;2408;6811;2587;7204
314110;201603;3891;12357;3434;11433;628;2437;1421;4329;2049;6766
314120;201603;1028;2454;513;1633;105;367;125;395;230;762
314130;201603;716;2048;376;1266;48;179;71;219;119;398
314140;201603;4834;14992;4031;13430;876;3192;1726;5692;2602;8884
314150;201603;1547;4225;1244;3705;189;619;618;1807;807;2426
314160;201603;2518;6468;1981;5761;191;601;1188;3662;1379;4263
314170;201603;1058;3159;881;2796;105;354;469;1448;574;1802
314180;201603;5189;16566;4607;15623;1250;4556;1864;6441;3114;10997
314190;201603;710;2022;546;1761;121;484;201;572;322;1056
314200;201603;2906;9037;2531;8365;274;1063;1715;5557;1989;6620
314210;201603;1939;5650;1727;5299;215;797;1052;3088;1267;3885
314220;201603;1578;4890;1216;4206;367;1395;215;651;582;2046
314225;201603;1313;3802;1208;3668;87;268;994;3080;1081;3348
314230;201603;653;2122;604;2039;124;478;296;979;420;1457
314240;201603;1105;3340;928;3079;138;477;520;1822;658;2299
314250;201603;553;1636;428;1380;92;328;124;352;216;680
314260;201603;1006;3572;901;3340;216;884;271;967;487;1851
314270;201603;2845;9224;2383;8406;229;904;1557;5554;1786;6458
314280;201603;3063;8451;2098;6606;471;1738;652;1800;1123;3538
314290;201603;4694;12964;4046;11916;1002;3059;2078;6044;3080;9103
314300;201603;1480;4937;1270;4461;352;1294;365;1252;717;2546
314310;201603;5274;15612;4508;14257;1173;4032;1599;4865;2772;8897
314315;201603;800;3122;731;2984;71;357;497;2004;568;2361
314320;201603;2939;8179;2104;7030;539;1972;988;3397;1527;5369
314330;201603;53128;159456;45671;147648;12587;43772;14609;46666;27196;90438
314340;201603;2881;7779;1696;5520;341;1237;124;264;465;1501
314345;201603;1178;4009;1063;3822;243;913;612;2207;855;3120
314350;201603;1283;3724;1001;3271;309;1090;191;600;500;1690
314360;201603;663;2124;451;1627;97;396;85;315;182;711
314370;201603;539;1828;500;1774;120;467;317;1115;437;1582
314380;201603;1269;3785;887;3041;231;874;112;376;343;1250
314390;201603;13539;39038;10245;33011;2398;8347;2331;7012;4729;15359
314400;201603;4338;12807;3710;11930;1305;4390;1141;3841;2446;8231
314410;201603;2571;7950;2092;7031;602;2261;606;1995;1208;4256
314420;201603;747;2122;585;1888;27;143;399;1218;426;1361
314430;201603;6249;18699;5458;17232;1552;5335;1500;4825;3052;10160
314435;201603;1289;4136;1133;3866;110;487;719;2403;829;2890
314437;201603;1070;2793;883;2508;32;93;696;1987;728;2080
314440;201603;635;1836;497;1645;163;612;91;251;254;863
314450;201603;1572;4605;1324;4258;308;1150;586;1753;894;2903
314460;201603;4039;13506;3275;11874;760;3057;573;2006;1333;5063
314465;201603;2221;7001;2078;6753;116;530;1611;5092;1727;5622
314467;201603;972;2782;823;2528;61;180;586;1835;647;2015
314470;201603;2221;6903;1865;6193;344;1396;691;2059;1035;3455
314480;201603;5755;19047;4154;14897;579;2244;445;1424;1024;3668
314490;201603;887;2629;691;2236;162;575;298;914;460;1489
314500;201603;1937;5492;1445;4635;327;1107;470;1443;797;2550
314505;201603;1727;5076;1582;4878;225;775;1048;3260;1273;4035
314510;201603;1839;4952;1246;4127;383;1406;282;937;665;2343
314520;201603;2885;10371;2222;8809;450;2013;233;822;683;2835
314530;201603;5841;20674;5538;20148;1055;3690;3257;12401;4312;16091
314535;201603;2720;7584;2294;6988;211;734;1728;5249;1939;5983
314537;201603;1120;3534;898;3135;119;508;526;1790;645;2298
314540;201603;411;1227;342;1086;70;263;100;278;170;541
314545;201603;1361;4170;1175;3905;118;457;858;2877;976;3334
314550;201603;612;1664;455;1440;86;357;169;467;255;824
314560;201603;4314;14794;3665;13280;672;2751;1069;3675;1741;6426
314570;201603;296;869;228;742;59;204;96;300;155;504
314580;201603;510;1696;406;1484;94;404;54;187;148;591
314585;201603;823;2668;600;2189;132;552;139;488;271;1040
314587;201603;1920;5853;1649;5390;338;1062;794;2668;1132;3730
314590;201603;3103;10500;2322;8505;425;1781;256;839;681;2620
314600;201603;1721;5653;1286;4745;302;1215;159;531;461;1746
314610;201603;6757;22858;6075;21300;1317;5153;2489;8250;3806;13403
314620;201603;1563;4682;1410;4461;138;449;1045;3303;1183;3752
314625;201603;1418;4874;1309;4677;188;820;897;3066;1085;3886
314630;201603;4753;14152;4168;13252;284;1134;3051;9628;3335;10762
314640;201603;563;1534;442;1329;111;366;119;298;230;664
314650;201603;1054;2918;761;2445;107;412;261;753;368;1165
314655;201603;1563;4649;1173;3892;294;944;425;1445;719;2389
314660;201603;286;776;206;611;23;71;98;279;121;350
314670;201603;1603;4271;1156;3489;180;603;639;1894;819;2497
314675;201603;1759;5337;1517;4900;172;625;1023;3298;1195;3923
314690;201603;2317;7373;1907;6669;519;2067;419;1393;938;3460
314700;201603;8608;29331;6378;24369;1795;7720;791;2990;2586;10710
314710;201603;9015;27203;6352;21472;1154;4365;807;2488;1961;6853
314720;201603;2341;7686;1956;6859;475;1863;582;2054;1057;3917
314730;201603;2159;6483;1783;5925;477;1767;659;2102;1136;3869
314740;201603;2841;9059;2452;8313;417;1622;1127;3664;1544;5286
314750;201603;346;1078;277;919;44;181;123;377;167;558
314760;201603;1714;5684;1301;4698;201;848;255;797;456;1645
314770;201603;1100;3406;646;2169;76;299;96;241;172;540
314780;201603;265;720;200;630;51;193;88;267;139;460
314790;201603;10955;32478;8399;28050;3333;12463;602;1605;3935;14068
314795;201603;1645;4725;1393;4336;100;405;1008;3025;1108;3430
314800;201603;10805;31283;7676;25141;2062;7339;852;2654;2914;9993
314810;201603;11512;33367;8918;28879;2481;8830;1680;5455;4161;14285
314820;201603;907;2513;631;2054;160;569;205;661;365;1230
314830;201603;1616;5332;1423;5014;414;1621;573;2031;987;3652
314840;201603;915;3284;757;3054;126;653;453;1755;579;2408
314850;201603;1877;5410;1503;4749;198;781;962;2925;1160;3706
314860;201603;3183;10592;2835;9959;645;2505;1356;4678;2001;7183
314870;201603;5440;17070;4661;16035;473;2031;3346;11436;3819;13467
314875;201603;1718;5614;1643;5512;262;851;1257;4300;1519;5151
314880;201603;861;2322;712;2131;35;100;529;1674;564;1774
314890;201603;599;1792;415;1398;78;322;141;417;219;739
314900;201603;511;1534;420;1401;94;335;205;664;299;999
314910;201603;1672;5415;1348;4875;401;1645;409;1379;810;3024
314915;201603;2469;7810;2156;7291;173;720;1552;5122;1725;5842
314920;201603;552;1516;392;1278;37;142;209;629;246;771
314930;201603;4419;14789;3873;13644;1025;3852;899;3021;1924;6873
314940;201603;392;1145;360;1094;65;217;199;571;264;788
314950;201603;337;979;251;853;44;164;69;221;113;385
314960;201603;728;2251;567;1926;134;516;158;481;292;997
314970;201603;541;1851;452;1678;109;452;108;407;217;859
314980;201603;1443;4470;1207;4077;330;1262;87;269;417;1531
314990;201603;2514;7910;1937;6679;509;2027;354;1032;863;3059
314995;201603;1581;4807;1381;4504;144;573;881;2799;1025;3372
315000;201603;1042;2992;852;2686;95;335;530;1669;625;2004
315010;201603;440;1339;345;1152;84;352;109;311;193;663
315015;201603;2058;6275;1851;6034;255;860;1318;4531;1573;5391
315020;201603;804;2491;610;2076;95;382;256;807;351;1189
315030;201603;678;2031;546;1807;143;513;112;350;255;863
315040;201603;871;2683;820;2591;148;486;504;1576;652;2062
315050;201603;1342;3872;1089;3485;217;797;470;1487;687;2284
315053;201603;1034;3074;935;2908;151;590;432;1354;583;1944
315057;201603;1668;5723;1465;5400;259;952;824;3147;1083;4099
315060;201603;831;2700;603;2193;118;469;87;308;205;777
315070;201603;741;2228;630;2049;177;620;285;883;462;1503
315080;201603;2819;9312;2445;8494;624;2333;996;3414;1620;5747
315090;201603;776;2755;680;2531;162;678;169;605;331;1283
315100;201603;1158;3869;846;3148;193;824;198;682;391;1506
315110;201603;1387;4212;1187;3839;276;965;411;1302;687;2267
315120;201603;14143;33021;9732;27395;1468;4322;4825;14511;6293;18833
315130;201603;1372;4524;1248;4297;329;1278;388;1295;717;2573
315140;201603;2669;8427;2189;7468;474;1884;727;2254;1201;4138
315150;201603;4559;12336;3450;10503;651;2230;1256;3779;1907;6009
315160;201603;1203;3492;977;3049;207;685;389;1189;596;1874
315170;201603;1458;4363;1174;3872;259;931;369;1307;628;2238
315180;201603;16586;46540;9777;32279;1660;6184;1551;4719;3211;10903
315190;201603;1999;5185;1676;4693;438;1254;871;2453;1309;3707
315200;201603;3789;12698;3140;11315;963;3774;632;2255;1595;6029
315210;201603;7649;22512;6159;19471;1195;4234;2138;6451;3333;10685
315213;201603;1064;3406;995;3309;52;196;807;2686;859;2882
315217;201603;2381;8212;2002;7530;226;1044;1159;4296;1385;5340
315220;201603;9740;28022;8200;25578;2319;7182;3309;10975;5628;18157
315230;201603;2905;7672;2620;7341;176;247;2227;6738;2403;6985
315240;201603;3013;9219;2556;8503;678;2464;1197;3867;1875;6331
315250;201603;9830;29942;7595;25710;1820;6844;2105;7084;3925;13928
315260;201603;975;3035;681;2406;140;538;96;291;236;829
315270;201603;711;2291;554;1987;106;428;119;382;225;810
315280;201603;2990;8507;1925;6246;414;1446;296;887;710;2333
315290;201603;1329;3702;963;3111;291;1027;165;525;456;1552
315300;201603;521;1351;347;1135;143;488;126;424;269;912
315310;201603;1234;3931;1035;3580;136;568;646;2126;782;2694
315320;201603;775;2334;618;2136;111;449;279;970;390;1419
315330;201603;716;2588;465;1921;114;519;49;206;163;725
315340;201603;3505;10057;2864;9102;610;2115;1109;3427;1719;5542
315350;201603;1836;5037;1376;4366;270;916;749;2439;1019;3355
315360;201603;1649;5464;1364;4812;253;981;423;1404;676;2385
315370;201603;488;1479;422;1376;82;270;212;718;294;988
315380;201603;201;686;159;587;35;154;37;110;72;264
315390;201603;1300;4309;974;3541;218;901;163;544;381;1445
315400;201603;4165;12570;3419;11163;692;2483;1502;4829;2194;7312
315410;201603;2037;5359;1714;4911;183;628;1169;3373;1352;4001
315415;201603;979;3197;882;3054;310;1113;365;1318;675;2431
315420;201603;1212;3860;956;3357;220;816;134;445;354;1261
315430;201603;3601;9736;2722;8315;719;2442;577;1674;1296;4116
315440;201603;882;2741;763;2545;152;575;330;1048;482;1623
315445;201603;2063;5772;1633;5109;183;644;1130;3511;1313;4155
315450;201603;2366;7467;2109;7072;428;1350;1229;4296;1657;5646
315460;201603;32082;104368;28521;97167;9367;34047;4805;15723;14172;49770
315470;201603;467;1410;383;1254;48;192;197;627;245;819
315480;201603;1682;5112;1120;3829;191;729;167;575;358;1304
315490;201603;3011;8092;2323;7179;339;1203;899;2647;1238;3850
315500;201603;488;1441;330;1085;44;167;125;357;169;524
315510;201603;1378;3939;1164;3603;103;350;821;2486;924;2836
315520;201603;994;3010;822;2728;106;389;513;1646;619;2035
315530;201603;575;1947;479;1717;171;646;126;424;297;1070
315540;201603;1081;3380;893;3026;170;682;308;1035;478;1717
315550;201603;1694;4743;1320;4206;322;1133;399;1234;721;2367
315560;201603;6406;21370;5781;20482;569;2266;3888;13957;4457;16223
315570;201603;1915;6062;1778;5847;298;1122;952;3047;1250;4169
315580;201603;2462;7188;1931;6242;479;1774;497;1500;976;3274
315590;201603;865;2526;770;2385;130;438;402;1224;532;1662
315600;201603;2439;8649;1966;7741;351;1439;1003;4135;1354;5574
315610;201603;984;2806;797;2428;152;585;293;746;445;1331
315620;201603;310;1090;293;1061;90;307;156;603;246;910
315630;201603;843;2685;707;2412;172;604;163;521;335;1125
315640;201603;477;1368;389;1230;78;300;166;483;244;783
315645;201603;842;2548;690;2225;244;846;154;477;398;1323
315650;201603;1812;5030;1443;4504;83;353;1058;3296;1141;3649
315660;201603;2508;6588;2069;5905;322;912;1294;3691;1616;4603
315670;201603;10290;33856;9177;31734;2553;9491;3162;10743;5715;20234
315680;201603;2993;9935;2343;8622;757;2952;489;1791;1246;4743
315690;201603;3325;9402;2314;7627;559;2032;395;1388;954;3420
315700;201603;7126;22199;6028;20046;1047;3877;2739;8737;3786;12614
315710;201603;1771;5136;1416;4575;109;457;899;2817;1008;3274
315720;201603;3564;11202;3160;10475;415;1641;1743;5511;2158;7152
315725;201603;1426;4531;1282;4310;269;943;791;2712;1060;3655
315727;201603;580;1802;481;1600;98;369;172;542;270;911
315730;201603;779;2429;715;2301;107;395;398;1249;505;1644
315733;201603;972;2916;863;2727;260;895;255;748;515;1643
315737;201603;1232;3778;962;3298;69;311;605;2114;674;2425
315740;201603;984;3021;823;2703;157;623;404;1228;561;1851
315750;201603;1096;3403;1002;3234;59;234;732;2347;791;2581
315760;201603;1007;2702;968;2653;18;68;894;2426;912;2494
315765;201603;1427;4454;1278;4257;60;233;1043;3534;1103;3767
315770;201603;1371;4415;1182;4081;313;1183;280;972;593;2155
315780;201603;21297;69392;19249;65021;4692;17018;5685;18987;10377;36005
315790;201603;3544;11733;3103;10852;295;983;2073;7474;2368;8457
315800;201603;1436;5552;1147;4721;256;1149;171;677;427;1826
315810;201603;1339;3602;1132;3288;159;461;726;2072;885;2533
315820;201603;2424;8174;2116;7635;680;2542;817;3056;1497;5598
315830;201603;1152;3861;980;3504;124;539;278;894;402;1433
315840;201603;834;2201;594;1786;96;327;167;461;263;788
315850;201603;982;3495;955;3446;231;915;503;1746;734;2661
315860;201603;509;1746;384;1481;89;411;66;225;155;636
315870;201603;449;1324;367;1194;92;329;149;458;241;787
315880;201603;1195;3069;946;2758;211;761;309;824;520;1585
315890;201603;1455;4941;1296;4681;468;1818;497;1769;965;3587
315895;201603;5106;15894;4418;14383;971;3472;1481;4531;2452;8003
315900;201603;721;2155;690;2102;68;277;539;1548;607;1825
315910;201603;494;1664;459;1605;148;584;251;833;399;1417
315920;201603;1557;4272;911;2923;182;644;151;401;333;1045
315930;201603;1050;2848;790;2395;197;657;194;573;391;1230
315935;201603;928;3077;833;2877;230;879;203;667;433;1546
315940;201603;613;1942;531;1775;121;468;238;761;359;1229
315950;201603;1166;3578;1047;3358;232;704;608;2017;840;2721
315960;201603;3428;10773;2370;8651;825;3480;106;241;931;3721
315970;201603;736;1999;565;1770;41;111;401;1325;442;1436
315980;201603;3939;9596;2432;7097;604;1988;550;1371;1154;3359
315990;201603;3937;11380;3257;10256;554;2084;1603;4904;2157;6988
316000;201603;551;1652;468;1538;140;566;176;544;316;1110
316010;201603;607;2000;487;1766;70;297;200;658;270;955
316020;201603;1027;3257;896;3051;116;455;586;1943;702;2398
316030;201603;3094;9088;2295;7647;200;775;1359;4632;1559;5407
316040;201603;3423;10778;2602;9074;399;1615;455;1325;854;2940
316045;201603;2029;6326;1865;6053;257;809;1273;4286;1530;5095
316050;201603;351;1099;280;987;54;215;123;402;177;617
316060;201603;722;2173;577;1966;79;351;331;1049;410;1400
316070;201603;5994;18780;5182;17002;1150;4219;2022;6320;3172;10539
316080;201603;721;2637;639;2440;146;633;70;269;216;902
316090;201603;572;1693;385;1297;77;293;86;268;163;561
316095;201603;1419;4506;1223;4161;187;648;753;2574;940;3222
316100;201603;2726;8989;2074;7381;494;1972;393;1280;887;3252
316105;201603;930;2654;703;2276;177;597;260;871;437;1468
316110;201603;12063;40990;10728;38731;1290;5023;6987;25984;8277;31007
316120;201603;1103;3576;896;3069;209;756;214;636;423;1392
316130;201603;1468;3312;916;2554;131;420;382;1005;513;1425
316140;201603;905;2661;721;2378;100;333;401;1359;501;1692
316150;201603;1481;4044;1292;3717;191;639;754;2155;945;2794
316160;201603;1232;3629;951;3100;173;627;395;1270;568;1897
316165;201603;909;2422;760;2211;146;488;397;1150;543;1638
316170;201603;1335;3847;1004;3291;160;603;413;1235;573;1838
316180;201603;1344;4190;949;3321;193;768;163;488;356;1256
316190;201603;2763;8586;1470;5206;252;882;204;632;456;1514
316200;201603;3787;11991;2935;10311;626;2513;733;2521;1359;5034
316210;201603;4560;14616;3879;13317;1466;5328;521;1821;1987;7149
316220;201603;788;2433;565;2001;108;437;69;257;177;694
316225;201603;1172;3241;992;2962;129;419;612;1780;741;2199
316230;201603;407;1159;333;1033;51;178;156;522;207;700
316240;201603;6527;19937;5698;18836;623;2066;4133;13824;4756;15890
316245;201603;3189;10953;2949;10564;204;1006;2298;8017;2502;9023
316250;201603;10482;30181;8187;25762;2060;7078;1995;5993;4055;13071
316255;201603;2498;7561;2189;7187;394;1404;1416;4682;1810;6086
316257;201603;1329;3669;997;3074;166;588;356;1032;522;1620
316260;201603;1764;4987;1396;4439;82;302;795;2693;877;2995
316265;201603;1319;3714;976;3050;107;398;553;1684;660;2082
316270;201603;3931;13118;3615;12488;924;3456;1395;4700;2319;8156
316280;201603;3157;10232;2869;9692;441;1679;1587;5270;2028;6949
316290;201603;3274;10241;2782;9308;527;2084;1105;3548;1632;5632
316292;201603;3275;10390;2910;9805;564;2121;1608;5199;2172;7320
316294;201603;828;2653;615;2206;115;494;42;150;157;644
316295;201603;1737;5750;1621;5525;212;895;1031;3385;1243;4280
316300;201603;991;3067;841;2822;66;245;543;1852;609;2097
316310;201603;697;2005;471;1599;85;341;128;405;213;746
316320;201603;602;1902;483;1686;79;340;92;289;171;629
316330;201603;907;2825;712;2379;76;285;442;1447;518;1732
316340;201603;924;2978;754;2626;167;698;325;1051;492;1749
316350;201603;1291;4119;1156;3900;190;671;658;2276;848;2947
316360;201603;724;1919;572;1696;68;207;400;1203;468;1410
316370;201603;4387;14165;3798;12996;1042;3898;538;1841;1580;5739
316380;201603;1586;4192;1258;3737;79;269;885;2655;964;2924
316390;201603;879;2543;739;2328;183;625;293;952;476;1577
316400;201603;1272;3912;980;3400;219;818;363;1225;582;2043
316410;201603;1032;3432;955;3317;190;695;586;2051;776;2746
316420;201603;1867;6053;1657;5776;136;594;1166;3944;1302;4538
316430;201603;919;2820;670;2307;157;592;139;434;296;1026
316440;201603;658;2142;543;1971;192;800;102;378;294;1178
316443;201603;675;1996;556;1785;122;448;209;633;331;1081
316447;201603;1546;4654;1410;4475;93;313;1195;3818;1288;4131
316450;201603;2078;7007;1773;6426;220;890;1173;4271;1393;5161
316460;201603;703;2188;635;2067;171;590;314;1001;485;1591
316470;201603;7132;22882;5698;19895;1426;5735;1438;4854;2864;10589
316480;201603;180;605;159;561;30;112;45;149;75;261
316490;201603;297;927;246;806;53;178;94;286;147;464
316500;201603;1138;4008;785;2966;140;566;35;125;175;691
316510;201603;749;2769;669;2601;231;965;156;594;387;1559
316520;201603;1058;3200;856;2885;155;583;273;815;428;1398
316530;201603;1017;3303;862;3008;187;802;282;816;469;1618
316540;201603;859;2725;766;2575;109;458;240;754;349;1212
316550;201603;1152;3863;1078;3743;213;851;641;2223;854;3074
316553;201603;1825;6390;1443;5458;392;1676;297;1087;689;2763
316555;201603;2748;9590;2450;9221;173;762;1861;7081;2034;7843
316556;201603;608;1577;481;1380;48;163;314;857;362;1020
316557;201603;760;2730;721;2667;272;1068;173;570;445;1638
316560;201603;307;1083;261;983;62;284;50;168;112;452
316570;201603;1232;3912;1081;3628;131;461;534;1820;665;2281
316580;201603;291;808;196;621;43;160;46;136;89;296
316590;201603;1438;3912;1030;3230;260;860;418;1232;678;2092
316600;201603;1038;3362;922;3134;261;958;324;1076;585;2034
316610;201603;567;2056;497;1914;98;440;300;1119;398;1559
316620;201603;2113;6413;1804;5896;274;1071;1061;3394;1335;4465
316630;201603;1394;4652;1202;4243;478;1775;289;1050;767;2825
316640;201603;176;555;157;518;32;136;67;185;99;321
316650;201603;881;3213;782;3053;110;431;487;1990;597;2421
316660;201603;189;491;91;284;7;31;17;40;24;71
316670;201603;1841;5263;1505;4688;585;1956;269;795;854;2751
316680;201603;1886;5110;1517;4603;181;587;1051;3202;1232;3789
316690;201603;1130;3829;1008;3552;282;1123;293;1003;575;2126
316695;201603;1074;3369;928;3089;124;441;539;1783;663;2224
316700;201603;348;1060;313;1004;43;182;192;557;235;739
316710;201603;2871;10688;2465;9806;874;3652;603;2561;1477;6213
316720;201603;15538;49587;12783;43750;3436;12487;2564;8522;6000;21009
316730;201603;354;1096;303;996;74;271;126;380;200;651
316740;201603;636;2131;577;2029;104;433;315;1103;419;1536
316750;201603;390;1312;331;1181;49;213;113;361;162;574
316760;201603;3346;11122;2891;10513;1540;5800;749;2807;2289;8607
316770;201603;1240;3531;1127;3384;96;365;892;2653;988;3018
316780;201603;565;1865;501;1742;139;562;85;254;224;816
316790;201603;844;2419;632;2062;154;543;176;579;330;1122
316800;201603;5095;16749;4516;15627;832;3261;2248;7339;3080;10600
316805;201603;778;2013;750;1975;58;157;638;1742;696;1899
316810;201603;604;1836;504;1641;137;502;191;566;328;1068
316820;201603;385;1003;218;718;35;135;30;96;65;231
316830;201603;557;1913;530;1864;164;633;209;719;373;1352
316840;201603;2775;8495;2440;7871;539;2024;1049;3188;1588;5212
316850;201603;1991;5850;1659;5299;242;868;910;2890;1152;3758
316860;201603;17146;54086;14689;49580;3332;12926;5746;18547;9078;31473
316870;201603;5807;18716;4727;16223;1320;4972;677;2245;1997;7217
316880;201603;835;2547;722;2354;208;803;224;702;432;1505
316890;201603;1231;3034;990;2727;283;920;534;1373;817;2293
316900;201603;2499;7458;1983;6410;433;1566;582;1678;1015;3244
316905;201603;445;1488;384;1349;133;493;118;416;251;909
316910;201603;790;2491;573;2063;155;597;98;370;253;967
316920;201603;1555;4241;1133;3674;316;1166;372;1160;688;2326
316930;201603;8231;27782;6533;24106;1375;5551;752;2550;2127;8101
316935;201603;4893;14308;3299;11145;830;3093;562;1848;1392;4941
316940;201603;6839;22213;5619;19668;1238;4585;1128;3828;2366;8413
316950;201603;1488;4180;1263;3863;118;429;884;2658;1002;3087
316960;201603;4697;11870;3702;10508;681;2105;2010;5637;2691;7742
316970;201603;3174;10066;2993;9768;650;2465;1174;3533;1824;5998
316980;201603;927;2840;673;2345;206;797;99;336;305;1133
316990;201603;9563;30425;8122;27161;2431;8851;641;2000;3072;10851
317000;201603;2731;9299;2624;9181;342;1094;1907;7524;2249;8618
317005;201603;2505;7746;2221;7297;442;1470;1231;4095;1673;5565
317010;201603;29921;74232;18562;56622;4328;14911;3362;10882;7690;25793
317020;201603;59038;161532;35800;114788;6936;24474;6682;19824;13618;44298
317030;201603;695;2050;582;1874;63;263;344;1079;407;1342
317040;201603;10080;29174;8094;25739;2025;6936;2866;9116;4891;16052
317043;201603;699;1928;603;1807;84;245;378;1148;462;1393
317047;201603;1111;2950;816;2470;105;354;399;1208;504;1562
317050;201603;1469;5015;1148;4262;225;891;403;1408;628;2299
317052;201603;2281;7374;2094;7084;166;656;1526;5113;1692;5769
317057;201603;1649;4624;1255;3930;113;455;735;2221;848;2676
317060;201603;406;1182;273;894;57;209;72;206;129;415
317065;201603;1241;4014;1124;3828;110;492;818;2724;928;3216
317070;201603;9495;29381;6579;22854;1324;5187;809;2730;2133;7917
317075;201603;1061;3209;843;2743;200;693;172;538;372;1231
317080;201603;6036;16545;5117;15008;1504;4566;1472;4278;2976;8844
317090;201603;4725;15774;4394;15257;554;1941;3028;10729;3582;12670
317100;201603;2883;7910;2163;6710;666;2229;677;2028;1343;4257
317103;201603;1959;6708;1669;6165;253;1192;812;2890;1065;4082
317107;201603;1294;3978;1124;3637;167;654;693;2110;860;2764
317110;201603;634;1580;362;1114;67;253;121;379;188;632
317115;201603;1114;3495;960;3180;109;364;664;2232;773;2596
317120;201603;10312;34142;8409;29701;1903;7444;2893;9996;4796;17440
317130;201603;7239;21594;6078;19497;1259;4517;2464;7819;3723;12336
317140;201603;554;1773;511;1709;72;257;329;1119;401;1376
317150;201603;956;2648;826;2497;88;318;604;1775;692;2093
317160;201603;3450;9096;2617;7996;202;653;1808;5519;2010;6172
317170;201603;1888;5123;1492;4458;112;424;756;2097;868;2521
317180;201603;1756;5938;1429;5237;378;1488;360;1335;738;2823
317190;201603;1349;3877;1077;3487;116;412;717;2308;833;2720
317200;201603;4374;13660;3774;12461;973;3574;1135;3618;2108;7192
317210;201603;1021;3058;848;2823;148;614;469;1520;617;2134
317220;201603;278;970;265;951;80;311;107;366;187;677
320010;201603;4837;15150;4207;13866;749;2632;2143;6985;2892;9617
320013;201603;1816;5570;1354;4618;218;772;551;1963;769;2735
320016;201603;3019;8607;2619;8015;342;1012;1804;5582;2146;6594
320020;201603;3755;11706;3199;10557;902;3209;978;3252;1880;6461
320030;201603;1660;5294;1331;4607;398;1460;387;1299;785;2759
320035;201603;1757;5207;1530;4861;510;1786;502;1491;1012;3277
320040;201603;3228;10370;2663;9236;567;2138;789;2680;1356;4818
320050;201603;1719;4658;1478;4220;335;1019;632;1714;967;2733
320060;201603;11468;36192;8841;30251;2022;7529;2208;7194;4230;14723
320070;201603;1388;4479;1126;3898;253;969;270;835;523;1804
320080;201603;5634;16391;4369;13886;1042;3369;1214;4116;2256;7485
320090;201603;7964;23218;6323;19920;1700;5689;2123;6444;3823;12133
320100;201603;2744;8509;2204;7407;619;2167;700;2350;1319;4517
320110;201603;1240;3706;1085;3401;266;840;313;988;579;1828
320115;201603;1731;6171;1562;5863;851;3324;327;1300;1178;4624
320120;201603;15754;47672;12286;41002;3006;11008;3253;10916;6259;21924
320130;201603;34847;112219;31673;105897;6484;24155;14323;46352;20807;70507
320140;201603;3587;11356;2580;9070;624;2425;278;989;902;3414
320150;201603;15756;43656;11545;35707;2729;9128;1557;4645;4286;13773
320160;201603;4808;15223;4181;13937;1029;3856;1334;4083;2363;7939
320170;201603;1689;5393;1373;4705;362;1304;481;1649;843;2953
320180;201603;740;2476;656;2325;257;941;147;554;404;1495
320190;201603;3612;12387;2872;10587;788;3041;465;1719;1253;4760
320200;201603;1010;3114;849;2844;214;782;267;936;481;1718
320210;201603;4656;13130;3967;11827;829;2784;1783;4921;2612;7705
320220;201603;2410;7474;1978;6620;514;1860;710;2416;1224;4276
320225;201603;1328;4486;1066;3866;361;1414;144;527;505;1941
320230;201603;4091;13277;3546;12345;1138;4222;1207;4306;2345;8528
320240;201603;12062;35412;9598;30961;2422;8540;2335;7503;4757;16043
320245;201603;3388;11555;3127;10925;1029;3827;740;2499;1769;6326
320250;201603;1786;5455;1273;4284;333;1298;194;548;527;1846
320255;201603;1710;5767;1498;5402;619;2402;470;1814;1089;4216
320260;201603;1041;3214;810;2690;203;727;200;583;403;1310
320265;201603;2316;7293;2017;6865;470;1665;1093;3856;1563;5521
320270;201603;2642;7858;1961;6542;435;1567;756;2561;1191;4128
320280;201603;6588;20049;5753;18376;1356;4776;1881;5550;3237;10326
320290;201603;1393;4559;1034;3695;316;1198;136;499;452;1697
320300;201603;4167;13910;3702;12886;1208;4471;773;2678;1981;7149
320305;201603;4349;14039;3776;12766;898;3301;1510;4899;2408;8200
320310;201603;1919;5740;1635;5182;421;1395;563;1738;984;3133
320313;201603;2182;6299;1515;4784;315;1183;256;700;571;1883
320316;201603;1716;5162;1397;4507;436;1486;392;1233;828;2719
320320;201603;19602;59583;15653;52337;4177;15367;4808;15683;8985;31050
320330;201603;2964;8743;2508;7987;644;2019;1098;3736;1742;5755
320332;201603;4968;16386;4344;15205;1544;5742;1201;4224;2745;9966
320334;201603;1856;5885;1305;4702;354;1443;222;751;576;2194
320335;201603;2347;6908;1505;4972;373;1363;168;466;541;1829
320340;201603;5850;15754;4855;14124;1060;3335;1998;5918;3058;9253
320350;201603;5034;13511;3801;11270;789;2495;1513;4446;2302;6941
320360;201603;1703;4506;1254;3641;217;672;462;1268;679;1940
320370;201603;2978;9679;2412;8411;683;2450;702;2428;1385;4878
320380;201603;2190;6458;1925;5991;371;1268;1052;3183;1423;4451
320390;201603;7263;21884;5924;19081;1696;5907;1482;4550;3178;10457
320400;201603;3489;10749;3110;10073;901;3237;1053;3194;1954;6431
320405;201603;4002;11807;3508;11016;835;2805;1719;5277;2554;8082
320410;201603;5473;14445;4028;12536;1006;3369;1684;5280;2690;8649
320420;201603;2078;6307;1625;5485;475;1796;358;1203;833;2999
320425;201603;1885;5099;1590;4604;200;633;955;2705;1155;3338
320430;201603;2372;6618;2053;5988;417;1297;1039;2912;1456;4209
320435;201603;2796;9122;2310;8132;1081;3954;570;2141;1651;6095
320440;201603;1032;3426;911;3115;194;752;294;944;488;1696
320450;201603;1968;6162;1605;5448;435;1631;620;2016;1055;3647
320455;201603;4055;13304;3003;10772;852;3295;613;2128;1465;5423
320460;201603;2636;8474;2042;7151;522;1957;499;1704;1021;3661
320465;201603;1584;4941;1205;4098;220;815;515;1740;735;2555
320470;201603;4290;12927;2950;9897;788;2938;418;1295;1206;4233
320480;201603;1765;5495;1557;5103;418;1507;510;1615;928;3122
320490;201603;15611;47782;13084;43194;3825;13839;3519;11649;7344;25488
320495;201603;1266;3680;843;2806;265;928;94;336;359;1264
320500;201603;46080;138774;40108;128079;9469;32714;17851;55741;27320;88455
320501;201603;4220;13191;3590;12258;1202;4607;1142;3751;2344;8358
320503;201603;1843;6243;1508;5543;588;2358;357;1181;945;3539
320506;201603;3920;12130;2803;9467;811;2986;178;513;989;3499
320510;201603;7960;24900;6871;22814;1645;5904;2972;9770;4617;15674
320515;201603;1859;5359;1529;4646;391;1234;259;733;650;1967
320517;201603;2136;6894;1753;6144;582;2246;326;1078;908;3324
320520;201603;37020;110488;30279;98196;7694;27483;9931;31782;17625;59265
320530;201603;26520;80369;22079;71846;4432;16623;10030;30601;14462;47224
330010;201603;19917;60561;17940;56782;3817;13055;9219;28735;13036;41790
330015;201603;1613;4501;1400;4105;228;778;600;1704;828;2482
330020;201603;16970;49755;15501;47386;2985;10013;8791;26242;11776;36255
330022;201603;1828;5482;1538;5002;301;1109;758;2389;1059;3498
330023;201603;3112;9611;2732;9002;760;2716;813;2573;1573;5289
330025;201603;4414;11895;3497;10398;790;2554;1747;5154;2537;7708
330030;201603;7815;25863;6906;24082;1412;5437;3238;10828;4650;16265
330040;201603;11842;34925;10451;32395;2320;7656;4997;15031;7317;22687
330045;201603;68735;189232;60128;177164;7802;24704;39838;115620;47640;140324
330050;201603;2380;7451;2111;6917;606;2196;622;1892;1228;4088
330060;201603;5636;16289;4901;15230;1172;4106;2413;7405;3585;11511
330070;201603;21489;64956;19187;61049;4192;14297;8454;26862;12646;41159
330080;201603;7796;22321;7242;21477;857;2565;4913;14664;5770;17229
330090;201603;2622;7118;2370;6723;434;1351;1273;3510;1707;4861
330093;201603;2001;5922;1674;5342;388;1289;568;1874;956;3163
330095;201603;973;3277;846;2994;222;908;221;711;443;1619
330100;201603;55559;176106;50692;168168;8752;32742;26882;88903;35634;121645
330110;201603;2321;7285;2064;6844;518;1835;569;1863;1087;3698
330115;201603;1899;5438;1668;5094;300;1033;853;2506;1153;3539
330120;201603;2533;7078;2240;6639;479;1589;1165;3326;1644;4915
330130;201603;3493;11222;3095;10526;799;2934;1328;4452;2127;7386
330140;201603;2994;9282;2726;8883;614;2208;1380;4466;1994;6674
330150;201603;2289;6734;1806;5769;405;1398;385;1246;790;2644
330160;201603;1148;3689;1008;3451;284;1116;447;1431;731;2547
330170;201603;98888;296243;90315;282927;16750;55633;51074;159028;67824;214661
330180;201603;1989;5822;1653;5207;146;571;986;2909;1132;3480
330185;201603;7823;24398;6786;22398;1509;5415;3332;10725;4841;16140
330187;201603;3751;10749;3225;9872;460;1585;2105;6336;2565;7921
330190;201603;24941;71035;23210;68312;4409;13617;14664;42905;19073;56522
330200;201603;13779;43351;12267;40776;3149;10838;5730;19311;8879;30149
330205;201603;2145;5872;1867;5406;335;1061;1007;2826;1342;3887
330210;201603;3522;9726;2863;8462;832;2578;678;1964;1510;4542
330220;201603;10052;30652;8782;27976;2284;7889;2179;6384;4463;14273
330225;201603;3775;11703;3386;10999;421;1624;2056;6578;2477;8202
330227;201603;16934;48650;15258;46212;3879;12023;7744;23915;11623;35938
330230;201603;1339;4004;1215;3806;291;1047;518;1522;809;2569
330240;201603;16828;51683;14425;47162;4646;16479;3182;9926;7828;26405
330245;201603;1269;3922;1001;3433;253;957;174;564;427;1521
330250;201603;35568;103827;32471;98783;9787;30029;12389;39089;22176;69118
330260;201603;3625;11409;3176;10519;616;2289;1284;4012;1900;6301
330270;201603;18348;43077;12456;35073;2975;9309;4069;11536;7044;20845
330280;201603;2163;6423;1804;5722;311;1092;820;2415;1131;3507
330285;201603;17831;51179;16145;48728;2763;9023;9771;29222;12534;38245
330290;201603;3355;9505;2977;8944;487;1660;1722;4957;2209;6617
330300;201603;3239;10500;2952;9968;435;1703;1729;5653;2164;7356
330310;201603;2286;6520;1968;5990;302;991;1093;3264;1395;4255
330320;201603;12897;38763;12083;37514;1794;6066;8577;26394;10371;32460
330330;201603;26927;74449;23595;69234;3904;12881;14106;40008;18010;52889
330340;201603;14232;41457;11276;36087;2778;9486;3242;10281;6020;19767
330350;201603;84209;250453;77493;240734;11539;37739;52764;164161;64303;201900
330360;201603;5701;17055;5489;16763;340;1178;4696;14263;5036;15441
330370;201603;3343;11834;3045;11188;1044;3982;969;3600;2013;7582
330380;201603;4861;15744;4128;14282;904;3470;1556;5227;2460;8697
330385;201603;3914;13501;3590;12864;1122;4324;1245;4461;2367;8785
330390;201603;22691;73970;20062;68739;4773;17893;8287;27747;13060;45640
330395;201603;2934;8613;2653;8151;250;915;1756;5263;2006;6178
330400;201603;2461;7796;2223;7394;308;1256;1300;3971;1608;5227
330410;201603;2795;8605;2328;7722;504;1842;1002;3215;1506;5057
330411;201603;2286;7123;1990;6505;234;906;1122;3505;1356;4411
330412;201603;1318;4455;1103;4026;235;994;452;1533;687;2527
330414;201603;23849;67548;21090;63697;4275;12853;12077;36939;16352;49792
330415;201603;3493;10675;3049;9906;801;2695;1067;3504;1868;6199
330420;201603;9515;27479;6571;22043;1426;5228;1077;3489;2503;8717
330430;201603;7216;21429;6425;19965;1337;4460;2964;9001;4301;13461
330440;201603;1620;5409;1410;4971;431;1683;273;854;704;2537
330450;201603;1319;4386;1178;4132;270;1144;565;1899;835;3043
330452;201603;13440;39296;10672;33977;2712;9390;3649;11238;6361;20628
330455;201603;474043;1309946;393797;1184199;90142;288382;186079;554195;276221;842577
330460;201603;1166;3796;1039;3572;221;871;450;1496;671;2367
330470;201603;4337;13123;3865;12259;889;3087;1677;5167;2566;8254
330475;201603;7746;24012;6825;22476;2015;7231;2406;7746;4421;14977
330480;201603;5726;16876;5261;16212;994;3346;3015;9130;4009;12476
330490;201603;104145;276852;94318;262520;9534;27603;69025;192443;78559;220046
330500;201603;5501;16917;5242;16447;677;2327;3529;10926;4206;13253
330510;201603;36539;111802;32919;106169;10295;33707;13797;45597;24092;79304
330513;201603;1471;4415;1336;4173;392;1225;512;1649;904;2874
330515;201603;2999;9258;2641;8576;795;2615;763;2470;1558;5085
330520;201603;11261;33770;10061;31685;2100;6931;4555;14245;6655;21176
330530;201603;1480;4415;1316;4116;328;1112;502;1526;830;2638
330540;201603;2856;8455;2395;7639;561;1917;948;2940;1509;4857
330550;201603;7774;25994;6883;24314;2934;10792;990;3529;3924;14321
330555;201603;9977;29308;8852;27718;1685;5374;5175;16675;6860;22049
330560;201603;4193;12607;3806;11894;736;2580;1937;5790;2673;8370
330570;201603;3356;9823;2884;9036;743;2475;1354;4231;2097;6706
330575;201603;5041;14530;4520;13601;716;2420;2794;8059;3510;10479
330580;201603;13755;43251;11734;39149;3035;10659;4437;14869;7472;25528
330590;201603;1588;4864;1471;4675;291;993;884;2778;1175;3771
330600;201603;10711;30782;8673;27406;1225;4357;4465;13877;5690;18234
330610;201603;8726;27340;7933;25938;1363;5060;4520;14437;5883;19497
330615;201603;1647;5777;1494;5459;657;2577;280;1043;937;3620
330620;201603;3394;11786;3068;11164;1078;4259;694;2584;1772;6843
330630;201603;22407;65739;18495;58885;3157;11473;9487;29024;12644;40497
350010;201603;1961;5819;1308;4505;298;1111;159;502;457;1613
350020;201603;451;1223;315;958;48;154;151;434;199;588
350030;201603;4238;13325;3335;11515;1172;4407;666;2194;1838;6601
350040;201603;442;1531;336;1292;73;302;80;289;153;591
350050;201603;877;2670;714;2375;172;659;239;711;411;1370
350055;201603;629;1874;535;1722;112;368;288;921;400;1289
350060;201603;111;322;87;285;24;92;37;110;61;202
350070;201603;3547;10692;2323;8109;456;1744;393;1199;849;2943
350075;201603;439;1456;350;1308;132;502;74;270;206;772
350080;201603;563;1609;393;1270;78;281;137;427;215;708
350090;201603;583;1508;380;1151;96;274;128;402;224;676
350100;201603;1753;5523;1277;4543;278;1096;330;1105;608;2201
350110;201603;448;1345;345;1131;41;157;167;533;208;690
350115;201603;1194;3664;1072;3419;182;672;584;1718;766;2390
350120;201603;581;1518;308;947;63;200;38;117;101;317
350130;201603;3131;9352;2770;8642;388;1398;1481;4365;1869;5763
350140;201603;558;1803;474;1666;74;307;224;770;298;1077
350150;201603;379;1276;332;1177;115;433;76;269;191;702
350160;201603;7541;21998;5192;17349;1197;4504;1821;5559;3018;10063
350170;201603;1622;5576;1398;5022;353;1342;285;968;638;2310
350180;201603;1004;2809;654;2017;99;308;287;887;386;1195
350190;201603;2901;9060;2412;8087;511;2039;1104;3278;1615;5317
350200;201603;341;1098;295;1015;38;138;160;556;198;694
350210;201603;4729;12628;3520;10658;979;3252;1313;3864;2292;7116
350220;201603;2501;7965;2176;7286;529;2089;781;2361;1310;4450
350230;201603;611;2018;556;1925;128;495;227;759;355;1254
350240;201603;451;1407;381;1234;76;251;203;648;279;899
350250;201603;1945;7083;1822;6844;640;2596;596;2194;1236;4790
350260;201603;937;2520;657;2015;110;366;278;808;388;1174
350270;201603;4924;15092;4160;13461;775;2664;1656;5163;2431;7827
350275;201603;1850;6125;1680;5827;469;1748;608;2009;1077;3757
350280;201603;21522;52775;13410;39176;2796;8756;2715;7957;5511;16713
350290;201603;1685;5439;1330;4694;275;1081;342;1141;617;2222
350300;201603;390;1129;316;978;74;225;164;504;238;729
350310;201603;800;2662;705;2460;97;393;299;1008;396;1401
350315;201603;498;1573;398;1356;60;248;97;294;157;542
350320;201603;10503;32645;9282;30357;2549;8864;1333;4536;3882;13400
350330;201603;13601;38099;9191;28094;1833;5557;2854;8339;4687;13896
350335;201603;327;1064;286;977;23;68;201;711;224;779
350340;201603;1074;3208;756;2570;138;532;209;696;347;1228
350350;201603;706;2207;608;2046;115;437;217;713;332;1150
350360;201603;766;2607;659;2379;180;685;237;890;417;1575
350370;201603;595;1782;443;1451;82;295;85;255;167;550
350380;201603;4021;11513;2697;9192;674;2554;612;1882;1286;4436
350390;201603;8508;26502;7594;24790;2254;7675;2728;8742;4982;16417
350395;201603;352;989;180;627;25;99;35;115;60;214
350400;201603;7582;21719;6137;19161;1387;4801;2335;7009;3722;11810
350410;201603;7892;26299;6143;22733;1588;6477;889;3164;2477;9641
350420;201603;521;1577;373;1308;68;288;23;79;91;367
350430;201603;670;2085;548;1863;117;447;245;792;362;1239
350440;201603;1182;3721;1059;3473;263;881;467;1519;730;2400
350450;201603;7308;22322;5806;19278;1322;4731;1286;4133;2608;8864
350460;201603;1332;3728;858;2773;162;579;241;719;403;1298
350470;201603;230;633;189;561;31;117;106;293;137;410
350480;201603;752;2280;531;1796;70;274;92;270;162;544
350490;201603;1768;5295;1526;4925;372;1309;568;1708;940;3017
350500;201603;542;1605;474;1492;106;372;231;705;337;1077
350510;201603;1017;3068;805;2627;135;522;319;956;454;1478
350520;201603;1295;4768;1017;4036;243;1063;161;638;404;1701
350530;201603;2253;6655;1878;5892;546;1760;548;1630;1094;3390
350535;201603;1229;3973;1154;3843;156;636;748;2383;904;3019
350540;201603;1725;4916;1365;4273;376;1222;425;1375;801;2597
350550;201603;10770;28690;7456;23251;1516;5316;2398;7108;3914;12424
350560;201603;3103;10306;2791;9635;399;1458;1480;5148;1879;6606
350570;201603;17250;57231;15479;53583;4481;16674;5440;17997;9921;34671
350580;201603;1574;4908;1137;3930;244;920;125;381;369;1301
350590;201603;3928;12182;3057;10438;785;2987;1016;3185;1801;6172
350600;201603;39774;97638;26463;75140;4235;12945;11271;30273;15506;43218
350610;201603;6829;19994;5452;17599;1138;4030;2272;7225;3410;11255
350620;201603;392;1115;294;965;57;223;126;388;183;611
350630;201603;1523;4506;1178;3864;243;950;355;1030;598;1980
350635;201603;5991;17860;4660;15519;1065;3841;1710;5646;2775;9487
350640;201603;704;2203;499;1715;87;336;95;303;182;639
350650;201603;7379;22374;4526;15573;1020;3913;481;1502;1501;5415
350660;201603;4351;12838;3660;11702;730;2567;1891;5895;2621;8462
350670;201603;1578;4899;1461;4686;293;968;827;2634;1120;3602
350680;201603;1020;3082;801;2654;170;632;315;1018;485;1650
350690;201603;815;2689;659;2381;144;562;189;662;333;1224
350700;201603;4072;12032;2720;9537;729;2765;594;1847;1323;4612
350710;201603;2518;7866;2236;7344;322;1175;1342;4344;1664;5519
350715;201603;763;2354;670;2173;212;718;220;664;432;1382
350720;201603;121;363;108;343;32;104;40;128;72;232
350730;201603;380;1423;368;1393;93;401;146;530;239;931
350740;201603;1791;5534;1325;4451;230;870;361;1090;591;1960
350745;201603;456;1433;287;978;45;163;123;378;168;541
350750;201603;9636;29059;7662;25230;1720;6207;1592;4838;3312;11045
350760;201603;12682;36908;10182;32479;2465;8669;3007;8787;5472;17456
350770;201603;687;1959;473;1551;63;236;226;720;289;956
350775;201603;543;1476;457;1348;60;220;256;739;316;959
350780;201603;1766;5425;1376;4648;378;1395;188;656;566;2051
350790;201603;1863;5757;1384;4818;318;1198;259;795;577;1993
350800;201603;2842;9469;2666;9178;413;1676;1660;5544;2073;7220
350810;201603;1951;5528;1623;5067;463;1521;614;1951;1077;3472
350820;201603;538;1459;399;1200;64;238;181;503;245;741
350830;201603;830;2577;561;1961;79;283;127;391;206;674
350840;201603;2332;8269;1926;7333;565;2292;350;1218;915;3510
350850;201603;5708;18978;4838;17085;1484;5516;1007;3489;2491;9005
350860;201603;3077;9562;2956;9389;218;882;2302;7228;2520;8110
350870;201603;2636;8360;2198;7668;520;2066;1223;4272;1743;6338
350880;201603;1191;3951;1000;3556;225;852;224;780;449;1632
350890;201603;606;1721;404;1284;54;195;88;211;142;406
350900;201603;3576;11600;2712;9631;689;2679;279;923;968;3602
350910;201603;791;2364;689;2157;219;732;256;763;475;1495
350920;201603;9787;28017;8797;26306;988;3288;6000;17284;6988;20572
350925;201603;4509;14014;3719;12436;887;3174;1258;3789;2145;6963
350930;201603;1551;4239;1235;3669;137;441;770;2208;907;2649
350940;201603;1715;5637;1565;5413;295;1192;880;2957;1175;4149
350945;201603;896;2820;770;2592;106;447;432;1398;538;1845
350950;201603;66759;201214;53915;174854;11984;42589;21147;65166;33131;107755
350960;201603;4405;14601;3774;13298;654;2611;2045;6871;2699;9482
350970;201603;4173;14350;3532;12837;1109;4390;633;2009;1742;6399
350980;201603;570;1868;514;1780;212;782;162;564;374;1346
350990;201603;1703;5782;1415;5245;423;1694;348;1279;771;2973
350995;201603;723;2490;693;2436;96;445;447;1478;543;1923
351000;201603;2960;8838;2469;7921;329;1186;1131;3443;1460;4629
351010;201603;326;921;204;667;48;172;64;211;112;383
351015;201603;790;2690;665;2454;141;594;297;1057;438;1651
351020;201603;7870;24592;6826;22978;1684;5948;3006;10279;4690;16227
351030;201603;1664;5908;1477;5458;327;1404;451;1527;778;2931
351040;201603;3204;9673;2930;9221;427;1522;1909;5796;2336;7318
351050;201603;13749;39119;9817;32196;2407;8651;2429;7929;4836;16580
351060;201603;33552;98414;27511;87554;5878;20422;12001;37204;17879;57626
351070;201603;1452;4082;979;3211;270;970;102;294;372;1264
351080;201603;2525;7294;1937;6555;480;1795;839;2737;1319;4532
351090;201603;352;1204;285;1062;57;244;48;179;105;423
351100;201603;2033;6218;1638;5397;452;1553;401;1375;853;2928
351110;201603;7016;17414;3874;12315;786;2875;773;2302;1559;5177
351120;201603;619;1791;497;1549;52;195;246;662;298;857
351130;201603;974;2713;529;1787;85;307;87;270;172;577
351140;201603;1634;5481;1349;4898;408;1587;298;1038;706;2625
351150;201603;1469;5147;1096;4174;183;750;165;546;348;1296
351160;201603;1206;4155;1062;3822;271;1088;327;1073;598;2161
351170;201603;1354;4295;1122;3795;197;723;472;1527;669;2250
351190;201603;759;2439;598;2022;100;345;150;504;250;849
351200;201603;1960;5795;1658;5234;300;1063;568;1632;868;2695
351210;201603;1032;3067;772;2533;163;588;256;767;419;1355
351220;201603;3101;10419;2829;9863;526;2027;1346;4599;1872;6626
351230;201603;1627;5098;1375;4631;258;1035;684;2202;942;3237
351240;201603;1040;3244;780;2691;215;800;196;602;411;1402
351250;201603;902;2604;594;1940;101;353;202;623;303;976
351260;201603;902;2648;787;2417;168;538;313;926;481;1464
351270;201603;310;1076;272;996;58;251;100;320;158;571
351280;201603;4671;13654;3558;11361;718;2500;1209;3653;1927;6153
351290;201603;944;2689;699;2222;161;518;271;857;432;1375
351300;201603;12172;39498;9153;33067;2132;8495;2582;9135;4714;17630
351310;201603;3000;9110;2429;8094;456;1742;1089;3358;1545;5100
351320;201603;847;2806;731;2554;146;584;220;685;366;1269
351330;201603;253;697;206;627;79;243;42;120;121;363
351340;201603;5548;18506;4820;17069;1359;5129;1715;6056;3074;11185
351350;201603;7265;23242;6252;21164;1723;6047;1938;6250;3661;12297
351360;201603;3994;12422;3650;11765;859;3050;1178;3482;2037;6532
351370;201603;2141;6584;1695;5660;345;1298;641;1955;986;3253
351380;201603;36302;106092;32803;99767;6440;21097;13852;41188;20292;62285
351385;201603;193;598;177;570;36;127;81;244;117;371
351390;201603;1096;3570;930;3239;240;975;336;1045;576;2020
351400;201603;838;2796;800;2710;297;1075;260;864;557;1939
351410;201603;2450;7338;2147;6805;337;1140;1247;3864;1584;5004
351420;201603;309;883;211;696;47;161;48;158;95;319
351430;201603;786;2468;734;2384;101;363;534;1719;635;2082
351440;201603;3246;9665;2510;8088;527;1740;376;1117;903;2857
351450;201603;1547;4346;1284;3953;318;1022;481;1558;799;2580
351460;201603;662;1987;566;1826;304;1003;127;405;431;1408
351470;201603;963;2891;854;2678;180;636;369;1107;549;1743
351480;201603;2647;8660;2446;8333;407;1757;1345;4347;1752;6104
351490;201603;1723;5651;1534;5256;179;757;896;2915;1075;3672
351492;201603;205;634;164;542;13;54;99;320;112;374
351495;201603;170;539;134;442;30;123;47;135;77;258
351500;201603;24027;68612;18574;58602;4620;16029;6870;20627;11490;36656
351510;201603;8442;25938;6911;22854;1591;5698;3162;10300;4753;15998
351512;201603;450;1300;345;1074;54;162;177;554;231;716
351515;201603;2175;6839;1557;5466;369;1411;375;1190;744;2601
351518;201603;2001;6221;1375;5061;329;1399;394;1320;723;2719
351519;201603;768;2253;565;1809;103;397;158;380;261;777
351520;201603;742;1989;372;1285;55;229;56;170;111;399
351530;201603;370;1130;268;884;42;135;68;189;110;324
351535;201603;2294;5886;1782;5139;155;525;1151;3205;1306;3730
351540;201603;1712;5155;1373;4511;436;1563;189;619;625;2182
351550;201603;4855;14228;3452;11279;671;2477;1186;3726;1857;6203
351560;201603;347;1118;302;1035;64;262;45;144;109;406
351565;201603;159;533;147;503;24;89;64;217;88;306
351570;201603;11512;34992;9664;31292;2093;7340;4936;15458;7029;22798
351580;201603;318;844;193;582;51;149;49;152;100;301
351590;201603;419;1101;284;852;29;97;123;349;152;446
351600;201603;1675;4650;1419;4213;201;669;755;2117;956;2786
351610;201603;651;1789;502;1535;60;223;226;617;286;840
351620;201603;17823;56688;13811;48592;2800;10996;3305;10386;6105;21382
351630;201603;18771;58969;16886;55947;3763;13258;9210;30241;12973;43499
351640;201603;11859;35337;9655;31371;1720;6104;5240;16691;6960;22795
351650;201603;438;1323;218;749;38;150;23;65;61;215
351660;201603;751;2405;563;1919;114;405;119;363;233;768
351670;201603;3764;11727;3110;10318;564;2094;1365;4245;1929;6339
351680;201603;606;1874;389;1370;71;251;64;228;135;479
351685;201603;363;1121;322;1048;86;264;148;498;234;762
351690;201603;1051;3136;759;2503;128;453;238;707;366;1160
351700;201603;1130;3308;971;3000;239;718;367;1128;606;1846
351710;201603;553;1817;469;1641;78;266;173;596;251;862
351720;201603;1555;4735;1073;3564;198;686;299;938;497;1624
351730;201603;1042;2985;846;2705;240;880;316;980;556;1860
351740;201603;3953;10770;3170;9234;648;2027;1132;3148;1780;5175
351750;201603;1078;3454;732;2659;167;660;165;580;332;1240
351760;201603;3479;10853;2857;9509;759;2722;909;2829;1668;5551
351770;201603;2098;6606;1795;6087;509;1830;744;2422;1253;4252
351780;201603;1476;4132;886;2841;140;481;211;662;351;1143
351790;201603;975;2854;854;2665;242;726;375;1227;617;1953
351800;201603;435;978;281;756;33;95;120;314;153;409
351810;201603;954;2728;839;2561;101;324;600;1830;701;2154
351820;201603;2356;7448;1803;6310;446;1642;163;544;609;2186
351830;201603;3766;11756;2884;9812;496;1892;1264;4114;1760;6006
351840;201603;6672;22134;5798;20402;1464;5577;1974;6757;3438;12334
351850;201603;1833;5059;1318;4154;191;751;619;1752;810;2503
351860;201603;3206;10252;2784;9377;743;2668;1033;3345;1776;6013
351870;201603;27596;82311;23244;74490;6557;22078;9255;29407;15812;51485
351880;201603;107000;335727;91222;303632;25953;91782;21987;70168;47940;161950
351885;201603;567;1956;517;1861;139;521;212;761;351;1282
351890;201603;606;1855;480;1607;109;406;80;231;189;637
351900;201603;1187;3616;998;3315;266;938;304;1008;570;1946
351905;201603;433;1356;354;1207;47;184;189;595;236;779
351907;201603;17183;50538;14218;45001;1674;6332;8593;26245;10267;32577
351910;201603;955;2994;806;2664;152;547;342;1099;494;1646
351920;201603;978;2672;854;2492;111;370;510;1451;621;1821
351925;201603;862;2689;731;2429;119;415;323;1033;442;1448
351930;201603;2515;8144;2388;7907;449;1866;1603;4946;2052;6812
351940;201603;939;2833;789;2549;166;585;327;1026;493;1611
351950;201603;1428;3935;1015;3167;138;466;491;1526;629;1992
351960;201603;4101;11755;2994;9710;638;2313;1214;3900;1852;6213
351970;201603;4779;17148;4222;16081;1191;4864;1407;5250;2598;10114
351980;201603;838;2524;654;2135;121;437;211;614;332;1051
351990;201603;1457;4115;1172;3584;239;868;228;588;467;1456
352000;201603;2190;7018;1981;6600;432;1535;912;2872;1344;4407
352010;201603;1596;5349;1397;4899;338;1286;278;976;616;2262
352020;201603;1349;4202;1155;3856;268;975;415;1330;683;2305
352030;201603;4707;13777;3908;12602;896;3024;1936;6285;2832;9309
352040;201603;1887;6153;1550;5416;309;1180;301;989;610;2169
352042;201603;3199;8938;2056;6451;405;1386;889;2707;1294;4093
352044;201603;1431;4550;1035;3673;184;725;169;537;353;1262
352050;201603;9697;29286;6666;22689;1471;5590;1237;3781;2708;9371
352060;201603;690;2067;561;1820;117;432;216;648;333;1080
352070;201603;785;2017;621;1746;132;396;205;567;337;963
352080;201603;404;1161;289;948;51;172;101;315;152;487
352090;201603;1253;4303;1040;3760;188;763;213;716;401;1479
352100;201603;2500;7601;1896;6484;479;1804;620;1986;1099;3790
352110;201603;466;1607;394;1463;113;440;142;489;255;929
352115;201603;414;1327;358;1223;57;209;171;559;228;768
352120;201603;879;2748;728;2476;120;498;364;1162;484;1660
352130;201603;1747;5020;1177;3863;309;1043;262;799;571;1842
352140;201603;1717;4921;1034;3477;158;553;350;1128;508;1681
352150;201603;716;2209;569;1928;148;520;244;821;392;1341
352160;201603;970;2678;758;2293;152;505;244;651;396;1156
352170;201603;2573;7768;2320;7263;437;1467;1205;3545;1642;5012
352180;201603;3194;9173;2683;8173;646;2094;918;2676;1564;4770
352190;201603;1127;3358;904;2896;144;567;290;719;434;1286
352200;201603;358;1232;284;1076;54;231;118;427;172;658
352210;201603;15596;42226;12749;38123;2310;7319;7315;22173;9625;29492
352215;201603;544;1674;497;1606;62;225;295;929;357;1154
352220;201603;11800;37896;9862;33940;3201;11770;2266;7858;5467;19628
352230;201603;11914;39824;10315;36862;2825;11078;3538;12200;6363;23278
352240;201603;11912;34421;9263;29835;2649;9648;2657;7632;5306;17280
352250;201603;21571;69224;18795;63587;5479;19712;5480;18498;10959;38210
352260;201603;5106;14513;3327;10821;616;2241;1098;3278;1714;5519
352265;201603;844;2684;721;2468;66;311;453;1457;519;1768
352270;201603;1690;5796;1424;5220;362;1397;330;1204;692;2601
352280;201603;2118;6415;1760;5801;416;1567;624;1947;1040;3514
352290;201603;1052;3335;897;3010;210;836;307;907;517;1743
352300;201603;921;2701;727;2342;167;590;298;891;465;1481
352310;201603;38914;115464;31948;103657;8157;27865;15438;50274;23595;78139
352320;201603;5377;16558;4640;15176;1268;4424;1377;4087;2645;8511
352330;201603;1922;6123;1635;5718;520;1931;437;1519;957;3450
352340;201603;5187;16458;3975;14100;1009;3903;684;2203;1693;6106
352350;201603;1565;5330;1406;5001;282;1136;503;1718;785;2854
352360;201603;1016;3115;886;2867;173;670;547;1664;720;2334
352370;201603;814;2791;736;2614;134;535;357;1226;491;1761
352380;201603;921;2930;792;2693;242;936;177;566;419;1502
352390;201603;17759;47629;11892;36570;2043;7146;5433;15598;7476;22744
352400;201603;3709;10503;2442;8029;686;2353;595;1828;1281;4181
352410;201603;2827;8571;2409;7868;588;2015;890;2828;1478;4843
352420;201603;845;2398;720;2157;173;557;303;871;476;1428
352430;201603;6090;18183;5085;16583;1720;6107;1460;4658;3180;10765
352440;201603;14654;44333;11893;39038;2843;9929;4051;13027;6894;22956
352450;201603;632;1929;434;1518;95;370;106;337;201;707
352460;201603;2275;7378;1902;6657;533;2074;478;1499;1011;3573
352470;201603;4068;11166;2597;8379;397;1409;833;2521;1230;3930
352480;201603;4264;11668;3302;9882;665;2254;1144;3083;1809;5337
352490;201603;635;2201;505;1866;94;386;110;371;204;757
352500;201603;8156;23633;7151;22160;3407;11289;1794;4932;5201;16221
352510;201603;2798;8794;2213;7697;648;2467;502;1672;1150;4139
352520;201603;1942;6826;1722;6288;442;1748;685;2451;1127;4199
352530;201603;7979;25358;6034;21020;1510;5659;771;2293;2281;7952
352540;201603;459;1428;341;1158;53;197;94;305;147;502
352550;201603;848;2813;609;2242;133;558;108;363;241;921
352560;201603;625;1871;448;1477;71;228;118;354;189;582
352570;201603;1755;5778;1337;4838;283;1180;234;736;517;1916
352580;201603;806;2374;697;2202;147;505;370;1158;517;1663
352585;201603;207;668;173;607;55;210;31;115;86;325
352590;201603;12070;36833;9681;32209;2723;9762;3621;11256;6344;21018
352600;201603;1518;4668;1340;4352;329;1163;553;1693;882;2856
352610;201603;3182;9765;2640;8859;762;2885;710;2249;1472;5134
352620;201603;5030;15399;4588;14758;956;3322;2510;7914;3466;11236
352630;201603;600;1916;566;1833;122;460;225;679;347;1139
352640;201603;2564;7866;2137;7025;253;954;1202;3858;1455;4812
352650;201603;781;2339;583;1913;118;405;162;504;280;909
352660;201603;991;3339;795;2903;146;603;189;672;335;1275
352670;201603;10214;30573;6396;22229;1424;5401;539;1782;1963;7183
352680;201603;2775;9302;2131;7827;486;1984;601;2003;1087;3987
352690;201603;29526;81216;21054;64471;3336;11278;9883;28909;13219;40187
352700;201603;583;1744;485;1593;141;511;203;643;344;1154
352710;201603;5079;14669;3857;12280;913;3234;1339;4036;2252;7270
352720;201603;7297;23599;6531;21939;1945;6587;1929;6474;3874;13061
352725;201603;387;1082;234;772;35;142;79;237;114;379
352730;201603;2060;6861;1858;6335;379;1386;642;1944;1021;3330
352740;201603;1957;5407;1565;4776;231;844;901;2604;1132;3448
352750;201603;469;1354;242;834;31;117;43;141;74;258
352760;201603;1126;3847;951;3416;283;1057;296;1009;579;2066
352770;201603;737;2314;637;2117;137;509;252;800;389;1309
352780;201603;585;1955;471;1695;98;386;135;454;233;840
352790;201603;613;1761;448;1470;86;302;103;337;189;639
352800;201603;906;3226;664;2588;141;603;179;631;320;1234
352810;201603;1132;2947;742;2195;133;429;232;642;365;1071
352820;201603;607;1667;437;1399;95;346;89;285;184;631
352830;201603;495;1433;307;1000;48;184;40;103;88;287
352840;201603;3529;11959;3146;11155;959;3524;1015;3532;1974;7056
352850;201603;8194;25129;6765;22745;1798;6410;2256;7465;4054;13875
352860;201603;748;2483;683;2344;159;580;237;779;396;1359
352870;201603;904;2282;629;1721;63;235;352;857;415;1092
352880;201603;2195;6205;1625;5080;293;933;529;1569;822;2502
352885;201603;205;698;194;670;21;78;126;422;147;500
352890;201603;650;1716;463;1345;61;216;211;544;272;760
352900;201603;19457;56718;14377;46608;2923;10378;5021;15536;7944;25914
352910;201603;346;1017;206;687;19;68;32;101;51;169
352920;201603;2248;6778;1716;5686;338;1262;676;2062;1014;3324
352930;201603;5464;16899;4306;14380;1031;3671;993;3169;2024;6840
352940;201603;21480;69369;17925;61263;5707;20951;2052;6351;7759;27302
352950;201603;284;822;179;630;39;161;34;104;73;265
352960;201603;574;1736;356;1239;51;194;61;197;112;391
352965;201603;362;1020;232;733;54;177;32;88;86;265
352970;201603;3040;7666;2452;6797;301;870;1584;4414;1885;5284
352980;201603;1105;3406;926;3117;200;667;522;1855;722;2522
352990;201603;3907;12351;3446;11567;912;3443;1343;4256;2255;7699
353000;201603;437;1236;241;781;24;81;36;110;60;191
353010;201603;2927;8145;2149;6645;507;1782;568;1516;1075;3298
353020;201603;4077;11066;2610;7937;358;1240;918;2506;1276;3746
353030;201603;3613;10641;2930;9386;820;2821;559;1711;1379;4532
353040;201603;527;1452;446;1329;110;363;138;385;248;748
353050;201603;4588;15318;3851;13834;1099;4201;1316;4580;2415;8781
353060;201603;34717;104214;31553;99234;3382;12860;22763;68995;26145;81855
353070;201603;10066;30910;7219;24925;1670;6150;1696;5858;3366;12008
353080;201603;4977;15684;3467;12407;714;2826;724;2411;1438;5237
353090;201603;495;1687;448;1591;45;194;257;853;302;1047
353100;201603;252;687;123;411;21;69;18;58;39;127
353110;201603;7154;21900;6125;20235;1453;5147;3185;10594;4638;15741
353120;201603;649;1914;412;1365;86;325;96;261;182;586
353130;201603;2374;6852;1911;6142;591;2038;567;1772;1158;3810
353140;201603;2210;6027;1704;5061;394;1260;665;1864;1059;3124
353150;201603;1581;4746;1281;4229;341;1176;338;1114;679;2290
353160;201603;655;1852;420;1359;92;309;59;142;151;451
353170;201603;401;1314;364;1256;110;480;157;490;267;970
353180;201603;7903;22529;6312;19719;1112;3807;3181;9677;4293;13484
353190;201603;3517;10665;2920;9384;512;1850;1465;4420;1977;6270
353200;201603;905;3011;737;2627;228;897;181;599;409;1496
353205;201603;349;1138;307;1057;73;253;116;404;189;657
353210;201603;963;2449;687;1959;36;133;453;1254;489;1387
353215;201603;357;1141;312;1038;51;198;114;331;165;529
353220;201603;626;1956;512;1713;123;442;109;337;232;779
353230;201603;779;2519;711;2401;175;662;177;559;352;1221
353240;201603;1923;6194;1705;5763;360;1369;858;2785;1218;4154
353250;201603;1024;2765;775;2309;103;327;374;1075;477;1402
353260;201603;845;2327;608;1898;99;354;216;648;315;1002
353270;201603;592;1746;520;1611;132;431;173;516;305;947
353280;201603;553;1815;458;1598;112;429;94;319;206;748
353282;201603;1615;5181;1495;4946;204;751;896;2844;1100;3595
353284;201603;335;904;194;604;34;105;48;149;82;254
353286;201603;139;419;100;334;16;49;17;60;33;109
353290;201603;575;1803;457;1597;74;326;249;812;323;1138
353300;201603;1344;4172;1126;3711;253;949;392;1165;645;2114
353310;201603;177;552;150;504;47;167;49;159;96;326
353320;201603;510;1470;447;1366;79;273;240;698;319;971
353325;201603;571;1871;475;1679;79;301;90;281;169;582
353330;201603;587;1707;396;1262;70;255;170;510;240;765
353340;201603;2585;7357;1709;5704;461;1636;404;1324;865;2960
353350;201603;3026;9058;2487;8039;739;2540;822;2513;1561;5053
353360;201603;375;1218;335;1133;40;160;216;698;256;858
353370;201603;594;1949;516;1768;67;273;276;907;343;1180
353380;201603;314;1047;260;933;51;219;82;267;133;486
353390;201603;5616;15349;4037;12547;767;2580;1321;3913;2088;6493
353400;201603;460;1400;394;1271;95;344;82;218;177;562
353410;201603;566;1652;470;1492;87;298;263;834;350;1132
353420;201603;540;1494;380;1152;107;320;102;298;209;618
353430;201603;2150;7271;1567;5811;361;1417;199;695;560;2112
353440;201603;55205;174685;45990;154324;12309;43204;15428;50178;27737;93382
353450;201603;405;1205;332;1055;71;249;120;364;191;613
353460;201603;3227;9092;2724;8216;386;1311;1309;4012;1695;5323
353470;201603;7827;23523;5733;19326;1233;4559;1193;3748;2426;8307
353475;201603;1527;4273;1064;3277;191;629;292;812;483;1441
353480;201603;1327;4038;1180;3751;194;672;676;2074;870;2746
353490;201603;915;2626;723;2255;145;473;245;724;390;1197
353500;201603;925;2488;757;2216;237;694;328;939;565;1633
353510;201603;951;3015;705;2411;152;553;140;447;292;1000
353520;201603;1051;3036;832;2681;143;525;334;1034;477;1559
353530;201603;2425;7127;2117;6580;338;1232;1125;3349;1463;4581
353540;201603;1820;5563;1570;5137;426;1474;609;1938;1035;3412
353550;201603;5728;15859;4832;14440;548;1926;2983;8457;3531;10383
353560;201603;1931;6384;1609;5828;415;1697;400;1334;815;3031
353570;201603;426;1318;357;1177;58;198;215;674;273;872
353580;201603;2149;6539;1952;6217;326;1172;1237;3898;1563;5070
353590;201603;706;2057;530;1704;139;476;155;508;294;984
353600;201603;1660;4586;1487;4298;213;677;769;2163;982;2840
353610;201603;523;1751;394;1476;67;302;66;212;133;514
353620;201603;2084;6792;1768;6150;443;1667;499;1607;942;3274
353625;201603;327;912;198;660;39;144;55;182;94;326
353630;201603;1453;5071;1173;4366;217;875;133;425;350;1300
353640;201603;1237;3703;981;3151;118;398;482;1546;600;1944
353650;201603;7089;20841;5295;17137;1002;3381;1675;5291;2677;8672
353657;201603;276;870;243;802;35;134;77;241;112;375
353660;201603;1061;2762;802;2330;300;941;108;212;408;1153
353670;201603;3355;10834;2860;9780;902;3467;842;2576;1744;6043
353680;201603;667;2147;568;1972;195;777;193;611;388;1388
353690;201603;507;1361;284;927;46;162;55;137;101;299
353700;201603;1852;5705;1592;5188;290;1009;677;2120;967;3129
353710;201603;2926;7038;1408;4584;306;1018;225;735;531;1753
353715;201603;468;1347;344;1087;29;109;85;238;114;347
353720;201603;1917;6007;1651;5597;320;1275;798;2543;1118;3818
353730;201603;4199;12655;3322;10853;669;2386;993;2963;1662;5349
353740;201603;1752;5229;1360;4464;354;1206;311;997;665;2203
353750;201603;797;2687;608;2245;127;519;142;545;269;1064
353760;201603;9303;25743;7538;23241;1276;4409;4334;13109;5610;17518
353770;201603;741;2302;463;1624;66;238;22;46;88;284
353780;201603;3900;13485;3397;12460;1081;4181;887;3238;1968;7419
353790;201603;1983;6780;1641;6080;423;1787;317;1172;740;2959
353800;201603;15353;46776;12238;41267;3157;11642;4070;13403;7227;25045
353810;201603;983;3122;758;2638;154;604;224;765;378;1369
353820;201603;1241;4185;1127;3917;223;909;572;1845;795;2754
353830;201603;625;1681;490;1468;85;286;261;760;346;1046
353850;201603;1617;5089;1434;4729;317;1101;565;1832;882;2933
353860;201603;2376;7879;2016;7060;527;1999;500;1687;1027;3686
353870;201603;27686;79680;19372;63706;3815;13822;5610;16799;9425;30621
353880;201603;2508;7931;2116;7255;303;1235;1096;3697;1399;4932
353890;201603;2594;6365;1813;5106;285;858;863;2323;1148;3181
353900;201603;937;2907;687;2408;144;561;180;599;324;1160
353910;201603;1032;3705;977;3591;255;952;534;1982;789;2934
353920;201603;2221;6550;1569;5187;325;1177;260;756;585;1933
353930;201603;4327;13005;3007;10591;725;2776;547;1922;1272;4698
353940;201603;1143;3617;907;3085;145;551;284;902;429;1453
353950;201603;3142;10037;2819;9418;463;1730;1594;5117;2057;6847
353960;201603;571;1803;438;1508;96;342;81;236;177;578
353970;201603;503;1457;436;1369;50;163;284;901;334;1064
353980;201603;12214;36708;10529;33538;2273;7714;5021;15476;7294;23190
353990;201603;314;999;285;938;44;179;135;413;179;592
354000;201603;2076;5867;1385;4470;252;866;126;380;378;1246
354010;201603;347;1043;288;946;65;213;158;534;223;747
354020;201603;4117;12931;3613;11835;945;3298;1118;3423;2063;6721
354025;201603;849;2359;617;1930;124;411;193;588;317;999
354030;201603;446;1255;308;1001;47;167;126;392;173;559
354040;201603;724;2003;507;1588;56;189;248;722;304;911
354050;201603;907;2902;745;2570;189;709;171;570;360;1279
354060;201603;4718;14569;3343;11530;805;2949;827;2743;1632;5692
354070;201603;2559;8554;2193;7731;533;2024;404;1341;937;3365
354075;201603;1794;6610;1674;6345;391;1667;748;2754;1139;4421
354080;201603;1471;4519;1042;3574;198;692;196;613;394;1305
354085;201603;309;792;274;741;14;53;223;591;237;644
354090;201603;1265;3765;1209;3672;137;471;846;2580;983;3051
354100;201603;14006;46639;11554;42049;2949;11443;4526;16196;7475;27639
354105;201603;787;2407;702;2267;114;410;443;1400;557;1810
354110;201603;684;1898;550;1715;206;713;77;181;283;894
354120;201603;1835;5059;1397;4244;244;816;570;1609;814;2425
354130;201603;5926;17163;4533;14478;1654;5576;435;1190;2089;6766
354140;201603;25464;63751;15749;46487;3160;9996;4520;12310;7680;22306
354150;201603;3694;9998;2831;8432;448;1481;1341;3845;1789;5326
354160;201603;3185;10322;2646;9101;716;2654;943;3154;1659;5808
354165;201603;396;1419;348;1310;92;386;115;426;207;812
354170;201603;1279;4009;1023;3442;201;751;365;1116;566;1867
354180;201603;443;1327;391;1218;51;190;215;601;266;791
354190;201603;1487;4755;1249;4267;330;1229;376;1224;706;2453
354200;201603;965;2737;773;2401;111;395;334;945;445;1340
354210;201603;570;1819;488;1670;72;294;254;812;326;1106
354220;201603;2746;8004;2335;7261;492;1636;1023;3114;1515;4750
354230;201603;590;1943;535;1839;99;385;218;722;317;1107
354240;201603;1163;3811;874;3148;155;622;177;618;332;1240
354250;201603;655;1869;436;1481;141;513;105;379;246;892
354260;201603;6679;20252;5682;18559;1621;5631;1729;5691;3350;11322
354270;201603;1083;3699;912;3312;194;765;293;1048;487;1813
354280;201603;658;2006;604;1916;85;340;413;1229;498;1569
354290;201603;856;2981;772;2809;187;753;323;1173;510;1926
354300;201603;3364;11176;3210;10891;892;3105;1473;4954;2365;8059
354310;201603;826;2533;654;2193;130;457;307;1037;437;1494
354320;201603;682;2054;570;1836;142;524;167;486;309;1010
354323;201603;419;1174;312;981;65;220;96;271;161;491
354325;201603;1184;3913;951;3346;191;759;341;1114;532;1873
354330;201603;6209;18723;5064;16485;1027;3732;2257;6893;3284;10625
354340;201603;22516;69262;18329;61857;5433;19812;6281;20585;11714;40397
354350;201603;1019;3024;943;2887;280;965;447;1245;727;2210
354360;201603;442;1412;289;1043;42;159;14;54;56;213
354370;201603;1106;3698;960;3418;97;429;557;1934;654;2363
354380;201603;812;2441;649;2146;182;711;101;276;283;987
354390;201603;12348;36383;8690;29286;1761;6439;1623;5347;3384;11786
354400;201603;1484;5160;1216;4495;238;931;343;1234;581;2165
354410;201603;5089;15746;4268;14212;1045;3699;1707;5641;2752;9340
354420;201603;1098;3327;831;2714;201;712;289;899;490;1611
354425;201603;2224;6425;1887;5800;579;1876;378;1165;957;3041
354430;201603;1261;4073;1155;3868;242;928;478;1555;720;2483
354440;201603;497;1499;375;1240;47;176;154;473;201;649
354450;201603;400;1152;238;811;37;155;36;97;73;252
354460;201603;867;2384;626;1958;162;551;247;766;409;1317
354470;201603;557;1535;436;1292;43;156;219;589;262;745
354480;201603;678;1871;578;1721;92;306;336;968;428;1274
354490;201603;667;2229;518;1871;86;326;170;583;256;909
354500;201603;2038;6659;1793;6239;659;2610;253;806;912;3416
354510;201603;696;2000;629;1892;84;238;401;1243;485;1481
354515;201603;267;895;207;758;38;164;72;241;110;405
354520;201603;7108;23059;4007;13998;764;3014;1457;4727;2221;7741
354530;201603;2851;9846;2547;9182;691;2730;986;3449;1677;6179
354540;201603;1169;3529;956;3152;338;1214;133;396;471;1610
354550;201603;430;1294;360;1149;63;216;171;520;234;736
354560;201603;1528;4302;1018;3190;171;532;397;1177;568;1709
354570;201603;834;2412;506;1636;73;251;69;199;142;450
354580;201603;9984;28231;7381;23474;1312;4527;2840;8592;4152;13119
354600;201603;1471;4869;1302;4521;279;1179;619;1997;898;3176
354610;201603;365;1055;216;700;27;77;46;135;73;212
354620;201603;366;1181;288;1047;70;317;133;455;203;772
354625;201603;263;838;192;686;32;118;53;175;85;293
354630;201603;1963;6595;1743;6127;704;2594;259;857;963;3451
354640;201603;3292;10778;2632;9349;545;2242;517;1670;1062;3912
354650;201603;826;2501;716;2283;92;325;463;1454;555;1779
354660;201603;2155;6209;1625;5277;204;764;911;2925;1115;3689
354670;201603;1300;4146;1013;3451;242;899;207;623;449;1522
354680;201603;4217;13804;3822;13025;1026;3734;1549;5203;2575;8937
354690;201603;742;2386;497;1777;90;334;110;389;200;723
354700;201603;1114;3179;784;2490;148;548;306;831;454;1379
354710;201603;500;1499;396;1270;44;160;171;487;215;647
354720;201603;222;597;134;428;39;123;34;106;73;229
354730;201603;7518;24458;5832;20982;1282;5049;2288;7976;3570;13025
354740;201603;227;706;139;508;18;78;26;89;44;167
354750;201603;2276;6978;1784;6053;483;1821;605;1969;1088;3790
354760;201603;1823;5764;1484;5039;417;1520;184;604;601;2124
354765;201603;278;767;143;471;15;55;16;41;31;96
354770;201603;2199;6134;1683;5267;582;1927;442;1333;1024;3260
354780;201603;48180;135108;41224;120748;6805;22441;22073;60793;28878;83234
354790;201603;737;2442;663;2286;124;473;333;1087;457;1560
354800;201603;1993;5824;1757;5519;419;1483;876;2691;1295;4174
354805;201603;948;2842;699;2305;62;211;144;422;206;633
354810;201603;578;1878;376;1388;67;302;57;164;124;466
354820;201603;926;3182;796;2893;165;701;199;646;364;1347
354830;201603;386;1076;299;922;76;245;123;352;199;597
354840;201603;599;1691;476;1474;100;315;221;685;321;1000
354850;201603;15857;48602;11855;40602;2522;9707;4608;14513;7130;24220
354860;201603;1323;4143;1136;3831;226;867;430;1361;656;2228
354870;201603;42040;124196;37445;114841;8702;28532;15535;46752;24237;75284
354880;201603;4090;11260;2338;7630;348;1333;636;1704;984;3037
354890;201603;15460;44844;12839;40185;2960;10028;4746;14316;7706;24344
354900;201603;409;1256;312;1048;66;234;65;209;131;443
354910;201603;6181;18446;3620;12879;560;2240;160;544;720;2784
354920;201603;402;1181;269;922;49;194;60;201;109;395
354925;201603;302;903;188;642;26;107;21;58;47;165
354930;201603;271;658;143;449;22;75;59;178;81;253
354940;201603;1773;6303;1460;5489;511;2056;165;572;676;2628
354950;201603;1395;4461;1198;4144;130;562;685;2315;815;2877
354960;201603;745;2320;648;2167;128;490;273;879;401;1369
354970;201603;3691;12022;3265;11154;567;2225;1739;5718;2306;7943
354980;201603;32705;81423;20106;60733;3432;11661;6256;17398;9688;29059
354990;201603;48651;142033;38737;122598;6795;23283;18495;56813;25290;80096
354995;201603;1657;5046;1403;4650;325;1112;706;2351;1031;3463
355000;201603;1346;4355;1194;4078;368;1450;226;670;594;2120
355010;201603;3406;10492;2668;8825;719;2489;829;2810;1548;5299
355020;201603;2750;9140;2123;7862;797;3238;430;1525;1227;4763
355030;201603;1024578;2819994;872346;2527766;192340;604760;373217;1035446;565557;1640206
355040;201603;2415;7406;2133;6920;505;1745;1137;3635;1642;5380
355050;201603;1091;3339;881;2939;284;966;130;429;414;1395
355060;201603;4194;13954;3420;12348;762;3089;941;3097;1703;6186
355070;201603;6074;18891;5408;17824;1131;4308;2649;8143;3780;12451
355080;201603;934;3248;670;2621;102;467;39;141;141;608
355090;201603;1067;3624;906;3278;164;623;354;1286;518;1909
355100;201603;16508;51616;13906;47294;3746;14008;6120;20269;9866;34277
355110;201603;1147;3736;988;3443;287;1069;215;747;502;1816
355120;201603;594;1874;500;1692;98;393;180;570;278;963
355130;201603;589;1496;294;872;42;128;91;244;133;372
355140;201603;1061;3532;1006;3444;222;855;526;1839;748;2694
355150;201603;3129;9024;2622;8231;545;1802;1324;4210;1869;6012
355160;201603;1516;4736;1277;4355;410;1565;351;1133;761;2698
355170;201603;8043;22360;6059;19071;1944;6517;1388;4497;3332;11014
355180;201603;2738;8504;2254;7621;562;2243;686;2093;1248;4336
355190;201603;1216;4105;1035;3743;365;1402;326;1165;691;2567
355200;201603;706;2537;657;2434;269;1081;135;464;404;1545
355210;201603;2506;7967;2199;7328;380;1481;1147;3601;1527;5082
355220;201603;30944;93814;25455;82942;8285;28460;5890;18190;14175;46650
355230;201603;1381;3825;779;2515;142;469;159;473;301;942
355240;201603;24672;70144;17486;55830;3620;12327;5541;17172;9161;29499
355250;201603;24930;79780;21554;73379;5985;21830;7746;25749;13731;47579
355255;201603;835;2297;536;1694;95;312;136;417;231;729
355260;201603;1184;3447;1013;3167;226;813;412;1151;638;1964
355270;201603;1509;4419;1403;4259;121;404;1080;3259;1201;3663
355280;201603;24002;69776;19608;61437;3665;12858;8352;24841;12017;37699
355290;201603;868;2742;706;2359;126;445;245;733;371;1178
355300;201603;1130;3654;943;3270;191;717;307;1003;498;1720
355310;201603;944;2886;796;2604;145;506;384;1259;529;1765
355320;201603;558;1738;481;1574;83;332;178;507;261;839
355330;201603;1793;5529;1289;4522;265;1023;482;1641;747;2664
355340;201603;2379;6234;2129;5827;363;1006;1253;3373;1616;4379
355350;201603;1268;4302;1029;3760;246;984;269;936;515;1920
355360;201603;1062;3391;957;3180;144;503;627;2145;771;2648
355365;201603;265;756;174;609;37;136;46;158;83;294
355370;201603;7458;18306;5439;15810;1452;4563;2114;6538;3566;11101
355380;201603;3140;9437;2463;7956;527;1867;510;1389;1037;3256
355385;201603;796;2528;735;2431;270;976;200;590;470;1566
355390;201603;820;2351;621;1943;137;485;224;595;361;1080
355395;201603;1853;5551;1376;4472;203;683;569;1732;772;2415
355400;201603;8553;28098;7414;25739;2199;8282;2030;6777;4229;15059
355410;201603;15446;50292;12466;44361;3716;14511;2222;8006;5938;22517
355420;201603;701;2505;649;2400;199;814;159;591;358;1405
355430;201603;3330;9342;2755;8369;529;1706;1340;3930;1869;5636
355440;201603;902;2775;682;2293;121;428;200;620;321;1048
355450;201603;3598;10292;2095;6962;365;1247;562;1758;927;3005
355460;201603;580;1581;387;1233;75;291;113;288;188;579
355465;201603;321;1042;275;955;55;204;67;231;122;435
355470;201603;725;2252;599;2004;125;457;260;841;385;1298
355475;201603;147;521;137;494;32;121;68;238;100;359
355480;201603;2641;9225;2420;8801;573;2248;1116;3968;1689;6216
355490;201603;939;2696;613;2020;110;375;137;425;247;800
355495;201603;696;2332;612;2146;115;425;186;630;301;1055
355500;201603;7244;20919;4823;15746;780;2798;799;2463;1579;5261
355510;201603;1948;5208;1108;3524;152;574;321;908;473;1482
355520;201603;411;969;213;589;30;99;89;220;119;319
355530;201603;405;960;167;521;18;65;28;73;46;138
355535;201603;645;1978;518;1746;147;563;117;331;264;894
355540;201603;7777;24501;7322;23766;1887;6536;3660;11512;5547;18048
355550;201603;671;2039;577;1902;125;489;258;837;383;1326
355560;201603;1196;3569;774;2631;143;560;71;174;214;734
355570;201603;181;563;121;433;17;67;11;38;28;105
355580;201603;1235;3449;850;2661;149;524;313;978;462;1502
355590;201603;224;588;176;504;24;81;94;255;118;336
355600;201603;1061;3244;885;2882;278;978;252;773;530;1751
355610;201603;1405;3952;1168;3535;208;689;499;1465;707;2154
355620;201603;3762;11763;3057;10218;519;1985;1359;4228;1878;6213
355630;201603;3191;9133;2046;6830;384;1376;492;1616;876;2992
355635;201603;868;2834;750;2642;87;354;498;1776;585;2130
355640;201603;2849;9044;2090;7505;335;1345;214;733;549;2078
355645;201603;3114;10607;2778;10071;477;1932;1585;5725;2062;7657
355650;201603;6463;19562;5516;17845;921;3459;3147;9525;4068;12984
355660;201603;1174;3729;949;3271;188;778;372;1194;560;1972
355670;201603;2490;7548;1819;6098;325;1270;752;2238;1077;3508
355680;201603;1593;5262;1177;4272;301;1173;172;604;473;1777
355690;201603;420;1318;315;1141;183;705;19;57;202;762
355695;201603;274;859;159;548;9;31;7;14;16;45
355700;201603;5066;16672;4323;15013;1035;3771;1575;5308;2610;9079
355710;201603;9844;24349;5901;17208;1327;4141;1356;3702;2683;7843
355715;201603;284;854;188;640;44;158;30;97;74;255
355720;201603;1502;4965;1245;4394;333;1274;352;1114;685;2388
355730;201603;767;2528;645;2252;202;715;144;499;346;1214
410010;201603;1338;4168;1157;3777;238;847;227;726;465;1573
410020;201603;1101;3612;966;3316;246;879;383;1309;629;2188
410030;201603;1107;3760;926;3313;204;780;153;533;357;1313
410040;201603;9085;29918;7947;27713;1961;7627;2193;7599;4154;15226
410045;201603;987;2783;698;2234;151;516;152;452;303;968
410050;201603;2488;6881;1596;5132;390;1335;123;312;513;1647
410060;201603;2189;6697;1936;6220;426;1418;835;2751;1261;4169
410070;201603;1641;4649;1265;3932;383;1306;259;745;642;2051
410080;201603;1333;3789;1063;3306;172;619;456;1309;628;1928
410090;201603;961;3007;893;2868;214;768;285;920;499;1688
410100;201603;2651;8064;2020;6613;431;1586;204;603;635;2189
410105;201603;361;1131;248;863;39;167;26;76;65;243
410110;201603;2675;7819;2160;6844;343;1198;654;2056;997;3254
410115;201603;503;1364;396;1168;61;186;123;328;184;514
410120;201603;2355;8138;2195;7850;735;2797;716;2580;1451;5377
410130;201603;999;3192;936;3029;412;1356;203;644;615;2000
410140;201603;16242;42525;11076;33411;2296;7547;2748;8064;5044;15611
410150;201603;16282;40815;8582;25628;1599;5151;1196;3242;2795;8393
410160;201603;2879;8872;2598;8393;671;2413;890;2907;1561;5320
410165;201603;711;2080;556;1724;125;400;215;619;340;1019
410170;201603;2167;6247;1678;5198;459;1599;264;777;723;2376
410180;201603;9855;31225;8485;28279;2023;7321;3097;9586;5120;16907
410185;201603;525;1463;407;1245;94;289;83;225;177;514
410190;201603;1992;5862;1579;4930;296;1011;248;705;544;1716
410200;201603;3653;10258;2731;8478;562;1986;327;961;889;2947
410210;201603;2470;7312;1837;5942;314;1184;367;975;681;2159
410220;201603;627;1756;467;1463;80;297;142;432;222;729
410230;201603;1307;4117;1129;3775;256;974;418;1378;674;2352
410240;201603;4126;12573;3755;11803;1215;4335;565;1666;1780;6001
410250;201603;2568;7103;1800;5523;417;1390;314;900;731;2290
410260;201603;1479;4403;1225;3959;283;984;461;1481;744;2465
410270;201603;528;1478;393;1209;56;181;143;418;199;599
410275;201603;821;2504;570;1920;78;292;261;883;339;1175
410280;201603;2180;6312;1632;5241;327;1202;439;1325;766;2527
410290;201603;3284;9779;2770;8809;662;2228;1026;3298;1688;5526
410300;201603;688;1928;579;1701;96;311;243;634;339;945
410302;201603;402;1082;258;822;29;96;125;419;154;515
410304;201603;1191;3817;1076;3573;294;1012;379;1321;673;2333
410305;201603;1774;4871;1479;4372;307;1008;777;2290;1084;3298
410310;201603;2185;7061;1975;6682;435;1636;716;2430;1151;4066
410315;201603;624;1819;408;1384;70;249;107;343;177;592
410320;201603;1176;3591;769;2649;97;388;62;197;159;585
410322;201603;514;1508;336;1118;61;205;78;256;139;461
410330;201603;1347;3692;1099;3217;238;734;281;816;519;1550
410335;201603;929;2739;801;2505;146;489;309;924;455;1413
410337;201603;790;2068;582;1682;80;275;198;509;278;784
410340;201603;506;1493;353;1094;45;161;133;360;178;521
410345;201603;1740;5046;1232;3946;271;932;297;928;568;1860
410347;201603;685;1871;479;1472;66;238;139;396;205;634
410350;201603;1023;3069;757;2523;155;568;126;363;281;931
410360;201603;3521;9717;2803;8449;440;1549;1343;3918;1783;5467
410370;201603;11486;33581;8470;26545;1494;5263;2244;6091;3738;11354
410380;201603;1244;3671;1121;3414;140;523;537;1582;677;2105
410390;201603;2404;7203;1966;6275;581;1980;468;1351;1049;3331
410395;201603;840;2792;741;2577;189;740;308;1061;497;1801
410400;201603;4266;13141;3645;11978;762;2817;1313;4176;2075;6993
410405;201603;829;2417;675;2137;152;530;215;682;367;1212
410410;201603;1245;3877;1197;3811;324;1245;524;1555;848;2800
410420;201603;6551;21223;5397;18624;1303;4854;665;1981;1968;6835
410425;201603;2759;8747;2007;7067;334;1232;177;615;511;1847
410430;201603;13809;37269;10075;30407;1942;6403;2777;8086;4719;14489
410440;201603;2699;8659;2419;8119;634;2363;921;3014;1555;5377
410442;201603;2604;8717;2303;8038;674;2432;605;2160;1279;4592
410445;201603;2250;7458;1953;6926;511;2031;591;2166;1102;4197
410450;201603;2033;5765;1583;4886;419;1352;163;410;582;1762
410460;201603;1868;5543;1477;4791;379;1249;301;944;680;2193
410465;201603;1957;6452;1651;5796;354;1367;593;1961;947;3328
410470;201603;1655;5338;1354;4671;290;1158;313;1063;603;2221
410480;201603;28525;80621;18508;59594;3268;11277;1784;5004;5052;16281
410490;201603;10475;32721;8198;27983;1894;7227;1966;6160;3860;13387
410500;201603;1492;4728;1213;4099;443;1680;232;721;675;2401
410510;201603;2408;6341;1721;4995;317;914;608;1634;925;2548
410520;201603;2986;10358;2821;10027;836;3150;1079;3878;1915;7028
410530;201603;1498;4120;1081;3265;197;643;278;789;475;1432
410540;201603;2950;8742;2072;6879;401;1370;565;1862;966;3232
410550;201603;5817;16780;4067;12995;745;2629;498;1465;1243;4094
410560;201603;1180;3505;906;2947;197;732;238;663;435;1395
410570;201603;2541;8165;2291;7742;660;2405;693;2640;1353;5045
410580;201603;20028;60490;16403;53313;4005;14362;4308;13106;8313;27468
410590;201603;1338;4145;860;2892;124;412;162;493;286;905
410600;201603;1782;5210;1433;4534;362;1165;486;1559;848;2724
410610;201603;757;2119;591;1798;78;260;212;628;290;888
410620;201603;1643;5589;1234;4587;291;1187;112;399;403;1586
410630;201603;2400;7089;1707;5546;388;1393;205;548;593;1941
410640;201603;4364;12031;3240;9892;802;2842;474;1352;1276;4194
410645;201603;1090;3807;1026;3709;489;1857;207;801;696;2658
410650;201603;2035;6293;1651;5490;514;1813;214;667;728;2480
410655;201603;817;2337;616;1946;112;405;196;588;308;993
410657;201603;724;2012;514;1576;91;318;161;420;252;738
410660;201603;2582;7518;1576;5246;329;1180;161;480;490;1660
410670;201603;899;2467;601;1835;111;368;162;443;273;811
410680;201603;2813;9177;2300;7939;660;2201;609;2286;1269;4487
410685;201603;620;1775;537;1637;45;145;380;1173;425;1318
410690;201603;109830;316454;78095;250797;15584;55219;16606;46794;32190;102013
410700;201603;2163;6556;1986;6223;516;1729;790;2371;1306;4100
410710;201603;876;2593;605;2006;138;474;135;389;273;863
410712;201603;787;2369;675;2153;248;847;159;528;407;1375
410715;201603;881;2814;659;2276;120;456;180;582;300;1038
410720;201603;3239;9541;2377;7737;470;1717;463;1370;933;3087
410725;201603;1014;2884;722;2307;107;341;99;280;206;621
410730;201603;498;1392;403;1241;119;398;91;302;210;700
410740;201603;901;2674;650;2170;101;388;264;866;365;1254
410750;201603;1746;5116;1434;4458;289;979;435;1284;724;2263
410752;201603;293;805;156;508;34;121;40;112;74;233
410753;201603;411;1192;258;837;32;120;73;219;105;339
410754;201603;1056;3123;901;2857;65;205;567;1928;632;2133
410755;201603;783;1972;596;1676;87;271;321;859;408;1130
410760;201603;2305;6998;1993;6430;532;1877;551;1749;1083;3626
410765;201603;14904;44526;11291;37456;1804;6757;854;2728;2658;9485
410770;201603;893;2458;640;1949;164;551;107;314;271;865
410773;201603;1277;3678;1111;3424;181;636;663;1990;844;2626
410775;201603;1374;3972;1268;3823;300;1001;450;1331;750;2332
410780;201603;523;1438;370;1153;89;277;117;415;206;692
410785;201603;728;2300;613;2043;183;675;123;391;306;1066
410790;201603;421;1368;377;1256;92;323;36;86;128;409
410800;201603;2735;6858;2133;5843;383;1249;738;1851;1121;3100
410810;201603;325;1009;274;903;55;205;96;318;151;523
410820;201603;808;2420;609;1974;139;492;85;258;224;750
410830;201603;29900;84923;23932;74736;6611;23000;7430;22215;14041;45215
410832;201603;952;2788;832;2554;90;336;467;1366;557;1702
410840;201603;6645;19466;4392;14660;858;3085;296;780;1154;3865
410845;201603;1212;3586;1029;3215;213;739;394;1192;607;1931
410850;201603;2661;7842;2378;7394;519;1773;986;3122;1505;4895
410855;201603;562;1567;404;1237;67;221;131;380;198;601
410860;201603;3792;10675;3022;9222;558;1847;978;2867;1536;4714
410865;201603;1442;4910;1378;4789;352;1318;754;2690;1106;4008
410870;201603;1177;3595;1094;3460;215;720;669;2152;884;2872
410880;201603;3564;11347;3003;10194;594;2226;509;1667;1103;3893
410890;201603;872;2861;696;2490;181;734;64;209;245;943
410895;201603;1057;3641;944;3390;327;1257;204;692;531;1949
410900;201603;903;2454;597;1869;93;315;167;477;260;792
410910;201603;398;1047;304;878;31;94;155;439;186;533
410920;201603;797;2212;638;1945;162;568;202;600;364;1168
410930;201603;1580;4664;1332;4175;322;1187;408;1259;730;2446
410940;201603;19938;64055;17075;58797;5124;19178;3861;13494;8985;32672
410950;201603;1683;5544;1564;5327;201;735;1102;3750;1303;4485
410960;201603;7049;19479;4448;14541;1293;4670;794;2455;2087;7125
410965;201603;1014;3097;851;2784;225;755;335;1091;560;1846
410970;201603;4357;12815;3420;11000;914;3369;549;1705;1463;5074
410975;201603;1571;4508;1252;3899;215;771;436;1307;651;2078
410980;201603;5582;15660;3563;11650;681;2479;669;2090;1350;4569
410990;201603;882;2570;552;1855;163;606;55;144;218;750
411000;201603;472;1420;353;1151;63;232;69;186;132;418
411005;201603;474;1421;296;989;61;225;27;75;88;300
411007;201603;2207;6932;1906;6291;555;1937;519;1695;1074;3632
411010;201603;3803;13020;3430;12192;876;3425;442;1514;1318;4939
411020;201603;2462;7610;2148;7083;683;2508;638;2052;1321;4560
411030;201603;640;1731;460;1382;70;240;106;286;176;526
411040;201603;641;1861;301;1016;49;179;55;196;104;375
411050;201603;1951;6726;1752;6291;496;1967;238;762;734;2729
411060;201603;1439;4392;1151;3758;222;842;129;367;351;1209
411065;201603;353;1042;280;898;52;168;90;282;142;450
411070;201603;5623;16777;4413;14326;1139;4096;871;2574;2010;6670
411080;201603;2103;6280;1869;5849;445;1546;435;1299;880;2845
411090;201603;797;1953;551;1571;69;253;105;273;174;526
411095;201603;1444;4098;1097;3376;151;527;275;761;426;1288
411100;201603;1284;3729;936;3001;158;626;150;431;308;1057
411110;201603;575;1695;320;1093;37;138;33;92;70;230
411120;201603;1586;4790;1200;3944;296;1113;354;1068;650;2181
411125;201603;3989;13097;3809;12753;1103;3895;1388;4618;2491;8513
411130;201603;679;2029;511;1662;112;389;128;456;240;845
411140;201603;2064;7104;1770;6416;500;1891;590;2219;1090;4110
411150;201603;3979;11176;3032;9304;644;2132;388;1042;1032;3174
411155;201603;895;2439;657;2006;94;327;266;780;360;1107
411160;201603;220;630;170;535;36;119;35;99;71;218
411170;201603;660;2079;552;1831;126;465;177;556;303;1021
411180;201603;5396;16114;4447;14322;981;3502;1409;4535;2390;8037
411190;201603;1342;3857;1114;3424;274;960;226;601;500;1561
411200;201603;4166;12295;3341;10856;814;2989;1016;3138;1830;6127
411210;201603;1882;5408;1501;4729;398;1381;153;420;551;1801
411220;201603;1093;3092;873;2696;212;767;291;786;503;1553
411230;201603;1219;3392;781;2524;159;553;217;677;376;1230
411240;201603;1399;3373;785;2319;134;410;236;645;370;1055
411250;201603;2114;6222;1766;5586;482;1681;425;1355;907;3036
411260;201603;292;813;195;642;27;96;71;220;98;316
411270;201603;1683;5256;1490;4893;265;1015;637;1982;902;2997
411275;201603;1281;3804;1048;3290;256;845;209;611;465;1456
411280;201603;1432;4189;991;3251;172;607;157;488;329;1095
411290;201603;716;2104;547;1749;134;450;138;425;272;875
411295;201603;949;2671;848;2473;161;501;305;917;466;1418
411300;201603;1193;3039;844;2386;78;243;324;858;402;1101
411310;201603;817;2221;643;1937;69;246;200;584;269;830
411320;201603;5301;15297;3941;12760;1006;3427;660;1936;1666;5363
411325;201603;1493;4713;1312;4330;276;977;624;2089;900;3066
411330;201603;2992;9252;2536;8372;802;2953;577;1922;1379;4875
411340;201603;904;2654;583;1899;55;215;193;589;248;804
411342;201603;693;1971;571;1727;159;515;178;488;337;1003
411345;201603;868;2723;776;2550;211;771;313;1020;524;1791
411350;201603;2625;7881;1934;6440;494;1825;182;583;676;2408
411360;201603;565;1427;386;1116;52;183;158;391;210;574
411370;201603;43291;121974;34148;105161;5506;19532;13668;39040;19174;58572
411373;201603;1432;4436;1243;4092;261;976;269;894;530;1870
411375;201603;1101;3031;812;2471;152;471;201;576;353;1047
411380;201603;1186;3226;707;2120;113;360;189;511;302;871
411390;201603;1789;5278;1490;4668;272;945;426;1213;698;2158
411400;201603;2035;5793;1555;4789;282;953;390;1134;672;2087
411410;201603;1962;5916;1525;4919;322;1148;347;979;669;2127
411420;201603;3820;10945;2667;8429;369;1309;375;943;744;2252
411430;201603;3012;9071;2514;8256;628;2295;1127;3615;1755;5910
411435;201603;426;1397;360;1230;82;302;138;459;220;761
411440;201603;2584;8318;2316;7788;727;2571;489;1775;1216;4346
411450;201603;2193;6743;1991;6354;402;1291;971;3247;1373;4538
411460;201603;3166;9203;1737;5946;264;1015;79;240;343;1255
411470;201603;817;2445;552;1821;79;284;74;213;153;497
411480;201603;4325;12986;3256;10939;819;3052;433;1369;1252;4421
411490;201603;1398;4236;1184;3858;239;842;263;786;502;1628
411500;201603;1808;4790;1262;3817;238;785;330;974;568;1759
411510;201603;1963;5893;1617;5180;432;1532;256;752;688;2284
411520;201603;25418;69181;15635;48860;2705;9142;3032;8974;5737;18116
411530;201603;998;2777;718;2292;156;582;120;332;276;914
411535;201603;502;1529;273;978;29;127;22;69;51;196
411540;201603;2896;7863;2125;6302;519;1759;516;1341;1035;3100
411545;201603;931;3113;851;2968;153;565;518;1864;671;2429
411550;201603;777;2102;629;1875;209;686;114;349;323;1035
411560;201603;2305;6830;1666;5370;275;998;163;445;438;1443
411570;201603;6414;17134;4778;14500;1093;3794;930;2924;2023;6718
411573;201603;829;2463;777;2372;134;424;457;1433;591;1857
411575;201603;1484;4578;1243;4067;246;847;428;1389;674;2236
411580;201603;3811;10815;2573;8344;312;1218;332;948;644;2166
411585;201603;712;2284;392;1381;85;306;64;220;149;526
411590;201603;341;1054;299;987;44;167;129;404;173;571
411600;201603;303;873;211;726;45;174;80;282;125;456
411605;201603;1645;4529;1149;3516;180;628;401;1203;581;1831
411610;201603;2122;5948;1740;5234;354;1165;808;2340;1162;3505
411620;201603;2560;8097;2346;7746;626;2247;1031;3450;1657;5697
411630;201603;477;1243;295;971;50;212;39;111;89;323
411640;201603;448;1365;360;1170;56;185;111;325;167;510
411650;201603;192;622;152;544;28;118;31;105;59;223
411660;201603;871;2352;662;1965;98;305;296;875;394;1180
411670;201603;1078;3029;887;2622;184;587;290;812;474;1399
411680;201603;1370;4177;1226;3918;177;600;758;2513;935;3113
411690;201603;3216;9451;2542;8194;656;2193;496;1690;1152;3883
411695;201603;766;2495;620;2173;141;553;181;628;322;1181
411700;201603;1679;4884;1186;3879;215;773;172;502;387;1275
411705;201603;1841;6374;1616;5926;372;1343;789;3088;1161;4431
411710;201603;1597;4713;1296;4095;319;1086;213;671;532;1757
411720;201603;853;2412;658;2017;93;320;182;501;275;821
411721;201603;697;2091;580;1852;151;523;64;188;215;711
411722;201603;646;1938;437;1464;87;345;101;286;188;631
411725;201603;1358;4357;878;3135;194;720;147;530;341;1250
411727;201603;1767;5206;1337;4269;324;1084;248;768;572;1852
411729;201603;556;1472;401;1189;127;383;60;153;187;536
411730;201603;5412;15561;4521;13842;1632;5059;1078;3310;2710;8369
411740;201603;620;1765;393;1259;64;222;128;387;192;609
411745;201603;868;2502;715;2194;129;421;223;689;352;1110
411750;201603;4607;13691;3514;11235;707;2466;991;3051;1698;5517
411760;201603;7491;21958;6448;20175;2074;6943;1481;4702;3555;11645
411770;201603;3286;10786;2739;9537;777;2940;479;1577;1256;4517
411780;201603;2729;8455;2494;8065;421;1478;1491;5026;1912;6504
411790;201603;3155;8972;2286;7189;597;2102;525;1568;1122;3670
411800;201603;1123;3240;776;2512;115;420;107;304;222;724
411810;201603;1579;4551;1299;3997;262;880;438;1248;700;2128
411820;201603;13035;42053;11014;37883;3769;13464;2340;8233;6109;21697
411830;201603;516;1355;408;1181;118;390;10;39;128;429
411840;201603;10018;28668;7485;23797;1656;5788;1251;3913;2907;9701
411845;201603;494;1508;314;1037;45;161;41;119;86;280
411850;201603;6763;20215;5582;17757;1365;4726;1391;4315;2756;9041
411860;201603;859;2636;693;2276;166;572;207;649;373;1221
411870;201603;840;2725;576;2011;108;451;101;306;209;757
411880;201603;2217;6402;1780;5634;415;1506;349;1011;764;2517
411885;201603;866;2392;723;2145;132;483;212;577;344;1060
411890;201603;1038;3173;701;2360;106;408;52;132;158;540
411900;201603;939;2943;673;2304;152;530;92;314;244;844
411910;201603;1168;3842;913;3238;257;969;198;648;455;1617
411915;201603;15441;42356;10021;31618;1809;6175;1982;5721;3791;11896
411920;201603;817;2775;714;2531;182;759;72;200;254;959
411925;201603;590;1680;391;1295;86;285;90;271;176;556
411930;201603;5816;18965;5121;17591;2227;8118;784;2703;3011;10821
411940;201603;3136;10473;2732;9596;674;2462;561;1941;1235;4403
411950;201603;11595;36672;9873;33354;2358;8473;4181;13921;6539;22394
411960;201603;5270;15678;4869;14942;1055;3626;1947;5823;3002;9449
411965;201603;566;1616;409;1347;70;278;117;401;187;679
411970;201603;717;2022;596;1834;164;536;224;749;388;1285
411980;201603;1614;4843;1400;4421;292;978;447;1427;739;2405
411990;201603;27919;89959;23457;80496;5957;22618;6216;20608;12173;43226
411995;201603;2342;7182;1992;6537;612;2249;412;1242;1024;3491
412000;201603;2074;5329;1616;4540;251;833;767;1956;1018;2789
412010;201603;683;2309;550;2014;85;328;111;385;196;713
412015;201603;639;1882;523;1644;87;285;242;772;329;1057
412020;201603;354;1032;239;776;46;162;66;197;112;359
412030;201603;700;2191;506;1751;80;308;113;374;193;682
412033;201603;746;2185;515;1642;79;281;113;347;192;628
412035;201603;963;2690;640;2095;135;467;202;661;337;1128
412040;201603;563;1767;443;1503;78;279;99;329;177;608
412050;201603;1691;4885;1296;4119;219;770;290;878;509;1648
412060;201603;6665;22768;6076;21575;1893;7274;1634;5723;3527;12997
412065;201603;798;2389;621;2013;128;460;161;480;289;940
412070;201603;1323;3558;975;2838;146;458;325;943;471;1401
412080;201603;1346;4181;825;2977;93;375;18;62;111;437
412085;201603;425;1236;153;534;27;102;20;58;47;160
412090;201603;4228;13273;3966;12816;709;2436;2193;7292;2902;9728
412100;201603;1862;5758;1530;5106;435;1601;341;1140;776;2741
412110;201603;1036;2905;693;2194;151;504;116;380;267;884
412120;201603;1629;5505;1408;5017;357;1407;419;1320;776;2727
412125;201603;617;2022;565;1923;127;473;196;636;323;1109
412130;201603;587;1741;428;1374;97;340;63;181;160;521
412135;201603;455;1286;305;979;64;217;89;273;153;490
412140;201603;1516;4556;1257;4021;268;916;235;706;503;1622
412150;201603;2824;8156;2443;7390;319;1094;1459;4316;1778;5410
412160;201603;1136;3626;724;2554;171;661;81;254;252;915
412170;201603;4409;13558;3610;12014;943;3412;1237;3911;2180;7323
412175;201603;1350;4522;1173;4134;273;1085;488;1699;761;2784
412180;201603;1583;4860;1181;4089;259;1029;327;1061;586;2090
412190;201603;3118;8881;2355;7523;535;1919;654;2177;1189;4096
412200;201603;2072;6601;1491;5101;285;1054;420;1435;705;2489
412210;201603;670;1841;402;1286;56;210;31;75;87;285
412215;201603;3512;10785;3161;10164;708;2272;1721;5750;2429;8022
412217;201603;1044;2960;919;2742;119;432;594;1666;713;2098
412220;201603;5435;17843;5201;17417;1525;5243;2430;8249;3955;13492
412230;201603;2690;8872;2340;8169;480;1892;633;2071;1113;3963
412240;201603;8540;21640;4940;15003;844;2862;823;2260;1667;5122
412250;201603;1828;5362;1562;4841;400;1330;200;530;600;1860
412260;201603;1275;3516;835;2589;119;414;275;761;394;1175
412265;201603;973;2988;856;2788;211;783;347;1124;558;1907
412270;201603;815;2574;544;1885;96;373;141;449;237;822
412280;201603;600;1863;445;1529;179;663;24;77;203;740
412290;201603;993;2840;764;2407;138;475;234;674;372;1149
412300;201603;1832;5521;1546;4975;405;1431;310;949;715;2380
412310;201603;997;2899;876;2710;114;422;429;1362;543;1784
412320;201603;824;2205;596;1806;102;371;191;562;293;933
412330;201603;1486;4260;1138;3532;189;660;497;1521;686;2181
412340;201603;906;2817;609;2061;77;284;83;241;160;525
412350;201603;2119;6580;1691;5634;337;1191;108;301;445;1492
412360;201603;284;851;178;582;19;75;55;152;74;227
412370;201603;888;2626;663;2214;149;550;123;406;272;956
412380;201603;1454;4654;1203;4043;288;1027;244;818;532;1845
412382;201603;660;1850;459;1434;77;246;95;258;172;504
412385;201603;2304;7207;2062;6654;675;2283;404;1280;1079;3563
412390;201603;2055;5876;1840;5529;477;1563;695;2155;1172;3718
412395;201603;790;2263;627;1992;75;274;343;1055;418;1329
412400;201603;874;2767;751;2489;200;716;158;537;358;1253
412402;201603;1792;5327;1450;4637;329;1177;266;763;595;1940
412405;201603;3495;10167;2209;7314;333;1256;125;370;458;1626
412410;201603;4675;14268;3858;12709;1071;4099;648;2014;1719;6113
412420;201603;333;991;239;773;40;135;74;199;114;334
412430;201603;517;1443;381;1182;52;177;134;385;186;562
412440;201603;3160;9623;2533;8493;551;2035;713;2423;1264;4458
412450;201603;303;970;232;782;34;105;16;38;50;143
412460;201603;703;2177;581;1909;161;571;108;344;269;915
412470;201603;1820;6239;1577;5607;521;1959;320;1194;841;3153
412480;201603;1088;3301;807;2626;135;465;90;225;225;690
412490;201603;832;2469;702;2207;127;411;185;568;312;979
412500;201603;1883;5447;1571;4831;290;1004;349;944;639;1948
412510;201603;2182;7099;1814;6208;524;1938;547;1842;1071;3780
412520;201603;1443;4072;1084;3343;251;816;186;528;437;1344
412530;201603;584;1717;452;1408;85;274;93;273;178;547
412535;201603;685;1992;461;1461;99;333;92;269;191;602
412540;201603;1216;3485;959;2977;137;496;272;841;409;1337
412545;201603;747;2133;562;1731;90;319;159;405;249;724
412550;201603;27856;83590;19492;64904;4334;15430;3541;11090;7875;26520
412555;201603;256;778;175;589;32;109;35;102;67;211
412560;201603;5017;15346;3931;13037;734;2901;1052;3310;1786;6211
412570;201603;4084;11997;2787;9195;602;2212;431;1451;1033;3663
412575;201603;837;2573;651;2125;128;476;163;474;291;950
412580;201603;1178;3271;843;2633;135;447;256;737;391;1184
412590;201603;407;1200;269;891;53;199;68;217;121;416
412600;201603;1384;4205;1071;3527;215;778;265;812;480;1590
412610;201603;697;2075;452;1443;112;377;107;307;219;684
412620;201603;1183;3779;938;3245;213;852;131;387;344;1239
412625;201603;9446;27050;7160;22598;1426;4846;831;2492;2257;7338
412627;201603;905;2811;644;2200;186;702;51;158;237;860
412630;201603;3185;10100;2576;8770;521;1810;706;2322;1227;4132
412635;201603;468;1386;327;1073;77;259;12;26;89;285
412640;201603;879;2654;594;1987;83;278;40;118;123;396
412650;201603;1669;4997;1403;4483;281;1031;381;1100;662;2131
412660;201603;2656;7683;2096;6546;403;1395;380;1052;783;2447
412665;201603;624;1628;351;1095;88;282;69;200;157;482
412667;201603;1620;4707;1276;4029;279;945;249;714;528;1659
412670;201603;522;1642;405;1390;98;378;64;200;162;578
412680;201603;1312;3937;825;2845;131;490;158;489;289;979
412690;201603;753;2286;563;1871;156;542;99;323;255;865
412700;201603;1799;5498;1511;5052;515;1965;376;1200;891;3165
412710;201603;6763;21274;5732;19195;1225;4604;1251;3853;2476;8457
412720;201603;1327;4095;946;3156;147;530;159;434;306;964
412730;201603;2002;6016;1228;4235;230;852;101;293;331;1145
412740;201603;1354;4314;1030;3605;227;890;137;527;364;1417
412750;201603;3923;11990;3494;11276;491;1906;2081;6591;2572;8497
412760;201603;2269;7290;2133;7049;408;1568;1186;3795;1594;5363
412770;201603;10668;29232;6184;19768;849;2963;979;2746;1828;5709
412780;201603;1224;3822;1059;3482;232;829;350;1111;582;1940
412785;201603;2251;6407;1683;5240;480;1549;676;2130;1156;3679
412788;201603;1352;4326;1184;3975;289;1097;347;1058;636;2155
412790;201603;1081;3215;804;2629;151;559;155;421;306;980
412795;201603;902;2517;723;2169;142;449;248;740;390;1189
412796;201603;2639;8130;2422;7732;576;2050;892;2670;1468;4720
412800;201603;2904;8396;2292;7080;365;1258;780;2285;1145;3543
412810;201603;10811;29367;6338;19830;809;2852;1285;3296;2094;6148
412820;201603;7075;20721;5269;17183;1158;4031;1146;3809;2304;7840
412830;201603;332;1037;265;876;43;169;67;189;110;358
412840;201603;1734;4978;1396;4287;263;873;250;755;513;1628
412850;201603;2773;8195;2308;7415;458;1720;799;2398;1257;4118
412853;201603;1647;4742;1461;4370;166;587;762;2121;928;2708
412855;201603;1435;4142;1123;3457;239;802;277;748;516;1550
412860;201603;1165;3340;954;2962;238;820;376;1149;614;1969
412862;201603;702;1844;485;1449;69;229;133;374;202;603
412863;201603;1147;3936;1117;3884;185;716;749;2557;934;3273
412865;201603;672;2058;512;1700;112;392;164;571;276;963
412870;201603;853;2423;674;2123;249;883;82;227;331;1110
412880;201603;861;2502;677;2139;157;535;99;286;256;821
420005;201603;525;1561;330;1124;49;175;109;367;158;542
420010;201603;3003;8621;2463;7866;367;1210;1643;5369;2010;6579
420020;201603;736;2387;420;1557;39;176;36;119;75;295
420030;201603;500;1304;254;843;44;176;28;92;72;268
420040;201603;694;2192;446;1661;83;339;29;93;112;432
420050;201603;648;1891;441;1464;130;455;128;423;258;878
420055;201603;205;627;119;417;20;78;18;61;38;139
420060;201603;240;784;164;599;24;111;30;82;54;193
420070;201603;1335;4219;1019;3455;165;644;373;1238;538;1882
420075;201603;168;443;88;268;17;57;15;38;32;95
420080;201603;582;1835;464;1607;145;540;105;367;250;907
420090;201603;469;1555;326;1241;76;309;52;210;128;519
420100;201603;1170;3665;1044;3490;244;854;566;1909;810;2763
420110;201603;319;1079;287;1005;68;252;101;352;169;604
420120;201603;260;910;209;791;66;276;33;115;99;391
420125;201603;243;900;215;838;58;239;86;310;144;549
420127;201603;540;1592;208;766;49;194;20;75;69;269
420130;201603;1750;5893;1430;5278;338;1369;288;969;626;2338
420140;201603;4443;13082;3150;10575;668;2484;408;1226;1076;3710
420150;201603;715;2003;432;1446;74;266;141;444;215;710
420160;201603;269;737;163;530;25;81;46;148;71;229
420165;201603;213;665;129;449;25;94;22;70;47;164
420170;201603;192;589;129;465;43;177;11;36;54;213
420180;201603;399;1212;221;797;36;139;41;141;77;280
420190;201603;451;1286;234;799;33;129;14;40;47;169
420195;201603;1269;3724;1036;3343;236;803;312;987;548;1790
420200;201603;2434;7612;1435;5300;247;1053;139;480;386;1533
420205;201603;894;2940;768;2731;174;666;389;1403;563;2069
420207;201603;1495;4374;1048;3457;280;1052;201;611;481;1663
420208;201603;564;1563;311;1112;98;387;62;241;160;628
420209;201603;315;964;205;704;32;121;76;257;108;378
420210;201603;1597;4901;1066;4024;270;1211;320;1162;590;2373
420213;201603;773;2776;729;2672;156;605;410;1521;566;2126
420215;201603;312;1017;209;773;51;204;14;63;65;267
420220;201603;151;530;122;466;30;124;26;88;56;212
420230;201603;4151;12021;3058;10085;586;2307;1159;3666;1745;5973
420240;201603;10328;28603;6459;21301;1017;4018;2440;7219;3457;11237
420243;201603;590;1790;468;1546;90;323;162;520;252;843
420245;201603;1085;3304;752;2591;114;433;222;712;336;1145
420250;201603;519;1671;471;1582;132;519;187;595;319;1114
420253;201603;484;1304;371;1151;57;184;205;658;262;842
420257;201603;304;843;191;635;34;115;91;305;125;420
420260;201603;1199;3773;982;3375;202;776;378;1292;580;2068
420270;201603;581;1777;199;713;29;119;45;141;74;260
420280;201603;2254;6094;1376;4517;273;986;435;1371;708;2357
420285;201603;152;452;74;278;10;42;3;15;13;57
420287;201603;509;1522;422;1386;127;426;125;418;252;844
420290;201603;6081;18039;4067;13426;739;2621;1101;3391;1840;6012
420300;201603;6453;19440;4250;14763;853;3259;635;2138;1488;5397
420310;201603;745;2065;665;1940;107;338;463;1323;570;1661
420315;201603;924;2937;724;2550;196;751;239;824;435;1575
420320;201603;4664;14316;3795;12784;1004;3691;1349;4550;2353;8241
420325;201603;230;786;207;725;42;165;76;252;118;417
420330;201603;955;3306;701;2666;167;692;153;538;320;1230
420340;201603;1409;4364;1072;3594;194;729;116;342;310;1071
420350;201603;1438;4299;1055;3553;278;985;358;1211;636;2196
420360;201603;2992;9073;1865;6619;376;1521;140;414;516;1935
420370;201603;1799;5151;1394;4436;164;542;975;3084;1139;3626
420380;201603;4959;15273;3371;11632;779;2931;713;2421;1492;5352
420390;201603;1368;3810;710;2426;105;425;105;290;210;715
420395;201603;1371;4214;954;3271;120;486;122;360;242;846
420400;201603;1237;3577;866;2859;212;813;187;543;399;1356
420410;201603;745;1998;518;1624;113;402;291;890;404;1292
420415;201603;454;1416;331;1124;95;346;90;296;185;642
420417;201603;693;2221;577;1939;99;340;284;961;383;1301
420419;201603;364;1099;237;848;80;320;17;69;97;389
420420;201603;10381;31282;8259;27221;2781;10196;1821;5513;4602;15709
420425;201603;1209;3256;833;2554;69;277;363;1039;432;1316
420430;201603;3226;9783;2056;7036;414;1537;601;2082;1015;3619
420435;201603;290;853;178;607;41;153;70;225;111;378
420440;201603;862;2672;497;1736;201;746;82;281;283;1027
420445;201603;365;1075;256;818;50;162;99;318;149;480
420450;201603;790;2389;524;1807;111;416;95;310;206;726
420455;201603;1885;5642;1620;5193;286;1141;745;2258;1031;3399
420460;201603;8415;24422;6328;20753;1366;5159;2229;6929;3595;12088
420470;201603;1046;2835;640;2035;137;489;173;511;310;1000
420475;201603;121;356;64;224;16;54;7;23;23;77
420480;201603;4724;13738;3460;11370;972;3432;585;1925;1557;5357
420490;201603;648;1681;349;1176;78;294;73;245;151;539
420500;201603;1512;4783;1162;4094;345;1370;360;1246;705;2616
420510;201603;80;304;69;288;16;74;32;127;48;201
420515;201603;106;356;84;312;13;57;16;59;29;116
420517;201603;812;2554;717;2391;142;518;361;1161;503;1679
420519;201603;548;1433;394;1165;62;200;105;296;167;496
420520;201603;641;1596;392;1238;80;266;120;318;200;584
420530;201603;1021;3388;752;2770;169;718;157;523;326;1241
420535;201603;260;749;140;497;32;124;4;13;36;137
420540;201603;19596;55759;14178;44530;3320;11447;3370;9142;6690;20589
420543;201603;386;1016;299;877;24;80;180;572;204;652
420545;201603;1481;4655;1182;4001;266;1013;349;1110;615;2123
420550;201603;4015;12703;2950;10494;733;3094;475;1545;1208;4639
420555;201603;352;1070;267;891;66;239;79;252;145;491
420560;201603;520;1502;385;1257;68;244;187;593;255;837
420570;201603;2065;6548;1602;5507;398;1569;504;1593;902;3162
420580;201603;1406;4308;1121;3824;280;1082;437;1453;717;2535
420590;201603;3053;9184;2026;6812;378;1401;270;799;648;2200
420600;201603;841;2751;761;2589;118;425;418;1478;536;1903
420610;201603;496;1515;275;1016;68;294;60;215;128;509
420620;201603;530;1635;472;1519;119;413;136;443;255;856
420630;201603;974;2986;689;2322;146;528;215;673;361;1201
420640;201603;768;2317;379;1383;76;320;19;58;95;378
420650;201603;2478;7184;1574;5335;252;974;358;1112;610;2086
420660;201603;457;1315;326;1044;63;221;101;316;164;537
420665;201603;680;1913;440;1451;65;232;113;335;178;567
420670;201603;1590;4711;1114;3717;204;803;270;821;474;1624
420675;201603;200;644;144;514;32;113;37;130;69;243
420680;201603;492;1164;283;841;48;163;88;245;136;408
420690;201603;827;2835;623;2285;106;418;100;315;206;733
420700;201603;3055;8944;2323;7489;469;1711;677;2040;1146;3751
420710;201603;552;1850;420;1571;112;478;122;438;234;916
420720;201603;1695;4815;1311;4313;339;1176;657;2180;996;3356
420730;201603;3144;9396;2547;8349;612;2203;950;2987;1562;5190
420740;201603;823;2536;676;2267;220;815;241;744;461;1559
420750;201603;2278;7270;1643;5772;256;1050;454;1432;710;2482
420757;201603;97;236;44;151;8;37;19;62;27;99
420760;201603;341;1059;197;664;37;136;36;104;73;240
420765;201603;543;1718;285;1068;54;237;46;159;100;396
420768;201603;1138;3968;890;3437;315;1260;280;1104;595;2364
420770;201603;628;1829;343;1259;75;322;63;231;138;553
420775;201603;627;1891;377;1285;81;290;60;185;141;475
420780;201603;1505;4519;910;3076;175;601;121;379;296;980
420785;201603;271;825;194;636;28;98;42;131;70;229
420790;201603;1255;4301;990;3693;285;1169;338;1185;623;2354
420800;201603;839;2390;418;1413;97;355;90;298;187;653
420810;201603;1987;6705;1569;5794;456;1923;323;1089;779;3012
420820;201603;7784;23070;5309;18868;1288;5178;1151;4023;2439;9201
420830;201603;2462;7790;2028;6991;617;2316;674;2315;1291;4631
420840;201603;986;2912;497;1791;109;466;74;230;183;696
420845;201603;1280;3864;921;3233;243;992;184;603;427;1595
420850;201603;1610;4996;972;3632;208;895;62;212;270;1107
420860;201603;445;1249;272;919;70;268;71;245;141;513
420870;201603;1115;3088;871;2710;292;1057;220;582;512;1639
420880;201603;988;3265;765;2697;146;559;129;413;275;972
420890;201603;10340;27173;5214;17064;834;2981;1144;3282;1978;6263
420895;201603;244;664;134;429;38;121;13;34;51;155
420900;201603;1816;5122;1164;3854;223;864;273;822;496;1686
420910;201603;22940;67905;15606;53298;2841;11012;4307;13578;7148;24590
420915;201603;547;2169;404;1743;86;396;169;688;255;1084
420917;201603;444;1388;208;710;40;160;73;209;113;369
420920;201603;181;507;74;258;11;42;12;46;23;88
420930;201603;17422;50155;13633;43788;3021;10813;4804;14932;7825;25745
420940;201603;2775;8390;2132;7091;566;2075;166;467;732;2542
420945;201603;198;625;129;468;21;95;32;109;53;204
420950;201603;606;1715;286;1070;39;192;39;138;78;330
420960;201603;881;2528;718;2240;138;476;303;895;441;1371
420970;201603;2447;7703;2023;6931;606;2305;530;1771;1136;4076
420980;201603;462;1340;340;1138;114;424;112;413;226;837
420985;201603;496;1413;233;842;43;192;47;147;90;339
420990;201603;877;2351;490;1645;84;316;94;261;178;577
421000;201603;555;1854;353;1334;69;273;54;173;123;446
421003;201603;716;1942;275;921;25;89;36;76;61;165
421005;201603;155;486;117;420;20;83;59;217;79;300
421010;201603;5272;14971;3658;12098;900;3342;683;2002;1583;5344
421020;201603;466;1449;360;1264;39;137;192;709;231;846
421030;201603;702;2561;639;2398;174;708;105;385;279;1093
421040;201603;854;2195;549;1718;95;354;263;781;358;1135
421050;201603;1628;4580;969;3207;168;607;189;541;357;1148
421055;201603;198;577;111;365;26;89;23;64;49;153
421060;201603;484;1644;327;1205;69;284;110;396;179;680
421070;201603;691;2214;439;1580;91;379;64;216;155;595
421080;201603;505;1523;424;1399;84;268;262;878;346;1146
421085;201603;538;1436;296;990;58;222;81;286;139;508
421090;201603;401;1124;200;680;26;100;67;209;93;309
421100;201603;888;2434;488;1567;129;421;56;168;185;589
421105;201603;1427;4380;1165;3932;258;932;392;1383;650;2315
421110;201603;976;3559;890;3360;322;1279;176;617;498;1896
421120;201603;1279;4092;862;3077;129;537;200;652;329;1189
421125;201603;398;1102;296;928;82;299;87;248;169;547
421130;201603;2955;9690;2505;8848;826;3245;739;2625;1565;5870
421140;201603;333;973;248;795;48;155;79;237;127;392
421145;201603;548;1736;343;1185;50;171;104;358;154;529
421150;201603;565;1655;403;1383;75;284;147;494;222;778
421160;201603;1205;3323;590;1940;115;416;186;580;301;996
421165;201603;275;939;219;779;35;127;87;315;122;442
421170;201603;1290;3783;1038;3390;210;753;588;1908;798;2661
421175;201603;1209;3403;877;2866;197;807;290;826;487;1633
421180;201603;564;1594;296;1020;62;244;47;155;109;399
421185;201603;390;1079;275;859;44;126;126;418;170;544
421187;201603;271;812;202;669;35;121;86;268;121;389
421189;201603;408;1254;353;1142;71;242;110;336;181;578
421190;201603;11395;32560;6915;23622;1349;5123;897;2911;2246;8034
421200;201603;877;2932;752;2676;162;624;201;671;363;1295
421205;201603;241;730;180;614;37;149;36;100;73;249
421210;201603;1487;4542;1112;3668;264;902;260;864;524;1766
421220;201603;1912;6476;1663;5926;478;1919;270;848;748;2767
421223;201603;513;1645;392;1387;102;382;108;376;210;758
421225;201603;1058;3365;896;3038;202;783;322;1080;524;1863
421227;201603;789;2570;700;2427;147;561;386;1310;533;1871
421230;201603;429;1412;379;1325;99;394;159;530;258;924
421240;201603;435;1406;255;931;32;146;37;124;69;270
421250;201603;1676;4850;1090;3814;291;1106;211;745;502;1851
421260;201603;352;1008;97;353;21;74;18;64;39;138
421265;201603;680;2112;592;1968;127;462;275;888;402;1350
421270;201603;798;2140;409;1358;79;278;75;293;154;571
421280;201603;1525;4797;1227;4302;350;1401;401;1346;751;2747
421290;201603;1184;3304;700;2289;118;422;105;301;223;723
421300;201603;293;883;228;746;65;244;84;255;149;499
421310;201603;230;727;181;612;35;128;52;164;87;292
421315;201603;359;1042;194;696;41;150;15;53;56;203
421320;201603;530;1701;357;1271;53;202;40;97;93;299
421330;201603;534;1730;410;1496;126;505;70;253;196;758
421335;201603;508;1672;418;1492;98;400;81;303;179;703
421340;201603;1730;4948;1381;4393;192;752;784;2473;976;3225
421350;201603;940;3107;783;2767;151;626;349;1167;500;1793
421360;201603;2953;8490;1888;6435;374;1491;508;1576;882;3067
421370;201603;670;2220;512;1870;139;577;148;522;287;1099
421380;201603;959;2716;792;2395;132;450;366;1082;498;1532
421390;201603;136;409;69;248;9;32;34;127;43;159
421400;201603;256;838;172;670;43;174;46;168;89;342
421410;201603;331;937;215;717;21;69;95;314;116;383
421415;201603;346;1130;163;605;39;157;28;92;67;249
421420;201603;853;2582;620;2059;112;400;169;529;281;929
421430;201603;236;731;178;615;29;109;37;134;66;243
421440;201603;818;2378;543;1874;127;496;205;693;332;1189
421450;201603;484;1486;304;1113;57;234;30;112;87;346
421460;201603;632;1717;330;1156;53;220;64;231;117;451
421470;201603;429;1426;337;1221;95;376;101;349;196;725
421480;201603;2970;8357;1840;6307;437;1775;295;834;732;2609
421490;201603;273;822;125;478;25;112;13;39;38;151
421500;201603;2131;7235;1770;6485;551;2258;218;762;769;3020
421505;201603;355;1200;309;1094;70;254;138;492;208;746
421507;201603;527;1587;337;1181;62;221;90;335;152;556
421510;201603;174;551;150;510;25;116;77;220;102;336
421520;201603;871;2305;588;1740;61;224;245;639;306;863
421530;201603;403;1231;239;866;39;182;58;209;97;391
421535;201603;679;2000;373;1371;57;245;149;515;206;760
421540;201603;320;883;252;771;53;178;91;255;144;433
421545;201603;804;2580;589;2163;134;556;129;466;263;1022
421550;201603;1912;6145;1599;5597;462;1818;441;1472;903;3290
421555;201603;322;939;114;403;19;74;14;45;33;119
421560;201603;209;640;94;326;18;68;18;60;36;128
421565;201603;831;2415;726;2265;252;879;283;882;535;1761
421567;201603;642;2367;576;2228;303;1213;114;438;417;1651
421568;201603;503;1556;336;1165;73;254;82;290;155;544
421569;201603;230;685;111;401;18;69;21;72;39;141
421570;201603;1346;4047;747;2617;181;705;112;365;293;1070
421575;201603;441;1457;386;1346;68;254;227;797;295;1051
421580;201603;2984;9418;2247;7790;544;2116;522;1632;1066;3748
421590;201603;217;671;176;596;20;60;92;310;112;370
421600;201603;553;1663;421;1380;98;349;80;236;178;585
421605;201603;604;1841;433;1521;85;356;105;340;190;696
421610;201603;1377;3743;1050;3196;153;523;520;1531;673;2054
421620;201603;4280;12973;2889;10094;792;2966;804;2825;1596;5791
421625;201603;372;1029;152;525;21;72;17;66;38;138
421630;201603;2898;8652;1644;5661;362;1377;191;591;553;1968
421635;201603;244;729;129;434;16;62;39;105;55;167
421640;201603;998;3021;738;2471;161;549;295;979;456;1528
421650;201603;2003;6447;1568;5473;409;1647;200;581;609;2228
421660;201603;7527;24275;6126;21456;1422;5576;1778;5775;3200;11351
421670;201603;1043;3207;728;2504;199;780;189;618;388;1398
421680;201603;1116;3608;925;3200;300;1104;164;540;464;1644
421690;201603;1614;5269;1236;4422;245;956;107;347;352;1303
421700;201603;492;1569;274;1000;45;177;55;149;100;326
421710;201603;222;747;111;409;28;103;28;98;56;201
421715;201603;259;689;137;439;35;121;33;91;68;212
421720;201603;1865;5488;1171;4068;304;1164;186;571;490;1735
421725;201603;105;346;95;323;26;94;21;66;47;160
421730;201603;581;1672;291;1001;46;171;46;129;92;300
421740;201603;734;2338;505;1797;110;456;78;226;188;682
421750;201603;974;2593;592;1847;115;401;242;686;357;1087
421755;201603;319;926;186;605;39;138;56;176;95;314
421760;201603;713;2257;388;1392;73;292;108;360;181;652
421770;201603;2865;8667;2179;7289;551;1935;674;2334;1225;4269
421775;201603;485;1415;340;1153;63;241;93;293;156;534
421780;201603;1189;3999;914;3356;217;884;269;944;486;1828
421790;201603;776;2107;443;1552;112;449;118;384;230;833
421795;201603;345;1018;219;705;36;135;54;172;90;307
421800;201603;2596;7738;1949;6518;414;1581;725;2269;1139;3850
421810;201603;578;1802;415;1479;110;424;38;132;148;556
421820;201603;1040;3011;652;2207;109;396;122;360;231;756
421825;201603;1412;4540;1313;4332;185;727;836;2633;1021;3360
421830;201603;2368;8130;2115;7619;476;1956;870;2985;1346;4941
421835;201603;147;430;104;367;22;101;61;203;83;304
421840;201603;270;875;195;704;49;202;47;156;96;358
421850;201603;397;1244;239;850;44;196;46;154;90;350
421860;201603;329;1005;214;772;35;132;41;127;76;259
421870;201603;3799;10691;2649;8431;787;2715;409;1267;1196;3982
421875;201603;421;1259;194;717;38;162;14;47;52;209
421880;201603;859;2636;644;2178;136;523;139;452;275;975
421885;201603;287;928;229;825;78;306;73;257;151;563
421890;201603;839;2859;727;2631;235;990;228;767;463;1757
421895;201603;356;1134;315;1062;76;269;163;555;239;824
421900;201603;915;2533;565;1809;149;515;137;392;286;907
421910;201603;493;1561;337;1204;68;281;47;138;115;419
421915;201603;502;1502;317;1077;56;189;71;227;127;416
421917;201603;559;1617;401;1380;133;521;111;371;244;892
421920;201603;755;2099;478;1725;251;954;96;347;347;1301
421930;201603;3060;8036;1694;5655;378;1388;242;722;620;2110
421935;201603;644;2123;471;1749;103;454;143;490;246;944
421940;201603;262;883;136;507;18;76;16;46;34;122
421950;201603;3548;9687;1704;5768;377;1409;200;676;577;2085
421960;201603;192;569;144;475;32;118;28;75;60;193
421970;201603;2170;6024;1352;4329;425;1439;331;971;756;2410
421985;201603;494;1274;277;854;40;155;82;253;122;408
422000;201603;1095;3271;919;2946;239;834;347;1145;586;1979
430003;201603;797;2317;611;2003;161;591;160;510;321;1101
430005;201603;319;946;232;785;43;160;100;323;143;483
430010;201603;2124;5710;1587;4808;392;1269;637;1948;1029;3217
430020;201603;711;1767;592;1611;79;233;362;952;441;1185
430030;201603;1014;2673;749;2188;250;800;123;330;373;1130
430040;201603;11025;28814;8434;24354;2261;7090;1330;3655;3591;10745
430045;201603;684;1845;515;1499;97;294;225;645;322;939
430047;201603;287;695;158;477;21;60;61;186;82;246
430050;201603;1237;3316;735;2314;137;455;162;480;299;935
430055;201603;300;803;160;495;26;90;65;189;91;279
430057;201603;68;156;31;89;4;9;4;5;8;14
430060;201603;16025;51068;13843;47338;3799;13955;5408;18714;9207;32669
430063;201603;990;2918;803;2532;194;640;387;1258;581;1898
430064;201603;1372;4114;1109;3635;274;919;407;1365;681;2284
430066;201603;164;397;119;329;8;28;66;175;74;203
430070;201603;593;1588;180;589;26;105;23;59;49;164
430080;201603;662;1859;403;1345;82;303;115;345;197;648
430085;201603;853;2233;564;1720;115;387;192;595;307;982
430087;201603;937;2866;866;2736;122;467;528;1558;650;2025
430090;201603;885;2324;356;1155;34;123;50;172;84;295
430100;201603;817;2152;424;1340;100;338;112;307;212;645
430105;201603;948;2805;638;2217;162;631;194;665;356;1296
430107;201603;256;836;188;647;35;131;45;142;80;273
430110;201603;1863;5340;1530;4825;398;1303;648;1997;1046;3300
430120;201603;1739;5121;1285;4189;261;883;574;1855;835;2738
430130;201603;3825;9913;3285;9137;785;2346;1303;3559;2088;5905
430140;201603;1195;3627;799;2725;216;762;225;770;441;1532
430150;201603;740;1974;503;1528;118;384;129;394;247;778
430155;201603;401;1110;223;730;33;128;60;195;93;323
430160;201603;16605;48274;14745;45192;3199;10791;6369;19568;9568;30359
430163;201603;1850;5470;1509;4870;240;853;734;2374;974;3227
430165;201603;456;1125;135;454;17;58;20;58;37;116
430170;201603;938;2638;371;1323;45;165;33;99;78;264
430175;201603;915;2838;752;2460;197;598;279;1006;476;1604
430180;201603;840;2310;682;2055;151;503;334;977;485;1480
430185;201603;587;1523;334;1047;51;172;97;246;148;418
430187;201603;650;1928;510;1651;111;410;169;515;280;925
430190;201603;1679;4978;1462;4562;280;963;801;2478;1081;3441
430192;201603;197;598;93;303;5;14;18;52;23;66
430195;201603;363;1110;96;331;8;28;4;12;12;40
430200;201603;1400;4497;1199;4082;345;1248;274;924;619;2172
430205;201603;552;1583;425;1353;41;164;299;951;340;1115
430210;201603;6140;16379;3636;11295;602;2048;801;2245;1403;4293
430215;201603;359;995;245;751;38;121;96;279;134;400
430220;201603;747;1885;270;918;42;174;45;148;87;322
430222;201603;270;820;212;696;33;131;97;297;130;428
430223;201603;340;962;292;890;66;206;166;530;232;736
430225;201603;35;86;15;43;5;14;5;15;10;29
430230;201603;1629;4867;1567;4803;183;418;1351;4321;1534;4739
430235;201603;279;914;228;793;49;187;67;218;116;405
430237;201603;521;1351;380;1116;40;140;238;673;278;813
430240;201603;975;2545;662;2020;104;383;306;880;410;1263
430245;201603;865;2674;655;2238;174;606;261;943;435;1549
430250;201603;1204;3432;1055;3192;368;1163;164;504;532;1667
430258;201603;164;456;121;381;10;34;52;172;62;206
430260;201603;774;2211;552;1776;61;206;292;987;353;1193
430265;201603;272;832;210;707;42;132;9;34;51;166
430270;201603;2918;8133;2509;7452;353;1203;1424;4058;1777;5261
430280;201603;4652;12560;3764;11024;944;2812;1517;4486;2461;7298
430290;201603;2418;6367;2213;6080;149;426;1895;5228;2044;5654
430300;201603;9022;26645;7499;23776;1820;6223;3039;9857;4859;16080
430310;201603;6229;18767;4849;16154;1165;4251;1661;5193;2826;9444
430320;201603;836;2439;542;1818;96;281;247;882;343;1163
430330;201603;662;1778;514;1502;148;418;194;547;342;965
430340;201603;705;1781;389;1274;63;230;199;642;262;872
430350;201603;6176;18872;5272;16979;1828;6100;1590;5043;3418;11143
430355;201603;386;952;153;465;24;79;19;54;43;133
430360;201603;1032;2732;864;2436;176;572;339;871;515;1443
430367;201603;262;673;163;503;48;174;50;142;98;316
430370;201603;509;1448;365;1157;94;325;73;202;167;527
430380;201603;863;2234;485;1569;138;493;127;409;265;902
430390;201603;3934;11052;2647;8469;509;1752;426;1318;935;3070
430400;201603;1391;3322;986;2682;311;869;328;844;639;1713
430410;201603;621;1671;446;1375;85;286;204;626;289;912
430420;201603;3600;10412;2838;8767;745;2363;1041;3179;1786;5542
430430;201603;752;2003;473;1497;129;442;108;350;237;792
430435;201603;2007;5437;1510;4555;385;1226;530;1615;915;2841
430440;201603;3929;12387;3086;10457;628;2230;1382;4855;2010;7085
430450;201603;7551;20897;6039;18056;1973;6265;1317;3952;3290;10217
430460;201603;27993;82656;21620;71340;5777;20966;6044;19588;11821;40554
430461;201603;510;1363;164;529;24;80;30;91;54;171
430462;201603;282;803;196;654;36;143;27;88;63;231
430463;201603;4052;12880;3498;11863;756;2731;1575;5475;2331;8206
430465;201603;641;1726;535;1553;162;514;256;718;418;1232
430466;201603;3546;9784;3110;9121;614;1954;1684;4805;2298;6759
430467;201603;505;1493;436;1369;89;298;175;522;264;820
430468;201603;1397;3903;1200;3611;326;1053;446;1287;772;2340
430469;201603;431;1152;61;213;9;39;9;23;18;62
430470;201603;7567;20208;5382;16575;1523;5107;823;2457;2346;7564
430471;201603;580;1914;508;1762;154;531;125;476;279;1007
430480;201603;960;2501;483;1534;70;246;109;328;179;574
430485;201603;212;584;99;314;13;45;20;52;33;97
430490;201603;316;894;207;669;46;159;89;290;135;449
430495;201603;373;1106;240;829;48;181;46;142;94;323
430500;201603;1185;3299;959;2925;257;879;406;1213;663;2092
430510;201603;20127;58895;16286;51752;5311;18447;4224;12490;9535;30937
430511;201603;402;1234;176;623;27;104;17;43;44;147
430512;201603;1159;2981;982;2673;242;685;304;880;546;1565
430513;201603;784;2045;468;1390;94;293;170;496;264;789
430515;201603;472;1366;344;1104;50;166;155;519;205;685
430517;201603;1159;3656;968;3266;185;645;511;1769;696;2414
430520;201603;1520;4191;1041;3224;262;890;278;769;540;1659
430530;201603;1114;2997;544;1748;67;257;128;378;195;635
430535;201603;2225;6737;1714;5737;370;1371;580;1879;950;3250
430537;201603;482;1542;415;1407;39;125;296;1023;335;1148
430540;201603;735;1635;488;1298;93;258;268;717;361;975
430543;201603;486;1264;424;1200;79;232;297;861;376;1093
430544;201603;649;2089;548;1883;110;398;269;914;379;1312
430545;201603;1283;4086;1099;3860;377;1427;426;1527;803;2954
430550;201603;627;1813;379;1268;78;285;80;263;158;548
430558;201603;85;243;43;147;9;41;9;31;18;72
430560;201603;376;922;210;637;14;53;63;175;77;228
430570;201603;1105;2843;707;2060;170;586;255;620;425;1206
430580;201603;1248;3110;754;2301;163;558;278;859;441;1417
430583;201603;166;459;53;175;2;11;5;18;7;29
430585;201603;331;857;213;611;51;174;80;195;131;369
430587;201603;190;594;163;538;49;171;42;149;91;320
430590;201603;1184;3415;1113;3306;161;526;751;2192;912;2718
430593;201603;25;96;23;89;5;25;10;34;15;59
430595;201603;245;661;76;258;8;34;6;16;14;50
430597;201603;332;966;242;755;28;95;60;159;88;254
430600;201603;2079;5571;1183;3586;212;693;356;1017;568;1710
430605;201603;1336;4013;1048;3426;236;903;402;1313;638;2216
430607;201603;757;1853;563;1565;80;238;337;969;417;1207
430610;201603;8144;21806;6295;18932;1734;5630;1667;4963;3401;10593
430613;201603;275;660;118;355;22;60;21;53;43;113
430620;201603;698;1997;558;1710;153;490;197;579;350;1069
430630;201603;432;1343;217;738;37;123;22;66;59;189
430632;201603;698;1943;369;1163;54;192;130;352;184;544
430635;201603;587;1696;452;1419;90;318;237;719;327;1037
430637;201603;483;1371;425;1258;61;210;252;707;313;917
430640;201603;1615;4323;735;2439;64;213;28;59;92;272
430642;201603;463;1237;289;914;57;192;105;332;162;524
430645;201603;269;632;105;305;15;40;22;65;37;105
430650;201603;1827;5878;1553;5335;328;1161;840;2950;1168;4111
430655;201603;159;403;135;355;20;72;73;159;93;231
430660;201603;5609;15805;4491;13867;1084;3662;1741;5343;2825;9005
430670;201603;490;1425;446;1348;38;114;332;1044;370;1158
430673;201603;717;1695;342;1027;76;227;96;297;172;524
430675;201603;260;764;104;349;13;52;41;133;54;185
430676;201603;3437;10310;2829;9196;748;2617;795;2642;1543;5259
430680;201603;1189;3398;736;2427;131;444;164;480;295;924
430690;201603;4332;12164;3433;10427;1066;3378;815;2489;1881;5867
430692;201603;274;915;204;779;19;88;136;503;155;591
430693;201603;1283;3550;850;2670;167;605;180;522;347;1127
430695;201603;562;1576;386;1225;74;259;145;434;219;693
430697;201603;480;1349;355;1124;96;318;120;392;216;710
430700;201603;10220;26200;5154;16601;856;3150;290;870;1146;4020
430705;201603;275;844;238;770;83;289;61;183;144;472
430710;201603;1765;4507;1324;3766;280;885;488;1412;768;2297
430720;201603;892;2161;574;1703;133;428;178;525;311;953
430730;201603;1609;4215;1090;3375;263;807;390;1300;653;2107
430740;201603;543;1528;316;1070;79;289;45;156;124;445
430745;201603;507;1438;261;838;40;143;32;97;72;240
430750;201603;1557;4275;1224;3721;227;776;634;1877;861;2653
430755;201603;499;1342;332;1000;29;92;131;372;160;464
430760;201603;3005;7309;2035;5911;468;1623;702;2108;1170;3731
430770;201603;6227;18032;4900;15573;934;3227;2495;7833;3429;11060
430780;201603;2466;6523;1477;4684;286;982;406;1236;692;2218
430781;201603;534;1532;358;1183;71;233;92;310;163;543
430783;201603;545;1334;341;989;62;197;144;382;206;579
430786;201603;74;245;50;185;7;29;12;38;19;67
430790;201603;4682;12710;3275;9937;701;2362;1170;3296;1871;5658
430800;201603;901;2556;607;1894;129;436;188;556;317;992
430805;201603;538;1489;350;1113;38;116;168;541;206;657
430807;201603;427;1241;287;922;62;233;66;197;128;430
430810;201603;730;1915;298;980;46;175;65;183;111;358
430820;201603;1256;3807;813;2769;162;593;183;619;345;1212
430825;201603;398;1031;152;464;22;55;27;63;49;118
430830;201603;1743;5383;1610;5190;240;855;1039;3320;1279;4175
430840;201603;962;2915;876;2762;227;728;406;1321;633;2049
430843;201603;97;268;52;169;5;21;15;44;20;65
430845;201603;305;923;252;811;109;371;20;52;129;423
430850;201603;2460;7233;2062;6487;491;1697;786;2420;1277;4117
430860;201603;1011;2715;512;1683;134;511;157;474;291;985
430865;201603;633;1663;563;1551;198;575;252;674;450;1249
430870;201603;707;1963;398;1299;98;325;58;148;156;473
430880;201603;1174;3322;835;2657;228;774;208;711;436;1485
430885;201603;239;577;135;420;16;52;87;274;103;326
430890;201603;1768;4677;1256;3788;179;674;323;878;502;1552
430900;201603;2822;7425;2310;6568;491;1654;1036;2732;1527;4386
430905;201603;1040;2941;658;2134;148;514;128;390;276;904
430910;201603;1540;4520;1050;3477;230;860;367;1089;597;1949
430912;201603;469;1327;363;1144;49;174;221;692;270;866
430915;201603;578;1819;398;1467;123;491;89;351;212;842
430920;201603;15791;47787;13941;44356;2790;9881;7707;23828;10497;33709
430925;201603;102;240;49;147;12;41;17;51;29;92
430930;201603;9727;27473;6689;21823;1760;6181;1440;4936;3200;11117
430940;201603;1251;3767;742;2514;153;552;112;362;265;914
430950;201603;991;2736;655;2043;149;522;231;640;380;1162
430955;201603;145;439;69;227;13;50;17;51;30;101
430957;201603;254;837;205;747;45;160;99;390;144;550
430960;201603;1368;3668;1119;3230;259;827;529;1566;788;2393
430965;201603;1496;4265;1280;3908;77;293;990;2966;1067;3259
430970;201603;513;1405;302;964;50;168;80;244;130;412
430975;201603;598;1938;468;1642;84;308;203;737;287;1045
430980;201603;430;1070;260;818;65;216;78;242;143;458
430990;201603;553;1753;385;1312;77;271;87;286;164;557
430995;201603;590;1722;467;1468;154;503;146;428;300;931
431000;201603;1578;4020;805;2490;127;442;65;170;192;612
431010;201603;2644;7437;1626;5456;273;1009;235;713;508;1722
431020;201603;11128;27304;7192;20439;1706;5012;1713;4817;3419;9829
431030;201603;328;948;160;573;39;152;22;82;61;234
431033;201603;2369;6889;2088;6490;556;1850;966;3082;1522;4932
431036;201603;201;518;80;273;16;58;13;34;29;92
431040;201603;914;2595;726;2279;154;557;348;1047;502;1604
431041;201603;523;1421;472;1354;158;459;180;546;338;1005
431043;201603;477;1352;269;945;116;451;53;155;169;606
431046;201603;109;309;76;240;9;34;23;68;32;102
431050;201603;1678;4269;1276;3597;286;858;641;1787;927;2645
431053;201603;589;1906;482;1667;143;537;99;350;242;887
431055;201603;656;1767;608;1689;62;171;452;1266;514;1437
431057;201603;373;1090;227;770;40;143;57;179;97;322
431060;201603;5535;16365;4935;15453;1566;4980;1803;5867;3369;10847
431065;201603;548;1564;408;1291;77;272;155;457;232;729
431070;201603;706;2011;417;1359;88;294;66;183;154;477
431075;201603;290;881;205;695;36;134;57;207;93;341
431080;201603;636;1943;475;1564;89;331;128;406;217;737
431085;201603;845;2302;656;1900;108;331;342;987;450;1318
431087;201603;587;1654;504;1492;59;169;334;1008;393;1177
431090;201603;516;1265;248;749;60;190;49;146;109;336
431100;201603;3648;10121;2942;8926;757;2484;924;2765;1681;5249
431110;201603;1540;4073;1141;3290;256;771;396;1064;652;1835
431112;201603;559;1812;516;1728;133;454;240;789;373;1243
431113;201603;502;1444;395;1242;99;329;111;362;210;691
431115;201603;1382;3984;1208;3695;230;736;673;2076;903;2812
431120;201603;2639;8072;2064;6951;638;2464;633;1933;1271;4397
431123;201603;452;1302;305;1021;58;198;168;575;226;773
431125;201603;1362;4120;1012;3388;304;998;221;825;525;1823
431127;201603;256;690;63;209;4;9;8;19;12;28
431130;201603;3296;9415;2401;7755;467;1680;761;2432;1228;4112
431140;201603;4746;11652;2671;8195;394;1341;640;1734;1034;3075
431142;201603;444;1319;394;1225;40;125;263;845;303;970
431150;201603;1106;3309;846;2787;187;704;280;902;467;1606
431160;201603;897;2626;744;2324;136;402;364;1254;500;1656
431162;201603;532;1364;244;813;31;127;22;45;53;172
431164;201603;171;473;54;196;8;33;4;16;12;49
431170;201603;708;1957;503;1595;138;468;129;399;267;867
431171;201603;775;2284;670;2078;208;677;190;570;398;1247
431173;201603;455;1311;386;1196;118;391;168;513;286;904
431175;201603;1025;2864;863;2597;252;811;244;708;496;1519
431177;201603;812;2645;643;2317;208;845;251;883;459;1728
431179;201603;372;809;98;286;13;42;20;53;33;95
431180;201603;2258;6469;1561;5058;384;1328;308;937;692;2265
431190;201603;628;1750;374;1208;54;197;78;233;132;430
431198;201603;359;1177;323;1104;121;434;81;291;202;725
431200;201603;396;1113;119;408;15;49;4;10;19;59
431205;201603;292;876;138;477;33;105;36;135;69;240
431210;201603;755;2030;626;1811;179;506;297;897;476;1403
431213;201603;231;715;179;613;31;123;80;275;111;398
431215;201603;281;833;154;536;25;84;9;25;34;109
431217;201603;173;536;130;442;38;137;46;161;84;298
431220;201603;906;2434;547;1689;53;179;236;681;289;860
431225;201603;1351;3753;1075;3265;236;764;439;1310;675;2074
431230;201603;852;2439;640;2009;81;270;315;970;396;1240
431235;201603;111;313;33;106;6;21;5;11;11;32
431237;201603;492;1435;387;1281;81;329;210;672;291;1001
431238;201603;42;135;34;117;9;35;8;28;17;63
431240;201603;2955;8736;2616;8239;815;2757;859;2685;1674;5442
431242;201603;362;1145;315;1057;91;314;106;375;197;689
431244;201603;378;865;226;617;28;94;113;280;141;374
431245;201603;1167;3035;826;2425;127;391;408;1171;535;1562
431247;201603;190;546;138;436;38;120;24;67;62;187
431250;201603;1498;4774;1305;4506;355;1335;501;1739;856;3074
431260;201603;346;970;170;597;25;109;48;153;73;262
431261;201603;244;830;212;757;35;165;82;259;117;424
431262;201603;413;1109;186;594;25;100;80;257;105;357
431265;201603;1434;3693;783;2389;148;493;182;455;330;948
431267;201603;177;480;140;423;31;110;80;220;111;330
431270;201603;2750;6887;1803;5360;440;1456;579;1741;1019;3197
431275;201603;222;671;123;449;33;123;12;44;45;167
431280;201603;325;907;134;450;15;58;22;49;37;107
431290;201603;315;958;233;770;49;192;37;102;86;294
431295;201603;93;257;47;147;3;10;16;46;19;56
431300;201603;402;1011;73;275;7;25;2;9;9;34
431301;201603;267;821;120;410;21;73;17;50;38;123
431303;201603;750;1981;433;1326;59;210;123;349;182;559
431306;201603;2291;5916;1463;4467;156;584;400;1045;556;1629
431308;201603;41;140;37;126;22;80;9;29;31;109
431310;201603;752;2237;466;1591;81;283;131;476;212;759
431320;201603;785;2154;406;1348;67;233;80;251;147;484
431330;201603;2816;6877;1397;4369;349;1246;80;207;429;1453
431333;201603;420;1130;176;539;22;77;36;91;58;168
431335;201603;54;167;39;134;12;41;6;13;18;54
431337;201603;2373;7227;1803;6101;398;1454;269;873;667;2327
431339;201603;588;1594;401;1221;77;241;181;550;258;791
431340;201603;23751;63341;17502;52566;3940;12796;4145;12380;8085;25176
431342;201603;537;1359;420;1172;131;417;205;525;336;942
431344;201603;353;971;251;789;12;33;187;606;199;639
431346;201603;319;815;138;422;29;92;18;53;47;145
431349;201603;721;2052;480;1479;91;288;155;457;246;745
431350;201603;4031;11771;3287;10421;672;2399;1174;3498;1846;5897
431360;201603;643;1648;420;1273;98;321;130;407;228;728
431365;201603;1230;3650;1051;3356;238;817;521;1708;759;2525
431370;201603;4858;13655;3790;11815;1079;3623;1033;3315;2112;6938
431380;201603;919;2864;852;2724;122;436;509;1599;631;2035
431390;201603;3169;8251;1878;5825;338;1183;470;1291;808;2474
431395;201603;1224;3652;1036;3333;232;817;480;1522;712;2339
431400;201603;348;1097;171;590;35;136;25;75;60;211
431402;201603;1278;3004;746;2086;147;428;335;902;482;1330
431403;201603;253;728;185;613;54;186;31;102;85;288
431405;201603;3931;11060;3237;10032;617;2136;1641;4998;2258;7134
431406;201603;740;2263;552;1878;146;524;238;806;384;1330
431407;201603;536;1530;354;1179;73;240;94;295;167;535
431410;201603;13831;39408;9425;30960;2651;9817;1066;3358;3717;13175
431413;201603;218;537;92;292;6;21;27;77;33;98
431415;201603;719;2022;507;1627;123;444;159;461;282;905
431417;201603;565;1430;467;1295;60;179;280;771;340;950
431420;201603;1358;3734;1196;3488;248;746;517;1604;765;2350
431430;201603;521;1357;320;963;61;202;100;258;161;460
431440;201603;22310;62258;18270;55844;5273;17074;5420;17589;10693;34663
431442;201603;123;358;78;254;10;37;8;19;18;56
431445;201603;519;1467;231;747;31;95;75;227;106;322
431446;201603;418;1236;302;1001;69;240;94;307;163;547
431447;201603;568;1628;438;1367;86;271;196;631;282;902
431449;201603;778;2160;618;1884;59;184;352;1091;411;1275
431450;201603;2176;5397;1897;4999;287;840;1324;3381;1611;4221
431454;201603;63;222;55;201;13;52;23;89;36;141
431455;201603;711;1789;381;1082;96;275;88;227;184;502
431460;201603;3329;9184;2835;8241;740;2171;860;2646;1600;4817
431470;201603;1750;5175;1336;4262;309;976;431;1413;740;2389
431475;201603;192;562;45;180;7;29;1;3;8;32
431477;201603;725;1896;480;1396;58;190;245;677;303;867
431478;201603;263;680;99;293;16;47;15;31;31;78
431480;201603;2896;8055;2211;6844;564;1918;788;2318;1352;4236
431490;201603;108522;292547;92495;268732;11244;38419;62395;176481;73639;214900
431500;201603;596;1656;466;1397;97;290;235;705;332;995
431505;201603;497;1198;335;962;23;58;206;606;229;664
431507;201603;355;874;214;602;40;105;112;317;152;422
431510;201603;1886;5283;1475;4455;328;1048;489;1365;817;2413
431513;201603;301;818;146;467;17;57;69;221;86;278
431514;201603;112;300;46;163;4;18;9;33;13;51
431515;201603;639;1879;437;1405;96;342;146;419;242;761
431517;201603;77;246;63;210;10;34;13;37;23;71
431520;201603;521;1319;245;792;41;160;29;85;70;245
431530;201603;4266;10040;3213;8810;1054;3140;909;2596;1963;5736
431531;201603;263;766;179;587;30;102;56;188;86;290
431532;201603;487;1350;405;1177;96;297;150;421;246;718
431535;201603;348;910;151;471;25;86;51;138;76;224
431540;201603;2037;6753;1793;6386;184;670;1148;4317;1332;4987
431545;201603;342;947;53;179;5;19;7;22;12;41
431550;201603;2218;6503;1955;6045;381;1323;854;2550;1235;3873
431555;201603;685;1726;521;1464;76;216;310;897;386;1113
431560;201603;20015;59233;14340;48419;3389;12822;3006;10698;6395;23520
431570;201603;5789;14894;4637;13409;1280;3813;1923;5741;3203;9554
431575;201603;405;1030;294;860;44;147;64;167;108;314
431580;201603;620;1749;387;1258;78;272;108;328;186;600
431590;201603;950;2575;588;1860;99;312;189;616;288;928
431595;201603;440;1261;350;1075;41;124;210;661;251;785
431600;201603;1962;5398;1408;4415;306;1130;330;974;636;2104
431610;201603;1435;4146;1056;3421;188;626;395;1309;583;1935
431620;201603;474;1397;242;772;53;170;91;268;144;438
431630;201603;1411;3781;902;2729;251;803;252;721;503;1524
431640;201603;6097;17170;5441;16205;1207;3855;2954;8859;4161;12714
431642;201603;499;1344;390;1155;56;183;181;521;237;704
431643;201603;277;709;154;432;21;65;52;123;73;188
431645;201603;1677;4810;1439;4406;261;894;814;2442;1075;3336
431647;201603;153;443;103;339;17;64;13;35;30;99
431650;201603;326;991;227;779;29;120;53;154;82;274
431660;201603;1140;3216;712;2355;134;478;128;367;262;845
431670;201603;1263;3332;947;2779;203;680;378;1020;581;1700
431673;201603;230;632;125;401;22;74;15;39;37;113
431675;201603;594;1559;147;492;21;71;24;70;45;141
431680;201603;9606;26023;7266;21793;1946;6260;1655;5038;3601;11298
431690;201603;23258;64573;18289;56367;4911;16199;5757;18320;10668;34519
431695;201603;137;420;95;314;19;61;22;55;41;116
431697;201603;447;1289;396;1192;104;318;179;559;283;877
431700;201603;1531;4359;1308;3939;219;688;693;2046;912;2734
431710;201603;12486;35904;10192;32268;3262;11157;2197;7591;5459;18748
431720;201603;7066;19469;5391;16287;1169;3823;1775;5278;2944;9101
431725;201603;15;42;6;20;1;4;2;4;3;8
431730;201603;3874;11246;3074;9849;793;2810;781;2623;1574;5433
431740;201603;5215;14482;4143;12576;1327;4435;662;1810;1989;6245
431750;201603;8951;25370;7769;23479;1797;5912;3497;10686;5294;16598
431755;201603;333;908;81;279;13;46;12;36;25;82
431760;201603;3814;10938;3065;9580;643;2200;1148;3422;1791;5622
431770;201603;1991;5305;1636;4768;296;885;913;2641;1209;3526
431775;201603;207;556;138;425;38;117;12;29;50;146
431780;201603;2424;6538;1839;5459;450;1436;383;1046;833;2482
431790;201603;1160;3524;950;3120;150;548;519;1719;669;2267
431795;201603;379;1020;226;684;36;115;70;209;106;324
431800;201603;8669;25443;6920;22215;2087;7254;1001;3130;3088;10384
431805;201603;337;812;108;356;18;67;15;48;33;115
431810;201603;3178;8748;2477;7388;455;1490;1058;3060;1513;4550
431820;201603;2487;7752;2157;7120;426;1542;892;2851;1318;4393
431830;201603;10703;26123;8310;22624;2325;6896;2940;8102;5265;14998
431840;201603;2643;7912;2286;7308;582;2002;954;3097;1536;5099
431842;201603;804;2015;346;1057;43;146;74;195;117;341
431843;201603;353;1021;289;902;41;143;141;427;182;570
431844;201603;277;751;93;307;21;76;18;46;39;122
431845;201603;482;1426;377;1200;24;82;235;751;259;833
431846;201603;322;990;277;921;25;96;190;629;215;725
431848;201603;247;660;144;459;16;56;32;91;48;147
431849;201603;459;1114;102;306;16;50;16;36;32;86
431850;201603;4749;13858;4155;12733;1000;3269;1473;4484;2473;7753
431860;201603;776;2051;571;1680;99;326;274;764;373;1090
431861;201603;95;271;48;165;6;18;6;15;12;33
431862;201603;470;1532;379;1364;104;435;101;332;205;767
431870;201603;17642;51023;14070;44672;3424;11798;4370;13952;7794;25750
431880;201603;4237;12613;3414;10910;801;2834;1153;3475;1954;6309
431890;201603;5037;13630;3686;11220;1099;3533;833;2653;1932;6186
431900;201603;1055;2955;696;2223;178;655;260;756;438;1411
431910;201603;1013;2411;490;1406;72;207;133;358;205;565
431912;201603;493;1434;403;1273;118;358;144;473;262;831
431915;201603;1289;3489;990;2954;221;690;357;1085;578;1775
431920;201603;1278;3602;1105;3330;125;384;778;2339;903;2723
431930;201603;1236;3363;862;2744;226;694;381;1295;607;1989
431935;201603;52;163;43;142;12;47;15;41;27;88
431936;201603;382;1109;285;898;62;200;111;362;173;562
431937;201603;331;864;187;570;43;150;24;63;67;213
431940;201603;2544;6908;1689;5227;369;1226;408;1240;777;2466
431950;201603;1601;4887;1407;4538;252;913;649;2020;901;2933
431960;201603;2840;8211;2486;7535;625;1960;775;2334;1400;4294
431970;201603;464;1293;221;747;35;136;46;142;81;278
431971;201603;96;281;64;221;7;26;14;45;21;71
431973;201603;463;1603;409;1492;64;231;243;927;307;1158
431975;201603;106;249;21;84;7;33;2;6;9;39
431980;201603;1380;4037;1124;3530;259;865;334;1004;593;1869
431990;201603;7120;19861;5385;16975;938;3396;1561;4666;2499;8062
432000;201603;9696;27036;7689;23651;2425;7790;2347;7173;4772;14963
432010;201603;2171;6103;1769;5396;359;1171;819;2486;1178;3657
432020;201603;2288;5527;1723;4748;244;733;1135;3079;1379;3812
432023;201603;509;1457;330;1066;66;229;103;297;169;526
432026;201603;1208;3651;893;2988;147;483;435;1461;582;1944
432030;201603;401;1171;299;944;54;160;146;456;200;616
432032;201603;603;1554;396;1184;67;218;171;469;238;687
432035;201603;817;2477;731;2332;281;972;234;761;515;1733
432040;201603;994;2308;471;1440;82;275;124;367;206;642
432045;201603;246;694;141;486;21;75;40;135;61;210
432050;201603;628;1739;538;1584;83;244;295;899;378;1143
432055;201603;871;2538;676;2179;127;430;355;1129;482;1559
432057;201603;405;977;306;815;52;129;186;486;238;615
432060;201603;510;1331;202;679;36;134;42;129;78;263
432065;201603;211;611;161;521;40;147;58;172;98;319
432067;201603;969;2975;722;2463;141;502;331;1133;472;1635
432070;201603;2339;6468;1557;4893;323;1108;291;845;614;1953
432080;201603;3673;10391;3093;9393;984;3218;937;2841;1921;6059
432085;201603;309;857;201;680;44;157;96;322;140;479
432090;201603;1416;4021;1093;3393;313;1039;388;1152;701;2191
432100;201603;1321;3804;652;2221;95;331;44;112;139;443
432110;201603;2640;7958;1971;6602;469;1799;194;591;663;2390
432120;201603;4708;13819;3958;12547;1442;4856;961;2967;2403;7823
432130;201603;2611;7291;2129;6669;732;2529;714;2239;1446;4768
432132;201603;395;1097;196;669;25;97;56;182;81;279
432135;201603;654;2052;622;1992;78;286;458;1435;536;1721
432140;201603;1893;6041;1492;5262;336;1256;595;2212;931;3468
432143;201603;1366;3989;1137;3606;207;663;524;1749;731;2412
432145;201603;1216;3697;759;2651;114;439;113;361;227;800
432146;201603;171;561;121;443;30;123;21;78;51;201
432147;201603;638;2017;479;1673;126;479;122;445;248;924
432149;201603;361;1012;231;703;48;143;82;257;130;400
432150;201603;3634;10170;2722;8531;576;2020;761;2298;1337;4318
432160;201603;4332;13624;3772;12644;1152;4087;1257;4358;2409;8445
432162;201603;394;940;75;235;10;36;10;23;20;59
432163;201603;362;968;94;301;5;18;4;12;9;30
432166;201603;672;1981;554;1746;76;283;258;776;334;1059
432170;201603;1069;3318;718;2566;138;508;127;444;265;952
432180;201603;2749;7362;1813;5591;412;1330;389;1158;801;2488
432183;201603;414;1280;325;1098;129;468;57;182;186;650
432185;201603;878;2356;555;1768;107;355;227;736;334;1091
432190;201603;3304;8979;2171;6560;481;1515;563;1601;1044;3116
432195;201603;1080;2943;841;2562;117;356;461;1367;578;1723
432200;201603;3030;9032;2420;7998;589;2126;1014;3388;1603;5514
432210;201603;418;1149;304;962;76;275;112;330;188;605
432215;201603;844;2573;716;2370;140;424;406;1451;546;1875
432218;201603;271;686;172;496;27;77;61;153;88;230
432220;201603;4163;11008;3421;9843;395;1350;2081;5803;2476;7153
432225;201603;69;223;61;208;25;92;18;60;43;152
432230;201603;1037;2778;624;1876;126;409;145;358;271;767
432232;201603;512;1451;399;1230;71;228;154;475;225;703
432234;201603;364;1007;239;738;48;151;59;175;107;326
432235;201603;107;302;39;127;9;32;1;1;10;33
432237;201603;462;1250;422;1188;17;70;311;847;328;917
432240;201603;13745;42859;11487;39923;1779;7307;6619;23779;8398;31086
432250;201603;4617;15686;4182;14830;1324;5110;1270;4578;2594;9688
432252;201603;389;1055;266;856;47;162;134;451;181;613
432253;201603;1309;4136;791;2774;187;709;74;265;261;974
432254;201603;836;2263;245;809;54;197;28;81;82;278
432255;201603;194;526;119;394;24;85;35;108;59;193
432260;201603;7522;18656;5273;15041;1174;3443;2013;6032;3187;9475
432270;201603;2548;7528;2135;6822;601;1977;713;2364;1314;4341
432280;201603;1376;3753;741;2390;110;375;149;430;259;805
432285;201603;188;601;31;110;5;20;4;8;9;28
432290;201603;562;1629;357;1170;82;270;97;313;179;583
432300;201603;23019;67945;20141;63066;3851;13101;10933;33873;14784;46974
432310;201603;798;2330;628;2050;145;514;308;987;453;1501
432320;201603;207;529;104;335;17;55;16;43;33;98
432330;201603;327;854;125;410;13;40;10;27;23;67
432335;201603;153;436;67;233;15;56;10;29;25;85
432340;201603;309;749;163;493;27;94;50;143;77;237
432345;201603;641;1778;586;1690;78;292;354;934;432;1226
432350;201603;390;1057;210;697;31;100;57;181;88;281
432360;201603;183;564;41;148;11;48;9;26;20;74
432370;201603;417;1157;336;1006;41;118;207;628;248;746
432375;201603;758;1897;578;1603;73;202;327;921;400;1123
432377;201603;172;568;38;141;7;21;4;5;11;26
432380;201603;882;2895;766;2664;258;999;278;917;536;1916
500020;201603;2194;6524;1669;5608;356;1421;653;2110;1009;3531
500025;201603;1334;3090;827;2225;92;254;459;1215;551;1469
500060;201603;6812;20166;5389;17770;672;2297;3349;11504;4021;13801
500070;201603;4295;12296;3462;10830;712;2520;1414;4355;2126;6875
500080;201603;1473;4340;1097;3652;289;1078;346;1152;635;2230
500085;201603;2200;5672;1548;4719;154;508;894;2649;1048;3157
500090;201603;2344;6737;1702;5582;354;1213;722;2489;1076;3702
500100;201603;2590;7516;2190;6830;518;1825;849;2514;1367;4339
500110;201603;8188;24101;6550;21574;1091;3897;3074;10793;4165;14690
500124;201603;2016;6415;1745;5969;353;1136;896;3425;1249;4561
500150;201603;1391;3493;969;2807;193;655;353;858;546;1513
500190;201603;4779;12409;3706;10953;684;2143;1923;5852;2607;7995
500200;201603;2407;6080;1836;5061;389;1160;724;1876;1113;3036
500210;201603;4724;14048;3931;12815;906;3126;1752;5820;2658;8946
500215;201603;1542;4724;1210;4070;195;716;436;1445;631;2161
500220;201603;2915;9111;2411;8244;485;1764;956;3361;1441;5125
500230;201603;2766;6987;1947;5708;427;1365;874;2631;1301;3996
500240;201603;4536;14148;3288;11600;529;2033;981;3751;1510;5784
500260;201603;2697;6874;1953;5743;305;1015;929;2604;1234;3619
500270;201603;122170;311890;77821;235881;17414;57243;16069;48335;33483;105578
500280;201603;1360;3507;1151;3238;89;268;882;2517;971;2785
500290;201603;4406;10010;2540;7317;533;1698;807;2268;1340;3966
500295;201603;2640;7716;1668;5575;260;953;377;1095;637;2048
500310;201603;749;1974;617;1787;136;461;297;822;433;1283
500315;201603;3044;9499;2503;8619;356;1267;1509;5418;1865;6685
500320;201603;16796;53308;13316;46907;3763;14534;3653;13630;7416;28164
500325;201603;4018;10270;2918;8564;571;1819;1483;4402;2054;6221
500330;201603;6676;17535;4678;13881;857;2843;1994;5807;2851;8650
500345;201603;2148;5595;1670;4869;364;1151;758;2204;1122;3355
500348;201603;2272;6548;1962;6067;127;477;1409;4317;1536;4794
500350;201603;1242;3704;720;2469;96;352;219;780;315;1132
500370;201603;23080;69247;17630;59401;3723;14168;4785;16316;8508;30484
500375;201603;2893;7917;2144;6493;453;1430;543;1585;996;3015
500380;201603;3041;8444;2412;7357;633;2025;885;2716;1518;4741
500390;201603;580;1286;337;913;50;160;174;435;224;595
500400;201603;1326;3997;987;3206;227;809;225;657;452;1466
500410;201603;2184;6107;1759;5492;434;1499;801;2539;1235;4038
500430;201603;2533;7083;1931;6215;396;1432;761;2570;1157;4002
500440;201603;1474;3882;989;3039;167;569;425;1290;592;1859
500450;201603;1644;4883;1183;3999;229;855;187;557;416;1412
500460;201603;3669;10922;2763;9192;702;2560;536;1740;1238;4300
500470;201603;3034;8809;2121;6886;513;1866;307;895;820;2761
500480;201603;2155;6594;1990;6390;220;611;1457;5132;1677;5743
500490;201603;955;2633;711;2210;208;737;148;486;356;1223
500500;201603;3771;11537;2951;10305;1007;4045;903;3232;1910;7277
500510;201603;837;2151;531;1617;62;213;218;601;280;814
500515;201603;1862;4955;1535;4529;239;731;869;2798;1108;3529
500520;201603;3129;10686;2797;10136;392;1554;1785;6595;2177;8149
500525;201603;1162;3696;924;3242;157;615;413;1505;570;2120
500540;201603;6295;17112;3739;12362;948;3716;441;1268;1389;4984
500560;201603;4565;14950;4139;14294;543;2057;2889;10054;3432;12111
500568;201603;4226;10331;2902;8376;578;2031;957;2564;1535;4595
500570;201603;7541;19971;4980;15229;1271;4193;880;2595;2151;6788
500580;201603;3671;10338;2933;9157;262;839;2046;6508;2308;7347
500600;201603;3874;10208;2536;7746;580;1895;692;2129;1272;4024
500620;201603;7642;21822;5837;18448;1061;3643;2344;7528;3405;11171
500625;201603;783;2276;442;1497;81;293;130;443;211;736
500627;201603;564;1616;434;1388;80;260;117;400;197;660
500630;201603;5989;16219;4283;13393;1059;3635;1246;3832;2305;7467
500635;201603;2703;10032;2213;9276;307;1251;1422;6542;1729;7793
500640;201603;1621;3884;1232;3336;85;274;873;2321;958;2595
500660;201603;18987;54063;14712;47261;4299;15586;4112;13219;8411;28805
500690;201603;2567;7560;2071;6868;951;3297;526;1909;1477;5206
500710;201603;3545;10511;2975;9565;663;2394;1200;3842;1863;6236
500720;201603;6054;15935;3857;12204;978;3396;771;2395;1749;5791
500730;201603;975;2681;679;2098;170;557;185;552;355;1109
500740;201603;4162;11292;3336;9767;379;1346;1518;4542;1897;5888
500750;201603;899;2472;764;2281;136;446;397;1165;533;1611
500755;201603;1161;3379;789;2620;164;580;168;462;332;1042
500769;201603;5160;13656;3008;9238;482;1632;556;1484;1038;3116
500770;201603;1691;4919;1224;4045;298;1046;298;1029;596;2075
500780;201603;1096;3152;873;2748;229;740;215;673;444;1413
500790;201603;9553;26006;7903;23258;1358;4572;4159;11987;5517;16559
500793;201603;2226;6361;1712;5490;462;1589;367;1050;829;2639
500795;201603;2385;7072;2025;6568;265;710;1394;4891;1659;5601
500797;201603;829;2244;578;1809;97;333;204;622;301;955
500800;201603;2802;7473;2157;6564;823;2866;494;1566;1317;4432
500830;201603;18953;50425;13274;40015;2495;8272;4229;12123;6724;20395
500840;201603;1313;3651;890;2814;103;357;335;1027;438;1384
510010;201603;1231;3644;1019;3303;266;854;496;1660;762;2514
510020;201603;3317;9369;2070;6878;456;1643;456;1437;912;3080
510025;201603;7470;21647;5751;18489;1278;4463;1656;4974;2934;9437
510030;201603;1675;4503;1361;4020;253;838;661;1875;914;2713
510035;201603;795;2302;617;2050;126;432;333;1145;459;1577
510040;201603;1676;4578;1298;4009;207;692;681;2126;888;2818
510050;201603;1827;5270;1327;4327;333;1187;359;1133;692;2320
510060;201603;1564;4446;1189;3746;211;708;472;1459;683;2167
510080;201603;1075;3354;845;2912;243;933;123;361;366;1294
510100;201603;666;1756;475;1373;55;187;215;567;270;754
510120;201603;306;657;193;514;13;43;128;343;141;386
510125;201603;3095;8112;2368;6860;414;1442;893;2380;1307;3822
510130;201603;1757;4826;1438;4310;388;1241;441;1316;829;2557
510140;201603;2758;8822;2210;8005;938;3805;394;1242;1332;5047
510160;201603;1306;4382;1174;4161;172;674;703;2437;875;3111
510170;201603;5060;15295;4192;13822;770;2818;1917;6151;2687;8969
510180;201603;12062;31177;8389;25438;2324;7448;2365;8174;4689;15622
510185;201603;1305;3876;1085;3575;132;423;691;2551;823;2974
510190;201603;2285;6597;1610;5588;320;1216;711;2631;1031;3847
510250;201603;13366;40868;11612;38182;3435;12183;4143;14157;7578;26340
510260;201603;2098;8671;1772;8018;415;1884;798;4236;1213;6120
510263;201603;3981;10651;2946;9001;705;2280;719;2100;1424;4380
510267;201603;5461;15633;3867;12308;797;2785;895;2696;1692;5481
510268;201603;807;2385;690;2216;143;491;365;1177;508;1668
510269;201603;1001;3057;746;2572;240;856;168;595;408;1451
510270;201603;2628;8554;2214;7716;407;1456;907;3121;1314;4577
510279;201603;1779;5522;1457;4855;381;1364;380;1118;761;2482
510285;201603;1228;3585;950;3111;266;953;283;881;549;1834
510300;201603;3284;9550;2703;8725;201;762;1996;6511;2197;7273
510305;201603;1488;4605;1161;4003;291;1093;329;1133;620;2226
510310;201603;754;2328;642;2115;202;710;197;636;399;1346
510320;201603;3434;9885;2715;8588;627;2334;737;2202;1364;4536
510325;201603;5139;16135;4363;15093;1234;4441;2413;8713;3647;13154
510330;201603;2602;8244;2075;7299;533;2077;674;2390;1207;4467
510335;201603;4812;14343;3882;13189;491;1614;2706;9850;3197;11464
510336;201603;573;1771;428;1500;78;285;209;746;287;1031
510337;201603;2031;6666;1626;5892;626;2390;246;924;872;3314
510340;201603;74721;199151;52307;164396;16500;57914;8840;29177;25340;87091
510343;201603;1097;3170;889;2814;108;365;604;1947;712;2312
510345;201603;1592;4722;1286;4197;323;1133;444;1414;767;2547
510350;201603;3162;8557;2401;7486;569;1885;1037;3414;1606;5299
510360;201603;1732;4240;1096;3476;106;424;750;2334;856;2758
510370;201603;1204;3961;1010;3649;216;808;557;2133;773;2941
510380;201603;512;1503;317;1108;113;431;24;76;137;507
510385;201603;914;3452;677;2919;88;406;297;1429;385;1835
510390;201603;1074;3316;982;3202;263;678;596;2202;859;2880
510395;201603;728;1787;523;1494;81;262;201;672;282;934
510410;201603;3677;11963;3232;11107;794;2854;1565;5547;2359;8401
510420;201603;2370;6003;1755;4997;171;617;905;2537;1076;3154
510450;201603;647;1700;454;1403;99;344;137;420;236;764
510452;201603;621;1987;469;1643;80;311;231;816;311;1127
510454;201603;817;2597;696;2369;98;369;436;1513;534;1882
510455;201603;951;2913;717;2436;130;506;224;713;354;1219
510460;201603;2231;5847;1705;5120;217;774;966;2788;1183;3562
510480;201603;4360;11491;3114;9266;643;2020;752;2138;1395;4158
510490;201603;1575;4910;1330;4539;279;1069;711;2373;990;3442
510500;201603;1495;4442;1016;3503;232;924;394;1293;626;2217
510510;201603;2561;8874;2213;8263;683;2748;638;2435;1321;5183
510515;201603;6019;18222;4460;14877;962;3561;977;3049;1939;6610
510517;201603;1615;4832;1317;4285;400;1367;306;984;706;2351
510520;201603;2041;4714;1468;4024;59;180;1006;2952;1065;3132
510523;201603;979;2887;862;2685;120;370;591;1908;711;2278
510525;201603;7877;20344;5385;16525;1056;3371;1867;5750;2923;9121
510530;201603;498;1425;414;1307;49;219;262;785;311;1004
510550;201603;2621;8574;2094;7545;564;2222;658;2359;1222;4581
510558;201603;1837;5273;1561;4881;262;903;822;2674;1084;3577
510560;201603;1632;4930;1055;3963;286;1197;194;742;480;1939
510562;201603;5290;15549;4079;13165;1154;4069;961;3201;2115;7270
510590;201603;2967;7869;2478;7251;477;1398;1390;4269;1867;5667
510600;201603;1537;3980;1042;3172;182;585;402;1189;584;1774
510610;201603;2873;8148;2329;7329;197;693;1532;4821;1729;5514
510615;201603;2002;6086;1695;5597;498;1719;721;2499;1219;4218
510617;201603;594;1763;492;1589;37;103;385;1304;422;1407
510618;201603;1441;4185;1050;3428;184;698;459;1455;643;2153
510619;201603;795;2189;481;1597;52;188;53;133;105;321
510620;201603;1391;3486;794;2569;194;701;103;298;297;999
510621;201603;884;3071;794;2888;204;818;239;825;443;1643
510622;201603;3683;11145;2604;8902;658;2426;267;809;925;3235
510623;201603;3245;9253;2574;8082;650;2240;912;2717;1562;4957
510624;201603;1466;4278;967;3289;193;751;210;652;403;1403
510625;201603;2053;5782;1574;4971;412;1438;271;865;683;2303
510626;201603;1513;4050;992;3333;309;1187;229;775;538;1962
510627;201603;711;2037;479;1542;113;403;91;288;204;691
510628;201603;1513;3744;1080;3168;103;317;760;2260;863;2577
510629;201603;1726;5579;1397;4873;410;1594;398;1367;808;2961
510630;201603;2459;8342;1823;7014;449;1924;300;1203;749;3127
510631;201603;350;1008;306;939;29;76;232;720;261;796
510637;201603;2621;7702;2264;7139;711;2419;780;2463;1491;4882
510642;201603;4567;15065;3958;14190;1158;4575;1699;6314;2857;10889
510645;201603;962;2159;614;1691;196;537;160;472;356;1009
510650;201603;6204;20549;5592;19839;1445;5391;3358;12421;4803;17812
510665;201603;1617;4235;988;3064;199;633;318;1010;517;1643
510670;201603;390;881;218;643;19;75;104;292;123;367
510675;201603;6258;19581;5027;17191;1426;5490;1115;3719;2541;9209
510677;201603;1893;5170;1567;4750;169;520;1157;3684;1326;4204
510680;201603;712;2130;534;1774;124;437;105;320;229;757
510682;201603;2086;6613;1626;5747;441;1782;270;903;711;2685
510685;201603;934;2500;769;2281;81;278;511;1500;592;1778
510700;201603;4233;10960;2903;9112;622;2001;1331;4356;1953;6357
510704;201603;9198;24368;7459;21655;1399;4444;3528;9999;4927;14443
510706;201603;1844;5463;1263;4599;271;1005;625;2446;896;3451
510710;201603;3297;9129;2347;7225;531;1696;565;1603;1096;3299
510715;201603;710;1742;472;1335;87;267;159;455;246;722
510718;201603;2265;5624;1485;4727;671;2197;332;1253;1003;3450
510719;201603;400;926;261;743;22;89;133;359;155;448
510720;201603;1096;2685;830;2333;243;768;303;764;546;1532
510724;201603;697;2112;550;1848;119;436;211;666;330;1102
510726;201603;599;1504;458;1286;70;226;233;581;303;807
510729;201603;724;1790;420;1242;90;289;144;432;234;721
510730;201603;2674;7748;2015;6556;564;2014;494;1570;1058;3584
510735;201603;1010;3349;782;2993;167;718;373;1446;540;2164
510740;201603;1062;2620;778;2201;168;450;395;1192;563;1642
510757;201603;674;2271;560;2053;214;796;158;598;372;1394
510760;201603;30410;77969;20707;62366;5725;18890;4279;12580;10004;31470
510770;201603;4198;10785;3581;10043;340;938;2348;7352;2688;8290
510774;201603;361;1021;326;967;66;225;152;481;218;706
510775;201603;694;2047;576;1843;172;612;152;444;324;1056
510776;201603;531;1449;416;1216;87;274;175;510;262;784
510777;201603;1568;4615;1178;4095;150;557;897;3167;1047;3724
510779;201603;631;1902;484;1620;67;233;228;797;295;1030
510780;201603;3629;10750;2957;9716;710;2462;1156;4085;1866;6547
510785;201603;1694;4892;1261;4150;400;1372;221;762;621;2134
510787;201603;2222;6652;1769;5871;729;2583;299;951;1028;3534
510788;201603;541;1400;387;1177;157;496;82;293;239;789
510790;201603;15626;45139;10775;36046;2156;8362;1029;3506;3185;11868
510792;201603;7766;22817;5421;18413;1058;4084;782;2486;1840;6570
510794;201603;1148;3631;931;3202;301;1145;256;835;557;1980
510795;201603;7948;23653;5894;19876;1495;5576;1110;3987;2605;9563
510800;201603;1522;4265;1200;3803;274;957;485;1433;759;2390
510805;201603;1900;5289;1487;4658;275;953;832;2563;1107;3516
510810;201603;637;1585;499;1398;144;409;215;580;359;989
510820;201603;721;1713;481;1353;83;282;175;429;258;711
510830;201603;659;2062;547;1891;138;514;275;1017;413;1531
510835;201603;614;1816;473;1551;104;376;171;523;275;899
510840;201603;46240;115101;36814;103040;8889;26275;16410;47452;25299;73727
510850;201603;1471;4180;1002;3316;263;946;127;372;390;1318
510860;201603;2609;8191;1933;6879;726;2852;103;320;829;3172
510880;201603;617;2038;527;1884;169;655;193;719;362;1374
510885;201603;635;1779;513;1614;99;348;198;620;297;968
510890;201603;820;2576;674;2361;194;771;269;901;463;1672
510895;201603;1051;3253;884;2932;220;829;328;1025;548;1854
520005;201603;1390;4403;1230;4172;310;1084;598;2110;908;3194
520010;201603;1651;5545;1336;4902;493;2096;222;732;715;2828
520013;201603;3362;9386;2493;7770;575;1878;789;2507;1364;4385
520015;201603;467;1326;375;1192;76;267;134;439;210;706
520017;201603;1032;3066;867;2803;207;733;321;978;528;1711
520020;201603;449;1143;342;996;77;240;146;416;223;656
520025;201603;25673;79790;24292;78169;2895;10009;19127;61577;22022;71586
520030;201603;4478;13947;3777;12793;711;2661;1875;6391;2586;9052
520050;201603;414;1042;286;843;18;45;178;550;196;595
520055;201603;731;2213;646;2036;100;307;354;1154;454;1461
520060;201603;1314;4109;1125;3728;245;913;392;1252;637;2165
520080;201603;1776;5170;1496;4809;301;935;823;2848;1124;3783
520082;201603;1057;2894;938;2709;122;329;635;1904;757;2233
520085;201603;836;2523;726;2331;164;533;237;752;401;1285
520090;201603;967;2215;694;1875;156;380;340;1018;496;1398
520110;201603;41115;118548;32114;105021;11461;42716;4774;15147;16235;57863
520120;201603;186;495;123;389;22;82;29;94;51;176
520130;201603;3360;9397;3042;8948;678;2196;1543;4624;2221;6820
520140;201603;36306;117195;31219;108027;10760;40551;5056;17362;15816;57913
520145;201603;348;940;250;766;60;192;78;227;138;419
520150;201603;448;1182;361;1086;52;183;216;648;268;831
520160;201603;871;2350;709;2115;208;632;184;574;392;1206
520170;201603;4248;9791;3315;8732;261;721;2665;7161;2926;7882
520180;201603;2048;5972;1696;5444;296;1137;806;2539;1102;3676
520215;201603;1894;4894;1572;4381;174;500;1002;2835;1176;3335
520235;201603;673;1748;493;1481;92;311;200;577;292;888
520250;201603;1514;4329;1136;3708;290;1090;230;721;520;1811
520260;201603;771;1962;521;1493;70;229;199;537;269;766
520280;201603;560;1620;494;1534;163;531;183;637;346;1168
520310;201603;1192;2839;851;2298;228;662;271;792;499;1454
520320;201603;1828;5654;1517;5080;111;390;1004;3439;1115;3829
520330;201603;2671;8143;2037;7075;511;1931;317;1059;828;2990
520340;201603;1797;4503;1381;3966;199;510;902;2795;1101;3305
520350;201603;3111;8514;2428;7310;635;2125;869;2533;1504;4658
520355;201603;1036;3440;929;3275;293;1130;351;1191;644;2321
520357;201603;831;2229;703;2018;56;180;490;1415;546;1595
520360;201603;649;1894;557;1741;138;455;219;708;357;1163
520380;201603;1273;3436;865;2643;117;371;360;1095;477;1466
520390;201603;1064;2486;625;1914;177;634;205;564;382;1198
520393;201603;481;1169;379;1024;54;149;221;592;275;741
520396;201603;693;2233;570;1991;71;293;359;1225;430;1518
520400;201603;1670;4777;1427;4433;234;773;891;2746;1125;3519
520410;201603;1412;3435;1038;2913;205;654;561;1556;766;2210
520420;201603;320;884;236;713;41;129;75;201;116;330
520425;201603;1063;2928;879;2612;232;708;413;1255;645;1963
520430;201603;1846;4904;1196;3695;242;760;234;651;476;1411
520440;201603;3650;9344;2463;7247;713;2313;474;1386;1187;3699
520450;201603;10094;28060;6870;22080;1387;4833;463;1452;1850;6285
520455;201603;640;1911;517;1701;138;476;173;577;311;1053
520460;201603;873;2461;715;2199;120;438;379;1117;499;1555
520465;201603;785;2199;681;2074;100;331;413;1249;513;1580
520470;201603;1721;5539;1542;5258;348;1207;931;3317;1279;4524
520480;201603;931;2694;679;2264;120;434;256;804;376;1238
520485;201603;1258;3967;1091;3707;278;1053;586;1981;864;3034
520490;201603;3905;12193;3122;10977;957;3427;1297;4813;2254;8240
520495;201603;1260;3481;1094;3270;80;254;887;2718;967;2972
520500;201603;1299;3643;1075;3328;278;933;427;1314;705;2247
520505;201603;731;2084;626;1925;144;442;315;986;459;1428
520510;201603;8815;24605;6347;20759;1551;5579;1913;6489;3464;12068
520520;201603;1056;2933;842;2624;266;881;235;756;501;1637
520530;201603;1936;6385;1604;5823;564;2040;446;1788;1010;3828
520540;201603;2801;7894;2091;6614;556;1840;356;1154;912;2994
520545;201603;1061;3179;882;2855;169;588;272;838;441;1426
520547;201603;647;2043;559;1878;199;684;167;532;366;1216
520549;201603;9395;27480;7862;25425;2350;7906;3379;11219;5729;19125
520551;201603;3485;10641;3210;10255;858;3057;1876;5902;2734;8959
520552;201603;751;2252;675;2152;93;313;474;1543;567;1856
520570;201603;544;1536;403;1301;144;501;112;336;256;837
520580;201603;3227;7947;2234;6578;571;1908;951;2758;1522;4666
520590;201603;1343;3796;1042;3297;238;769;193;587;431;1356
520620;201603;7258;22455;6584;21524;1649;5572;3625;12054;5274;17626
520630;201603;903;2336;656;1974;112;348;266;800;378;1148
520640;201603;2758;7591;2258;6762;608;1871;807;2513;1415;4384
520650;201603;837;2234;620;1833;126;410;311;910;437;1320
520660;201603;337;953;268;864;89;316;86;281;175;597
520670;201603;894;2632;806;2509;63;199;658;2062;721;2261
520680;201603;715;1892;570;1687;145;423;244;739;389;1162
520690;201603;312;854;244;746;57;150;108;349;165;499
520710;201603;543;1406;341;1013;6;15;204;603;210;618
520725;201603;1527;3930;1150;3310;190;595;674;1919;864;2514
520735;201603;741;2082;522;1660;126;455;153;462;279;917
520740;201603;1600;4441;1286;4055;231;816;661;2068;892;2884
520750;201603;566;1534;451;1358;92;264;216;702;308;966
520753;201603;1415;3846;1277;3655;149;423;849;2604;998;3027
520760;201603;802;2133;705;2008;82;234;497;1484;579;1718
520780;201603;1900;4642;1497;4094;139;385;989;2698;1128;3083
520790;201603;2767;7147;2190;6332;224;602;1530;4669;1754;5271
520800;201603;15504;44346;13409;41870;2880;8564;7892;26706;10772;35270
520810;201603;1020;2531;813;2286;117;314;579;1746;696;2060
520815;201603;573;1825;432;1530;179;718;15;40;194;758
520830;201603;1565;4094;1286;3789;41;118;1096;3239;1137;3357
520840;201603;1551;5026;1306;4609;478;1845;222;839;700;2684
520850;201603;579;1790;441;1539;100;389;145;499;245;888
520860;201603;6450;18841;4855;16235;1188;4253;1538;5300;2726;9553
520870;201603;98763;263959;69950;217982;19382;66594;14596;44234;33978;110828
520880;201603;6784;19446;5140;17084;1729;6459;602;1994;2331;8453
520890;201603;3722;10460;3010;9315;584;1971;1448;4489;2032;6460
520910;201603;3789;10917;2778;9010;904;3159;460;1439;1364;4598
520915;201603;646;1921;525;1690;117;399;233;746;350;1145
520920;201603;3378;9068;2421;7576;451;1538;915;2959;1366;4497
520929;201603;528;1457;410;1278;78;238;230;745;308;983
520940;201603;1029;2975;835;2689;105;378;581;1853;686;2231
520945;201603;649;1567;520;1359;135;317;240;625;375;942
520960;201603;1005;2933;790;2532;81;266;384;1263;465;1529
520970;201603;2781;8418;2408;7776;607;2143;634;1980;1241;4123
520980;201603;720;2091;637;1971;212;705;304;939;516;1644
520990;201603;2901;9397;2735;9168;438;1528;1837;6439;2275;7967
520993;201603;924;2361;744;2107;49;144;541;1565;590;1709
520995;201603;2296;6100;2007;5760;347;902;1348;4047;1695;4949
521000;201603;6707;20271;5548;18157;1656;5989;1407;4341;3063;10330
521010;201603;3924;11399;3078;9883;782;2499;1097;3591;1879;6090
521015;201603;664;1854;574;1712;138;388;286;876;424;1264
521020;201603;3024;8668;2105;6797;564;1962;212;640;776;2602
521030;201603;650;1633;492;1366;93;251;196;579;289;830
521040;201603;5830;15758;4937;14469;1747;5296;1605;5018;3352;10314
521056;201603;844;2577;705;2352;243;843;212;804;455;1647
521060;201603;1098;2839;883;2518;177;477;427;1315;604;1792
521080;201603;1125;2710;668;1969;73;270;236;590;309;860
521090;201603;2857;7683;2250;6919;699;2257;681;2180;1380;4437
521100;201603;1934;4329;1491;3822;283;670;944;2594;1227;3264
521120;201603;4387;11772;3485;10598;850;2800;1369;4350;2219;7150
521130;201603;993;2685;746;2220;101;368;416;1212;517;1580
521140;201603;1009;3059;826;2719;222;763;260;868;482;1631
521150;201603;11752;29543;7540;22219;2646;8294;1607;4801;4253;13095
521160;201603;825;1944;519;1431;110;311;213;579;323;890
521170;201603;1128;2765;854;2368;185;532;460;1249;645;1781
521180;201603;6201;20221;5590;19175;1714;6312;1560;5402;3274;11714
521190;201603;9159;26140;6241;20874;1518;5536;1197;3991;2715;9527
521200;201603;741;2020;611;1811;76;254;357;1043;433;1297
521205;201603;584;1658;453;1424;41;135;254;804;295;939
521210;201603;921;2556;611;1937;176;656;131;341;307;997
521220;201603;4148;10679;3117;9320;794;2628;1287;3887;2081;6515
521225;201603;368;897;299;821;31;78;212;618;243;696
521230;201603;1138;3641;1050;3476;332;1183;510;1642;842;2825
521250;201603;27435;87051;24229;82187;10364;37225;6060;21149;16424;58374
521260;201603;669;1637;569;1494;82;273;358;884;440;1157
521270;201603;1846;5351;1696;5145;173;450;1267;4028;1440;4478
521280;201603;1825;5538;1492;4898;428;1492;395;1267;823;2759
521290;201603;486;1357;366;1169;92;344;157;477;249;821
521295;201603;1166;2892;984;2655;149;393;685;1955;834;2348
521300;201603;1907;5356;1634;4927;227;645;980;3030;1207;3675
521305;201603;736;2083;602;1876;114;332;326;1061;440;1393
521308;201603;4274;12622;3372;10890;907;2973;1164;3797;2071;6770
521310;201603;7594;22412;5508;18428;1363;4960;1027;3251;2390;8211
521340;201603;292;753;276;735;14;40;233;612;247;652
521350;201603;1915;5284;1596;4801;230;655;1053;3298;1283;3953
521370;201603;922;2709;705;2332;235;844;139;452;374;1296
521375;201603;1154;3530;970;3203;222;792;397;1260;619;2052
521377;201603;1074;2707;994;2623;64;111;871;2392;935;2503
521380;201603;5363;15186;3881;12425;591;2004;919;3069;1510;5073
521385;201603;482;1299;430;1235;96;310;229;656;325;966
521390;201603;844;2315;663;2085;170;627;211;625;381;1252
521400;201603;1879;5439;1751;5280;220;735;1333;4053;1553;4788
521405;201603;1350;3784;1054;3253;292;962;417;1310;709;2272
521410;201603;690;2120;647;2053;231;688;276;962;507;1650
521440;201603;1324;3885;1116;3448;169;571;449;1208;618;1779
521450;201603;3820;12337;3108;10966;1019;3827;559;1943;1578;5770
521460;201603;6478;18806;5458;17094;1369;4654;2469;7628;3838;12282
521470;201603;685;1969;512;1635;112;384;75;240;187;624
521480;201603;373;1128;253;865;49;172;82;273;131;445
521483;201603;2818;7346;2154;6224;547;1577;604;1724;1151;3301
521486;201603;1568;4016;1284;3606;124;325;923;2619;1047;2944
521487;201603;575;1475;410;1208;110;343;76;213;186;556
521490;201603;772;2226;624;1985;50;220;404;1232;454;1452
521500;201603;1320;4182;1018;3537;186;735;235;722;421;1457
521520;201603;863;2056;657;1782;163;469;298;865;461;1334
521523;201603;12919;46557;12160;45263;4228;17191;1513;6338;5741;23529
521525;201603;1030;2707;881;2488;112;373;565;1555;677;1928
521530;201603;1699;4816;1073;3552;230;816;133;438;363;1254
521540;201603;924;2472;634;1988;133;498;209;624;342;1122
521550;201603;1308;3358;917;2584;209;629;411;1118;620;1747
521560;201603;3567;11798;3032;11049;1182;4711;941;3392;2123;8103
521565;201603;598;1539;501;1419;90;215;315;924;405;1139
521570;201603;4550;12492;2925;9294;636;2237;521;1677;1157;3914
521580;201603;547;1269;357;1000;86;249;95;262;181;511
521590;201603;622;1729;515;1562;146;490;136;390;282;880
521600;201603;485;1340;352;1120;89;303;81;251;170;554
521630;201603;1350;3394;964;2841;236;826;177;441;413;1267
521640;201603;2016;5151;1561;4530;420;1264;645;1932;1065;3196
521645;201603;569;1673;432;1390;61;205;153;460;214;665
521680;201603;1339;4289;1132;3887;536;1978;142;471;678;2449
521690;201603;569;1659;502;1545;121;430;226;639;347;1069
521710;201603;2841;8310;2283;7356;485;1631;808;2665;1293;4296
521720;201603;1848;5247;1500;4645;318;981;787;2393;1105;3374
521730;201603;3563;11655;3121;10791;1124;4327;631;1912;1755;6239
521740;201603;3487;9578;2757;8560;660;2223;1210;4028;1870;6251
521760;201603;12830;41842;11377;39405;2939;11100;4598;16167;7537;27267
521770;201603;2572;7455;2076;6554;751;2544;541;1625;1292;4169
521800;201603;6894;20867;5942;19253;1834;6325;2058;6956;3892;13281
521805;201603;900;2044;657;1698;154;361;346;984;500;1345
521810;201603;806;2009;589;1701;119;372;239;733;358;1105
521830;201603;5191;16419;4644;15613;761;2791;3049;10245;3810;13036
521839;201603;701;1927;539;1639;102;329;185;540;287;869
521850;201603;6729;18016;5166;15366;1232;3902;1471;4074;2703;7976
521860;201603;1945;5274;1496;4585;344;1177;423;1277;767;2454
521870;201603;477;1566;393;1386;98;368;117;398;215;766
521878;201603;766;2190;548;1736;80;285;214;638;294;923
521880;201603;22922;58756;15543;46982;4011;13017;4372;13783;8383;26800
521890;201603;3321;9887;2602;8533;743;2610;493;1583;1236;4193
521900;201603;1430;3775;1010;3154;240;789;328;953;568;1742
521910;201603;894;2434;797;2322;137;417;462;1441;599;1858
521920;201603;289;894;238;802;86;320;43;132;129;452
521925;201603;669;2031;560;1838;112;406;191;589;303;995
521930;201603;3597;11571;3108;10634;1034;3690;523;1828;1557;5518
521935;201603;588;1672;506;1523;131;405;234;684;365;1089
521940;201603;989;2745;807;2470;185;618;382;1145;567;1763
521945;201603;652;2086;572;1963;98;321;348;1302;446;1623
521950;201603;629;1650;509;1476;70;215;318;938;388;1153
521960;201603;645;1959;523;1716;108;395;219;705;327;1100
521970;201603;2558;6776;2128;6251;202;579;1657;5049;1859;5628
521971;201603;1039;2752;733;2197;139;425;170;490;309;915
521973;201603;919;2838;774;2576;150;529;337;1116;487;1645
521975;201603;11942;32912;10945;31765;2009;6094;7367;21362;9376;27456
521980;201603;1971;5506;1695;5164;254;655;1296;4155;1550;4810
521990;201603;1162;3249;930;2886;80;271;620;1970;700;2241
522000;201603;2223;6103;1616;5329;199;730;899;3132;1098;3862
522005;201603;395;966;273;782;81;219;89;275;170;494
522010;201603;3374;9634;2828;8743;1001;3157;597;1891;1598;5048
522015;201603;878;2612;739;2392;161;519;364;1202;525;1721
522020;201603;5041;13096;3963;11469;953;2827;1925;5520;2878;8347
522026;201603;607;1644;446;1458;105;377;153;541;258;918
522028;201603;509;1476;409;1254;59;184;235;721;294;905
522040;201603;2306;5679;1832;5100;390;1082;1085;3083;1475;4165
522045;201603;14797;48132;12348;43221;3404;13107;2208;7659;5612;20766
522050;201603;1133;3178;810;2577;187;628;226;643;413;1271
522060;201603;2590;7678;2020;6821;579;2142;846;2868;1425;5010
522068;201603;1675;5237;1512;5050;146;425;1187;4189;1333;4614
522070;201603;706;2126;630;2003;75;290;446;1411;521;1701
522100;201603;508;1533;441;1435;169;603;170;528;339;1131
522108;201603;850;2626;716;2431;60;259;536;1779;596;2038
522119;201603;1345;4132;1130;3809;273;967;494;1725;767;2692
522130;201603;343;972;283;904;87;280;164;537;251;817
522140;201603;17332;48218;13965;42542;3999;13039;3511;10278;7510;23317
522145;201603;785;2189;682;2031;261;793;232;749;493;1542
522150;201603;864;2411;744;2220;202;610;274;834;476;1444
522155;201603;807;2277;707;2121;135;358;433;1392;568;1750
522157;201603;656;1814;558;1675;39;140;431;1298;470;1438
522160;201603;5768;16451;4217;13676;1186;4265;365;1154;1551;5419
522170;201603;2278;6663;1841;5872;577;1939;396;1257;973;3196
522180;201603;312;907;234;772;70;252;59;205;129;457
522185;201603;14813;42425;12330;39278;3239;10846;6348;20714;9587;31560
522190;201603;872;2171;666;1882;102;302;329;988;431;1290
522200;201603;1646;5296;1367;4722;344;1284;335;1114;679;2398
522205;201603;1370;3859;1109;3452;219;735;543;1656;762;2391
522220;201603;1328;3550;1083;3251;253;740;546;1805;799;2545
522230;201603;1205;3379;1012;3080;110;400;634;1923;744;2323
530010;201603;218055;680722;193131;637884;51406;187776;63889;206419;115295;394195
110001;201602;3250;10898;2920;10373;695;2559;1413;5115;2108;7674
110002;201602;12606;37328;10022;32832;2954;10507;3034;9814;5988;20321
110003;201602;712;2360;659;2252;192;689;143;469;335;1158
110004;201602;9676;30372;7952;26946;2398;8771;1435;5045;3833;13816
110005;201602;1763;5648;1529;5215;508;1772;600;2055;1108;3827
110006;201602;1855;5724;1319;4680;374;1455;138;431;512;1886
110007;201602;1299;4020;1210;3844;351;1207;471;1682;822;2889
110008;201602;2287;7845;2154;7656;370;1234;1532;5709;1902;6943
110009;201602;4476;13534;3567;12109;1029;3816;1087;3717;2116;7533
110010;201602;7419;22016;6546;20897;1753;5510;3239;11501;4992;17011
110011;201602;7369;22933;6302;20878;2153;7454;1942;6498;4095;13952
110012;201602;13832;41292;11411;37042;3300;11195;2868;9675;6168;20870
110013;201602;5122;16334;4424;15082;1677;5919;1123;4095;2800;10014
110014;201602;3890;11666;3452;10945;853;2801;1802;5769;2655;8570
110015;201602;4632;13893;3385;11552;983;3643;633;2186;1616;5829
110018;201602;3915;11119;2966;9731;763;2821;1065;3356;1828;6177
110020;201602;59728;164755;44912;144912;10011;34411;19695;65716;29706;100127
110025;201602;4117;11938;3391;10671;589;1951;1988;6207;2577;8158
110026;201602;606;1885;558;1813;134;423;311;1056;445;1479
110028;201602;6624;20044;5240;17345;1414;5121;594;1942;2008;7063
110029;201602;1262;3748;1055;3405;319;1063;400;1309;719;2372
110030;201602;10006;27232;7706;24120;1968;6777;3040;9773;5008;16550
110032;201602;3727;11844;3289;11011;1055;3638;952;3183;2007;6821
110033;201602;5177;16544;4703;15775;1518;5100;1735;6194;3253;11294
110034;201602;3280;8881;2743;8164;763;2303;1529;4575;2292;6878
110037;201602;1927;6523;1655;5987;434;1669;684;2463;1118;4132
110040;201602;3323;10518;2857;9678;825;3008;1059;3511;1884;6519
110045;201602;4868;15868;4201;15029;1362;5291;1924;6916;3286;12207
110050;201602;1587;5142;1361;4735;433;1565;591;2081;1024;3646
110060;201602;781;2588;640;2300;225;909;112;379;337;1288
110070;201602;1894;6363;1768;6108;538;2017;744;2487;1282;4504
110080;201602;4087;11359;3591;10796;561;1613;2578;8150;3139;9763
110090;201602;698;2080;548;1811;127;474;228;715;355;1189
110092;201602;1264;4270;1168;4138;192;727;749;2724;941;3451
110094;201602;3533;10640;3100;10045;1040;3593;1219;3965;2259;7558
110100;201602;2094;6686;1908;6337;621;2180;819;2724;1440;4904
110110;201602;1578;5048;1419;4839;588;2025;370;1339;958;3364
110120;201602;1767;5631;1387;4813;416;1518;272;947;688;2465
110130;201602;2352;6876;1777;5870;567;1980;310;1027;877;3007
110140;201602;2285;7524;1939;6865;573;2213;549;1844;1122;4057
110143;201602;1189;3713;902;3214;273;996;350;1302;623;2298
110145;201602;969;2805;784;2512;197;692;389;1218;586;1910
110146;201602;417;1291;356;1197;73;241;196;690;269;931
110147;201602;683;2032;545;1785;143;477;174;545;317;1022
110148;201602;1203;3653;899;3003;200;703;106;341;306;1044
110149;201602;3181;9620;2578;8627;865;2886;1007;3565;1872;6451
110150;201602;2322;6842;1956;6302;545;1854;689;2321;1234;4175
110155;201602;814;2514;732;2329;192;649;306;929;498;1578
110160;201602;1900;6085;1592;5491;567;1989;499;1751;1066;3740
110170;201602;2802;7918;2045;6527;445;1478;970;3100;1415;4578
110175;201602;1580;4879;1279;4477;225;829;672;2491;897;3320
110180;201602;1256;3726;1069;3450;265;837;591;1961;856;2798
120001;201602;2690;9323;2501;9020;512;1936;1504;5582;2016;7518
120005;201602;1484;6257;1394;6079;156;751;1030;4662;1186;5413
120010;201602;4458;15360;4261;15068;567;2010;3190;11582;3757;13592
120013;201602;1772;7101;1691;6985;396;1612;993;4372;1389;5984
120017;201602;1934;7082;1810;6859;518;2006;780;3305;1298;5311
120020;201602;13829;62108;13384;61240;2014;9472;9465;44853;11479;54325
120025;201602;2380;8369;2291;8244;444;1694;1440;5268;1884;6962
120030;201602;6093;24004;5953;23846;229;1088;5392;21700;5621;22788
120032;201602;1427;6977;1373;6853;170;1036;990;4952;1160;5988
120033;201602;3432;13900;3352;13758;279;1162;2925;12179;3204;13341
120034;201602;2059;8510;1982;8376;145;814;1640;6855;1785;7669
120035;201602;2987;13800;2919;13666;216;1160;2475;11700;2691;12860
120038;201602;2541;9351;2414;9103;636;2445;1237;4835;1873;7280
120039;201602;1636;8289;1597;8202;159;960;1232;6409;1391;7369
120040;201602;43609;156390;39984;149677;9608;38931;19298;73647;28906;112578
120042;201602;2881;12395;2743;12090;355;1729;1953;8740;2308;10469
120043;201602;886;4216;856;4167;72;344;684;3467;756;3811
120045;201602;4092;14122;3994;14003;538;1988;3222;11374;3760;13362
120050;201602;7816;32540;7460;31769;1095;4954;5067;22301;6162;27255
120060;201602;7383;33439;7236;33171;698;3731;5734;26517;6432;30248
120070;201602;2604;9826;2533;9670;421;1600;1650;6503;2071;8103
120080;201602;3439;13183;3290;12922;633;2583;2234;8990;2867;11573
130002;201602;3013;12515;2843;12248;182;936;2403;10399;2585;11335
130006;201602;1954;8292;1723;7877;251;1297;1192;5489;1443;6786
130008;201602;2080;8362;1955;8141;198;852;1533;6496;1731;7348
130010;201602;2797;9462;2563;9197;180;710;2235;8037;2415;8747
130014;201602;3063;10137;2708;9572;490;1848;1675;6000;2165;7848
130020;201602;2646;9747;2561;9594;64;332;2233;8262;2297;8594
130030;201602;7195;27441;6948;27153;454;1590;6107;24505;6561;26095
130040;201602;3714;11499;3333;11002;286;1021;2676;8983;2962;10004
130050;201602;5752;23825;5449;23393;409;1773;4527;20072;4936;21845
130060;201602;5504;26120;5295;25775;517;3028;4122;20031;4639;23059
130063;201602;3569;15946;3473;15835;313;1547;2962;13646;3275;15193
130068;201602;3085;13022;2794;12413;354;1665;1814;8223;2168;9888
130070;201602;6653;21440;5911;20563;655;2289;4508;16089;5163;18378
130080;201602;5014;22672;4787;22316;750;3817;3328;15782;4078;19599
130083;201602;2045;8210;1937;8063;284;1318;1340;5605;1624;6923
130090;201602;2566;9321;2468;9171;109;525;2189;8096;2298;8621
130100;201602;5578;20783;5440;20615;159;687;5097;19358;5256;20045
130110;201602;6501;21162;6118;20710;714;2245;4862;17010;5576;19255
130115;201602;4306;15376;4107;15072;176;716;3590;13230;3766;13946
130120;201602;14218;54315;13375;53260;1391;5628;10838;44228;12229;49856
130130;201602;3710;15342;3659;15246;221;1145;3170;13161;3391;14306
130140;201602;6226;24150;6122;24033;233;944;5742;22606;5975;23550
130150;201602;3291;13156;3217;13066;165;930;2861;11466;3026;12396
130160;201602;4063;17088;3926;16904;474;2384;3174;13574;3648;15958
130165;201602;2792;11645;2663;11431;273;1322;2092;9036;2365;10358
130170;201602;8832;32060;7830;30819;1068;4516;5770;23176;6838;27692
130180;201602;3406;11271;3341;11182;153;345;3078;10513;3231;10858
130185;201602;11039;35424;9928;34163;900;2841;8066;29082;8966;31923
130190;201602;16283;56389;14345;53915;2627;10039;9270;36333;11897;46372
130195;201602;1895;7967;1830;7880;112;513;1600;6989;1712;7502
130200;201602;1945;6991;1790;6747;453;1695;1056;4136;1509;5831
130210;201602;1203;4813;1141;4732;119;609;941;3860;1060;4469
130220;201602;1952;8035;1782;7714;308;1518;981;4237;1289;5755
130230;201602;3540;16317;3332;15976;384;1939;2487;12333;2871;14272
130240;201602;8385;32011;7696;31066;403;2177;6616;26707;7019;28884
130250;201602;18968;66753;17865;65357;2602;9438;13071;49806;15673;59244
130255;201602;4127;14480;3870;14080;167;694;3413;12542;3580;13236
130260;201602;236152;777385;213265;738673;62091;228671;89052;312274;151143;540945
130270;201602;6701;28789;6243;28062;897;4269;4451;20666;5348;24935
130280;201602;3197;13288;3093;13165;138;630;2819;12156;2957;12786
130290;201602;11091;39533;10619;38985;205;643;10057;37543;10262;38186
130300;201602;4244;16692;4060;16402;247;1184;3510;14223;3757;15407
130310;201602;4848;18635;4497;18182;327;1419;3766;15483;4093;16902
130320;201602;2871;10313;2634;9987;373;1519;1818;7070;2191;8589
130330;201602;3476;12798;3194;12442;221;1045;2641;10271;2862;11316
130340;201602;17317;66832;16107;65331;2646;10697;12002;50319;14648;61016
130350;201602;3176;13432;3107;13331;279;1583;2555;10804;2834;12387
130353;201602;5897;18144;5179;17241;1149;3766;3067;11041;4216;14807
130356;201602;4435;16086;4180;15721;416;1508;3231;12641;3647;14149
130360;201602;3228;9180;2861;8788;145;396;2586;8127;2731;8523
130370;201602;5172;20503;4517;19649;275;1562;3681;16013;3956;17575
130380;201602;7446;31255;7186;30908;471;2371;6171;26663;6642;29034
130390;201602;4710;21379;4448;20885;485;2586;3290;15611;3775;18197
130395;201602;2054;7377;1845;6979;268;1100;1196;4476;1464;5576
130400;201602;2038;7868;1960;7761;145;700;1703;6739;1848;7439
130406;201602;10291;39526;9383;38231;2147;9046;5844;24440;7991;33486
130410;201602;3818;14678;3453;14061;1047;4527;1481;6304;2528;10831
130420;201602;10246;43547;9800;42903;2508;10611;6212;28767;8720;39378
130423;201602;3221;12576;3011;12290;269;1339;2496;10122;2765;11461
130426;201602;2131;9345;2070;9246;255;1212;1588;7248;1843;8460
130430;201602;3269;11746;3149;11572;340;1324;2492;9260;2832;10584
130440;201602;3401;12579;3236;12389;256;1039;2754;10628;3010;11667
140002;201602;1585;5228;1464;5059;117;480;1074;3719;1191;4199
140005;201602;3045;8885;2929;8757;72;172;2800;8441;2872;8613
140010;201602;53128;155945;44387;143162;11048;37935;18481;62530;29529;100465
140015;201602;2718;8886;2566;8700;265;791;2101;7383;2366;8174
140017;201602;3075;9830;2792;9473;279;891;2111;7492;2390;8383
140020;201602;4201;14510;3836;13996;579;2337;2644;9657;3223;11994
140023;201602;2087;7063;1826;6676;217;873;1262;4719;1479;5592
140028;201602;2050;5712;1911;5525;270;865;1360;3763;1630;4628
140030;201602;3585;11426;3355;11125;459;1297;2446;8454;2905;9751
140040;201602;1625;7702;1591;7642;101;611;1394;6653;1495;7264
140045;201602;2370;8869;2166;8591;435;1615;1380;5940;1815;7555
140047;201602;5409;16141;4803;15262;1276;4099;2182;7512;3458;11611
140050;201602;1343;4298;1215;4130;298;1016;685;2401;983;3417
140060;201602;1432;4424;1277;4183;252;871;807;2676;1059;3547
140070;201602;1401;7710;1355;7567;116;788;1060;5925;1176;6713
150010;201602;34336;105242;32354;102620;2099;7109;26232;83678;28331;90787
150013;201602;1664;4882;1512;4709;162;498;1177;3758;1339;4256
150020;201602;12235;41181;11831;40627;1317;4260;9552;33651;10869;37911
150030;201602;6956;29812;6736;29484;814;3223;5371;24432;6185;27655
150034;201602;4082;11376;3860;11100;190;562;3416;9871;3606;10433
150040;201602;12539;40705;10846;38678;1966;6385;7524;28926;9490;35311
150050;201602;5567;21865;5344;21496;301;1494;4563;18338;4864;19832
150060;201602;17012;53471;15515;51147;2944;9673;9731;33201;12675;42874
150070;201602;5872;24032;5259;23391;310;1557;4665;20931;4975;22488
150080;201602;69516;181166;59704;168485;11745;32737;32914;97635;44659;130372
150085;201602;5199;17848;4961;17540;490;1480;4094;15042;4584;16522
150090;201602;9971;38474;9455;37728;912;3713;7340;29984;8252;33697
150095;201602;5142;17061;4702;16423;405;1321;3695;13412;4100;14733
150100;201602;3139;11861;2956;11554;171;853;2369;9090;2540;9943
150110;201602;3233;16179;3226;16162;254;1272;2779;14144;3033;15416
150120;201602;6239;23382;6093;23158;606;2246;4874;19080;5480;21326
150125;201602;677;2004;599;1910;107;380;381;1211;488;1591
150130;201602;21590;65638;20016;63494;2420;7392;14644;47861;17064;55253
150140;201602;156150;440510;146897;428614;17017;49071;111591;330980;128608;380051
150145;201602;4357;14101;3988;13631;580;2108;2985;10392;3565;12500
150150;201602;11600;35571;10692;34241;1891;6386;6805;22099;8696;28485
150157;201602;3037;9160;2654;8619;367;1364;1813;5970;2180;7334
150160;201602;3047;9827;2867;9564;946;3202;1410;4889;2356;8091
150170;201602;21319;78990;20156;77137;3180;12417;13916;54382;17096;66799
150172;201602;3001;10292;2645;9703;419;1560;1764;6675;2183;8235
150175;201602;1881;5746;1765;5618;155;501;1425;4717;1580;5218
150178;201602;9805;30632;8699;29404;1152;4159;6068;21231;7220;25390
150180;201602;18009;72435;17330;71556;1401;6509;14455;60141;15856;66650
150190;201602;6804;23201;6540;22839;277;1053;5856;20633;6133;21686
150195;201602;5052;16896;4714;16363;271;1049;4024;14058;4295;15107
150200;201602;5212;16639;4978;16371;127;422;4633;15390;4760;15812
150210;201602;24302;91944;23526;90861;2268;8629;18985;75571;21253;84200
150215;201602;6652;21121;5875;19898;1702;6005;2382;8284;4084;14289
150220;201602;11857;37031;10629;35141;2405;8153;5318;18090;7723;26243
150230;201602;11438;36560;10028;34596;1373;5154;6677;23408;8050;28562
150240;201602;34770;103384;30626;96383;10123;32952;8906;29401;19029;62353
150250;201602;3940;16434;3806;16242;656;2811;2665;11811;3321;14622
150260;201602;2023;8086;1932;7928;413;1694;1131;4828;1544;6522
150270;201602;8399;25975;6720;23829;1778;6576;3598;13165;5376;19741
150275;201602;5796;21143;5510;20685;708;2609;3959;15253;4667;17862
150276;201602;2014;6138;1787;5833;429;1482;1129;3705;1558;5187
150277;201602;4696;14705;4089;13954;752;2703;2721;9549;3473;12252
150280;201602;5726;25726;5553;25365;1103;5077;3648;17200;4751;22277
150285;201602;2770;10949;2604;10645;463;1962;1644;6948;2107;8910
150290;201602;9557;28076;9146;27613;692;1734;7761;24318;8453;26052
150293;201602;9425;25892;7193;22834;2149;7279;2339;8217;4488;15496
150295;201602;7142;21437;5944;20036;1459;5050;3252;11858;4711;16908
150300;201602;1855;6381;1751;6242;124;534;1376;4908;1500;5442
150304;201602;3997;12710;3475;11904;577;1985;2202;7833;2779;9818
150307;201602;6309;21452;5869;20840;402;1424;4854;17393;5256;18817
150309;201602;5961;20737;5430;20010;1202;4379;3312;12938;4514;17317
150310;201602;5974;25998;5767;25677;633;3026;4534;20488;5167;23514
150320;201602;9294;22549;8588;21801;554;1198;7353;19032;7907;20230
150330;201602;13431;46269;12595;45060;1779;6368;9122;33740;10901;40108
150340;201602;2383;7751;2204;7475;267;921;1597;5463;1864;6384
150345;201602;6425;21542;6006;20987;585;2034;4747;16989;5332;19023
150350;201602;7715;24205;7191;23530;1219;3377;5150;17782;6369;21159
150360;201602;20457;64101;18002;60954;3067;10334;11770;41700;14837;52034
150370;201602;9672;35562;9062;34756;1305;4792;6746;27121;8051;31913
150375;201602;2816;12382;2738;12278;239;1061;2323;10609;2562;11670
150380;201602;9700;28228;8602;26707;577;1843;7070;22270;7647;24113
150390;201602;7663;33206;7187;32364;1311;5767;4590;21609;5901;27376
150400;201602;5708;22706;5496;22301;485;1988;4332;17945;4817;19933
150405;201602;8045;24423;7157;23333;1317;3540;4779;17215;6096;20755
150410;201602;1539;5916;1432;5696;198;897;872;3467;1070;4364
150420;201602;35635;120234;30333;111675;9292;37278;9422;36782;18714;74060
150430;201602;7140;24286;6797;23747;920;3139;4953;17804;5873;20943
150440;201602;5311;18582;5109;18310;880;3039;3628;13477;4508;16516
150442;201602;20663;60315;18482;57035;3513;10850;10941;35017;14454;45867
150445;201602;4994;17496;4656;16927;622;2253;3376;12586;3998;14839
150450;201602;4216;20499;4082;20304;342;1759;3372;17082;3714;18841
150460;201602;6619;25274;6094;24643;349;1805;5119;21164;5468;22969
150470;201602;16826;51924;16178;51164;442;1162;15176;48598;15618;49760
150475;201602;2999;10412;2775;10124;262;977;2226;8289;2488;9266
150480;201602;13546;46322;12559;44843;1280;4779;9890;35864;11170;40643
150490;201602;6815;26386;6667;26172;293;1261;5864;23263;6157;24524
150495;201602;4779;18064;4656;17901;209;874;4239;16381;4448;17255
150497;201602;2644;9829;2399;9358;787;3223;1024;4082;1811;7305
150500;201602;3060;8530;2848;8231;260;753;2222;6400;2482;7153
150503;201602;3590;11053;3080;10418;1040;3614;1555;5517;2595;9131
150506;201602;10924;38333;9940;36932;2429;8649;5862;23508;8291;32157
150510;201602;9359;37119;8647;35729;1392;5876;5622;24187;7014;30063
150520;201602;6599;26072;6488;25929;258;1027;5999;24211;6257;25238
150530;201602;12006;41094;10854;39361;1128;3919;8252;30597;9380;34516
150540;201602;4558;13971;4089;13324;281;926;3320;10862;3601;11788
150543;201602;5520;17174;4948;16362;1022;3490;2940;10086;3962;13576
150548;201602;8825;28529;8301;27855;510;1638;7391;25155;7901;26793
150549;201602;1991;6514;1841;6347;77;291;1657;5767;1734;6058
150550;201602;19570;62063;17191;58118;5152;17941;6379;22575;11531;40516
150553;201602;22412;77296;18856;70074;6828;27198;4253;16248;11081;43446
150555;201602;1638;5018;1406;4632;92;346;1072;3549;1164;3895
150560;201602;1934;6317;1821;6093;288;959;1128;3783;1416;4742
150563;201602;2622;8717;2439;8410;619;2334;1266;4343;1885;6677
150565;201602;3723;12899;3407;12406;212;973;2770;10139;2982;11112
150570;201602;5595;20779;5464;20551;399;1761;4387;16569;4786;18330
150580;201602;9307;39437;9073;39170;585;2572;7969;35053;8554;37625
150590;201602;5620;22538;5414;22278;170;794;4982;20557;5152;21351
150600;201602;7654;29899;7359;29476;388;1713;6485;26178;6873;27891
150610;201602;2342;7993;2148;7607;228;882;1484;5209;1712;6091
150611;201602;2669;9287;2512;9004;183;715;2009;7238;2192;7953
150613;201602;11629;35225;9745;32392;3196;11223;3752;12825;6948;24048
150616;201602;2951;9062;2301;8001;562;2163;753;2504;1315;4667
150618;201602;6127;21247;5586;20274;1580;5845;2699;10112;4279;15957
150619;201602;5060;17395;4692;16820;576;2258;3347;12037;3923;14295
150620;201602;6234;22453;5726;21800;751;2907;4359;17045;5110;19952
150630;201602;5616;17079;5329;16741;589;1924;4279;13708;4868;15632
150635;201602;3891;12801;3524;12084;849;3045;1569;5549;2418;8594
150640;201602;1774;5403;1706;5322;226;652;1361;4476;1587;5128
150650;201602;12149;36651;10865;34495;2895;9295;4633;15408;7528;24703
150655;201602;4850;16315;4573;15807;660;2311;3228;11348;3888;13659
150658;201602;4263;13093;3751;12389;921;3295;2125;7215;3046;10510
150660;201602;5434;17214;4980;16557;1177;3905;2647;9142;3824;13047
150670;201602;6844;18503;5741;17125;762;2373;4287;13169;5049;15542
150680;201602;55241;196182;48806;185323;14712;58229;18774;77243;33486;135472
150690;201602;2007;6196;1818;5905;295;897;1192;4001;1487;4898
150700;201602;6111;19057;5609;18412;986;3325;3649;12354;4635;15679
150710;201602;4207;14252;3782;13564;448;1680;2691;9872;3139;11552
150715;201602;4825;15324;4214;14403;504;1954;3061;10497;3565;12451
150720;201602;6370;26076;6033;25474;801;3531;4303;18786;5104;22317
150730;201602;9546;32673;8929;31637;1020;3709;6930;25145;7950;28854
150740;201602;3630;11677;3261;11023;658;2321;1729;5898;2387;8219
150745;201602;5035;16059;4563;15409;1113;3932;2717;9207;3830;13139
150746;201602;1384;4484;1322;4377;129;412;944;3166;1073;3578
150747;201602;5267;16539;4688;15813;378;1088;3567;13002;3945;14090
150750;201602;3148;10408;2923;10125;208;841;2376;8263;2584;9104
150760;201602;10703;34940;9988;33997;2194;7617;6195;21641;8389;29258
150770;201602;5727;21896;5446;21421;440;1645;4496;18706;4936;20351
150775;201602;1092;3353;949;3097;192;747;493;1560;685;2307
150780;201602;3174;10405;3083;10305;101;366;2832;9501;2933;9867
150790;201602;4857;15950;4539;15575;358;1290;3622;13161;3980;14451
150795;201602;15026;47476;13576;45313;3044;10064;7887;27594;10931;37658
150796;201602;2969;8844;2701;8528;377;1214;1992;6471;2369;7685
150797;201602;3576;12276;3318;11844;112;486;2809;10007;2921;10493
150800;201602;13368;44407;12325;43122;2711;8896;8018;29892;10729;38788
150803;201602;6464;23586;6086;22974;699;2769;4418;16916;5117;19685
150805;201602;2520;9094;2365;8836;322;1198;1695;6445;2017;7643
150808;201602;5558;18613;4637;16869;1822;7236;650;2410;2472;9646
150810;201602;18461;57503;15649;54104;2257;7472;10406;38285;12663;45757
150812;201602;5098;16201;4699;15534;509;1944;3253;10440;3762;12384
150815;201602;8249;27257;7411;26207;808;2902;5793;21024;6601;23926
150820;201602;11138;32165;9986;30886;739;1769;8213;26259;8952;28028
150830;201602;12710;47932;11935;46930;675;3338;9712;39266;10387;42604
150835;201602;1993;7036;1853;6778;453;1657;875;3328;1328;4985
150840;201602;6709;20610;5634;18847;1313;4818;2627;8782;3940;13600
160005;201602;719;2531;684;2460;66;275;541;1918;607;2193
160010;201602;1283;4321;1279;4316;48;103;1218;4184;1266;4287
160015;201602;1654;6146;1618;6098;93;345;1458;5582;1551;5927
160020;201602;1878;6841;1774;6708;218;863;1328;5139;1546;6002
160021;201602;967;4165;934;4107;148;762;650;2870;798;3632
160023;201602;995;4026;988;4017;104;421;811;3339;915;3760
160025;201602;1271;3929;1258;3916;27;102;1212;3761;1239;3863
160027;201602;7875;23594;7277;22934;2368;7099;3949;13446;6317;20545
160030;201602;44956;158946;40409;151159;9792;36943;21198;84376;30990;121319
160040;201602;4259;16653;4163;16519;176;1006;3802;14877;3978;15883
160050;201602;2978;11418;2668;10976;1379;5588;763;3531;2142;9119
160053;201602;2670;10408;2609;10320;521;2150;1761;7073;2282;9223
160055;201602;519;2084;512;2075;32;137;444;1806;476;1943
160060;201602;15081;51476;14112;50378;2745;9359;9679;35861;12424;45220
160070;201602;2420;9566;2281;9325;177;875;1921;7785;2098;8660
160080;201602;2491;9458;2451;9410;101;500;2283;8689;2384;9189
170025;201602;486;1616;445;1558;126;446;221;806;347;1252
170030;201602;1121;3682;987;3446;286;1023;344;1256;630;2279
170035;201602;1403;4096;1156;3666;250;882;475;1493;725;2375
170040;201602;1861;5929;1650;5659;201;800;1051;3775;1252;4575
170070;201602;1605;4352;1272;3906;278;926;676;2049;954;2975
170100;201602;2285;6877;1999;6456;241;778;1502;4905;1743;5683
170105;201602;730;2292;576;1981;117;454;265;869;382;1323
170110;201602;925;3057;811;2857;185;708;341;1222;526;1930
170130;201602;1311;4196;1095;3784;316;1126;457;1644;773;2770
170190;201602;1513;4483;1161;3908;429;1411;205;831;634;2242
170200;201602;1552;4370;1017;3353;259;918;230;736;489;1654
170210;201602;30826;87785;24887;78353;7285;24780;6279;20993;13564;45773
170215;201602;1158;3631;985;3368;83;348;701;2369;784;2717
170220;201602;5496;19089;5081;18283;1260;4699;2504;9203;3764;13902
170230;201602;1334;4336;1113;3913;235;932;465;1596;700;2528
170240;201602;2587;7907;2160;7252;270;1075;1445;4798;1715;5873
170255;201602;3251;10511;2754;9645;823;2919;1140;4180;1963;7099
170270;201602;959;2454;691;2087;68;216;469;1407;537;1623
170290;201602;2767;8399;2505;8098;212;469;2080;7178;2292;7647
170300;201602;1878;5800;1566;5298;192;734;993;3392;1185;4126
170305;201602;732;2191;600;1957;110;400;292;957;402;1357
170307;201602;1013;3623;859;3343;177;786;396;1597;573;2383
170310;201602;1556;4343;1180;3714;311;1035;503;1615;814;2650
170320;201602;1097;3170;796;2650;202;722;245;843;447;1565
170330;201602;764;2494;692;2381;82;318;513;1734;595;2052
170360;201602;442;1405;367;1275;84;306;161;556;245;862
170370;201602;1318;3799;1037;3352;200;727;519;1659;719;2386
170380;201602;1693;5490;1378;4975;230;950;702;2550;932;3500
170382;201602;548;1814;469;1688;90;367;271;974;361;1341
170384;201602;1505;6159;1383;5926;328;1479;721;3146;1049;4625
170386;201602;862;2595;751;2429;191;706;313;977;504;1683
170388;201602;610;1844;500;1667;106;409;180;575;286;984
170389;201602;896;3026;814;2891;79;326;592;2082;671;2408
170390;201602;1204;3544;1036;3337;89;313;801;2624;890;2937
170410;201602;528;1681;446;1538;38;162;281;962;319;1124
170460;201602;473;1293;322;1040;71;261;101;323;172;584
170510;201602;745;2517;603;2261;77;336;298;1106;375;1442
170550;201602;6590;18795;4916;15916;1524;5439;621;2035;2145;7474
170555;201602;1266;3712;1022;3331;203;705;481;1627;684;2332
170560;201602;1009;3342;800;3070;168;702;439;1781;607;2483
170600;201602;1272;3752;1136;3567;266;818;713;2319;979;3137
170610;201602;1564;4805;1255;4318;136;522;774;2685;910;3207
170625;201602;406;1243;307;1053;56;187;88;309;144;496
170650;201602;1161;3814;998;3527;252;957;367;1395;619;2352
170700;201602;4000;12610;3246;11360;695;2643;1361;4938;2056;7581
170710;201602;1740;5205;1411;4616;220;754;806;2683;1026;3437
170720;201602;1796;4895;1532;4479;242;613;1066;3293;1308;3906
170730;201602;933;2778;769;2521;198;688;316;1053;514;1741
170740;201602;2110;7508;1834;7008;286;1151;1144;4447;1430;5598
170755;201602;742;2353;602;2047;116;460;219;728;335;1188
170765;201602;1275;3488;972;3001;272;883;360;1156;632;2039
170770;201602;1637;5624;1496;5383;248;938;909;3311;1157;4249
170820;201602;3405;11084;3079;10554;686;2485;1461;5072;2147;7557
170825;201602;685;2060;569;1842;99;336;242;766;341;1102
170830;201602;1356;4006;1171;3733;125;319;947;3156;1072;3475
170900;201602;2432;8750;2306;8545;208;798;1847;6960;2055;7758
170930;201602;3483;10803;3060;10111;874;3041;1177;4027;2051;7068
170950;201602;13442;39126;10106;33326;2976;11175;1544;5159;4520;16334
170980;201602;484;1454;367;1267;83;319;142;471;225;790
171050;201602;1455;4958;1316;4705;88;400;1029;3645;1117;4045
171070;201602;1432;4583;1312;4409;348;1148;660;2343;1008;3491
171090;201602;1021;2813;848;2569;63;178;612;1867;675;2045
171110;201602;575;1703;434;1443;122;446;169;528;291;974
171150;201602;862;2471;638;2084;100;359;371;1219;471;1578
171180;201602;684;2070;483;1660;114;417;177;656;291;1073
171190;201602;1576;5894;1399;5516;289;1192;642;2684;931;3876
171195;201602;789;2839;687;2649;102;425;387;1535;489;1960
171200;201602;665;2100;536;1853;162;623;178;563;340;1186
171215;201602;447;1335;346;1131;59;212;151;507;210;719
171240;201602;690;2520;636;2415;76;353;411;1604;487;1957
171245;201602;602;2017;496;1768;100;406;153;527;253;933
171250;201602;997;2965;812;2659;141;501;427;1369;568;1870
171270;201602;388;1609;366;1560;122;495;134;654;256;1149
171280;201602;859;2632;718;2395;178;586;303;1120;481;1706
171320;201602;3704;11271;3136;10306;886;2916;1297;4426;2183;7342
171330;201602;2736;7992;2230;7201;640;2189;923;2962;1563;5151
171360;201602;1305;4405;1188;4222;156;582;804;2901;960;3483
171370;201602;625;1827;541;1711;121;423;285;893;406;1316
171380;201602;1260;4095;1057;3733;421;1485;273;1057;694;2542
171395;201602;848;2610;668;2265;134;539;301;975;435;1514
171420;201602;2042;6359;1621;5583;400;1450;571;1986;971;3436
171430;201602;1032;3187;861;2910;188;654;428;1450;616;2104
171488;201602;2431;7461;2101;6991;481;1572;1104;3866;1585;5438
171500;201602;738;2282;642;2127;84;263;439;1512;523;1775
171510;201602;864;3044;779;2902;68;297;555;2100;623;2397
171515;201602;464;1347;375;1191;57;180;207;649;264;829
171525;201602;612;1979;522;1835;87;344;287;969;374;1313
171550;201602;308;1050;239;918;84;358;43;173;127;531
171570;201602;1193;3800;1042;3504;204;662;662;2286;866;2948
171575;201602;1840;5229;1400;4442;268;873;618;2014;886;2887
171610;201602;5062;16270;4254;14880;1124;4381;1290;4584;2414;8965
171620;201602;2517;7423;2195;6994;98;406;1841;5875;1939;6281
171630;201602;848;2661;698;2421;222;825;285;1002;507;1827
171650;201602;2072;6522;1633;5628;441;1622;498;1741;939;3363
171660;201602;2353;6590;1836;5687;227;790;1071;3320;1298;4110
171665;201602;1429;4198;1157;3784;180;657;655;2235;835;2892
171670;201602;1858;5336;1551;4833;426;1447;620;1899;1046;3346
171700;201602;1071;3472;927;3203;123;481;595;2029;718;2510
171720;201602;701;2086;592;1909;196;640;223;762;419;1402
171750;201602;1131;3540;881;3050;253;879;246;900;499;1779
171780;201602;1100;3072;849;2714;96;332;495;1629;591;1961
171790;201602;1316;4647;1196;4435;247;889;738;2895;985;3784
171800;201602;617;1975;552;1887;74;278;375;1325;449;1603
171820;201602;9664;28718;8074;26420;1625;5753;4136;13740;5761;19493
171830;201602;1320;4990;1193;4712;309;1187;515;2133;824;3320
171840;201602;761;2102;652;1952;39;120;536;1615;575;1735
171845;201602;692;1927;542;1674;93;318;271;854;364;1172
171850;201602;913;3289;812;3090;102;450;506;1907;608;2357
171855;201602;1078;3471;990;3311;79;320;728;2389;807;2709
171865;201602;437;1444;380;1354;78;293;186;655;264;948
171870;201602;703;2128;568;1886;138;504;202;713;340;1217
171875;201602;1235;3993;1043;3695;106;458;699;2434;805;2892
171880;201602;778;2970;761;2946;87;339;599;2384;686;2723
171884;201602;956;2661;703;2290;165;596;187;723;352;1319
171886;201602;1364;4479;1105;3953;325;1268;235;844;560;2112
171888;201602;674;2034;526;1752;52;171;287;999;339;1170
171889;201602;494;1572;443;1491;96;341;221;794;317;1135
171890;201602;1168;3653;984;3388;144;551;568;1949;712;2500
171900;201602;476;1777;420;1672;112;446;188;780;300;1226
172000;201602;525;1767;458;1639;72;280;258;915;330;1195
172010;201602;1142;4009;1061;3878;126;553;764;2783;890;3336
172015;201602;313;1240;267;1153;54;222;149;681;203;903
172020;201602;2203;7406;2051;7163;275;998;1407;5003;1682;6001
172025;201602;689;2020;514;1720;89;326;243;849;332;1175
172030;201602;1126;3691;1000;3482;71;313;747;2574;818;2887
172049;201602;1297;3449;968;2892;146;427;695;2152;841;2579
172065;201602;1263;3420;1053;3184;58;171;953;2936;1011;3107
172080;201602;2339;7407;2024;6859;214;849;1294;4341;1508;5190
172085;201602;491;1362;356;1102;53;151;98;309;151;460
172090;201602;3357;9725;2769;8836;214;770;2154;6938;2368;7708
172093;201602;587;1792;469;1599;121;479;223;761;344;1240
172097;201602;573;1755;471;1598;108;365;191;670;299;1035
172100;201602;31995;95508;24827;83054;6839;25539;6066;20504;12905;46043
172110;201602;1622;6111;1447;5830;175;792;1027;4235;1202;5027
172120;201602;4910;15388;4094;14240;646;2234;2568;9335;3214;11569
172125;201602;242;784;203;712;40;164;87;307;127;471
172130;201602;531;1489;420;1310;37;144;277;863;314;1007
172208;201602;2023;6081;1821;5794;306;995;1058;3432;1364;4427
172210;201602;2411;7473;2127;7062;528;1886;1052;3471;1580;5357
210005;201602;21280;66554;18079;61675;5754;20981;6421;22410;12175;43391
210010;201602;1563;5665;1420;5416;123;531;1077;4154;1200;4685
210015;201602;3297;10536;2938;9998;189;534;2494;8735;2683;9269
210020;201602;6988;16954;6579;16480;209;547;5975;14908;6184;15455
210030;201602;5411;18167;5077;17712;325;1471;4177;14493;4502;15964
210040;201602;1829;5138;1689;4977;91;276;1466;4344;1557;4620
210043;201602;6562;18572;5682;17474;590;1693;4076;13291;4666;14984
210047;201602;6411;24328;5851;23454;598;2775;4342;17451;4940;20226
210050;201602;2239;8331;1884;7641;672;2789;606;2686;1278;5475
210055;201602;1713;5886;1560;5662;161;621;1169;4288;1330;4909
210060;201602;7107;27694;6615;26795;1012;4215;4278;17839;5290;22054
210070;201602;6980;20668;6452;20018;155;597;5799;18069;5954;18666
210080;201602;3605;12490;3513;12374;43;213;3325;11706;3368;11919
210083;201602;4271;14996;3936;14642;130;573;3682;13763;3812;14336
210087;201602;2883;8556;2624;8222;291;940;2059;6559;2350;7499
210090;201602;9738;32055;9236;31260;523;1890;7884;26835;8407;28725
210095;201602;5843;21402;5617;21089;370;1515;4670;17737;5040;19252
210100;201602;7113;21519;6530;20814;814;2782;4968;15785;5782;18567
210110;201602;2791;9818;2700;9694;102;472;2431;8697;2533;9169
210120;201602;25707;70311;22434;66551;2738;6867;16229;51715;18967;58582
210125;201602;3488;11187;3368;11062;201;513;2965;10041;3166;10554
210130;201602;4071;12138;3777;11728;290;917;3074;9582;3364;10499
210135;201602;1648;4870;1441;4576;103;342;1157;3704;1260;4046
210140;201602;16614;53284;14507;50458;2671;9783;8864;32048;11535;41831
210150;201602;4509;11149;4054;10590;61;165;3796;9915;3857;10080
210160;201602;17250;54564;16216;53082;1430;4257;13043;43989;14473;48246
210170;201602;13604;48739;13250;48296;707;2647;11758;43380;12465;46027
210173;201602;1926;7955;1861;7854;116;686;1595;6621;1711;7307
210177;201602;3010;9383;2858;9207;161;536;2543;8272;2704;8808
210180;201602;1452;4472;1361;4338;61;221;1147;3628;1208;3849
210190;201602;4769;15264;4422;14633;229;994;3394;11028;3623;12022
210193;201602;1372;4330;1237;4109;74;262;1014;3423;1088;3685
210197;201602;2069;6888;1911;6706;238;805;1463;5320;1701;6125
210200;201602;8284;27995;7677;27128;1070;3542;5672;20924;6742;24466
210203;201602;6447;20763;6131;20352;389;1129;5289;17874;5678;19003
210207;201602;2908;9559;2735;9249;324;1058;1939;6742;2263;7800
210210;201602;8332;28179;7983;27715;79;378;7317;25936;7396;26314
210215;201602;1144;4806;1095;4728;99;479;869;3813;968;4292
210220;201602;5979;22856;5691;22393;375;1706;4700;18643;5075;20349
210230;201602;4995;16483;4707;16043;265;953;4007;13785;4272;14738
210232;201602;12644;40901;10659;38392;1558;5910;6854;26602;8412;32512
210235;201602;3550;11192;3181;10729;179;731;2690;9105;2869;9836
210237;201602;2304;8923;2242;8833;44;230;2111;8342;2155;8572
210240;201602;2980;9371;2790;9111;164;495;2325;7675;2489;8170
210250;201602;5057;16444;4763;16060;132;646;4302;14394;4434;15040
210255;201602;2496;8098;2285;7732;322;1154;1608;5479;1930;6633
210260;201602;5043;16570;4644;15973;613;2015;3366;11986;3979;14001
210270;201602;5319;15041;4673;14152;129;595;4104;12315;4233;12910
210275;201602;3546;8629;3402;8477;50;72;3277;8289;3327;8361
210280;201602;5490;16645;4761;15660;279;1171;3642;11829;3921;13000
210290;201602;5492;18389;5080;17899;335;1178;4279;15320;4614;16498
210300;201602;37031;104120;30832;96534;2122;7152;23250;75985;25372;83137
210310;201602;2861;8091;2632;7796;79;186;2316;6942;2395;7128
210312;201602;2173;6904;2074;6776;65;304;1823;5930;1888;6234
210315;201602;2569;8560;2385;8318;157;607;2028;7156;2185;7763
210317;201602;4086;12524;3896;12293;175;622;3509;11115;3684;11737
210320;201602;18912;61076;17439;59307;932;3337;14794;51225;15726;54562
210325;201602;3553;11177;3162;10585;258;977;2428;8243;2686;9220
210330;201602;35541;86506;28025;78439;4105;9815;17996;57909;22101;67724
210340;201602;11478;34895;10466;33584;1187;3316;7658;26344;8845;29660
210350;201602;9790;30443;8875;29173;653;2154;7063;23569;7716;25723
210355;201602;3817;14115;3526;13686;205;900;2996;11858;3201;12758
210360;201602;15687;47903;14360;46095;1084;3812;11247;36251;12331;40063
210370;201602;9237;22254;7783;20703;296;573;6840;18926;7136;19499
210375;201602;3046;9338;2597;8761;776;2692;1214;4260;1990;6952
210380;201602;6003;16716;5347;15823;441;1199;4318;13080;4759;14279
210390;201602;2835;10181;2585;9785;141;742;2176;8217;2317;8959
210400;201602;4710;14990;4513;14768;128;391;4249;14034;4377;14425
210405;201602;8216;22544;6625;20318;2185;6757;2235;7724;4420;14481
210407;201602;2009;7173;1747;6729;210;791;1246;4938;1456;5729
210408;201602;2379;9247;2227;9057;144;671;1875;7875;2019;8546
210409;201602;3643;13404;3442;13118;220;1063;2804;10711;3024;11774
210410;201602;3462;11590;3367;11481;344;1014;2719;9746;3063;10760
210420;201602;3953;13166;3629;12617;271;905;2894;10281;3165;11186
210430;201602;2146;6646;2070;6560;115;367;1809;5767;1924;6134
210440;201602;3898;12332;3780;12183;198;574;3406;11139;3604;11713
210450;201602;2778;8754;2476;8315;144;516;1978;6619;2122;7135
210455;201602;3846;11328;3462;10760;556;1712;2383;7738;2939;9450
210460;201602;3540;11766;3305;11397;186;754;2710;9359;2896;10113
210462;201602;1447;5287;1354;5117;91;441;1066;4024;1157;4465
210465;201602;2494;8332;2333;8107;204;595;1931;6945;2135;7540
210467;201602;6048;20264;5647;19800;411;1491;4727;16809;5138;18300
210470;201602;2016;5496;1544;4815;82;235;1147;3636;1229;3871
210480;201602;14080;45737;12378;43540;2595;8916;7797;29463;10392;38379
210490;201602;3550;10006;3116;9409;146;492;2599;7827;2745;8319
210500;201602;6194;25670;5971;25280;727;3046;4449;19449;5176;22495
210510;201602;6416;21976;6084;21590;365;1115;5156;18903;5521;20018
210515;201602;3572;11495;3421;11325;91;288;3196;10734;3287;11022
210520;201602;2545;7849;2331;7550;158;484;1946;6434;2104;6918
210530;201602;35978;111462;29205;101327;7422;28987;11919;42797;19341;71784
210535;201602;3161;10964;3036;10798;102;346;2734;9863;2836;10209
210540;201602;13289;43781;11674;41509;2563;8845;6432;24899;8995;33744
210542;201602;5657;16488;5191;15985;312;752;4490;14252;4802;15004
210545;201602;2276;7455;2169;7275;59;305;1904;6313;1963;6618
210547;201602;3699;13222;3465;12841;287;964;2687;10267;2974;11231
210550;201602;5984;17905;5497;17399;263;626;5028;16365;5291;16991
210560;201602;4049;12759;3629;12074;196;743;3018;10032;3214;10775
210565;201602;1465;5239;1257;4910;104;527;918;3614;1022;4141
210570;201602;12190;34628;11068;33357;789;1773;9439;29517;10228;31290
210580;201602;3115;9299;2804;8915;313;726;2134;7412;2447;8138
210590;201602;4005;12689;3718;12330;313;1105;3110;10366;3423;11471
210592;201602;2429;7677;2339;7532;42;188;2068;6657;2110;6845
210594;201602;2627;7411;2141;6702;106;298;1669;5394;1775;5692
210596;201602;2646;9898;2507;9635;283;1162;1826;7149;2109;8311
210598;201602;1850;5792;1694;5602;99;369;1449;4759;1548;5128
210600;201602;3148;9186;2764;8676;184;601;2172;6830;2356;7431
210610;201602;2465;8191;2313;7994;125;554;2006;6840;2131;7394
210620;201602;1875;6103;1759;5964;52;148;1589;5506;1641;5654
210630;201602;3571;12718;3206;12122;355;1557;2193;8342;2548;9899
210632;201602;4438;15595;4148;15171;442;1754;3185;11680;3627;13434
210635;201602;1852;6518;1757;6375;125;423;1504;5573;1629;5996
210637;201602;2621;8923;2418;8648;160;636;1955;7048;2115;7684
210640;201602;4145;15122;4076;15045;8;33;3972;14806;3980;14839
210650;201602;6785;20734;6583;20488;257;814;6155;19229;6412;20043
210660;201602;7849;23632;7284;22833;259;946;6622;20710;6881;21656
210663;201602;2678;8040;2518;7851;195;687;2081;6529;2276;7216
210667;201602;1808;6341;1711;6194;87;390;1469;5345;1556;5735
210670;201602;4367;16330;4156;15985;231;1054;3439;13337;3670;14391
210675;201602;4960;13854;4587;13407;360;908;3790;11421;4150;12329
210680;201602;4028;11146;3592;10631;195;514;3064;9196;3259;9710
210690;201602;7187;24249;6906;23952;275;901;6112;21869;6387;22770
210700;201602;2570;7727;2386;7526;387;927;1662;6025;2049;6952
210710;201602;4762;15743;4500;15341;207;890;3787;12856;3994;13746
210720;201602;2534;9260;2394;9066;143;660;2088;7859;2231;8519
210725;201602;1071;4066;961;3868;123;533;594;2457;717;2990
210730;201602;1104;3509;985;3336;107;304;749;2621;856;2925
210735;201602;4073;14234;3729;13671;643;2399;2505;9517;3148;11916
210740;201602;4904;14647;4634;14370;207;904;4183;12694;4390;13598
210745;201602;3851;11462;3609;11158;252;689;3022;9452;3274;10141
210750;201602;20093;54561;17750;51934;1977;5772;13527;40656;15504;46428
210760;201602;5810;16484;5408;16063;39;137;5252;15647;5291;15784
210770;201602;5788;16028;5070;15213;123;512;4580;13703;4703;14215
210780;201602;8093;27166;7435;26072;841;3019;5245;18889;6086;21908
210790;201602;4593;14532;4180;14056;280;721;3407;12109;3687;12830
210800;201602;4710;13437;4272;12920;153;466;3779;11552;3932;12018
210805;201602;3673;15468;3545;15246;170;901;3044;13190;3214;14091
210810;201602;5295;16277;4920;15801;362;744;4202;14135;4564;14879
210820;201602;7602;22143;6943;21213;1166;3424;4580;14459;5746;17883
210825;201602;5580;19319;5321;18965;645;2194;4097;15091;4742;17285
210830;201602;8192;24295;7784;23808;868;2292;6155;19636;7023;21928
210840;201602;3609;9944;3246;9414;165;422;2667;7771;2832;8193
210845;201602;5672;17464;5492;17269;91;209;5260;16782;5351;16991
210850;201602;5955;21332;5408;20430;713;3033;3677;13917;4390;16950
210860;201602;17495;52155;15765;49818;1378;4384;12231;39293;13609;43677
210870;201602;5732;19343;5254;18741;577;2014;3986;14521;4563;16535
210880;201602;4210;13764;4013;13511;326;1205;3292;11107;3618;12312
210890;201602;5130;15173;4669;14646;507;1447;3746;12279;4253;13726
210900;201602;4881;14675;4040;13312;1445;5018;1013;3598;2458;8616
210905;201602;1793;5706;1620;5470;140;377;1263;4447;1403;4824
210910;201602;8440;26961;7632;25641;1138;4088;5105;17297;6243;21385
210920;201602;2870;10372;2748;10169;172;792;2242;8288;2414;9080
210923;201602;1487;5125;1383;4975;149;607;924;3443;1073;4050
210927;201602;4730;15221;4487;14964;55;206;4302;14426;4357;14632
210930;201602;2410;8930;2275;8736;135;765;1909;7191;2044;7956
210940;201602;2795;10859;2736;10750;177;800;2308;9051;2485;9851
210945;201602;5786;17572;5597;17373;264;362;5222;16684;5486;17046
210950;201602;5245;16176;4553;15093;426;1428;3374;11443;3800;12871
210955;201602;1859;6039;1651;5733;184;645;1144;4149;1328;4794
210960;201602;8610;28318;8243;27825;2140;7004;4738;16995;6878;23999
210970;201602;1328;4764;1180;4530;157;696;810;3106;967;3802
210975;201602;1748;5879;1677;5760;124;458;1327;4584;1451;5042
210980;201602;9824;23468;9500;23138;788;1552;8251;20761;9039;22313
210990;201602;16517;50309;13451;46146;3113;11224;6647;23860;9760;35084
211000;201602;15114;49071;13471;47114;814;3444;11129;39499;11943;42943
211003;201602;4718;16912;4320;16369;315;1468;3263;12671;3578;14139
211010;201602;6396;23358;6142;23062;85;400;5839;22056;5924;22456
211020;201602;7318;23826;7107;23517;631;2231;5751;19033;6382;21264
211023;201602;2208;7509;2134;7387;183;687;1732;6013;1915;6700
211027;201602;2892;11189;2816;11072;300;1219;2238;8915;2538;10134
211030;201602;3800;11750;3555;11491;582;1377;2663;9401;3245;10778
211040;201602;4250;16180;4084;15926;149;808;3554;13925;3703;14733
211050;201602;9981;26020;9623;25630;310;775;8953;23907;9263;24682
211060;201602;6004;21425;5830;21186;463;1739;4976;18309;5439;20048
211065;201602;1858;6206;1718;6027;70;216;1576;5624;1646;5840
211070;201602;7957;27493;7329;26482;416;1642;6060;22186;6476;23828
211080;201602;1316;4062;1130;3779;82;392;864;2776;946;3168
211085;201602;1849;6391;1689;6121;295;1101;1068;3948;1363;5049
211090;201602;3453;10176;3237;9884;126;521;2780;8353;2906;8874
211100;201602;6538;16882;6395;16733;37;127;6228;16322;6265;16449
211102;201602;2960;11255;2795;11025;246;989;2322;9346;2568;10335
211105;201602;2627;8492;2249;7921;218;870;1652;5773;1870;6643
211107;201602;4335;13963;3931;13448;231;794;3185;11262;3416;12056
211110;201602;6267;18719;5062;16929;998;3265;2949;10383;3947;13648
211120;201602;34993;97643;31551;93628;5652;16016;21127;65625;26779;81641
211125;201602;2066;6601;1831;6232;121;465;1513;5167;1634;5632
211130;201602;133305;370869;121806;356776;22696;67158;74199;224754;96895;291912
211140;201602;5302;17224;4958;16719;185;731;4219;14239;4404;14970
211150;201602;9505;27825;8599;26696;455;1657;7197;22353;7652;24010
211153;201602;2782;8622;2554;8329;376;1163;1908;6448;2284;7611
211157;201602;1187;3814;1029;3579;89;398;681;2448;770;2846
211160;201602;4072;13441;3465;12433;262;1264;2392;8370;2654;9634
211163;201602;1636;5453;1546;5332;39;124;1398;4925;1437;5049
211167;201602;1472;4965;1410;4882;38;181;1313;4544;1351;4725
211170;201602;6237;16614;5977;16309;105;318;5530;15034;5635;15352
211172;201602;2404;7142;2189;6843;131;568;1841;5654;1972;6222
211174;201602;2732;8026;2465;7696;75;372;2214;6793;2289;7165
211176;201602;4174;13151;3597;12398;418;1561;2512;8812;2930;10373
211178;201602;3772;10070;3560;9845;65;168;3389;9374;3454;9542
211180;201602;4145;14603;3911;14257;301;1238;3205;11795;3506;13033
211190;201602;2767;9332;2564;9037;77;376;2236;7875;2313;8251
211195;201602;1453;4446;1216;4154;66;198;1015;3595;1081;3793
211200;201602;2137;7122;1881;6773;374;1277;1120;4333;1494;5610
211210;201602;6712;20725;6388;20300;468;1431;5306;17060;5774;18491
211220;201602;33311;97203;29059;91833;5738;18665;17860;58044;23598;76709
211223;201602;4960;14807;4545;14157;590;1877;3214;10083;3804;11960
211227;201602;1585;5684;1447;5467;150;624;1109;4232;1259;4856
211230;201602;8250;27038;7480;25787;833;2979;5543;19412;6376;22391
211240;201602;7942;27504;7535;27005;265;1206;6743;23981;7008;25187
211245;201602;5353;16061;5318;16024;130;209;5132;15704;5262;15913
211250;201602;12886;42950;12159;42112;1638;4611;9260;34409;10898;39020
211260;201602;8435;26293;8072;25811;552;1920;7056;22538;7608;24458
211270;201602;10132;34944;9085;33640;536;2438;7108;26896;7644;29334
211280;201602;12635;37675;11823;36705;1170;3090;9509;30748;10679;33838
211285;201602;1682;6206;1484;5778;276;1151;730;2979;1006;4130
211290;201602;7090;23444;6817;23095;523;1579;5740;19897;6263;21476
211300;201602;8148;24672;7637;23997;157;463;7105;22527;7262;22990
211400;201602;11644;36526;10313;34689;2844;9782;4781;17713;7625;27495
220005;201602;1817;5241;1675;5036;73;287;1359;3989;1432;4276
220010;201602;1327;3955;1186;3738;56;229;939;2897;995;3126
220020;201602;3222;10284;3057;10015;593;1945;1875;6178;2468;8123
220025;201602;2201;5452;2001;5158;24;75;1701;4325;1725;4400
220027;201602;1350;3659;1216;3486;63;196;994;2866;1057;3062
220030;201602;3097;8687;3038;8603;152;528;2671;7462;2823;7990
220040;201602;7387;23226;6879;22332;1445;4683;4149;13541;5594;18224
220045;201602;1364;4503;1244;4272;59;254;954;3219;1013;3473
220050;201602;4345;13213;3821;12341;213;862;3033;9688;3246;10550
220060;201602;1941;4995;1833;4873;49;99;1665;4443;1714;4542
220070;201602;2365;7039;2176;6739;158;489;1741;5407;1899;5896
220080;201602;684;2091;635;2018;55;231;523;1606;578;1837
220090;201602;1740;4451;1470;4099;56;186;1272;3485;1328;3671
220095;201602;708;1935;661;1872;15;71;606;1680;621;1751
220100;201602;1321;4057;1122;3715;83;329;836;2748;919;3077
220105;201602;2211;7080;1986;6662;163;539;1444;4893;1607;5432
220110;201602;3303;9696;3105;9377;114;466;2708;8031;2822;8497
220115;201602;2392;8295;2299;8148;142;603;2019;7099;2161;7702
220117;201602;1277;3432;1064;3114;69;199;855;2519;924;2718
220120;201602;11997;34923;11131;33897;145;654;10440;31744;10585;32398
220130;201602;800;2863;732;2751;35;204;624;2295;659;2499
220140;201602;1631;4403;1448;4184;214;500;1123;3384;1337;3884
220150;201602;6867;21222;6505;20718;175;739;5716;18015;5891;18754
220155;201602;1094;3367;896;3008;52;216;586;1932;638;2148
220157;201602;1046;2666;937;2505;23;73;816;2156;839;2229
220160;201602;2555;7767;2286;7283;95;426;1827;5729;1922;6155
220170;201602;1341;4138;1158;3843;54;253;920;3025;974;3278
220173;201602;2032;6159;1685;5496;48;227;1328;4257;1376;4484
220177;201602;1745;5190;1716;5152;52;201;1606;4794;1658;4995
220180;201602;1112;3075;938;2749;23;86;653;1831;676;1917
220190;201602;4426;14818;4128;14409;595;2141;3027;10619;3622;12760
220191;201602;1394;4622;1317;4493;156;562;957;3226;1113;3788
220192;201602;1735;4962;1400;4372;99;327;999;3128;1098;3455
220194;201602;1631;4976;1472;4713;107;389;1113;3488;1220;3877
220196;201602;1933;5768;1778;5507;149;519;1382;4266;1531;4785
220198;201602;1314;3775;1017;3384;13;48;950;3206;963;3254
220200;201602;4299;14490;4035;14121;608;2188;2916;10313;3524;12501
220202;201602;2095;6424;1878;6052;43;211;1618;5113;1661;5324
220205;201602;2711;7133;2444;6760;40;162;2184;5973;2224;6135
220207;201602;876;2676;754;2460;70;287;536;1719;606;2006
220208;201602;1785;5760;1549;5349;233;910;926;3189;1159;4099
220209;201602;1508;4600;1368;4380;48;212;1110;3516;1158;3728
220210;201602;1657;4527;1475;4249;35;155;1224;3447;1259;3602
220211;201602;1545;4510;1480;4436;61;252;1292;3807;1353;4059
220213;201602;1695;4864;1577;4649;34;133;1290;3709;1324;3842
220217;201602;1928;6264;1861;6189;41;164;1718;5770;1759;5934
220220;201602;10628;29714;9597;28193;746;1951;7005;21137;7751;23088
220225;201602;1072;3132;901;2904;36;135;743;2373;779;2508
220230;201602;5194;14528;4758;13902;155;463;4227;12400;4382;12863
220240;201602;2851;8895;2642;8525;151;569;2091;6719;2242;7288
220245;201602;1460;3957;1266;3690;23;80;1124;3325;1147;3405
220250;201602;3118;8995;2865;8618;82;330;2498;7503;2580;7833
220253;201602;1600;4855;1384;4465;172;636;961;3059;1133;3695
220255;201602;1700;4843;1478;4469;50;215;1187;3426;1237;3641
220260;201602;4595;14874;4096;13964;314;1115;3000;10342;3314;11457
220265;201602;1309;4554;1195;4377;126;522;755;2818;881;3340
220270;201602;6698;21639;6473;21248;342;1594;5408;17173;5750;18767
220271;201602;1458;4097;1317;3876;84;220;1087;3273;1171;3493
220272;201602;1746;5326;1596;5077;54;226;1257;3933;1311;4159
220273;201602;1184;3471;1053;3241;88;276;762;2343;850;2619
220275;201602;2044;5276;1707;4872;27;121;1539;4328;1566;4449
220277;201602;2181;6158;1943;5793;81;278;1549;4559;1630;4837
220280;201602;1526;4158;1348;3847;85;307;1071;2971;1156;3278
220285;201602;1553;4202;1297;3844;23;94;1168;3477;1191;3571
220290;201602;5803;19785;5083;18783;470;2020;3726;13827;4196;15847
220300;201602;1781;6052;1633;5835;82;437;1329;4635;1411;5072
220310;201602;2325;8081;2207;7949;79;336;1905;7008;1984;7344
220320;201602;3054;9349;2607;8533;262;970;1819;5908;2081;6878
220323;201602;1434;5141;1261;4889;143;596;957;3749;1100;4345
220325;201602;1142;3709;981;3388;78;330;698;2393;776;2723
220327;201602;1280;4157;1179;3986;32;172;963;3180;995;3352
220330;201602;3408;9514;3158;9208;106;310;2857;8406;2963;8716
220335;201602;1808;5580;1644;5395;38;111;1530;5082;1568;5193
220340;201602;1814;5060;1568;4689;96;312;1217;3622;1313;3934
220342;201602;1087;3646;1024;3551;63;280;824;2832;887;3112
220345;201602;2826;7327;2504;6840;66;157;2271;6222;2337;6379
220350;201602;3882;10382;3353;9564;200;598;2583;7321;2783;7919
220360;201602;1245;3506;1082;3252;102;342;815;2411;917;2753
220370;201602;8998;26160;8227;25179;350;1235;7269;22183;7619;23418
220375;201602;1463;4674;1373;4563;13;39;1321;4436;1334;4475
220380;201602;1355;3663;1145;3380;46;166;944;2732;990;2898
220385;201602;824;2132;671;1891;16;62;535;1477;551;1539
220390;201602;9214;28509;8234;26803;2104;7087;3066;10244;5170;17331
220400;201602;1499;3579;1211;3136;42;146;994;2491;1036;2637
220410;201602;1195;3523;1044;3289;71;272;813;2518;884;2790
220415;201602;872;2389;769;2252;54;166;551;1585;605;1751
220420;201602;2119;6172;1806;5557;78;238;1414;4352;1492;4590
220430;201602;2509;7190;2443;7105;135;462;2130;6130;2265;6592
220435;201602;1601;4779;1476;4573;38;155;1225;3764;1263;3919
220440;201602;2324;7764;2188;7587;141;535;1820;6237;1961;6772
220450;201602;2050;6394;1730;5934;388;1415;975;3377;1363;4792
220455;201602;1290;4141;1207;4022;56;208;1084;3633;1140;3841
220460;201602;875;2395;807;2319;41;118;696;1986;737;2104
220465;201602;2282;7648;2091;7352;512;1899;1198;4256;1710;6155
220470;201602;3761;11241;3448;10740;180;587;2690;8299;2870;8886
220480;201602;2452;7041;2200;6685;150;411;1694;5198;1844;5609
220490;201602;2241;6485;2069;6272;61;227;1823;5489;1884;5716
220500;201602;3193;8662;2738;7889;85;394;2184;6107;2269;6501
220510;201602;2697;7857;2202;7016;98;376;1601;5067;1699;5443
220515;201602;1838;4579;1644;4321;146;345;1324;3528;1470;3873
220520;201602;5081;13994;4650;13428;112;342;4170;12107;4282;12449
220525;201602;1256;3592;1195;3497;42;144;1027;2991;1069;3135
220527;201602;1356;4181;1202;3874;136;459;847;2782;983;3241
220530;201602;1227;3557;1091;3357;49;201;947;2849;996;3050
220535;201602;862;2624;819;2567;80;266;615;1918;695;2184
220540;201602;3389;11044;3245;10820;127;557;2809;9288;2936;9845
220545;201602;1362;4593;1297;4471;158;608;953;3250;1111;3858
220550;201602;8980;29028;8363;28021;863;3085;6153;20565;7016;23650
220551;201602;1423;4614;1305;4429;65;298;1047;3507;1112;3805
220552;201602;1559;4909;1354;4513;60;303;1036;3335;1096;3638
220553;201602;1576;4626;1301;4209;50;207;992;3283;1042;3490
220554;201602;777;2294;693;2162;60;204;539;1669;599;1873
220555;201602;2197;6722;2039;6506;48;244;1845;5816;1893;6060
220556;201602;1426;4433;1278;4149;56;226;968;3068;1024;3294
220557;201602;1545;5017;1388;4714;135;478;939;3196;1074;3674
220558;201602;1042;3241;946;3077;53;241;727;2290;780;2531
220559;201602;1495;4245;1362;4014;28;97;1178;3455;1206;3552
220560;201602;1610;4064;1360;3730;55;153;1139;3076;1194;3229
220570;201602;7145;23208;6724;22461;1376;4594;4039;13891;5415;18485
220580;201602;6382;20396;6240;20194;256;880;5667;18297;5923;19177
220585;201602;2004;7042;1886;6827;176;686;1474;5330;1650;6016
220590;201602;1293;3911;1169;3736;185;630;786;2574;971;3204
220595;201602;2269;6759;2116;6558;37;173;1926;5912;1963;6085
220600;201602;1262;3073;1051;2812;171;301;763;2211;934;2512
220605;201602;1916;5639;1675;5256;77;260;1344;4172;1421;4432
220610;201602;2636;8089;2529;7943;58;237;2299;7196;2357;7433
220620;201602;7407;24954;7135;24585;320;1564;6305;21425;6625;22989
220630;201602;388;1208;330;1102;55;190;170;587;225;777
220635;201602;1633;5776;1477;5436;82;414;1069;3838;1151;4252
220640;201602;2604;7659;2350;7304;112;397;1965;6063;2077;6460
220650;201602;2190;6436;1961;6028;126;431;1492;4589;1618;5020
220660;201602;2493;7997;2259;7682;153;736;1872;6164;2025;6900
220665;201602;1143;3970;1069;3839;24;128;947;3388;971;3516
220667;201602;1680;5574;1583;5428;73;252;1320;4541;1393;4793
220669;201602;1844;6074;1749;5910;249;1024;1192;3939;1441;4963
220670;201602;1922;5757;1715;5487;134;355;1407;4643;1541;4998
220672;201602;2441;7099;2300;6932;209;661;1900;5769;2109;6430
220675;201602;1254;3606;1175;3466;66;164;928;2762;994;2926
220680;201602;2281;7299;2151;7129;154;508;1794;6001;1948;6509
220690;201602;1666;4652;1447;4305;115;347;1121;3388;1236;3735
220695;201602;915;2594;837;2465;34;108;663;1945;697;2053
220700;201602;8352;23976;7281;22326;507;1748;5524;16813;6031;18561
220710;201602;799;2379;680;2173;40;118;492;1584;532;1702
220720;201602;2026;5362;1923;5231;53;159;1700;4598;1753;4757
220730;201602;1348;3830;1153;3529;22;106;981;2971;1003;3077
220735;201602;986;2559;797;2231;42;130;639;1767;681;1897
220740;201602;1352;4334;1182;4107;96;321;952;3399;1048;3720
220750;201602;3888;11177;3603;10742;378;949;2805;8607;3183;9556
220755;201602;1188;3354;1066;3159;50;177;854;2491;904;2668
220760;201602;2601;9066;2402;8802;149;747;2008;7253;2157;8000
220770;201602;21732;72301;19546;68161;6336;23158;6167;22484;12503;45642
220775;201602;1237;3331;1194;3283;16;43;1158;3187;1174;3230
220777;201602;1589;4379;1369;4052;68;164;1068;3164;1136;3328
220779;201602;1297;3483;1245;3409;40;158;1116;2967;1156;3125
220780;201602;5754;15566;5095;14589;386;1115;4065;11683;4451;12798
220785;201602;1239;3296;1170;3185;44;117;1061;2868;1105;2985
220790;201602;9883;30467;9166;29375;725;2614;7309;23243;8034;25857
220793;201602;808;2338;734;2230;39;147;607;1840;646;1987
220795;201602;1409;4077;1362;4014;60;178;1239;3673;1299;3851
220800;201602;15845;43640;14295;41480;910;3100;10740;30717;11650;33817
220810;201602;3279;9538;2851;8817;115;474;2266;6907;2381;7381
220820;201602;5319;14663;4878;14055;240;698;4243;12173;4483;12871
220830;201602;7410;20941;6901;20146;594;1765;5384;15789;5978;17554
220840;201602;13894;44183;12420;41292;2881;9726;5717;19462;8598;29188
220850;201602;2806;9737;2665;9560;108;497;2381;8552;2489;9049
220855;201602;616;1887;538;1748;33;136;399;1263;432;1399
220860;201602;921;2501;819;2340;35;124;691;1947;726;2071
220865;201602;2557;7101;2073;6260;65;319;1649;4813;1714;5132
220870;201602;2204;7436;1965;7123;58;274;1778;6433;1836;6707
220880;201602;4686;12780;4379;12421;90;268;4085;11632;4175;11900
220885;201602;1239;4543;1104;4286;87;422;824;3169;911;3591
220887;201602;1358;3409;1196;3181;17;65;1106;2923;1123;2988
220890;201602;1596;5557;1433;5254;120;433;1095;4107;1215;4540
220900;201602;1791;5153;1594;4854;49;143;1348;4078;1397;4221
220910;201602;1508;4641;1327;4374;41;126;1166;3913;1207;4039
220915;201602;1013;2866;873;2599;28;115;665;1922;693;2037
220920;201602;1326;4771;1202;4593;90;447;891;3340;981;3787
220930;201602;1356;4516;1295;4425;57;253;1081;3684;1138;3937
220935;201602;1057;3243;956;3039;46;189;634;1950;680;2139
220937;201602;1497;4117;1266;3731;58;221;968;2781;1026;3002
220940;201602;1322;4208;1237;4047;76;328;910;2929;986;3257
220945;201602;422;1575;386;1503;33;151;274;1054;307;1205
220950;201602;1286;3218;959;2702;28;110;697;1907;725;2017
220955;201602;1407;4109;1243;3826;84;262;928;2856;1012;3118
220960;201602;898;2345;715;2041;17;55;561;1592;578;1647
220965;201602;1606;4835;1517;4703;51;262;1287;3853;1338;4115
220970;201602;2136;5695;1602;4834;143;451;1084;3312;1227;3763
220975;201602;657;2170;612;2110;27;160;555;1850;582;2010
220980;201602;1255;3818;1104;3573;77;272;813;2643;890;2915
220985;201602;1169;3485;1107;3400;85;313;841;2515;926;2828
220987;201602;1460;4673;1317;4442;78;358;1012;3343;1090;3701
220990;201602;1801;5234;1573;4852;37;194;1237;3721;1274;3915
220995;201602;1254;3697;956;3227;110;389;648;2270;758;2659
220997;201602;2192;6865;2100;6736;49;224;1946;6196;1995;6420
221000;201602;4156;12798;3890;12343;322;1222;2999;9370;3321;10592
221005;201602;1439;4509;1322;4293;532;1592;511;1816;1043;3408
221010;201602;1115;2989;964;2800;41;129;828;2386;869;2515
221020;201602;1739;5419;1620;5203;64;273;1202;3791;1266;4064
221030;201602;1462;4385;1324;4156;66;287;1070;3305;1136;3592
221035;201602;1430;3967;1344;3854;58;127;1231;3613;1289;3740
221037;201602;619;1837;554;1734;14;54;401;1205;415;1259
221038;201602;599;1688;488;1497;42;130;302;932;344;1062
221039;201602;906;2593;822;2471;51;209;665;1931;716;2140
221040;201602;4509;14053;4233;13607;192;680;3446;11144;3638;11824
221050;201602;3432;10499;3226;10225;162;589;2780;8771;2942;9360
221060;201602;7970;23486;7011;21955;577;1968;5246;16396;5823;18364
221062;201602;1250;4434;1159;4259;51;269;947;3452;998;3721
221063;201602;1042;3450;954;3282;214;687;564;2068;778;2755
221065;201602;2767;7562;2496;7140;122;338;2052;5817;2174;6155
221070;201602;3699;11774;3272;11040;142;566;2604;8828;2746;9394
221080;201602;3377;8835;2876;8149;100;321;2434;6886;2534;7207
221090;201602;1384;3832;1182;3504;32;141;976;2835;1008;2976
221093;201602;1614;4849;1526;4671;258;838;870;2600;1128;3438
221095;201602;940;2508;839;2359;15;46;718;2002;733;2048
221097;201602;779;2215;638;1965;33;138;447;1332;480;1470
221100;201602;110443;323863;101444;309093;20015;63940;57704;173404;77719;237344
221110;201602;10100;32021;9423;31197;421;1774;7919;25940;8340;27714
221120;201602;3974;12996;3771;12646;729;2545;2393;8068;3122;10613
221130;201602;4461;13020;3810;11688;1115;3445;1641;5104;2756;8549
221135;201602;1481;4565;1370;4418;109;418;1142;3640;1251;4058
221140;201602;1321;3249;1202;3095;40;96;1043;2671;1083;2767
221150;201602;1193;3067;994;2729;28;121;766;2060;794;2181
221160;201602;813;2157;766;2091;34;94;602;1648;636;1742
221170;201602;1125;3477;1043;3342;51;177;837;2680;888;2857
230010;201602;3370;9100;2706;7968;206;695;2038;5889;2244;6584
230015;201602;2888;10000;2718;9641;388;1555;1647;5736;2035;7291
230020;201602;13499;44246;13130;43640;695;2637;11066;36692;11761;39329
230030;201602;11840;34152;10670;32329;461;1670;8721;26169;9182;27839
230040;201602;4457;12251;3759;11053;302;1040;2667;7712;2969;8752
230050;201602;2621;8978;2092;7601;433;1639;721;2655;1154;4294
230060;201602;2174;6273;1865;5721;70;281;1423;4293;1493;4574
230070;201602;4138;11524;3572;10603;297;1034;2401;7160;2698;8194
230075;201602;8659;31078;8111;29988;557;2932;6245;22440;6802;25372
230080;201602;2370;6256;1931;5623;98;350;1572;4544;1670;4894
230090;201602;3778;11022;3361;10311;411;1435;2333;7150;2744;8585
230100;201602;16311;48716;15039;46464;2491;8304;8875;27603;11366;35907
230110;201602;12918;41188;11884;39025;2253;7690;6225;20263;8478;27953
230120;201602;7857;21840;6787;20262;770;2228;4487;14134;5257;16362
230125;201602;3025;8757;2508;7842;168;614;1805;5584;1973;6198
230130;201602;5722;18747;4918;17055;433;1698;3291;11298;3724;12996
230140;201602;3456;11064;2943;10129;314;1167;1975;6893;2289;8060
230150;201602;1660;5221;1438;4768;286;1022;744;2432;1030;3454
230160;201602;6137;18431;5507;17492;275;1097;4388;13832;4663;14929
230170;201602;6228;19622;5420;18109;337;1324;3836;12687;4173;14011
230180;201602;1688;5003;1486;4596;85;365;1063;3135;1148;3500
230185;201602;3895;12745;3511;12055;565;1986;2143;7577;2708;9563
230190;201602;12531;40102;11100;37227;2220;8067;5183;17254;7403;25321
230195;201602;5197;15910;4557;14833;358;1410;3439;10926;3797;12336
230200;201602;5056;14634;4549;13661;430;1363;3299;9831;3729;11194
230205;201602;4109;13331;3709;12635;240;1085;2621;8792;2861;9877
230210;201602;8808;25387;7723;23681;1399;4388;4497;14074;5896;18462
230220;201602;12883;36939;11652;34828;1086;3671;8326;24449;9412;28120
230230;201602;7191;23150;6604;22018;862;2930;4359;14671;5221;17601
230240;201602;13724;38584;12124;35965;587;1992;9331;27353;9918;29345
230250;201602;9674;30149;9596;30025;547;2065;7542;23256;8089;25321
230260;201602;14076;47242;13130;45349;2168;8016;7316;25778;9484;33794
230270;201602;7445;21977;6405;20177;733;2568;4148;13178;4881;15746
230280;201602;19510;57592;17458;54140;1588;5145;12729;39397;14317;44542
230290;201602;4783;14477;4102;13110;571;1752;2676;8637;3247;10389
230300;201602;4344;13082;4146;12802;258;964;3348;10197;3606;11161
230310;201602;4745;14217;4197;13296;229;945;3017;9387;3246;10332
230320;201602;6937;21765;6334;20717;440;1770;4643;14983;5083;16753
230330;201602;4718;13871;4024;12514;325;1086;2788;8577;3113;9663
230340;201602;3290;11170;3001;10567;360;1412;1899;6572;2259;7984
230350;201602;17873;54434;16329;51831;1849;6782;9670;31127;11519;37909
230360;201602;3240;9254;2627;8132;226;787;1702;5191;1928;5978
230365;201602;2962;8075;2593;7442;117;442;2052;5835;2169;6277
230370;201602;53407;171111;48365;162530;12885;45359;20137;70328;33022;115687
230380;201602;6374;18821;5344;16899;297;1000;3767;11871;4064;12871
230390;201602;3443;10925;3061;10282;230;1032;2145;7040;2375;8072
230393;201602;3160;10417;2721;9550;186;918;1929;6518;2115;7436
230395;201602;5601;16458;5022;15475;767;2402;2967;9424;3734;11826
230400;201602;5397;16419;4759;15411;270;1225;3651;11571;3921;12796
230410;201602;14262;45450;12441;41672;1731;6103;7275;24445;9006;30548
230420;201602;23846;76786;21709;72606;4729;17020;9899;32863;14628;49883
230423;201602;4083;13532;3778;12935;246;1041;2821;9588;3067;10629
230425;201602;5469;18232;5042;17329;708;2502;3157;10924;3865;13426
230426;201602;2658;7471;2122;6469;71;304;1565;4647;1636;4951
230427;201602;1829;5450;1401;4509;177;587;782;2442;959;3029
230428;201602;8522;26559;8113;25828;1309;4594;4647;14586;5956;19180
230430;201602;4494;14305;4164;13715;308;1273;2983;9588;3291;10861
230435;201602;4870;15502;4377;14602;767;2929;2322;7609;3089;10538
230440;201602;346615;1025977;317599;976926;73912;238469;143391;445108;217303;683577
230445;201602;4481;12133;3823;11154;279;809;2676;7835;2955;8644
230450;201602;3524;11193;3081;10385;346;1487;2010;6632;2356;8119
230460;201602;1913;6289;1659;5823;159;636;1135;3957;1294;4593
230465;201602;4014;11973;3395;10853;234;983;2235;6944;2469;7927
230470;201602;10715;39167;9932;37553;1304;5418;6668;25256;7972;30674
230480;201602;1453;4575;1225;4144;153;595;810;2696;963;3291
230490;201602;2247;6881;1959;6322;301;1036;950;2965;1251;4001
230495;201602;5723;18885;5133;17832;692;2887;2789;9558;3481;12445
230500;201602;8826;31401;8428;30627;595;2632;6293;22818;6888;25450
230510;201602;1488;5291;1171;4493;301;1249;351;1347;652;2596
230520;201602;4777;14595;4321;13797;450;1651;2749;8657;3199;10308
230523;201602;14395;46782;12678;42914;2860;10533;3047;10583;5907;21116
230526;201602;4045;12088;3465;11071;208;908;2636;8247;2844;9155
230530;201602;5295;17091;4801;16405;884;3190;3122;10996;4006;14186
230533;201602;4003;11104;3457;10080;459;1261;2314;6845;2773;8106
230535;201602;5506;16254;4820;15049;675;2078;2891;9380;3566;11458
230540;201602;17227;50531;15567;47932;617;2488;12831;39004;13448;41492
230550;201602;19129;56885;17107;53131;3095;10447;8741;26501;11836;36948
230560;201602;6693;19276;5895;17854;213;869;4510;13415;4723;14284
230565;201602;3389;9406;2754;8234;120;441;2016;5981;2136;6422
230570;201602;3593;9872;3204;9383;104;411;2665;7711;2769;8122
230580;201602;9863;29860;9137;28824;489;1855;7785;24449;8274;26304
230590;201602;8938;27800;7716;25527;583;2443;5377;17298;5960;19741
230600;201602;3805;10493;2941;8806;150;500;1889;5645;2039;6145
230610;201602;6027;19348;5568;18609;763;2581;3808;12937;4571;15518
230620;201602;2152;6154;1726;5247;204;664;951;2805;1155;3469
230625;201602;7721;25076;6977;23370;1996;7225;2020;6743;4016;13968
230630;201602;10852;34454;9970;32844;2628;8120;4563;16200;7191;24320
230640;201602;25592;83447;23608;80505;2639;10056;17407;59060;20046;69116
230650;201602;4816;14864;4362;13999;290;1176;3298;10310;3588;11486
230655;201602;9032;34210;8701;33598;766;3289;6764;26310;7530;29599
230660;201602;6004;18875;5154;17273;319;1452;3894;12733;4213;14185
230670;201602;6050;16183;4865;14144;155;559;3722;10509;3877;11068
230680;201602;2636;7783;2274;7096;349;1139;1309;4066;1658;5205
230690;201602;6308;20457;6129;20078;618;2342;3921;12547;4539;14889
230700;201602;9324;26210;8356;24515;652;2322;5881;16722;6533;19044
230710;201602;7415;24120;6455;22341;673;2424;4509;15694;5182;18118
230720;201602;1821;5781;1583;5286;201;705;924;3067;1125;3772
230725;201602;3654;12418;3187;11280;779;2818;1007;3573;1786;6391
230730;201602;56072;169850;47412;155499;12971;47755;10659;36669;23630;84424
230740;201602;6036;18043;5472;17095;215;888;4348;13380;4563;14268
230750;201602;8304;23983;7139;22085;390;1482;5379;16393;5769;17875
230760;201602;10555;31361;9764;29812;1073;3743;6566;19296;7639;23039
230763;201602;4232;12997;3786;12163;211;941;2836;8782;3047;9723
230765;201602;38003;120277;34196;112912;8765;30888;9885;33625;18650;64513
230770;201602;24716;68501;22321;65126;2853;8746;14652;42752;17505;51498
230780;201602;5864;22663;5623;22121;1393;5654;2673;11026;4066;16680
230790;201602;2745;8791;2528;8424;248;929;1846;6180;2094;7109
230800;201602;7398;26246;6744;24809;1463;5725;2904;10597;4367;16322
230810;201602;11967;38786;11282;37652;830;3040;8731;29087;9561;32127
230820;201602;3264;11264;2877;10424;412;1699;1576;5619;1988;7318
230830;201602;7368;22389;6542;20845;469;1800;4746;14923;5215;16723
230835;201602;3911;10393;3227;9371;180;583;2459;7117;2639;7700
230837;201602;3151;10719;2771;9976;289;1265;1806;6378;2095;7643
230840;201602;8967;29281;8246;28052;700;2740;6174;21047;6874;23787
230850;201602;9455;29523;8785;28389;1029;3402;5967;19482;6996;22884
230860;201602;5018;14354;4470;13568;211;788;3617;10898;3828;11686
230870;201602;18558;48771;16010;44990;698;2256;12269;34253;12967;36509
230880;201602;1943;6581;1843;6370;143;638;1277;4326;1420;4964
230890;201602;3906;14258;3628;13654;439;2024;2275;8297;2714;10321
230900;201602;2890;9640;2455;8735;512;1760;1094;4034;1606;5794
230910;201602;3108;9125;2567;8160;197;869;1848;5672;2045;6541
230920;201602;4622;13448;4301;13042;270;1024;3534;10684;3804;11708
230930;201602;7219;21818;6386;20266;611;2058;4239;13476;4850;15534
230940;201602;7687;22020;6764;20584;305;1045;5422;16545;5727;17590
230945;201602;6024;18348;5339;17256;429;1558;3616;11919;4045;13477
230950;201602;6329;17450;5743;16671;238;677;4883;14483;5121;15160
230960;201602;14073;43239;12896;41002;2521;8398;5837;18804;8358;27202
230970;201602;13446;41051;11844;38121;2365;8384;5078;16026;7443;24410
230980;201602;2896;9079;2542;8438;695;2289;1158;4091;1853;6380
230990;201602;1747;5181;1462;4636;123;514;922;2800;1045;3314
231000;201602;2673;7323;2140;6293;141;488;1355;3858;1496;4346
231010;201602;3110;8514;2552;7604;264;868;1667;4821;1931;5689
231020;201602;7765;26162;7368;25338;1268;4371;4444;15604;5712;19975
231025;201602;7880;24169;7192;23005;933;3161;4656;15129;5589;18290
231030;201602;7524;24479;6427;22292;1129;4181;3356;11704;4485;15885
231040;201602;3154;10018;2799;9315;160;713;2009;6489;2169;7202
231050;201602;11752;33583;10053;30608;781;2661;7215;21845;7996;24506
231060;201602;2325;7618;2162;7317;143;715;1561;5099;1704;5814
231070;201602;8563;27210;7769;25595;1323;4593;4191;13938;5514;18531
231080;201602;4013;12493;3646;11887;179;920;2783;8693;2962;9613
231085;201602;4713;14652;4529;14401;673;2108;3107;10245;3780;12353
231090;201602;4117;11553;3331;10000;172;602;2288;6774;2460;7376
231095;201602;2174;7041;1895;6480;211;810;1207;4130;1418;4940
231100;201602;3181;9850;2677;8893;193;763;1880;6191;2073;6954
231110;201602;3492;11693;3457;11629;337;1312;2374;7929;2711;9241
231120;201602;1970;6736;1867;6525;282;1046;1138;4039;1420;5085
231123;201602;2037;5645;1762;5180;137;398;1334;3911;1471;4309
231126;201602;6192;17681;5248;16110;284;1112;3809;11550;4093;12662
231130;201602;18881;57931;17070;54964;3324;11036;9673;32640;12997;43676
231135;201602;4074;12268;3502;11241;251;873;2428;7768;2679;8641
231140;201602;16786;52871;14805;49151;1212;5383;9684;31050;10896;36433
231150;201602;5710;16423;4887;14919;782;2510;2409;7419;3191;9929
231160;201602;5781;19063;5389;18275;963;3263;3076;10563;4039;13826
231170;201602;4200;13502;3777;12646;276;1154;2610;8508;2886;9662
231180;201602;13856;41324;12442;38552;2085;6932;6910;21048;8995;27980
231190;201602;4527;12783;3817;11705;242;879;2891;8665;3133;9544
231195;201602;4540;15257;3934;14070;407;1813;2637;9279;3044;11092
231200;201602;7729;26385;6769;24395;432;2213;4748;16643;5180;18856
231210;201602;4896;15488;4281;14633;280;1361;3298;11121;3578;12482
231220;201602;11647;33805;10284;31274;509;1973;7547;22477;8056;24450
231230;201602;9099;30465;8291;29217;768;3245;6057;21315;6825;24560
231240;201602;11922;37312;10783;35052;2260;7549;5039;16631;7299;24180
231250;201602;1979;5722;1397;4311;437;1324;290;888;727;2212
231260;201602;3442;10248;3096;9699;535;1661;1829;5879;2364;7540
231270;201602;7150;19738;6327;18450;317;1330;4738;13457;5055;14787
231280;201602;1719;5649;1611;5453;178;635;1083;3693;1261;4328
231290;201602;33341;113186;30249;106342;6383;24874;12091;41429;18474;66303
231300;201602;4464;12972;3645;11380;243;935;2425;7353;2668;8288
231310;201602;7272;20710;6070;18239;880;2700;3359;9968;4239;12668
231320;201602;6952;21298;5915;19281;316;1355;4153;13456;4469;14811
231325;201602;2745;8079;2414;7578;267;875;1585;5059;1852;5934
231330;201602;12082;38290;10495;35222;1637;5532;6035;20557;7672;26089
231335;201602;5300;15193;4610;13917;188;776;3602;10640;3790;11416
231340;201602;17191;56921;15900;54934;1094;3835;12465;43955;13559;47790
231350;201602;13342;41299;12770;40486;923;2822;10868;34941;11791;37763
231355;201602;4430;14149;4084;13568;273;1113;2968;9778;3241;10891
231360;201602;7594;24245;6749;22771;1181;4043;4083;14149;5264;18192
231370;201602;2397;6694;1880;5839;76;239;1389;4328;1465;4567
231375;201602;4202;14309;3943;13835;234;1093;3089;10700;3323;11793
231380;201602;5241;16503;4953;16132;518;1817;3501;11675;4019;13492
231390;201602;3398;10651;3126;10179;266;933;2182;7066;2448;7999
231395;201602;3763;12374;3434;11754;581;1996;1914;6644;2495;8640
231400;201602;8930;27597;8319;26396;538;2102;6132;19177;6670;21279
231410;201602;14054;47774;12974;46176;1269;4709;9721;35018;10990;39727
240010;201602;2414;7251;2026;6482;338;1200;970;2998;1308;4198
240020;201602;10426;32915;9393;31002;2015;7079;4376;14564;6391;21643
240030;201602;2424;6999;2345;6880;117;437;1999;5730;2116;6167
240040;201602;829;2449;700;2189;25;124;490;1454;515;1578
240050;201602;3415;9244;2912;8381;106;365;2313;6558;2419;6923
240060;201602;1385;3983;1236;3704;51;191;979;2831;1030;3022
240070;201602;2522;7460;2355;7140;376;1188;1501;4468;1877;5656
240080;201602;3017;8115;2623;7577;180;522;2001;5774;2181;6296
240090;201602;2262;6112;1866;5400;38;142;1453;4108;1491;4250
240100;201602;8072;23209;7236;21524;612;2040;5142;14894;5754;16934
240110;201602;4724;14871;4245;13915;647;2408;2341;7406;2988;9814
240120;201602;2655;9148;2538;8923;382;1478;1578;5504;1960;6982
240130;201602;2696;7351;2370;6841;110;371;1905;5416;2015;5787
240140;201602;2198;6613;1883;6043;293;1128;1060;3276;1353;4404
240145;201602;5673;18039;5143;17074;1432;4957;2372;8117;3804;13074
240150;201602;957;2950;796;2607;78;315;504;1598;582;1913
240160;201602;1425;4593;1240;4274;156;592;761;2704;917;3296
240165;201602;890;2813;786;2603;111;337;471;1651;582;1988
240170;201602;2291;6975;2014;6470;497;1744;889;2818;1386;4562
240180;201602;2581;8256;2302;7677;444;1577;1284;4356;1728;5933
240185;201602;1396;4660;1306;4512;84;319;1029;3569;1113;3888
240190;201602;958;3027;862;2869;47;225;635;2076;682;2301
240200;201602;13363;35131;11205;32143;2513;7484;4766;14110;7279;21594
240210;201602;2857;8013;2586;7620;171;611;2097;6065;2268;6676
240220;201602;7223;24307;6724;23565;641;2887;4990;17205;5631;20092
240230;201602;5638;14979;4902;13846;151;474;4126;11639;4277;12113
240240;201602;1811;5509;1273;4214;256;929;215;628;471;1557
240250;201602;2621;7691;2466;7479;113;362;2105;6370;2218;6732
240260;201602;12030;40741;11430;39759;1833;7092;7183;24868;9016;31960
240270;201602;2204;7107;2031;6818;183;650;1544;5244;1727;5894
240280;201602;1532;4344;1366;4100;76;267;1087;3240;1163;3507
240290;201602;1236;3968;1104;3711;58;303;715;2261;773;2564
240300;201602;2248;6222;1671;5015;311;1009;630;1840;941;2849
240310;201602;9390;26940;8536;25609;1150;3801;4742;14398;5892;18199
240320;201602;2000;5967;1621;5206;53;235;1146;3557;1199;3792
240325;201602;33782;93719;27205;83372;8342;27488;5753;18533;14095;46021
240330;201602;1470;4492;1246;4018;72;291;787;2449;859;2740
240340;201602;1978;5272;1680;4799;177;529;1212;3434;1389;3963
240350;201602;1868;5543;1757;5410;105;379;1526;4684;1631;5063
240360;201602;6884;20940;6150;19844;1395;4711;3090;10326;4485;15037
240370;201602;1983;5492;1599;4781;203;573;956;2907;1159;3480
240375;201602;832;2287;733;2118;106;347;461;1255;567;1602
240380;201602;2398;7195;1858;5998;241;807;920;2938;1161;3745
240390;201602;912;2529;774;2280;39;149;543;1545;582;1694
240400;201602;1312;3607;1082;3193;82;287;747;2140;829;2427
240410;201602;479;1591;430;1491;78;330;233;771;311;1101
240420;201602;4591;17685;4321;17075;878;3895;2277;9019;3155;12914
240430;201602;3224;9179;2950;8682;140;566;2310;6567;2450;7133
240440;201602;2458;6442;2206;6070;543;1555;1136;3099;1679;4654
240450;201602;3797;11325;3280;10345;290;1219;2039;6079;2329;7298
240460;201602;2878;8866;2719;8654;174;769;2206;6818;2380;7587
240470;201602;3547;11126;2828;9562;794;2560;1271;4410;2065;6970
240480;201602;516;1380;407;1174;33;106;209;585;242;691
240485;201602;1916;6090;1696;5650;257;919;1025;3455;1282;4374
240490;201602;1645;4247;1390;3844;37;136;1153;3124;1190;3260
240500;201602;2100;6066;1906;5777;127;444;1481;4456;1608;4900
240510;201602;1741;5221;1633;5059;120;421;1304;4017;1424;4438
240520;201602;1211;3569;1103;3381;115;411;812;2422;927;2833
240530;201602;1937;6316;1784;6081;384;1342;1097;3745;1481;5087
240540;201602;1675;5102;1604;4987;115;385;1309;4051;1424;4436
240550;201602;795;2282;686;2091;41;139;515;1547;556;1686
240560;201602;3134;9175;2934;8871;375;1130;2158;6564;2533;7694
240570;201602;3027;8513;2306;6915;517;1666;765;2039;1282;3705
240580;201602;7449;23537;6928;22618;783;2825;5180;16708;5963;19533
240590;201602;766;2165;672;1992;30;117;503;1453;533;1570
240600;201602;1603;4742;1267;4036;143;533;695;2119;838;2652
240610;201602;4548;13145;3989;12077;469;1550;2480;7332;2949;8882
240615;201602;1023;3016;826;2639;171;589;431;1329;602;1918
240620;201602;1737;5437;1542;5112;191;586;1108;3745;1299;4331
240630;201602;1999;6141;1836;5864;162;447;1277;4203;1439;4650
240640;201602;886;2570;755;2357;54;251;520;1551;574;1802
240650;201602;3789;11415;3407;10853;185;669;2706;8593;2891;9262
240660;201602;2322;7506;2179;7301;181;682;1686;5621;1867;6303
240670;201602;2609;7818;2183;6933;290;969;1191;3741;1481;4710
240680;201602;1482;4367;1205;3874;108;375;748;2371;856;2746
240690;201602;946;2608;814;2383;46;175;647;1839;693;2014
240700;201602;2547;7685;2145;6948;77;341;1628;5172;1705;5513
240710;201602;18695;49111;16270;45525;3079;8573;8954;25664;12033;34237
240720;201602;5157;14832;4689;13970;1511;4617;1889;5461;3400;10078
240725;201602;1047;3169;850;2738;71;238;490;1543;561;1781
240730;201602;2092;6360;1827;5865;117;419;1344;4300;1461;4719
240740;201602;1928;5707;1728;5349;146;581;1214;3620;1360;4201
240750;201602;2087;7901;1952;7640;479;2056;875;3439;1354;5495
240760;201602;1317;3607;1109;3327;106;260;815;2618;921;2878
240770;201602;3079;8901;2756;8453;154;633;2257;6811;2411;7444
240780;201602;5973;16591;4848;14792;778;2409;2634;8178;3412;10587
240790;201602;883;2689;736;2423;33;130;516;1707;549;1837
240800;201602;34717;100008;30990;93799;7426;23247;12352;38054;19778;61301
240810;201602;83527;241841;77457;231638;20462;62321;34784;106328;55246;168649
240820;201602;6258;19107;5480;17884;1304;4586;2197;7507;3501;12093
240830;201602;8516;26613;7970;25820;382;1634;6661;21312;7043;22946
240840;201602;1197;3368;1019;3084;85;269;627;1846;712;2115
240850;201602;1247;3709;939;2999;133;439;461;1463;594;1902
240860;201602;1289;3696;1064;3292;48;174;805;2426;853;2600
240870;201602;1163;3211;952;2824;81;272;590;1667;671;1939
240880;201602;1144;3846;1079;3743;94;420;851;2859;945;3279
240890;201602;4927;14104;4183;12723;897;2842;1704;5079;2601;7921
240895;201602;2575;8973;2382;8631;262;1048;1681;6147;1943;7195
240910;201602;2816;8515;2502;7914;153;576;1884;5901;2037;6477
240920;201602;748;2448;651;2239;126;489;294;980;420;1469
240930;201602;3414;8975;3012;8481;145;406;2465;7039;2610;7445
240933;201602;1379;3950;1226;3700;89;322;927;2718;1016;3040
240940;201602;6361;17295;5170;15287;839;2461;2908;8607;3747;11068
240950;201602;951;3147;892;3042;60;288;676;2228;736;2516
240960;201602;778;2439;693;2275;67;235;481;1599;548;1834
240970;201602;1879;5252;1585;4752;102;385;1191;3435;1293;3820
240980;201602;2911;9677;2701;9287;494;1794;1594;5497;2088;7291
240990;201602;2723;8170;2563;7862;429;1408;1534;4633;1963;6041
241000;201602;1047;2934;892;2663;45;168;615;1812;660;1980
241010;201602;2771;9440;2598;9102;320;1366;1802;6086;2122;7452
241020;201602;2018;5678;1656;4954;158;474;1019;2980;1177;3454
241025;201602;1625;4954;1454;4647;73;332;1027;3212;1100;3544
241030;201602;2449;8148;2210;7683;218;937;1555;5336;1773;6273
241040;201602;2169;7479;1990;7159;187;778;1399;5070;1586;5848
241050;201602;1245;3720;1093;3452;66;262;809;2492;875;2754
241060;201602;853;2483;769;2347;52;167;560;1687;612;1854
241070;201602;774;2243;705;2123;63;223;508;1471;571;1694
241080;201602;1128;3376;939;3003;35;156;682;2150;717;2306
241090;201602;2138;6340;1809;5770;126;575;1349;4209;1475;4784
241100;201602;1173;3522;1021;3168;97;323;655;2023;752;2346
241105;201602;1152;3511;1013;3255;235;771;461;1548;696;2319
241110;201602;803;2527;679;2270;53;218;419;1360;472;1578
241120;201602;7198;22186;6574;21165;1502;4808;3530;11895;5032;16703
241140;201602;3372;9276;2925;8399;311;892;1989;5613;2300;6505
241142;201602;713;2129;532;1728;136;506;191;570;327;1076
241150;201602;5350;15919;4786;14951;554;1833;3158;9849;3712;11682
241160;201602;966;2838;871;2676;134;412;541;1673;675;2085
241170;201602;1138;3359;1062;3228;93;286;821;2490;914;2776
241180;201602;934;2619;764;2293;96;308;394;1146;490;1454
241190;201602;1181;3268;942;2779;59;207;594;1675;653;1882
241200;201602;18483;54327;16498;51242;4073;13428;6767;21524;10840;34952
241210;201602;1432;4046;1151;3464;167;584;611;1767;778;2351
241220;201602;7679;25453;7171;24518;1794;6352;3491;12243;5285;18595
241230;201602;2950;8740;2734;8399;158;618;2270;6842;2428;7460
241240;201602;1206;3564;826;2680;90;323;346;1127;436;1450
241250;201602;5968;18466;5009;16623;204;1098;3786;12154;3990;13252
241255;201602;1652;6361;1532;6082;349;1536;726;2867;1075;4403
241260;201602;5064;13733;4090;12217;184;790;3014;8789;3198;9579
241270;201602;1813;5649;1608;5236;120;467;1074;3446;1194;3913
241280;201602;1832;5323;1673;5023;173;530;1197;3573;1370;4103
241290;201602;2962;8377;2522;7618;227;778;1730;5138;1957;5916
241300;201602;1439;4151;1247;3811;54;181;876;2682;930;2863
241310;201602;1595;4792;1465;4572;111;418;1115;3444;1226;3862
241320;201602;912;3135;835;2979;114;461;509;1802;623;2263
241330;201602;1414;4441;1332;4334;93;400;1109;3534;1202;3934
241335;201602;2710;8281;2510;7924;142;518;2061;6457;2203;6975
241340;201602;1817;5649;1563;5094;368;1304;655;2039;1023;3343
241350;201602;1875;6019;1701;5685;138;584;1250;4055;1388;4639
241355;201602;1395;3930;1145;3507;50;187;911;2769;961;2956
241360;201602;2026;5561;1688;4908;72;204;1207;3420;1279;3624
241370;201602;1343;4049;1111;3582;131;483;644;2019;775;2502
241380;201602;641;1844;549;1669;77;252;312;927;389;1179
241390;201602;2714;8983;2535;8673;270;1086;1857;6310;2127;7396
241400;201602;3751;10876;3424;10434;409;1347;2515;7712;2924;9059
241410;201602;2447;7528;2218;7209;503;1735;1219;3933;1722;5668
241415;201602;1634;4946;1482;4709;92;358;1184;3683;1276;4041
241420;201602;2241;7764;1984;7334;614;2479;456;1662;1070;4141
241430;201602;568;1700;445;1422;47;166;245;742;292;908
241440;201602;6154;22307;5800;21739;1083;4298;3805;14431;4888;18729
241445;201602;997;2914;951;2860;82;214;766;2452;848;2666
241450;201602;2987;8196;2625;7692;304;990;1797;5207;2101;6197
241460;201602;3364;9832;2991;9109;241;852;2125;6305;2366;7157
241470;201602;1326;3760;1105;3465;136;468;747;2334;883;2802
241475;201602;1235;3725;1039;3336;39;186;765;2376;804;2562
241480;201602;2718;9069;2509;8703;1008;3654;527;2010;1535;5664
241490;201602;668;1765;576;1640;36;93;354;986;390;1079
241500;201602;757;2418;647;2244;42;189;484;1656;526;1845
250010;201602;2692;8490;2315;7654;115;512;1716;5541;1831;6053
250020;201602;1633;4708;1271;4051;78;304;822;2530;900;2834
250030;201602;6835;20037;6415;19449;479;1527;5230;15795;5709;17322
250040;201602;4109;13765;3804;13110;588;2080;2320;8010;2908;10090
250050;201602;3374;10699;3180;10422;455;1555;2140;6974;2595;8529
250053;201602;1210;3658;1111;3525;141;474;760;2459;901;2933
250057;201602;618;2647;608;2636;10;17;579;2585;589;2602
250060;201602;5044;15122;4732;14668;413;1463;3732;11438;4145;12901
250070;201602;3941;12267;3658;11789;144;693;2863;8913;3007;9606
250073;201602;747;2297;663;2155;41;159;532;1706;573;1865
250077;201602;2121;6231;1790;5708;162;548;1195;3853;1357;4401
250080;201602;4096;11991;3915;11688;316;996;3028;8879;3344;9875
250090;201602;2552;7445;2431;7252;103;320;1992;5876;2095;6196
250100;201602;3794;12535;3592;12171;323;1233;2738;9148;3061;10381
250110;201602;5002;15052;4739;14680;433;1598;3740;11385;4173;12983
250115;201602;517;1675;465;1566;32;166;308;970;340;1136
250120;201602;1911;5871;1671;5408;93;339;1273;4101;1366;4440
250130;201602;5210;16388;4832;15760;232;991;4050;13110;4282;14101
250135;201602;1038;3173;954;3031;44;159;747;2385;791;2544
250140;201602;1968;6670;1892;6551;167;708;1458;5042;1625;5750
250150;201602;4955;16730;4509;15907;300;1338;3304;11491;3604;12829
250153;201602;1400;3871;1237;3641;46;206;1047;3005;1093;3211
250157;201602;1701;5592;1571;5344;169;665;1136;3841;1305;4506
250160;201602;3219;9730;3098;9552;123;470;2814;8643;2937;9113
250170;201602;1492;4537;1368;4350;185;650;955;3045;1140;3695
250180;201602;15437;45718;14586;44423;1396;5023;10681;31639;12077;36662
250190;201602;4136;12001;3791;11468;620;1909;2271;6804;2891;8713
250200;201602;1998;5861;1674;5385;100;393;1365;4346;1465;4739
250205;201602;856;2974;805;2874;49;252;594;2101;643;2353
250210;201602;1414;4803;1327;4673;116;488;999;3438;1115;3926
250215;201602;1340;4417;1270;4310;102;423;833;2809;935;3232
250220;201602;723;2214;641;2103;38;160;524;1708;562;1868
250230;201602;1508;3878;1264;3483;50;177;1027;2714;1077;2891
250240;201602;2278;7683;2160;7465;117;463;1729;5971;1846;6434
250250;201602;4213;12871;3905;12470;177;621;3353;10749;3530;11370
250260;201602;1671;5138;1463;4815;71;266;1141;3759;1212;4025
250270;201602;1230;3897;1125;3770;97;334;856;2954;953;3288
250280;201602;3561;10630;3156;9993;381;1202;2297;7328;2678;8530
250290;201602;1870;5029;1594;4672;36;147;1432;4204;1468;4351
250300;201602;5378;15837;5110;15521;575;2381;4101;11897;4676;14278
250310;201602;1145;3525;1031;3343;75;289;788;2520;863;2809
250320;201602;7888;24146;7487;23483;894;3142;5142;15729;6036;18871
250330;201602;2359;7437;2053;6990;138;583;1571;5277;1709;5860
250340;201602;1085;3243;979;3069;33;124;836;2595;869;2719
250350;201602;4041;11393;3635;10910;141;520;3121;9385;3262;9905
250355;201602;1856;6000;1713;5801;65;333;1464;4863;1529;5196
250360;201602;1826;5431;1714;5268;65;178;1464;4540;1529;4718
250370;201602;11255;33295;10256;32197;841;2726;8726;27568;9567;30294
250375;201602;1058;3275;982;3164;33;134;841;2710;874;2844
250380;201602;1623;4705;1548;4613;96;377;1313;3835;1409;4212
250390;201602;1877;5095;1527;4509;168;474;1007;3012;1175;3486
250400;201602;71446;190354;57112;167863;14310;44413;21405;64085;35715;108498
250403;201602;1491;4910;1381;4761;217;857;845;2849;1062;3706
250407;201602;1159;3327;1013;3092;63;201;742;2204;805;2405
250410;201602;535;1760;504;1706;28;139;395;1299;423;1438
250415;201602;1795;5449;1627;5155;101;343;1221;3830;1322;4173
250420;201602;1227;3667;1122;3513;30;128;985;3052;1015;3180
250430;201602;5945;16515;5558;15946;282;966;4600;12943;4882;13909
250435;201602;1332;4121;1205;3898;129;482;834;2669;963;3151
250440;201602;4285;12556;3980;12132;165;514;3340;10181;3505;10695
250450;201602;1912;5480;1716;5222;65;239;1448;4343;1513;4582
250460;201602;6282;19058;5881;18528;576;1917;4546;14512;5122;16429
250470;201602;1541;4204;1310;3889;133;464;876;2491;1009;2955
250480;201602;3673;11248;3436;10931;102;450;3016;9584;3118;10034
250485;201602;656;1649;548;1486;29;97;439;1150;468;1247
250490;201602;3712;11809;3624;11685;762;2432;2469;8055;3231;10487
250500;201602;1716;5282;1555;5026;302;927;978;3286;1280;4213
250510;201602;4675;13425;4206;12740;170;578;3658;11106;3828;11684
250520;201602;1691;5166;1588;5004;222;751;948;2920;1170;3671
250523;201602;1553;5008;1508;4939;209;768;1099;3547;1308;4315
250527;201602;1359;4141;1294;4065;21;108;1187;3677;1208;3785
250530;201602;592;1849;518;1759;23;74;458;1577;481;1651
250535;201602;1291;4084;1223;3949;47;214;987;3116;1034;3330
250540;201602;2348;6827;2197;6653;46;199;1940;5775;1986;5974
250550;201602;884;2948;805;2829;51;242;627;2155;678;2397
250560;201602;1624;5133;1571;5059;78;337;1384;4384;1462;4721
250570;201602;2577;8260;2266;7658;141;622;1719;5675;1860;6297
250580;201602;1109;2987;955;2753;84;294;739;2065;823;2359
250590;201602;834;2651;790;2599;75;299;648;2083;723;2382
250600;201602;7184;21004;6753;20396;717;2060;5168;15801;5885;17861
250610;201602;3078;8990;2861;8662;250;815;2161;6498;2411;7313
250620;201602;681;2017;604;1859;93;306;360;1091;453;1397
250625;201602;2339;7585;2302;7542;94;225;2160;7206;2254;7431
250630;201602;9252;28947;8528;27523;2020;6539;4198;13724;6218;20263
250640;201602;3358;10398;3208;10214;159;694;2794;8746;2953;9440
250650;201602;782;2290;701;2165;47;184;516;1514;563;1698
250660;201602;1776;4829;1630;4639;24;54;1537;4414;1561;4468
250670;201602;2319;7929;2204;7729;138;652;1809;6219;1947;6871
250680;201602;4685;13527;4460;13256;214;702;3918;11660;4132;12362
250690;201602;5907;15450;5637;15136;445;1149;4920;13228;5365;14377
250700;201602;4660;13878;4288;13331;687;2205;2793;8666;3480;10871
250710;201602;4129;13303;3887;12961;545;1920;2647;8965;3192;10885
250720;201602;2628;7667;2475;7442;89;385;2160;6406;2249;6791
250730;201602;3355;10339;3153;10060;245;854;2390;7496;2635;8350
250740;201602;1862;5488;1623;5123;162;613;1219;3729;1381;4342
250750;201602;97113;276102;89992;265864;12146;39335;60447;176365;72593;215700
250760;201602;2208;6375;1991;6066;120;461;1658;4993;1778;5454
250770;201602;3786;12823;3604;12582;514;2001;2441;8478;2955;10479
250780;201602;1798;5295;1566;4877;165;621;996;2989;1161;3610
250790;201602;2353;7717;2236;7528;483;1618;1300;4530;1783;6148
250800;201602;2614;7354;2325;6894;85;281;1920;5589;2005;5870
250810;201602;1271;3751;1113;3506;72;300;868;2688;940;2988
250820;201602;1812;5740;1736;5646;67;287;1573;5079;1640;5366
250830;201602;5563;18027;5167;17235;566;2152;3505;11444;4071;13596
250840;201602;887;2895;755;2613;53;222;509;1757;562;1979
250850;201602;1936;6016;1763;5733;90;429;1376;4377;1466;4806
250855;201602;1032;3163;949;3048;60;259;716;2224;776;2483
250860;201602;3087;10134;2710;9454;673;2532;895;3172;1568;5704
250870;201602;1048;3070;953;2889;38;145;725;2151;763;2296
250880;201602;1371;3876;1201;3631;154;473;879;2684;1033;3157
250890;201602;9021;27712;8540;27058;1076;4240;6036;18412;7112;22652
250900;201602;2770;9047;2456;8438;241;800;1774;6150;2015;6950
250905;201602;1955;6288;1878;6188;291;957;1375;4583;1666;5540
250910;201602;4845;14212;4603;13851;248;849;3789;11313;4037;12162
250915;201602;1369;4289;1345;4255;96;258;1155;3743;1251;4001
250920;201602;3221;9289;3025;8994;362;1029;2129;6406;2491;7435
250930;201602;1953;6110;1841;5931;189;776;1319;4119;1508;4895
250933;201602;1107;3634;1039;3505;99;377;690;2281;789;2658
250937;201602;650;2022;594;1917;56;220;420;1312;476;1532
250939;201602;1514;4734;1427;4593;138;480;1005;3214;1143;3694
250940;201602;3641;10963;3433;10638;126;484;2907;9010;3033;9494
250950;201602;1234;3811;1095;3633;54;236;872;2879;926;3115
250960;201602;1064;3528;1022;3463;76;285;819;2789;895;3074
250970;201602;8218;22997;7243;21488;736;2292;5142;15207;5878;17499
250980;201602;2512;7475;2309;7122;118;484;1681;4983;1799;5467
250990;201602;1901;6512;1716;6120;252;1030;1028;3538;1280;4568
251000;201602;2053;6235;1881;5983;62;286;1575;4957;1637;5243
251010;201602;2732;8046;2461;7617;73;246;2134;6616;2207;6862
251020;201602;1552;4512;1427;4353;76;251;1275;3891;1351;4142
251030;201602;1066;3035;982;2891;60;202;722;2081;782;2283
251040;201602;1754;5542;1593;5277;88;415;1173;3750;1261;4165
251050;201602;1045;3060;916;2833;95;320;607;1838;702;2158
251060;201602;990;2310;763;2019;40;140;595;1553;635;1693
251065;201602;463;1408;413;1331;30;102;280;853;310;955
251070;201602;608;1721;551;1646;38;154;435;1238;473;1392
251080;201602;19216;54498;17486;51681;4388;13519;8032;24419;12420;37938
251090;201602;2920;9116;2609;8533;194;726;1863;5985;2057;6711
251100;201602;942;2988;851;2834;82;319;557;1788;639;2107
251110;201602;1920;5664;1690;5216;149;429;1131;3507;1280;3936
251120;201602;6029;20481;5766;20028;687;2745;4176;14328;4863;17073
251130;201602;3909;10294;3612;9978;12;33;3557;9849;3569;9882
251140;201602;4128;12690;3906;12341;120;522;3279;10311;3399;10833
251150;201602;2464;8112;2310;7874;186;853;1729;5740;1915;6593
251160;201602;1758;5817;1699;5741;65;259;1541;5214;1606;5473
251170;201602;1386;4240;1319;4159;87;351;1106;3422;1193;3773
251180;201602;2483;7590;2268;7256;378;1209;1384;4432;1762;5641
251190;201602;4249;11863;4093;11688;163;500;3797;10814;3960;11314
251200;201602;3824;12354;3684;12183;95;428;3375;11108;3470;11536
251203;201602;1001;3386;977;3339;50;253;773;2601;823;2854
251207;201602;1074;3381;934;3132;56;261;633;2050;689;2311
251210;201602;7750;22169;6686;20775;701;2129;5093;16296;5794;18425
251220;201602;1128;3025;936;2743;86;252;697;2053;783;2305
251230;201602;4337;13287;4010;12901;207;833;3580;11395;3787;12228
251240;201602;3196;9766;2970;9476;411;1303;2155;6881;2566;8184
251250;201602;10107;30051;9382;28985;883;3206;6992;21179;7875;24385
251260;201602;477;1533;437;1477;20;85;331;1106;351;1191
251270;201602;4152;13451;3864;13105;147;683;3425;11592;3572;12275
251272;201602;1306;3884;1264;3825;73;242;1124;3389;1197;3631
251274;201602;890;2812;808;2676;78;334;556;1793;634;2127
251275;201602;1222;3594;1161;3497;69;310;878;2509;947;2819
251276;201602;1191;3693;1121;3572;80;321;818;2534;898;2855
251278;201602;580;1837;517;1726;63;251;336;1103;399;1354
251280;201602;2263;6918;2135;6708;120;478;1692;5146;1812;5624
251290;201602;5514;15319;5212;14956;572;2065;4062;11280;4634;13345
251300;201602;734;2494;691;2430;37;167;551;1917;588;2084
251310;201602;2932;8789;2705;8471;116;478;2190;6709;2306;7187
251315;201602;1587;5526;1516;5408;166;627;1067;3819;1233;4446
251320;201602;1848;5179;1447;4525;52;188;1047;3274;1099;3462
251330;201602;1728;4741;1496;4441;66;280;1292;3748;1358;4028
251335;201602;1014;3453;935;3314;82;379;654;2269;736;2648
251340;201602;3330;9516;2947;8956;205;817;2207;6492;2412;7309
251350;201602;1268;4089;1186;3939;81;323;905;2921;986;3244
251360;201602;1770;5667;1583;5423;62;273;1376;4727;1438;5000
251365;201602;788;2327;638;2015;18;79;442;1370;460;1449
251370;201602;21507;67964;20928;67207;1790;7155;16582;51681;18372;58836
251380;201602;1315;4136;1131;3825;41;234;939;3037;980;3271
251385;201602;778;2125;668;1957;80;225;433;1233;513;1458
251390;201602;5734;19739;5248;18861;1339;4948;2603;9503;3942;14451
251392;201602;1035;3096;925;2923;67;241;703;2195;770;2436
251394;201602;606;1889;501;1699;47;159;339;1148;386;1307
251396;201602;812;2322;706;2147;99;294;447;1356;546;1650
251398;201602;940;2770;828;2570;42;164;558;1691;600;1855
251400;201602;1139;3229;985;3015;82;298;716;2128;798;2426
251410;201602;1340;3617;1219;3430;62;251;1014;2777;1076;3028
251420;201602;1950;5665;1737;5414;210;677;1251;3871;1461;4548
251430;201602;1608;5700;1476;5486;71;367;1212;4436;1283;4803
251440;201602;1204;3617;997;3217;52;201;736;2345;788;2546
251445;201602;1454;4536;1378;4429;100;409;1051;3257;1151;3666
251450;201602;4403;14276;4170;13962;114;526;3522;11779;3636;12305
251455;201602;1063;3458;961;3273;91;339;653;2238;744;2577
251460;201602;783;2473;735;2397;79;236;573;1921;652;2157
251465;201602;420;1363;373;1258;16;77;274;896;290;973
251470;201602;1138;3358;959;3007;78;280;590;1835;668;2115
251480;201602;919;2605;817;2437;30;138;654;1886;684;2024
251490;201602;1706;5148;1542;4897;153;583;1073;3363;1226;3946
251500;201602;1660;5418;1609;5324;132;524;1256;4066;1388;4590
251510;201602;2543;8367;2315;7917;402;1431;1297;4451;1699;5882
251520;201602;910;2542;813;2384;118;347;497;1448;615;1795
251530;201602;11707;32983;11078;32113;346;1513;9573;27058;9919;28571
251540;201602;2813;9106;2604;8706;177;741;2080;6880;2257;7621
251550;201602;3414;8942;2944;8330;72;310;2457;6841;2529;7151
251560;201602;673;2134;628;2048;82;315;373;1154;455;1469
251570;201602;989;2952;797;2585;43;191;550;1703;593;1894
251580;201602;1884;5317;1740;5123;395;966;1061;3336;1456;4302
251590;201602;1478;4689;1415;4609;53;198;1170;3801;1223;3999
251593;201602;982;3077;917;2993;128;438;564;1804;692;2242
251597;201602;1850;5738;1785;5659;65;287;1566;4872;1631;5159
251600;201602;6362;18854;5944;18195;343;1160;4807;14618;5150;15778
251610;201602;3200;9730;2948;9320;308;968;2133;6822;2441;7790
251615;201602;1121;3258;914;2897;64;266;640;1978;704;2244
251620;201602;14672;40844;13012;38860;830;2584;10712;32623;11542;35207
251630;201602;4491;11749;3890;10912;282;819;3033;8427;3315;9246
251640;201602;2497;7373;2120;6749;112;472;1591;5001;1703;5473
251650;201602;3845;11247;3561;10883;220;727;3040;9267;3260;9994
251660;201602;3406;11109;3169;10692;115;580;2647;8696;2762;9276
251670;201602;4300;12891;3724;12150;44;151;3441;11376;3485;11527
251675;201602;708;2275;655;2201;142;531;375;1209;517;1740
251680;201602;2641;7662;2180;6948;96;415;1676;5258;1772;5673
251690;201602;3178;9681;2981;9302;138;489;2320;7117;2458;7606
251700;201602;1923;6264;1808;6124;103;480;1534;5104;1637;5584
251710;201602;911;2361;670;1917;82;262;370;1023;452;1285
251720;201602;1381;4254;1213;3960;75;360;920;2891;995;3251
251740;201602;769;2180;614;1916;79;249;363;1149;442;1398
260005;201602;25023;60963;21339;55904;4581;11928;11221;29799;15802;41727
260010;201602;9763;26439;8087;24289;1364;4087;4526;14287;5890;18374
260020;201602;5726;16361;4856;15064;254;919;3807;11929;4061;12848
260030;201602;5984;17324;5390;16427;391;1378;4134;12546;4525;13924
260040;201602;9887;24126;8166;22157;732;1898;6141;17316;6873;19214
260050;201602;11136;34582;10422;33759;567;2022;8955;29354;9522;31376
260060;201602;3781;10765;3383;10058;327;983;2451;7406;2778;8389
260070;201602;9625;28018;8863;26831;1354;4408;5665;16908;7019;21316
260080;201602;5590;15052;4963;14175;588;1746;3463;9815;4051;11561
260090;201602;4989;14025;4667;13556;865;2461;3125;9220;3990;11681
260100;201602;3230;8989;2802;8385;164;692;2302;6806;2466;7498
260105;201602;4765;13574;4516;13143;282;1016;3663;10438;3945;11454
260110;201602;20394;58128;18876;56331;853;2663;16575;49615;17428;52278
260120;201602;11494;35233;10399;33325;2405;7928;5122;17040;7527;24968
260130;201602;3169;8984;2969;8671;459;1313;2019;5933;2478;7246
260140;201602;13090;32522;11247;30301;812;2415;8859;24070;9671;26485
260150;201602;3088;8759;2764;8325;200;755;2138;6389;2338;7144
260160;201602;5437;17406;4795;16574;282;1308;3904;13407;4186;14715
260170;201602;15863;45041;15134;43998;1117;3564;12319;35530;13436;39094
260180;201602;3222;9839;2941;9447;183;661;2437;7814;2620;8475
260190;201602;15757;37066;14403;35409;433;1189;12501;30370;12934;31559
260200;201602;10477;28698;9729;27727;594;1937;8183;23480;8777;25417
260210;201602;11333;34590;10213;32905;572;2283;8310;26730;8882;29013
260220;201602;9278;27122;8977;26741;408;1610;7927;23247;8335;24857
260230;201602;9399;27165;8665;26140;419;1518;7041;21314;7460;22832
260240;201602;2895;8795;2518;8254;345;1248;1745;5759;2090;7007
260250;201602;2258;6267;2033;5971;103;302;1737;5132;1840;5434
260260;201602;11989;33995;10938;32507;1698;5364;7579;22844;9277;28208
260270;201602;3558;10387;3291;9987;265;1092;2450;7116;2715;8208
260280;201602;12757;41377;11717;39829;704;2526;9749;33521;10453;36047
260290;201602;30028;90556;28421;87772;5014;16462;17119;52171;22133;68633
260300;201602;8485;26023;7541;24628;436;1893;5792;18951;6228;20844
260310;201602;4542;13477;4176;12950;1207;3438;2150;7248;3357;10686
260320;201602;6994;22724;6503;21942;376;1461;5363;18135;5739;19596
260330;201602;2546;8263;2375;7954;115;498;1852;6077;1967;6575
260340;201602;1826;5403;1696;5198;59;203;1490;4558;1549;4761
260345;201602;22520;70155;21129;67568;5545;19473;7824;23829;13369;43302
260350;201602;4680;12741;4365;12297;213;779;3668;10189;3881;10968
260360;201602;2276;6700;2073;6351;170;651;1406;4268;1576;4919
260370;201602;5702;17814;5034;16620;458;1835;3541;11636;3999;13471
260380;201602;4793;15776;4364;15114;298;1243;3256;11219;3554;12462
260390;201602;4235;13613;3742;12653;332;1294;2613;8678;2945;9972
260392;201602;3444;10983;3156;10618;194;861;2702;8961;2896;9822
260400;201602;13437;38312;12736;37173;1707;5581;8593;24478;10300;30059
260410;201602;60025;171786;52633;160195;14985;48291;18888;59057;33873;107348
260415;201602;3796;12024;3287;11028;291;1222;2070;6699;2361;7921
260420;201602;11748;26943;10448;25543;225;753;9453;22836;9678;23589
260430;201602;2794;9156;2489;8615;250;882;1675;5863;1925;6745
260440;201602;3223;9740;2866;9022;406;1406;1718;5277;2124;6683
260450;201602;4805;14363;4596;14068;180;648;4070;12494;4250;13142
260460;201602;5518;17355;5060;16504;943;3289;2754;8841;3697;12130
260470;201602;4404;13488;4090;13107;208;655;3555;11693;3763;12348
260480;201602;4005;11499;3529;10832;564;1921;2246;6950;2810;8871
260490;201602;4934;13177;4294;12091;265;865;3437;9470;3702;10335
260500;201602;5742;16619;5122;15629;777;2371;3283;10045;4060;12416
260510;201602;8548;23088;7953;22333;376;1261;6978;19430;7354;20691
260515;201602;4698;14317;3662;12257;239;916;2286;7637;2525;8553
260520;201602;15584;41144;14931;40271;2080;5655;10903;29404;12983;35059
260530;201602;9519;29238;8479;27665;394;1471;7122;23297;7516;24768
260540;201602;5959;14802;5418;14230;767;1460;4192;11647;4959;13107
260545;201602;71;254;48;187;8;33;11;38;19;71
260550;201602;2688;8818;2294;7980;464;1783;898;3095;1362;4878
260560;201602;6094;16196;5511;15371;154;601;4847;13289;5001;13890
260570;201602;6772;22291;6198;21361;646;2522;4389;15073;5035;17595
260580;201602;3622;10294;3368;9868;172;604;2781;7951;2953;8555
260590;201602;5983;15096;5635;14696;292;811;4870;12680;5162;13491
260600;201602;27112;79989;24445;75598;2087;7720;17544;53703;19631;61423
260610;201602;6504;19535;6164;19008;897;2890;4192;12792;5089;15682
260620;201602;15402;46811;14717;45636;2484;8454;9016;27373;11500;35827
260630;201602;2155;6474;1942;6129;123;520;1548;4735;1671;5255
260640;201602;16815;46566;15766;45152;2573;7548;9930;28596;12503;36144
260650;201602;5278;16843;4698;15852;411;1511;3555;12143;3966;13654
260660;201602;7769;21748;6994;20770;337;1189;5973;17627;6310;18816
260670;201602;2331;6286;1908;5703;162;538;1329;3981;1491;4519
260680;201602;21004;59344;19288;56389;3973;11953;9055;26533;13028;38486
260690;201602;3666;9966;3111;9064;221;622;2387;6989;2608;7611
260700;201602;5634;16775;5501;16637;41;107;5378;16414;5419;16521
260710;201602;1275;3792;1180;3665;88;311;891;2778;979;3089
260720;201602;16639;54083;15761;52463;3625;12412;8126;27363;11751;39775
260730;201602;6551;22152;6154;21497;1019;3670;4139;14512;5158;18182
260740;201602;1254;3778;1108;3526;110;406;781;2486;891;2892
260750;201602;6674;20443;5964;19529;460;1471;4919;16428;5379;17899
260760;201602;4621;12509;4337;12147;238;753;3587;10093;3825;10846
260765;201602;7616;25785;7238;25158;1051;4646;4817;16043;5868;20689
260770;201602;3726;9919;3439;9501;116;392;2854;7774;2970;8166
260775;201602;4972;14450;4694;14042;441;1600;3313;9640;3754;11240
260780;201602;3577;11612;3342;11156;654;2443;1688;5384;2342;7827
260790;201602;107692;272648;100070;261463;20388;54523;56391;146636;76779;201159
260795;201602;2973;8985;2669;8526;238;885;1871;5993;2109;6878
260800;201602;4705;12823;4387;12397;153;607;3886;10659;4039;11266
260805;201602;3783;11078;3325;10377;375;1333;2222;6812;2597;8145
260810;201602;6811;19141;6586;18858;292;920;5805;16578;6097;17498
260820;201602;4072;11610;3671;11021;864;2653;1863;5572;2727;8225
260825;201602;2834;9109;2538;8621;192;740;1924;6566;2116;7306
260830;201602;3627;11754;3253;11028;681;2265;1864;6531;2545;8796
260840;201602;4163;11985;3702;11311;241;909;2973;8978;3214;9887
260845;201602;4103;11987;3873;11582;481;1511;2742;8220;3223;9731
260850;201602;4831;15883;4301;14706;812;3068;1987;6662;2799;9730
260860;201602;3367;10560;2996;9809;160;635;2288;7453;2448;8088
260870;201602;4123;11422;3679;10867;471;1273;2706;8205;3177;9478
260875;201602;6319;17637;5629;16589;842;2496;3677;10940;4519;13436
260880;201602;9342;28693;8574;27442;689;2274;6651;21488;7340;23762
260890;201602;12817;36927;11956;35613;806;2812;9004;26631;9810;29443
260900;201602;5748;17761;4973;16280;478;1924;3091;9940;3569;11864
260910;201602;2949;8997;2689;8597;196;734;2032;6517;2228;7251
260915;201602;4418;14996;4196;14691;75;367;3851;13493;3926;13860
260920;201602;3168;9696;2943;9396;229;901;2319;7434;2548;8335
260930;201602;3876;12662;3466;11999;391;1419;2402;8394;2793;9813
260940;201602;13586;36220;12431;34393;1592;4932;8050;21671;9642;26603
260950;201602;6197;19172;5638;18094;854;3172;2937;8999;3791;12171
260960;201602;54040;150505;49655;143492;9616;29468;25521;73247;35137;102715
260970;201602;4783;14865;4380;14332;251;1058;3446;11234;3697;12292
260980;201602;3771;12348;3551;12072;120;499;3164;10749;3284;11248
260990;201602;16404;51966;15003;50047;1056;4066;11897;39836;12953;43902
261000;201602;15866;43126;12987;38741;2389;7544;6442;19944;8831;27488
261010;201602;2489;7007;2290;6770;138;313;2000;6097;2138;6410
261020;201602;6044;17740;5354;16604;583;1850;3792;11673;4375;13523
261030;201602;3422;10978;3122;10451;212;871;2431;8004;2643;8875
261040;201602;5047;16373;4426;15129;386;1551;3164;10698;3550;12249
261050;201602;7745;22898;7271;22049;1032;3108;4662;14264;5694;17372
261060;201602;12002;35440;11131;33887;999;3602;8123;24080;9122;27682
261070;201602;49571;122484;44010;114741;6405;17039;27845;72808;34250;89847
261080;201602;5610;16439;5297;15976;347;983;4496;13799;4843;14782
261090;201602;16126;44657;14886;42964;1329;3788;11624;33909;12953;37697
261100;201602;7869;24960;7090;23596;1296;4643;3883;13135;5179;17778
261110;201602;59232;175908;53067;166785;12323;40980;26177;84230;38500;125210
261120;201602;3667;9792;3227;9275;91;361;2847;8164;2938;8525
261130;201602;6846;17629;6381;17111;176;581;5797;15477;5973;16058
261140;201602;3197;9006;2908;8574;384;1297;1756;5045;2140;6342
261150;201602;5168;15291;4782;14674;399;1455;3811;11611;4210;13066
261153;201602;2100;6089;1723;5516;74;305;1270;4072;1344;4377
261160;201602;192699;505907;178966;486405;42845;121160;83961;231136;126806;352296
261170;201602;5710;15715;5200;14971;544;1623;3867;11251;4411;12874
261180;201602;9390;26285;8788;25448;995;3170;5921;16958;6916;20128
261190;201602;4976;15506;4630;15078;501;2143;3224;10072;3725;12215
261200;201602;3519;8989;3160;8565;406;1058;2433;6777;2839;7835
261210;201602;1870;4972;1757;4830;123;335;1537;4253;1660;4588
261220;201602;12972;40538;11005;36374;1793;6490;5456;17900;7249;24390
261230;201602;4296;13088;3961;12676;144;599;3455;11072;3599;11671
261240;201602;4753;14116;4368;13471;605;1756;2943;9289;3548;11045
261245;201602;3474;10827;3011;9987;160;729;2344;7596;2504;8325
261247;201602;3224;9948;2759;9120;203;839;1953;6491;2156;7330
261250;201602;19209;51462;18067;49947;3510;9331;11965;34209;15475;43540
261255;201602;3918;12299;3533;11608;202;788;2868;9369;3070;10157
261260;201602;11898;33736;10716;32300;582;1848;8920;27117;9502;28965
261270;201602;3557;10612;3210;10054;391;1400;2144;6564;2535;7964
261280;201602;2447;7577;2285;7340;125;492;1851;5886;1976;6378
261290;201602;2882;8286;2628;7954;148;549;2130;6466;2278;7015
261300;201602;10492;34063;9239;31802;1457;5684;5488;18633;6945;24317
261310;201602;7181;22195;6773;21458;1641;5283;3620;11542;5261;16825
261320;201602;5496;17307;5069;16537;206;814;4102;13292;4308;14106
261330;201602;5334;15619;5045;15225;457;1455;3969;11939;4426;13394
261340;201602;3816;12876;3626;12568;385;1687;2402;8183;2787;9870
261350;201602;7839;26143;7384;25375;272;1397;5932;19926;6204;21323
261360;201602;8024;21229;7178;20044;575;1764;5656;15511;6231;17275
261370;201602;19247;56793;17961;54804;3790;12052;9797;30037;13587;42089
261380;201602;4033;13878;3735;13247;580;2276;2334;8274;2914;10550
261390;201602;15860;48430;14435;46106;2129;7360;8568;27385;10697;34745
261400;201602;4598;15920;4151;14994;345;1449;2913;10499;3258;11948
261410;201602;8551;23977;7704;22678;895;2652;5665;16802;6560;19454
261420;201602;7236;24553;6928;24134;1695;6632;3918;13344;5613;19976
261430;201602;3339;10539;2944;9958;266;957;2235;7682;2501;8639
261440;201602;1507;4823;1361;4606;58;305;1037;3412;1095;3717
261450;201602;13858;39308;13374;38736;321;1201;12131;34943;12452;36144
261460;201602;7008;20769;6551;20156;409;1179;5630;17609;6039;18788
261470;201602;3846;10592;3501;10144;116;376;3172;9222;3288;9598
261480;201602;3583;12837;3305;12324;330;1358;2339;8614;2669;9972
261485;201602;4844;14979;4391;14187;707;2603;2548;8066;3255;10669
261500;201602;5569;15540;4967;14743;452;1257;3686;11284;4138;12541
261510;201602;1836;5911;1681;5669;120;443;1232;4164;1352;4607
261520;201602;2631;8574;2464;8265;139;534;1662;5810;1801;6344
261530;201602;11762;37742;10452;35195;2161;8180;4282;14272;6443;22452
261540;201602;7007;22750;6629;22096;1408;4699;3913;13332;5321;18031
261550;201602;3362;9575;3163;9293;242;932;2482;7075;2724;8007
261560;201602;6875;22831;6250;21987;932;3672;4373;15492;5305;19164
261570;201602;3306;10132;2912;9498;405;1396;1828;5972;2233;7368
261580;201602;5808;17943;5259;17076;347;1418;4314;13892;4661;15310
261590;201602;2352;6763;2079;6354;179;542;1530;4728;1709;5270
261600;201602;5156;14136;4479;13196;331;1019;3487;10352;3818;11371
261610;201602;2414;7014;2108;6600;111;470;1655;5092;1766;5562
261618;201602;2446;6879;2222;6599;188;585;1678;4926;1866;5511
261620;201602;4045;12595;3772;12136;632;2072;2440;7987;3072;10059
261630;201602;7561;22218;6384;20052;839;3061;3498;10739;4337;13800
261640;201602;32784;82543;30622;79956;2146;5447;24452;66147;26598;71594
261650;201602;3570;11014;3313;10663;341;1267;2381;7690;2722;8957
270010;201602;4249;16194;3912;15557;422;1991;2646;10551;3068;12542
270020;201602;3719;10657;3461;10286;399;1280;2595;7614;2994;8894
270030;201602;38970;117099;36415;113041;8897;28308;19230;60486;28127;88794
270040;201602;10406;32069;9608;31029;2059;6651;5571;18667;7630;25318
270050;201602;4189;11898;3840;11467;425;1394;2941;8760;3366;10154
270060;201602;1753;5363;1632;5204;287;964;1058;3429;1345;4393
270070;201602;4223;13158;3887;12717;195;937;3309;10568;3504;11505
270080;201602;1234;3937;1086;3647;154;575;664;2175;818;2750
270090;201602;2096;6512;1929;6187;57;313;1610;4971;1667;5284
270100;201602;5587;17466;5271;16923;839;2924;3425;10853;4264;13777
270110;201602;3104;8576;2742;8185;370;1136;1795;5745;2165;6881
270120;201602;3032;8692;2692;8278;88;333;2413;7448;2501;7781
270130;201602;4923;15082;4579;14694;608;2009;3480;11411;4088;13420
270135;201602;1714;4598;1587;4448;170;333;1344;3948;1514;4281
270140;201602;10020;24517;8648;22802;731;2914;6718;16458;7449;19372
270150;201602;2631;8783;2560;8692;68;242;2428;8271;2496;8513
270160;201602;5000;16660;4597;16151;216;906;3926;13737;4142;14643
270170;201602;3713;12090;3420;11699;585;2317;1995;6738;2580;9055
270180;201602;2194;7341;2015;7088;103;540;1652;5699;1755;6239
270190;201602;1745;5780;1663;5673;97;393;1390;4762;1487;5155
270200;201602;2528;8468;2362;8235;204;875;1797;6166;2001;7041
270210;201602;4502;13743;4235;13371;281;1189;3495;10782;3776;11971
270220;201602;1306;4342;1218;4184;228;848;685;2331;913;3179
270230;201602;10686;33705;9398;31717;1228;5100;5648;18417;6876;23517
270235;201602;6287;20384;5873;19723;381;1653;4761;15770;5142;17423
270240;201602;9230;27894;7817;26082;1996;6888;3510;12069;5506;18957
270250;201602;3175;8401;2892;8053;478;1284;2163;6031;2641;7315
270255;201602;4880;14755;3843;12904;243;1022;2703;8893;2946;9915
270260;201602;5705;18629;5527;18381;424;1802;4634;15098;5058;16900
270270;201602;1163;3372;1069;3237;199;634;613;1830;812;2464
270280;201602;3421;9849;3038;9301;329;970;2130;6569;2459;7539
270290;201602;7994;27957;7487;27085;661;2932;5720;20396;6381;23328
270300;201602;3523;11566;3164;11146;321;1306;2293;8009;2614;9315
270310;201602;7276;22149;6390;20836;257;1336;5308;16892;5565;18228
270320;201602;5689;18154;5430;17746;764;2922;3828;12227;4592;15149
270330;201602;4222;14411;3962;14050;401;1514;3075;11048;3476;12562
270340;201602;1709;5269;1508;5005;134;430;1158;3863;1292;4293
270350;201602;1822;5047;1642;4834;136;480;1197;3512;1333;3992
270360;201602;1928;6045;1847;5952;189;543;1525;5068;1714;5611
270370;201602;1485;4954;1360;4745;120;502;967;3377;1087;3879
270375;201602;2758;7763;2470;7378;203;723;1953;5719;2156;6442
270380;201602;5514;17228;5175;16761;469;1579;3998;13192;4467;14771
270390;201602;1224;3426;1080;3221;73;275;804;2315;877;2590
270400;201602;6168;18584;5548;17712;384;1473;4009;12502;4393;13975
270410;201602;4731;14811;4375;14166;452;1630;3066;9792;3518;11422
270420;201602;5670;18297;5459;18007;250;1160;4480;14456;4730;15616
270430;201602;129294;377731;118289;361350;31884;102970;48278;150494;80162;253464
270440;201602;4546;13804;4203;13347;204;813;3415;10863;3619;11676
270450;201602;6150;19115;5889;18780;307;1348;4887;15310;5194;16658
270460;201602;3338;9001;3005;8593;180;604;2569;7255;2749;7859
270470;201602;10040;32238;9271;31017;1353;4748;5754;19600;7107;24348
270480;201602;2769;8726;2460;8168;239;983;1676;5337;1915;6320
270490;201602;937;3047;878;2964;36;154;708;2364;744;2518
270500;201602;4809;16455;4543;16131;308;1358;3745;13243;4053;14601
270510;201602;5755;17331;5174;16514;650;2696;3777;11487;4427;14183
270520;201602;3501;11168;3226;10710;955;3489;1140;3889;2095;7378
270530;201602;1354;4203;1253;4053;144;477;840;2793;984;3270
270540;201602;2001;6742;1834;6499;116;607;1474;5039;1590;5646
270550;201602;7041;20556;6128;19402;842;2843;4093;13253;4935;16096
270560;201602;2972;9055;2774;8753;294;1145;2014;6183;2308;7328
270570;201602;3934;12737;3606;12183;343;1447;2721;8996;3064;10443
270580;201602;1957;6305;1867;6185;177;600;1433;4844;1610;5444
270590;201602;1340;4504;1286;4415;15;68;1234;4245;1249;4313
270600;201602;2718;9183;2487;8798;150;749;1943;6705;2093;7454
270610;201602;3103;9850;2882;9534;189;697;2347;7715;2536;8412
270620;201602;1338;4597;1263;4475;87;426;1004;3422;1091;3848
270630;201602;16045;46937;14721;44794;2262;6763;9739;30508;12001;37271
270640;201602;5553;17360;5053;16606;325;1411;4032;12971;4357;14382
270642;201602;2232;7946;2097;7750;234;1077;1549;5636;1783;6713
270644;201602;2580;7607;2303;7247;254;753;1748;5635;2002;6388
270650;201602;3573;11408;3404;11169;500;2222;2297;7061;2797;9283
270660;201602;2374;6055;1853;5313;84;342;1327;3734;1411;4076
270670;201602;16023;41631;13960;39311;1868;5067;10007;29300;11875;34367
270680;201602;4164;12427;3989;12233;125;356;3686;11411;3811;11767
270690;201602;8473;23598;7614;22633;2414;6866;3872;12238;6286;19104
270700;201602;632;1981;569;1878;74;304;385;1220;459;1524
270710;201602;5735;18550;5461;18197;403;1603;4535;14966;4938;16569
270720;201602;3241;11050;2956;10539;144;774;2388;8348;2532;9122
270730;201602;6007;18113;5727;17812;607;2044;4648;14536;5255;16580
270740;201602;2232;6420;2103;6232;246;845;1582;4580;1828;5425
270750;201602;4933;15518;4599;15002;640;2299;3232;10473;3872;12772
270760;201602;3259;9936;2920;9370;170;684;2286;7251;2456;7935
270770;201602;18701;48842;15435;44914;3315;9681;8231;25290;11546;34971
270780;201602;1725;5706;1639;5568;189;735;1183;3996;1372;4731
270790;201602;1509;4756;1389;4583;333;1182;689;2238;1022;3420
270800;201602;11029;32843;10285;31878;743;2865;8434;25693;9177;28558
270810;201602;3278;9977;2567;8717;271;1113;1540;5252;1811;6365
270820;201602;1740;5784;1579;5519;272;1040;932;3256;1204;4296
270830;201602;5405;14920;4920;14339;380;1198;3920;11674;4300;12872
270840;201602;7680;25063;7154;24389;328;1708;6196;20666;6524;22374
270850;201602;7153;22716;6894;22378;1106;4396;4679;14349;5785;18745
270860;201602;10945;30652;9281;28538;1063;3907;6203;18654;7266;22561
270870;201602;2097;6397;1756;5691;254;873;1079;3456;1333;4329
270880;201602;7972;25715;7430;24919;497;2085;5950;19675;6447;21760
270890;201602;2324;7111;2180;6860;228;879;1587;4847;1815;5726
270895;201602;2763;10367;2664;10228;153;735;2291;8789;2444;9524
270900;201602;1914;5189;1563;4704;94;313;1162;3439;1256;3752
270910;201602;3481;11443;3226;10980;248;1112;2466;8150;2714;9262
270915;201602;9341;31365;8429;29763;1360;5620;4869;16775;6229;22395
270920;201602;5977;18995;5770;18708;212;1130;5172;16316;5384;17446
270930;201602;16936;45261;14032;41831;2663;8064;8135;25208;10798;33272
270940;201602;5520;18497;5236;18192;472;2157;4129;14127;4601;16284
280010;201602;637;1906;555;1767;54;236;345;1031;399;1267
280020;201602;4693;13725;4063;12663;722;2444;2405;7417;3127;9861
280030;201602;72887;191186;63209;176961;17838;52114;23693;68126;41531;120240
280040;201602;3050;9379;2708;8867;242;908;1995;6487;2237;7395
280050;201602;3696;11941;3438;11500;1163;4123;1258;4327;2421;8450
280060;201602;4543;14656;4107;13880;835;3042;2085;7204;2920;10246
280067;201602;7166;20330;6191;18891;880;2642;3881;12078;4761;14720
280070;201602;1870;6208;1782;6083;244;900;1280;4368;1524;5268
280100;201602;3733;11633;3379;11019;626;2231;1978;6481;2604;8712
280110;201602;1391;4226;1282;4067;68;296;1062;3320;1130;3616
280120;201602;7621;24127;7011;23134;1242;3704;4552;15838;5794;19542
280130;201602;7210;20421;6633;19588;1109;3517;4248;12626;5357;16143
280140;201602;5428;14880;4954;14211;389;1212;3936;11321;4325;12533
280150;201602;3300;9966;3090;9615;297;1062;2194;6660;2491;7722
280160;201602;1353;3940;1188;3678;159;537;783;2382;942;2919
280170;201602;4681;14006;4243;13370;451;1456;3119;9986;3570;11442
280190;201602;1066;2946;956;2764;63;226;728;2050;791;2276
280200;201602;1137;3435;1037;3288;123;480;726;2230;849;2710
280210;201602;13276;39707;11958;37900;2281;7686;6812;21926;9093;29612
280220;201602;1536;4751;1439;4597;84;336;1170;3675;1254;4011
280230;201602;3344;10067;3008;9558;361;1248;1942;6213;2303;7461
280240;201602;3404;9975;3090;9484;274;811;2366;7320;2640;8131
280250;201602;806;2126;662;1898;124;423;322;831;446;1254
280260;201602;1981;5335;1847;5168;75;235;1649;4642;1724;4877
280270;201602;2219;6917;1989;6570;119;482;1540;4998;1659;5480
280280;201602;4101;13343;3722;12720;797;2230;2077;7974;2874;10204
280290;201602;17131;52123;15548;49715;2172;7690;9624;31039;11796;38729
280300;201602;9265;28323;8753;27693;832;2904;6794;21990;7626;24894
280310;201602;1330;3755;1188;3531;70;283;828;2414;898;2697
280320;201602;8369;26855;7694;25719;1500;5499;3828;12663;5328;18162
280330;201602;4426;12569;4035;11937;414;1496;3016;8572;3430;10068
280340;201602;3715;10581;3481;10267;340;1109;2731;8057;3071;9166
280350;201602;21512;60670;19290;57345;2887;9056;12245;36722;15132;45778
280360;201602;5585;17525;5237;16971;992;3665;2856;8992;3848;12657
280370;201602;1826;5144;1594;4753;147;451;1103;3277;1250;3728
280380;201602;1023;3150;924;2988;91;347;659;2085;750;2432
280390;201602;3082;9121;2664;8361;382;1277;1665;5232;2047;6509
280400;201602;4120;11742;3771;11239;1281;3781;1600;5055;2881;8836
280410;201602;2173;6885;1858;6282;248;957;1052;3434;1300;4391
280420;201602;4006;11816;3730;11387;224;743;3121;9523;3345;10266
280430;201602;2220;5691;2009;5401;103;354;1577;4139;1680;4493
280440;201602;4570;13623;4294;13301;379;1291;3441;10563;3820;11854
280445;201602;2467;6933;2299;6660;73;286;1828;5205;1901;5491
280450;201602;8798;23762;8213;23038;581;1403;6889;19883;7470;21286
280460;201602;6829;18034;6180;17120;812;2376;4367;12234;5179;14610
280470;201602;1776;5394;1614;5116;178;566;1143;3676;1321;4242
280480;201602;29915;87827;28290;85463;4883;16552;17678;52144;22561;68696
280490;201602;3763;11269;3302;10497;244;946;2411;7495;2655;8441
280500;201602;912;2441;823;2330;49;153;671;1857;720;2010
280510;201602;2622;7589;2280;7144;194;687;1668;5250;1862;5937
280520;201602;1748;4812;1603;4635;151;419;1299;3809;1450;4228
280530;201602;2323;6437;2168;6250;141;393;1779;5198;1920;5591
280540;201602;9168;25180;8516;24281;222;932;7449;20766;7671;21698
280550;201602;6793;17953;5760;16402;607;1766;3983;11390;4590;13156
280560;201602;7450;22084;7068;21526;372;1299;5902;17751;6274;19050
280570;201602;6365;17213;5571;16151;578;1884;3738;10704;4316;12588
280580;201602;5491;17016;4680;15606;799;2701;2686;9233;3485;11934
280590;201602;2308;7033;2141;6815;223;995;1478;4508;1701;5503
280600;201602;3636;11159;3398;10808;305;1089;2546;8001;2851;9090
280610;201602;2430;6825;2233;6542;195;711;1590;4505;1785;5216
280620;201602;5120;15222;4501;14155;575;1750;2974;9707;3549;11457
280630;201602;3622;11811;3418;11505;318;1017;2721;9422;3039;10439
280640;201602;2185;6561;2086;6449;88;243;1938;6069;2026;6312
280650;201602;1100;3440;996;3272;100;380;692;2253;792;2633
280660;201602;2617;7380;2507;7245;404;1096;1925;5644;2329;6740
280670;201602;15809;41596;14639;40026;2718;7912;8950;24190;11668;32102
280680;201602;2719;7380;2426;6932;196;642;1888;5287;2084;5929
280690;201602;937;2675;835;2531;119;371;563;1714;682;2085
280700;201602;1051;3143;938;2966;70;232;669;2114;739;2346
280710;201602;11655;30740;10644;29600;705;1787;8961;25514;9666;27301
280720;201602;2271;6223;2067;5985;268;802;1396;4140;1664;4942
280730;201602;920;2750;859;2664;86;304;670;2052;756;2356
280740;201602;12844;35010;11187;32516;1495;4316;7132;21072;8627;25388
280750;201602;3457;10536;3173;10061;321;1087;2181;6967;2502;8054
280760;201602;5557;16984;5070;16279;770;2680;3082;10146;3852;12826
290010;201602;2942;6672;2137;5438;47;198;1666;4024;1713;4222
290020;201602;4295;14386;4205;14266;363;1009;3512;12162;3875;13171
290030;201602;3065;9616;2900;9376;528;1675;1980;6475;2508;8150
290035;201602;4631;11773;4010;10959;221;725;3072;8684;3293;9409
290040;201602;3960;10754;3403;10127;196;768;2670;7861;2866;8629
290050;201602;2441;7974;2188;7563;153;632;1615;5575;1768;6207
290060;201602;1264;3324;1072;3101;173;564;774;2183;947;2747
290070;201602;32793;82020;28211;76317;6101;16325;13210;38146;19311;54471
290080;201602;5937;17791;5068;16639;643;2128;3546;12002;4189;14130
290090;201602;2123;4611;1674;4135;165;384;1380;3482;1545;3866
290100;201602;9452;27079;8335;25353;1064;3378;5220;16316;6284;19694
290110;201602;4742;14084;4500;13677;689;2291;2858;8468;3547;10759
290115;201602;4716;14276;4200;13604;221;726;3433;11367;3654;12093
290120;201602;6684;17510;5544;16152;253;897;4572;13196;4825;14093
290130;201602;4571;12005;3794;11050;190;725;3024;8559;3214;9284
290135;201602;4438;11214;3811;10279;254;827;2774;7160;3028;7987
290140;201602;4090;12744;3552;12010;259;1003;2867;9740;3126;10743
290150;201602;2161;6509;2055;6360;222;716;1590;4848;1812;5564
290160;201602;3303;8732;3164;8563;321;651;2596;7147;2917;7798
290170;201602;2710;8936;2461;8577;168;802;2037;6968;2205;7770
290180;201602;2891;8449;2499;7841;178;677;1921;5990;2099;6667
290190;201602;3691;12394;3537;12165;189;850;2751;9319;2940;10169
290195;201602;2144;5856;1808;5354;84;371;1463;4237;1547;4608
290200;201602;3765;11769;3339;11121;277;956;2570;8596;2847;9552
290205;201602;3131;9200;2822;8730;253;952;2052;6224;2305;7176
290210;201602;14978;42092;13576;40306;2388;6370;8892;28455;11280;34825
290220;201602;2243;6680;2127;6499;133;547;1666;4952;1799;5499
290225;201602;2828;7315;2554;7013;128;377;2294;6299;2422;6676
290230;201602;2251;7292;2138;7163;133;556;1766;5883;1899;6439
290240;201602;3493;9543;3195;9105;297;901;2367;6647;2664;7548
290250;201602;3725;11848;3375;11350;182;602;2775;9692;2957;10294
290260;201602;4940;14088;4155;12925;332;1173;3133;9741;3465;10914
290265;201602;3304;10383;2944;9742;155;676;2273;7445;2428;8121
290270;201602;11863;43225;11303;42351;1479;5856;8098;30762;9577;36618
290280;201602;5207;17054;4835;16450;424;1620;3605;12306;4029;13926
290290;201602;9584;30263;8581;28619;1317;4443;5593;19060;6910;23503
290300;201602;4572;12902;3303;10564;246;790;2142;7073;2388;7863
290310;201602;1437;4320;1261;4047;244;849;666;2149;910;2998
290320;201602;28279;80529;24042;75026;5728;19032;11080;35768;16808;54800
290323;201602;3791;10278;3340;9770;167;509;2751;8066;2918;8575
290327;201602;4355;13203;3750;12114;536;1767;2334;7567;2870;9334
290330;201602;1768;4394;1631;4249;128;352;1407;3683;1535;4035
290340;201602;4849;15018;4531;14620;1303;4304;2441;7976;3744;12280
290350;201602;4270;13340;3756;12588;378;1311;2609;8977;2987;10288
290360;201602;4465;13620;3864;12817;163;646;3203;10729;3366;11375
290370;201602;4654;12923;4012;12099;338;982;3181;9738;3519;10720
290380;201602;5549;16007;4836;14937;320;1079;3769;11807;4089;12886
290390;201602;14321;43963;13009;42049;2250;7487;7707;25949;9957;33436
290395;201602;2524;8300;2258;7800;135;617;1672;5771;1807;6388
290400;201602;3548;10426;3021;9639;273;890;2111;6710;2384;7600
290405;201602;4591;14527;3905;13273;601;2089;2256;7883;2857;9972
290410;201602;5905;17454;4826;15773;436;1693;3355;10687;3791;12380
290420;201602;3227;9351;2706;8614;205;720;2096;6662;2301;7382
290430;201602;3052;9611;2743;9080;502;1743;1606;5392;2108;7135
290440;201602;2935;7784;2386;7016;169;610;1824;5399;1993;6009
290450;201602;3254;9496;2785;8804;308;1051;1881;5954;2189;7005
290460;201602;12666;36714;11413;34658;3196;9853;4455;13722;7651;23575
290470;201602;4353;11987;3321;10467;775;2662;1362;4469;2137;7131
290475;201602;5193;17123;4685;16189;297;1368;3500;11851;3797;13219
290480;201602;2398;6461;2213;6223;275;796;1527;4506;1802;5302
290485;201602;4726;15003;4115;14092;293;1417;3241;10848;3534;12265
290490;201602;7864;20811;7475;20302;642;1831;6024;16232;6666;18063
290500;201602;4129;12975;3402;11550;511;1897;1766;5973;2277;7870
290510;201602;3267;9393;2856;8843;154;574;2358;7320;2512;7894
290515;201602;3335;9527;2833;8869;251;817;2243;7136;2494;7953
290520;201602;12008;36735;9752;32523;846;3347;5821;19278;6667;22625
290530;201602;5004;14857;4388;13908;318;969;3411;10924;3729;11893
290540;201602;3853;11089;3653;10845;422;1254;2845;8538;3267;9792
290550;201602;4516;11866;3970;11248;123;346;3618;10324;3741;10670
290560;201602;6206;18078;5473;17033;1267;3991;3042;9733;4309;13724
290570;201602;41849;114538;38259;109636;3884;11538;27068;77628;30952;89166
290580;201602;6844;23381;6442;22736;791;2908;4600;16599;5391;19507
290590;201602;7215;23083;6226;21328;290;1229;4974;17019;5264;18248
290600;201602;17295;52216;16042;50435;2197;6647;11525;37564;13722;44211
290610;201602;2434;8226;2034;7441;143;678;1416;5089;1559;5767
290620;201602;6358;19266;5818;18438;384;1243;4677;14842;5061;16085
290630;201602;7730;20373;6822;19385;600;1764;5576;16027;6176;17791
290640;201602;2636;7689;2132;6883;143;571;1580;5023;1723;5594
290650;201602;10762;30817;10153;30008;2172;6292;6122;18697;8294;24989
290660;201602;3599;10032;3112;9335;131;428;2347;7306;2478;7734
290670;201602;6754;20650;6078;19544;675;2206;4248;13901;4923;16107
290680;201602;10204;30361;9199;29145;439;1725;7574;23871;8013;25596
290682;201602;4433;12717;3953;12039;143;572;3383;10163;3526;10735
290685;201602;3726;8837;2464;7084;293;883;1469;4336;1762;5219
290687;201602;7483;21017;5872;18591;1368;4382;2709;9085;4077;13467
290689;201602;3118;9035;2750;8477;242;787;2038;6534;2280;7321
290690;201602;5363;15299;4753;14495;773;2388;3040;9375;3813;11763
290700;201602;2320;7211;2191;7026;155;581;1700;5447;1855;6028
290710;201602;7596;24065;7130;23386;348;1181;6020;19890;6368;21071
290720;201602;18092;53252;16586;51370;1294;3839;13440;42626;14734;46465
290730;201602;7118;19636;6360;18650;1012;2870;4187;12500;5199;15370
290740;201602;918;2707;750;2420;76;266;506;1642;582;1908
290750;201602;9911;27574;8501;25028;1404;4574;4541;12894;5945;17468
290755;201602;2314;6542;1890;5848;90;336;1378;4227;1468;4563
290760;201602;4169;12592;3413;11231;443;1332;2067;7057;2510;8389
290770;201602;2476;8732;2341;8556;96;453;1893;6940;1989;7393
290780;201602;8856;22407;7676;20715;801;1692;5746;16232;6547;17924
290790;201602;4242;12803;3914;12353;234;756;3289;10423;3523;11179
290800;201602;7158;15240;5693;13680;600;1197;4238;10839;4838;12036
290810;201602;5103;15737;4297;14455;183;702;3260;11056;3443;11758
290820;201602;5589;15520;4959;14707;456;1535;3732;11155;4188;12690
290830;201602;4302;11419;3951;10934;213;721;2965;8012;3178;8733
290840;201602;17434;49216;15422;46246;2396;7028;9785;30643;12181;37671
290850;201602;6040;17461;5823;17201;710;1874;4586;14133;5296;16007
290860;201602;5000;16862;4669;16467;432;1649;3623;13068;4055;14717
290870;201602;4634;13631;3760;12159;257;1035;2664;8561;2921;9596
290880;201602;1416;3840;1129;3391;109;303;740;2270;849;2573
290890;201602;6960;18023;5934;16885;638;1630;4659;13593;5297;15223
290900;201602;2398;6883;1813;5868;267;905;931;3020;1198;3925
290910;201602;4606;12395;3828;11270;102;403;3234;9419;3336;9822
290920;201602;4608;13223;4222;12696;284;824;3456;10470;3740;11294
290930;201602;7769;23834;6806;22252;393;1731;5227;16796;5620;18527
290940;201602;3418;10905;3152;10531;127;446;2642;9031;2769;9477
290950;201602;1528;4243;1334;3953;159;469;881;2656;1040;3125
290960;201602;5680;16090;5170;15455;179;666;4310;12924;4489;13590
290970;201602;3603;11399;3161;10676;289;981;2128;7349;2417;8330
290980;201602;10495;29843;8933;26969;2373;7340;2664;8093;5037;15433
290990;201602;8951;26840;7771;24917;771;2665;5623;17856;6394;20521
291000;201602;2942;8876;2662;8552;148;566;2344;7527;2492;8093
291005;201602;14188;36864;12504;34676;1675;4712;8473;23953;10148;28665
291010;201602;3252;10042;2571;8617;247;843;1641;5584;1888;6427
291020;201602;1343;3512;1042;2998;106;303;557;1517;663;1820
291030;201602;2239;6106;1657;4968;165;543;965;2849;1130;3392
291040;201602;5460;16344;4868;15503;353;1322;3767;12000;4120;13322
291050;201602;7586;24618;6897;23375;1643;6248;3444;11226;5087;17474
291060;201602;5922;21718;5590;21201;908;3837;3537;13265;4445;17102
291070;201602;15877;45771;13909;42945;1016;3526;10552;32644;11568;36170
291072;201602;22731;66894;18526;58661;4540;15547;6089;19611;10629;35158
291075;201602;5065;14317;4531;13555;240;629;3544;10855;3784;11484
291077;201602;1434;4094;1170;3667;91;301;741;2333;832;2634
291080;201602;76897;238396;69354;224345;23804;78087;14418;46877;38222;124964
291085;201602;5633;14718;4853;13690;410;1229;3897;11035;4307;12264
291090;201602;1536;3724;1395;3560;47;140;1236;3153;1283;3293
291100;201602;2589;6593;2084;6043;96;376;1643;4697;1739;5073
291110;201602;4663;17061;4249;16444;510;2303;2969;11267;3479;13570
291120;201602;7106;19329;6555;18515;847;2393;4523;12937;5370;15330
291125;201602;1862;3753;1414;3271;90;220;1111;2629;1201;2849
291130;201602;2805;8801;2380;8053;124;549;1759;5808;1883;6357
291140;201602;4118;12266;3617;11344;494;1501;2238;7158;2732;8659
291150;201602;1916;5094;1808;4966;112;349;1480;4018;1592;4367
291160;201602;5213;16296;4589;15279;1042;3511;2353;7882;3395;11393
291165;201602;2515;7037;1930;5952;46;191;1395;4198;1441;4389
291170;201602;21513;55928;18405;51766;1624;4939;11994;33883;13618;38822
291180;201602;6111;16090;4972;14387;431;1371;3486;10150;3917;11521
291185;201602;3699;10087;3308;9495;267;780;2639;7528;2906;8308
291190;201602;6946;19052;6129;17924;472;1646;4882;14087;5354;15733
291200;201602;2878;8582;2303;7492;156;529;1532;5081;1688;5610
291210;201602;6759;16267;5698;15065;278;881;4329;11421;4607;12302
291220;201602;4119;12777;3761;12222;474;1774;2519;8079;2993;9853
291230;201602;3950;10070;3607;9693;74;149;3396;9249;3470;9398
291240;201602;4577;12437;3970;11368;133;432;3188;8988;3321;9420
291250;201602;3503;10778;2808;9493;288;1005;1818;6268;2106;7273
291260;201602;1051;3072;968;2964;62;238;802;2387;864;2625
291270;201602;4384;14081;3980;13338;1249;4366;1857;6286;3106;10652
291280;201602;2107;5988;1681;5291;376;1335;784;2348;1160;3683
291290;201602;5459;15171;4739;14241;787;2367;2805;8615;3592;10982
291300;201602;4343;12342;3380;10722;202;740;2469;7720;2671;8460
291310;201602;5260;15046;4592;13832;289;923;3525;10602;3814;11525
291320;201602;5979;18795;4932;16822;1139;4023;2258;7812;3397;11835
291330;201602;1561;4718;1389;4436;127;461;972;3063;1099;3524
291340;201602;3859;10945;3201;10015;131;463;2560;7989;2691;8452
291345;201602;3353;10670;3114;10383;202;702;2617;8911;2819;9613
291350;201602;5661;16595;4967;15427;292;1012;3824;12039;4116;13051
291360;201602;32363;89030;28817;84147;7076;20811;15246;45950;22322;66761
291370;201602;8203;23421;7710;22818;510;1629;5999;17889;6509;19518
291380;201602;3656;11049;3135;10204;204;758;2308;7622;2512;8380
291390;201602;9984;27124;9238;26243;1343;3687;6619;19032;7962;22719
291400;201602;13413;37397;11847;35024;2291;6241;7181;22559;9472;28800
291410;201602;3233;8501;2411;7213;127;552;1738;5007;1865;5559
291420;201602;2058;5645;1785;5324;88;329;1480;4357;1568;4686
291430;201602;3198;9384;2843;8907;133;647;2311;6994;2444;7641
291440;201602;6527;19811;5553;18200;520;1800;4049;13442;4569;15242
291450;201602;8222;23981;7200;22584;330;1036;5747;18831;6077;19867
291460;201602;13001;39207;11723;37209;1669;5770;7249;23172;8918;28942
291465;201602;7857;22315;6914;21250;441;1655;5638;17150;6079;18805
291470;201602;15589;41872;13719;39652;1060;2920;10259;30761;11319;33681
291480;201602;33748;86872;28746;80082;4045;12426;16470;45887;20515;58313
291490;201602;4211;13518;3991;13222;444;1494;2953;9942;3397;11436
291500;201602;4224;12155;3592;11234;203;766;2836;8832;3039;9598
291510;201602;3552;10706;3258;10315;69;249;2902;9323;2971;9572
291520;201602;3746;10273;3229;9581;299;995;2214;6576;2513;7571
291530;201602;2168;5895;1716;5224;386;1196;833;2739;1219;3935
291535;201602;3716;11312;3355;10756;191;688;2625;8469;2816;9157
291540;201602;2093;4981;1747;4627;119;217;1529;4196;1648;4413
291550;201602;5045;13650;4399;12767;932;2582;2457;7368;3389;9950
291560;201602;18112;42948;13073;37073;978;2811;9547;28356;10525;31167
291570;201602;2159;5840;1985;5631;138;304;1680;4956;1818;5260
291580;201602;5390;16438;4793;15585;506;2023;3382;10925;3888;12948
291590;201602;1703;5443;1541;5182;160;596;1134;3851;1294;4447
291600;201602;5298;14717;3968;12626;1060;3490;1547;4920;2607;8410
291610;201602;4767;15256;4594;15064;150;528;4171;13787;4321;14315
291620;201602;2901;6907;2298;6277;132;400;1833;5154;1965;5554
291630;201602;3065;7460;2551;6869;249;678;1935;5320;2184;5998
291640;201602;16795;45688;13458;40804;3302;10431;4004;12677;7306;23108
291650;201602;7910;23626;7310;22893;625;1651;6013;19398;6638;21049
291660;201602;2134;5639;1743;5038;135;495;1122;3069;1257;3564
291670;201602;1809;5058;1631;4819;90;267;1296;3898;1386;4165
291680;201602;3958;11550;3448;10711;620;2079;1956;6060;2576;8139
291685;201602;4728;11878;3929;10849;656;1745;2505;7202;3161;8947
291690;201602;3867;10367;3048;9033;220;619;2113;6263;2333;6882
291700;201602;8980;27999;8008;26312;901;2905;5787;19343;6688;22248
291710;201602;5123;13353;4151;12135;324;1006;3022;8868;3346;9874
291720;201602;4403;14429;3765;13109;341;1381;2576;8770;2917;10151
291730;201602;5924;17690;5398;16987;521;1783;4152;13250;4673;15033
291733;201602;2602;7483;2236;6999;205;692;1461;4726;1666;5418
291735;201602;2824;7850;2364;7188;115;414;1900;5747;2015;6161
291740;201602;3532;10405;3053;9732;230;831;2384;7608;2614;8439
291750;201602;22223;56957;17358;49542;3787;11135;8177;24033;11964;35168
291760;201602;10855;34661;9664;32648;3857;14465;2358;7943;6215;22408
291770;201602;7553;21827;6414;19797;770;2591;4063;12308;4833;14899
291780;201602;4409;13320;4120;12844;264;882;3376;10494;3640;11376
291790;201602;2624;8029;2493;7858;86;388;2111;6531;2197;6919
291800;201602;29852;80986;26238;76032;4224;12305;15871;47547;20095;59852
291810;201602;10459;28827;8847;26856;387;1401;7136;21715;7523;23116
291820;201602;3704;10934;3327;10386;205;723;2539;7976;2744;8699
291830;201602;3970;10741;3663;10300;472;1381;2584;7354;3056;8735
291835;201602;6238;19485;5047;17390;1415;5233;2302;8036;3717;13269
291840;201602;46636;130764;41156;124564;6435;18987;27925;87931;34360;106918
291845;201602;2604;7682;2427;7458;124;334;2183;6861;2307;7195
291850;201602;4471;12815;3691;11582;351;1016;2640;8573;2991;9589
291855;201602;1795;4498;1549;4194;157;544;1127;2944;1284;3488
291860;201602;2152;6097;1748;5332;83;309;1158;3444;1241;3753
291870;201602;1398;3741;1010;3044;70;271;628;1810;698;2081
291875;201602;2768;8714;2520;8340;112;453;1806;5864;1918;6317
291880;201602;4848;15595;4522;15002;436;1482;3341;11204;3777;12686
291890;201602;1253;3262;1036;2997;260;707;621;1905;881;2612
291900;201602;1242;3328;1005;2954;62;224;743;2152;805;2376
291905;201602;2679;7290;2026;6101;184;657;1387;3995;1571;4652
291910;201602;2715;7244;2277;6728;122;469;1898;5563;2020;6032
291915;201602;6949;21206;5827;19172;310;1120;4507;14923;4817;16043
291920;201602;25176;74382;23157;71563;3664;11919;14070;43736;17734;55655
291930;201602;2571;7606;2282;7153;194;733;1599;4893;1793;5626
291940;201602;3308;9363;2452;7867;300;1063;1392;4350;1692;5413
291950;201602;8592;28627;7792;27130;1227;4298;4501;16185;5728;20483
291955;201602;10630;30490;9826;29496;2373;7181;5153;16394;7526;23575
291960;201602;3107;9080;2545;8234;237;781;1830;6143;2067;6924
291970;201602;3809;11865;3522;11391;382;1389;2361;7713;2743;9102
291980;201602;11876;33661;9102;29703;1044;3471;5985;20101;7029;23572
291990;201602;2128;6525;1940;6279;83;283;1636;5432;1719;5715
291992;201602;2744;8371;2681;8263;368;1157;2004;6158;2372;7315
291995;201602;1978;5733;1734;5392;106;411;1436;4425;1542;4836
292000;201602;2388;6705;2151;6392;226;790;1513;4532;1739;5322
292010;201602;6301;15886;4929;13954;484;1282;3529;10227;4013;11509
292020;201602;3919;13622;3709;13269;625;2352;2597;9281;3222;11633
292030;201602;2019;6206;1805;5911;221;774;1056;3437;1277;4211
292040;201602;4348;11759;3754;11140;269;587;3128;9891;3397;10478
292045;201602;3119;10218;2880;9889;108;437;2621;8918;2729;9355
292050;201602;6257;19048;5382;17305;443;1685;3439;10937;3882;12622
292060;201602;11780;30973;10919;29920;998;2446;8681;23935;9679;26381
292070;201602;4535;14113;4271;13808;396;1235;3509;11488;3905;12723
292080;201602;3492;9120;2873;8342;176;576;2422;7057;2598;7633
292090;201602;3874;10210;3325;9569;188;689;2795;8058;2983;8747
292100;201602;11119;29849;9510;27681;2370;7180;4302;13118;6672;20298
292105;201602;2967;9244;2656;8751;122;528;2122;6974;2244;7502
292110;201602;6383;17087;4986;14891;1339;3998;2281;7031;3620;11029
292120;201602;7445;20928;6251;18705;1210;3512;3296;10234;4506;13746
292130;201602;2870;7861;2467;7302;466;1247;1451;4534;1917;5781
292140;201602;4908;12876;4087;11728;732;1933;2643;7848;3375;9781
292145;201602;2369;7292;2117;6866;292;912;1376;4670;1668;5582
292150;201602;12697;38828;11705;37261;595;2205;9334;29808;9929;32013
292160;201602;2427;7063;2079;6610;98;406;1806;5680;1904;6086
292170;201602;8650;24640;7158;22097;888;3022;4462;13758;5350;16780
292180;201602;2915;8548;2323;7521;385;1184;1298;4363;1683;5547
292190;201602;3271;9322;2754;8538;557;1802;1465;4630;2022;6432
292200;201602;6601;20357;5650;18716;1643;5840;1904;6366;3547;12206
292205;201602;3796;11461;3415;10916;156;660;2713;8491;2869;9151
292210;201602;6358;17146;5304;15765;314;1153;4326;12783;4640;13936
292220;201602;1854;5094;1661;4811;503;1378;735;2172;1238;3550
292225;201602;3119;9730;2842;9315;153;648;2316;7543;2469;8191
292230;201602;6530;18907;6158;18319;331;1396;4800;13728;5131;15124
292240;201602;4756;14322;4283;13383;483;1589;2908;9045;3391;10634
292250;201602;4953;15281;4609;14687;1120;3681;2046;6622;3166;10303
292260;201602;3108;9190;2899;8913;187;575;2413;7478;2600;8053
292265;201602;3137;9477;2705;8760;122;551;2039;6450;2161;7001
292270;201602;4009;10198;3233;9292;162;545;2684;7756;2846;8301
292273;201602;2730;6310;2091;5527;195;468;1540;4290;1735;4758
292275;201602;1533;4235;1356;3979;154;473;998;2994;1152;3467
292280;201602;2049;5898;1788;5604;161;464;1339;4482;1500;4946
292285;201602;2465;6667;2038;6055;113;403;1576;4658;1689;5061
292290;201602;6928;20812;5769;19264;408;1608;4347;14682;4755;16290
292300;201602;7965;23943;6944;22695;1730;5974;3700;12416;5430;18390
292303;201602;2814;8543;2550;8187;98;398;2171;6861;2269;7259
292305;201602;2877;7787;2711;7552;62;248;2455;6745;2517;6993
292310;201602;5774;17151;5348;16503;169;609;4408;13561;4577;14170
292320;201602;6569;18497;5569;16829;418;1331;4227;12742;4645;14073
292330;201602;2154;5798;1978;5565;157;525;1578;4373;1735;4898
292335;201602;5024;13270;4489;12575;460;1217;3536;10104;3996;11321
292340;201602;6204;17700;5310;16241;483;1476;3727;11493;4210;12969
292350;201602;2260;6644;1963;6221;135;520;1558;4923;1693;5443
292360;201602;5193;13617;4923;13150;205;391;4093;11465;4298;11856
292370;201602;7895;23147;7125;22121;640;1789;5556;17591;6196;19380
292380;201602;7166;21228;6531;20217;551;1586;5070;15932;5621;17518
292390;201602;3378;7726;2859;7165;83;188;2588;6579;2671;6767
292400;201602;20361;62001;19088;60029;2526;7923;13325;42398;15851;50321
292405;201602;4460;11138;3592;10023;191;468;2857;8094;3048;8562
292410;201602;1937;5203;1797;5047;131;349;1500;4232;1631;4581
292420;201602;3734;12078;3534;11794;225;871;2903;9696;3128;10567
292430;201602;5499;16242;4179;14388;343;1329;2794;9681;3137;11010
292440;201602;8288;27600;7683;26702;210;911;6847;23988;7057;24899
292450;201602;3941;11811;3246;10659;337;1103;2228;7436;2565;8539
292460;201602;4931;14835;4264;13718;548;1892;2776;8931;3324;10823
292465;201602;2374;7041;2003;6446;198;705;1263;4141;1461;4846
292467;201602;1819;5865;1737;5741;293;1041;1127;3797;1420;4838
292470;201602;2860;7646;2359;6812;103;359;1837;5247;1940;5606
292480;201602;6043;16147;5182;15029;148;542;4643;13416;4791;13958
292490;201602;2365;6448;1948;5850;141;441;1459;4369;1600;4810
292500;201602;6453;19154;5523;17534;671;2180;3564;11507;4235;13687
292510;201602;12555;35666;10857;33238;751;2733;8285;25550;9036;28283
292520;201602;5464;15577;4772;14577;1113;3437;2416;7531;3529;10968
292525;201602;5190;13593;4423;12695;173;563;3724;10706;3897;11269
292530;201602;26349;75106;23052;70665;6173;19570;9955;31761;16128;51331
292540;201602;2804;7763;2477;7371;258;878;1893;5578;2151;6456
292550;201602;6324;19541;5502;18475;643;2292;4070;14039;4713;16331
292560;201602;3968;11095;3459;10330;180;693;2629;7744;2809;8437
292570;201602;4052;11632;3751;11318;67;154;3539;10943;3606;11097
292575;201602;6123;20359;5924;20052;570;2060;4737;16101;5307;18161
292580;201602;6693;19801;6283;19246;350;1157;5286;16209;5636;17366
292590;201602;7178;21370;6672;20642;472;1463;5475;16870;5947;18333
292593;201602;2964;7654;2460;6874;371;974;1625;4537;1996;5511
292595;201602;5706;15858;5037;15013;380;1216;3877;11618;4257;12834
292600;201602;10518;29757;9441;28378;870;2129;7267;22666;8137;24795
292610;201602;4569;12801;3737;11452;293;905;2279;7326;2572;8231
292620;201602;5994;17697;5253;16843;114;388;4855;15716;4969;16104
292630;201602;9181;23205;7621;20825;790;2124;5198;14479;5988;16603
292640;201602;7727;25045;7171;24189;424;1639;5444;18568;5868;20207
292650;201602;4699;12524;4398;12138;372;868;3652;10216;4024;11084
292660;201602;10617;31861;9745;30616;1048;3375;7228;23056;8276;26431
292665;201602;2422;7467;2307;7316;41;116;2129;6822;2170;6938
292670;201602;3666;10317;2864;8896;185;634;1808;5621;1993;6255
292680;201602;3575;10716;3242;10168;463;1337;2215;7029;2678;8366
292690;201602;2823;7708;2070;6511;168;535;1395;4535;1563;5070
292700;201602;9202;27341;8110;25734;1186;3494;5137;17201;6323;20695
292710;201602;2074;6785;1956;6628;64;255;1733;5880;1797;6135
292720;201602;9092;23246;7842;21862;322;1058;6669;18812;6991;19870
292730;201602;3581;10677;3436;10469;258;829;2706;8264;2964;9093
292740;201602;320969;858346;300895;828949;53243;155369;182557;498390;235800;653759
292750;201602;6408;17171;5509;15957;291;945;4402;12789;4693;13734
292760;201602;3936;12336;3549;11645;401;1413;2379;7838;2780;9251
292770;201602;5816;17005;5124;16039;910;3005;3025;9773;3935;12778
292780;201602;1869;4405;1424;3834;114;395;1006;2625;1120;3020
292790;201602;3236;7939;3102;7799;74;132;2959;7535;3033;7667
292800;201602;8976;26510;8259;25334;475;1621;6596;20141;7071;21762
292805;201602;2911;8213;2558;7722;296;967;1854;5589;2150;6556
292810;201602;9265;27731;7746;25606;954;3219;5256;17842;6210;21061
292820;201602;7144;20625;5454;18164;292;1251;4258;14151;4550;15402
292830;201602;1729;5022;1562;4791;67;288;1358;4112;1425;4400
292840;201602;7712;23519;7247;22897;318;1303;6353;19738;6671;21041
292850;201602;3105;8260;2527;7375;328;1001;1537;4386;1865;5387
292860;201602;14687;38221;13470;36652;1118;3195;10361;28086;11479;31281
292870;201602;18933;51670;16567;48036;2015;6493;9631;27490;11646;33983
292880;201602;12413;35045;11034;33148;1005;3417;7806;23010;8811;26427
292890;201602;5198;17567;4720;16709;648;2440;3017;10844;3665;13284
292895;201602;2758;6694;2152;5780;248;624;1469;4006;1717;4630
292900;201602;2713;8409;2582;8212;166;750;1910;5795;2076;6545
292905;201602;3959;11723;3242;10612;250;899;2270;7459;2520;8358
292910;201602;4898;14574;4442;13765;590;1913;2607;8112;3197;10025
292920;201602;8981;26302;8541;25670;522;1899;7014;20525;7536;22424
292925;201602;5038;15343;4549;14639;368;1223;3485;11272;3853;12495
292930;201602;6367;20414;6018;19803;458;1998;4282;13687;4740;15685
292935;201602;1986;5794;1674;5454;89;332;1409;4740;1498;5072
292937;201602;3197;8138;2658;7473;187;565;2098;5911;2285;6476
292940;201602;3252;8851;2595;7983;274;852;1733;5556;2007;6408
292950;201602;7917;23133;7357;22209;506;1866;5367;15781;5873;17647
292960;201602;5172;13306;4450;12344;294;870;3272;9020;3566;9890
292970;201602;4201;12567;3706;11913;140;653;3029;9688;3169;10341
292975;201602;3466;9219;3235;8930;341;881;2719;7613;3060;8494
292980;201602;3255;8712;2545;7713;212;748;1804;5454;2016;6202
292990;201602;11689;33600;10218;31388;409;1474;8292;25405;8701;26879
293000;201602;2767;7173;2539;6904;53;164;2024;5883;2077;6047
293010;201602;17617;48844;14997;44713;2355;7470;8532;25261;10887;32731
293015;201602;7368;25192;6551;23590;735;3008;4231;15159;4966;18167
293020;201602;8853;29718;8340;28998;311;1429;7183;24844;7494;26273
293030;201602;5464;15652;4386;13977;255;883;3086;10235;3341;11118
293040;201602;3652;12067;3490;11765;168;551;3067;10383;3235;10934
293050;201602;19893;54830;17532;51857;3367;10178;8970;28108;12337;38286
293060;201602;3697;9807;3042;8751;243;758;2172;6152;2415;6910
293070;201602;21686;61274;18690;56879;4461;13695;8550;27173;13011;40868
293075;201602;3167;10863;2921;10488;207;886;2260;8147;2467;9033
293076;201602;3708;10208;3337;9718;179;482;2769;8272;2948;8754
293077;201602;4771;14983;4318;14360;929;3223;2448;8424;3377;11647
293080;201602;4521;14278;4135;13667;210;975;3380;10965;3590;11940
293090;201602;3255;10424;2705;9585;268;1017;1921;6929;2189;7946
293100;201602;5745;16911;4769;15192;445;1495;3388;10913;3833;12408
293105;201602;3945;12931;3446;11965;522;1791;2148;7640;2670;9431
293110;201602;2002;5698;1771;5365;64;216;1448;4409;1512;4625
293120;201602;3658;12116;3492;11859;332;1021;2687;9378;3019;10399
293130;201602;3994;11278;3442;10674;138;510;3009;9501;3147;10011
293135;201602;30995;78041;23602;67721;4781;15442;9005;25855;13786;41297
293140;201602;1946;5532;1852;5400;132;493;1494;4221;1626;4714
293150;201602;5397;17825;4635;16357;742;2700;2774;10052;3516;12752
293160;201602;3729;9563;3408;9192;554;1107;2456;7186;3010;8293
293170;201602;3278;9720;3001;9331;272;1005;2114;6600;2386;7605
293180;201602;5119;14486;4097;12832;153;643;3158;9700;3311;10343
293190;201602;13642;41131;12551;39511;429;2023;10748;33222;11177;35245
293200;201602;7044;19356;6164;18276;182;699;4830;14438;5012;15137
293210;201602;4998;14359;4416;13372;289;941;3305;9996;3594;10937
293220;201602;4922;14495;4230;13291;1140;3613;1481;4833;2621;8446
293230;201602;3670;11280;3320;10742;471;1676;2216;7164;2687;8840
293240;201602;4350;11942;3497;10530;138;455;2566;7750;2704;8205
293245;201602;4156;11892;3785;11358;268;774;2933;8919;3201;9693
293250;201602;5580;15435;5022;14619;502;1526;3528;10252;4030;11778
293260;201602;4439;13315;3786;12356;253;887;2830;9343;3083;10230
293270;201602;5416;14487;4952;13990;413;1006;4184;12086;4597;13092
293280;201602;5169;14568;4389;13543;212;658;3439;10781;3651;11439
293290;201602;14425;47861;13441;46003;3280;11586;5942;20958;9222;32544
293300;201602;6849;16096;5721;14796;342;803;4410;11663;4752;12466
293305;201602;4813;11890;4055;10892;140;431;3386;9069;3526;9500
293310;201602;2484;6497;2020;5704;186;517;1339;3765;1525;4282
293315;201602;4158;10629;3545;9716;354;907;2587;7202;2941;8109
293317;201602;2432;7013;2198;6593;212;611;1464;4475;1676;5086
293320;201602;7676;25477;7471;25214;816;2886;5805;19728;6621;22614
293325;201602;1776;5063;1456;4581;192;652;951;2996;1143;3648
293330;201602;50195;160107;45281;151633;9960;35407;20720;70403;30680;105810
293340;201602;2617;7436;2054;6475;288;949;1109;3518;1397;4467
293345;201602;3245;9614;2836;9070;242;662;2173;7284;2415;7946
293350;201602;6367;18538;6004;18118;257;589;5381;16763;5638;17352
293360;201602;12682;38959;11496;37464;1048;3891;9516;30901;10564;34792
310010;201602;904;2453;710;2156;105;402;321;910;426;1312
310020;201602;2885;9056;2398;8123;539;1993;312;983;851;2976
310030;201602;2278;7081;1876;6397;410;1562;970;3249;1380;4811
310040;201602;952;2535;795;2322;59;206;615;1765;674;1971
310050;201602;1836;6285;1668;5915;343;1366;686;2356;1029;3722
310060;201602;3156;9948;2741;9413;347;1305;2009;6904;2356;8209
310070;201602;323;912;248;774;20;88;154;444;174;532
310080;201602;703;2130;580;1917;105;433;206;642;311;1075
310090;201602;4508;13437;3892;12363;474;1687;2460;7751;2934;9438
310100;201602;3360;10169;2827;9290;179;718;2135;6987;2314;7705
310110;201602;4643;13125;4003;12091;675;2298;2137;6243;2812;8541
310120;201602;589;1812;464;1556;122;517;176;470;298;987
310130;201602;397;1203;361;1150;88;329;181;525;269;854
310140;201602;204;665;168;610;51;231;45;130;96;361
310150;201602;4609;14095;4002;12964;956;3392;1416;4512;2372;7904
310160;201602;7115;22354;5908;20146;1725;6380;1007;3337;2732;9717
310163;201602;1001;3205;847;2901;255;914;214;722;469;1636
310170;201602;8937;25121;7968;23778;1143;3630;5182;15708;6325;19338
310180;201602;1572;4555;1349;4210;288;988;634;1906;922;2894
310190;201602;2771;9122;2458;8542;682;2595;381;1305;1063;3900
310200;201602;1794;5826;1524;5283;326;1262;512;1761;838;3023
310205;201602;1084;3127;838;2752;152;507;442;1491;594;1998
310210;201602;2647;7716;2372;7311;190;625;1848;5726;2038;6351
310220;201602;1019;3088;907;2906;170;597;533;1667;703;2264
310230;201602;2457;7635;2085;6840;354;1382;1040;3202;1394;4584
310240;201602;887;3231;808;3068;120;502;438;1720;558;2222
310250;201602;798;2645;771;2600;151;622;445;1383;596;2005
310260;201602;3115;9850;2429;8483;565;2234;539;1697;1104;3931
310270;201602;2483;7095;2068;6506;171;657;1586;4943;1757;5600
310280;201602;2261;5973;1852;5362;213;784;1045;2887;1258;3671
310285;201602;2015;7226;1869;7008;215;968;1384;5223;1599;6191
310290;201602;1121;3381;1055;3278;253;888;521;1460;774;2348
310300;201602;1664;5606;1581;5459;422;1663;777;2569;1199;4232
310310;201602;358;976;261;802;33;97;120;381;153;478
310320;201602;381;1202;316;1082;42;200;149;484;191;684
310330;201602;506;1274;342;969;35;112;139;343;174;455
310340;201602;8238;24713;6779;22223;1318;4416;3317;11372;4635;15788
310350;201602;13419;35501;9810;29620;2342;7886;2466;7230;4808;15116
310360;201602;428;1263;399;1223;26;113;287;832;313;945
310370;201602;1384;4598;1256;4376;367;1287;588;2091;955;3378
310375;201602;1168;3175;759;2430;108;402;262;827;370;1229
310380;201602;358;935;242;762;81;278;78;218;159;496
310390;201602;444;1561;385;1448;82;338;68;221;150;559
310400;201602;9888;27407;7536;23496;1720;5863;1765;5573;3485;11436
310410;201602;717;2390;501;2010;105;459;89;359;194;818
310420;201602;5429;15208;3611;11458;620;2171;510;1411;1130;3582
310430;201602;1299;4233;1003;3654;246;989;138;473;384;1462
310440;201602;543;1567;415;1331;74;280;163;504;237;784
310445;201602;1193;3922;1001;3564;131;501;631;2243;762;2744
310450;201602;4452;12641;3636;11472;407;1351;2433;7796;2840;9147
310460;201602;1495;4479;1244;4097;353;1289;258;926;611;2215
310470;201602;3706;8881;3141;8200;264;619;2611;6944;2875;7563
310480;201602;1221;3559;907;2937;187;629;350;1073;537;1702
310490;201602;2816;9179;2452;8483;604;2453;944;3128;1548;5581
310500;201602;1223;4126;1092;3861;248;967;409;1397;657;2364
310510;201602;2002;6274;1579;5361;378;1374;240;811;618;2185
310520;201602;1375;3550;1049;3048;80;223;701;2051;781;2274
310530;201602;983;2932;525;1797;64;248;58;170;122;418
310540;201602;2876;9353;2580;8821;640;2277;1101;3794;1741;6071
310550;201602;1189;3353;957;2993;202;759;460;1330;662;2089
310560;201602;15024;45653;12781;41410;3359;12136;3648;11062;7007;23198
310570;201602;1129;3412;962;3125;154;589;616;1965;770;2554
310590;201602;4191;12178;3421;10760;597;1996;1412;4328;2009;6324
310600;201602;1358;4471;1222;4201;285;1131;457;1450;742;2581
310610;201602;455;1546;399;1423;79;353;108;341;187;694
310620;201602;136615;418961;117740;384003;27237;99199;42921;130717;70158;229916
310630;201602;3943;11947;3640;11459;365;1311;2635;8197;3000;9508
310640;201602;1249;3774;1010;3369;298;1089;249;771;547;1860
310650;201602;2624;8303;2098;7391;334;1234;1162;4115;1496;5349
310660;201602;1305;3954;1152;3755;125;421;822;2657;947;3078
310665;201602;1234;3747;1112;3580;102;359;855;2811;957;3170
310670;201602;38531;118196;34387;109748;8967;30272;11789;36897;20756;67169
310680;201602;642;1867;587;1791;100;335;368;1100;468;1435
310690;201602;1393;4469;1134;4026;240;1018;386;1272;626;2290
310700;201602;522;1277;405;1128;73;242;242;651;315;893
310710;201602;6158;20146;4819;17922;972;4243;647;2190;1619;6433
310720;201602;756;2273;690;2158;93;341;428;1304;521;1645
310730;201602;9173;28428;8196;26827;1497;5309;4585;14970;6082;20279
310740;201602;4824;15271;3854;13407;923;3498;793;2636;1716;6134
310750;201602;1457;3618;1104;3144;205;618;541;1460;746;2078
310760;201602;599;1815;503;1654;93;332;186;612;279;944
310770;201602;862;2704;662;2398;153;628;258;874;411;1502
310780;201602;3637;10087;3083;9108;474;1409;1892;5595;2366;7004
310790;201602;1905;6102;1732;5795;436;1525;751;2635;1187;4160
310800;201602;2759;8701;2127;7488;621;2522;166;533;787;3055
310810;201602;1114;3139;990;2915;175;570;533;1485;708;2055
310820;201602;1278;3668;915;2986;211;740;217;721;428;1461
310825;201602;2467;8335;1944;7420;126;671;1397;5276;1523;5947
310830;201602;1303;4224;1048;3740;300;1136;265;902;565;2038
310840;201602;2076;6336;1614;5543;335;1240;404;1323;739;2563
310850;201602;1491;4440;1268;4149;175;614;870;2865;1045;3479
310855;201602;2847;8986;2447;8371;400;1477;1549;5358;1949;6835
310860;201602;7336;22493;6176;20414;792;2828;3565;11960;4357;14788
310870;201602;1006;2784;784;2416;144;480;401;1237;545;1717
310880;201602;1032;3239;861;2930;156;614;423;1416;579;2030
310890;201602;2502;7591;1942;6632;454;1749;389;1203;843;2952
310900;201602;3883;12245;3052;10537;686;2619;902;2907;1588;5526
310910;201602;1887;5320;1267;4128;221;832;149;388;370;1220
310920;201602;1853;5443;1465;4847;330;1243;616;2013;946;3256
310925;201602;886;2916;801;2769;302;1151;279;932;581;2083
310930;201602;5987;16870;4798;15129;840;2843;2627;8575;3467;11418
310940;201602;6061;17066;5064;15553;847;2689;2702;8258;3549;10947
310945;201602;1104;3264;977;3086;125;463;599;1832;724;2295
310950;201602;1978;6296;1471;5205;401;1630;359;1168;760;2798
310960;201602;371;1210;303;1082;90;363;98;347;188;710
310970;201602;1403;4662;1031;3795;245;1006;124;388;369;1394
310980;201602;430;1055;265;776;38;130;121;316;159;446
310990;201602;1115;3636;918;3225;208;826;246;801;454;1627
311000;201602;3447;11691;3145;11119;868;3450;1037;3407;1905;6857
311010;201602;692;2340;641;2249;213;795;281;984;494;1779
311020;201602;872;2584;693;2274;144;538;293;908;437;1446
311030;201602;1569;4269;1106;3452;278;990;335;942;613;1932
311040;201602;458;1532;391;1374;85;301;89;291;174;592
311050;201602;2035;6373;1808;6019;491;1815;759;2521;1250;4336
311060;201602;2288;6739;1720;5578;327;1185;462;1381;789;2566
311070;201602;1352;4662;1195;4360;269;1116;473;1698;742;2814
311080;201602;789;2435;683;2234;141;504;286;878;427;1382
311090;201602;1519;5723;1323;5322;406;1796;276;1084;682;2880
311100;201602;2021;6759;1647;5965;562;2205;225;805;787;3010
311110;201602;3388;8182;2459;6871;385;1164;1228;3437;1613;4601
311115;201602;1189;3479;996;3195;100;414;660;2067;760;2481
311120;201602;7751;21748;6030;18763;1390;4851;1536;4427;2926;9278
311130;201602;1863;5877;1574;5462;320;1350;654;2119;974;3469
311140;201602;1241;3335;1022;3052;91;318;696;2048;787;2366
311150;201602;1709;5900;1572;5682;267;1072;960;3468;1227;4540
311160;201602;3955;13237;3253;11967;1118;4500;727;2676;1845;7176
311170;201602;776;2319;615;2031;62;225;289;992;351;1217
311180;201602;1156;3333;907;2865;263;900;200;595;463;1495
311190;201602;1105;3108;816;2546;160;574;198;546;358;1120
311200;201602;1980;6033;1607;5263;429;1550;270;790;699;2340
311205;201602;983;3260;840;2968;120;484;372;1330;492;1814
311210;201602;917;2967;846;2873;155;520;564;1988;719;2508
311220;201602;858;2683;701;2356;157;574;222;717;379;1291
311230;201602;8143;25558;6444;22147;1267;4643;2187;7816;3454;12459
311240;201602;1011;3045;790;2688;198;750;206;677;404;1427
311250;201602;744;2432;667;2312;194;756;203;618;397;1374
311260;201602;2369;6325;1777;5365;431;1454;560;1671;991;3125
311265;201602;1203;3382;951;2967;178;602;482;1514;660;2116
311270;201602;3276;10451;2866;9878;307;1446;1948;6447;2255;7893
311280;201602;1226;3414;795;2530;158;586;185;560;343;1146
311290;201602;1957;6561;1839;6301;389;1319;1015;3552;1404;4871
311300;201602;4218;14157;3776;13358;442;1874;2576;9031;3018;10905
311310;201602;561;1889;509;1797;93;377;187;606;280;983
311320;201602;3729;12388;3368;11613;634;2472;1170;3795;1804;6267
311330;201602;4526;13572;3918;12543;1042;3709;1598;5120;2640;8829
311340;201602;11583;36501;10137;33775;3009;10741;2635;8677;5644;19418
311350;201602;2252;6361;1751;5432;287;1040;769;2177;1056;3217
311360;201602;1092;3024;844;2708;345;1141;127;437;472;1578
311370;201602;3627;10913;3050;9903;641;2461;1231;3696;1872;6157
311380;201602;396;1311;346;1221;96;365;109;379;205;744
311390;201602;1716;6270;1576;6072;666;2933;442;1589;1108;4522
311400;201602;1380;4376;1151;3943;208;843;463;1441;671;2284
311410;201602;1746;5930;1567;5700;424;1718;748;2775;1172;4493
311420;201602;1838;5923;1269;4535;234;916;155;419;389;1335
311430;201602;3756;11262;2616;8790;471;1716;263;876;734;2592
311440;201602;2348;7467;1746;6387;532;2261;261;941;793;3202
311450;201602;1901;6549;1601;5897;431;1764;304;1032;735;2796
311455;201602;1115;2976;883;2599;217;681;379;1041;596;1722
311460;201602;615;1995;467;1692;100;428;108;358;208;786
311470;201602;482;1595;386;1392;101;435;86;259;187;694
311480;201602;765;2020;712;1948;171;446;426;1167;597;1613
311490;201602;221;812;200;753;62;254;65;225;127;479
311500;201602;416;1210;330;1050;79;298;126;390;205;688
311510;201602;2876;8841;2348;7892;693;2750;496;1591;1189;4341
311520;201602;601;1970;558;1882;173;635;212;684;385;1319
311530;201602;11401;29267;8194;24128;1823;6428;2188;6204;4011;12632
311535;201602;785;2278;515;1748;117;461;72;225;189;686
311540;201602;602;2091;561;2025;208;738;222;801;430;1539
311545;201602;2047;6251;1824;5979;183;686;1290;4178;1473;4864
311547;201602;1468;4137;1229;3764;90;303;818;2500;908;2803
311550;201602;2836;9012;2386;8128;414;1613;825;2748;1239;4361
311560;201602;255;663;216;620;26;76;120;326;146;402
311570;201602;2011;5080;1580;4500;117;375;1161;3386;1278;3761
311580;201602;2298;4671;1735;4022;474;1009;898;2246;1372;3255
311590;201602;438;1330;372;1224;92;344;141;461;233;805
311600;201602;1175;3589;1002;3364;180;595;613;2114;793;2709
311610;201602;2881;10149;2592;9667;851;3105;997;4004;1848;7109
311615;201602;3011;9331;2518;8554;251;1002;1734;5887;1985;6889
311620;201602;398;1247;356;1170;67;246;198;647;265;893
311630;201602;1351;3935;1121;3552;242;738;625;1989;867;2727
311640;201602;762;2436;632;2224;126;488;308;1067;434;1555
311650;201602;2215;6357;1878;5830;272;921;1001;3120;1273;4041
311660;201602;2286;7581;1789;6440;326;1235;156;473;482;1708
311670;201602;1618;4695;1317;4187;426;1471;381;1205;807;2676
311680;201602;2025;6364;1713;5847;380;1357;891;3063;1271;4420
311690;201602;477;1256;410;1175;32;97;328;958;360;1055
311700;201602;2135;5788;1760;5280;138;453;1315;3892;1453;4345
311710;201602;1625;4929;1205;4141;421;1616;284;931;705;2547
311720;201602;388;1287;348;1208;68;250;153;528;221;778
311730;201602;5679;14213;3291;10128;892;3169;635;1558;1527;4727
311740;201602;772;2330;732;2278;231;700;422;1349;653;2049
311750;201602;3888;12671;3388;11899;616;2470;1764;6100;2380;8570
311760;201602;693;2302;614;2125;141;562;178;529;319;1091
311770;201602;2171;6885;1790;6178;408;1559;521;1731;929;3290
311780;201602;1093;3857;928;3499;261;1148;212;725;473;1873
311783;201602;1908;6298;1612;5723;97;494;1185;4146;1282;4640
311787;201602;578;1979;427;1536;79;307;98;292;177;599
311790;201602;1481;4342;1100;3631;227;848;354;1121;581;1969
311800;201602;4399;14735;3794;13251;786;2962;249;708;1035;3670
311810;201602;1049;3408;921;3168;68;316;583;1980;651;2296
311820;201602;589;1835;481;1592;123;444;223;691;346;1135
311830;201602;8026;26693;6640;23405;2025;7795;693;2229;2718;10024
311840;201602;2900;8742;2596;8296;690;2454;1188;3735;1878;6189
311850;201602;267;815;236;767;55;200;108;331;163;531
311860;201602;46368;136748;39649;125057;8096;28000;18537;56736;26633;84736
311870;201602;2070;6052;1539;5048;313;1171;454;1380;767;2551
311880;201602;6672;19135;5911;18190;737;2104;4155;13350;4892;15454
311890;201602;1429;4225;1152;3720;276;975;466;1480;742;2455
311900;201602;730;2202;638;2068;80;290;376;1241;456;1531
311910;201602;4173;12273;3424;11162;801;2826;1423;4655;2224;7481
311920;201602;1853;6104;1628;5688;206;792;969;3378;1175;4170
311930;201602;3419;9716;2893;8909;1106;3555;735;2250;1841;5805
311940;201602;12053;36002;9774;31471;2368;8300;2000;6032;4368;14332
311950;201602;2155;6354;1799;5842;149;543;1255;4054;1404;4597
311960;201602;371;1166;331;1083;72;273;126;346;198;619
311970;201602;338;1177;285;1060;52;226;69;245;121;471
311980;201602;600;1673;405;1321;61;208;141;478;202;686
311990;201602;404;1185;336;1079;119;417;111;334;230;751
311995;201602;1157;3523;723;2492;46;167;67;177;113;344
312000;201602;585;1772;524;1679;63;220;325;1061;388;1281
312010;201602;870;2822;738;2543;128;480;283;956;411;1436
312015;201602;1338;4313;1201;4063;132;537;775;2591;907;3128
312020;201602;1001;3136;878;2938;167;601;414;1398;581;1999
312030;201602;1721;5093;1545;4874;102;382;1290;4041;1392;4423
312040;201602;712;2610;608;2343;152;659;127;470;279;1129
312050;201602;1228;4295;1048;3871;243;1007;146;464;389;1471
312060;201602;737;2235;641;2094;231;804;234;725;465;1529
312070;201602;992;3046;665;2345;146;558;223;789;369;1347
312080;201602;2556;7111;2047;6329;286;1057;1093;3172;1379;4229
312083;201602;868;2497;755;2328;95;324;529;1609;624;1933
312087;201602;2080;6428;1871;6128;223;803;1321;4384;1544;5187
312090;201602;8671;26726;7395;24567;2177;7618;2573;8429;4750;16047
312100;201602;1324;4472;1115;4148;249;1061;473;1730;722;2791
312110;201602;1021;3559;895;3291;273;1155;150;474;423;1629
312120;201602;705;2281;594;2058;128;535;200;599;328;1134
312125;201602;1079;3480;960;3260;222;744;487;1745;709;2489
312130;201602;837;2375;652;2023;95;337;230;673;325;1010
312140;201602;794;2540;695;2313;145;527;194;566;339;1093
312150;201602;494;1437;434;1310;21;78;284;817;305;895
312160;201602;7147;24126;6358;22512;1654;6436;2261;7855;3915;14291
312170;201602;903;2607;767;2380;70;240;474;1454;544;1694
312180;201602;1328;4077;1156;3746;259;907;433;1322;692;2229
312190;201602;565;1827;436;1575;139;560;73;266;212;826
312200;201602;4624;13331;3894;12184;671;2071;2170;6862;2841;8933
312210;201602;1025;2759;789;2418;213;725;318;909;531;1634
312220;201602;1872;6261;1726;6099;183;576;1413;5236;1596;5812
312230;201602;11986;36658;9384;31787;2988;11234;1209;3970;4197;15204
312235;201602;1507;4547;1328;4280;157;609;917;2916;1074;3525
312240;201602;896;2993;721;2625;172;673;187;675;359;1348
312245;201602;2111;6353;1901;6073;101;362;1547;4938;1648;5300
312247;201602;780;2341;606;2040;165;601;248;854;413;1455
312250;201602;1152;3177;878;2713;157;548;342;999;499;1547
312260;201602;876;2776;730;2531;133;535;433;1454;566;1989
312270;201602;639;1923;539;1736;70;298;247;721;317;1019
312280;201602;396;1327;353;1234;120;449;42;140;162;589
312290;201602;739;2420;678;2333;179;722;217;728;396;1450
312300;201602;854;2833;678;2421;157;612;61;167;218;779
312310;201602;839;3132;786;3023;227;965;287;1078;514;2043
312320;201602;1857;5351;1415;4485;320;1085;183;469;503;1554
312330;201602;956;2810;803;2594;133;516;558;1781;691;2297
312340;201602;303;812;262;747;36;139;176;452;212;591
312350;201602;282;724;251;689;26;87;203;536;229;623
312352;201602;1573;4976;1415;4744;301;1062;891;3063;1192;4125
312360;201602;2958;9422;2472;8458;508;1922;734;2507;1242;4429
312370;201602;1645;5196;1497;4960;491;1832;490;1523;981;3355
312380;201602;1825;5111;1616;4828;69;198;1353;4155;1422;4353
312385;201602;1279;3786;1101;3502;102;412;764;2358;866;2770
312390;201602;2100;6757;1714;6016;443;1671;282;899;725;2570
312400;201602;3082;9832;2585;8860;947;3345;642;2309;1589;5654
312410;201602;9229;30285;8237;28423;1842;6902;3359;11413;5201;18315
312420;201602;3760;11539;3560;11287;545;1722;2435;7880;2980;9602
312430;201602;7740;23027;6668;21112;1102;3543;3998;12801;5100;16344
312440;201602;725;2257;617;2070;174;653;272;948;446;1601
312450;201602;1070;3529;827;3029;262;999;229;880;491;1879
312460;201602;343;1032;305;988;81;300;145;465;226;765
312470;201602;643;1755;418;1321;77;273;126;385;203;658
312480;201602;1175;3084;890;2772;203;700;463;1369;666;2069
312490;201602;1938;5107;1523;4501;214;714;849;2414;1063;3128
312500;201602;648;1954;568;1834;101;378;198;616;299;994
312510;201602;3256;9433;2623;8154;405;1450;1224;3544;1629;4994
312520;201602;248;843;200;759;53;216;57;228;110;444
312530;201602;580;1720;518;1636;70;281;327;999;397;1280
312540;201602;1419;4451;1102;3839;218;818;513;1793;731;2611
312550;201602;665;2039;577;1849;113;374;262;793;375;1167
312560;201602;1980;5271;1637;4834;91;334;1319;3848;1410;4182
312570;201602;2322;6876;1945;6243;552;1910;562;1769;1114;3679
312580;201602;510;1685;430;1511;72;309;151;501;223;810
312590;201602;1627;5425;1418;4996;249;1086;605;1968;854;3054
312595;201602;1883;6312;1687;5860;345;1255;882;3065;1227;4320
312600;201602;759;2477;588;2140;93;432;266;900;359;1332
312610;201602;6824;19067;5019;15839;1099;3885;1049;3124;2148;7009
312620;201602;2142;6199;1655;5536;157;595;1191;4131;1348;4726
312630;201602;335;1088;290;1007;79;314;104;335;183;649
312640;201602;530;1718;433;1517;87;324;123;404;210;728
312650;201602;2087;6159;1565;5122;144;532;903;2962;1047;3494
312660;201602;1377;3637;1113;3256;109;371;740;2134;849;2505
312670;201602;5489;16347;4677;15244;1276;4576;1613;5132;2889;9708
312675;201602;1212;3931;1031;3537;130;514;617;2102;747;2616
312680;201602;1441;4345;1225;4057;194;760;719;2295;913;3055
312690;201602;2085;5573;1703;5038;252;814;1049;3001;1301;3815
312695;201602;788;2819;758;2777;157;555;482;1861;639;2416
312700;201602;1811;5464;1443;4739;192;716;702;2263;894;2979
312705;201602;1225;3519;1039;3191;82;279;735;2224;817;2503
312707;201602;1531;4872;1210;4252;167;694;602;2044;769;2738
312710;201602;6634;16775;4360;13139;1148;3908;747;2175;1895;6083
312720;201602;732;2509;637;2314;146;588;227;787;373;1375
312730;201602;1845;4383;1267;3696;152;492;717;2101;869;2593
312733;201602;1625;4318;1241;3634;60;206;763;2160;823;2366
312735;201602;799;2202;694;2063;154;514;391;1104;545;1618
312737;201602;808;2046;590;1745;185;547;199;621;384;1168
312738;201602;494;1495;366;1242;86;331;112;341;198;672
312740;201602;367;937;226;775;70;272;51;165;121;437
312750;201602;1216;4325;1158;4223;236;1036;545;1903;781;2939
312760;201602;1930;6198;1514;5356;361;1400;318;1109;679;2509
312770;201602;39410;108111;30721;93830;7783;25725;7976;23710;15759;49435
312780;201602;2566;8953;2291;8493;409;1678;1173;4459;1582;6137
312790;201602;308;779;182;564;34;130;46;104;80;234
312800;201602;4831;15685;3952;13947;1185;4533;929;3287;2114;7820
312810;201602;2027;6196;1417;4995;320;1215;230;756;550;1971
312820;201602;1819;5247;1614;4916;90;324;1117;3324;1207;3648
312825;201602;1302;3586;1135;3368;100;336;858;2539;958;2875
312830;201602;2507;7693;1778;6252;424;1635;263;920;687;2555
312840;201602;1190;3852;1007;3502;152;642;380;1229;532;1871
312850;201602;659;2062;525;1807;88;360;162;557;250;917
312860;201602;1084;3178;839;2742;223;806;215;631;438;1437
312870;201602;5481;16914;3903;13613;736;2844;745;2483;1481;5327
312880;201602;1227;3688;1084;3472;132;465;667;2197;799;2662
312890;201602;1570;4764;1036;3555;251;946;319;1106;570;2052
312900;201602;1178;3457;1039;3265;131;433;728;2350;859;2783
312910;201602;1562;3142;955;2362;149;421;458;1042;607;1463
312920;201602;831;2647;689;2389;189;758;249;795;438;1553
312930;201602;2092;6041;1825;5650;398;1279;864;2742;1262;4021
312940;201602;875;2848;764;2667;195;768;207;676;402;1444
312950;201602;3035;8514;2357;7505;781;2688;545;1737;1326;4425
312960;201602;1892;5473;1647;5166;211;616;1244;4041;1455;4657
312965;201602;1757;5585;1503;5133;190;769;899;3065;1089;3834
312970;201602;956;3200;797;2922;217;907;161;570;378;1477
312980;201602;16132;53994;15205;52150;4710;17655;5497;18288;10207;35943
312990;201602;450;1340;329;1134;98;383;97;339;195;722
313000;201602;494;1628;403;1451;98;458;155;479;253;937
313005;201602;2521;8128;2245;7612;514;1696;1126;3942;1640;5638
313010;201602;3436;10971;2893;10045;761;2850;1189;4088;1950;6938
313020;201602;930;3027;735;2545;142;570;136;388;278;958
313030;201602;1460;3892;1072;3351;227;877;440;1292;667;2169
313040;201602;794;2614;689;2370;105;434;272;854;377;1288
313050;201602;1758;5425;1320;4752;289;1173;324;1054;613;2227
313055;201602;1546;4887;1406;4693;82;295;1133;3815;1215;4110
313060;201602;716;2308;573;1976;154;547;69;217;223;764
313065;201602;1895;6137;1625;5712;318;1243;1046;3674;1364;4917
313070;201602;1021;2980;840;2668;185;674;346;1045;531;1719
313080;201602;432;1363;330;1155;72;296;100;314;172;610
313090;201602;5135;14762;4435;13649;1044;3397;2184;6780;3228;10177
313100;201602;1066;3281;960;3109;93;295;726;2399;819;2694
313110;201602;1686;4797;1270;4006;201;707;530;1578;731;2285
313115;201602;2367;7987;2238;7722;510;2006;973;3120;1483;5126
313120;201602;3397;8986;2902;8340;697;2267;1543;4307;2240;6574
313130;201602;24413;73699;21246;67379;4672;16383;7989;23868;12661;40251
313140;201602;567;1460;436;1268;27;95;311;886;338;981
313150;201602;1281;4039;1087;3700;473;1714;203;694;676;2408
313160;201602;918;2799;797;2557;121;448;453;1413;574;1861
313170;201602;7627;25733;6246;22598;1469;5703;1196;4229;2665;9932
313180;201602;2319;6373;1877;5756;478;1632;662;1963;1140;3595
313190;201602;3161;10778;2538;9222;536;2115;572;1953;1108;4068
313200;201602;1124;3670;980;3396;119;451;666;2274;785;2725
313210;201602;4086;12749;3422;11733;790;2883;1437;4803;2227;7686
313220;201602;1409;4224;1044;3439;235;859;218;607;453;1466
313230;201602;2231;7932;2067;7709;293;1191;1432;5339;1725;6530
313240;201602;7607;23140;6039;20355;1199;4627;2151;6911;3350;11538
313250;201602;6768;21247;5920;19825;810;2817;3340;11302;4150;14119
313260;201602;599;1771;430;1419;65;237;97;323;162;560
313270;201602;5243;15681;4382;14236;842;2950;2204;7095;3046;10045
313280;201602;372;1226;273;1011;51;212;56;187;107;399
313290;201602;803;2794;662;2548;230;978;84;299;314;1277
313300;201602;1771;5855;1467;5142;396;1513;187;562;583;2075
313310;201602;1023;3531;916;3307;206;863;161;521;367;1384
313320;201602;2257;6465;1697;5574;320;1171;684;2244;1004;3415
313330;201602;3888;12025;3244;10916;376;1514;1860;6097;2236;7611
313340;201602;1861;4572;1471;4005;279;763;761;2081;1040;2844
313350;201602;2861;8872;2295;7656;455;1687;437;1330;892;3017
313360;201602;1178;3370;900;2924;228;903;445;1348;673;2251
313370;201602;1114;3775;1047;3600;161;662;528;1685;689;2347
313375;201602;2254;5848;1557;4829;280;1082;479;1410;759;2492
313380;201602;4752;14745;4004;13253;994;3601;1217;3788;2211;7389
313390;201602;856;2940;815;2886;97;387;546;1920;643;2307
313400;201602;3601;9832;3168;9334;287;782;2650;8019;2937;8801
313410;201602;1169;3325;985;3047;231;796;520;1561;751;2357
313420;201602;18553;44072;11570;32540;2094;6653;1847;5193;3941;11846
313430;201602;1023;3178;781;2675;147;602;283;889;430;1491
313440;201602;5956;13484;4094;11327;256;707;2629;7411;2885;8118
313450;201602;603;1792;491;1577;98;367;150;442;248;809
313460;201602;2059;7035;1773;6564;463;1969;536;1812;999;3781
313470;201602;3029;8425;2705;7974;396;1213;1774;5169;2170;6382
313480;201602;1033;2940;802;2575;109;411;295;884;404;1295
313490;201602;1442;4227;851;3276;250;1068;98;366;348;1434
313500;201602;379;1230;319;1084;58;222;100;330;158;552
313505;201602;8879;26005;8183;25218;358;823;7434;23434;7792;24257
313507;201602;1333;3706;1165;3461;114;374;770;2311;884;2685
313510;201602;15108;43222;13199;40445;1965;6254;7317;22612;9282;28866
313520;201602;13967;43129;11789;39224;1361;5125;7354;24316;8715;29441
313530;201602;594;1813;493;1634;45;177;167;527;212;704
313535;201602;2391;7177;2164;6764;180;623;1572;4850;1752;5473
313540;201602;1051;3279;781;2594;197;714;167;516;364;1230
313545;201602;1249;4592;1124;4342;151;731;651;2363;802;3094
313550;201602;1769;5677;1557;5261;397;1395;654;2162;1051;3557
313560;201602;2115;5005;1754;4600;288;708;1191;3255;1479;3963
313570;201602;851;2970;731;2738;232;930;210;782;442;1712
313580;201602;5670;16226;4553;14628;757;2585;2559;8379;3316;10964
313590;201602;956;2711;751;2430;365;1302;150;458;515;1760
313600;201602;3727;11207;3228;10437;389;1391;2169;7048;2558;8439
313610;201602;950;2866;813;2607;165;594;396;1233;561;1827
313620;201602;5226;16065;4520;14828;1211;4255;1486;4899;2697;9154
313630;201602;7825;21919;5916;19170;1057;3906;2532;8678;3589;12584
313640;201602;748;2170;560;1881;166;621;166;541;332;1162
313650;201602;1896;6234;1671;5861;266;1074;1070;3670;1336;4744
313652;201602;915;3238;840;3098;137;579;504;1808;641;2387
313655;201602;908;2923;764;2680;106;441;457;1567;563;2008
313657;201602;1291;3863;1072;3533;110;505;776;2390;886;2895
313660;201602;800;2630;708;2467;152;615;317;1047;469;1662
313665;201602;3458;11142;2997;10182;623;2380;1325;4343;1948;6723
313670;201602;43377;126932;32403;105863;7505;26994;9546;30453;17051;57447
313680;201602;1020;3050;908;2870;139;533;527;1604;666;2137
313690;201602;809;2914;708;2677;176;688;238;911;414;1599
313695;201602;1314;4283;1131;3950;102;412;785;2758;887;3170
313700;201602;3367;11620;2984;11134;459;1773;2102;8033;2561;9806
313710;201602;1220;3304;944;2889;176;595;483;1430;659;2025
313720;201602;5039;16054;4036;13898;772;2927;1247;3998;2019;6925
313730;201602;1236;3343;939;2974;157;563;513;1624;670;2187
313740;201602;2003;7203;1706;6502;483;2071;127;421;610;2492
313750;201602;2134;6436;1796;5796;460;1580;543;1632;1003;3212
313753;201602;1755;5103;1397;4505;313;1122;574;1830;887;2952
313760;201602;4216;13648;3515;12248;966;3674;896;2923;1862;6597
313770;201602;3174;10258;2804;9704;842;3161;1200;4111;2042;7272
313780;201602;3730;10297;2941;9139;418;1573;1205;3772;1623;5345
313790;201602;476;1651;449;1604;97;345;244;909;341;1254
313800;201602;1208;3269;1042;3023;105;349;695;2039;800;2388
313810;201602;1473;4266;1376;4132;66;179;1184;3669;1250;3848
313820;201602;12433;33066;10296;29830;1753;5926;4586;12726;6339;18652
313830;201602;408;1350;346;1226;90;363;121;431;211;794
313835;201602;862;2908;799;2809;150;617;433;1457;583;2074
313840;201602;7357;21110;5818;18532;1410;4958;1372;4315;2782;9273
313850;201602;1158;3142;1009;2879;191;651;500;1302;691;1953
313860;201602;2643;7994;2029;6685;461;1648;458;1432;919;3080
313862;201602;1183;2971;830;2403;112;314;414;1286;526;1600
313865;201602;2177;6754;1963;6436;211;817;1427;4626;1638;5443
313867;201602;1080;3711;940;3402;274;1074;252;946;526;2020
313868;201602;1585;5380;1367;4937;131;595;910;3213;1041;3808
313870;201602;769;2410;702;2300;207;775;193;554;400;1329
313880;201602;1363;4202;1178;3913;235;890;574;1760;809;2650
313890;201602;1823;4975;1522;4578;333;944;918;2942;1251;3886
313900;201602;3869;13912;3454;12991;1016;4275;906;3329;1922;7604
313910;201602;722;2428;609;2206;214;830;62;214;276;1044
313920;201602;3253;10800;2819;9995;476;1774;1547;5667;2023;7441
313925;201602;1841;4987;1394;4168;76;259;833;2493;909;2752
313930;201602;5217;16832;4287;15158;772;2916;2201;7890;2973;10806
313940;201602;8283;27325;6899;25154;1933;7857;2170;8367;4103;16224
313950;201602;3995;11368;3113;9963;960;3528;943;2730;1903;6258
313960;201602;5319;13665;3867;11648;1048;3434;960;2731;2008;6165
313970;201602;1400;4019;1223;3819;142;494;732;2396;874;2890
313980;201602;1192;3701;925;3246;247;986;386;1352;633;2338
313990;201602;1726;6380;1482;5816;475;2062;275;948;750;3010
314000;201602;7660;24490;6936;23110;1229;4895;3877;12327;5106;17222
314010;201602;1108;3092;920;2852;92;328;579;1740;671;2068
314015;201602;1146;3967;970;3645;243;1018;357;1295;600;2313
314020;201602;501;1511;359;1218;84;321;71;216;155;537
314030;201602;803;2594;648;2258;92;349;229;786;321;1135
314040;201602;667;1900;561;1711;248;801;111;318;359;1119
314050;201602;1648;5116;1313;4455;290;1161;437;1349;727;2510
314053;201602;1526;4800;1347;4566;194;658;866;3102;1060;3760
314055;201602;2103;6306;1838;5915;75;316;1433;4642;1508;4958
314060;201602;1133;3487;897;3088;61;285;570;1912;631;2197
314070;201602;3993;12349;3151;10733;772;2825;680;2198;1452;5023
314080;201602;1905;5859;1344;4596;219;853;270;800;489;1653
314085;201602;1942;6482;1711;6157;435;1735;629;2256;1064;3991
314090;201602;3234;11107;2858;10370;683;2787;950;3540;1633;6327
314100;201602;3200;8206;2827;7716;181;392;2388;6774;2569;7166
314110;201602;3834;12209;3379;11288;609;2369;1387;4235;1996;6604
314120;201602;1009;2423;510;1626;106;371;124;390;230;761
314130;201602;719;2051;377;1272;47;175;71;221;118;396
314140;201602;4810;14937;4015;13388;901;3277;1686;5567;2587;8844
314150;201602;1551;4241;1248;3721;189;619;619;1810;808;2429
314160;201602;2509;6450;1971;5739;196;619;1177;3629;1373;4248
314170;201602;1049;3129;873;2766;112;385;458;1405;570;1790
314180;201602;5177;16567;4601;15637;1248;4564;1867;6478;3115;11042
314190;201602;702;2005;548;1768;116;467;211;604;327;1071
314200;201602;2892;9006;2525;8348;283;1100;1698;5498;1981;6598
314210;201602;1915;5598;1704;5247;224;821;1026;3023;1250;3844
314220;201602;1576;4890;1214;4205;368;1391;219;667;587;2058
314225;201602;1298;3787;1194;3654;92;293;979;3053;1071;3346
314230;201602;645;2103;595;2018;122;471;286;952;408;1423
314240;201602;1102;3332;925;3071;141;485;516;1812;657;2297
314250;201602;550;1633;426;1381;93;331;122;349;215;680
314260;201602;1001;3557;895;3321;224;912;267;948;491;1860
314270;201602;2831;9196;2377;8397;230;914;1551;5534;1781;6448
314280;201602;3034;8405;2084;6589;473;1749;634;1763;1107;3512
314290;201602;4661;12904;4025;11874;1051;3202;2026;5915;3077;9117
314300;201602;1472;4929;1270;4477;354;1299;365;1261;719;2560
314310;201602;5201;15449;4452;14116;1178;4037;1554;4754;2732;8791
314315;201602;802;3128;735;2995;73;369;499;2002;572;2371
314320;201602;2915;8100;2081;6956;545;1991;970;3342;1515;5333
314330;201602;52798;158809;45567;147387;12479;43421;14805;47361;27284;90782
314340;201602;2854;7714;1678;5481;338;1230;119;263;457;1493
314345;201602;1174;4006;1059;3819;244;918;608;2204;852;3122
314350;201602;1274;3698;994;3253;304;1074;192;608;496;1682
314360;201602;660;2119;450;1625;98;404;86;320;184;724
314370;201602;537;1822;498;1768;124;484;308;1083;432;1567
314380;201602;1261;3762;882;3025;230;866;114;391;344;1257
314390;201602;13464;38918;10208;32972;2402;8388;2313;6962;4715;15350
314400;201602;4327;12813;3716;11954;1309;4414;1143;3841;2452;8255
314410;201602;2547;7920;2088;7042;615;2333;589;1912;1204;4245
314420;201602;735;2091;572;1856;30;158;382;1166;412;1324
314430;201602;6233;18684;5453;17242;1553;5334;1480;4782;3033;10116
314435;201602;1286;4124;1136;3867;110;484;719;2402;829;2886
314437;201602;1066;2780;881;2502;33;98;691;1966;724;2064
314440;201602;632;1842;493;1649;164;620;87;246;251;866
314450;201602;1558;4576;1314;4233;323;1196;560;1681;883;2877
314460;201602;4017;13453;3260;11849;756;3056;562;1972;1318;5028
314465;201602;2204;6943;2062;6696;116;529;1593;5032;1709;5561
314467;201602;971;2778;822;2524;61;180;586;1834;647;2014
314470;201602;2206;6865;1853;6170;336;1377;678;2027;1014;3404
314480;201602;5732;18982;4143;14872;587;2286;433;1379;1020;3665
314490;201602;885;2625;691;2239;168;590;291;897;459;1487
314500;201602;1937;5520;1448;4676;333;1128;480;1485;813;2613
314505;201602;1702;5045;1568;4862;238;817;1022;3196;1260;4013
314510;201602;1824;4911;1234;4095;382;1400;275;921;657;2321
314520;201602;2854;10298;2209;8777;453;2041;225;797;678;2838
314530;201602;5808;20636;5530;20160;1040;3670;3272;12433;4312;16103
314535;201602;2699;7546;2280;6961;204;714;1721;5236;1925;5950
314537;201602;1115;3528;893;3128;124;525;516;1764;640;2289
314540;201602;404;1208;337;1075;71;268;95;267;166;535
314545;201602;1355;4153;1168;3887;128;499;841;2819;969;3318
314550;201602;611;1664;455;1441;85;357;170;472;255;829
314560;201602;4305;14761;3657;13247;666;2719;1071;3688;1737;6407
314570;201602;295;868;228;742;60;205;95;299;155;504
314580;201602;506;1682;405;1475;95;411;54;178;149;589
314585;201602;817;2652;595;2175;131;555;131;459;262;1014
314587;201602;1905;5825;1639;5371;349;1091;772;2615;1121;3706
314590;201602;3086;10465;2307;8464;413;1725;249;826;662;2551
314600;201602;1713;5624;1285;4738;306;1239;160;532;466;1771
314610;201602;6707;22725;6037;21212;1300;5108;2470;8185;3770;13293
314620;201602;1549;4653;1396;4433;146;463;1022;3260;1168;3723
314625;201602;1419;4890;1315;4701;195;845;922;3158;1117;4003
314630;201602;4745;14157;4163;13260;289;1142;3046;9638;3335;10780
314640;201602;563;1539;443;1337;110;359;117;294;227;653
314650;201602;1047;2885;756;2418;104;399;256;729;360;1128
314655;201602;1560;4648;1170;3890;293;948;418;1421;711;2369
314660;201602;276;752;202;600;22;70;96;274;118;344
314670;201602;1583;4240;1149;3483;183;617;621;1845;804;2462
314675;201602;1752;5339;1511;4903;174;628;1017;3298;1191;3926
314690;201602;2309;7347;1903;6651;528;2099;428;1425;956;3524
314700;201602;8516;29164;6356;24372;1803;7749;785;2999;2588;10748
314710;201602;8971;27126;6335;21460;1140;4302;804;2520;1944;6822
314720;201602;2327;7648;1948;6833;484;1899;575;2013;1059;3912
314730;201602;2133;6415;1767;5873;480;1779;626;1996;1106;3775
314740;201602;2823;9010;2442;8279;422;1641;1116;3624;1538;5265
314750;201602;345;1078;276;919;42;172;125;388;167;560
314760;201602;1712;5686;1297;4690;206;871;254;792;460;1663
314770;201602;1105;3423;655;2215;73;289;98;246;171;535
314780;201602;257;701;193;613;51;193;82;251;133;444
314790;201602;10902;32380;8353;27956;3307;12411;613;1638;3920;14049
314795;201602;1635;4704;1385;4317;106;433;996;2985;1102;3418
314800;201602;10703;31045;7650;25060;2067;7356;858;2693;2925;10049
314810;201602;11467;33327;8937;28990;2463;8792;1689;5512;4152;14304
314820;201602;899;2489;627;2038;157;559;205;653;362;1212
314830;201602;1607;5322;1414;5004;420;1655;554;1955;974;3610
314840;201602;906;3278;750;3050;126;656;448;1749;574;2405
314850;201602;1865;5402;1493;4743;205;804;943;2883;1148;3687
314860;201602;3154;10518;2812;9899;651;2525;1324;4586;1975;7111
314870;201602;5403;17032;4640;16021;493;2148;3313;11341;3806;13489
314875;201602;1691;5558;1616;5459;276;905;1214;4183;1490;5088
314880;201602;851;2303;705;2115;36;101;522;1656;558;1757
314890;201602;598;1786;416;1396;78;321;142;419;220;740
314900;201602;504;1521;412;1386;96;342;197;648;293;990
314910;201602;1660;5389;1342;4858;401;1649;402;1350;803;2999
314915;201602;2462;7801;2156;7290;177;737;1547;5099;1724;5836
314920;201602;548;1505;388;1267;40;157;204;612;244;769
314930;201602;4362;14634;3835;13539;1015;3822;879;2982;1894;6804
314940;201602;386;1127;355;1077;66;221;190;542;256;763
314950;201602;337;980;251;854;44;164;69;222;113;386
314960;201602;719;2240;560;1914;137;530;154;474;291;1004
314970;201602;543;1859;452;1682;108;451;108;406;216;857
314980;201602;1426;4447;1202;4069;325;1242;86;270;411;1512
314990;201602;2464;7797;1924;6648;508;2032;344;1003;852;3035
314995;201602;1563;4777;1368;4480;147;589;864;2752;1011;3341
315000;201602;1024;2959;842;2666;98;347;521;1657;619;2004
315010;201602;432;1327;341;1151;80;337;107;308;187;645
315015;201602;2040;6240;1833;5999;247;834;1310;4524;1557;5358
315020;201602;802;2492;610;2077;96;389;255;812;351;1201
315030;201602;677;2034;546;1811;143;516;111;347;254;863
315040;201602;861;2661;811;2570;155;509;487;1530;642;2039
315050;201602;1327;3832;1080;3455;228;838;443;1400;671;2238
315053;201602;1019;3029;921;2866;151;591;421;1316;572;1907
315057;201602;1650;5698;1446;5374;275;1030;792;3058;1067;4088
315060;201602;824;2680;601;2184;118;468;86;304;204;772
315070;201602;730;2204;622;2033;175;617;283;884;458;1501
315080;201602;2777;9248;2436;8504;633;2372;973;3359;1606;5731
315090;201602;770;2743;681;2540;158;665;172;620;330;1285
315100;201602;1150;3865;845;3154;197;845;197;681;394;1526
315110;201602;1380;4208;1184;3840;276;971;411;1303;687;2274
315120;201602;14066;32859;9692;27300;1478;4388;4789;14392;6267;18780
315130;201602;1357;4498;1237;4282;334;1293;373;1257;707;2550
315140;201602;2612;8340;2176;7438;475;1896;722;2244;1197;4140
315150;201602;4546;12311;3429;10457;659;2256;1227;3701;1886;5957
315160;201602;1189;3452;966;3012;203;672;385;1175;588;1847
315170;201602;1439;4302;1177;3873;258;924;389;1377;647;2301
315180;201602;16462;46296;9754;32256;1659;6232;1544;4708;3203;10940
315190;201602;1984;5163;1666;4678;441;1266;859;2429;1300;3695
315200;201602;3774;12672;3127;11297;957;3763;614;2184;1571;5947
315210;201602;7595;22385;6115;19377;1197;4259;2098;6333;3295;10592
315213;201602;1055;3388;991;3298;53;199;802;2671;855;2870
315217;201602;2364;8189;2001;7542;233;1074;1145;4259;1378;5333
315220;201602;9701;27924;8159;25482;2322;7169;3304;10954;5626;18123
315230;201602;2884;7608;2596;7274;188;266;2190;6649;2378;6915
315240;201602;3012;9215;2557;8504;668;2427;1218;3940;1886;6367
315250;201602;9743;29735;7533;25555;1813;6816;2062;6985;3875;13801
315260;201602;960;2984;672;2373;142;546;99;300;241;846
315270;201602;708;2286;553;1991;106;433;122;396;228;829
315280;201602;2965;8439;1916;6217;407;1428;299;886;706;2314
315290;201602;1321;3691;957;3101;287;1020;160;507;447;1527
315300;201602;520;1347;348;1133;150;511;124;413;274;924
315310;201602;1227;3930;1035;3597;132;554;643;2135;775;2689
315320;201602;768;2319;611;2121;108;436;280;986;388;1422
315330;201602;709;2560;460;1895;111;509;46;192;157;701
315340;201602;3497;10039;2864;9096;615;2140;1108;3417;1723;5557
315350;201602;1818;5006;1367;4351;274;931;737;2414;1011;3345
315360;201602;1630;5417;1350;4770;244;948;418;1392;662;2340
315370;201602;485;1470;422;1375;86;289;210;712;296;1001
315380;201602;201;686;160;590;37;160;34;101;71;261
315390;201602;1294;4298;969;3533;216;899;162;546;378;1445
315400;201602;4127;12462;3393;11082;688;2483;1484;4758;2172;7241
315410;201602;2012;5327;1698;4890;189;653;1144;3305;1333;3958
315415;201602;959;3161;869;3031;305;1094;383;1400;688;2494
315420;201602;1200;3824;947;3327;220;820;134;444;354;1264
315430;201602;3584;9729;2717;8318;717;2455;580;1689;1297;4144
315440;201602;882;2741;765;2547;149;566;337;1066;486;1632
315445;201602;2055;5771;1628;5113;189;677;1119;3478;1308;4155
315450;201602;2358;7445;2105;7056;450;1406;1200;4213;1650;5619
315460;201602;31920;103872;28394;96738;9247;33633;4783;15683;14030;49316
315470;201602;466;1407;381;1250;47;193;196;617;243;810
315480;201602;1665;5061;1110;3801;191;736;163;563;354;1299
315490;201602;2964;8026;2306;7144;334;1199;897;2651;1231;3850
315500;201602;484;1441;327;1089;45;173;121;350;166;523
315510;201602;1376;3939;1163;3607;99;339;824;2499;923;2838
315520;201602;990;3005;818;2723;103;383;512;1646;615;2029
315530;201602;562;1919;472;1710;171;650;124;426;295;1076
315540;201602;1070;3353;884;3003;171;689;302;1019;473;1708
315550;201602;1665;4675;1298;4149;336;1197;388;1195;724;2392
315560;201602;6361;21287;5762;20453;602;2391;3853;13858;4455;16249
315570;201602;1916;6055;1781;5847;308;1164;939;2987;1247;4151
315580;201602;2438;7145;1916;6218;473;1761;486;1470;959;3231
315590;201602;860;2510;763;2367;134;451;392;1192;526;1643
315600;201602;2424;8604;1960;7713;350;1437;1002;4127;1352;5564
315610;201602;972;2781;788;2414;148;577;287;729;435;1306
315620;201602;311;1092;294;1063;91;311;156;601;247;912
315630;201602;830;2654;700;2393;177;645;163;526;340;1171
315640;201602;474;1360;385;1219;78;297;164;479;242;776
315645;201602;827;2510;682;2210;243;840;149;467;392;1307
315650;201602;1811;5043;1443;4518;85;362;1056;3306;1141;3668
315660;201602;2497;6575;2070;5913;348;1007;1265;3598;1613;4605
315670;201602;10146;33492;9061;31424;2563;9567;3054;10401;5617;19968
315680;201602;2983;9929;2339;8632;775;3017;448;1653;1223;4670
315690;201602;3310;9378;2312;7620;565;2075;394;1371;959;3446
315700;201602;7086;22108;6009;19999;1061;3944;2715;8651;3776;12595
315710;201602;1754;5099;1404;4545;109;455;884;2781;993;3236
315720;201602;3531;11110;3134;10404;452;1774;1682;5317;2134;7091
315725;201602;1421;4533;1277;4312;283;985;769;2657;1052;3642
315727;201602;572;1784;474;1585;98;367;170;540;268;907
315730;201602;776;2411;712;2285;109;398;395;1236;504;1634
315733;201602;959;2892;854;2710;258;896;248;730;506;1626
315737;201602;1232;3773;966;3301;70;310;607;2116;677;2426
315740;201602;977;3008;817;2694;155;619;400;1222;555;1841
315750;201602;1087;3388;994;3220;64;256;717;2306;781;2562
315760;201602;999;2694;960;2645;19;69;881;2400;900;2469
315765;201602;1404;4378;1254;4181;68;258;1016;3444;1084;3702
315770;201602;1364;4416;1182;4098;310;1184;283;989;593;2173
315780;201602;21003;68614;19002;64342;4716;17122;5490;18432;10206;35554
315790;201602;3505;11675;3075;10819;301;1014;2049;7435;2350;8449
315800;201602;1434;5525;1147;4700;257;1150;177;699;434;1849
315810;201602;1329;3588;1122;3273;135;381;763;2208;898;2589
315820;201602;2421;8191;2118;7662;693;2600;805;3029;1498;5629
315830;201602;1148;3871;983;3523;124;546;276;883;400;1429
315840;201602;833;2192;599;1788;93;308;175;482;268;790
315850;201602;969;3478;944;3431;229;897;491;1733;720;2630
315860;201602;510;1752;387;1494;93;432;64;219;157;651
315870;201602;447;1321;365;1191;98;352;141;432;239;784
315880;201602;1190;3057;942;2748;213;762;307;820;520;1582
315890;201602;1439;4903;1283;4646;466;1810;492;1760;958;3570
315895;201602;5061;15780;4403;14344;971;3487;1503;4621;2474;8108
315900;201602;715;2147;685;2095;73;298;528;1515;601;1813
315910;201602;494;1665;459;1606;148;584;251;834;399;1418
315920;201602;1550;4268;912;2934;193;682;154;419;347;1101
315930;201602;1042;2845;786;2399;197;668;194;575;391;1243
315935;201602;921;3048;827;2849;233;879;202;673;435;1552
315940;201602;610;1940;528;1773;124;486;234;745;358;1231
315950;201602;1154;3553;1037;3335;222;669;615;2046;837;2715
315960;201602;3389;10687;2342;8579;825;3493;99;231;924;3724
315970;201602;723;1962;554;1736;40;108;391;1296;431;1404
315980;201602;3908;9514;2411;7049;598;1993;542;1334;1140;3327
315990;201602;3882;11241;3234;10197;535;2037;1618;4958;2153;6995
316000;201602;546;1637;464;1524;140;563;170;527;310;1090
316010;201602;597;1969;480;1742;70;298;194;636;264;934
316020;201602;1017;3245;888;3042;120;472;572;1915;692;2387
316030;201602;3090;9089;2297;7660;204;786;1357;4629;1561;5415
316040;201602;3424;10801;2604;9109;384;1548;451;1333;835;2881
316045;201602;2013;6292;1850;6024;256;815;1258;4255;1514;5070
316050;201602;345;1091;276;985;49;203;127;418;176;621
316060;201602;716;2156;571;1949;80;355;326;1038;406;1393
316070;201602;5960;18718;5157;16959;1154;4257;1995;6231;3149;10488
316080;201602;714;2609;636;2420;143;625;72;276;215;901
316090;201602;568;1688;381;1291;75;283;84;267;159;550
316095;201602;1408;4475;1214;4133;193;672;738;2516;931;3188
316100;201602;2718;8969;2064;7347;484;1949;382;1246;866;3195
316105;201602;921;2630;697;2259;177;599;255;856;432;1455
316110;201602;11963;40834;10647;38614;1286;5056;6929;25839;8215;30895
316120;201602;1093;3544;891;3052;208;751;210;617;418;1368
316130;201602;1440;3241;893;2494;139;454;389;1032;528;1486
316140;201602;899;2642;716;2361;100;333;394;1335;494;1668
316150;201602;1460;4021;1274;3701;208;699;715;2058;923;2757
316160;201602;1225;3631;948;3115;162;609;408;1329;570;1938
316165;201602;899;2429;755;2223;147;496;393;1154;540;1650
316170;201602;1327;3839;997;3280;158;594;401;1202;559;1796
316180;201602;1334;4185;947;3332;190;764;159;478;349;1242
316190;201602;2748;8537;1461;5174;256;920;204;624;460;1544
316200;201602;3747;11914;2915;10269;640;2580;740;2571;1380;5151
316210;201602;4536;14529;3860;13247;1486;5401;505;1759;1991;7160
316220;201602;787;2428;565;1996;112;451;70;260;182;711
316225;201602;1157;3219;985;2951;132;433;606;1766;738;2199
316230;201602;404;1146;329;1017;52;180;153;509;205;689
316240;201602;6473;19852;5658;18772;630;2100;4081;13717;4711;15817
316245;201602;3170;10919;2935;10537;209;1042;2277;7940;2486;8982
316250;201602;10424;30066;8163;25712;2077;7138;1991;5978;4068;13116
316255;201602;2468;7516;2168;7156;398;1417;1369;4545;1767;5962
316257;201602;1321;3658;994;3070;171;606;355;1034;526;1640
316260;201602;1749;4961;1385;4418;87;321;783;2668;870;2989
316265;201602;1320;3711;978;3053;108;411;550;1665;658;2076
316270;201602;3926;13121;3611;12495;929;3472;1403;4736;2332;8208
316280;201602;3136;10185;2851;9651;445;1686;1569;5221;2014;6907
316290;201602;3236;10126;2746;9202;530;2093;1083;3469;1613;5562
316292;201602;3222;10267;2866;9692;573;2159;1546;5017;2119;7176
316294;201602;830;2649;615;2200;114;484;43;153;157;637
316295;201602;1717;5712;1604;5498;213;907;1015;3343;1228;4250
316300;201602;980;3037;834;2809;67;249;532;1824;599;2073
316310;201602;693;1994;469;1592;87;349;125;398;212;747
316320;201602;604;1912;484;1699;81;344;91;293;172;637
316330;201602;897;2791;704;2349;79;301;433;1413;512;1714
316340;201602;920;2970;753;2623;168;707;321;1042;489;1749
316350;201602;1286;4101;1152;3884;191;665;651;2257;842;2922
316360;201602;720;1912;569;1691;67;204;396;1196;463;1400
316370;201602;4324;14007;3752;12873;1031;3874;537;1846;1568;5720
316380;201602;1575;4183;1251;3734;81;274;876;2639;957;2913
316390;201602;873;2542;739;2335;187;643;290;944;477;1587
316400;201602;1222;3836;962;3362;222;827;356;1208;578;2035
316410;201602;1024;3420;950;3309;195;713;575;2022;770;2735
316420;201602;1864;6053;1655;5778;141;613;1161;3934;1302;4547
316430;201602;919;2820;672;2312;156;587;143;445;299;1032
316440;201602;641;2090;531;1925;189;786;98;355;287;1141
316443;201602;662;1962;547;1758;122;446;204;612;326;1058
316447;201602;1540;4654;1405;4476;95;323;1193;3825;1288;4148
316450;201602;2072;6999;1774;6435;219;887;1166;4257;1385;5144
316460;201602;690;2155;623;2039;165;578;310;991;475;1569
316470;201602;7102;22807;5668;19822;1405;5652;1442;4887;2847;10539
316480;201602;181;607;160;563;32;118;45;149;77;267
316490;201602;294;928;244;808;50;175;93;285;143;460
316500;201602;1138;4015;792;2986;141;570;35;125;176;695
316510;201602;750;2774;669;2605;228;952;157;596;385;1548
316520;201602;1052;3187;854;2882;157;590;273;819;430;1409
316530;201602;1009;3280;854;2980;185;799;276;793;461;1592
316540;201602;844;2684;751;2537;111;467;238;748;349;1215
316550;201602;1150;3857;1076;3737;214;858;645;2229;859;3087
316553;201602;1811;6353;1433;5430;385;1641;300;1105;685;2746
316555;201602;2739;9572;2446;9211;175;765;1838;7002;2013;7767
316556;201602;599;1563;475;1367;48;163;308;848;356;1011
316557;201602;755;2712;719;2656;275;1077;168;551;443;1628
316560;201602;306;1081;261;983;56;263;51;171;107;434
316570;201602;1222;3880;1072;3600;134;481;525;1783;659;2264
316580;201602;288;804;193;619;43;161;43;131;86;292
316590;201602;1429;3896;1027;3230;262;874;409;1202;671;2076
316600;201602;1029;3334;913;3110;268;984;308;1022;576;2006
316610;201602;561;2036;491;1895;97;433;293;1102;390;1535
316620;201602;2103;6400;1799;5896;289;1140;1045;3335;1334;4475
316630;201602;1392;4649;1200;4237;478;1773;289;1050;767;2823
316640;201602;173;548;155;513;31;133;66;183;97;316
316650;201602;870;3202;772;3043;111;444;483;1988;594;2432
316660;201602;187;483;91;281;9;38;19;43;28;81
316670;201602;1835;5258;1503;4689;588;1977;264;790;852;2767
316680;201602;1870;5073;1508;4575;190;619;1035;3150;1225;3769
316690;201602;1125;3826;1005;3550;288;1150;295;1015;583;2165
316695;201602;1064;3366;925;3098;132;462;531;1778;663;2240
316700;201602;345;1056;310;1000;45;190;187;545;232;735
316710;201602;2870;10693;2466;9819;878;3670;599;2557;1477;6227
316720;201602;15294;48905;12602;43215;3403;12409;2469;8264;5872;20673
316730;201602;351;1091;303;997;73;273;126;377;199;650
316740;201602;615;2069;555;1965;112;469;277;977;389;1446
316750;201602;384;1294;326;1165;53;230;107;339;160;569
316760;201602;3301;11013;2847;10412;1547;5826;727;2745;2274;8571
316770;201602;1229;3512;1117;3367;101;391;875;2604;976;2995
316780;201602;560;1856;498;1736;139;569;92;276;231;845
316790;201602;844;2417;632;2060;156;550;174;570;330;1120
316800;201602;5070;16707;4496;15600;839;3295;2220;7254;3059;10549
316805;201602;775;2015;748;1978;62;165;633;1736;695;1901
316810;201602;601;1834;503;1642;139;509;186;556;325;1065
316820;201602;384;1000;218;714;36;139;31;97;67;236
316830;201602;557;1911;531;1863;168;639;205;708;373;1347
316840;201602;2770;8501;2437;7880;549;2060;1040;3177;1589;5237
316850;201602;1968;5795;1645;5258;240;865;903;2870;1143;3735
316860;201602;17007;53801;14594;49367;3315;12880;5729;18559;9044;31439
316870;201602;5719;18487;4674;16076;1325;4965;653;2182;1978;7147
316880;201602;831;2543;719;2353;208;805;222;699;430;1504
316890;201602;1202;2971;970;2672;291;936;512;1315;803;2251
316900;201602;2482;7432;1970;6390;434;1580;572;1661;1006;3241
316905;201602;445;1487;385;1352;133;492;118;415;251;907
316910;201602;781;2471;568;2049;153;593;96;366;249;959
316920;201602;1533;4212;1122;3656;321;1193;361;1129;682;2322
316930;201602;8220;27774;6533;24117;1379;5576;748;2531;2127;8107
316935;201602;4866;14257;3266;11075;816;3059;519;1705;1335;4764
316940;201602;6818;22173;5632;19719;1257;4649;1115;3794;2372;8443
316950;201602;1476;4172;1255;3859;120;436;873;2652;993;3088
316960;201602;4667;11814;3677;10462;677;2111;1993;5604;2670;7715
316970;201602;3156;10016;2979;9729;658;2515;1152;3454;1810;5969
316980;201602;928;2842;675;2353;212;819;98;333;310;1152
316990;201602;9531;30380;8114;27155;2421;8812;645;2024;3066;10836
317000;201602;2707;9257;2604;9143;334;1085;1894;7494;2228;8579
317005;201602;2490;7716;2213;7284;435;1447;1232;4115;1667;5562
317010;201602;29784;73912;18518;56491;4322;14910;3373;10896;7695;25806
317020;201602;57815;158875;35338;113613;6899;24468;6564;19514;13463;43982
317030;201602;693;2050;583;1879;66;275;343;1074;409;1349
317040;201602;9974;29003;8027;25636;2014;6933;2833;9051;4847;15984
317043;201602;692;1911;597;1791;80;232;375;1147;455;1379
317047;201602;1113;2954;817;2473;108;362;392;1188;500;1550
317050;201602;1464;5003;1149;4268;225;898;408;1429;633;2327
317052;201602;2267;7348;2081;7059;170;682;1511;5066;1681;5748
317057;201602;1642;4604;1250;3914;117;470;725;2189;842;2659
317060;201602;400;1164;271;885;57;207;72;207;129;414
317065;201602;1241;4021;1125;3837;110;492;819;2733;929;3225
317070;201602;9416;29156;6526;22683;1304;5117;809;2742;2113;7859
317075;201602;1047;3182;830;2717;192;669;167;518;359;1187
317080;201602;5933;16335;5038;14840;1486;4542;1452;4222;2938;8764
317090;201602;4708;15753;4382;15245;579;2024;2987;10620;3566;12644
317100;201602;2872;7926;2166;6744;669;2246;676;2029;1345;4275
317103;201602;1960;6740;1673;6203;263;1237;800;2859;1063;4096
317107;201602;1273;3929;1107;3591;172;675;676;2055;848;2730
317110;201602;631;1590;364;1133;70;268;119;381;189;649
317115;201602;1107;3484;959;3179;114;379;655;2207;769;2586
317120;201602;10211;33832;8323;29418;1909;7490;2796;9669;4705;17159
317130;201602;7177;21466;6044;19422;1271;4556;2443;7775;3714;12331
317140;201602;550;1766;507;1702;72;256;326;1110;398;1366
317150;201602;947;2634;819;2486;92;333;589;1732;681;2065
317160;201602;3409;9038;2593;7962;201;664;1793;5493;1994;6157
317170;201602;1854;5076;1490;4473;106;409;773;2155;879;2564
317180;201602;1754;5937;1430;5247;383;1511;374;1383;757;2894
317190;201602;1340;3863;1074;3484;114;403;713;2300;827;2703
317200;201602;4354;13632;3762;12454;980;3608;1119;3563;2099;7171
317210;201602;1015;3047;844;2817;149;621;463;1504;612;2125
317220;201602;278;970;265;951;80;311;107;366;187;677
320010;201602;4807;15103;4188;13839;759;2665;2117;6921;2876;9586
320013;201602;1807;5543;1344;4594;210;746;552;1966;762;2712
320016;201602;2993;8560;2610;7990;351;1031;1784;5530;2135;6561
320020;201602;3734;11659;3182;10515;909;3242;965;3203;1874;6445
320030;201602;1641;5261;1333;4610;398;1454;389;1312;787;2766
320035;201602;1747;5170;1522;4827;511;1784;499;1477;1010;3261
320040;201602;3207;10317;2652;9207;581;2205;773;2622;1354;4827
320050;201602;1710;4630;1475;4208;337;1034;619;1669;956;2703
320060;201602;11440;36154;8847;30282;2011;7492;2260;7339;4271;14831
320070;201602;1379;4446;1116;3862;253;975;267;824;520;1799
320080;201602;5568;15940;4309;13453;1079;3457;1123;3619;2202;7076
320090;201602;7937;23193;6315;19933;1700;5704;2125;6468;3825;12172
320100;201602;2744;8507;2207;7415;615;2150;711;2386;1326;4536
320110;201602;1232;3687;1077;3381;260;824;319;1007;579;1831
320115;201602;1725;6153;1557;5848;840;3283;330;1309;1170;4592
320120;201602;15553;47191;12181;40686;3004;11003;3237;10896;6241;21899
320130;201602;34599;111583;31487;105387;6492;24185;14186;45954;20678;70139
320140;201602;3568;11303;2571;9045;623;2430;263;933;886;3363
320150;201602;15686;43506;11521;35651;2679;8952;1595;4763;4274;13715
320160;201602;4759;15104;4150;13863;1031;3878;1327;4053;2358;7931
320170;201602;1674;5363;1366;4695;359;1295;480;1659;839;2954
320180;201602;746;2497;663;2349;261;957;153;574;414;1531
320190;201602;3609;12392;2875;10608;803;3102;459;1699;1262;4801
320200;201602;1017;3147;858;2882;218;791;273;968;491;1759
320210;201602;4639;13098;3962;11825;842;2824;1774;4911;2616;7735
320220;201602;2398;7441;1966;6586;511;1853;701;2391;1212;4244
320225;201602;1335;4505;1071;3886;363;1419;150;548;513;1967
320230;201602;4050;13191;3523;12308;1120;4181;1212;4334;2332;8515
320240;201602;11990;35151;9550;30743;2425;8559;2340;7474;4765;16033
320245;201602;3377;11551;3125;10946;1033;3847;752;2549;1785;6396
320250;201602;1762;5386;1265;4248;333;1294;189;523;522;1817
320255;201602;1685;5688;1477;5332;609;2378;466;1793;1075;4171
320260;201602;1032;3185;803;2664;204;732;190;541;394;1273
320265;201602;2301;7273;2004;6849;457;1627;1103;3909;1560;5536
320270;201602;2631;7847;1958;6544;441;1592;746;2534;1187;4126
320280;201602;6481;19811;5691;18228;1365;4827;1897;5612;3262;10439
320290;201602;1392;4568;1034;3705;319;1201;136;504;455;1705
320300;201602;4141;13828;3699;12863;1201;4426;800;2776;2001;7202
320305;201602;4335;14006;3771;12753;901;3315;1502;4878;2403;8193
320310;201602;1908;5700;1626;5145;419;1383;571;1764;990;3147
320313;201602;2160;6244;1503;4751;319;1208;254;690;573;1898
320316;201602;1711;5154;1394;4504;435;1485;397;1245;832;2730
320320;201602;19218;58852;15554;52123;4189;15439;4765;15615;8954;31054
320330;201602;2938;8703;2494;7977;619;1950;1136;3872;1755;5822
320332;201602;4903;16244;4288;15074;1538;5743;1153;4092;2691;9835
320334;201602;1882;5987;1323;4786;361;1479;212;724;573;2203
320335;201602;2349;6921;1511;4995;373;1369;170;466;543;1835
320340;201602;5814;15684;4826;14057;1072;3386;1959;5794;3031;9180
320350;201602;4989;13458;3781;11258;792;2524;1486;4396;2278;6920
320360;201602;1694;4480;1247;3619;213;670;463;1258;676;1928
320370;201602;2964;9659;2408;8415;691;2481;703;2440;1394;4921
320380;201602;2192;6473;1930;6016;372;1269;1057;3206;1429;4475
320390;201602;7243;21857;5910;19065;1700;5935;1466;4515;3166;10450
320400;201602;3486;10766;3113;10106;910;3275;1051;3200;1961;6475
320405;201602;3999;11834;3507;11052;846;2845;1698;5240;2544;8085
320410;201602;5418;14288;3997;12437;1013;3379;1654;5192;2667;8571
320420;201602;2039;6194;1589;5382;464;1772;344;1148;808;2920
320425;201602;1866;5081;1580;4602;207;656;942;2687;1149;3343
320430;201602;2348;6557;2034;5937;423;1307;1019;2873;1442;4180
320435;201602;2773;9089;2299;8118;1063;3907;578;2176;1641;6083
320440;201602;1032;3439;913;3133;201;783;287;920;488;1703
320450;201602;1954;6125;1600;5431;436;1635;611;1992;1047;3627
320455;201602;4020;13222;2975;10707;841;3235;615;2173;1456;5408
320460;201602;2617;8441;2046;7178;521;1965;520;1779;1041;3744
320465;201602;1565;4903;1189;4064;222;827;492;1678;714;2505
320470;201602;4274;12895;2944;9885;781;2915;413;1283;1194;4198
320480;201602;1765;5487;1559;5101;415;1497;512;1623;927;3120
320490;201602;15479;47435;12975;42893;3819;13816;3433;11392;7252;25208
320495;201602;1248;3680;857;2858;270;947;98;353;368;1300
320500;201602;45759;138050;39844;127461;9494;32875;17622;55126;27116;88001
320501;201602;4206;13184;3582;12263;1211;4649;1142;3768;2353;8417
320503;201602;1834;6226;1505;5537;586;2348;347;1149;933;3497
320506;201602;3898;12066;2811;9507;822;3019;176;501;998;3520
320510;201602;7894;24721;6816;22650;1646;5892;2921;9625;4567;15517
320515;201602;1855;5349;1532;4649;387;1207;267;755;654;1962
320517;201602;2116;6838;1735;6098;578;2222;325;1086;903;3308
320520;201602;36514;109268;29966;97356;7673;27462;9838;31585;17511;59047
320530;201602;26273;79745;21910;71375;4456;16743;9905;30211;14361;46954
330010;201602;19819;60282;17864;56555;3806;13003;9135;28499;12941;41502
330015;201602;1604;4479;1399;4100;234;796;590;1672;824;2468
330020;201602;16829;49483;15382;47146;2971;9977;8690;26032;11661;36009
330022;201602;1808;5436;1524;4971;299;1093;743;2349;1042;3442
330023;201602;3093;9566;2714;8956;766;2745;810;2566;1576;5311
330025;201602;4350;11741;3450;10283;799;2592;1690;4993;2489;7585
330030;201602;7757;25705;6857;23938;1403;5414;3209;10734;4612;16148
330040;201602;11725;34647;10357;32156;2313;7627;4920;14834;7233;22461
330045;201602;68106;187895;59690;176111;7782;24635;39486;114830;47268;139465
330050;201602;2359;7394;2093;6865;606;2201;605;1830;1211;4031
330060;201602;5595;16205;4868;15161;1201;4204;2353;7243;3554;11447
330070;201602;21373;64631;19095;60771;4182;14275;8433;26822;12615;41097
330080;201602;7728;22152;7196;21340;861;2562;4905;14676;5766;17238
330090;201602;2594;7056;2345;6664;443;1394;1240;3416;1683;4810
330093;201602;1987;5895;1663;5319;382;1276;567;1877;949;3153
330095;201602;952;3236;828;2960;225;912;207;681;432;1593
330100;201602;55323;175521;50490;167660;8761;32788;26653;88268;35414;121056
330110;201602;2312;7271;2054;6828;517;1854;565;1842;1082;3696
330115;201602;1901;5460;1671;5115;302;1040;859;2539;1161;3579
330120;201602;2489;6969;2201;6538;493;1630;1132;3236;1625;4866
330130;201602;3476;11178;3085;10495;793;2917;1323;4432;2116;7349
330140;201602;2955;9182;2687;8782;618;2225;1337;4334;1955;6559
330150;201602;2277;6709;1799;5751;396;1374;385;1245;781;2619
330160;201602;1141;3670;1003;3437;285;1114;437;1412;722;2526
330170;201602;98436;295169;90048;282203;16542;54949;51300;159891;67842;214840
330180;201602;1982;5821;1648;5210;150;591;976;2888;1126;3479
330185;201602;7784;24353;6771;22399;1515;5455;3323;10720;4838;16175
330187;201602;3720;10661;3199;9794;461;1587;2081;6263;2542;7850
330190;201602;24744;70580;23042;67904;4397;13604;14536;42580;18933;56184
330200;201602;13638;43004;12153;40485;3149;10870;5628;19013;8777;29883
330205;201602;2138;5849;1862;5386;341;1094;991;2761;1332;3855
330210;201602;3624;9986;2923;8649;826;2573;691;2004;1517;4577
330220;201602;9930;30310;8704;27739;2290;7917;2137;6265;4427;14182
330225;201602;3750;11648;3376;10979;423;1621;2048;6568;2471;8189
330227;201602;16872;48588;15214;46182;3927;12190;7627;23639;11554;35829
330230;201602;1341;4009;1218;3812;303;1074;502;1479;805;2553
330240;201602;16588;51038;14234;46624;4635;16438;3025;9457;7660;25895
330245;201602;1260;3897;997;3415;250;949;174;563;424;1512
330250;201602;35417;103425;32368;98481;9767;29947;12374;39013;22141;68960
330260;201602;3568;11257;3135;10400;599;2234;1270;3982;1869;6216
330270;201602;18117;42753;12370;34957;2966;9302;4037;11498;7003;20800
330280;201602;2139;6377;1791;5694;305;1067;805;2382;1110;3449
330285;201602;17736;50980;16078;48579;2772;9097;9711;29043;12483;38140
330290;201602;3346;9483;2969;8924;489;1672;1715;4939;2204;6611
330300;201602;3219;10453;2936;9929;428;1686;1715;5618;2143;7304
330310;201602;2278;6511;1964;5989;313;1035;1074;3203;1387;4238
330320;201602;12811;38541;12008;37318;1787;6048;8513;26233;10300;32281
330330;201602;26568;73712;23322;68638;3908;12913;13908;39569;17816;52482
330340;201602;14098;41142;11179;35836;2774;9481;3193;10147;5967;19628
330350;201602;83258;248547;76935;239434;11473;37602;52485;163567;63958;201169
330360;201602;5681;16996;5471;16707;347;1199;4659;14151;5006;15350
330370;201602;3296;11692;3003;11057;1035;3955;956;3569;1991;7524
330380;201602;4838;15685;4112;14236;897;3418;1554;5245;2451;8663
330385;201602;3906;13507;3590;12889;1125;4338;1247;4473;2372;8811
330390;201602;22642;73865;20041;68686;4780;17919;8269;27701;13049;45620
330395;201602;2916;8588;2639;8131;256;946;1741;5218;1997;6164
330400;201602;2454;7797;2218;7401;308;1252;1279;3921;1587;5173
330410;201602;2797;8619;2330;7736;506;1852;1002;3219;1508;5071
330411;201602;2278;7099;1988;6494;231;902;1115;3474;1346;4376
330412;201602;1311;4436;1095;4005;231;990;441;1494;672;2484
330414;201602;23756;67289;21046;63509;4263;12787;12071;36876;16334;49663
330415;201602;3479;10633;3037;9867;794;2668;1068;3511;1862;6179
330420;201602;9416;27286;6523;21932;1418;5200;1059;3438;2477;8638
330430;201602;7177;21298;6400;19869;1328;4421;2975;9041;4303;13462
330440;201602;1602;5358;1397;4933;427;1680;269;841;696;2521
330450;201602;1309;4365;1171;4121;270;1150;558;1876;828;3026
330452;201602;13425;39286;10668;33995;2711;9407;3605;11122;6316;20529
330455;201602;467376;1295572;389953;1174812;90268;289150;183009;546413;273277;835563
330460;201602;1162;3786;1036;3564;219;861;452;1512;671;2373
330470;201602;4304;13039;3836;12181;889;3085;1651;5093;2540;8178
330475;201602;7712;23943;6801;22423;2013;7244;2409;7740;4422;14984
330480;201602;5693;16805;5229;16144;1037;3466;2932;8919;3969;12385
330490;201602;103276;275102;93679;261098;9479;27464;68619;191639;78098;219103
330500;201602;5506;16935;5247;16465;676;2326;3534;10942;4210;13268
330510;201602;36556;111939;32962;106354;10280;33685;13813;45668;24093;79353
330513;201602;1466;4419;1333;4180;401;1264;496;1601;897;2865
330515;201602;2991;9237;2637;8563;789;2589;766;2490;1555;5079
330520;201602;11255;33791;10063;31717;2116;7000;4551;14244;6667;21244
330530;201602;1464;4389;1307;4104;338;1142;486;1490;824;2632
330540;201602;2838;8406;2383;7603;566;1947;948;2936;1514;4883
330550;201602;7738;25930;6857;24265;2927;10785;1003;3591;3930;14376
330555;201602;9929;29181;8822;27615;1662;5302;5181;16685;6843;21987
330560;201602;4164;12549;3785;11854;738;2582;1918;5756;2656;8338
330570;201602;3353;9823;2884;9044;745;2469;1345;4219;2090;6688
330575;201602;5029;14511;4508;13585;723;2448;2773;8003;3496;10451
330580;201602;13737;43239;11719;39151;3016;10611;4460;14969;7476;25580
330590;201602;1583;4849;1467;4661;292;1004;880;2759;1172;3763
330600;201602;10619;30500;8620;27203;1202;4292;4505;13980;5707;18272
330610;201602;8662;27228;7905;25871;1383;5125;4470;14312;5853;19437
330615;201602;1642;5765;1488;5446;663;2603;271;1010;934;3613
330620;201602;3394;11783;3072;11171;1071;4232;707;2637;1778;6869
330630;201602;22280;65463;18411;58696;3160;11511;9409;28815;12569;40326
350010;201602;1944;5776;1300;4482;291;1089;156;491;447;1580
350020;201602;452;1225;316;960;49;157;151;433;200;590
350030;201602;4234;13318;3335;11510;1174;4420;663;2173;1837;6593
350040;201602;436;1517;332;1281;72;292;78;282;150;574
350050;201602;874;2669;711;2372;171;659;238;710;409;1369
350055;201602;622;1845;529;1694;113;372;281;890;394;1262
350060;201602;111;322;87;285;24;92;38;114;62;206
350070;201602;3501;10591;2299;8037;451;1735;381;1157;832;2892
350075;201602;428;1434;340;1287;129;500;74;275;203;775
350080;201602;552;1573;385;1243;80;287;131;408;211;695
350090;201602;568;1466;365;1110;87;253;124;386;211;639
350100;201602;1745;5499;1266;4512;272;1067;317;1068;589;2135
350110;201602;439;1310;337;1096;45;172;155;487;200;659
350115;201602;1178;3640;1061;3403;183;689;569;1681;752;2370
350120;201602;575;1513;306;944;63;199;38;117;101;316
350130;201602;3086;9220;2737;8540;390;1407;1445;4246;1835;5653
350140;201602;550;1784;469;1652;80;327;212;733;292;1060
350150;201602;380;1285;333;1186;116;439;77;276;193;715
350160;201602;7458;21768;5148;17199;1186;4455;1797;5494;2983;9949
350170;201602;1614;5562;1399;5031;349;1343;285;964;634;2307
350180;201602;984;2743;639;1971;105;326;272;840;377;1166
350190;201602;2875;8971;2388;8011;497;1983;1097;3257;1594;5240
350200;201602;328;1061;283;979;38;141;146;509;184;650
350210;201602;4671;12475;3475;10532;979;3251;1284;3780;2263;7031
350220;201602;2484;7923;2165;7257;530;2093;762;2305;1292;4398
350230;201602;604;1996;551;1906;131;510;224;745;355;1255
350240;201602;449;1414;380;1241;76;257;200;643;276;900
350250;201602;1945;7111;1827;6877;645;2591;613;2293;1258;4884
350260;201602;931;2505;654;2008;114;381;269;782;383;1163
350270;201602;4924;15106;4150;13460;771;2655;1645;5143;2416;7798
350275;201602;1809;6049;1645;5761;466;1749;599;2002;1065;3751
350280;201602;21338;52414;13345;39027;2779;8689;2636;7767;5415;16456
350290;201602;1664;5374;1314;4643;277;1092;319;1063;596;2155
350300;201602;344;1013;285;897;72;230;144;451;216;681
350310;201602;798;2656;705;2456;99;392;300;1014;399;1406
350315;201602;496;1571;395;1352;62;255;96;293;158;548
350320;201602;10451;32508;9237;30231;2528;8789;1320;4505;3848;13294
350330;201602;13462;37831;9107;27943;1797;5475;2810;8269;4607;13744
350335;201602;323;1055;282;967;23;66;192;687;215;753
350340;201602;1066;3202;750;2562;139;541;207;687;346;1228
350350;201602;699;2187;602;2030;116;457;213;693;329;1150
350360;201602;762;2600;657;2379;186;711;229;861;415;1572
350370;201602;591;1776;439;1443;79;287;82;243;161;530
350380;201602;3989;11399;2666;9091;666;2535;594;1823;1260;4358
350390;201602;8418;26247;7529;24603;2256;7700;2698;8645;4954;16345
350395;201602;344;963;172;599;22;86;34;114;56;200
350400;201602;7550;21676;6129;19164;1393;4843;2319;6979;3712;11822
350410;201602;7807;26060;6092;22581;1567;6406;848;3035;2415;9441
350420;201602;516;1562;368;1292;66;281;22;76;88;357
350430;201602;666;2074;545;1854;119;452;236;761;355;1213
350440;201602;1156;3633;1040;3405;262;884;459;1483;721;2367
350450;201602;7248;22124;5754;19099;1323;4731;1266;4070;2589;8801
350460;201602;1281;3639;854;2771;165;594;236;707;401;1301
350470;201602;221;617;182;549;29;111;104;292;133;403
350480;201602;750;2275;529;1795;71;273;92;271;163;544
350490;201602;1754;5257;1516;4895;377;1325;555;1670;932;2995
350500;201602;534;1585;466;1472;104;366;221;679;325;1045
350510;201602;999;3029;790;2592;130;505;307;935;437;1440
350520;201602;1286;4729;1012;4008;243;1060;157;615;400;1675
350530;201602;2229;6589;1861;5845;541;1750;533;1581;1074;3331
350535;201602;1234;3971;1161;3847;151;614;756;2394;907;3008
350540;201602;1714;4913;1358;4277;393;1271;404;1332;797;2603
350550;201602;10751;28660;7446;23243;1516;5311;2395;7131;3911;12442
350560;201602;3074;10228;2772;9580;404;1475;1446;5051;1850;6526
350570;201602;17138;56941;15396;53356;4452;16594;5413;17935;9865;34529
350580;201602;1562;4879;1136;3930;242;910;126;381;368;1291
350590;201602;3912;12143;3043;10404;781;2969;995;3121;1776;6090
350600;201602;39424;96758;26275;74615;4186;12799;11248;30211;15434;43010
350610;201602;6782;19871;5413;17490;1120;4010;2255;7150;3375;11160
350620;201602;387;1099;289;950;58;227;123;379;181;606
350630;201602;1522;4514;1181;3879;245;954;352;1027;597;1981
350635;201602;5940;17725;4613;15381;1055;3828;1681;5539;2736;9367
350640;201602;700;2191;493;1705;87;336;92;294;179;630
350650;201602;7326;22241;4473;15435;997;3845;455;1431;1452;5276
350660;201602;4283;12663;3613;11562;719;2537;1888;5903;2607;8440
350670;201602;1572;4894;1455;4676;283;939;842;2677;1125;3616
350680;201602;1008;3054;796;2641;170;635;311;1016;481;1651
350690;201602;797;2650;642;2342;140;553;179;632;319;1185
350700;201602;4041;11940;2693;9450;709;2694;581;1807;1290;4501
350710;201602;2459;7698;2206;7254;325;1195;1332;4314;1657;5509
350715;201602;781;2400;684;2212;215;740;224;662;439;1402
350720;201602;120;359;106;337;32;104;40;128;72;232
350730;201602;377;1411;365;1381;95;407;142;515;237;922
350740;201602;1777;5498;1318;4432;229;862;367;1106;596;1968
350745;201602;407;1309;281;962;42;154;119;367;161;521
350750;201602;9518;28731;7560;24931;1696;6149;1523;4621;3219;10770
350760;201602;12577;36656;10107;32307;2434;8624;3010;8816;5444;17440
350770;201602;681;1943;467;1536;63;234;216;693;279;927
350775;201602;542;1474;457;1346;59;217;259;741;318;958
350780;201602;1763;5421;1381;4662;384;1417;180;630;564;2047
350790;201602;1856;5742;1381;4809;318;1200;262;799;580;1999
350800;201602;2844;9489;2669;9199;412;1669;1663;5568;2075;7237
350810;201602;1939;5492;1611;5031;462;1538;602;1898;1064;3436
350820;201602;530;1433;393;1178;63;235;176;481;239;716
350830;201602;820;2554;559;1960;83;301;124;380;207;681
350840;201602;2310;8188;1916;7276;550;2226;342;1186;892;3412
350850;201602;5686;18900;4824;17023;1478;5493;1010;3478;2488;8971
350860;201602;3055;9515;2938;9348;224;905;2281;7178;2505;8083
350870;201602;2616;8316;2186;7641;524;2093;1213;4246;1737;6339
350880;201602;1171;3894;987;3510;225;853;218;761;443;1614
350890;201602;602;1707;405;1282;52;192;91;217;143;409
350900;201602;3486;11341;2667;9478;671;2626;269;891;940;3517
350910;201602;781;2348;683;2150;220;731;251;759;471;1490
350920;201602;9651;27727;8699;26087;1004;3354;5880;16978;6884;20332
350925;201602;4509;14001;3734;12457;904;3220;1289;3910;2193;7130
350930;201602;1547;4218;1235;3660;140;450;775;2213;915;2663
350940;201602;1714;5637;1562;5411;297;1201;875;2956;1172;4157
350945;201602;879;2772;754;2546;111;463;418;1355;529;1818
350950;201602;65675;198266;53106;172588;11950;42521;20576;63611;32526;106132
350960;201602;4346;14468;3724;13185;654;2614;2009;6802;2663;9416
350970;201602;4135;14216;3505;12723;1089;4301;642;2038;1731;6339
350980;201602;568;1860;513;1773;210;767;163;574;373;1341
350990;201602;1642;5657;1400;5204;422;1692;336;1243;758;2935
350995;201602;716;2489;687;2437;98;455;435;1452;533;1907
351000;201602;2949;8813;2467;7916;338;1211;1124;3420;1462;4631
351010;201602;323;914;204;667;48;172;63;209;111;381
351015;201602;781;2666;658;2435;150;620;286;1029;436;1649
351020;201602;7816;24454;6789;22873;1679;5956;3002;10261;4681;16217
351030;201602;1635;5815;1455;5380;325;1402;439;1490;764;2892
351040;201602;3145;9513;2871;9061;434;1545;1835;5588;2269;7133
351050;201602;13623;38819;9722;31959;2376;8564;2361;7711;4737;16275
351060;201602;32960;96942;27065;86326;5864;20449;11631;36136;17495;56585
351070;201602;1443;4063;975;3204;271;975;104;297;375;1272
351080;201602;2488;7204;1904;6477;477;1778;816;2684;1293;4462
351090;201602;346;1187;281;1049;57;245;47;175;104;420
351100;201602;2000;6109;1611;5310;458;1568;362;1260;820;2828
351110;201602;6993;17357;3859;12271;783;2876;764;2270;1547;5146
351120;201602;606;1749;493;1527;48;182;256;693;304;875
351130;201602;964;2689;523;1774;87;321;88;275;175;596
351140;201602;1626;5458;1338;4864;400;1550;294;1023;694;2573
351150;201602;1463;5147;1099;4202;173;723;167;565;340;1288
351160;201602;1188;4091;1049;3773;267;1083;327;1076;594;2159
351170;201602;1334;4256;1104;3765;199;731;454;1480;653;2211
351190;201602;749;2409;590;1995;100;349;139;469;239;818
351200;201602;1952;5776;1654;5218;306;1089;548;1556;854;2645
351210;201602;1013;3019;763;2513;163;591;245;736;408;1327
351220;201602;3096;10411;2823;9855;541;2078;1329;4548;1870;6626
351230;201602;1608;5054;1360;4599;256;1027;680;2211;936;3238
351240;201602;1042;3255;784;2708;214;793;190;582;404;1375
351250;201602;886;2554;599;1950;104;361;202;624;306;985
351260;201602;894;2636;780;2405;167;538;308;917;475;1455
351270;201602;307;1069;272;997;59;258;101;322;160;580
351280;201602;4630;13563;3531;11292;709;2475;1191;3604;1900;6079
351290;201602;944;2686;701;2220;160;511;273;858;433;1369
351300;201602;12007;39047;9015;32672;2112;8451;2526;8964;4638;17415
351310;201602;2969;9039;2403;8036;457;1754;1075;3337;1532;5091
351320;201602;847;2820;732;2575;147;594;217;677;364;1271
351330;201602;254;699;207;629;80;245;42;120;122;365
351340;201602;5492;18317;4776;16911;1336;5024;1706;6037;3042;11061
351350;201602;7225;23146;6239;21114;1736;6113;1906;6134;3642;12247
351360;201602;3988;12416;3650;11774;870;3084;1167;3449;2037;6533
351370;201602;2104;6472;1667;5574;347;1314;620;1895;967;3209
351380;201602;35976;105373;32542;99146;6407;21044;13758;40934;20165;61978
351385;201602;193;598;177;570;36;127;81;244;117;371
351390;201602;1058;3453;902;3149;238;957;321;1000;559;1957
351400;201602;835;2788;797;2702;306;1102;253;841;559;1943
351410;201602;2440;7311;2141;6794;335;1136;1233;3820;1568;4956
351420;201602;307;878;209;690;48;165;51;167;99;332
351430;201602;775;2420;723;2336;99;354;523;1671;622;2025
351440;201602;3216;9599;2498;8059;522;1726;381;1128;903;2854
351450;201602;1536;4324;1274;3931;314;1007;484;1574;798;2581
351460;201602;658;1974;562;1813;300;987;125;402;425;1389
351470;201602;958;2876;850;2667;183;644;356;1069;539;1713
351480;201602;2651;8700;2452;8375;406;1756;1350;4383;1756;6139
351490;201602;1680;5544;1498;5162;179;767;873;2856;1052;3623
351492;201602;201;623;159;529;15;62;92;297;107;359
351495;201602;159;511;125;421;26;107;46;134;72;241
351500;201602;23577;67464;18256;57716;4514;15710;6698;20178;11212;35888
351510;201602;8268;25507;6785;22539;1563;5634;3114;10192;4677;15826
351512;201602;443;1287;340;1065;53;157;178;567;231;724
351515;201602;2149;6753;1538;5392;367;1396;371;1173;738;2569
351518;201602;1986;6194;1370;5060;330;1406;384;1290;714;2696
351519;201602;759;2234;560;1799;102;396;155;376;257;772
351520;201602;743;1995;373;1291;55;229;56;170;111;399
351530;201602;365;1114;269;893;40;129;67;187;107;316
351535;201602;2258;5826;1754;5088;161;541;1114;3121;1275;3662
351540;201602;1680;5074;1353;4451;419;1498;184;602;603;2100
351550;201602;4791;14054;3415;11193;666;2479;1167;3683;1833;6162
351560;201602;343;1108;299;1027;66;271;44;141;110;412
351565;201602;157;527;145;497;24;86;61;210;85;296
351570;201602;11282;34387;9496;30810;2068;7259;4833;15202;6901;22461
351580;201602;318;844;195;586;51;144;49;152;100;296
351590;201602;409;1085;284;861;28;95;118;340;146;435
351600;201602;1663;4621;1410;4187;214;707;718;2010;932;2717
351610;201602;642;1759;495;1510;60;229;224;613;284;842
351620;201602;17638;56211;13671;48220;2793;11013;3201;10067;5994;21080
351630;201602;18460;58193;16617;55237;3752;13256;8988;29617;12740;42873
351640;201602;11634;34702;9497;30906;1701;6061;5114;16319;6815;22380
351650;201602;434;1313;217;746;40;162;24;66;64;228
351660;201602;737;2364;555;1897;113;412;117;355;230;767
351670;201602;3744;11661;3099;10279;563;2091;1357;4216;1920;6307
351680;201602;607;1884;388;1373;72;258;64;229;136;487
351685;201602;359;1108;319;1036;82;257;151;501;233;758
351690;201602;1036;3084;746;2456;132;461;220;652;352;1113
351700;201602;1128;3303;972;3002;242;730;364;1114;606;1844
351710;201602;542;1793;458;1617;79;273;165;582;244;855
351720;201602;1541;4690;1063;3530;203;704;293;915;496;1619
351730;201602;1036;2982;843;2711;250;926;309;961;559;1887
351740;201602;3947;10743;3160;9213;644;2010;1105;3077;1749;5087
351750;201602;1063;3412;729;2653;161;647;164;575;325;1222
351760;201602;3446;10776;2840;9468;754;2678;909;2853;1663;5531
351770;201602;2096;6601;1797;6092;502;1804;744;2421;1246;4225
351780;201602;1475;4123;885;2832;146;505;206;636;352;1141
351790;201602;963;2829;843;2641;244;738;358;1179;602;1917
351800;201602;443;992;292;776;33;89;133;349;166;438
351810;201602;935;2675;833;2538;104;331;597;1829;701;2160
351820;201602;2328;7367;1785;6255;444;1640;158;519;602;2159
351830;201602;3705;11599;2856;9714;494;1894;1273;4154;1767;6048
351840;201602;6617;21959;5753;20257;1465;5593;1935;6623;3400;12216
351850;201602;1776;4922;1284;4057;190;747;589;1667;779;2414
351860;201602;3192;10196;2778;9344;733;2618;1026;3328;1759;5946
351870;201602;27468;82078;23201;74415;6502;21921;9327;29646;15829;51567
351880;201602;105550;332019;90457;301439;25976;91919;22164;71153;48140;163072
351885;201602;524;1856;494;1798;133;499;201;736;334;1235
351890;201602;603;1844;476;1594;111;413;80;231;191;644
351900;201602;1184;3606;995;3304;269;949;297;986;566;1935
351905;201602;428;1345;351;1201;47;191;187;584;234;775
351907;201602;16854;49717;14031;44451;1696;6416;8485;25941;10181;32357
351910;201602;938;2961;797;2649;151;552;343;1106;494;1658
351920;201602;974;2662;850;2483;112;377;507;1445;619;1822
351925;201602;856;2667;725;2406;118;416;320;1016;438;1432
351930;201602;2492;8083;2366;7848;451;1877;1579;4873;2030;6750
351940;201602;932;2816;783;2531;164;579;323;1015;487;1594
351950;201602;1413;3898;1001;3135;138;465;488;1520;626;1985
351960;201602;4041;11590;2949;9586;631;2282;1181;3808;1812;6090
351970;201602;4749;17055;4197;16002;1192;4887;1391;5196;2583;10083
351980;201602;830;2498;649;2116;123;437;213;619;336;1056
351990;201602;1438;4079;1159;3567;245;885;213;552;458;1437
352000;201602;2167;6966;1962;6557;433;1540;887;2808;1320;4348
352010;201602;1587;5337;1390;4890;333;1265;279;979;612;2244
352020;201602;1334;4164;1148;3832;262;960;407;1297;669;2257
352030;201602;4670;13687;3883;12526;893;3024;1920;6235;2813;9259
352040;201602;1862;6101;1542;5403;307;1179;317;1053;624;2232
352042;201602;3165;8844;2048;6424;407;1395;883;2689;1290;4084
352044;201602;1317;4262;992;3526;180;713;170;543;350;1256
352050;201602;9687;29228;6628;22605;1429;5456;1218;3717;2647;9173
352060;201602;681;2036;556;1803;117;434;213;637;330;1071
352070;201602;776;1998;613;1730;134;402;200;555;334;957
352080;201602;394;1137;281;926;47;156;97;307;144;463
352090;201602;1287;4409;1068;3861;202;825;201;666;403;1491
352100;201602;2470;7509;1869;6402;480;1823;596;1894;1076;3717
352110;201602;454;1582;386;1446;111;433;137;475;248;908
352115;201602;408;1297;353;1196;57;212;165;525;222;737
352120;201602;875;2742;724;2470;122;510;359;1149;481;1659
352130;201602;1735;4979;1174;3849;311;1052;254;761;565;1813
352140;201602;1702;4890;1025;3458;160;569;340;1101;500;1670
352150;201602;709;2184;562;1900;152;530;230;773;382;1303
352160;201602;971;2686;761;2303;151;498;244;653;395;1151
352170;201602;2551;7720;2304;7236;440;1480;1187;3499;1627;4979
352180;201602;3187;9136;2678;8139;626;2027;931;2703;1557;4730
352190;201602;1107;3305;885;2845;147;577;279;701;426;1278
352200;201602;348;1217;279;1074;54;234;114;424;168;658
352210;201602;15497;41990;12672;37928;2313;7350;7251;21983;9564;29333
352215;201602;539;1678;492;1613;61;217;292;939;353;1156
352220;201602;11702;37698;9833;33900;3186;11728;2280;7911;5466;19639
352230;201602;11814;39576;10247;36682;2822;11105;3525;12193;6347;23298
352240;201602;11836;34269;9212;29722;2655;9688;2620;7533;5275;17221
352250;201602;21377;68750;18667;63247;5421;19563;5429;18352;10850;37915
352260;201602;5063;14410;3300;10757;611;2226;1076;3224;1687;5450
352265;201602;831;2676;712;2466;72;331;426;1396;498;1727
352270;201602;1682;5785;1417;5208;360;1398;321;1177;681;2575
352280;201602;2097;6348;1746;5751;418;1569;610;1896;1028;3465
352290;201602;1046;3326;893;3003;205;819;303;900;508;1719
352300;201602;906;2666;717;2314;167;585;290;871;457;1456
352310;201602;38078;113399;31395;102083;8003;27359;15213;49741;23216;77100
352320;201602;5370;16515;4642;15161;1288;4503;1373;4066;2661;8569
352330;201602;1923;6140;1637;5736;523;1953;435;1512;958;3465
352340;201602;5164;16410;3960;14065;997;3877;672;2171;1669;6048
352350;201602;1554;5305;1398;4986;276;1117;498;1698;774;2815
352360;201602;1006;3081;876;2833;172;675;538;1622;710;2297
352370;201602;796;2738;722;2573;134;528;339;1171;473;1699
352380;201602;914;2912;787;2680;236;914;175;565;411;1479
352390;201602;17570;47180;11801;36344;2020;7087;5377;15460;7397;22547
352400;201602;3832;10755;2549;8303;701;2397;649;1948;1350;4345
352410;201602;2799;8484;2382;7780;594;2035;856;2716;1450;4751
352420;201602;830;2363;705;2123;167;542;298;864;465;1406
352430;201602;6029;18072;5037;16494;1697;6080;1441;4622;3138;10702
352440;201602;14647;44367;11898;39098;2867;10009;4013;12901;6880;22910
352450;201602;600;1817;417;1457;87;344;102;320;189;664
352460;201602;2240;7285;1878;6590;523;2039;465;1468;988;3507
352470;201602;4024;11046;2565;8284;399;1425;791;2408;1190;3833
352480;201602;4242;11641;3297;9895;644;2186;1155;3145;1799;5331
352490;201602;627;2177;498;1848;90;376;111;375;201;751
352500;201602;7961;23190;6995;21770;3291;10981;1772;4891;5063;15872
352510;201602;2766;8685;2189;7598;640;2445;492;1623;1132;4068
352520;201602;1919;6756;1703;6230;434;1727;683;2450;1117;4177
352530;201602;7843;24958;5975;20849;1495;5600;762;2304;2257;7904
352540;201602;458;1413;339;1146;57;217;97;294;154;511
352550;201602;843;2797;603;2225;136;570;103;354;239;924
352560;201602;622;1849;450;1467;73;223;114;339;187;562
352570;201602;1747;5752;1331;4811;280;1158;237;751;517;1909
352580;201602;794;2356;687;2187;145;506;363;1139;508;1645
352585;201602;208;670;174;609;56;212;31;115;87;327
352590;201602;12030;36810;9665;32223;2663;9584;3658;11431;6321;21015
352600;201602;1490;4586;1319;4283;326;1157;550;1686;876;2843
352610;201602;3151;9686;2619;8805;764;2879;697;2230;1461;5109
352620;201602;4946;15212;4534;14615;941;3285;2514;7923;3455;11208
352630;201602;585;1889;554;1809;121;470;219;656;340;1126
352640;201602;2517;7751;2099;6929;256;978;1160;3740;1416;4718
352650;201602;770;2313;575;1898;122;422;150;472;272;894
352660;201602;982;3330;783;2888;145;607;186;674;331;1281
352670;201602;10125;30391;6368;22184;1426;5416;537;1773;1963;7189
352680;201602;2790;9376;2150;7911;499;2038;599;1994;1098;4032
352690;201602;29221;80432;20786;63730;3346;11314;9641;28260;12987;39574
352700;201602;577;1728;480;1580;136;497;204;649;340;1146
352710;201602;5199;15052;3964;12642;941;3343;1362;4123;2303;7466
352720;201602;7221;23374;6468;21755;1912;6486;1932;6488;3844;12974
352725;201602;386;1079;238;776;36;144;85;252;121;396
352730;201602;2028;6760;1826;6234;367;1340;626;1899;993;3239
352740;201602;1911;5333;1544;4740;233;853;885;2566;1118;3419
352750;201602;460;1326;235;807;35;131;42;137;77;268
352760;201602;1107;3788;942;3393;283;1063;312;1075;595;2138
352770;201602;725;2272;626;2077;135;500;247;787;382;1287
352780;201602;569;1905;465;1678;97;389;129;432;226;821
352790;201602;605;1747;447;1472;87;300;101;333;188;633
352800;201602;901;3217;663;2585;144;618;173;600;317;1218
352810;201602;1114;2914;737;2193;133;434;228;636;361;1070
352820;201602;588;1627;428;1372;97;356;85;274;182;630
352830;201602;491;1408;304;977;48;180;39;95;87;275
352840;201602;3482;11857;3114;11083;953;3520;1006;3521;1959;7041
352850;201602;8045;24881;6718;22652;1779;6388;2231;7419;4010;13807
352860;201602;739;2458;676;2322;157;570;232;768;389;1338
352870;201602;887;2230;624;1705;60;236;355;860;415;1096
352880;201602;2183;6188;1621;5075;296;944;521;1548;817;2492
352885;201602;200;684;189;656;20;76;123;414;143;490
352890;201602;637;1697;457;1339;62;215;207;545;269;760
352900;201602;19234;56165;14244;46277;2892;10298;4984;15495;7876;25793
352910;201602;341;1004;202;674;22;79;24;71;46;150
352920;201602;2217;6690;1696;5622;341;1279;657;1991;998;3270
352930;201602;5425;16792;4270;14285;1041;3724;948;3024;1989;6748
352940;201602;21447;69336;17888;61212;5679;20860;2055;6458;7734;27318
352950;201602;287;836;182;644;40;165;34;104;74;269
352960;201602;563;1719;359;1249;55;214;57;187;112;401
352965;201602;356;1006;229;728;53;171;33;88;86;259
352970;201602;3026;7631;2438;6762;303;875;1568;4368;1871;5243
352980;201602;1161;3536;963;3224;208;694;526;1864;734;2558
352990;201602;3895;12343;3445;11580;917;3470;1333;4222;2250;7692
353000;201602;445;1258;249;803;26;84;36;110;62;194
353010;201602;2921;8144;2154;6663;513;1804;562;1499;1075;3303
353020;201602;4055;11041;2610;7954;357;1242;912;2495;1269;3737
353030;201602;3593;10583;2915;9337;819;2826;556;1694;1375;4520
353040;201602;528;1452;448;1330;111;367;139;383;250;750
353050;201602;4551;15219;3824;13758;1103;4217;1302;4547;2405;8764
353060;201602;34213;103000;31221;98316;3400;12958;22564;68520;25964;81478
353070;201602;10002;30738;7169;24776;1661;6113;1680;5825;3341;11938
353080;201602;4936;15571;3428;12287;705;2808;707;2351;1412;5159
353090;201602;491;1659;446;1569;43;173;256;847;299;1020
353100;201602;245;669;120;403;21;70;18;58;39;128
353110;201602;7102;21770;6075;20107;1478;5245;3096;10319;4574;15564
353120;201602;648;1912;411;1363;87;331;96;262;183;593
353130;201602;2358;6806;1899;6100;589;2030;566;1768;1155;3798
353140;201602;2195;5988;1694;5028;401;1282;658;1841;1059;3123
353150;201602;1570;4725;1273;4215;333;1152;336;1125;669;2277
353160;201602;654;1853;423;1372;93;317;57;134;150;451
353170;201602;391;1289;355;1233;98;437;160;505;258;942
353180;201602;7796;22292;6217;19495;1114;3834;3068;9356;4182;13190
353190;201602;3459;10513;2884;9280;516;1873;1431;4310;1947;6183
353200;201602;893;2985;733;2617;223;880;179;593;402;1473
353205;201602;348;1136;307;1058;73;253;116;405;189;658
353210;201602;952;2427;682;1953;35;133;446;1240;481;1373
353215;201602;354;1137;311;1038;52;202;113;327;165;529
353220;201602;615;1926;507;1695;125;448;99;299;224;747
353230;201602;778;2528;711;2413;174;662;176;562;350;1224
353240;201602;1899;6124;1687;5706;362;1378;847;2748;1209;4126
353250;201602;1014;2746;772;2305;104;328;370;1073;474;1401
353260;201602;838;2307;603;1882;95;340;217;653;312;993
353270;201602;598;1766;524;1627;132;431;176;529;308;960
353280;201602;547;1798;451;1578;110;426;94;323;204;749
353282;201602;1581;5083;1486;4911;206;772;917;2911;1123;3683
353284;201602;330;886;191;591;34;103;48;147;82;250
353286;201602;139;420;100;335;16;49;16;59;32;108
353290;201602;566;1778;450;1575;76;329;240;780;316;1109
353300;201602;1319;4103;1105;3653;256;967;367;1083;623;2050
353310;201602;172;537;145;489;47;169;44;141;91;310
353320;201602;500;1443;437;1340;78;270;238;695;316;965
353325;201602;569;1863;475;1677;83;315;85;260;168;575
353330;201602;586;1701;395;1256;69;250;171;512;240;762
353340;201602;2562;7288;1694;5656;450;1591;401;1313;851;2904
353350;201602;3007;9029;2474;8019;734;2525;843;2592;1577;5117
353360;201602;378;1230;338;1145;41;165;219;710;260;875
353370;201602;591;1939;513;1758;63;251;275;906;338;1157
353380;201602;303;1019;252;917;48;207;76;252;124;459
353390;201602;5630;15388;4046;12579;773;2599;1312;3885;2085;6484
353400;201602;448;1364;383;1235;99;354;75;201;174;555
353410;201602;561;1640;465;1480;84;290;259;821;343;1111
353420;201602;536;1481;375;1139;108;321;101;293;209;614
353430;201602;2130;7232;1557;5786;356;1410;187;648;543;2058
353440;201602;54798;173686;45812;153809;12263;43002;15314;49913;27577;92915
353450;201602;402;1202;329;1053;71;251;119;361;190;612
353460;201602;3208;9056;2713;8196;405;1366;1285;3952;1690;5318
353470;201602;7819;23538;5730;19350;1239;4609;1203;3779;2442;8388
353475;201602;1521;4272;1063;3287;190;623;292;815;482;1438
353480;201602;1321;4023;1174;3736;196;675;673;2069;869;2744
353490;201602;906;2611;720;2246;146;476;242;714;388;1190
353500;201602;921;2495;754;2222;240;710;321;924;561;1634
353510;201602;936;2977;695;2387;149;546;134;426;283;972
353520;201602;1047;3026;829;2671;146;540;329;1018;475;1558
353530;201602;2394;7056;2094;6527;336;1234;1113;3321;1449;4555
353540;201602;1816;5560;1569;5140;415;1426;610;1951;1025;3377
353550;201602;5602;15480;4749;14155;533;1885;2950;8355;3483;10240
353560;201602;1975;6487;1643;5920;410;1675;423;1407;833;3082
353570;201602;417;1289;351;1162;59;196;210;665;269;861
353580;201602;2113;6472;1931;6171;323;1171;1228;3883;1551;5054
353590;201602;691;2003;526;1685;141;472;153;509;294;981
353600;201602;1647;4554;1476;4269;223;719;753;2103;976;2822
353610;201602;519;1745;392;1476;66;297;63;208;129;505
353620;201602;2064;6752;1752;6118;440;1654;498;1606;938;3260
353625;201602;323;899;195;652;42;151;52;177;94;328
353630;201602;1454;5085;1177;4388;219;887;132;425;351;1312
353640;201602;1234;3692;982;3154;125;427;480;1529;605;1956
353650;201602;7045;20753;5274;17098;1000;3381;1658;5256;2658;8637
353657;201602;270;853;238;787;36;135;72;229;108;364
353660;201602;1059;2760;802;2336;302;949;109;214;411;1163
353670;201602;3324;10729;2829;9676;907;3471;806;2463;1713;5934
353680;201602;654;2111;564;1952;194;772;194;612;388;1384
353690;201602;501;1348;283;928;46;162;57;150;103;312
353700;201602;1832;5681;1574;5164;295;1034;646;2035;941;3069
353710;201602;2893;6945;1384;4524;288;962;205;688;493;1650
353715;201602;455;1307;329;1047;28;106;82;234;110;340
353720;201602;1908;5994;1647;5589;319;1264;794;2548;1113;3812
353730;201602;4173;12583;3298;10797;661;2356;974;2921;1635;5277
353740;201602;1755;5243;1364;4480;356;1213;308;1000;664;2213
353750;201602;790;2661;605;2236;125;521;142;532;267;1053
353760;201602;9142;25371;7408;22902;1305;4504;4153;12614;5458;17118
353770;201602;738;2293;463;1625;65;228;21;45;86;273
353780;201602;3858;13366;3364;12354;1080;4181;863;3164;1943;7345
353790;201602;1953;6678;1617;5994;427;1814;302;1112;729;2926
353800;201602;15206;46384;12104;40902;3121;11507;3968;13102;7089;24609
353810;201602;974;3098;749;2615;152;598;219;752;371;1350
353820;201602;1235;4159;1121;3892;227;927;568;1826;795;2753
353830;201602;621;1670;487;1460;88;295;257;749;345;1044
353850;201602;1596;5026;1420;4681;313;1089;564;1830;877;2919
353860;201602;2369;7880;2015;7078;520;1977;501;1690;1021;3667
353870;201602;27353;78857;19185;63216;3832;13884;5421;16266;9253;30150
353880;201602;2471;7816;2077;7129;298;1231;1073;3615;1371;4846
353890;201602;2571;6305;1796;5060;291;872;838;2257;1129;3129
353900;201602;942;2925;692;2426;145;565;181;602;326;1167
353910;201602;1003;3626;952;3516;252;938;519;1942;771;2880
353920;201602;2207;6510;1554;5140;326;1177;250;720;576;1897
353930;201602;4310;12961;2992;10551;719;2745;541;1915;1260;4660
353940;201602;1121;3539;897;3048;143;541;284;910;427;1451
353950;201602;3118;9962;2801;9354;443;1645;1611;5175;2054;6820
353960;201602;568;1794;437;1508;96;342;80;234;176;576
353970;201602;499;1449;434;1364;48;160;284;897;332;1057
353980;201602;12013;36190;10384;33137;2271;7719;4886;15114;7157;22833
353990;201602;311;1001;284;943;45;184;132;408;177;592
354000;201602;2050;5813;1380;4462;246;848;126;386;372;1234
354010;201602;344;1037;287;946;67;223;155;524;222;747
354020;201602;4080;12823;3582;11727;945;3296;1121;3428;2066;6724
354025;201602;849;2359;616;1929;124;415;188;573;312;988
354030;201602;439;1229;306;994;48;169;126;393;174;562
354040;201602;709;1965;496;1558;53;183;247;720;300;903
354050;201602;882;2854;747;2573;198;745;169;557;367;1302
354060;201602;4708;14552;3342;11530;803;2945;829;2752;1632;5697
354070;201602;2508;8392;2158;7614;522;1978;396;1331;918;3309
354075;201602;1759;6533;1658;6314;391;1667;741;2752;1132;4419
354080;201602;1464;4499;1034;3551;200;707;184;568;384;1275
354085;201602;310;794;275;743;14;53;224;593;238;646
354090;201602;1237;3699;1183;3612;129;440;825;2543;954;2983
354100;201602;13896;46357;11494;41884;2923;11349;4499;16167;7422;27516
354105;201602;781;2394;698;2257;114;412;441;1388;555;1800
354110;201602;680;1882;545;1698;206;713;75;175;281;888
354120;201602;1821;5033;1392;4237;244;809;556;1578;800;2387
354130;201602;5852;16975;4498;14377;1647;5548;442;1218;2089;6766
354140;201602;25628;64235;15958;47083;3180;10074;4600;12515;7780;22589
354150;201602;3677;9985;2830;8447;461;1539;1324;3794;1785;5333
354160;201602;3156;10252;2631;9057;727;2690;922;3075;1649;5765
354165;201602;380;1370;335;1268;93;394;103;376;196;770
354170;201602;1258;3953;1006;3395;199;746;357;1095;556;1841
354180;201602;442;1323;392;1217;52;196;221;613;273;809
354190;201602;1473;4708;1236;4221;332;1236;368;1195;700;2431
354200;201602;964;2731;777;2407;111;392;337;960;448;1352
354210;201602;561;1794;480;1647;71;289;247;790;318;1079
354220;201602;2708;7926;2313;7212;494;1649;1003;3053;1497;4702
354230;201602;583;1923;528;1819;99;387;213;708;312;1095
354240;201602;1137;3719;856;3072;155;617;163;570;318;1187
354250;201602;651;1862;435;1479;143;525;104;376;247;901
354260;201602;7558;22386;6331;20363;1755;6058;1907;6130;3662;12188
354270;201602;1070;3675;910;3312;191;767;294;1049;485;1816
354280;201602;648;1981;594;1890;87;339;406;1221;493;1560
354290;201602;853;2975;771;2809;189;759;318;1164;507;1923
354300;201602;3286;10976;3165;10753;866;3003;1456;4912;2322;7915
354310;201602;820;2515;648;2174;131;460;296;1001;427;1461
354320;201602;679;2045;567;1827;143;529;166;484;309;1013
354323;201602;416;1169;309;975;68;230;92;261;160;491
354325;201602;1180;3900;961;3377;189;748;358;1182;547;1930
354330;201602;6162;18604;5037;16409;1017;3698;2240;6848;3257;10546
354340;201602;22223;68613;18164;61419;5434;19832;6173;20283;11607;40115
354350;201602;1013;3004;939;2871;285;985;439;1207;724;2192
354360;201602;439;1409;290;1056;41;152;16;72;57;224
354370;201602;1094;3671;948;3391;103;467;541;1872;644;2339
354380;201602;809;2420;648;2132;186;720;92;247;278;967
354390;201602;12209;36115;8652;29215;1758;6464;1622;5351;3380;11815
354400;201602;1466;5111;1203;4464;244;971;332;1210;576;2181
354410;201602;5054;15661;4249;14161;1036;3650;1709;5680;2745;9330
354420;201602;1091;3321;826;2710;194;691;289;902;483;1593
354425;201602;2221;6416;1887;5801;584;1885;373;1151;957;3036
354430;201602;1256;4052;1153;3852;245;933;473;1529;718;2462
354440;201602;479;1429;358;1179;46;175;144;441;190;616
354450;201602;394;1133;235;800;34;142;36;99;70;241
354460;201602;825;2275;605;1902;165;560;229;713;394;1273
354470;201602;555;1534;435;1292;43;160;219;587;262;747
354480;201602;670;1857;572;1711;95;316;330;957;425;1273
354490;201602;653;2185;503;1826;82;303;154;531;236;834
354500;201602;2017;6608;1775;6193;654;2597;252;795;906;3392
354510;201602;682;1962;617;1856;89;249;391;1214;480;1463
354515;201602;263;882;202;742;36;155;69;232;105;387
354520;201602;6978;22644;3955;13818;753;2972;1421;4626;2174;7598
354530;201602;2801;9674;2511;9045;679;2669;979;3429;1658;6098
354540;201602;1171;3549;958;3168;340;1229;133;398;473;1627
354550;201602;423;1283;360;1149;63;217;171;524;234;741
354560;201602;1520;4293;1012;3184;175;544;387;1156;562;1700
354570;201602;808;2350;503;1630;72;245;66;189;138;434
354580;201602;9830;27905;7324;23321;1319;4562;2847;8642;4166;13204
354600;201602;1452;4824;1288;4484;277;1179;614;1989;891;3168
354610;201602;360;1041;213;690;26;74;39;115;65;189
354620;201602;363;1182;285;1048;73;332;127;441;200;773
354625;201602;259;833;191;686;32;121;53;177;85;298
354630;201602;1957;6600;1752;6162;698;2571;260;863;958;3434
354640;201602;3279;10731;2624;9317;536;2190;520;1672;1056;3862
354650;201602;829;2506;720;2290;93;330;464;1450;557;1780
354660;201602;2115;6113;1601;5211;202;751;899;2910;1101;3661
354670;201602;1309;4196;1021;3494;244;904;206;636;450;1540
354680;201602;4190;13738;3798;12967;1027;3749;1524;5114;2551;8863
354690;201602;728;2359;495;1771;90;331;107;377;197;708
354700;201602;1108;3180;782;2499;148;547;307;851;455;1398
354710;201602;491;1469;394;1261;46;167;171;486;217;653
354720;201602;219;588;135;429;42;130;33;100;75;230
354730;201602;7407;24162;5753;20752;1265;4995;2234;7827;3499;12822
354740;201602;227;702;138;503;18;78;27;94;45;172
354750;201602;2318;7019;1778;6049;486;1830;606;1988;1092;3818
354760;201602;1811;5734;1472;5004;415;1515;182;592;597;2107
354765;201602;271;743;146;473;14;51;17;40;31;91
354770;201602;2184;6082;1672;5222;582;1920;438;1319;1020;3239
354780;201602;47543;133558;40746;119539;6824;22463;21674;59816;28498;82279
354790;201602;730;2414;656;2258;124;475;326;1059;450;1534
354800;201602;1984;5812;1753;5515;438;1532;863;2669;1301;4201
354805;201602;918;2742;677;2227;57;196;139;413;196;609
354810;201602;576;1872;373;1378;62;283;53;144;115;427
354820;201602;922;3172;791;2885;171;736;202;659;373;1395
354830;201602;374;1050;289;899;70;228;122;349;192;577
354840;201602;586;1668;466;1456;93;300;224;695;317;995
354850;201602;15851;48637;11865;40685;2547;9818;4583;14420;7130;24238
354860;201602;1317;4139;1131;3828;226;875;436;1389;662;2264
354870;201602;41396;122663;36944;113601;8698;28579;15100;45641;23798;74220
354880;201602;4057;11161;2318;7556;353;1347;632;1684;985;3031
354890;201602;15320;44526;12726;39919;2988;10128;4586;13894;7574;24022
354900;201602;407;1249;310;1041;66;230;64;208;130;438
354910;201602;6173;18385;3651;12955;566;2250;151;529;717;2779
354920;201602;393;1160;272;924;49;194;63;213;112;407
354925;201602;299;896;187;644;27;110;21;62;48;172
354930;201602;195;515;138;423;25;80;64;193;89;273
354940;201602;1767;6298;1459;5488;503;2029;166;573;669;2602
354950;201602;1382;4436;1185;4112;125;538;668;2265;793;2803
354960;201602;741;2314;645;2162;133;508;267;864;400;1372
354970;201602;3652;11921;3237;11082;576;2268;1706;5621;2282;7889
354980;201602;32514;81002;20058;60530;3443;11685;6190;17217;9633;28902
354990;201602;47755;139945;38169;121159;6770;23293;18127;55841;24897;79134
354995;201602;1629;4990;1389;4615;321;1101;701;2334;1022;3435
355000;201602;1324;4297;1172;4018;367;1445;205;609;572;2054
355010;201602;3358;10348;2653;8774;704;2451;837;2835;1541;5286
355020;201602;2740;9089;2110;7824;799;3241;416;1495;1215;4736
355030;201602;1007926;2783535;860760;2501349;190833;601414;366429;1020310;557262;1621724
355040;201602;2372;7279;2097;6808;503;1738;1097;3511;1600;5249
355050;201602;1096;3353;888;2958;285;966;128;423;413;1389
355060;201602;4161;13884;3401;12311;758;3086;932;3081;1690;6167
355070;201602;5980;18653;5343;17632;1115;4251;2649;8159;3764;12410
355080;201602;932;3243;672;2629;107;492;39;141;146;633
355090;201602;1054;3591;898;3255;163;623;348;1269;511;1892
355100;201602;16331;51149;13783;46952;3736;13987;6055;20132;9791;34119
355110;201602;1141;3725;986;3436;282;1048;217;751;499;1799
355120;201602;589;1873;500;1702;99;404;181;574;280;978
355130;201602;571;1446;286;844;42;130;88;236;130;366
355140;201602;1046;3479;993;3398;223;856;515;1800;738;2656
355150;201602;3026;8792;2550;8046;540;1770;1280;4099;1820;5869
355160;201602;1462;4595;1244;4258;400;1543;350;1128;750;2671
355170;201602;8022;22269;6036;18981;1914;6414;1383;4474;3297;10888
355180;201602;2717;8443;2247;7595;571;2272;680;2068;1251;4340
355190;201602;1197;4044;1021;3694;363;1397;317;1126;680;2523
355200;201602;699;2528;652;2430;268;1085;131;456;399;1541
355210;201602;2439;7787;2156;7215;391;1514;1101;3482;1492;4996
355220;201602;30201;91819;24923;81412;8138;27907;5758;17940;13896;45847
355230;201602;1374;3812;779;2518;142;466;162;488;304;954
355240;201602;24534;69838;17447;55765;3579;12202;5578;17304;9157;29506
355250;201602;24309;78308;21174;72357;5921;21647;7702;25750;13623;47397
355255;201602;831;2278;535;1682;95;310;136;414;231;724
355260;201602;1175;3422;1004;3142;230;825;401;1114;631;1939
355270;201602;1487;4352;1386;4200;116;390;1081;3262;1197;3652
355280;201602;23641;68883;19379;60847;3641;12798;8196;24414;11837;37212
355290;201602;867;2742;705;2359;126;445;245;737;371;1182
355300;201602;1126;3653;939;3266;200;758;323;1055;523;1813
355310;201602;928;2838;782;2560;140;485;381;1252;521;1737
355320;201602;549;1712;473;1548;84;333;174;494;258;827
355330;201602;1760;5434;1258;4437;263;1029;457;1566;720;2595
355340;201602;2357;6199;2111;5790;366;1015;1236;3331;1602;4346
355350;201602;1251;4257;1016;3727;249;1002;269;949;518;1951
355360;201602;1047;3340;948;3142;143;492;625;2136;768;2628
355365;201602;247;727;169;594;35;130;45;153;80;283
355370;201602;7415;18200;5403;15719;1447;4546;2101;6512;3548;11058
355380;201602;3119;9391;2460;7948;530;1881;504;1350;1034;3231
355385;201602;798;2532;736;2437;276;998;195;576;471;1574
355390;201602;814;2324;621;1935;138;482;224;600;362;1082
355395;201602;1846;5548;1386;4512;215;730;562;1710;777;2440
355400;201602;8495;27955;7379;25650;2196;8282;2043;6834;4239;15116
355410;201602;15127;49471;12239;43716;3667;14370;2188;7937;5855;22307
355420;201602;700;2511;651;2411;204;834;159;595;363;1429
355430;201602;3286;9238;2727;8288;520;1697;1343;3939;1863;5636
355440;201602;881;2717;675;2270;119;420;190;581;309;1001
355450;201602;3559;10172;2075;6903;362;1236;554;1742;916;2978
355460;201602;573;1568;382;1221;74;287;108;272;182;559
355465;201602;326;1066;281;982;55;208;69;241;124;449
355470;201602;707;2208;584;1965;119;440;259;843;378;1283
355475;201602;146;519;136;492;32;121;68;239;100;360
355480;201602;2660;9305;2443;8896;577;2275;1131;4039;1708;6314
355490;201602;933;2681;607;2005;111;378;129;395;240;773
355495;201602;693;2321;609;2135;117;437;186;634;303;1071
355500;201602;7200;20806;4804;15704;780;2814;791;2438;1571;5252
355510;201602;1945;5203;1109;3528;151;572;323;915;474;1487
355520;201602;409;960;214;585;30;96;89;216;119;312
355530;201602;402;958;168;525;17;62;26;68;43;130
355535;201602;641;1966;513;1729;147;567;109;301;256;868
355540;201602;7751;24468;7300;23740;1880;6511;3653;11528;5533;18039
355550;201602;673;2049;579;1912;125;489;260;844;385;1333
355560;201602;1187;3549;771;2632;146;567;71;174;217;741
355570;201602;178;554;120;433;18;68;10;36;28;104
355580;201602;1233;3449;854;2673;154;553;307;947;461;1500
355590;201602;219;574;173;494;25;83;91;246;116;329
355600;201602;1054;3234;881;2884;274;968;248;765;522;1733
355610;201602;1327;3739;1133;3415;206;691;507;1489;713;2180
355620;201602;3716;11636;3020;10116;515;1972;1333;4149;1848;6121
355630;201602;3170;9085;2028;6787;375;1350;474;1551;849;2901
355635;201602;852;2806;738;2620;89;366;489;1756;578;2122
355640;201602;2833;8997;2084;7486;335;1347;211;718;546;2065
355645;201602;3041;10441;2725;9934;464;1888;1561;5663;2025;7551
355650;201602;6336;19232;5420;17575;857;3243;3143;9551;4000;12794
355660;201602;1165;3702;946;3262;191;790;372;1201;563;1991
355670;201602;2381;7279;1737;5877;320;1260;720;2159;1040;3419
355680;201602;1569;5176;1159;4199;306;1187;177;622;483;1809
355690;201602;415;1302;310;1125;180;691;19;58;199;749
355695;201602;276;863;163;562;9;31;9;18;18;49
355700;201602;5000;16481;4264;14846;1036;3781;1523;5140;2559;8921
355710;201602;9764;24154;5838;17045;1316;4109;1319;3602;2635;7711
355715;201602;280;847;185;635;41;148;30;97;71;245
355720;201602;1486;4925;1236;4372;339;1298;337;1065;676;2363
355730;201602;750;2481;628;2205;197;702;134;473;331;1175
410010;201602;1331;4151;1152;3773;238;847;235;756;473;1603
410020;201602;1107;3643;971;3346;250;899;382;1314;632;2213
410030;201602;1108;3766;931;3323;206;793;152;524;358;1317
410040;201602;9051;29856;7928;27680;1964;7634;2187;7604;4151;15238
410045;201602;981;2769;693;2220;149;515;153;458;302;973
410050;201602;2441;6761;1565;5044;394;1333;123;324;517;1657
410060;201602;2170;6674;1922;6207;438;1477;817;2694;1255;4171
410070;201602;1618;4582;1246;3874;382;1299;250;721;632;2020
410080;201602;1315;3749;1055;3284;173;619;452;1306;625;1925
410090;201602;942;2976;878;2843;217;782;269;876;486;1658
410100;201602;2622;7971;2003;6552;433;1592;199;587;632;2179
410105;201602;355;1109;241;840;38;164;26;78;64;242
410110;201602;2625;7699;2131;6762;346;1215;644;2018;990;3233
410115;201602;498;1345;392;1152;59;181;123;331;182;512
410120;201602;2343;8110;2185;7826;712;2718;734;2656;1446;5374
410130;201602;1027;3248;952;3062;401;1318;206;637;607;1955
410140;201602;16119;42269;11026;33288;2272;7510;2750;8058;5022;15568
410150;201602;16159;40438;8517;25426;1586;5116;1178;3194;2764;8310
410160;201602;2851;8791;2573;8322;674;2433;875;2855;1549;5288
410165;201602;700;2043;554;1718;128;407;212;611;340;1018
410170;201602;2112;6109;1655;5139;456;1589;260;764;716;2353
410180;201602;9598;30522;8295;27755;2015;7281;2925;9127;4940;16408
410185;201602;522;1462;407;1249;94;291;85;234;179;525
410190;201602;1986;5855;1575;4932;302;1035;246;709;548;1744
410200;201602;3614;10144;2701;8381;547;1934;319;932;866;2866
410210;201602;2439;7242;1820;5908;304;1168;362;959;666;2127
410220;201602;623;1747;464;1454;79;292;135;407;214;699
410230;201602;1306;4104;1130;3765;261;988;415;1362;676;2350
410240;201602;4097;12541;3733;11781;1207;4311;563;1673;1770;5984
410250;201602;2552;7068;1798;5525;427;1429;320;922;747;2351
410260;201602;1463;4372;1215;3938;287;1003;448;1434;735;2437
410270;201602;521;1453;389;1188;55;180;141;404;196;584
410275;201602;800;2440;567;1905;75;283;264;888;339;1171
410280;201602;2163;6283;1627;5228;334;1227;440;1334;774;2561
410290;201602;3276;9803;2773;8849;660;2228;1028;3313;1688;5541
410300;201602;679;1899;574;1682;96;309;242;629;338;938
410302;201602;398;1071;257;820;28;93;126;423;154;516
410304;201602;1182;3795;1071;3559;297;1017;375;1312;672;2329
410305;201602;1743;4783;1468;4325;326;1057;757;2217;1083;3274
410310;201602;2149;6951;1949;6598;429;1618;708;2419;1137;4037
410315;201602;624;1818;406;1381;73;258;104;336;177;594
410320;201602;1173;3565;765;2617;97;378;64;195;161;573
410322;201602;515;1508;338;1123;61;210;71;230;132;440
410330;201602;1334;3656;1093;3200;236;734;283;826;519;1560
410335;201602;916;2714;789;2480;149;501;303;915;452;1416
410337;201602;786;2056;580;1675;80;276;195;497;275;773
410340;201602;498;1488;346;1089;43;152;129;359;172;511
410345;201602;1695;4892;1201;3828;267;918;288;886;555;1804
410347;201602;680;1862;480;1476;65;230;140;412;205;642
410350;201602;1003;3006;739;2468;152;559;112;322;264;881
410360;201602;3452;9590;2750;8353;447;1581;1284;3777;1731;5358
410370;201602;11381;33289;8404;26369;1498;5271;2196;5958;3694;11229
410380;201602;1214;3600;1092;3344;137;509;526;1559;663;2068
410390;201602;2385;7160;1961;6261;586;1998;472;1370;1058;3368
410395;201602;840;2793;742;2580;187;737;306;1055;493;1792
410400;201602;4207;12984;3604;11854;765;2841;1300;4125;2065;6966
410405;201602;828;2421;672;2137;155;537;216;696;371;1233
410410;201602;1221;3845;1176;3784;340;1305;473;1410;813;2715
410420;201602;6502;21081;5367;18528;1326;4938;667;1988;1993;6926
410425;201602;2743;8694;1991;7025;330;1227;174;603;504;1830
410430;201602;13711;37062;10061;30393;1960;6492;2768;8061;4728;14553
410440;201602;2692;8637;2413;8099;645;2396;909;2982;1554;5378
410442;201602;2576;8634;2274;7943;677;2431;592;2121;1269;4552
410445;201602;2207;7351;1927;6851;511;2041;566;2093;1077;4134
410450;201602;2025;5755;1577;4883;422;1363;160;405;582;1768
410460;201602;1889;5601;1495;4843;389;1289;313;977;702;2266
410465;201602;1930;6387;1631;5750;358;1385;586;1946;944;3331
410470;201602;1644;5300;1364;4706;285;1134;313;1066;598;2200
410480;201602;28219;79769;18404;59204;3312;11411;1803;5064;5115;16475
410490;201602;10349;32470;8126;27824;1884;7206;1892;5951;3776;13157
410500;201602;1479;4691;1204;4070;429;1619;249;791;678;2410
410510;201602;2335;6207;1670;4900;302;897;594;1591;896;2488
410520;201602;2968;10336;2804;10008;840;3176;1056;3818;1896;6994
410530;201602;1472;4051;1071;3233;196;642;272;775;468;1417
410540;201602;2923;8695;2053;6848;414;1415;562;1883;976;3298
410550;201602;5755;16635;4031;12923;731;2599;504;1480;1235;4079
410560;201602;1162;3452;889;2897;197;734;238;662;435;1396
410570;201602;2507;8081;2265;7669;647;2384;688;2612;1335;4996
410580;201602;19763;59882;16204;52840;3997;14391;4186;12780;8183;27171
410590;201602;1335;4159;859;2910;114;382;155;482;269;864
410600;201602;1767;5189;1432;4539;353;1126;491;1590;844;2716
410610;201602;746;2103;582;1780;81;275;203;606;284;881
410620;201602;1630;5559;1224;4568;299;1227;118;425;417;1652
410630;201602;2392;7063;1713;5554;396;1408;213;574;609;1982
410640;201602;4313;11933;3216;9845;796;2837;476;1352;1272;4189
410645;201602;1084;3802;1025;3712;484;1842;209;810;693;2652
410650;201602;2015;6257;1636;5468;515;1817;212;673;727;2490
410655;201602;802;2300;616;1940;116;425;196;589;312;1014
410657;201602;711;1972;511;1565;86;301;164;435;250;736
410660;201602;2543;7446;1558;5217;326;1175;158;474;484;1649
410670;201602;867;2379;594;1813;111;362;157;428;268;790
410680;201602;2786;9123;2285;7916;655;2198;628;2360;1283;4558
410685;201602;612;1770;532;1636;44;142;373;1166;417;1308
410690;201602;108534;313170;77383;248900;15478;54945;16299;46056;31777;101001
410700;201602;2150;6547;1974;6214;514;1735;789;2387;1303;4122
410710;201602;870;2582;603;2002;136;464;136;398;272;862
410712;201602;782;2356;670;2139;238;817;172;581;410;1398
410715;201602;878;2799;655;2259;114;435;181;584;295;1019
410720;201602;3239;9512;2379;7723;478;1768;474;1389;952;3157
410725;201602;1009;2883;721;2312;104;327;98;278;202;605
410730;201602;494;1388;402;1245;124;418;89;297;213;715
410740;201602;892;2641;645;2145;100;379;262;867;362;1246
410750;201602;1736;5083;1431;4445;295;990;432;1275;727;2265
410752;201602;284;782;152;499;32;112;40;115;72;227
410753;201602;409;1186;256;829;33;124;73;217;106;341
410754;201602;1021;3046;881;2804;63;203;565;1898;628;2101
410755;201602;777;1955;596;1670;93;283;311;836;404;1119
410760;201602;2280;6940;1978;6394;525;1862;547;1739;1072;3601
410765;201602;14910;44369;11289;37314;1805;6777;883;2692;2688;9469
410770;201602;887;2460;643;1978;167;577;109;318;276;895
410773;201602;1262;3644;1097;3393;185;657;639;1921;824;2578
410775;201602;1357;3924;1251;3778;296;994;449;1330;745;2324
410780;201602;519;1435;369;1159;89;281;114;407;203;688
410785;201602;721;2290;609;2034;197;718;114;368;311;1086
410790;201602;405;1310;364;1212;78;280;42;99;120;379
410800;201602;2690;6726;2093;5723;377;1225;725;1796;1102;3021
410810;201602;325;1009;274;903;55;204;99;328;154;532
410820;201602;804;2417;609;1979;141;504;84;256;225;760
410830;201602;29729;84619;23846;74602;6649;23178;7373;22088;14022;45266
410832;201602;920;2686;800;2452;85;320;447;1298;532;1618
410840;201602;6699;19652;4456;14894;886;3219;308;815;1194;4034
410845;201602;1211;3595;1031;3230;211;728;395;1197;606;1925
410850;201602;2640;7783;2364;7354;516;1787;983;3102;1499;4889
410855;201602;558;1561;403;1239;67;221;129;378;196;599
410860;201602;3768;10601;3018;9204;558;1842;994;2918;1552;4760
410865;201602;1422;4893;1359;4774;356;1348;736;2656;1092;4004
410870;201602;1157;3562;1074;3427;232;788;638;2067;870;2855
410880;201602;3507;11203;2961;10077;589;2211;509;1675;1098;3886
410890;201602;858;2815;689;2464;179;730;63;204;242;934
410895;201602;1048;3615;937;3369;323;1243;203;688;526;1931
410900;201602;882;2408;600;1879;103;362;173;502;276;864
410910;201602;396;1042;300;868;37;119;146;408;183;527
410920;201602;787;2188;631;1926;161;568;197;581;358;1149
410930;201602;1550;4585;1317;4135;316;1167;403;1246;719;2413
410940;201602;19787;63764;17004;58686;5074;19044;3943;13818;9017;32862
410950;201602;1656;5484;1542;5275;211;767;1069;3658;1280;4425
410960;201602;6933;19212;4400;14421;1269;4573;776;2409;2045;6982
410965;201602;997;3060;839;2758;222;751;326;1075;548;1826
410970;201602;4320;12720;3397;10935;924;3423;558;1732;1482;5155
410975;201602;1561;4511;1249;3917;220;798;433;1306;653;2104
410980;201602;5507;15460;3498;11467;673;2467;623;1944;1296;4411
410990;201602;883;2565;549;1850;165;616;53;138;218;754
411000;201602;477;1431;356;1161;66;247;71;189;137;436
411005;201602;466;1396;290;969;64;239;25;68;89;307
411007;201602;2191;6888;1886;6237;538;1880;513;1676;1051;3556
411010;201602;3772;12964;3404;12149;876;3455;444;1519;1320;4974
411020;201602;2433;7555;2133;7050;676;2485;639;2070;1315;4555
411030;201602;631;1710;449;1352;73;245;101;282;174;527
411040;201602;642;1866;300;1017;48;175;56;200;104;375
411050;201602;1930;6670;1730;6236;496;1966;238;769;734;2735
411060;201602;1423;4354;1148;3758;223;838;122;351;345;1189
411065;201602;350;1031;277;888;53;173;91;289;144;462
411070;201602;5546;16591;4347;14167;1142;4119;832;2454;1974;6573
411080;201602;2095;6269;1862;5841;453;1583;419;1242;872;2825
411090;201602;784;1922;545;1555;70;255;111;294;181;549
411095;201602;1412;4025;1084;3350;160;577;275;758;435;1335
411100;201602;1281;3734;939;3020;157;627;144;408;301;1035
411110;201602;567;1675;318;1078;36;135;31;85;67;220
411120;201602;1577;4763;1191;3920;299;1115;351;1067;650;2182
411125;201602;3951;13015;3776;12677;1098;3895;1381;4584;2479;8479
411130;201602;676;2025;511;1664;110;380;132;472;242;852
411140;201602;2058;7106;1765;6417;510;1932;576;2177;1086;4109
411150;201602;3972;11183;3033;9334;652;2167;389;1058;1041;3225
411155;201602;883;2419;656;2001;97;335;259;761;356;1096
411160;201602;210;605;166;525;33;107;33;94;66;201
411170;201602;633;2018;540;1802;128;478;174;548;302;1026
411180;201602;5352;16005;4411;14232;980;3509;1385;4472;2365;7981
411190;201602;1333;3852;1111;3430;275;968;224;604;499;1572
411200;201602;4121;12156;3302;10727;803;2945;1040;3212;1843;6157
411210;201602;1875;5399;1499;4721;401;1389;156;432;557;1821
411220;201602;1084;3080;865;2684;212;765;284;766;496;1531
411230;201602;1205;3352;766;2481;168;584;196;604;364;1188
411240;201602;1366;3277;764;2259;131;404;229;630;360;1034
411250;201602;2104;6209;1759;5579;486;1691;420;1339;906;3030
411260;201602;290;804;194;634;24;83;73;223;97;306
411270;201602;1664;5216;1476;4865;258;993;633;1980;891;2973
411275;201602;1269;3776;1034;3254;256;845;202;595;458;1440
411280;201602;1421;4168;988;3245;182;654;148;446;330;1100
411290;201602;714;2088;545;1735;135;448;138;427;273;875
411295;201602;930;2629;831;2436;156;489;300;904;456;1393
411300;201602;1174;2981;837;2355;81;256;323;839;404;1095
411310;201602;806;2200;635;1921;73;253;201;601;274;854
411320;201602;5272;15239;3917;12711;983;3366;661;1931;1644;5297
411325;201602;1478;4673;1300;4294;273;968;620;2074;893;3042
411330;201602;2977;9222;2528;8363;800;2948;582;1942;1382;4890
411340;201602;899;2639;578;1887;54;213;189;579;243;792
411342;201602;680;1930;562;1698;159;513;168;456;327;969
411345;201602;854;2693;766;2529;208;763;307;1004;515;1767
411350;201602;2602;7825;1922;6418;490;1818;178;569;668;2387
411360;201602;555;1396;379;1095;48;171;161;401;209;572
411370;201602;42833;120785;33784;104207;5517;19588;13367;38240;18884;57828
411373;201602;1406;4381;1220;4042;263;985;259;858;522;1843
411375;201602;1092;3011;805;2454;156;488;189;541;345;1029
411380;201602;1183;3226;715;2156;115;362;186;507;301;869
411390;201602;1779;5264;1492;4689;282;993;434;1241;716;2234
411400;201602;1997;5706;1517;4699;267;918;377;1097;644;2015
411410;201602;1945;5856;1511;4874;318;1138;347;974;665;2112
411420;201602;3800;10907;2669;8443;374;1327;370;929;744;2256
411430;201602;2961;8949;2479;8154;633;2312;1093;3522;1726;5834
411435;201602;424;1401;357;1231;83;311;131;441;214;752
411440;201602;2557;8253;2303;7757;737;2603;503;1824;1240;4427
411450;201602;2167;6662;1970;6287;399;1281;968;3232;1367;4513
411460;201602;3151;9180;1734;5954;272;1058;81;258;353;1316
411470;201602;801;2400;549;1809;71;246;76;227;147;473
411480;201602;4268;12823;3221;10826;816;3052;436;1371;1252;4423
411490;201602;1382;4197;1167;3816;230;827;262;776;492;1603
411500;201602;1794;4756;1257;3804;254;834;323;957;577;1791
411510;201602;1940;5855;1605;5163;446;1586;245;719;691;2305
411520;201602;25100;68333;15479;48372;2698;9144;2949;8690;5647;17834
411530;201602;995;2764;711;2273;156;577;117;319;273;896
411535;201602;499;1522;271;976;31;136;22;69;53;205
411540;201602;2869;7804;2122;6293;529;1799;508;1318;1037;3117
411545;201602;924;3090;844;2945;150;559;513;1844;663;2403
411550;201602;769;2083;625;1863;209;682;118;361;327;1043
411560;201602;2274;6771;1663;5387;285;1055;167;458;452;1513
411570;201602;6338;16953;4726;14365;1102;3831;908;2863;2010;6694
411573;201602;821;2461;770;2371;136;435;451;1425;587;1860
411575;201602;1464;4542;1229;4039;233;817;424;1383;657;2200
411580;201602;3797;10780;2565;8319;319;1233;336;964;655;2197
411585;201602;701;2259;387;1363;84;306;60;203;144;509
411590;201602;343;1055;301;988;45;167;130;404;175;571
411600;201602;295;852;205;707;44;172;74;262;118;434
411605;201602;1624;4467;1141;3494;180;625;391;1175;571;1800
411610;201602;2055;5745;1719;5175;348;1152;811;2356;1159;3508
411620;201602;2513;7966;2314;7639;632;2276;1012;3373;1644;5649
411630;201602;469;1216;289;947;51;210;36;105;87;315
411640;201602;440;1340;352;1148;55;184;107;312;162;496
411650;201602;190;625;151;548;27;117;32;114;59;231
411660;201602;835;2289;656;1959;112;362;284;832;396;1194
411670;201602;1066;2995;878;2596;184;589;287;809;471;1398
411680;201602;1342;4129;1203;3875;179;610;744;2485;923;3095
411690;201602;3182;9380;2516;8133;647;2181;487;1653;1134;3834
411695;201602;759;2473;614;2151;138;539;180;625;318;1164
411700;201602;1668;4871;1178;3868;213;767;168;495;381;1262
411705;201602;1838;6376;1614;5928;363;1309;787;3089;1150;4398
411710;201602;1574;4658;1278;4045;312;1067;210;657;522;1724
411720;201602;834;2357;644;1976;92;305;175;490;267;795
411721;201602;686;2055;571;1824;146;507;60;178;206;685
411722;201602;638;1908;434;1456;80;319;101;283;181;602
411725;201602;1347;4322;869;3098;188;701;141;502;329;1203
411727;201602;1758;5195;1332;4271;317;1078;256;801;573;1879
411729;201602;552;1465;396;1178;121;368;66;173;187;541
411730;201602;5388;15487;4503;13793;1640;5084;1060;3259;2700;8343
411740;201602;607;1750;404;1287;67;230;126;380;193;610
411745;201602;860;2482;709;2177;131;425;219;672;350;1097
411750;201602;4575;13623;3488;11173;720;2535;953;2927;1673;5462
411760;201602;7420;21761;6382;19991;2056;6908;1465;4659;3521;11567
411770;201602;3245;10704;2710;9482;777;2955;470;1565;1247;4520
411780;201602;2566;8133;2433;7926;376;1323;1503;5109;1879;6432
411790;201602;3135;8913;2275;7157;601;2122;521;1555;1122;3677
411800;201602;1128;3255;779;2519;116;423;109;314;225;737
411810;201602;1546;4478;1274;3933;262;878;422;1214;684;2092
411820;201602;12959;41891;10971;37796;3776;13504;2330;8226;6106;21730
411830;201602;511;1353;410;1189;123;400;14;61;137;461
411840;201602;9928;28494;7449;23737;1650;5755;1252;3942;2902;9697
411845;201602;488;1486;313;1031;42;145;45;130;87;275
411850;201602;6664;19983;5497;17564;1335;4625;1346;4208;2681;8833
411860;201602;845;2607;680;2253;165;580;206;657;371;1237
411870;201602;833;2707;573;1999;109;448;99;303;208;751
411880;201602;2183;6324;1762;5585;410;1500;352;1020;762;2520
411885;201602;835;2299;696;2053;128;471;200;532;328;1003
411890;201602;1031;3155;694;2342;103;398;51;131;154;529
411900;201602;934;2943;675;2325;153;535;93;326;246;861
411910;201602;1147;3764;898;3181;253;970;193;624;446;1594
411915;201602;15137;41575;9868;31152;1775;6072;1905;5510;3680;11582
411920;201602;820;2784;717;2541;180;756;76;210;256;966
411925;201602;589;1670;390;1287;86;284;90;270;176;554
411930;201602;5785;18890;5118;17597;2198;8032;819;2820;3017;10852
411940;201602;3121;10431;2721;9565;663;2437;562;1933;1225;4370
411950;201602;11479;36339;9760;33024;2333;8410;4111;13722;6444;22132
411960;201602;5207;15523;4814;14803;1061;3646;1924;5788;2985;9434
411965;201602;564;1606;404;1331;71;280;117;403;188;683
411970;201602;711;1999;591;1815;182;608;193;636;375;1244
411980;201602;1598;4806;1391;4399;290;975;445;1416;735;2391
411990;201602;27395;88549;23122;79547;5889;22399;6069;20207;11958;42606
411995;201602;2307;7111;1965;6479;608;2237;391;1191;999;3428
412000;201602;2041;5293;1595;4525;246;820;751;1946;997;2766
412010;201602;678;2290;546;1996;78;285;110;387;188;672
412015;201602;628;1865;513;1626;96;318;228;732;324;1050
412020;201602;352;1026;239;776;48;169;64;191;112;360
412030;201602;692;2161;500;1729;73;273;115;384;188;657
412033;201602;738;2168;512;1638;83;299;111;335;194;634
412035;201602;943;2644;634;2079;142;491;197;653;339;1144
412040;201602;559;1757;440;1495;80;289;97;320;177;609
412050;201602;1674;4848;1279;4082;218;767;283;869;501;1636
412060;201602;6617;22642;6039;21473;1883;7240;1641;5755;3524;12995
412065;201602;789;2363;617;2007;125;454;156;457;281;911
412070;201602;1301;3504;961;2803;150;466;315;914;465;1380
412080;201602;1331;4129;811;2927;93;386;16;60;109;446
412085;201602;410;1186;151;525;27;101;19;56;46;157
412090;201602;4201;13267;3947;12821;702;2423;2196;7320;2898;9743
412100;201602;1841;5705;1517;5072;428;1577;350;1163;778;2740
412110;201602;1034;2915;697;2214;154;516;115;377;269;893
412120;201602;1623;5488;1402;4998;363;1430;422;1325;785;2755
412125;201602;612;2001;561;1905;127;475;194;631;321;1106
412130;201602;580;1728;430;1386;101;358;63;183;164;541
412135;201602;449;1276;311;996;70;238;95;292;165;530
412140;201602;1495;4508;1253;4000;276;937;232;700;508;1637
412150;201602;2788;8069;2409;7301;301;1049;1449;4295;1750;5344
412160;201602;1121;3582;718;2535;173;670;79;249;252;919
412170;201602;4376;13483;3583;11951;930;3382;1217;3853;2147;7235
412175;201602;1327;4468;1156;4094;279;1103;463;1616;742;2719
412180;201602;1569;4832;1175;4078;256;1024;324;1059;580;2083
412190;201602;3100;8846;2339;7485;523;1862;652;2201;1175;4063
412200;201602;2043;6532;1472;5054;285;1052;413;1421;698;2473
412210;201602;665;1823;399;1273;54;198;30;73;84;271
412215;201602;3509;10781;3161;10169;704;2261;1737;5797;2441;8058
412217;201602;1040;2946;917;2735;116;420;595;1672;711;2092
412220;201602;5363;17681;5139;17275;1497;5175;2430;8240;3927;13415
412230;201602;2654;8759;2314;8088;472;1877;640;2105;1112;3982
412240;201602;8490;21496;4892;14870;834;2825;803;2206;1637;5031
412250;201602;1800;5299;1542;4799;407;1352;192;514;599;1866
412260;201602;1254;3464;827;2569;118;415;272;752;390;1167
412265;201602;969;2974;852;2774;212;786;348;1125;560;1911
412270;201602;803;2536;534;1855;97;374;133;425;230;799
412280;201602;589;1826;435;1494;184;683;24;75;208;758
412290;201602;981;2823;760;2404;137;472;229;662;366;1134
412300;201602;1828;5523;1543;4977;403;1436;311;951;714;2387
412310;201602;1001;2906;881;2719;119;436;434;1377;553;1813
412320;201602;821;2200;595;1806;103;373;193;570;296;943
412330;201602;1472;4228;1130;3510;189;658;502;1537;691;2195
412340;201602;896;2780;603;2034;72;268;84;246;156;514
412350;201602;2080;6491;1682;5619;335;1186;110;311;445;1497
412360;201602;281;841;176;574;21;80;53;145;74;225
412370;201602;867;2559;648;2161;149;548;125;413;274;961
412380;201602;1427;4585;1185;3995;289;1031;245;831;534;1862
412382;201602;657;1842;459;1432;76;242;98;267;174;509
412385;201602;2260;7131;2028;6600;667;2282;375;1201;1042;3483
412390;201602;2033;5831;1820;5485;463;1520;686;2142;1149;3662
412395;201602;779;2247;619;1981;71;262;341;1063;412;1325
412400;201602;866;2745;750;2487;201;720;157;532;358;1252
412402;201602;1766;5264;1436;4600;316;1134;273;795;589;1929
412405;201602;3478;10164;2228;7400;344;1310;140;416;484;1726
412410;201602;4604;14128;3811;12617;1054;4071;635;1974;1689;6045
412420;201602;323;961;233;749;37;126;73;193;110;319
412430;201602;514;1440;380;1185;52;176;134;390;186;566
412440;201602;3140;9584;2520;8467;546;2008;730;2499;1276;4507
412450;201602;301;961;230;778;34;105;16;38;50;143
412460;201602;696;2165;576;1901;161;578;106;334;267;912
412470;201602;1822;6243;1583;5619;522;1968;327;1210;849;3178
412480;201602;1076;3289;805;2636;133;462;86;223;219;685
412490;201602;820;2423;693;2168;124;401;181;551;305;952
412500;201602;1861;5403;1559;4814;291;1012;348;944;639;1956
412510;201602;2166;7057;1804;6183;511;1881;572;1941;1083;3822
412520;201602;1437;4068;1080;3339;240;775;190;546;430;1321
412530;201602;574;1691;445;1390;85;277;90;256;175;533
412535;201602;671;1956;449;1427;91;303;90;263;181;566
412540;201602;1212;3480;960;2982;139;501;267;826;406;1327
412545;201602;742;2125;563;1734;89;315;158;406;247;721
412550;201602;27788;83238;19458;64737;4350;15513;3440;10742;7790;26255
412555;201602;255;775;174;586;31;106;35;103;66;209
412560;201602;4929;15074;3875;12860;719;2856;1045;3277;1764;6133
412570;201602;4054;11949;2787;9210;603;2222;442;1492;1045;3714
412575;201602;826;2543;640;2095;135;500;151;437;286;937
412580;201602;1160;3234;836;2627;142;468;256;747;398;1215
412590;201602;393;1150;262;859;52;199;66;212;118;411
412600;201602;1383;4211;1074;3547;217;790;271;828;488;1618
412610;201602;682;2028;449;1441;119;403;103;298;222;701
412620;201602;1176;3748;932;3217;208;830;131;382;339;1212
412625;201602;9383;26838;7123;22466;1425;4838;828;2491;2253;7329
412627;201602;890;2777;636;2182;177;670;52;161;229;831
412630;201602;3165;10048;2571;8751;516;1794;706;2332;1222;4126
412635;201602;462;1372;323;1063;75;253;11;25;86;278
412640;201602;878;2657;595;1997;81;270;38;114;119;384
412650;201602;1661;4970;1396;4457;282;1038;378;1084;660;2122
412660;201602;2632;7637;2077;6514;404;1398;363;1018;767;2416
412665;201602;622;1622;350;1090;90;285;67;199;157;484
412667;201602;1615;4708;1279;4055;295;1013;234;661;529;1674
412670;201602;512;1610;398;1364;97;371;61;187;158;558
412680;201602;1303;3920;822;2841;128;481;156;488;284;969
412690;201602;746;2261;557;1848;157;547;99;322;256;869
412700;201602;1783;5473;1504;5041;512;1950;375;1204;887;3154
412710;201602;6712;21123;5695;19071;1215;4550;1239;3826;2454;8376
412720;201602;1315;4065;939;3139;143;514;154;423;297;937
412730;201602;1977;5973;1222;4237;228;844;99;295;327;1139
412740;201602;1346;4287;1023;3580;230;897;137;530;367;1427
412750;201602;3900;11931;3474;11224;503;1966;2048;6471;2551;8437
412760;201602;2194;7080;2065;6857;422;1632;1124;3584;1546;5216
412770;201602;10581;28982;6169;19709;855;2986;979;2739;1834;5725
412780;201602;1218;3806;1054;3467;231;827;351;1113;582;1940
412785;201602;2239;6410;1679;5251;472;1537;680;2152;1152;3689
412788;201602;1335;4271;1171;3927;281;1066;347;1055;628;2121
412790;201602;1084;3224;805;2633;151;562;155;421;306;983
412795;201602;890;2494;724;2175;147;463;245;731;392;1194
412796;201602;2607;8047;2396;7661;570;2036;883;2637;1453;4673
412800;201602;2879;8355;2281;7066;369;1278;766;2253;1135;3531
412810;201602;10685;29062;6275;19662;796;2793;1245;3216;2041;6009
412820;201602;6993;20514;5207;17024;1149;4022;1099;3667;2248;7689
412830;201602;331;1031;265;874;40;155;72;210;112;365
412840;201602;1710;4943;1379;4255;256;858;249;754;505;1612
412850;201602;2767;8178;2307;7414;466;1752;801;2403;1267;4155
412853;201602;1628;4683;1443;4316;157;573;763;2117;920;2690
412855;201602;1418;4094;1114;3430;238;808;276;743;514;1551
412860;201602;1158;3330;951;2961;242;836;364;1118;606;1954
412862;201602;686;1808;481;1436;68;228;133;372;201;600
412863;201602;1135;3902;1105;3850;181;707;742;2539;923;3246
412865;201602;668;2038;509;1687;112;393;162;560;274;953
412870;201602;838;2391;665;2097;243;858;85;242;328;1100
412880;201602;856;2501;674;2143;157;535;102;294;259;829
420005;201602;523;1561;331;1128;52;183;108;364;160;547
420010;201602;2948;8538;2433;7817;364;1213;1623;5325;1987;6538
420020;201602;731;2375;417;1547;38;171;30;91;68;262
420030;201602;497;1296;253;841;45;179;25;85;70;264
420040;201602;693;2206;448;1682;86;355;28;87;114;442
420050;201602;649;1900;442;1473;132;464;129;428;261;892
420055;201602;207;633;121;423;21;79;18;61;39;140
420060;201602;237;775;161;590;25;114;27;73;52;187
420070;201602;1329;4202;1015;3441;164;637;381;1276;545;1913
420075;201602;168;445;89;271;17;57;15;38;32;95
420080;201602;578;1823;462;1599;149;555;101;350;250;905
420090;201602;468;1551;326;1242;76;310;52;209;128;519
420100;201602;1164;3655;1040;3483;248;869;560;1895;808;2764
420110;201602;317;1072;286;1000;66;244;101;348;167;592
420120;201602;254;888;207;778;66;277;37;128;103;405
420125;201602;236;883;209;822;60;246;82;303;142;549
420127;201602;530;1569;207;766;51;201;19;70;70;271
420130;201602;1715;5777;1405;5193;331;1337;282;957;613;2294
420140;201602;4416;13014;3133;10527;662;2475;404;1200;1066;3675
420150;201602;711;1985;430;1431;75;270;136;418;211;688
420160;201602;270;743;164;536;26;87;46;148;72;235
420165;201602;211;661;126;442;26;100;22;70;48;170
420170;201602;192;590;129;466;42;174;12;39;54;213
420180;201602;398;1215;222;807;38;148;38;135;76;283
420190;201602;449;1281;235;802;32;125;15;42;47;167
420195;201602;1244;3667;1024;3308;236;807;315;999;551;1806
420200;201602;2410;7557;1418;5254;245;1051;129;445;374;1496
420205;201602;880;2906;756;2705;175;671;377;1370;552;2041
420207;201602;1482;4325;1042;3426;281;1053;204;612;485;1665
420208;201602;553;1536;302;1086;91;354;70;273;161;627
420209;201602;314;961;204;701;32;121;75;254;107;375
420210;201602;1545;4763;1034;3921;263;1188;298;1084;561;2272
420213;201602;773;2770;731;2668;157;605;412;1521;569;2126
420215;201602;314;1030;205;767;48;202;16;69;64;271
420220;201602;153;538;124;474;30;124;26;88;56;212
420230;201602;4138;12009;3048;10076;585;2311;1171;3721;1756;6032
420240;201602;10228;28351;6381;21099;1011;4004;2370;7041;3381;11045
420243;201602;590;1792;468;1548;90;323;162;522;252;845
420245;201602;1078;3271;751;2579;121;456;214;681;335;1137
420250;201602;515;1657;469;1572;127;503;193;615;320;1118
420253;201602;482;1306;372;1157;56;182;205;661;261;843
420257;201602;305;851;194;646;36;123;91;305;127;428
420260;201602;1194;3766;978;3371;201;771;378;1303;579;2074
420270;201602;569;1738;198;707;30;123;44;138;74;261
420280;201602;2238;6042;1365;4473;274;995;435;1358;709;2353
420285;201602;153;447;73;270;8;33;4;16;12;49
420287;201602;506;1514;420;1379;131;437;122;408;253;845
420290;201602;6031;17909;4027;13309;735;2628;1069;3300;1804;5928
420300;201602;6396;19319;4236;14730;863;3281;638;2158;1501;5439
420310;201602;746;2071;666;1946;107;338;464;1329;571;1667
420315;201602;908;2888;713;2518;190;733;237;829;427;1562
420320;201602;4627;14181;3772;12678;991;3622;1353;4556;2344;8178
420325;201602;230;786;208;728;42;165;75;249;117;414
420330;201602;944;3278;697;2653;168;703;153;531;321;1234
420340;201602;1404;4362;1077;3619;202;758;118;347;320;1105
420350;201602;1416;4251;1044;3525;276;982;338;1142;614;2124
420360;201602;2980;9047;1864;6631;374;1504;137;403;511;1907
420370;201602;1784;5107;1379;4390;157;515;968;3074;1125;3589
420380;201602;4927;15203;3347;11580;771;2913;701;2399;1472;5312
420390;201602;1357;3797;703;2422;105;427;101;282;206;709
420395;201602;1361;4180;947;3251;125;494;125;377;250;871
420400;201602;1238;3591;869;2876;217;829;183;536;400;1365
420410;201602;743;1983;517;1610;114;403;289;875;403;1278
420415;201602;452;1412;329;1120;95;346;90;296;185;642
420417;201602;686;2214;573;1937;100;347;287;979;387;1326
420419;201602;364;1100;236;845;80;322;17;70;97;392
420420;201602;10321;31095;8219;27078;2735;10007;1831;5576;4566;15583
420425;201602;1205;3253;833;2556;72;293;360;1032;432;1325
420430;201602;3187;9705;2040;7009;410;1533;607;2106;1017;3639
420435;201602;291;856;179;610;41;153;70;225;111;378
420440;201602;859;2671;499;1750;203;753;81;281;284;1034
420445;201602;363;1074;260;832;49;157;101;328;150;485
420450;201602;777;2354;514;1779;106;404;94;307;200;711
420455;201602;1857;5592;1606;5167;286;1135;730;2227;1016;3362
420460;201602;8346;24276;6285;20647;1356;5138;2196;6856;3552;11994
420470;201602;1041;2827;637;2031;135;484;168;497;303;981
420475;201602;121;356;64;224;16;54;7;23;23;77
420480;201602;4622;13542;3405;11260;967;3450;538;1798;1505;5248
420490;201602;654;1700;356;1197;82;306;74;249;156;555
420500;201602;1509;4778;1165;4104;342;1351;363;1259;705;2610
420510;201602;74;287;63;271;16;74;26;107;42;181
420515;201602;108;363;86;319;13;57;16;59;29;116
420517;201602;802;2531;704;2363;117;432;356;1155;473;1587
420519;201602;544;1423;391;1156;60;194;104;294;164;488
420520;201602;642;1596;396;1251;86;289;125;334;211;623
420530;201602;996;3309;735;2710;165;696;147;491;312;1187
420535;201602;259;746;139;494;32;125;4;13;36;138
420540;201602;19412;55285;14050;44185;3296;11385;3342;9135;6638;20520
420543;201602;384;1013;298;877;24;81;178;570;202;651
420545;201602;1467;4617;1175;3977;264;1008;343;1083;607;2091
420550;201602;3974;12627;2932;10446;709;2996;476;1555;1185;4551
420555;201602;353;1080;270;909;66;238;80;260;146;498
420560;201602;504;1457;375;1226;70;248;179;573;249;821
420570;201602;2049;6494;1592;5469;401;1580;496;1564;897;3144
420580;201602;1356;4187;1084;3720;262;1027;430;1439;692;2466
420590;201602;3012;9114;2013;6796;371;1392;270;801;641;2193
420600;201602;830;2707;751;2546;117;424;410;1441;527;1865
420610;201602;488;1491;271;1004;66;280;60;218;126;498
420620;201602;524;1620;468;1511;115;401;135;441;250;842
420630;201602;962;2963;676;2293;145;528;208;657;353;1185
420640;201602;760;2298;377;1380;74;301;22;77;96;378
420650;201602;2457;7132;1560;5291;255;994;334;1028;589;2022
420660;201602;453;1305;323;1036;63;223;101;313;164;536
420665;201602;670;1889;429;1424;65;234;108;320;173;554
420670;201602;1581;4691;1109;3705;203;798;266;809;469;1607
420675;201602;194;620;140;494;29;105;37;130;66;235
420680;201602;486;1166;282;849;46;159;89;257;135;416
420690;201602;828;2834;626;2289;94;362;125;407;219;769
420700;201602;2966;8729;2268;7342;463;1709;664;2012;1127;3721
420710;201602;543;1818;413;1546;115;485;118;426;233;911
420720;201602;1672;4770;1300;4288;342;1195;661;2199;1003;3394
420730;201602;3107;9306;2521;8279;610;2203;933;2948;1543;5151
420740;201602;822;2527;675;2257;214;792;245;752;459;1544
420750;201602;2238;7162;1612;5692;259;1062;433;1375;692;2437
420757;201602;95;227;42;142;7;31;18;59;25;90
420760;201602;338;1052;198;669;38;141;36;104;74;245
420765;201602;532;1680;273;1029;50;224;38;134;88;358
420768;201602;1113;3908;864;3370;292;1184;273;1089;565;2273
420770;201602;628;1830;343;1259;76;320;63;231;139;551
420775;201602;627;1895;377;1289;82;298;60;185;142;483
420780;201602;1499;4501;905;3070;181;628;113;353;294;981
420785;201602;269;819;191;627;28;98;41;131;69;229
420790;201602;1251;4282;987;3676;284;1163;334;1166;618;2329
420800;201602;811;2305;411;1377;94;345;85;269;179;614
420810;201602;1961;6627;1547;5728;452;1917;310;1039;762;2956
420820;201602;7707;22879;5256;18732;1271;5130;1117;3934;2388;9064
420830;201602;2445;7751;2023;6979;623;2341;666;2287;1289;4628
420840;201602;987;2930;504;1820;107;453;81;257;188;710
420845;201602;1251;3808;915;3214;241;986;181;591;422;1577
420850;201602;1602;4984;971;3638;209;915;67;232;276;1147
420860;201602;443;1250;272;924;69;268;72;250;141;518
420870;201602;1111;3078;868;2700;292;1055;223;593;515;1648
420880;201602;985;3252;763;2687;150;575;129;407;279;982
420890;201602;10313;27113;5188;17012;830;2968;1107;3181;1937;6149
420895;201602;243;662;134;429;39;125;13;34;52;159
420900;201602;1798;5078;1155;3838;225;882;267;812;492;1694
420910;201602;22652;67162;15441;52816;2842;11012;4176;13171;7018;24183
420915;201602;538;2136;396;1718;84;392;169;691;253;1083
420917;201602;443;1386;210;716;40;160;73;209;113;369
420920;201602;181;508;75;260;11;42;13;48;24;90
420930;201602;17262;49749;13527;43506;3042;10895;4682;14592;7724;25487
420940;201602;2747;8342;2116;7062;566;2078;164;470;730;2548
420945;201602;197;628;129;471;22;101;34;117;56;218
420950;201602;599;1685;281;1043;39;193;33;108;72;301
420960;201602;863;2489;703;2208;140;479;290;860;430;1339
420970;201602;2434;7668;2017;6910;594;2273;539;1808;1133;4081
420980;201602;460;1331;338;1129;114;424;109;402;223;826
420985;201602;494;1411;231;839;44;198;48;149;92;347
420990;201602;879;2367;492;1659;82;308;100;288;182;596
421000;201602;551;1844;354;1340;66;261;56;180;122;441
421003;201602;713;1938;276;926;25;88;33;69;58;157
421005;201602;152;472;114;406;19;80;59;214;78;294
421010;201602;5275;14992;3672;12142;920;3424;685;1997;1605;5421
421020;201602;466;1451;361;1269;40;144;191;703;231;847
421030;201602;692;2541;632;2384;174;714;106;396;280;1110
421040;201602;839;2149;534;1670;95;355;253;750;348;1105
421050;201602;1605;4497;952;3140;163;593;185;525;348;1118
421055;201602;199;579;112;367;26;89;24;66;50;155
421060;201602;476;1622;323;1196;69;285;107;385;176;670
421070;201602;686;2206;441;1583;95;390;69;240;164;630
421080;201602;499;1501;418;1377;85;271;256;856;341;1127
421085;201602;533;1423;294;988;60;232;78;277;138;509
421090;201602;387;1090;197;677;29;110;66;206;95;316
421100;201602;855;2373;486;1557;132;434;58;170;190;604
421105;201602;1406;4331;1153;3899;258;925;387;1377;645;2302
421110;201602;974;3560;888;3360;322;1291;180;634;502;1925
421120;201602;1262;4035;847;3025;126;519;200;656;326;1175
421125;201602;397;1100;295;924;82;299;88;251;170;550
421130;201602;2909;9559;2460;8721;790;3114;740;2651;1530;5765
421140;201602;328;959;245;783;47;149;78;233;125;382
421145;201602;538;1701;336;1158;45;162;102;345;147;507
421150;201602;555;1625;398;1367;75;283;145;491;220;774
421160;201602;1193;3310;584;1939;107;398;190;602;297;1000
421165;201602;274;941;218;781;34;123;88;323;122;446
421170;201602;1271;3736;1021;3346;215;772;570;1856;785;2628
421175;201602;1199;3373;873;2847;192;788;291;830;483;1618
421180;201602;552;1569;300;1033;66;259;50;166;116;425
421185;201602;388;1077;273;857;45;128;125;419;170;547
421187;201602;267;801;198;658;35;120;83;263;118;383
421189;201602;406;1250;355;1149;70;235;114;353;184;588
421190;201602;11292;32303;6882;23473;1327;5022;895;2911;2222;7933
421200;201602;869;2902;743;2643;161;631;196;644;357;1275
421205;201602;241;730;180;614;37;149;36;100;73;249
421210;201602;1486;4542;1110;3666;274;946;226;743;500;1689
421220;201602;1907;6474;1661;5931;479;1916;271;858;750;2774
421223;201602;510;1641;391;1389;100;375;106;371;206;746
421225;201602;1047;3326;888;3008;201;772;313;1053;514;1825
421227;201602;787;2584;699;2447;153;581;392;1357;545;1938
421230;201602;423;1396;375;1311;96;386;160;532;256;918
421240;201602;432;1397;259;941;31;138;37;120;68;258
421250;201602;1670;4841;1087;3813;291;1112;209;734;500;1846
421260;201602;345;987;97;354;21;74;18;64;39;138
421265;201602;675;2105;589;1963;128;465;264;860;392;1325
421270;201602;795;2136;412;1368;80;282;74;285;154;567
421280;201602;1493;4698;1203;4214;342;1357;399;1360;741;2717
421290;201602;1213;3390;725;2375;125;445;110;316;235;761
421300;201602;292;882;230;752;66;247;86;263;152;510
421310;201602;231;731;182;616;35;128;53;168;88;296
421315;201602;360;1055;200;720;38;139;16;58;54;197
421320;201602;523;1661;349;1231;49;178;44;106;93;284
421330;201602;526;1714;405;1485;128;537;67;238;195;775
421335;201602;509;1685;420;1507;99;403;83;316;182;719
421340;201602;1711;4900;1370;4359;193;759;786;2462;979;3221
421350;201602;913;3035;759;2697;148;615;324;1089;472;1704
421360;201602;2943;8463;1891;6435;384;1511;489;1525;873;3036
421370;201602;669;2223;513;1876;143;595;142;499;285;1094
421380;201602;952;2707;786;2389;131;451;364;1085;495;1536
421390;201602;136;410;69;249;9;32;34;127;43;159
421400;201602;252;830;168;662;42;171;45;167;87;338
421410;201602;309;893;216;717;21;69;99;321;120;390
421415;201602;345;1127;162;601;37;146;28;92;65;238
421420;201602;849;2564;615;2037;112;400;164;509;276;909
421430;201602;237;737;179;621;30;114;36;132;66;246
421440;201602;806;2350;537;1856;127;495;200;678;327;1173
421450;201602;475;1468;305;1120;59;252;30;114;89;366
421460;201602;625;1694;325;1142;50;214;63;222;113;436
421470;201602;431;1431;340;1228;96;372;103;359;199;731
421480;201602;2935;8263;1809;6219;422;1728;289;816;711;2544
421490;201602;273;823;124;475;27;120;13;39;40;159
421500;201602;2117;7222;1762;6488;558;2306;216;762;774;3068
421505;201602;348;1181;303;1078;65;242;139;497;204;739
421507;201602;527;1589;337;1183;61;218;91;340;152;558
421510;201602;173;546;149;505;25;116;76;215;101;331
421520;201602;863;2288;582;1728;60;218;240;629;300;847
421530;201602;385;1187;234;857;36;173;57;208;93;381
421535;201602;677;2001;372;1374;62;268;147;512;209;780
421540;201602;320;882;256;775;52;174;96;260;148;434
421545;201602;801;2584;589;2174;136;572;124;449;260;1021
421550;201602;1887;6068;1576;5521;460;1802;421;1397;881;3199
421555;201602;321;937;115;406;20;74;14;45;34;119
421560;201602;204;625;89;309;18;68;20;68;38;136
421565;201602;829;2411;725;2261;253;879;282;879;535;1758
421567;201602;645;2380;579;2241;305;1223;115;441;420;1664
421568;201602;496;1541;334;1164;72;249;78;285;150;534
421569;201602;230;689;112;407;18;69;21;72;39;141
421570;201602;1336;4022;739;2593;179;699;108;352;287;1051
421575;201602;435;1443;380;1332;63;239;226;799;289;1038
421580;201602;2986;9438;2249;7804;545;2121;515;1608;1060;3729
421590;201602;216;669;176;596;20;60;92;310;112;370
421600;201602;549;1653;417;1370;99;358;78;230;177;588
421605;201602;587;1799;419;1486;81;341;97;317;178;658
421610;201602;1364;3716;1054;3201;158;548;531;1551;689;2099
421620;201602;4270;12949;2898;10109;795;2964;807;2839;1602;5803
421625;201602;373;1029;153;525;20;70;19;72;39;142
421630;201602;2856;8550;1618;5572;364;1399;178;561;542;1960
421635;201602;246;737;130;439;16;62;40;110;56;172
421640;201602;994;3011;738;2471;161;549;293;976;454;1525
421650;201602;1981;6394;1573;5488;423;1698;209;614;632;2312
421660;201602;7483;24133;6093;21342;1420;5594;1759;5712;3179;11306
421670;201602;1042;3205;727;2502;199;781;188;615;387;1396
421680;201602;1108;3599;922;3203;299;1102;161;533;460;1635
421690;201602;1607;5256;1231;4417;248;971;107;348;355;1319
421700;201602;492;1559;275;1000;44;171;54;143;98;314
421710;201602;222;743;111;405;29;109;28;97;57;206
421715;201602;259;690;137;440;35;121;32;88;67;209
421720;201602;1876;5549;1198;4182;317;1229;209;646;526;1875
421725;201602;105;347;95;324;26;94;21;67;47;161
421730;201602;584;1680;290;1000;46;170;43;123;89;293
421740;201602;734;2337;509;1810;109;451;81;235;190;686
421750;201602;956;2568;593;1857;115;398;244;699;359;1097
421755;201602;319;926;185;601;39;138;55;172;94;310
421760;201602;697;2217;379;1366;72;291;101;339;173;630
421770;201602;2830;8589;2159;7241;551;1941;660;2300;1211;4241
421775;201602;479;1414;340;1158;65;250;91;289;156;539
421780;201602;1186;4004;913;3367;223;915;273;957;496;1872
421790;201602;778;2111;445;1556;112;449;120;388;232;837
421795;201602;346;1020;221;709;35;131;55;175;90;306
421800;201602;2568;7659;1938;6479;414;1595;718;2234;1132;3829
421810;201602;571;1786;412;1473;103;398;40;146;143;544
421820;201602;1040;3033;657;2243;111;404;116;345;227;749
421825;201602;1386;4472;1288;4262;188;746;760;2387;948;3133
421830;201602;2350;8104;2111;7622;473;1952;885;3053;1358;5005
421835;201602;144;422;102;360;22;101;59;196;81;297
421840;201602;270;875;195;704;49;202;47;156;96;358
421850;201602;389;1216;240;849;46;204;44;148;90;352
421860;201602;323;987;208;750;33;123;40;122;73;245
421870;201602;3765;10602;2628;8377;773;2664;405;1265;1178;3929
421875;201602;422;1259;194;714;38;159;16;54;54;213
421880;201602;852;2613;640;2170;135;519;138;445;273;964
421885;201602;282;914;225;813;80;314;68;239;148;553
421890;201602;824;2815;714;2586;231;966;229;776;460;1742
421895;201602;352;1137;311;1065;76;271;158;546;234;817
421900;201602;888;2473;561;1796;146;503;138;393;284;896
421910;201602;484;1549;339;1220;70;295;48;142;118;437
421915;201602;501;1509;319;1093;60;209;68;217;128;426
421917;201602;552;1603;398;1373;130;514;108;360;238;874
421920;201602;756;2102;479;1728;251;954;97;350;348;1304
421930;201602;3048;8021;1697;5684;375;1382;251;758;626;2140
421935;201602;643;2129;469;1750;105;457;139;483;244;940
421940;201602;263;888;137;512;18;76;16;46;34;122
421950;201602;3530;9662;1705;5786;377;1407;200;686;577;2093
421960;201602;193;570;145;476;32;118;28;74;60;192
421970;201602;2134;5954;1342;4308;424;1433;324;960;748;2393
421985;201602;487;1245;269;820;39;153;75;222;114;375
422000;201602;1080;3231;907;2916;234;821;341;1130;575;1951
430003;201602;788;2296;606;1990;163;593;157;502;320;1095
430005;201602;317;940;230;779;43;160;99;318;142;478
430010;201602;2103;5673;1570;4789;392;1267;622;1929;1014;3196
430020;201602;698;1749;581;1596;70;203;368;986;438;1189
430030;201602;1015;2676;751;2192;251;802;122;327;373;1129
430040;201602;11013;28772;8474;24432;2276;7104;1357;3723;3633;10827
430045;201602;680;1834;512;1489;96;287;221;635;317;922
430047;201602;285;687;157;471;21;60;61;183;82;243
430050;201602;1231;3306;732;2308;134;448;163;482;297;930
430055;201602;297;797;159;492;27;95;64;185;91;280
430057;201602;69;159;32;92;3;6;4;5;7;11
430060;201602;15788;50526;13712;46980;3753;13744;5456;18941;9209;32685
430063;201602;983;2902;800;2527;195;649;384;1247;579;1896
430064;201602;1372;4114;1110;3638;274;919;407;1363;681;2282
430066;201602;164;397;120;332;8;28;64;170;72;198
430070;201602;595;1591;186;606;28;108;24;62;52;170
430080;201602;655;1850;397;1341;78;295;114;346;192;641
430085;201602;846;2216;560;1710;109;369;190;592;299;961
430087;201602;942;2868;872;2742;121;455;537;1584;658;2039
430090;201602;886;2324;359;1163;34;122;50;171;84;293
430100;201602;813;2151;430;1359;104;348;111;302;215;650
430105;201602;947;2804;640;2226;163;634;198;682;361;1316
430107;201602;255;835;187;646;35;131;44;141;79;272
430110;201602;1848;5302;1514;4786;398;1310;632;1947;1030;3257
430120;201602;1722;5079;1284;4183;263;882;574;1854;837;2736
430130;201602;3799;9895;3274;9143;773;2326;1309;3590;2082;5916
430140;201602;1185;3601;792;2705;215;756;223;766;438;1522
430150;201602;734;1963;503;1530;120;393;125;380;245;773
430155;201602;402;1115;224;735;33;128;61;200;94;328
430160;201602;16485;48067;14672;45054;3149;10626;6397;19699;9546;30325
430163;201602;1838;5430;1499;4834;245;868;722;2330;967;3198
430165;201602;454;1117;135;452;17;58;20;58;37;116
430170;201602;935;2632;375;1332;49;178;33;99;82;277
430175;201602;916;2843;753;2464;196;595;280;1009;476;1604
430180;201602;832;2284;675;2032;151;505;333;965;484;1470
430185;201602;581;1507;333;1039;53;177;94;238;147;415
430187;201602;654;1944;514;1665;113;417;168;511;281;928
430190;201602;1668;4961;1453;4547;279;969;789;2452;1068;3421
430192;201602;197;600;94;306;6;19;18;53;24;72
430195;201602;357;1087;102;352;8;28;4;12;12;40
430200;201602;1401;4499;1200;4084;343;1237;270;907;613;2144
430205;201602;546;1570;421;1343;42;167;294;938;336;1105
430210;201602;6061;16200;3572;11157;583;1996;754;2143;1337;4139
430215;201602;355;985;240;740;38;121;94;277;132;398
430220;201602;747;1879;271;921;41;167;46;151;87;318
430222;201602;272;819;213;693;34;134;98;296;132;430
430223;201602;338;956;292;888;65;202;168;534;233;736
430225;201602;35;87;15;44;6;17;5;15;11;32
430230;201602;1632;4876;1570;4812;183;418;1354;4330;1537;4748
430235;201602;278;914;228;793;49;187;66;216;115;403
430237;201602;518;1350;378;1116;43;149;229;656;272;805
430240;201602;970;2537;659;2015;106;389;298;857;404;1246
430245;201602;865;2680;658;2250;173;598;271;979;444;1577
430250;201602;1200;3424;1051;3184;371;1172;163;504;534;1676
430258;201602;164;457;121;382;10;34;52;173;62;207
430260;201602;769;2199;546;1761;62;208;285;968;347;1176
430265;201602;273;837;211;712;42;132;9;34;51;166
430270;201602;2915;8133;2507;7455;354;1212;1419;4045;1773;5257
430280;201602;4633;12535;3751;11005;939;2809;1513;4477;2452;7286
430290;201602;2399;6318;2198;6038;150;429;1883;5196;2033;5625
430300;201602;8969;26514;7470;23684;1822;6249;3013;9769;4835;16018
430310;201602;6110;18422;4777;15927;1142;4167;1635;5127;2777;9294
430320;201602;822;2408;547;1844;96;277;254;919;350;1196
430330;201602;661;1773;513;1497;147;415;194;545;341;960
430340;201602;723;1799;401;1293;66;240;196;633;262;873
430350;201602;6138;18791;5242;16922;1817;6085;1564;4968;3381;11053
430355;201602;368;912;146;446;23;76;16;46;39;122
430360;201602;1021;2701;861;2421;174;562;336;860;510;1422
430367;201602;257;667;161;500;46;170;49;138;95;308
430370;201602;506;1439;372;1179;105;366;79;231;184;597
430380;201602;861;2230;483;1565;138;490;124;405;262;895
430390;201602;3917;11030;2650;8497;518;1795;435;1350;953;3145
430400;201602;1381;3310;982;2682;305;859;326;844;631;1703
430410;201602;617;1662;447;1376;86;293;202;617;288;910
430420;201602;3584;10376;2828;8747;743;2353;1037;3178;1780;5531
430430;201602;745;1987;471;1491;126;433;109;353;235;786
430435;201602;1999;5414;1504;4536;379;1213;534;1622;913;2835
430440;201602;3890;12286;3066;10406;633;2268;1365;4795;1998;7063
430450;201602;7520;20849;6018;18033;1983;6324;1309;3931;3292;10255
430460;201602;27845;82350;21555;71181;5741;20909;6056;19643;11797;40552
430461;201602;510;1363;164;529;23;77;30;89;53;166
430462;201602;299;849;224;727;69;252;50;143;119;395
430463;201602;4017;12765;3465;11754;747;2706;1555;5405;2302;8111
430465;201602;638;1717;532;1544;163;516;250;703;413;1219
430466;201602;3514;9709;3089;9067;595;1903;1693;4834;2288;6737
430467;201602;499;1478;431;1355;86;290;173;517;259;807
430468;201602;1389;3885;1191;3593;328;1066;439;1272;767;2338
430469;201602;423;1126;64;223;9;39;9;23;18;62
430470;201602;7533;20116;5356;16510;1508;5064;807;2426;2315;7490
430471;201602;579;1916;509;1772;154;531;123;469;277;1000
430480;201602;951;2468;472;1493;69;250;103;301;172;551
430485;201602;212;585;98;312;13;46;22;59;35;105
430490;201602;312;893;205;671;47;166;88;287;135;453
430495;201602;371;1099;240;827;48;179;44;130;92;309
430500;201602;1175;3277;953;2909;262;891;389;1168;651;2059
430510;201602;19765;57856;16073;51083;5285;18371;4134;12226;9419;30597
430511;201602;403;1238;177;627;25;95;17;43;42;138
430512;201602;1155;2971;981;2671;245;696;307;881;552;1577
430513;201602;782;2045;472;1405;91;286;172;503;263;789
430515;201602;473;1374;349;1124;54;180;157;527;211;707
430517;201602;1152;3652;963;3267;188;660;512;1770;700;2430
430520;201602;1512;4184;1044;3240;261;886;286;807;547;1693
430530;201602;1104;2973;548;1750;69;265;128;376;197;641
430535;201602;2204;6664;1701;5682;359;1320;584;1891;943;3211
430537;201602;479;1536;413;1403;43;140;290;1005;333;1145
430540;201602;732;1621;486;1285;93;254;267;711;360;965
430543;201602;487;1267;425;1203;79;232;298;864;377;1096
430544;201602;647;2085;549;1888;109;391;268;914;377;1305
430545;201602;1268;4045;1084;3820;377;1430;415;1496;792;2926
430550;201602;628;1822;381;1279;79;287;82;278;161;565
430558;201602;82;240;42;145;10;44;8;29;18;73
430560;201602;377;934;217;661;17;61;67;190;84;251
430570;201602;1099;2835;708;2064;174;602;249;599;423;1201
430580;201602;1244;3108;750;2298;172;590;263;819;435;1409
430583;201602;166;459;53;175;2;11;4;13;6;24
430585;201602;329;857;213;615;50;173;82;201;132;374
430587;201602;191;597;164;541;49;171;43;152;92;323
430590;201602;1183;3412;1112;3303;160;519;750;2189;910;2708
430593;201602;25;96;23;89;5;25;10;34;15;59
430595;201602;242;657;77;262;8;34;6;16;14;50
430597;201602;332;966;242;755;26;89;62;167;88;256
430600;201602;2065;5551;1182;3594;215;694;355;1029;570;1723
430605;201602;1327;3979;1042;3399;233;892;405;1321;638;2213
430607;201602;751;1848;558;1559;80;236;334;966;414;1202
430610;201602;8109;21740;6274;18894;1706;5577;1694;5035;3400;10612
430613;201602;274;663;119;359;22;60;21;53;43;113
430620;201602;685;1959;546;1674;146;468;192;567;338;1035
430630;201602;432;1348;220;750;37;123;23;71;60;194
430632;201602;691;1919;370;1163;57;203;131;353;188;556
430635;201602;578;1679;448;1416;97;341;227;696;324;1037
430637;201602;483;1375;425;1259;61;210;253;713;314;923
430640;201602;1603;4301;731;2440;58;197;27;58;85;255
430642;201602;463;1241;288;914;55;190;105;326;160;516
430645;201602;269;635;106;311;15;40;23;70;38;110
430650;201602;1817;5853;1547;5327;323;1147;841;2951;1164;4098
430655;201602;158;399;136;357;22;78;72;156;94;234
430660;201602;5575;15739;4470;13823;1093;3696;1717;5272;2810;8968
430670;201602;488;1417;444;1340;39;117;330;1037;369;1154
430673;201602;718;1701;345;1041;76;230;99;304;175;534
430675;201602;259;762;104;349;13;52;41;133;54;185
430676;201602;3425;10292;2819;9179;753;2628;790;2628;1543;5256
430680;201602;1209;3462;759;2493;134;449;173;507;307;956
430690;201602;4328;12170;3434;10446;1061;3354;823;2536;1884;5890
430692;201602;274;911;204;774;20;89;133;487;153;576
430693;201602;1277;3539;846;2664;165;602;181;532;346;1134
430695;201602;561;1570;384;1218;75;262;143;428;218;690
430697;201602;479;1350;356;1129;101;326;119;397;220;723
430700;201602;10147;26037;5136;16546;851;3132;286;858;1137;3990
430705;201602;272;837;237;770;83;288;58;175;141;463
430710;201602;1755;4495;1315;3758;282;892;484;1406;766;2298
430720;201602;888;2151;573;1696;130;419;178;525;308;944
430730;201602;1595;4185;1084;3360;282;868;366;1222;648;2090
430740;201602;540;1519;314;1064;79;289;44;153;123;442
430745;201602;509;1444;263;844;42;152;32;97;74;249
430750;201602;1551;4257;1219;3707;229;780;625;1854;854;2634
430755;201602;497;1342;331;1000;29;94;129;366;158;460
430760;201602;3003;7306;2034;5907;471;1628;699;2111;1170;3739
430770;201602;6182;17928;4860;15485;922;3208;2473;7779;3395;10987
430780;201602;2462;6523;1471;4680;285;974;395;1209;680;2183
430781;201602;533;1533;359;1190;71;234;95;317;166;551
430783;201602;542;1332;340;991;61;191;145;392;206;583
430786;201602;73;241;49;181;6;25;12;38;18;63
430790;201602;4654;12625;3253;9868;705;2380;1157;3236;1862;5616
430800;201602;897;2550;608;1905;129;450;189;559;318;1009
430805;201602;532;1468;349;1110;41;127;167;541;208;668
430807;201602;425;1238;287;925;61;226;69;214;130;440
430810;201602;722;1904;292;968;48;191;66;186;114;377
430820;201602;1240;3774;800;2735;160;581;182;620;342;1201
430825;201602;394;1019;154;471;22;58;27;62;49;120
430830;201602;1746;5383;1613;5190;236;832;1047;3345;1283;4177
430840;201602;963;2919;878;2768;227;729;401;1304;628;2033
430843;201602;96;266;52;169;5;21;15;44;20;65
430845;201602;305;923;252;811;109;371;20;52;129;423
430850;201602;2447;7206;2060;6485;475;1619;793;2462;1268;4081
430860;201602;1010;2716;512;1687;136;521;157;477;293;998
430865;201602;634;1667;564;1555;198;576;254;679;452;1255
430870;201602;700;1948;394;1290;93;309;60;156;153;465
430880;201602;1167;3304;832;2652;227;773;207;709;434;1482
430885;201602;242;589;138;432;16;52;90;286;106;338
430890;201602;1766;4675;1255;3787;176;665;321;870;497;1535
430900;201602;2811;7402;2305;6554;504;1694;1018;2677;1522;4371
430905;201602;1031;2918;651;2114;145;508;127;393;272;901
430910;201602;1515;4446;1033;3419;230;859;359;1069;589;1928
430912;201602;463;1316;361;1137;48;171;220;688;268;859
430915;201602;576;1813;395;1457;123;489;88;352;211;841
430920;201602;15506;46994;13757;43786;2774;9814;7639;23632;10413;33446
430925;201602;102;240;49;147;12;41;17;51;29;92
430930;201602;9633;27286;6658;21743;1760;6192;1432;4889;3192;11081
430940;201602;1235;3731;731;2485;142;519;114;367;256;886
430950;201602;990;2735;656;2048;152;527;230;638;382;1165
430955;201602;138;415;66;215;13;48;15;46;28;94
430957;201602;255;838;206;748;45;160;101;394;146;554
430960;201602;1351;3625;1104;3193;253;804;524;1556;777;2360
430965;201602;1481;4228;1264;3868;81;312;974;2921;1055;3233
430970;201602;514;1407;303;966;51;170;80;244;131;414
430975;201602;592;1918;462;1620;81;300;203;733;284;1033
430980;201602;424;1056;254;804;64;214;78;242;142;456
430990;201602;547;1740;384;1319;80;290;82;267;162;557
430995;201602;586;1712;466;1466;154;510;145;420;299;930
431000;201602;1560;3982;803;2480;124;435;68;181;192;616
431010;201602;2652;7443;1629;5458;274;1013;238;717;512;1730
431020;201602;11059;27189;7201;20474;1705;5013;1733;4881;3438;9894
431030;201602;323;938;158;573;41;167;23;86;64;253
431033;201602;2348;6845;2067;6447;558;1857;942;3016;1500;4873
431036;201602;200;512;80;270;15;54;12;32;27;86
431040;201602;914;2603;730;2296;158;570;349;1055;507;1625
431041;201602;513;1403;466;1340;161;464;181;547;342;1011
431043;201602;464;1315;261;915;112;430;52;154;164;584
431046;201602;109;309;76;240;9;34;23;68;32;102
431050;201602;1678;4267;1278;3598;283;847;647;1801;930;2648
431053;201602;591;1920;486;1685;144;546;100;353;244;899
431055;201602;652;1761;605;1684;63;169;447;1258;510;1427
431057;201602;373;1085;228;772;45;161;56;176;101;337
431060;201602;5505;16298;4934;15436;1569;4967;1863;6065;3432;11032
431065;201602;541;1547;405;1282;73;262;157;462;230;724
431070;201602;706;2016;417;1372;89;295;65;191;154;486
431075;201602;289;878;205;693;35;129;57;207;92;336
431080;201602;628;1935;476;1590;92;347;115;359;207;706
431085;201602;844;2300;655;1898;111;340;333;962;444;1302
431087;201602;587;1658;504;1496;62;181;334;1008;396;1189
431090;201602;513;1254;251;754;62;194;50;151;112;345
431100;201602;3626;10080;2922;8888;749;2453;918;2767;1667;5220
431110;201602;1538;4070;1146;3306;261;784;398;1062;659;1846
431112;201602;553;1790;510;1705;133;453;232;760;365;1213
431113;201602;502;1444;395;1242;99;329;111;362;210;691
431115;201602;1374;3965;1203;3682;233;746;666;2057;899;2803
431120;201602;2633;8068;2058;6944;637;2464;624;1911;1261;4375
431123;201602;452;1294;302;1007;57;193;166;565;223;758
431125;201602;1356;4118;1018;3413;308;1014;220;829;528;1843
431127;201602;254;681;62;207;4;9;8;19;12;28
431130;201602;3290;9390;2403;7751;468;1678;764;2445;1232;4123
431140;201602;4694;11546;2640;8124;393;1331;609;1656;1002;2987
431142;201602;435;1300;389;1215;38;124;263;845;301;969
431150;201602;1108;3318;848;2796;190;712;277;897;467;1609
431160;201602;895;2621;743;2320;136;403;360;1242;496;1645
431162;201602;529;1370;246;827;35;151;22;48;57;199
431164;201602;174;477;55;197;8;33;4;16;12;49
431170;201602;708;1959;503;1597;138;469;129;399;267;868
431171;201602;772;2280;668;2075;210;685;183;547;393;1232
431173;201602;455;1308;386;1193;117;386;174;532;291;918
431175;201602;1019;2858;861;2600;252;805;248;732;500;1537
431177;201602;803;2636;647;2338;213;864;251;887;464;1751
431179;201602;371;805;97;283;13;41;20;53;33;94
431180;201602;2234;6411;1550;5028;379;1309;303;928;682;2237
431190;201602;618;1709;365;1165;54;193;72;213;126;406
431198;201602;357;1172;321;1099;122;435;78;284;200;719
431200;201602;393;1101;120;410;16;50;3;9;19;59
431205;201602;292;875;139;478;34;106;36;135;70;241
431210;201602;747;2008;619;1792;176;503;297;897;473;1400
431213;201602;230;710;178;608;31;123;79;270;110;393
431215;201602;276;817;150;524;23;76;7;18;30;94
431217;201602;171;525;128;431;38;137;44;150;82;287
431220;201602;902;2430;546;1690;53;180;236;680;289;860
431225;201602;1340;3723;1072;3258;228;731;474;1426;702;2157
431230;201602;858;2456;646;2023;84;275;315;968;399;1243
431235;201602;112;315;33;106;6;21;5;11;11;32
431237;201602;490;1430;385;1276;81;330;207;663;288;993
431238;201602;42;135;34;117;9;35;7;25;16;60
431240;201602;2932;8687;2594;8194;809;2743;848;2660;1657;5403
431242;201602;362;1145;315;1057;91;314;105;372;196;686
431244;201602;377;866;225;618;28;96;112;279;140;375
431245;201602;1159;3017;831;2436;123;380;420;1205;543;1585
431247;201602;188;542;140;441;40;129;25;68;65;197
431250;201602;1495;4766;1303;4498;356;1339;507;1759;863;3098
431260;201602;346;966;171;599;27;117;50;161;77;278
431261;201602;243;831;213;764;33;157;78;242;111;399
431262;201602;408;1102;186;595;25;100;79;256;104;356
431265;201602;1426;3670;781;2377;151;493;175;436;326;929
431267;201602;175;476;139;420;29;106;79;217;108;323
431270;201602;2726;6827;1793;5326;444;1482;570;1699;1014;3181
431275;201602;221;669;122;447;32;121;12;44;44;165
431280;201602;322;894;133;445;15;58;22;49;37;107
431290;201602;312;956;232;774;50;201;38;107;88;308
431295;201602;93;257;47;147;3;10;16;46;19;56
431300;201602;397;995;71;267;6;23;2;9;8;32
431301;201602;266;817;122;416;22;78;17;50;39;128
431303;201602;747;1976;432;1326;58;211;123;349;181;560
431306;201602;2283;5908;1468;4485;159;589;413;1093;572;1682
431308;201602;40;137;36;123;21;77;9;29;30;106
431310;201602;752;2243;469;1604;82;285;132;479;214;764
431320;201602;783;2151;413;1372;72;253;85;266;157;519
431330;201602;2802;6848;1388;4350;343;1226;81;213;424;1439
431333;201602;422;1138;179;549;21;76;38;98;59;174
431335;201602;54;167;39;134;12;41;6;13;18;54
431337;201602;2351;7163;1788;6053;396;1444;267;869;663;2313
431339;201602;584;1584;398;1211;77;242;177;536;254;778
431340;201602;23636;63088;17444;52434;3954;12851;4105;12298;8059;25149
431342;201602;537;1357;421;1171;131;416;205;523;336;939
431344;201602;353;975;253;798;12;33;187;609;199;642
431346;201602;320;817;139;424;27;83;20;61;47;144
431349;201602;716;2045;484;1495;93;293;149;440;242;733
431350;201602;4013;11718;3293;10421;663;2364;1191;3536;1854;5900
431360;201602;643;1645;421;1272;99;325;130;404;229;729
431365;201602;1221;3618;1042;3328;243;835;505;1655;748;2490
431370;201602;4838;13599;3775;11769;1060;3571;1026;3294;2086;6865
431380;201602;916;2852;849;2715;126;448;502;1575;628;2023
431390;201602;3150;8231;1896;5880;342;1205;470;1287;812;2492
431395;201602;1223;3659;1035;3340;233;826;484;1538;717;2364
431400;201602;340;1071;171;594;35;137;24;73;59;210
431402;201602;1277;2999;747;2083;143;417;339;907;482;1324
431403;201602;252;727;184;612;53;185;31;102;84;287
431405;201602;3913;11016;3225;10004;617;2147;1627;4951;2244;7098
431406;201602;737;2266;554;1890;150;538;234;796;384;1334
431407;201602;538;1536;354;1183;76;253;93;292;169;545
431410;201602;13675;39013;9337;30709;2627;9754;1061;3351;3688;13105
431413;201602;217;535;92;297;5;19;28;87;33;106
431415;201602;694;1963;501;1604;118;430;163;473;281;903
431417;201602;565;1435;467;1300;60;178;281;779;341;957
431420;201602;1342;3703;1181;3460;243;740;511;1593;754;2333
431430;201602;514;1345;314;951;61;208;93;235;154;443
431440;201602;22180;62003;18188;55675;5215;16912;5468;17770;10683;34682
431442;201602;123;358;78;253;12;45;9;20;21;65
431445;201602;519;1469;233;752;32;99;75;226;107;325
431446;201602;419;1240;303;1006;71;245;93;305;164;550
431447;201602;570;1641;443;1385;86;275;197;634;283;909
431449;201602;778;2168;618;1891;59;182;352;1097;411;1279
431450;201602;2167;5382;1892;4995;296;872;1307;3335;1603;4207
431454;201602;64;226;56;205;14;55;22;87;36;142
431455;201602;709;1786;381;1082;96;275;88;227;184;502
431460;201602;3314;9147;2826;8216;739;2164;859;2642;1598;4806
431470;201602;1741;5181;1330;4267;305;977;427;1407;732;2384
431475;201602;193;564;47;187;6;24;1;3;7;27
431477;201602;720;1881;477;1387;55;180;245;677;300;857
431478;201602;261;673;101;299;17;49;15;32;32;81
431480;201602;2914;8101;2226;6883;566;1922;788;2318;1354;4240
431490;201602;107792;291077;91975;267657;11195;38336;61958;175553;73153;213889
431500;201602;598;1670;468;1411;98;294;235;711;333;1005
431505;201602;496;1193;336;962;22;54;206;608;228;662
431507;201602;351;867;211;595;40;105;111;316;151;421
431510;201602;1888;5285;1478;4460;330;1053;489;1361;819;2414
431513;201602;301;817;146;466;18;61;69;219;87;280
431514;201602;112;300;46;163;5;22;8;29;13;51
431515;201602;630;1863;430;1393;97;343;139;402;236;745
431517;201602;73;235;58;195;9;30;15;43;24;73
431520;201602;502;1298;244;791;40;158;26;75;66;233
431530;201602;4243;10015;3211;8813;1063;3165;898;2573;1961;5738
431531;201602;259;755;176;578;32;109;54;182;86;291
431532;201602;486;1354;404;1181;96;297;151;429;247;726
431535;201602;344;903;149;470;25;87;50;137;75;224
431540;201602;2035;6762;1792;6396;196;710;1138;4295;1334;5005
431545;201602;329;895;54;183;5;18;8;25;13;43
431550;201602;2205;6475;1948;6029;376;1313;856;2557;1232;3870
431555;201602;686;1725;520;1458;78;224;310;895;388;1119
431560;201602;19782;58647;14218;48055;3374;12822;2992;10641;6366;23463
431570;201602;5487;14592;4594;13369;1278;3819;1911;5722;3189;9541
431575;201602;405;1031;294;861;44;147;64;168;108;315
431580;201602;619;1752;390;1269;80;280;109;330;189;610
431590;201602;941;2555;585;1852;95;292;191;625;286;917
431595;201602;439;1262;348;1075;43;133;206;652;249;785
431600;201602;1949;5373;1394;4384;301;1114;330;976;631;2090
431610;201602;1419;4112;1058;3426;186;624;405;1338;591;1962
431620;201602;469;1388;239;768;55;185;91;269;146;454
431630;201602;1410;3791;905;2751;252;809;254;735;506;1544
431640;201602;6048;17114;5398;16162;1194;3860;2929;8809;4123;12669
431642;201602;495;1333;388;1148;57;186;181;522;238;708
431643;201602;268;680;150;419;20;62;51;121;71;183
431645;201602;1648;4762;1416;4368;264;907;792;2400;1056;3307
431647;201602;153;443;103;339;17;64;13;35;30;99
431650;201602;320;982;224;776;31;127;51;147;82;274
431660;201602;1139;3214;717;2375;137;486;133;386;270;872
431670;201602;1257;3318;943;2769;198;667;383;1031;581;1698
431673;201602;230;631;126;403;23;77;15;34;38;111
431675;201602;593;1554;147;492;22;74;23;67;45;141
431680;201602;9543;25858;7221;21679;1931;6207;1642;5012;3573;11219
431690;201602;23106;64285;18216;56222;4875;16107;5781;18447;10656;34554
431695;201602;133;410;92;307;18;58;20;51;38;109
431697;201602;446;1287;395;1190;102;310;180;563;282;873
431700;201602;1521;4325;1304;3921;224;711;684;2009;908;2720
431710;201602;12456;35868;10164;32229;3223;11058;2185;7559;5408;18617
431720;201602;7037;19411;5382;16274;1153;3779;1774;5288;2927;9067
431725;201602;15;42;6;20;2;5;1;3;3;8
431730;201602;3853;11199;3062;9820;790;2812;774;2594;1564;5406
431740;201602;5190;14437;4136;12557;1309;4380;658;1815;1967;6195
431750;201602;8907;25254;7737;23394;1797;5913;3504;10740;5301;16653
431755;201602;334;914;82;282;12;41;12;35;24;76
431760;201602;3784;10865;3044;9521;647;2220;1121;3341;1768;5561
431770;201602;1979;5276;1627;4742;298;888;895;2592;1193;3480
431775;201602;209;567;140;436;40;128;12;29;52;157
431780;201602;2411;6504;1840;5461;457;1449;374;1023;831;2472
431790;201602;1162;3533;952;3129;151;553;522;1728;673;2281
431795;201602;376;1017;223;681;36;116;69;209;105;325
431800;201602;8649;25410;6907;22191;2083;7233;1040;3255;3123;10488
431805;201602;334;809;107;357;17;65;16;52;33;117
431810;201602;3173;8740;2476;7389;457;1492;1046;3027;1503;4519
431820;201602;2482;7757;2159;7140;430;1578;887;2837;1317;4415
431830;201602;10644;26008;8274;22547;2301;6833;2938;8110;5239;14943
431840;201602;2621;7866;2263;7264;580;2010;942;3067;1522;5077
431842;201602;799;2006;345;1059;44;150;74;197;118;347
431843;201602;353;1020;289;901;42;147;140;422;182;569
431844;201602;273;739;94;310;22;79;19;49;41;128
431845;201602;477;1414;375;1195;24;82;232;742;256;824
431846;201602;323;995;278;926;25;96;190;629;215;725
431848;201602;246;660;145;463;16;56;32;92;48;148
431849;201602;458;1112;103;311;16;50;16;36;32;86
431850;201602;4728;13814;4146;12707;991;3237;1475;4505;2466;7742
431860;201602;748;1966;564;1657;100;333;271;753;371;1086
431861;201602;94;272;48;169;5;16;6;15;11;31
431862;201602;469;1526;379;1359;108;448;95;305;203;753
431870;201602;17464;50545;13949;44299;3415;11748;4288;13734;7703;25482
431880;201602;4217;12551;3401;10860;793;2814;1147;3461;1940;6275
431890;201602;5015;13573;3676;11193;1096;3520;839;2667;1935;6187
431900;201602;1045;2937;689;2210;174;641;260;761;434;1402
431910;201602;1009;2396;488;1397;73;209;133;354;206;563
431912;201602;492;1434;402;1273;117;352;144;480;261;832
431915;201602;1283;3474;990;2951;217;674;355;1079;572;1753
431920;201602;1271;3573;1096;3298;120;370;778;2336;898;2706
431930;201602;1233;3360;860;2743;223;689;383;1300;606;1989
431935;201602;52;163;43;142;12;47;14;39;26;86
431936;201602;382;1110;285;898;62;200;111;362;173;562
431937;201602;330;859;187;567;42;142;24;66;66;208
431940;201602;2537;6891;1691;5230;375;1252;407;1232;782;2484
431950;201602;1603;4895;1409;4546;252;912;646;2010;898;2922
431960;201602;2824;8184;2474;7518;630;1967;758;2295;1388;4262
431970;201602;450;1252;216;728;35;135;44;136;79;271
431971;201602;97;284;65;224;8;30;15;48;23;78
431973;201602;462;1603;409;1495;62;221;246;944;308;1165
431975;201602;104;244;19;79;6;30;2;8;8;38
431980;201602;1378;4042;1130;3551;269;902;334;1002;603;1904
431990;201602;7075;19772;5369;16932;950;3433;1531;4572;2481;8005
432000;201602;9606;26787;7608;23413;2368;7631;2339;7161;4707;14792
432010;201602;2161;6083;1760;5381;363;1179;803;2454;1166;3633
432020;201602;2276;5502;1715;4728;242;722;1131;3076;1373;3798
432023;201602;510;1462;331;1071;64;223;105;310;169;533
432026;201602;1208;3653;893;2986;144;471;443;1491;587;1962
432030;201602;396;1155;294;928;57;171;139;432;196;603
432032;201602;595;1529;390;1161;69;220;164;448;233;668
432035;201602;802;2430;716;2283;282;972;220;710;502;1682
432040;201602;983;2283;463;1420;91;313;111;326;202;639
432045;201602;243;684;138;474;21;75;40;135;61;210
432050;201602;627;1742;537;1587;83;255;297;905;380;1160
432055;201602;850;2505;672;2179;124;430;352;1119;476;1549
432057;201602;405;978;306;816;52;129;186;487;238;616
432060;201602;506;1320;202;676;37;137;40;121;77;258
432065;201602;209;600;159;510;38;137;58;172;96;309
432067;201602;971;2991;724;2478;139;495;334;1156;473;1651
432070;201602;2333;6452;1561;4899;321;1097;295;861;616;1958
432080;201602;3644;10364;3075;9389;1001;3255;905;2782;1906;6037
432085;201602;303;835;195;658;43;153;90;299;133;452
432090;201602;1400;3967;1081;3343;313;1032;379;1121;692;2153
432100;201602;1300;3743;656;2230;91;320;48;124;139;444
432110;201602;2633;7950;1973;6610;470;1800;194;594;664;2394
432120;201602;4695;13816;3955;12566;1439;4868;967;2998;2406;7866
432130;201602;2595;7249;2114;6632;722;2524;703;2186;1425;4710
432132;201602;396;1100;197;672;25;97;57;185;82;282
432135;201602;652;2045;620;1985;78;284;456;1430;534;1714
432140;201602;1888;6026;1489;5253;334;1248;595;2212;929;3460
432143;201602;1364;3984;1135;3600;207;663;522;1742;729;2405
432145;201602;1197;3640;748;2607;118;464;110;350;228;814
432146;201602;171;561;121;443;28;116;22;81;50;197
432147;201602;638;2020;480;1679;128;483;121;445;249;928
432149;201602;360;1009;231;703;49;146;81;254;130;400
432150;201602;3625;10148;2716;8512;577;2032;760;2285;1337;4317
432160;201602;4305;13546;3749;12575;1149;4061;1248;4353;2397;8414
432162;201602;393;935;76;239;11;40;11;25;22;65
432163;201602;359;962;94;301;5;18;4;12;9;30
432166;201602;673;1983;555;1748;76;283;259;778;335;1061
432170;201602;1059;3276;707;2523;139;515;126;433;265;948
432180;201602;2723;7302;1812;5591;413;1320;391;1185;804;2505
432183;201602;414;1282;326;1101;130;470;56;180;186;650
432185;201602;878;2359;555;1770;107;355;227;738;334;1093
432190;201602;3272;8903;2181;6578;496;1551;555;1569;1051;3120
432195;201602;1064;2918;834;2551;114;353;459;1362;573;1715
432200;201602;3023;9014;2419;7995;583;2114;1013;3390;1596;5504
432210;201602;414;1140;301;955;76;275;110;326;186;601
432215;201602;846;2584;718;2381;141;428;408;1457;549;1885
432218;201602;271;688;174;504;28;79;63;163;91;242
432220;201602;4146;10981;3410;9820;382;1302;2083;5813;2465;7115
432225;201602;68;217;60;202;22;77;18;60;40;137
432230;201602;1041;2790;628;1889;129;426;144;351;273;777
432232;201602;510;1448;398;1229;72;231;149;463;221;694
432234;201602;363;1005;238;736;47;146;61;183;108;329
432235;201602;107;302;39;127;9;32;1;1;10;33
432237;201602;457;1243;417;1182;16;68;307;840;323;908
432240;201602;13685;42760;11441;39849;1789;7378;6569;23637;8358;31015
432250;201602;4579;15581;4155;14750;1338;5164;1244;4479;2582;9643
432252;201602;380;1042;266;858;48;165;133;448;181;613
432253;201602;1306;4130;811;2846;202;778;79;277;281;1055
432254;201602;826;2231;247;810;53;187;29;86;82;273
432255;201602;194;525;118;391;24;85;36;110;60;195
432260;201602;7470;18539;5233;14938;1163;3416;1984;5963;3147;9379
432270;201602;2525;7479;2120;6789;594;1965;717;2376;1311;4341
432280;201602;1354;3696;729;2357;105;361;149;433;254;794
432285;201602;188;601;33;117;7;28;4;8;11;36
432290;201602;557;1621;352;1161;83;278;99;320;182;598
432300;201602;22832;67524;19999;62742;3844;13109;10823;33583;14667;46692
432310;201602;792;2322;624;2049;148;527;300;972;448;1499
432320;201602;207;529;104;335;17;55;16;43;33;98
432330;201602;323;843;124;408;12;38;9;23;21;61
432335;201602;149;426;67;231;15;56;11;32;26;88
432340;201602;371;890;178;538;28;95;51;143;79;238
432345;201602;635;1761;580;1673;77;292;347;913;424;1205
432350;201602;388;1048;209;693;33;104;55;175;88;279
432360;201602;183;565;41;150;12;51;10;31;22;82
432370;201602;415;1154;335;1004;42;121;202;614;244;735
432375;201602;761;1909;582;1617;73;202;328;926;401;1128
432377;201602;172;571;37;142;7;21;3;6;10;27
432380;201602;880;2895;765;2668;260;1005;273;910;533;1915
500020;201602;2203;6568;1677;5650;364;1454;653;2116;1017;3570
500025;201602;1319;3050;820;2198;93;257;457;1203;550;1460
500060;201602;6766;20056;5361;17687;658;2250;3339;11486;3997;13736
500070;201602;4222;12160;3447;10792;710;2505;1425;4415;2135;6920
500080;201602;1467;4320;1092;3634;290;1079;339;1131;629;2210
500085;201602;2174;5631;1534;4698;159;523;882;2637;1041;3160
500090;201602;2334;6707;1695;5556;349;1186;718;2479;1067;3665
500100;201602;2543;7424;2165;6782;505;1798;878;2628;1383;4426
500110;201602;8146;24028;6553;21577;1072;3811;3122;10978;4194;14789
500124;201602;2016;6433;1748;5992;350;1124;897;3431;1247;4555
500150;201602;1387;3469;965;2787;186;639;355;857;541;1496
500190;201602;4723;12297;3682;10875;684;2148;1906;5785;2590;7933
500200;201602;2401;6070;1837;5061;384;1153;738;1916;1122;3069
500210;201602;4694;13992;3918;12785;882;3055;1756;5832;2638;8887
500215;201602;1531;4708;1208;4072;195;715;435;1445;630;2160
500220;201602;2878;9023;2395;8196;492;1791;924;3273;1416;5064
500230;201602;2750;6927;1935;5656;439;1401;857;2570;1296;3971
500240;201602;4529;14123;3296;11623;524;2008;996;3803;1520;5811
500260;201602;2683;6853;1949;5737;303;1002;927;2615;1230;3617
500270;201602;120902;308764;77256;234275;17384;57149;15800;47628;33184;104777
500280;201602;1354;3502;1148;3237;93;278;872;2498;965;2776
500290;201602;4343;9900;2522;7270;520;1679;799;2226;1319;3905
500295;201602;2612;7650;1656;5536;266;976;365;1061;631;2037
500310;201602;751;1986;618;1796;139;474;295;818;434;1292
500315;201602;3038;9502;2501;8627;359;1279;1505;5421;1864;6700
500320;201602;16734;53186;13303;46887;3756;14508;3660;13663;7416;28171
500325;201602;3977;10138;2883;8448;578;1838;1450;4291;2028;6129
500330;201602;6614;17411;4640;13801;867;2859;1963;5753;2830;8612
500345;201602;2147;5603;1672;4885;365;1161;764;2221;1129;3382
500348;201602;2260;6504;1950;6022;129;484;1396;4269;1525;4753
500350;201602;1234;3677;723;2473;98;358;225;808;323;1166
500370;201602;22893;68784;17520;59109;3738;14269;4726;16141;8464;30410
500375;201602;2881;7876;2146;6491;463;1464;556;1639;1019;3103
500380;201602;3031;8430;2405;7353;641;2050;877;2719;1518;4769
500390;201602;575;1286;339;926;53;170;172;430;225;600
500400;201602;1313;3958;979;3184;228;812;221;643;449;1455
500410;201602;2170;6087;1748;5476;454;1559;772;2461;1226;4020
500430;201602;2460;6969;1913;6173;401;1453;754;2551;1155;4004
500440;201602;1465;3867;986;3038;171;597;421;1266;592;1863
500450;201602;1628;4848;1187;4011;232;868;193;579;425;1447
500460;201602;3635;10826;2749;9134;706;2563;543;1782;1249;4345
500470;201602;3021;8776;2125;6890;516;1873;297;874;813;2747
500480;201602;2117;6529;1968;6345;242;668;1405;4997;1647;5665
500490;201602;917;2557;694;2170;202;719;149;489;351;1208
500500;201602;3723;11443;2916;10237;1076;4336;803;2852;1879;7188
500510;201602;831;2142;530;1621;68;224;213;595;281;819
500515;201602;1848;4930;1527;4511;251;772;851;2744;1102;3516
500520;201602;3097;10588;2770;10050;396;1591;1769;6526;2165;8117
500525;201602;1155;3665;917;3212;160;627;401;1455;561;2082
500540;201602;6251;17035;3717;12328;950;3715;434;1267;1384;4982
500560;201602;4535;14910;4115;14265;522;1986;2887;10096;3409;12082
500568;201602;4149;10233;2865;8351;564;1987;950;2567;1514;4554
500570;201602;7512;19915;4975;15222;1257;4143;884;2608;2141;6751
500580;201602;3649;10298;2916;9126;277;890;2010;6407;2287;7297
500600;201602;3828;10105;2513;7684;567;1858;695;2137;1262;3995
500620;201602;7616;21738;5823;18390;1087;3751;2364;7597;3451;11348
500625;201602;779;2265;437;1484;83;306;127;431;210;737
500627;201602;556;1612;431;1391;82;268;116;404;198;672
500630;201602;5961;16148;4267;13350;1052;3631;1238;3797;2290;7428
500635;201602;2701;10046;2215;9294;309;1254;1423;6550;1732;7804
500640;201602;1611;3863;1223;3315;86;275;866;2305;952;2580
500660;201602;18831;53718;14605;47032;4269;15515;4059;13142;8328;28657
500690;201602;2562;7564;2070;6884;942;3265;531;1943;1473;5208
500710;201602;3529;10454;2969;9532;659;2382;1203;3849;1862;6231
500720;201602;5999;15843;3836;12172;982;3431;770;2403;1752;5834
500730;201602;966;2660;678;2094;163;547;194;572;357;1119
500740;201602;4099;11173;3311;9719;387;1401;1501;4489;1888;5890
500750;201602;890;2442;758;2256;136;437;394;1157;530;1594
500755;201602;1157;3390;796;2651;166;600;169;469;335;1069
500769;201602;5071;13460;2973;9152;470;1590;547;1461;1017;3051
500770;201602;1663;4855;1222;4046;305;1061;288;1007;593;2068
500780;201602;1070;3091;860;2711;227;742;215;669;442;1411
500790;201602;9369;25647;7788;22984;1352;4561;4100;11862;5452;16423
500793;201602;2223;6379;1719;5539;456;1575;406;1199;862;2774
500795;201602;2374;7059;2016;6559;267;721;1386;4873;1653;5594
500797;201602;826;2248;580;1819;95;326;204;622;299;948
500800;201602;2763;7398;2142;6529;819;2860;494;1567;1313;4427
500830;201602;18720;49968;13139;39738;2491;8294;4105;11826;6596;20120
500840;201602;1290;3604;876;2784;101;355;329;1009;430;1364
510010;201602;1214;3617;1008;3287;269;875;484;1620;753;2495
510020;201602;3271;9283;2061;6850;448;1608;448;1420;896;3028
510025;201602;7419;21518;5764;18488;1296;4533;1702;5057;2998;9590
510030;201602;1672;4501;1360;4024;257;852;649;1841;906;2693
510035;201602;788;2289;613;2044;126;426;332;1148;458;1574
510040;201602;1662;4539;1289;3979;202;670;676;2116;878;2786
510050;201602;1813;5241;1310;4296;333;1201;350;1120;683;2321
510060;201602;1551;4422;1179;3727;214;710;462;1438;676;2148
510080;201602;1074;3343;846;2908;249;954;132;399;381;1353
510100;201602;663;1753;476;1380;56;187;211;566;267;753
510120;201602;306;655;193;512;15;46;126;338;141;384
510125;201602;3079;8086;2360;6851;408;1420;894;2403;1302;3823
510130;201602;1738;4768;1420;4251;372;1173;442;1335;814;2508
510140;201602;2736;8791;2211;8012;937;3806;407;1285;1344;5091
510160;201602;1298;4359;1167;4140;162;641;696;2408;858;3049
510170;201602;5046;15263;4175;13786;766;2810;1925;6179;2691;8989
510180;201602;11962;30999;8361;25395;2325;7463;2376;8217;4701;15680
510185;201602;1291;3828;1075;3537;133;434;682;2518;815;2952
510190;201602;2258;6556;1587;5557;312;1194;697;2609;1009;3803
510250;201602;13256;40641;11515;37979;3384;12050;4108;14083;7492;26133
510260;201602;2083;8622;1764;7988;450;2071;751;3998;1201;6069
510263;201602;3949;10584;2914;8936;696;2267;716;2104;1412;4371
510267;201602;5418;15511;3867;12295;819;2841;902;2717;1721;5558
510268;201602;793;2343;684;2186;142;474;362;1165;504;1639
510269;201602;989;3035;744;2567;231;824;173;621;404;1445
510270;201602;2598;8474;2207;7702;386;1358;928;3211;1314;4569
510279;201602;1754;5464;1439;4820;376;1340;356;1066;732;2406
510285;201602;1224;3572;948;3103;263;939;285;892;548;1831
510300;201602;3266;9492;2689;8675;202;763;1984;6465;2186;7228
510305;201602;1469;4540;1145;3945;293;1090;321;1107;614;2197
510310;201602;748;2303;636;2089;198;698;194;619;392;1317
510320;201602;3397;9790;2686;8506;635;2352;714;2137;1349;4489
510325;201602;5125;16116;4355;15082;1205;4330;2442;8839;3647;13169
510330;201602;2570;8172;2060;7255;533;2084;675;2391;1208;4475
510335;201602;4740;14179;3828;13050;485;1596;2680;9786;3165;11382
510336;201602;564;1732;420;1464;74;277;207;727;281;1004
510337;201602;2027;6669;1633;5913;628;2394;244;919;872;3313
510340;201602;74177;197985;52099;163854;16433;57695;8806;29107;25239;86802
510343;201602;1087;3144;891;2821;105;352;622;2011;727;2363
510345;201602;1574;4685;1277;4175;328;1153;433;1387;761;2540
510350;201602;3148;8528;2394;7469;574;1903;1030;3394;1604;5297
510360;201602;1726;4248;1098;3494;107;432;752;2344;859;2776
510370;201602;1187;3915;1001;3619;211;779;568;2186;779;2965
510380;201602;513;1509;319;1117;117;445;25;84;142;529
510385;201602;910;3436;675;2905;88;410;300;1434;388;1844
510390;201602;1074;3319;982;3205;264;681;596;2203;860;2884
510395;201602;719;1769;517;1482;82;269;198;662;280;931
510410;201602;3630;11846;3224;11061;790;2839;1576;5566;2366;8405
510420;201602;2355;5975;1742;4969;179;641;893;2511;1072;3152
510450;201602;644;1689;451;1394;99;347;137;412;236;759
510452;201602;610;1960;459;1619;82;320;220;781;302;1101
510454;201602;801;2549;687;2328;99;373;424;1462;523;1835
510455;201602;946;2889;715;2420;133;520;219;693;352;1213
510460;201602;2207;5786;1683;5060;220;787;948;2730;1168;3517
510480;201602;4347;11487;3105;9267;646;2042;721;2046;1367;4088
510490;201602;1570;4886;1323;4512;287;1093;703;2341;990;3434
510500;201602;1493;4433;1016;3500;239;948;384;1256;623;2204
510510;201602;2528;8786;2188;8184;679;2735;639;2434;1318;5169
510515;201602;5966;18063;4441;14793;968;3568;979;3061;1947;6629
510517;201602;1616;4845;1326;4318;403;1377;314;1022;717;2399
510520;201602;2027;4696;1462;4014;58;174;1000;2940;1058;3114
510523;201602;968;2869;853;2671;124;388;575;1859;699;2247
510525;201602;7843;20223;5358;16432;1048;3322;1845;5693;2893;9015
510530;201602;488;1394;404;1276;49;217;250;749;299;966
510550;201602;2589;8477;2081;7499;562;2209;650;2333;1212;4542
510558;201602;1824;5253;1549;4864;279;969;798;2606;1077;3575
510560;201602;1615;4881;1052;3943;285;1192;196;749;481;1941
510562;201602;5220;15379;4076;13124;1170;4097;965;3203;2135;7300
510590;201602;2941;7805;2458;7192;490;1431;1353;4162;1843;5593
510600;201602;1540;3991;1044;3179;185;600;408;1202;593;1802
510610;201602;2839;8084;2317;7308;195;692;1534;4832;1729;5524
510615;201602;1996;6075;1691;5592;495;1723;721;2494;1216;4217
510617;201602;591;1768;488;1592;37;112;380;1296;417;1408
510618;201602;1403;4089;1026;3361;176;671;446;1425;622;2096
510619;201602;789;2187;478;1602;52;189;51;130;103;319
510620;201602;1382;3469;793;2570;201;727;104;308;305;1035
510621;201602;875;3050;785;2864;202;817;241;833;443;1650
510622;201602;3648;11032;2575;8811;655;2422;257;776;912;3198
510623;201602;3226;9225;2575;8092;649;2234;915;2730;1564;4964
510624;201602;1409;4171;960;3267;194;748;212;662;406;1410
510625;201602;2043;5762;1568;4962;413;1447;272;871;685;2318
510626;201602;1491;3982;979;3282;298;1143;236;809;534;1952
510627;201602;708;2022;477;1527;109;386;87;274;196;660
510628;201602;1503;3734;1079;3167;101;311;762;2269;863;2580
510629;201602;1702;5482;1384;4807;408;1581;397;1339;805;2920
510630;201602;2446;8299;1820;7003;455;1946;304;1225;759;3171
510631;201602;349;1008;307;942;33;91;230;712;263;803
510637;201602;2599;7630;2245;7070;687;2321;802;2558;1489;4879
510642;201602;4545;15015;3941;14145;1155;4560;1691;6298;2846;10858
510645;201602;959;2159;612;1691;189;514;164;494;353;1008
510650;201602;6161;20438;5557;19737;1432;5319;3331;12364;4763;17683
510665;201602;1598;4176;985;3037;204;645;304;938;508;1583
510670;201602;384;868;215;635;21;82;99;278;120;360
510675;201602;6203;19461;4999;17120;1415;5464;1096;3660;2511;9124
510677;201602;1879;5118;1560;4709;169;521;1151;3647;1320;4168
510680;201602;711;2132;542;1796;126;441;117;371;243;812
510682;201602;2075;6587;1623;5741;446;1816;270;890;716;2706
510685;201602;928;2488;764;2273;81;281;506;1485;587;1766
510700;201602;4217;10946;2901;9122;617;1999;1348;4416;1965;6415
510704;201602;9044;23969;7396;21473;1394;4451;3583;10220;4977;14671
510706;201602;1836;5437;1262;4584;279;1032;614;2400;893;3432
510710;201602;3293;9129;2347;7234;546;1739;536;1528;1082;3267
510715;201602;708;1736;469;1326;86;262;157;445;243;707
510718;201602;2246;5570;1469;4679;677;2212;336;1260;1013;3472
510719;201602;397;925;262;748;26;111;133;350;159;461
510720;201602;1087;2656;826;2311;243;761;309;776;552;1537
510724;201602;690;2110;549;1853;119;437;212;679;331;1116
510726;201602;593;1499;454;1282;72;228;218;550;290;778
510729;201602;713;1762;416;1223;91;290;140;414;231;704
510730;201602;2649;7699;2025;6593;561;2006;504;1605;1065;3611
510735;201602;1006;3347;783;2995;168;724;371;1438;539;2162
510740;201602;1050;2592;769;2182;176;474;380;1149;556;1623
510757;201602;674;2273;560;2054;213;787;159;606;372;1393
510760;201602;29948;77007;20479;61791;5637;18622;4277;12673;9914;31295
510770;201602;4189;10780;3573;10041;333;920;2345;7363;2678;8283
510774;201602;363;1025;329;973;68;232;153;480;221;712
510775;201602;689;2031;572;1831;174;621;150;435;324;1056
510776;201602;527;1450;412;1215;89;284;172;507;261;791
510777;201602;1524;4527;1153;4030;151;563;870;3083;1021;3646
510779;201602;622;1863;475;1582;68;231;228;795;296;1026
510780;201602;3605;10721;2946;9709;715;2501;1137;4019;1852;6520
510785;201602;1688;4879;1257;4146;406;1393;232;804;638;2197
510787;201602;2192;6583;1749;5818;688;2452;312;994;1000;3446
510788;201602;533;1385;389;1177;160;510;82;279;242;789
510790;201602;15532;44936;10729;35940;2147;8375;1010;3438;3157;11813
510792;201602;7645;22536;5365;18257;1060;4088;777;2484;1837;6572
510794;201602;1117;3561;907;3139;298;1133;253;832;551;1965
510795;201602;7937;23607;5884;19831;1503;5606;1103;3938;2606;9544
510800;201602;1503;4237;1188;3784;272;953;474;1413;746;2366
510805;201602;1879;5246;1476;4638;251;862;873;2733;1124;3595
510810;201602;635;1589;497;1402;143;408;216;588;359;996
510820;201602;717;1705;481;1350;82;274;176;436;258;710
510830;201602;644;2042;540;1881;137;520;269;1007;406;1527
510835;201602;600;1790;462;1526;104;382;165;503;269;885
510840;201602;46040;114558;36708;102675;8846;26126;16448;47568;25294;73694
510850;201602;1432;4073;996;3293;274;988;121;359;395;1347
510860;201602;2599;8192;1928;6880;738;2898;101;311;839;3209
510880;201602;616;2035;526;1881;169;656;193;718;362;1374
510885;201602;633;1772;509;1601;98;351;200;620;298;971
510890;201602;818;2588;673;2374;189;762;268;901;457;1663
510895;201602;1048;3252;883;2934;218;828;329;1038;547;1866
520005;201602;1372;4362;1217;4138;311;1096;586;2069;897;3165
520010;201602;1620;5435;1317;4822;481;2032;223;732;704;2764
520013;201602;3350;9381;2489;7781;566;1854;792;2530;1358;4384
520015;201602;465;1317;375;1186;76;261;133;437;209;698
520017;201602;1026;3071;867;2817;218;779;318;971;536;1750
520020;201602;443;1133;338;988;73;227;145;417;218;644
520025;201602;25316;78862;24002;77325;2817;9756;18933;61003;21750;70759
520030;201602;4420;13825;3734;12694;726;2716;1823;6245;2549;8961
520050;201602;411;1032;285;835;18;45;176;541;194;586
520055;201602;718;2175;634;1999;101;315;342;1116;443;1431
520060;201602;1304;4072;1116;3694;241;914;395;1252;636;2166
520080;201602;1760;5136;1492;4787;303;951;811;2796;1114;3747
520082;201602;1046;2872;934;2696;131;353;623;1877;754;2230
520085;201602;842;2552;731;2357;171;558;233;743;404;1301
520090;201602;963;2203;693;1869;154;377;339;1014;493;1391
520110;201602;40829;117777;31964;104503;11359;42349;4870;15485;16229;57834
520120;201602;186;501;123;393;23;89;29;94;52;183
520130;201602;3322;9321;3004;8871;744;2416;1431;4276;2175;6692
520140;201602;35953;116309;31019;107428;10631;40132;5089;17483;15720;57615
520145;201602;346;939;249;769;59;191;83;248;142;439
520150;201602;448;1185;360;1088;51;177;215;650;266;827
520160;201602;865;2348;705;2116;209;642;184;580;393;1222
520170;201602;4191;9698;3263;8644;269;752;2602;7032;2871;7784
520180;201602;2015;5890;1668;5369;307;1171;766;2431;1073;3602
520215;201602;1864;4828;1549;4333;178;520;972;2745;1150;3265
520235;201602;674;1755;494;1488;100;342;195;560;295;902
520250;201602;1488;4277;1121;3672;283;1070;228;712;511;1782
520260;201602;766;1947;519;1486;73;232;199;537;272;769
520280;201602;554;1604;488;1518;164;532;177;621;341;1153
520310;201602;1183;2820;851;2297;230;667;268;784;498;1451
520320;201602;1815;5633;1507;5063;123;426;968;3338;1091;3764
520330;201602;2652;8101;2025;7038;508;1925;318;1047;826;2972
520340;201602;1787;4475;1380;3955;202;520;899;2780;1101;3300
520350;201602;3035;8318;2380;7167;622;2083;850;2474;1472;4557
520355;201602;1028;3424;921;3259;294;1136;340;1157;634;2293
520357;201602;829;2227;702;2017;56;182;492;1423;548;1605
520360;201602;646;1885;556;1734;134;444;221;707;355;1151
520380;201602;1263;3407;859;2628;118;385;368;1108;486;1493
520390;201602;1054;2467;616;1895;173;613;203;570;376;1183
520393;201602;471;1153;371;1010;52;146;217;584;269;730
520396;201602;687;2232;568;2001;74;301;355;1220;429;1521
520400;201602;1650;4736;1414;4402;228;757;885;2733;1113;3490
520410;201602;1384;3370;1021;2866;195;614;560;1565;755;2179
520420;201602;309;857;228;692;39;122;69;185;108;307
520425;201602;1067;2945;885;2631;235;720;416;1260;651;1980
520430;201602;1828;4864;1191;3684;242;772;263;741;505;1513
520440;201602;3610;9236;2457;7227;703;2276;481;1412;1184;3688
520450;201602;9936;27708;6804;21902;1349;4731;466;1451;1815;6182
520455;201602;628;1877;507;1669;134;471;165;544;299;1015
520460;201602;864;2434;707;2175;121;441;366;1077;487;1518
520465;201602;776;2190;678;2072;105;349;404;1232;509;1581
520470;201602;1698;5475;1523;5200;356;1234;918;3282;1274;4516
520480;201602;923;2682;678;2265;119;432;264;830;383;1262
520485;201602;1227;3892;1065;3643;279;1064;562;1908;841;2972
520490;201602;3848;12062;3072;10855;916;3327;1298;4809;2214;8136
520495;201602;1249;3456;1086;3249;81;266;882;2696;963;2962
520500;201602;1291;3620;1068;3306;286;964;414;1270;700;2234
520505;201602;730;2086;624;1924;147;448;310;976;457;1424
520510;201602;8755;24473;6309;20668;1568;5658;1870;6369;3438;12027
520520;201602;1051;2921;835;2607;262;861;238;772;500;1633
520530;201602;1913;6352;1594;5805;561;2040;451;1807;1012;3847
520540;201602;2778;7841;2089;6608;552;1831;383;1248;935;3079
520545;201602;1051;3162;877;2852;167;582;269;830;436;1412
520547;201602;642;2036;555;1872;198;681;168;539;366;1220
520549;201602;9369;27434;7845;25394;2373;8000;3346;11114;5719;19114
520551;201602;3414;10438;3150;10069;859;3054;1817;5727;2676;8781
520552;201602;744;2231;672;2135;92;314;469;1517;561;1831
520570;201602;542;1531;401;1296;143;497;108;325;251;822
520580;201602;3203;7921;2216;6558;579;1948;915;2664;1494;4612
520590;201602;1339;3786;1042;3296;231;748;196;596;427;1344
520620;201602;7133;22144;6481;21240;1630;5538;3572;11901;5202;17439
520630;201602;885;2290;643;1940;114;364;254;765;368;1129
520640;201602;2735;7559;2242;6745;612;1897;794;2483;1406;4380
520650;201602;836;2235;620;1835;131;424;303;887;434;1311
520660;201602;337;952;268;863;91;323;85;277;176;600
520670;201602;889;2618;803;2499;61;191;660;2072;721;2263
520680;201602;705;1867;562;1665;149;437;237;717;386;1154
520690;201602;313;864;245;756;57;149;109;360;166;509
520710;201602;544;1407;343;1016;5;14;205;601;210;615
520725;201602;1495;3845;1131;3252;193;606;663;1894;856;2500
520735;201602;731;2072;517;1661;129;470;148;460;277;930
520740;201602;1568;4366;1258;3984;229;812;636;2006;865;2818
520750;201602;562;1524;448;1350;90;262;219;706;309;968
520753;201602;1381;3776;1246;3588;148;420;826;2546;974;2966
520760;201602;800;2132;705;2010;83;240;496;1480;579;1720
520780;201602;1887;4603;1493;4065;143;391;987;2679;1130;3070
520790;201602;2743;7108;2175;6303;234;641;1505;4597;1739;5238
520800;201602;15354;44129;13306;41704;2862;8562;7856;26636;10718;35198
520810;201602;1013;2527;808;2284;124;344;566;1709;690;2053
520815;201602;572;1830;436;1546;176;710;15;38;191;748
520830;201602;1512;4023;1254;3743;38;110;1066;3190;1104;3300
520840;201602;1531;4972;1289;4562;466;1808;223;840;689;2648
520850;201602;569;1772;434;1523;103;397;141;491;244;888
520860;201602;6406;18715;4820;16115;1189;4258;1520;5238;2709;9496
520870;201602;98044;262268;69494;216766;19234;66160;14486;44036;33720;110196
520880;201602;6695;19204;5066;16867;1685;6316;601;2006;2286;8322
520890;201602;3696;10412;2992;9281;586;1987;1428;4438;2014;6425
520910;201602;3743;10814;2750;8939;875;3054;459;1453;1334;4507
520915;201602;649;1928;530;1706;119;402;233;744;352;1146
520920;201602;3353;8995;2393;7495;476;1628;860;2794;1336;4422
520929;201602;525;1449;407;1270;79;239;226;735;305;974
520940;201602;1023;2963;834;2686;106;383;577;1843;683;2226
520945;201602;646;1548;516;1339;141;324;229;598;370;922
520960;201602;961;2839;766;2463;82;270;363;1196;445;1466
520970;201602;2762;8369;2395;7745;601;2116;640;2017;1241;4133
520980;201602;714;2082;635;1970;218;726;293;909;511;1635
520990;201602;2867;9327;2708;9106;435;1524;1819;6391;2254;7915
520993;201602;915;2344;740;2098;48;142;538;1555;586;1697
520995;201602;2276;6083;1995;5752;351;924;1333;4011;1684;4935
521000;201602;6568;19908;5451;17901;1578;5745;1451;4495;3029;10240
521010;201602;3897;11337;3061;9836;799;2563;1040;3419;1839;5982
521015;201602;661;1851;569;1704;144;410;275;843;419;1253
521020;201602;3484;9833;2391;7668;636;2200;235;703;871;2903
521030;201602;653;1641;495;1374;93;250;199;589;292;839
521040;201602;5748;15548;4895;14337;1682;5069;1710;5373;3392;10442
521056;201602;831;2547;699;2337;240;835;215;813;455;1648
521060;201602;1086;2814;874;2498;180;484;426;1318;606;1802
521080;201602;1121;2704;668;1970;79;293;229;565;308;858
521090;201602;2826;7607;2229;6857;671;2154;709;2274;1380;4428
521100;201602;1904;4257;1471;3774;272;633;938;2603;1210;3236
521120;201602;4198;11530;3390;10459;873;2895;1296;4144;2169;7039
521130;201602;978;2660;741;2219;106;383;405;1193;511;1576
521140;201602;1000;3039;820;2705;219;751;255;854;474;1605
521150;201602;12225;30997;7767;22997;2658;8342;1575;4717;4233;13059
521160;201602;821;1932;513;1415;109;303;204;560;313;863
521170;201602;1117;2746;843;2349;176;507;457;1248;633;1755
521180;201602;6191;20228;5590;19205;1736;6395;1534;5348;3270;11743
521190;201602;9112;26029;6232;20850;1517;5513;1217;4095;2734;9608
521200;201602;731;1990;604;1787;75;248;352;1025;427;1273
521205;201602;572;1618;441;1381;41;136;244;766;285;902
521210;201602;912;2536;612;1940;179;666;131;337;310;1003
521220;201602;4073;10539;3072;9224;793;2605;1253;3815;2046;6420
521225;201602;359;876;291;802;33;83;202;594;235;677
521230;201602;1131;3605;1043;3439;338;1196;499;1602;837;2798
521250;201602;26898;85816;23844;81200;10109;36519;6031;21102;16140;57621
521260;201602;663;1629;564;1487;81;275;356;877;437;1152
521270;201602;1828;5361;1679;5158;138;339;1301;4207;1439;4546
521280;201602;1829;5561;1497;4922;430;1501;398;1278;828;2779
521290;201602;478;1344;361;1160;93;352;153;462;246;814
521295;201602;1162;2883;982;2649;152;403;683;1944;835;2347
521300;201602;1885;5301;1616;4883;243;697;947;2944;1190;3641
521305;201602;734;2086;600;1876;107;314;327;1066;434;1380
521308;201602;4268;12591;3368;10868;910;2969;1155;3757;2065;6726
521310;201602;7462;22077;5454;18278;1367;5003;1000;3186;2367;8189
521340;201602;280;738;264;717;15;41;218;588;233;629
521350;201602;1887;5216;1579;4746;227;662;1047;3275;1274;3937
521370;201602;910;2676;698;2308;230;824;139;452;369;1276
521375;201602;1150;3527;972;3212;216;770;398;1270;614;2040
521377;201602;1055;2675;976;2592;69;129;847;2338;916;2467
521380;201602;5330;15105;3875;12401;614;2090;931;3087;1545;5177
521385;201602;458;1255;412;1198;93;298;221;637;314;935
521390;201602;842;2304;659;2074;171;640;196;581;367;1221
521400;201602;1872;5430;1745;5272;222;742;1322;4033;1544;4775
521405;201602;1345;3775;1050;3246;290;956;415;1307;705;2263
521410;201602;687;2115;643;2047;228;685;276;962;504;1647
521440;201602;1312;3852;1116;3442;163;556;469;1259;632;1815
521450;201602;3798;12262;3094;10907;1024;3850;540;1863;1564;5713
521460;201602;6431;18698;5424;17009;1351;4594;2469;7654;3820;12248
521470;201602;681;1947;507;1612;108;372;76;241;184;613
521480;201602;366;1104;247;842;49;174;81;265;130;439
521483;201602;2795;7313;2145;6213;547;1581;599;1715;1146;3296
521486;201602;1529;3908;1256;3524;113;300;915;2594;1028;2894
521487;201602;572;1468;408;1201;110;335;73;207;183;542
521490;201602;763;2222;618;1984;53;241;393;1207;446;1448
521500;201602;1308;4138;1011;3508;188;736;231;700;419;1436
521520;201602;869;2080;663;1806;164;473;303;885;467;1358
521523;201602;12889;46586;12165;45357;4258;17313;1499;6302;5757;23615
521525;201602;1000;2635;867;2438;114;379;553;1511;667;1890
521530;201602;1687;4784;1071;3543;230;815;132;434;362;1249
521540;201602;919;2453;628;1970;135;507;201;596;336;1103
521550;201602;1257;3214;901;2523;206;612;415;1127;621;1739
521560;201602;3537;11772;3028;11053;1177;4695;944;3407;2121;8102
521565;201602;597;1536;501;1422;88;210;317;932;405;1142
521570;201602;4520;12422;2941;9333;632;2216;518;1675;1150;3891
521580;201602;543;1255;359;998;91;259;97;261;188;520
521590;201602;616;1719;511;1555;146;490;129;374;275;864
521600;201602;484;1332;351;1112;90;304;79;241;169;545
521630;201602;1344;3392;962;2847;234;821;170;429;404;1250
521640;201602;1996;5109;1539;4484;411;1241;637;1927;1048;3168
521645;201602;563;1655;432;1386;63;214;154;462;217;676
521680;201602;1335;4273;1127;3864;527;1944;148;489;675;2433
521690;201602;567;1656;502;1546;121;432;224;632;345;1064
521710;201602;2779;8208;2260;7321;484;1638;813;2688;1297;4326
521720;201602;1830;5208;1489;4615;313;972;782;2371;1095;3343
521730;201602;3541;11599;3105;10753;1120;4319;638;1942;1758;6261
521740;201602;3458;9487;2734;8474;683;2307;1168;3880;1851;6187
521760;201602;12640;41347;11220;38969;2835;10753;4584;16154;7419;26907
521770;201602;2555;7421;2064;6532;753;2553;533;1602;1286;4155
521800;201602;6863;20794;5921;19192;1822;6295;2049;6910;3871;13205
521805;201602;892;2031;649;1685;151;355;342;974;493;1329
521810;201602;806;2013;591;1706;123;379;236;727;359;1106
521830;201602;5158;16312;4614;15510;772;2832;3012;10118;3784;12950
521839;201602;689;1891;534;1621;99;320;178;520;277;840
521850;201602;6642;17792;5096;15158;1224;3879;1422;3917;2646;7796
521860;201602;1920;5214;1478;4533;339;1154;410;1237;749;2391
521870;201602;476;1561;390;1373;97;360;106;364;203;724
521878;201602;758;2171;540;1716;81;289;210;629;291;918
521880;201602;22468;57852;15329;46454;3931;12778;4289;13596;8220;26374
521890;201602;3282;9783;2575;8457;730;2565;504;1623;1234;4188
521900;201602;1411;3723;1001;3120;237;782;326;933;563;1715
521910;201602;887;2420;792;2310;134;415;462;1434;596;1849
521920;201602;291;900;240;808;87;323;44;136;131;459
521925;201602;662;2007;556;1820;113;406;191;589;304;995
521930;201602;3563;11495;3093;10604;996;3589;535;1869;1531;5458
521935;201602;576;1643;501;1511;142;433;216;644;358;1077
521940;201602;990;2754;808;2477;188;632;375;1123;563;1755
521945;201602;636;2034;561;1921;97;318;344;1282;441;1600
521950;201602;619;1639;502;1469;69;212;308;922;377;1134
521960;201602;648;1969;528;1739;105;391;227;731;332;1122
521970;201602;2534;6732;2107;6210;204;593;1638;5000;1842;5593
521971;201602;1037;2746;735;2203;140;425;169;487;309;912
521973;201602;898;2786;755;2529;160;573;303;1006;463;1579
521975;201602;11824;32606;10851;31491;1980;5994;7353;21337;9333;27331
521980;201602;1947;5471;1676;5137;260;674;1277;4117;1537;4791
521990;201602;1126;3175;910;2839;83;281;604;1920;687;2201
522000;201602;2196;6052;1597;5287;202;744;888;3102;1090;3846
522005;201602;392;964;270;776;78;213;88;269;166;482
522010;201602;3332;9535;2793;8660;978;3093;594;1887;1572;4980
522015;201602;872;2587;734;2369;165;525;355;1172;520;1697
522020;201602;5001;13027;3961;11472;947;2791;1923;5538;2870;8329
522026;201602;609;1649;448;1463;105;377;154;543;259;920
522028;201602;506;1471;406;1249;64;196;228;707;292;903
522040;201602;2255;5569;1785;4995;395;1111;1035;2951;1430;4062
522045;201602;14633;47658;12233;42861;3418;13191;2187;7548;5605;20739
522050;201602;1131;3186;817;2601;198;667;228;655;426;1322
522060;201602;2571;7651;2005;6804;576;2147;827;2822;1403;4969
522068;201602;1647;5166;1492;4987;145;424;1168;4124;1313;4548
522070;201602;709;2145;633;2021;77;299;448;1424;525;1723
522100;201602;509;1536;442;1438;170;608;172;535;342;1143
522108;201602;845;2627;714;2437;62;262;530;1780;592;2042
522119;201602;1334;4114;1127;3810;273;969;491;1719;764;2688
522130;201602;345;979;285;911;87;280;166;544;253;824
522140;201602;17239;47857;13929;42314;3982;12936;3600;10535;7582;23471
522145;201602;781;2190;678;2032;262;803;228;741;490;1544
522150;201602;817;2322;719;2160;203;612;260;785;463;1397
522155;201602;790;2242;693;2094;131;348;428;1386;559;1734
522157;201602;650;1792;552;1653;37;133;427;1283;464;1416
522160;201602;5716;16370;4195;13639;1183;4295;362;1137;1545;5432
522170;201602;2274;6673;1841;5890;580;1956;404;1288;984;3244
522180;201602;307;890;230;756;70;254;58;200;128;454
522185;201602;14716;42230;12278;39156;3188;10702;6379;20844;9567;31546
522190;201602;872;2165;666;1877;101;300;328;982;429;1282
522200;201602;1626;5243;1355;4682;346;1292;335;1122;681;2414
522205;201602;1358;3845;1099;3438;232;782;527;1613;759;2395
522220;201602;1311;3516;1069;3222;258;758;535;1788;793;2546
522230;201602;1201;3370;1011;3080;112;401;625;1900;737;2301
530010;201602;216537;677641;192135;635797;51511;188502;63248;204921;114759;393423
110001;201601;3249;10904;2920;10380;694;2562;1415;5127;2109;7689
110002;201601;12556;37203;10007;32796;2936;10451;3051;9876;5987;20327
110003;201601;712;2367;663;2265;195;698;141;462;336;1160
110004;201601;9612;30261;7923;26895;2418;8834;1445;5094;3863;13928
110005;201601;1753;5618;1523;5195;502;1743;596;2048;1098;3791
110006;201601;1853;5730;1323;4697;376;1465;139;435;515;1900
110007;201601;1291;4003;1204;3835;345;1187;477;1712;822;2899
110008;201601;2283;7836;2153;7652;376;1250;1524;5686;1900;6936
110009;201601;4457;13485;3563;12089;1034;3834;1085;3701;2119;7535
110010;201601;7402;21973;6541;20872;1752;5512;3226;11439;4978;16951
110011;201601;7353;22900;6286;20845;2146;7439;1942;6499;4088;13938
110012;201601;13539;40713;11303;36789;3298;11216;2895;9789;6193;21005
110013;201601;5108;16296;4417;15060;1670;5902;1122;4090;2792;9992
110014;201601;3881;11654;3455;10947;849;2789;1806;5773;2655;8562
110015;201601;4603;13827;3370;11514;973;3619;633;2190;1606;5809
110018;201601;3895;11067;2960;9711;773;2854;1063;3347;1836;6201
110020;201601;59162;163747;44692;144389;9974;34339;19755;65979;29729;100318
110025;201601;4091;11897;3380;10647;590;1954;1980;6192;2570;8146
110026;201601;607;1892;559;1820;132;420;316;1072;448;1492
110028;201601;6592;19935;5211;17243;1379;5004;581;1901;1960;6905
110029;201601;1263;3753;1056;3411;318;1059;403;1322;721;2381
110030;201601;10014;27261;7712;24145;1973;6799;3048;9789;5021;16588
110032;201601;3694;11783;3281;10992;1052;3632;959;3211;2011;6843
110033;201601;5164;16533;4703;15784;1513;5085;1737;6198;3250;11283
110034;201601;3226;8789;2735;8142;729;2188;1581;4734;2310;6922
110037;201601;1919;6503;1651;5973;434;1667;679;2454;1113;4121
110040;201601;3316;10502;2856;9674;829;3018;1061;3514;1890;6532
110045;201601;4857;15848;4193;15016;1360;5288;1928;6932;3288;12220
110050;201601;1583;5143;1358;4740;425;1545;599;2113;1024;3658
110060;201601;781;2589;641;2303;224;899;113;386;337;1285
110070;201601;1887;6350;1764;6100;534;2009;748;2494;1282;4503
110080;201601;4063;11310;3580;10761;559;1609;2574;8124;3133;9733
110090;201601;695;2076;549;1817;127;475;227;712;354;1187
110092;201601;1262;4264;1167;4133;192;728;749;2720;941;3448
110094;201601;3526;10627;3102;10050;1051;3624;1228;4002;2279;7626
110100;201601;2091;6680;1903;6329;623;2185;804;2683;1427;4868
110110;201601;1578;5048;1420;4841;589;2027;375;1359;964;3386
110120;201601;1762;5614;1382;4796;411;1499;272;947;683;2446
110130;201601;2354;6888;1780;5884;568;1988;309;1029;877;3017
110140;201601;2277;7509;1939;6862;559;2159;563;1911;1122;4070
110143;201601;1174;3695;898;3214;269;989;357;1327;626;2316
110145;201601;971;2810;786;2517;198;695;389;1218;587;1913
110146;201601;413;1280;355;1191;70;238;194;680;264;918
110147;201601;681;2029;545;1785;143;477;174;545;317;1022
110148;201601;1205;3663;902;3014;201;704;109;351;310;1055
110149;201601;3163;9590;2572;8609;861;2871;1008;3565;1869;6436
110150;201601;2311;6821;1952;6288;539;1837;689;2315;1228;4152
110155;201601;807;2506;724;2318;193;646;302;926;495;1572
110160;201601;1902;6098;1594;5502;570;2002;499;1752;1069;3754
110170;201601;2804;7926;2047;6535;447;1485;970;3102;1417;4587
110175;201601;1577;4871;1276;4469;223;824;674;2498;897;3322
110180;201601;1255;3732;1070;3462;260;827;596;1981;856;2808
120001;201601;2684;9318;2499;9019;516;1963;1495;5547;2011;7510
120005;201601;1484;6264;1395;6087;156;755;1035;4681;1191;5436
120010;201601;4451;15350;4256;15061;588;2084;3160;11489;3748;13573
120013;201601;1761;7055;1682;6943;401;1630;982;4321;1383;5951
120017;201601;1921;7052;1798;6830;512;1985;777;3302;1289;5287
120020;201601;13796;61925;13356;61072;2077;9693;9364;44403;11441;54096
120025;201601;2380;8369;2291;8245;443;1691;1442;5276;1885;6967
120030;201601;6035;23860;5897;23705;235;1108;5336;21565;5571;22673
120032;201601;1423;6945;1370;6821;174;1047;984;4910;1158;5957
120033;201601;3417;13827;3339;13687;312;1268;2876;11994;3188;13262
120034;201601;2032;8436;1958;8309;145;823;1615;6779;1760;7602
120035;201601;2984;13778;2919;13651;222;1177;2466;11659;2688;12836
120038;201601;2531;9316;2405;9069;634;2423;1223;4802;1857;7225
120039;201601;1636;8283;1597;8196;165;976;1223;6374;1388;7350
120040;201601;43493;156009;39882;149326;9633;39031;19177;73242;28810;112273
120042;201601;2855;12323;2719;12020;363;1766;1922;8638;2285;10404
120043;201601;888;4232;858;4183;72;344;685;3479;757;3823
120045;201601;4083;14124;3987;14008;544;1997;3206;11358;3750;13355
120050;201601;7786;32462;7442;31713;1136;5098;5008;22079;6144;27177
120060;201601;7337;33312;7192;33045;700;3754;5699;26394;6399;30148
120070;201601;2592;9798;2520;9641;420;1604;1645;6487;2065;8091
120080;201601;3423;13154;3272;12889;654;2668;2194;8869;2848;11537
130002;201601;3002;12502;2836;12241;191;987;2387;10338;2578;11325
130006;201601;1955;8294;1724;7879;252;1299;1192;5489;1444;6788
130008;201601;2062;8308;1942;8095;216;923;1495;6349;1711;7272
130010;201601;2729;9355;2520;9115;186;752;2185;7909;2371;8661
130014;201601;3038;10078;2693;9529;483;1834;1670;5986;2153;7820
130020;201601;2653;9764;2568;9611;64;332;2239;8275;2303;8607
130030;201601;7121;27272;6892;27004;467;1640;6029;24273;6496;25913
130040;201601;3712;11496;3331;10999;284;1012;2674;8983;2958;9995
130050;201601;5692;23616;5391;23190;413;1778;4458;19843;4871;21621
130060;201601;5488;26080;5286;25746;524;3077;4104;19944;4628;23021
130063;201601;3554;15874;3468;15776;316;1563;2938;13506;3254;15069
130068;201601;3069;12979;2786;12394;367;1729;1789;8121;2156;9850
130070;201601;6608;21339;5874;20468;650;2277;4474;15995;5124;18272
130080;201601;4993;22597;4777;22262;773;3893;3290;15627;4063;19520
130083;201601;2027;8172;1920;8023;289;1349;1321;5542;1610;6891
130090;201601;2545;9251;2452;9112;112;544;2162;7988;2274;8532
130100;201601;5570;20764;5433;20597;161;697;5086;19325;5247;20022
130110;201601;6474;21107;6096;20658;731;2298;4815;16873;5546;19171
130115;201601;4282;15298;4083;14995;179;723;3556;13122;3735;13845
130120;201601;14146;54149;13327;53120;1446;5840;10714;43797;12160;49637
130130;201601;3673;15249;3624;15155;226;1175;3127;13023;3353;14198
130140;201601;6181;24048;6080;23935;225;940;5703;22499;5928;23439
130150;201601;3289;13112;3216;13025;169;958;2852;11374;3021;12332
130160;201601;4034;17003;3905;16828;482;2420;3152;13476;3634;15896
130165;201601;2797;11660;2669;11448;278;1328;2085;9014;2363;10342
130170;201601;8746;31906;7774;30697;1099;4655;5671;22865;6770;27520
130180;201601;3400;11256;3336;11168;169;364;3055;10470;3224;10834
130185;201601;10984;35327;9894;34091;883;2842;8062;29030;8945;31872
130190;201601;16204;56250;14307;53828;2628;10031;9237;36245;11865;46276
130195;201601;1897;7973;1832;7886;112;513;1602;6995;1714;7508
130200;201601;1946;6996;1791;6752;454;1699;1056;4137;1510;5836
130210;201601;1193;4769;1131;4689;119;599;933;3830;1052;4429
130220;201601;1951;8036;1781;7713;310;1530;975;4209;1285;5739
130230;201601;3526;16249;3322;15915;384;1914;2475;12289;2859;14203
130240;201601;8313;31853;7647;30934;415;2240;6555;26516;6970;28756
130250;201601;18857;66361;17769;64985;2580;9394;13006;49501;15586;58895
130255;201601;4089;14421;3848;14038;171;712;3388;12481;3559;13193
130260;201601;234922;774510;212415;736428;61959;228416;88353;310228;150312;538644
130270;201601;6693;28731;6238;28012;905;4307;4443;20586;5348;24893
130280;201601;3180;13235;3081;13116;145;655;2788;12041;2933;12696
130290;201601;11068;39373;10611;38847;163;462;10119;37674;10282;38136
130300;201601;4203;16624;4029;16349;249;1195;3476;14152;3725;15347
130310;201601;4833;18559;4489;18118;333;1444;3745;15370;4078;16814
130320;201601;2859;10282;2625;9962;381;1559;1796;6989;2177;8548
130330;201601;3469;12805;3194;12453;225;1064;2636;10250;2861;11314
130340;201601;17216;66577;16028;65108;2672;10785;11865;49884;14537;60669
130350;201601;3179;13449;3111;13349;281;1594;2555;10800;2836;12394
130353;201601;5899;18141;5191;17252;1168;3822;3054;10976;4222;14798
130356;201601;4402;16005;4154;15648;409;1495;3210;12584;3619;14079
130360;201601;3221;9169;2858;8782;147;397;2576;8102;2723;8499
130370;201601;5096;20359;4450;19513;280;1600;3566;15634;3846;17234
130380;201601;7416;31173;7161;30828;481;2416;6136;26535;6617;28951
130390;201601;4678;21248;4419;20760;477;2543;3276;15556;3753;18099
130395;201601;2019;7292;1813;6895;288;1193;1138;4285;1426;5478
130400;201601;2028;7837;1951;7731;152;732;1694;6694;1846;7426
130406;201601;10228;39348;9326;38064;2140;9022;5789;24254;7929;33276
130410;201601;3800;14662;3446;14063;1046;4532;1477;6307;2523;10839
130420;201601;10243;43550;9798;42911;2520;10675;6189;28685;8709;39360
130423;201601;3206;12536;3002;12257;273;1360;2481;10066;2754;11426
130426;201601;2127;9327;2067;9230;258;1229;1581;7213;1839;8442
130430;201601;3230;11632;3115;11465;361;1419;2434;9048;2795;10467
130440;201601;3394;12574;3234;12389;257;1047;2748;10615;3005;11662
140002;201601;1583;5229;1463;5060;118;483;1070;3707;1188;4190
140005;201601;2996;8831;2882;8705;76;184;2749;8375;2825;8559
140010;201601;52554;154730;44021;142227;10927;37616;18385;62256;29312;99872
140015;201601;2689;8827;2543;8651;273;813;2077;7322;2350;8135
140017;201601;3068;9804;2785;9447;279;886;2103;7464;2382;8350
140020;201601;4188;14484;3838;13996;598;2388;2634;9619;3232;12007
140023;201601;2065;7024;1813;6651;221;893;1244;4656;1465;5549
140028;201601;2036;5695;1900;5510;272;873;1344;3729;1616;4602
140030;201601;3539;11313;3328;11035;478;1343;2400;8318;2878;9661
140040;201601;1607;7627;1573;7567;102;617;1371;6551;1473;7168
140045;201601;2363;8838;2159;8561;435;1614;1379;5935;1814;7549
140047;201601;5378;15676;4789;14845;1300;4096;2186;7309;3486;11405
140050;201601;1346;4302;1218;4134;310;1054;675;2361;985;3415
140060;201601;1431;4425;1280;4189;255;888;806;2668;1061;3556
140070;201601;1381;7590;1335;7446;108;739;1047;5842;1155;6581
150010;201601;34001;104640;32054;102069;2089;7164;25958;83091;28047;90255
150013;201601;1649;4856;1508;4694;166;503;1174;3749;1340;4252
150020;201601;12222;41111;11817;40556;1302;4220;9553;33613;10855;37833
150030;201601;6920;29728;6702;29403;815;3232;5333;24333;6148;27565
150034;201601;4058;11340;3841;11070;194;584;3386;9798;3580;10382
150040;201601;12464;40579;10790;38575;2007;6525;7407;28620;9414;35145
150050;201601;5564;21845;5344;21481;304;1509;4563;18326;4867;19835
150060;201601;16943;53304;15477;51044;2910;9525;9733;33211;12643;42736
150070;201601;5861;23999;5249;23360;313;1567;4653;20890;4966;22457
150080;201601;68867;179867;59260;167459;11657;32515;32742;97289;44399;129804
150085;201601;5174;17793;4938;17485;501;1512;4053;14930;4554;16442
150090;201601;9970;38452;9456;37715;945;3839;7321;29902;8266;33741
150095;201601;5124;17038;4691;16411;405;1327;3683;13384;4088;14711
150100;201601;3145;11881;2961;11572;172;860;2373;9100;2545;9960
150110;201601;3231;16168;3224;16151;262;1299;2763;14076;3025;15375
150120;201601;6203;23342;6059;23124;604;2248;4853;19039;5457;21287
150125;201601;678;2005;599;1910;107;380;381;1211;488;1591
150130;201601;21548;65517;19996;63411;2432;7440;14613;47726;17045;55166
150140;201601;154674;437096;145603;425453;16845;48582;110735;328880;127580;377462
150145;201601;4334;14032;3969;13566;592;2136;2953;10299;3545;12435
150150;201601;11574;35532;10676;34217;1894;6384;6770;22008;8664;28392
150157;201601;3029;9140;2647;8602;373;1377;1800;5938;2173;7315
150160;201601;3046;9827;2866;9564;953;3229;1396;4837;2349;8066
150170;201601;21294;78930;20134;77084;3221;12550;13837;54120;17058;66670
150172;201601;2986;10263;2635;9683;433;1607;1742;6604;2175;8211
150175;201601;1889;5762;1771;5629;157;512;1427;4713;1584;5225
150178;201601;9763;30592;8692;29402;1165;4230;6019;21077;7184;25307
150180;201601;17853;72004;17184;71135;1456;6672;14240;59494;15696;66166
150190;201601;6801;23136;6540;22778;288;1073;5842;20546;6130;21619
150195;201601;5027;16839;4690;16306;275;1062;3986;13959;4261;15021
150200;201601;5214;16650;4980;16382;127;422;4635;15401;4762;15823
150210;201601;24270;91900;23494;90816;2293;8708;18925;75424;21218;84132
150215;201601;6619;21030;5852;19827;1690;5968;2371;8258;4061;14226
150220;201601;11868;37075;10638;35183;2408;8165;5322;18112;7730;26277
150230;201601;11355;36481;9991;34579;1401;5239;6640;23358;8041;28597
150240;201601;34748;103421;30626;96444;10126;32976;8912;29458;19038;62434
150250;201601;3914;16330;3781;16137;627;2703;2680;11851;3307;14554
150260;201601;2023;8088;1932;7930;412;1689;1127;4821;1539;6510
150270;201601;8375;25922;6711;23802;1761;6498;3595;13173;5356;19671
150275;201601;5783;21119;5499;20664;713;2628;3943;15210;4656;17838
150276;201601;2001;6122;1781;5826;447;1536;1100;3631;1547;5167
150277;201601;4681;14684;4080;13939;761;2742;2703;9500;3464;12242
150280;201601;5716;25687;5546;25335;1115;5139;3620;17068;4735;22207
150285;201601;2764;10943;2601;10642;472;2001;1632;6908;2104;8909
150290;201601;9515;27999;9117;27549;701;1767;7725;24218;8426;25985
150293;201601;9417;25880;7193;22837;2152;7283;2332;8199;4484;15482
150295;201601;7098;21368;5919;19988;1453;5047;3235;11819;4688;16866
150300;201601;1833;6341;1737;6217;129;549;1358;4882;1487;5431
150304;201601;3985;12687;3472;11898;580;1991;2194;7812;2774;9803
150307;201601;6283;21411;5849;20808;401;1428;4834;17352;5235;18780
150309;201601;5945;20720;5424;20008;1190;4335;3311;12952;4501;17287
150310;201601;5959;25945;5755;25630;652;3118;4500;20317;5152;23435
150320;201601;9274;22451;8575;21717;572;1228;7317;18912;7889;20140
150330;201601;13402;46206;12571;45006;1778;6347;9109;33728;10887;40075
150340;201601;2365;7709;2189;7438;271;930;1573;5408;1844;6338
150345;201601;6363;21425;5959;20887;583;2036;4710;16897;5293;18933
150350;201601;7659;24127;7140;23459;1241;3420;5060;17611;6301;21031
150360;201601;20297;63728;17893;60642;3040;10322;11704;41436;14744;51758
150370;201601;9495;35143;8910;34372;1289;4767;6633;26798;7922;31565
150375;201601;2799;12336;2722;12233;239;1063;2307;10564;2546;11627
150380;201601;9643;28144;8558;26644;591;1899;7014;22143;7605;24042
150390;201601;7631;33096;7161;32262;1303;5747;4574;21533;5877;27280
150400;201601;5666;22617;5456;22215;491;2025;4285;17804;4776;19829
150405;201601;8013;24343;7138;23270;1328;3587;4750;17109;6078;20696
150410;201601;1506;5842;1410;5641;201;921;855;3417;1056;4338
150420;201601;35566;120160;30310;111678;9254;37179;9477;36996;18731;74175
150430;201601;7089;24159;6749;23621;957;3251;4866;17549;5823;20800
150440;201601;5287;18546;5086;18275;905;3122;3574;13334;4479;16456
150442;201601;20497;60017;18371;56833;3498;10840;10884;34898;14382;45738
150445;201601;4955;17372;4621;16809;632;2290;3329;12411;3961;14701
150450;201601;4216;20493;4083;20299;342;1778;3374;17067;3716;18845
150460;201601;6549;25114;6033;24497;358;1869;5065;20970;5423;22839
150470;201601;16823;51932;16175;51172;443;1164;15170;48597;15613;49761
150475;201601;2951;10223;2729;9939;262;982;2184;8117;2446;9099
150480;201601;13490;46227;12517;44770;1308;4880;9829;35718;11137;40598
150490;201601;6797;26328;6651;26116;298;1289;5845;23188;6143;24477
150495;201601;4749;17974;4630;17816;228;960;4202;16223;4430;17183
150497;201601;2633;9797;2391;9333;783;3211;1023;4078;1806;7289
150500;201601;3041;8492;2829;8197;271;789;2192;6328;2463;7117
150503;201601;3543;10966;3049;10351;1029;3585;1541;5483;2570;9068
150506;201601;10914;38335;9940;36943;2429;8649;5863;23519;8292;32168
150510;201601;9322;37017;8626;35652;1398;5905;5604;24131;7002;30036
150520;201601;6572;25993;6464;25853;259;1029;5975;24122;6234;25151
150530;201601;11975;41042;10828;39317;1135;3944;8221;30525;9356;34469
150540;201601;4533;13929;4069;13288;287;954;3291;10791;3578;11745
150543;201601;5484;17082;4918;16272;1014;3474;2927;10035;3941;13509
150548;201601;8795;28425;8285;27765;516;1654;7367;25032;7883;26686
150549;201601;1974;6460;1824;6293;78;301;1641;5705;1719;6006
150550;201601;19491;61858;17128;57938;5127;17884;6355;22469;11482;40353
150553;201601;22337;77129;18835;70004;6809;27105;4253;16287;11062;43392
150555;201601;1631;5001;1402;4622;96;367;1069;3531;1165;3898
150560;201601;1928;6301;1816;6080;284;937;1133;3808;1417;4745
150563;201601;2619;8705;2437;8399;620;2336;1269;4359;1889;6695
150565;201601;3695;12819;3381;12329;214;981;2743;10056;2957;11037
150570;201601;5552;20717;5423;20491;397;1756;4351;16519;4748;18275
150580;201601;9301;39368;9072;39107;621;2657;7930;34899;8551;37556
150590;201601;5611;22529;5406;22273;168;779;4994;20635;5162;21414
150600;201601;7636;29858;7343;29436;390;1719;6467;26120;6857;27839
150610;201601;2326;7962;2143;7600;229;896;1472;5170;1701;6066
150611;201601;2660;9277;2504;8995;190;742;1992;7193;2182;7935
150613;201601;11628;35245;9746;32414;3193;11218;3749;12830;6942;24048
150616;201601;2946;9067;2301;8016;562;2165;755;2521;1317;4686
150618;201601;6128;21278;5592;20316;1586;5866;2699;10120;4285;15986
150619;201601;5050;17381;4686;16814;585;2286;3329;12006;3914;14292
150620;201601;6220;22416;5715;21768;754;2928;4349;17003;5103;19931
150630;201601;5607;17058;5322;16723;585;1916;4270;13681;4855;15597
150635;201601;3867;12738;3510;12044;832;2979;1588;5629;2420;8608
150640;201601;1766;5375;1700;5296;233;672;1347;4427;1580;5099
150650;201601;12122;36590;10844;34440;2884;9258;4620;15391;7504;24649
150655;201601;4848;16338;4575;15836;668;2358;3234;11379;3902;13737
150658;201601;4266;13105;3754;12401;920;3293;2128;7227;3048;10520
150660;201601;5410;17167;4959;16519;1187;3938;2623;9082;3810;13020
150670;201601;6780;18404;5705;17061;775;2419;4237;13054;5012;15473
150680;201601;54530;194466;48344;184074;14609;57897;18707;77190;33316;135087
150690;201601;1997;6184;1814;5907;311;932;1163;3939;1474;4871
150700;201601;6109;19024;5609;18382;1009;3386;3623;12257;4632;15643
150710;201601;4202;14240;3778;13554;448;1682;2690;9874;3138;11556
150715;201601;4801;15283;4199;14377;505;1960;3036;10430;3541;12390
150720;201601;6360;26061;6025;25460;808;3548;4282;18727;5090;22275
150730;201601;9475;32473;8871;31474;1004;3651;6900;25069;7904;28720
150740;201601;3620;11665;3255;11020;655;2313;1729;5908;2384;8221
150745;201601;5031;16051;4559;15402;1117;3941;2713;9197;3830;13138
150746;201601;1383;4476;1321;4368;139;458;928;3100;1067;3558
150747;201601;5246;16495;4675;15779;379;1093;3553;12962;3932;14055
150750;201601;3128;10368;2906;10088;211;854;2361;8219;2572;9073
150760;201601;10699;34953;9988;34015;2223;7697;6131;21473;8354;29170
150770;201601;5716;21847;5435;21372;449;1678;4475;18617;4924;20295
150775;201601;1083;3340;944;3090;189;741;489;1553;678;2294
150780;201601;3160;10377;3073;10281;102;367;2822;9477;2924;9844
150790;201601;4858;15951;4540;15576;356;1288;3626;13168;3982;14456
150795;201601;15004;47352;13561;45209;3022;10005;7874;27511;10896;37516
150796;201601;2955;8824;2692;8514;385;1246;1979;6436;2364;7682
150797;201601;3583;12306;3325;11874;114;496;2815;10029;2929;10525
150800;201601;13290;44242;12270;42991;2699;8873;7984;29788;10683;38661
150803;201601;6441;23498;6066;22892;694;2763;4421;16908;5115;19671
150805;201601;2521;9082;2366;8823;326;1214;1693;6425;2019;7639
150808;201601;5520;18516;4618;16812;1822;7205;666;2494;2488;9699
150810;201601;18383;57334;15621;53999;2241;7418;10402;38212;12643;45630
150812;201601;5086;16181;4691;15519;511;1965;3244;10386;3755;12351
150815;201601;8201;27090;7383;26066;784;2800;5795;20994;6579;23794
150820;201601;11104;32053;9964;30790;710;1692;8229;26259;8939;27951
150830;201601;12659;47765;11882;46761;697;3443;9690;39191;10387;42634
150835;201601;1996;7050;1856;6792;460;1683;872;3319;1332;5002
150840;201601;6668;20510;5607;18772;1308;4824;2607;8720;3915;13544
160005;201601;715;2517;678;2444;66;276;534;1897;600;2173
160010;201601;1283;4325;1279;4320;48;103;1218;4188;1266;4291
160015;201601;1606;6038;1573;5995;81;303;1429;5519;1510;5822
160020;201601;1869;6809;1766;6678;218;861;1317;5096;1535;5957
160021;201601;961;4144;928;4086;151;773;641;2834;792;3607
160023;201601;995;4026;988;4017;104;421;811;3339;915;3760
160025;201601;1261;3897;1248;3884;28;107;1202;3727;1230;3834
160027;201601;7765;23326;7176;22681;2500;7424;3699;12813;6199;20237
160030;201601;44712;158325;40206;150568;9701;36633;21102;84070;30803;120703
160040;201601;4219;16522;4124;16389;177;1017;3751;14684;3928;15701
160050;201601;2975;11414;2667;10974;1377;5584;763;3531;2140;9115
160053;201601;2673;10411;2613;10325;520;2149;1766;7081;2286;9230
160055;201601;519;2068;512;2059;32;137;444;1790;476;1927
160060;201601;14992;51226;14035;50147;2809;9555;9520;35372;12329;44927
160070;201601;2421;9574;2282;9333;177;875;1922;7793;2099;8668
160080;201601;2484;9437;2447;9392;102;509;2275;8643;2377;9152
170025;201601;477;1610;442;1561;125;444;217;803;342;1247
170030;201601;1118;3682;985;3448;291;1039;335;1231;626;2270
170035;201601;1400;4095;1153;3665;283;998;434;1358;717;2356
170040;201601;1859;5927;1647;5659;209;835;1041;3739;1250;4574
170070;201601;1594;4321;1266;3886;276;925;670;2030;946;2955
170100;201601;2278;6853;1995;6438;244;798;1494;4863;1738;5661
170105;201601;730;2298;575;1985;116;458;264;867;380;1325
170110;201601;926;3063;812;2863;185;708;340;1218;525;1926
170130;201601;1294;4154;1089;3764;315;1117;451;1635;766;2752
170190;201601;1508;4481;1160;3912;432;1417;205;832;637;2249
170200;201601;1547;4375;1013;3359;263;939;230;741;493;1680
170210;201601;30640;87406;24786;78112;7177;24425;6341;21235;13518;45660
170215;201601;1157;3629;986;3371;84;352;699;2361;783;2713
170220;201601;5475;19042;5064;18243;1258;4684;2498;9194;3756;13878
170230;201601;1323;4320;1105;3909;240;952;456;1567;696;2519
170240;201601;2576;7911;2156;7262;273;1092;1434;4784;1707;5876
170255;201601;3242;10495;2755;9657;832;2950;1130;4157;1962;7107
170270;201601;955;2451;688;2084;68;216;466;1403;534;1619
170290;201601;2744;8361;2491;8069;204;466;2080;7161;2284;7627
170300;201601;1872;5801;1565;5303;202;766;977;3346;1179;4112
170305;201601;731;2192;599;1956;112;410;286;942;398;1352
170307;201601;1013;3626;860;3347;177;791;396;1594;573;2385
170310;201601;1555;4346;1181;3719;309;1035;501;1609;810;2644
170320;201601;1090;3164;795;2654;202;721;242;834;444;1555
170330;201601;748;2456;681;2354;84;323;499;1700;583;2023
170360;201601;443;1408;368;1278;85;309;161;556;246;865
170370;201601;1313;3788;1034;3345;202;735;513;1642;715;2377
170380;201601;1693;5502;1381;4993;234;964;701;2547;935;3511
170382;201601;543;1792;464;1664;97;391;261;929;358;1320
170384;201601;1501;6156;1381;5928;325;1478;722;3150;1047;4628
170386;201601;854;2583;750;2425;189;685;313;990;502;1675
170388;201601;601;1821;492;1645;107;417;171;551;278;968
170389;201601;892;3009;810;2874;81;330;586;2061;667;2391
170390;201601;1197;3535;1032;3334;92;321;797;2620;889;2941
170410;201601;527;1680;444;1536;38;155;282;979;320;1134
170460;201601;473;1288;321;1033;69;253;104;330;173;583
170510;201601;745;2518;603;2262;77;337;298;1106;375;1443
170550;201601;6497;18622;4880;15845;1519;5425;637;2094;2156;7519
170555;201601;1248;3687;1016;3323;208;725;472;1602;680;2327
170560;201601;1003;3328;794;3056;169;706;433;1763;602;2469
170600;201601;1268;3749;1133;3566;265;821;714;2322;979;3143
170610;201601;1548;4781;1243;4303;138;542;757;2637;895;3179
170625;201601;400;1236;305;1055;55;185;89;320;144;505
170650;201601;1163;3826;1000;3539;252;957;368;1402;620;2359
170700;201601;3980;12579;3238;11348;682;2598;1367;4963;2049;7561
170710;201601;1725;5168;1399;4585;220;759;798;2661;1018;3420
170720;201601;1787;4869;1522;4449;273;694;1012;3151;1285;3845
170730;201601;926;2760;766;2517;203;695;318;1069;521;1764
170740;201601;2104;7494;1832;7007;290;1152;1141;4448;1431;5600
170755;201601;739;2354;603;2053;120;473;215;718;335;1191
170765;201601;1267;3470;970;2992;274;892;355;1136;629;2028
170770;201601;1628;5601;1489;5363;238;917;908;3291;1146;4208
170820;201601;3393;11056;3070;10537;687;2491;1459;5075;2146;7566
170825;201601;684;2060;568;1842;98;329;238;753;336;1082
170830;201601;1354;4001;1175;3738;128;324;947;3152;1075;3476
170900;201601;2424;8720;2298;8514;211;804;1838;6931;2049;7735
170930;201601;3460;10767;3045;10085;872;3042;1150;3947;2022;6989
170950;201601;13414;39028;10111;33310;2974;11145;1550;5177;4524;16322
170980;201601;486;1460;369;1273;84;322;143;472;227;794
171050;201601;1452;4947;1313;4693;89;403;1025;3633;1114;4036
171070;201601;1438;4608;1318;4434;350;1152;662;2355;1012;3507
171090;201601;1009;2793;842;2559;64;182;607;1858;671;2040
171110;201601;575;1707;435;1448;122;439;172;546;294;985
171150;201601;824;2370;611;2004;101;369;354;1163;455;1532
171180;201601;683;2072;481;1657;112;407;178;665;290;1072
171190;201601;1537;5801;1378;5463;285;1186;642;2686;927;3872
171195;201601;786;2832;684;2642;101;423;386;1533;487;1956
171200;201601;662;2098;534;1852;164;627;173;552;337;1179
171215;201601;446;1334;348;1136;58;207;151;507;209;714
171240;201601;685;2510;630;2401;79;370;405;1584;484;1954
171245;201601;601;2016;495;1767;100;411;151;517;251;928
171250;201601;1003;2980;821;2677;144;518;435;1386;579;1904
171270;201601;389;1612;367;1563;123;498;134;654;257;1152
171280;201601;858;2620;718;2388;182;590;305;1126;487;1716
171320;201601;3695;11268;3134;10310;883;2883;1304;4476;2187;7359
171330;201601;2719;7967;2218;7186;632;2174;920;2960;1552;5134
171360;201601;1304;4402;1189;4227;156;579;805;2908;961;3487
171370;201601;627;1827;542;1710;126;435;277;871;403;1306
171380;201601;1259;4090;1057;3731;422;1478;275;1067;697;2545
171395;201601;849;2605;671;2270;139;555;299;975;438;1530
171420;201601;2038;6360;1620;5586;404;1475;563;1959;967;3434
171430;201601;1028;3170;858;2896;188;639;424;1447;612;2086
171488;201601;2414;7403;2089;6943;473;1566;1105;3846;1578;5412
171500;201601;739;2286;644;2131;94;303;428;1469;522;1772
171510;201601;857;3027;774;2891;69;304;552;2094;621;2398
171515;201601;460;1332;371;1176;57;180;204;639;261;819
171525;201601;608;1971;517;1825;89;354;277;935;366;1289
171550;201601;305;1042;237;911;83;351;41;168;124;519
171570;201601;1189;3790;1038;3496;206;677;656;2259;862;2936
171575;201601;1841;5229;1404;4447;272;881;612;1999;884;2880
171610;201601;5040;16228;4239;14853;1131;4404;1294;4605;2425;9009
171620;201601;2510;7424;2192;7002;99;407;1838;5882;1937;6289
171630;201601;837;2634;688;2395;219;819;277;979;496;1798
171650;201601;2048;6427;1615;5554;437;1606;505;1754;942;3360
171660;201601;2350;6590;1836;5693;227;789;1068;3321;1295;4110
171665;201601;1433;4205;1161;3793;181;657;660;2251;841;2908
171670;201601;1847;5320;1546;4827;429;1459;608;1868;1037;3327
171700;201601;1069;3478;927;3214;129;509;593;2024;722;2533
171720;201601;690;2052;583;1878;208;661;207;718;415;1379
171750;201601;1126;3533;883;3058;250;871;245;897;495;1768
171780;201601;1096;3065;851;2717;95;325;496;1636;591;1961
171790;201601;1300;4615;1190;4427;244;871;739;2916;983;3787
171800;201601;620;1987;554;1898;81;307;369;1303;450;1610
171820;201601;9582;28482;8014;26230;1603;5721;4114;13644;5717;19365
171830;201601;1321;4995;1195;4719;308;1185;519;2146;827;3331
171840;201601;761;2104;652;1954;38;119;537;1617;575;1736
171845;201601;690;1924;541;1672;94;319;268;847;362;1166
171850;201601;911;3267;811;3071;101;445;505;1892;606;2337
171855;201601;1079;3476;991;3316;84;342;723;2368;807;2710
171865;201601;434;1437;380;1352;79;296;185;652;264;948
171870;201601;702;2131;568;1893;138;504;201;717;339;1221
171875;201601;1231;3992;1041;3696;110;472;696;2426;806;2898
171880;201601;773;2954;756;2930;84;331;596;2372;680;2703
171884;201601;950;2647;695;2271;164;595;187;722;351;1317
171886;201601;1353;4453;1093;3923;324;1271;228;829;552;2100
171888;201601;677;2046;529;1764;53;175;289;1006;342;1181
171889;201601;485;1555;436;1476;96;345;210;755;306;1100
171890;201601;1168;3653;984;3388;146;555;564;1938;710;2493
171900;201601;475;1784;421;1683;113;459;188;775;301;1234
172000;201601;528;1781;461;1653;72;280;260;927;332;1207
172010;201601;1141;4000;1061;3871;127;557;763;2771;890;3328
172015;201601;313;1240;267;1153;52;209;150;688;202;897
172020;201601;2197;7386;2048;7149;274;993;1404;4994;1678;5987
172025;201601;690;2026;515;1726;89;326;244;855;333;1181
172030;201601;1109;3649;989;3452;71;316;731;2526;802;2842
172049;201601;1272;3383;946;2834;153;460;676;2091;829;2551
172065;201601;1262;3418;1052;3182;58;171;952;2934;1010;3105
172080;201601;2334;7392;2020;6844;212;839;1288;4322;1500;5161
172085;201601;492;1365;357;1105;55;153;97;310;152;463
172090;201601;3291;9626;2718;8755;228;822;2088;6793;2316;7615
172093;201601;579;1773;463;1587;125;499;213;730;338;1229
172097;201601;574;1768;472;1611;109;370;191;677;300;1047
172100;201601;31519;94502;24575;82408;6786;25334;6028;20437;12814;45771
172110;201601;1622;6109;1447;5828;174;786;1024;4226;1198;5012
172120;201601;4898;15366;4089;14232;625;2183;2588;9394;3213;11577
172125;201601;242;787;204;717;38;155;89;317;127;472
172130;201601;529;1487;420;1309;38;149;281;874;319;1023
172208;201601;2014;6063;1812;5775;313;1024;1036;3366;1349;4390
172210;201601;2410;7495;2128;7088;538;1922;1043;3454;1581;5376
210005;201601;21198;66373;18034;61554;5706;20855;6411;22364;12117;43219
210010;201601;1532;5621;1393;5373;131;554;1038;4077;1169;4631
210015;201601;3269;10466;2918;9939;201;579;2458;8608;2659;9187
210020;201601;6971;16934;6567;16468;212;560;5955;14870;6167;15430
210030;201601;5407;18174;5077;17723;336;1514;4168;14466;4504;15980
210040;201601;1828;5138;1689;4979;104;316;1451;4297;1555;4613
210043;201601;6521;18523;5664;17451;591;1699;4062;13250;4653;14949
210047;201601;6376;24289;5828;23440;620;2854;4275;17252;4895;20106
210050;201601;2228;8319;1876;7631;677;2807;591;2640;1268;5447
210055;201601;1707;5856;1556;5638;178;670;1162;4276;1340;4946
210060;201601;7077;27571;6587;26681;993;4146;4261;17755;5254;21901
210070;201601;6928;20553;6407;19912;161;625;5741;17908;5902;18533
210080;201601;3602;12511;3510;12395;47;237;3314;11685;3361;11922
210083;201601;4275;15005;3940;14651;130;573;3686;13772;3816;14345
210087;201601;2867;8511;2613;8187;292;943;2046;6522;2338;7465
210090;201601;9708;32012;9209;31223;540;1964;7833;26698;8373;28662
210095;201601;5795;21298;5570;20987;377;1542;4619;17618;4996;19160
210100;201601;7058;21416;6486;20725;850;2888;4874;15543;5724;18431
210110;201601;2783;9777;2692;9652;102;473;2422;8650;2524;9123
210120;201601;25609;70084;22335;66322;2763;6966;16116;51386;18879;58352
210125;201601;3479;11132;3357;11005;224;583;2932;9911;3156;10494
210130;201601;4057;12083;3765;11674;292;926;3064;9532;3356;10458
210135;201601;1648;4871;1443;4581;105;348;1156;3700;1261;4048
210140;201601;16543;53098;14469;50327;2672;9779;8830;31919;11502;41698
210150;201601;4485;11108;4039;10560;64;172;3777;9877;3841;10049
210160;201601;17211;54488;16188;53024;1463;4338;12970;43805;14433;48143
210170;201601;13562;48649;13219;48222;706;2653;11730;43300;12436;45953
210173;201601;1910;7940;1845;7839;119;713;1572;6544;1691;7257
210177;201601;2990;9324;2841;9152;162;550;2523;8194;2685;8744
210180;201601;1445;4462;1355;4331;59;216;1142;3617;1201;3833
210190;201601;4753;15232;4420;14629;228;991;3392;11020;3620;12011
210193;201601;1371;4333;1236;4112;73;258;1014;3430;1087;3688
210197;201601;2063;6858;1906;6678;241;812;1452;5279;1693;6091
210200;201601;8216;27770;7616;26913;1073;3555;5603;20675;6676;24230
210203;201601;6389;20643;6080;20241;420;1220;5194;17633;5614;18853
210207;201601;2894;9536;2724;9231;342;1110;1910;6677;2252;7787
210210;201601;8324;28138;7980;27682;82;389;7306;25886;7388;26275
210215;201601;1146;4816;1097;4738;99;479;870;3818;969;4297
210220;201601;5966;22836;5685;22384;396;1740;4665;18570;5061;20310
210230;201601;4976;16457;4691;16021;270;969;3984;13733;4254;14702
210232;201601;12596;40796;10629;38318;1562;5916;6828;26530;8390;32446
210235;201601;3513;11110;3150;10654;189;766;2644;8988;2833;9754
210237;201601;2298;8916;2238;8828;48;258;2104;8305;2152;8563
210240;201601;2973;9367;2784;9109;162;490;2323;7691;2485;8181
210250;201601;5031;16334;4740;15953;132;646;4277;14280;4409;14926
210255;201601;2469;8036;2261;7673;325;1170;1584;5409;1909;6579
210260;201601;5023;16504;4626;15912;628;2088;3335;11857;3963;13945
210270;201601;5316;15038;4670;14147;130;597;4094;12288;4224;12885
210275;201601;3514;8585;3375;8440;52;75;3248;8249;3300;8324
210280;201601;5464;16604;4748;15642;292;1219;3620;11772;3912;12991
210290;201601;5484;18388;5081;17908;354;1245;4255;15242;4609;16487
210300;201601;36818;103737;30712;96262;2129;7165;23134;75698;25263;82863
210310;201601;2849;8073;2622;7781;77;182;2308;6930;2385;7112
210312;201601;2173;6906;2074;6778;65;305;1823;5930;1888;6235
210315;201601;2546;8503;2367;8268;158;618;2005;7080;2163;7698
210317;201601;4086;12539;3895;12307;186;671;3494;11067;3680;11738
210320;201601;18845;60737;17386;58987;949;3406;14703;50759;15652;54165
210325;201601;3498;11060;3125;10499;277;1049;2361;8026;2638;9075
210330;201601;35467;86254;27966;78219;4100;9783;17949;57714;22049;67497
210340;201601;11433;34848;10426;33543;1195;3353;7615;26255;8810;29608
210350;201601;9764;30397;8877;29164;668;2186;7031;23469;7699;25655
210355;201601;3804;14089;3516;13666;217;950;2973;11781;3190;12731
210360;201601;15634;47821;14349;46069;1088;3810;11247;36261;12335;40071
210370;201601;9194;22157;7755;20621;290;567;6826;18843;7116;19410
210375;201601;3042;9346;2594;8767;778;2693;1200;4230;1978;6923
210380;201601;5955;16656;5309;15780;435;1185;4286;13038;4721;14223
210390;201601;2824;10163;2573;9766;137;729;2166;8196;2303;8925
210400;201601;4694;14919;4497;14697;127;388;4227;13943;4354;14331
210405;201601;8207;22565;6627;20354;2184;6765;2235;7734;4419;14499
210407;201601;2007;7170;1751;6736;202;768;1256;4973;1458;5741
210408;201601;2372;9194;2220;9004;146;671;1866;7821;2012;8492
210409;201601;3642;13412;3442;13127;220;1063;2811;10735;3031;11798
210410;201601;3439;11511;3345;11403;354;1056;2697;9648;3051;10704
210420;201601;3922;13070;3600;12527;271;909;2862;10165;3133;11074
210430;201601;2142;6641;2066;6555;113;361;1805;5759;1918;6120
210440;201601;3903;12362;3790;12218;199;580;3414;11164;3613;11744
210450;201601;2777;8763;2478;8330;154;542;1971;6612;2125;7154
210455;201601;3847;11340;3465;10775;554;1709;2388;7753;2942;9462
210460;201601;3530;11740;3298;11381;185;755;2704;9345;2889;10100
210462;201601;1450;5299;1357;5129;91;441;1069;4036;1160;4477
210465;201601;2493;8332;2334;8110;215;621;1919;6908;2134;7529
210467;201601;6022;20208;5626;19748;428;1550;4677;16644;5105;18194
210470;201601;2014;5493;1547;4817;84;240;1147;3636;1231;3876
210480;201601;13986;45541;12304;43367;2616;8991;7666;29072;10282;38063
210490;201601;3546;10001;3115;9407;147;494;2598;7823;2745;8317
210500;201601;6199;25708;5977;25321;774;3206;4410;19334;5184;22540
210510;201601;6385;21933;6066;21562;372;1161;5129;18819;5501;19980
210515;201601;3570;11524;3418;11353;97;301;3188;10744;3285;11045
210520;201601;2544;7855;2334;7560;158;486;1950;6445;2108;6931
210530;201601;35773;111044;29111;101079;7389;28881;11919;42852;19308;71733
210535;201601;3139;10903;3015;10736;105;358;2707;9775;2812;10133
210540;201601;13195;43659;11623;41436;2590;8967;6352;24669;8942;33636
210542;201601;5629;16430;5163;15926;315;762;4458;14176;4773;14938
210545;201601;2252;7414;2147;7239;62;317;1877;6258;1939;6575
210547;201601;3692;13207;3462;12830;289;966;2683;10259;2972;11225
210550;201601;5956;17846;5473;17345;262;635;5003;16297;5265;16932
210560;201601;4046;12740;3626;12057;210;777;3002;9972;3212;10749
210565;201601;1462;5230;1261;4917;104;528;919;3610;1023;4138
210570;201601;12148;34572;11036;33314;813;1832;9382;29406;10195;31238
210580;201601;3105;9299;2794;8915;323;768;2113;7364;2436;8132
210590;201601;4001;12674;3719;12326;317;1106;3104;10347;3421;11453
210592;201601;2408;7645;2318;7500;45;203;2050;6627;2095;6830
210594;201601;2616;7393;2135;6690;103;296;1671;5384;1774;5680
210596;201601;2648;9899;2510;9640;284;1161;1831;7155;2115;8316
210598;201601;1839;5765;1685;5577;100;373;1435;4718;1535;5091
210600;201601;3126;9153;2749;8653;194;630;2145;6768;2339;7398
210610;201601;2457;8154;2307;7960;130;567;1997;6801;2127;7368
210620;201601;1869;6091;1755;5954;54;157;1585;5488;1639;5645
210630;201601;3556;12687;3195;12096;365;1586;2174;8293;2539;9879
210632;201601;4415;15547;4133;15131;443;1755;3170;11634;3613;13389
210635;201601;1841;6488;1747;6346;127;431;1497;5555;1624;5986
210637;201601;2627;8935;2425;8661;158;626;1964;7072;2122;7698
210640;201601;4140;15063;4071;14986;9;36;3966;14744;3975;14780
210650;201601;6788;20736;6588;20492;265;840;6151;19202;6416;20042
210660;201601;7806;23538;7244;22741;257;927;6583;20615;6840;21542
210663;201601;2654;7949;2493;7758;195;678;2044;6401;2239;7079
210667;201601;1799;6332;1704;6188;87;392;1460;5330;1547;5722
210670;201601;4342;16260;4135;15920;232;1041;3419;13272;3651;14313
210675;201601;4915;13790;4546;13349;353;902;3760;11365;4113;12267
210680;201601;4031;11165;3597;10653;197;513;3066;9217;3263;9730
210690;201601;7151;24144;6875;23851;286;937;6080;21744;6366;22681
210700;201601;2564;7717;2381;7517;391;938;1654;6006;2045;6944
210710;201601;4733;15647;4474;15251;220;931;3750;12729;3970;13660
210720;201601;2532;9259;2392;9065;143;660;2089;7871;2232;8531
210725;201601;1069;4058;960;3862;126;550;594;2447;720;2997
210730;201601;1099;3507;981;3335;106;303;741;2598;847;2901
210735;201601;4067;14233;3727;13676;651;2427;2490;9468;3141;11895
210740;201601;4888;14595;4622;14322;211;925;4159;12603;4370;13528
210745;201601;3846;11438;3607;11137;252;681;3016;9421;3268;10102
210750;201601;20021;54361;17689;51751;2006;5846;13435;40384;15441;46230
210760;201601;5807;16490;5406;16070;41;141;5248;15648;5289;15789
210770;201601;5726;15907;5024;15109;126;516;4539;13624;4665;14140
210780;201601;8100;27165;7442;26065;847;3029;5246;18870;6093;21899
210790;201601;4575;14500;4171;14043;283;729;3402;12097;3685;12826
210800;201601;4692;13390;4260;12881;162;481;3757;11494;3919;11975
210805;201601;3646;15377;3521;15162;168;886;3019;13105;3187;13991
210810;201601;5224;16153;4873;15708;384;797;4132;13988;4516;14785
210820;201601;7590;22130;6937;21211;1176;3458;4560;14411;5736;17869
210825;201601;5578;19312;5321;18960;650;2206;4082;15020;4732;17226
210830;201601;8171;24251;7764;23769;858;2271;6151;19625;7009;21896
210840;201601;3604;9946;3242;9418;173;442;2653;7754;2826;8196
210845;201601;5629;17376;5452;17184;96;217;5214;16686;5310;16903
210850;201601;5948;21327;5407;20435;741;3167;3645;13782;4386;16949
210860;201601;17420;52022;15715;49723;1381;4409;12182;39173;13563;43582
210870;201601;5726;19325;5250;18728;589;2057;3972;14476;4561;16533
210880;201601;4212;13768;4015;13515;333;1226;3284;11078;3617;12304
210890;201601;5131;15178;4676;14660;547;1528;3714;12206;4261;13734
210900;201601;4876;14680;4036;13319;1425;4946;1017;3630;2442;8576
210905;201601;1784;5695;1614;5461;146;391;1252;4427;1398;4818
210910;201601;8415;26902;7616;25595;1164;4172;5069;17185;6233;21357
210920;201601;2870;10345;2746;10140;167;769;2248;8295;2415;9064
210923;201601;1484;5125;1382;4980;158;635;915;3419;1073;4054
210927;201601;4726;15199;4485;14944;61;236;4292;14367;4353;14603
210930;201601;2397;8887;2264;8697;135;763;1898;7152;2033;7915
210940;201601;2782;10837;2723;10730;184;817;2294;9046;2478;9863
210945;201601;5743;17427;5555;17230;261;358;5185;16548;5446;16906
210950;201601;5238;16169;4557;15110;431;1439;3378;11459;3809;12898
210955;201601;1850;6020;1643;5716;187;655;1128;4102;1315;4757
210960;201601;8531;28040;8167;27553;2178;7150;4632;16592;6810;23742
210970;201601;1326;4761;1176;4523;157;702;808;3102;965;3804
210975;201601;1740;5864;1670;5749;131;475;1316;4562;1447;5037
210980;201601;9777;23357;9457;23031;860;1706;8128;20480;8988;22186
210990;201601;16471;50194;13424;46068;3093;11173;6655;23885;9748;35058
211000;201601;15060;48982;13437;47048;813;3443;11086;39368;11899;42811
211003;201601;4705;16878;4311;16343;322;1502;3245;12602;3567;14104
211010;201601;6391;23296;6144;23011;91;427;5837;21981;5928;22408
211020;201601;7288;23770;7079;23459;636;2249;5717;18947;6353;21196
211023;201601;2203;7498;2132;7379;182;685;1733;6011;1915;6696
211027;201601;2888;11180;2814;11066;305;1230;2231;8893;2536;10123
211030;201601;3784;11761;3542;11506;568;1370;2663;9419;3231;10789
211040;201601;4252;16191;4086;15937;149;808;3556;13936;3705;14744
211050;201601;9955;26007;9616;25636;346;829;8897;23812;9243;24641
211060;201601;5980;21371;5810;21137;476;1798;4946;18207;5422;20005
211065;201601;1844;6174;1702;5993;72;230;1556;5569;1628;5799
211070;201601;7936;27412;7316;26417;418;1649;6043;22102;6461;23751
211080;201601;1309;4053;1124;3771;84;397;857;2769;941;3166
211085;201601;1842;6380;1683;6113;309;1158;1047;3873;1356;5031
211090;201601;3424;10154;3214;9872;127;517;2755;8345;2882;8862
211100;201601;6536;16887;6393;16738;38;130;6225;16323;6263;16453
211102;201601;2961;11232;2797;11003;248;986;2320;9318;2568;10304
211105;201601;2622;8480;2248;7917;220;869;1651;5779;1871;6648
211107;201601;4338;13971;3933;13455;232;799;3188;11271;3420;12070
211110;201601;6248;18690;5058;16921;1010;3297;2928;10332;3938;13629
211120;201601;34842;97240;31409;93233;5655;16012;20982;65252;26637;81264
211125;201601;2053;6571;1818;6201;122;465;1503;5144;1625;5609
211130;201601;131368;367703;119896;353622;22629;67055;73869;223816;96498;290871
211140;201601;5203;16784;4860;16282;189;735;4114;13786;4303;14521
211150;201601;9460;27726;8561;26604;461;1678;7145;22205;7606;23883
211153;201601;2751;8535;2531;8249;394;1222;1865;6291;2259;7513
211157;201601;1186;3811;1028;3576;90;402;680;2443;770;2845
211160;201601;4065;13457;3467;12468;266;1294;2388;8367;2654;9661
211163;201601;1628;5434;1539;5314;44;138;1387;4894;1431;5032
211167;201601;1471;4959;1409;4876;37;176;1313;4543;1350;4719
211170;201601;6223;16593;5961;16286;106;318;5518;15019;5624;15337
211172;201601;2385;7101;2173;6806;137;588;1806;5548;1943;6136
211174;201601;2716;7986;2452;7659;74;369;2198;6750;2272;7119
211176;201601;4162;13146;3599;12408;423;1569;2498;8774;2921;10343
211178;201601;3761;10051;3553;9832;70;181;3375;9343;3445;9524
211180;201601;4136;14591;3908;14254;303;1238;3198;11788;3501;13026
211190;201601;2736;9289;2537;9000;80;392;2205;7821;2285;8213
211195;201601;1450;4442;1214;4151;69;206;1010;3581;1079;3787
211200;201601;2132;7111;1878;6765;376;1281;1117;4322;1493;5603
211210;201601;6718;20693;6394;20268;483;1466;5296;16995;5779;18461
211220;201601;33153;96916;28967;91634;5790;18815;17688;57579;23478;76394
211223;201601;4930;14758;4519;14114;643;2031;3133;9887;3776;11918
211227;201601;1559;5610;1425;5402;154;648;1080;4130;1234;4778
211230;201601;8232;26999;7467;25759;837;2979;5522;19372;6359;22351
211240;201601;7910;27405;7511;26920;266;1213;6719;23887;6985;25100
211245;201601;5309;15950;5276;15915;138;226;5083;15580;5221;15806
211250;201601;12798;42790;12078;41961;1678;4729;9113;34060;10791;38789
211260;201601;8441;26302;8079;25821;558;1932;7054;22518;7612;24450
211270;201601;10125;34936;9094;33659;542;2453;7102;26867;7644;29320
211280;201601;12598;37519;11800;36571;1158;3046;9508;30683;10666;33729
211285;201601;1684;6215;1486;5787;277;1155;731;2983;1008;4138
211290;201601;7083;23437;6813;23091;581;1714;5676;19750;6257;21464
211300;201601;8105;24584;7597;23913;163;483;7057;22419;7220;22902
211400;201601;11595;36416;10293;34620;2846;9778;4733;17544;7579;27322
220005;201601;1812;5244;1671;5040;73;287;1356;3993;1429;4280
220010;201601;1319;3925;1178;3708;60;244;927;2854;987;3098
220020;201601;3219;10271;3050;9990;610;1988;1848;6107;2458;8095
220025;201601;2188;5429;1989;5134;24;76;1687;4293;1711;4369
220027;201601;1344;3654;1215;3488;64;196;988;2857;1052;3053
220030;201601;3089;8679;3031;8596;156;535;2657;7440;2813;7975
220040;201601;7364;23183;6862;22300;1446;4692;4137;13519;5583;18211
220045;201601;1365;4511;1246;4282;60;261;951;3210;1011;3471
220050;201601;4328;13176;3814;12315;216;872;3020;9636;3236;10508
220060;201601;1908;4934;1809;4821;49;101;1645;4399;1694;4500
220070;201601;2352;7020;2167;6727;155;484;1735;5396;1890;5880
220080;201601;683;2088;635;2017;56;237;522;1599;578;1836
220090;201601;1732;4438;1465;4089;57;191;1268;3477;1325;3668
220095;201601;708;1937;661;1874;15;71;605;1678;620;1749
220100;201601;1313;4031;1119;3704;91;346;822;2708;913;3054
220105;201601;2201;7051;1976;6634;165;534;1428;4861;1593;5395
220110;201601;3271;9649;3075;9334;118;484;2674;7966;2792;8450
220115;201601;2378;8269;2285;8122;145;608;2001;7061;2146;7669
220117;201601;1277;3432;1065;3115;70;205;854;2510;924;2715
220120;201601;11953;34830;11100;33820;150;676;10404;31624;10554;32300
220130;201601;790;2850;724;2740;35;201;616;2288;651;2489
220140;201601;1624;4390;1443;4173;223;516;1107;3351;1330;3867
220150;201601;6823;21161;6465;20662;179;757;5663;17906;5842;18663
220155;201601;1089;3363;893;3005;49;205;583;1923;632;2128
220157;201601;1038;2654;932;2498;23;72;810;2147;833;2219
220160;201601;2551;7734;2284;7256;97;436;1822;5689;1919;6125
220170;201601;1338;4126;1155;3832;56;261;915;3004;971;3265
220173;201601;2025;6142;1678;5479;46;219;1322;4241;1368;4460
220177;201601;1730;5169;1701;5131;52;201;1591;4773;1643;4974
220180;201601;1105;3072;932;2749;26;97;648;1835;674;1932
220190;201601;4385;14781;4115;14401;608;2173;2998;10559;3606;12732
220191;201601;1388;4609;1312;4481;166;585;939;3177;1105;3762
220192;201601;1709;4906;1375;4316;100;345;970;3047;1070;3392
220194;201601;1612;4939;1454;4676;116;414;1079;3397;1195;3811
220196;201601;1917;5748;1765;5494;164;566;1344;4175;1508;4741
220198;201601;1305;3762;1012;3376;14;49;942;3191;956;3240
220200;201601;4280;14482;4024;14126;620;2214;2855;10135;3475;12349
220202;201601;2076;6419;1864;6059;43;212;1600;5098;1643;5310
220205;201601;2705;7125;2441;6756;38;157;2182;5971;2220;6128
220207;201601;872;2676;752;2465;71;291;534;1720;605;2011
220208;201601;1784;5763;1551;5358;236;930;926;3180;1162;4110
220209;201601;1500;4588;1362;4374;49;217;1104;3509;1153;3726
220210;201601;1653;4515;1473;4241;36;156;1220;3434;1256;3590
220211;201601;1531;4497;1465;4422;66;281;1275;3768;1341;4049
220213;201601;1684;4849;1569;4638;34;136;1279;3682;1313;3818
220217;201601;1916;6238;1849;6163;43;174;1706;5738;1749;5912
220220;201601;10594;29661;9575;28158;757;1987;6967;21043;7724;23030
220225;201601;1068;3128;901;2906;37;137;739;2368;776;2505
220230;201601;5147;14459;4716;13838;155;465;4173;12282;4328;12747
220240;201601;2814;8824;2609;8465;153;578;2052;6631;2205;7209
220245;201601;1458;3958;1265;3692;25;91;1122;3316;1147;3407
220250;201601;3112;8970;2865;8604;83;327;2495;7483;2578;7810
220253;201601;1600;4863;1386;4480;171;621;964;3084;1135;3705
220255;201601;1697;4834;1478;4466;52;225;1182;3404;1234;3629
220260;201601;4598;14885;4104;13985;324;1148;2994;10322;3318;11470
220265;201601;1313;4565;1200;4391;125;511;759;2840;884;3351
220270;201601;6654;21560;6435;21181;355;1651;5363;17077;5718;18728
220271;201601;1454;4099;1317;3884;91;237;1086;3270;1177;3507
220272;201601;1738;5314;1589;5066;55;230;1255;3935;1310;4165
220273;201601;1181;3461;1051;3233;89;278;759;2329;848;2607
220275;201601;2028;5251;1693;4849;30;137;1524;4296;1554;4433
220277;201601;2173;6136;1940;5778;84;285;1544;4547;1628;4832
220280;201601;1522;4150;1347;3845;87;317;1064;2950;1151;3267
220285;201601;1553;4206;1297;3848;22;93;1169;3482;1191;3575
220290;201601;5786;19780;5078;18792;469;2023;3731;13857;4200;15880
220300;201601;1779;6041;1635;5827;83;438;1332;4634;1415;5072
220310;201601;2310;8050;2195;7921;83;359;1894;6976;1977;7335
220320;201601;3053;9361;2606;8546;262;971;1813;5901;2075;6872
220323;201601;1424;5124;1252;4873;148;622;946;3716;1094;4338
220325;201601;1138;3703;977;3380;78;328;689;2372;767;2700
220327;201601;1279;4157;1178;3986;33;179;961;3176;994;3355
220330;201601;3393;9488;3146;9186;111;327;2834;8345;2945;8672
220335;201601;1811;5564;1648;5380;40;117;1531;5058;1571;5175
220340;201601;1802;5051;1559;4685;96;309;1206;3606;1302;3915
220342;201601;1084;3641;1020;3545;63;280;819;2824;882;3104
220345;201601;2829;7334;2506;6846;66;157;2273;6228;2339;6385
220350;201601;3869;10363;3342;9544;202;604;2571;7298;2773;7902
220360;201601;1243;3500;1081;3247;102;340;813;2406;915;2746
220370;201601;8965;26073;8200;25099;365;1291;7220;22025;7585;23316
220375;201601;1457;4662;1368;4552;16;56;1313;4408;1329;4464
220380;201601;1353;3663;1145;3382;46;161;940;2723;986;2884
220385;201601;823;2125;670;1884;16;62;535;1472;551;1534
220390;201601;9147;28389;8191;26734;2087;7057;3035;10189;5122;17246
220400;201601;1499;3582;1213;3142;43;151;994;2491;1037;2642
220410;201601;1188;3511;1043;3284;71;270;811;2507;882;2777
220415;201601;861;2363;762;2235;57;170;541;1566;598;1736
220420;201601;2113;6170;1806;5571;81;246;1410;4355;1491;4601
220430;201601;2497;7180;2432;7096;133;460;2121;6124;2254;6584
220435;201601;1588;4771;1467;4571;43;168;1207;3730;1250;3898
220440;201601;2305;7726;2172;7552;140;540;1805;6195;1945;6735
220450;201601;2045;6391;1729;5937;388;1421;976;3383;1364;4804
220455;201601;1291;4148;1208;4029;52;199;1089;3649;1141;3848
220460;201601;879;2401;811;2325;42;121;701;1991;743;2112
220465;201601;2279;7646;2089;7351;525;1945;1174;4183;1699;6128
220470;201601;3736;11205;3435;10720;188;616;2664;8239;2852;8855
220480;201601;2443;7026;2193;6670;149;413;1687;5174;1836;5587
220490;201601;2229;6455;2058;6243;55;216;1817;5467;1872;5683
220500;201601;3166;8618;2717;7858;89;411;2159;6050;2248;6461
220510;201601;2685;7836;2194;7003;101;387;1588;5030;1689;5417
220515;201601;1831;4560;1637;4301;158;375;1303;3472;1461;3847
220520;201601;5050;13940;4626;13383;114;358;4141;12033;4255;12391
220525;201601;1249;3582;1187;3484;43;145;1017;2975;1060;3120
220527;201601;1348;4175;1194;3868;140;467;836;2768;976;3235
220530;201601;1221;3544;1086;3348;52;216;940;2831;992;3047
220535;201601;857;2617;814;2560;84;284;606;1889;690;2173
220540;201601;3386;11067;3244;10846;131;573;2804;9295;2935;9868
220545;201601;1353;4580;1290;4458;160;612;938;3213;1098;3825
220550;201601;8931;28953;8334;27991;928;3283;6038;20260;6966;23543
220551;201601;1408;4596;1293;4417;68;314;1031;3475;1099;3789
220552;201601;1552;4896;1352;4513;60;307;1030;3318;1090;3625
220553;201601;1577;4635;1303;4217;50;208;992;3283;1042;3491
220554;201601;772;2286;689;2155;62;204;533;1660;595;1864
220555;201601;2191;6692;2038;6486;47;232;1845;5805;1892;6037
220556;201601;1421;4421;1274;4139;58;230;962;3054;1020;3284
220557;201601;1536;4991;1385;4701;139;488;930;3165;1069;3653
220558;201601;1037;3235;942;3071;59;271;721;2269;780;2540
220559;201601;1483;4232;1353;4004;30;98;1165;3435;1195;3533
220560;201601;1599;4038;1351;3708;62;174;1124;3035;1186;3209
220570;201601;7133;23188;6718;22454;1399;4672;3988;13741;5387;18413
220580;201601;6317;20305;6178;20105;279;928;5580;18155;5859;19083
220585;201601;1997;7046;1878;6829;175;676;1477;5369;1652;6045
220590;201601;1291;3905;1168;3731;191;646;778;2551;969;3197
220595;201601;2239;6692;2089;6494;39;182;1894;5830;1933;6012
220600;201601;1252;3055;1041;2794;173;305;751;2188;924;2493
220605;201601;1903;5625;1665;5248;77;266;1332;4149;1409;4415
220610;201601;2626;8061;2522;7918;60;244;2290;7165;2350;7409
220620;201601;7363;24850;7097;24489;329;1610;6264;21300;6593;22910
220630;201601;386;1204;328;1096;55;184;173;592;228;776
220635;201601;1633;5772;1478;5433;82;412;1067;3828;1149;4240
220640;201601;2599;7636;2347;7283;114;406;1960;6034;2074;6440
220650;201601;2181;6424;1961;6033;128;444;1490;4573;1618;5017
220660;201601;2465;7948;2235;7637;153;738;1846;6109;1999;6847
220665;201601;1142;3964;1068;3833;24;128;948;3391;972;3519
220667;201601;1677;5556;1581;5413;74;255;1315;4518;1389;4773
220669;201601;1829;6006;1737;5848;251;1025;1178;3874;1429;4899
220670;201601;1918;5751;1712;5482;134;354;1404;4638;1538;4992
220672;201601;2434;7073;2295;6909;214;656;1893;5760;2107;6416
220675;201601;1252;3609;1173;3469;70;171;923;2757;993;2928
220680;201601;2256;7272;2128;7106;155;516;1768;5960;1923;6476
220690;201601;1657;4634;1442;4293;113;341;1115;3376;1228;3717
220695;201601;909;2580;832;2453;36;115;658;1929;694;2044
220700;201601;8332;23940;7273;22307;501;1736;5525;16808;6026;18544
220710;201601;799;2379;680;2173;40;118;492;1584;532;1702
220720;201601;1999;5346;1901;5223;52;161;1675;4574;1727;4735
220730;201601;1341;3816;1148;3520;23;113;978;2965;1001;3078
220735;201601;986;2559;797;2231;42;130;639;1767;681;1897
220740;201601;1345;4321;1181;4102;101;333;948;3388;1049;3721
220750;201601;3883;11209;3604;10787;402;991;2779;8601;3181;9592
220755;201601;1184;3351;1064;3158;50;177;850;2482;900;2659
220760;201601;2595;9061;2397;8798;149;749;2002;7239;2151;7988
220770;201601;21702;72269;19544;68193;6343;23222;6184;22542;12527;45764
220775;201601;1237;3331;1194;3283;15;42;1159;3188;1174;3230
220777;201601;1585;4374;1374;4063;73;186;1074;3179;1147;3365
220779;201601;1292;3475;1241;3402;42;168;1111;2954;1153;3122
220780;201601;5741;15550;5088;14581;395;1128;4048;11661;4443;12789
220785;201601;1229;3283;1161;3174;46;129;1048;2836;1094;2965
220790;201601;9839;30389;9130;29301;735;2641;7257;23122;7992;25763
220793;201601;806;2333;735;2230;40;152;606;1831;646;1983
220795;201601;1407;4059;1364;4000;62;186;1239;3649;1301;3835
220800;201601;15755;43491;14219;41355;934;3181;10643;30515;11577;33696
220810;201601;3247;9482;2827;8773;121;504;2239;6847;2360;7351
220820;201601;5296;14619;4871;14035;250;728;4223;12119;4473;12847
220830;201601;7383;20871;6880;20084;606;1808;5358;15687;5964;17495
220840;201601;13856;44098;12394;41230;2897;9768;5646;19241;8543;29009
220850;201601;2798;9731;2657;9554;112;510;2370;8536;2482;9046
220855;201601;615;1888;539;1754;35;147;400;1264;435;1411
220860;201601;918;2491;817;2332;35;124;689;1938;724;2062
220865;201601;2554;7093;2071;6254;64;317;1646;4797;1710;5114
220870;201601;2203;7445;1966;7135;60;283;1777;6436;1837;6719
220880;201601;4660;12734;4361;12384;89;267;4067;11591;4156;11858
220885;201601;1239;4539;1104;4282;87;416;826;3176;913;3592
220887;201601;1357;3404;1195;3176;17;65;1103;2913;1120;2978
220890;201601;1592;5555;1430;5255;121;442;1091;4098;1212;4540
220900;201601;1784;5150;1589;4855;52;153;1339;4065;1391;4218
220910;201601;1496;4625;1325;4374;42;132;1164;3914;1206;4046
220915;201601;1005;2850;871;2598;28;117;663;1922;691;2039
220920;201601;1318;4746;1195;4571;90;450;884;3317;974;3767
220930;201601;1355;4515;1294;4424;57;253;1080;3683;1137;3936
220935;201601;1056;3244;957;3045;46;189;633;1948;679;2137
220937;201601;1493;4107;1262;3721;58;221;964;2764;1022;2985
220940;201601;1311;4185;1226;4021;74;321;898;2901;972;3222
220945;201601;423;1577;387;1505;33;150;275;1057;308;1207
220950;201601;1285;3218;963;2711;31;119;697;1905;728;2024
220955;201601;1408;4105;1244;3821;84;262;929;2852;1013;3114
220960;201601;891;2330;708;2026;19;62;552;1571;571;1633
220965;201601;1604;4838;1516;4707;52;265;1290;3871;1342;4136
220970;201601;2125;5684;1595;4829;145;456;1070;3286;1215;3742
220975;201601;655;2161;610;2101;26;151;554;1850;580;2001
220980;201601;1251;3810;1099;3562;81;293;807;2619;888;2912
220985;201601;1167;3481;1105;3396;86;318;839;2511;925;2829
220987;201601;1462;4671;1320;4442;81;371;1010;3321;1091;3692
220990;201601;1785;5206;1561;4833;36;193;1223;3694;1259;3887
220995;201601;1256;3701;957;3230;110;390;648;2270;758;2660
220997;201601;2175;6840;2083;6711;49;222;1929;6172;1978;6394
221000;201601;4133;12761;3875;12324;333;1241;2969;9308;3302;10549
221005;201601;1437;4517;1322;4305;529;1592;509;1819;1038;3411
221010;201601;1101;2972;953;2789;40;128;817;2372;857;2500
221020;201601;1733;5417;1616;5208;65;281;1196;3780;1261;4061
221030;201601;1456;4381;1322;4159;66;284;1069;3319;1135;3603
221035;201601;1425;3961;1341;3851;58;127;1229;3611;1287;3738
221037;201601;618;1835;553;1732;14;55;399;1199;413;1254
221038;201601;594;1670;485;1482;44;135;298;919;342;1054
221039;201601;901;2578;820;2461;54;220;660;1908;714;2128
221040;201601;4502;14039;4230;13599;188;670;3448;11151;3636;11821
221050;201601;3421;10495;3219;10225;164;591;2768;8757;2932;9348
221060;201601;7924;23397;6980;21894;606;2061;5186;16235;5792;18296
221062;201601;1242;4415;1154;4244;52;277;947;3447;999;3724
221063;201601;1035;3441;949;3276;219;703;547;2023;766;2726
221065;201601;2750;7549;2486;7138;128;360;2035;5786;2163;6146
221070;201601;3666;11720;3248;11001;141;562;2589;8798;2730;9360
221080;201601;3353;8797;2863;8129;102;332;2422;6865;2524;7197
221090;201601;1372;3810;1171;3484;34;149;966;2818;1000;2967
221093;201601;1614;4853;1528;4679;265;848;856;2562;1121;3410
221095;201601;923;2484;826;2341;15;46;708;1993;723;2039
221097;201601;777;2209;638;1962;36;149;442;1312;478;1461
221100;201601;109805;322296;100972;307831;19788;63327;57804;173841;77592;237168
221110;201601;10047;31916;9379;31102;429;1820;7872;25806;8301;27626
221120;201601;3940;12923;3739;12577;737;2577;2358;7985;3095;10562
221130;201601;4443;12985;3803;11675;1127;3476;1618;5048;2745;8524
221135;201601;1480;4569;1369;4422;108;417;1142;3644;1250;4061
221140;201601;1311;3227;1192;3072;39;95;1037;2655;1076;2750
221150;201601;1184;3052;986;2716;28;119;762;2053;790;2172
221160;201601;807;2136;761;2072;36;97;595;1627;631;1724
221170;201601;1121;3478;1040;3347;51;179;836;2682;887;2861
230010;201601;3360;9077;2695;7944;211;701;2024;5853;2235;6554
230015;201601;2870;9973;2703;9615;402;1602;1620;5664;2022;7266
230020;201601;13472;44200;13109;43605;709;2698;11035;36609;11744;39307
230030;201601;11804;34109;10656;32330;467;1688;8712;26190;9179;27878
230040;201601;4454;12258;3764;11074;302;1037;2666;7714;2968;8751
230050;201601;2621;8981;2096;7617;438;1668;719;2644;1157;4312
230060;201601;2164;6235;1860;5700;72;284;1410;4252;1482;4536
230070;201601;4126;11513;3570;10607;304;1061;2388;7110;2692;8171
230075;201601;8636;31068;8101;30005;561;2948;6222;22402;6783;25350
230080;201601;2359;6232;1921;5601;97;345;1562;4521;1659;4866
230090;201601;3751;10971;3345;10282;434;1512;2298;7055;2732;8567
230100;201601;16268;48601;15002;46364;2485;8282;8828;27486;11313;35768
230110;201601;12893;41130;11881;39024;2251;7694;6243;20325;8494;28019
230120;201601;7832;21780;6769;20217;782;2241;4456;14078;5238;16319
230125;201601;3018;8756;2504;7845;175;642;1793;5552;1968;6194
230130;201601;5714;18747;4920;17074;438;1719;3285;11279;3723;12998
230140;201601;3441;11026;2936;10115;328;1231;1965;6859;2293;8090
230150;201601;1659;5227;1439;4775;284;1018;744;2434;1028;3452
230160;201601;6108;18379;5494;17467;282;1130;4365;13743;4647;14873
230170;201601;6205;19572;5416;18100;350;1360;3810;12609;4160;13969
230180;201601;1685;4991;1484;4588;85;366;1060;3128;1145;3494
230185;201601;3889;12723;3513;12044;579;2023;2133;7537;2712;9560
230190;201601;12450;39874;11036;37037;2223;8120;5154;17157;7377;25277
230195;201601;5157;15799;4533;14754;361;1433;3420;10847;3781;12280
230200;201601;5038;14600;4539;13640;425;1351;3291;9812;3716;11163
230205;201601;4112;13334;3712;12638;239;1080;2623;8794;2862;9874
230210;201601;8753;25329;7683;23657;1457;4544;4382;13836;5839;18380
230220;201601;12847;36861;11632;34784;1094;3685;8303;24390;9397;28075
230230;201601;7178;23121;6589;21982;890;3007;4309;14533;5199;17540
230240;201601;13612;38395;12055;35844;573;2019;9293;27235;9866;29254
230250;201601;9642;30092;9565;29969;561;2119;7487;23101;8048;25220
230260;201601;14077;47293;13138;45407;2182;8082;7300;25726;9482;33808
230270;201601;7411;21918;6386;20153;731;2576;4137;13151;4868;15727
230280;201601;19369;57398;17373;54044;1651;5327;12594;39186;14245;44513
230290;201601;4773;14452;4097;13096;573;1770;2670;8610;3243;10380
230300;201601;4332;13096;4138;12823;265;1013;3344;10212;3609;11225
230310;201601;4723;14177;4181;13263;233;958;3010;9383;3243;10341
230320;201601;6917;21744;6322;20719;443;1793;4625;14946;5068;16739
230330;201601;4675;13790;4003;12491;322;1098;2784;8585;3106;9683
230340;201601;3279;11130;2995;10535;367;1437;1881;6499;2248;7936
230350;201601;17747;54228;16233;51666;1914;7017;9536;30748;11450;37765
230360;201601;3237;9258;2630;8144;236;818;1698;5175;1934;5993
230365;201601;2953;8059;2590;7443;121;462;2038;5796;2159;6258
230370;201601;53162;170710;48264;162387;12862;45308;20146;70422;33008;115730
230380;201601;6288;18687;5302;16850;308;1044;3726;11821;4034;12865
230390;201601;3443;10932;3065;10294;232;1037;2146;7044;2378;8081
230393;201601;3157;10416;2724;9557;190;937;1928;6509;2118;7446
230395;201601;5584;16418;5009;15444;790;2478;2922;9292;3712;11770
230400;201601;5377;16383;4741;15373;274;1235;3630;11519;3904;12754
230410;201601;14243;45475;12441;41734;1732;6148;7279;24484;9011;30632
230420;201601;23673;76547;21586;72492;4782;17282;9803;32689;14585;49971
230423;201601;4074;13530;3773;12942;249;1053;2809;9553;3058;10606
230425;201601;5457;18215;5036;17327;705;2490;3154;10927;3859;13417
230426;201601;2648;7453;2123;6471;75;321;1560;4630;1635;4951
230427;201601;1824;5429;1402;4510;183;608;774;2418;957;3026
230428;201601;8491;26482;8092;25776;1302;4565;4637;14565;5939;19130
230430;201601;4498;14319;4169;13730;307;1271;2984;9592;3291;10863
230435;201601;4846;15461;4360;14574;776;2987;2306;7552;3082;10539
230440;201601;344288;1021815;315968;974003;74040;239048;141789;441629;215829;680677
230445;201601;4474;12140;3821;11166;278;813;2672;7834;2950;8647
230450;201601;3509;11167;3074;10374;356;1529;1986;6552;2342;8081
230460;201601;1908;6281;1659;5827;166;664;1129;3936;1295;4600
230465;201601;3999;11943;3382;10826;240;1011;2217;6883;2457;7894
230470;201601;10674;39083;9898;37480;1322;5466;6602;25080;7924;30546
230480;201601;1438;4540;1214;4125;154;596;794;2656;948;3252
230490;201601;2242;6883;1960;6339;301;1036;942;2947;1243;3983
230495;201601;5702;18857;5123;17833;701;2936;2773;9526;3474;12462
230500;201601;8806;31374;8418;30620;590;2633;6305;22878;6895;25511
230510;201601;1481;5261;1168;4476;305;1275;344;1327;649;2602
230520;201601;4767;14581;4315;13785;458;1665;2738;8626;3196;10291
230523;201601;14291;46604;12615;42823;2861;10587;3002;10486;5863;21073
230526;201601;4038;12072;3464;11066;210;915;2635;8240;2845;9155
230530;201601;5281;17055;4794;16387;931;3297;3061;10833;3992;14130
230533;201601;4000;11094;3454;10068;485;1339;2270;6721;2755;8060
230535;201601;5506;16254;4830;15076;679;2083;2887;9367;3566;11450
230540;201601;17172;50408;15529;47842;646;2573;12762;38828;13408;41401
230550;201601;19060;56743;17061;53029;3100;10456;8694;26386;11794;36842
230560;201601;6638;19154;5862;17777;219;894;4469;13300;4688;14194
230565;201601;3383;9398;2751;8229;119;437;2008;5963;2127;6400
230570;201601;3575;9853;3190;9371;104;421;2658;7707;2762;8128
230580;201601;9823;29812;9105;28789;496;1882;7763;24440;8259;26322
230590;201601;8924;27811;7718;25575;581;2439;5373;17311;5954;19750
230600;201601;3778;10432;2953;8837;151;512;1892;5644;2043;6156
230610;201601;6011;19339;5568;18636;784;2657;3775;12855;4559;15512
230620;201601;2146;6148;1721;5238;202;660;945;2789;1147;3449
230625;201601;7705;25045;6970;23371;1991;7202;2003;6706;3994;13908
230630;201601;10838;34446;9969;32875;2624;8139;4547;16154;7171;24293
230640;201601;25551;83393;23584;80484;2627;10040;17426;59170;20053;69210
230650;201601;4817;14852;4366;13992;291;1176;3301;10300;3592;11476
230655;201601;9008;34142;8683;33540;791;3386;6729;26196;7520;29582
230660;201601;5968;18809;5132;17244;326;1494;3859;12651;4185;14145
230670;201601;6015;16136;4848;14136;166;594;3696;10472;3862;11066
230680;201601;2632;7804;2273;7128;352;1164;1302;4057;1654;5221
230690;201601;6298;20446;6130;20091;621;2369;3928;12576;4549;14945
230700;201601;9251;26051;8306;24415;683;2425;5809;16538;6492;18963
230710;201601;7362;24035;6407;22262;678;2441;4454;15564;5132;18005
230720;201601;1809;5755;1575;5269;199;703;915;3048;1114;3751
230725;201601;3651;12412;3185;11276;779;2817;1008;3578;1787;6395
230730;201601;55905;169587;47337;155432;12906;47543;10766;37056;23672;84599
230740;201601;6013;17986;5455;17052;216;894;4318;13279;4534;14173
230750;201601;8265;23926;7124;22078;412;1554;5346;16332;5758;17886
230760;201601;10469;31146;9711;29685;1076;3755;6540;19250;7616;23005
230763;201601;4233;12996;3797;12181;210;940;2841;8786;3051;9726
230765;201601;37891;120192;34156;112978;8735;30875;9919;33780;18654;64655
230770;201601;24674;68470;22296;65117;2884;8869;14580;42574;17464;51443
230780;201601;5860;22673;5621;22135;1398;5670;2672;11033;4070;16703
230790;201601;2733;8759;2517;8393;259;962;1824;6113;2083;7075
230800;201601;7375;26222;6727;24797;1473;5794;2891;10572;4364;16366
230810;201601;11893;38655;11230;37561;872;3179;8656;28919;9528;32098
230820;201601;3267;11257;2878;10414;414;1705;1576;5611;1990;7316
230830;201601;7320;22330;6504;20806;490;1863;4678;14787;5168;16650
230835;201601;3906;10402;3233;9398;187;605;2455;7112;2642;7717
230837;201601;3144;10712;2766;9976;310;1350;1784;6316;2094;7666
230840;201601;8978;29336;8258;28108;704;2757;6179;21080;6883;23837
230850;201601;9451;29532;8793;28431;1026;3408;5976;19505;7002;22913
230860;201601;5009;14358;4461;13572;223;829;3600;10872;3823;11701
230870;201601;18473;48616;15959;44901;712;2305;12224;34147;12936;36452
230880;201601;1937;6572;1838;6365;149;658;1266;4298;1415;4956
230890;201601;3890;14223;3614;13620;446;2047;2256;8238;2702;10285
230900;201601;2888;9638;2455;8740;513;1773;1094;4032;1607;5805
230910;201601;3052;9028;2519;8078;197;876;1797;5579;1994;6455
230920;201601;4625;13461;4301;13049;282;1071;3517;10625;3799;11696
230930;201601;7206;21750;6378;20212;625;2098;4215;13384;4840;15482
230940;201601;7656;21969;6737;20539;318;1079;5371;16425;5689;17504
230945;201601;5995;18301;5308;17204;432;1579;3607;11900;4039;13479
230950;201601;6316;17405;5736;16632;244;695;4865;14408;5109;15103
230960;201601;13977;43017;12820;40821;2519;8404;5797;18700;8316;27104
230970;201601;13354;40879;11778;37987;2344;8309;5051;15995;7395;24304
230980;201601;2888;9072;2542;8453;701;2318;1153;4075;1854;6393
230990;201601;1745;5181;1463;4642;124;524;923;2800;1047;3324
231000;201601;2658;7293;2137;6284;145;502;1349;3846;1494;4348
231010;201601;3111;8526;2556;7624;265;872;1667;4825;1932;5697
231020;201601;7760;26158;7364;25337;1277;4405;4434;15579;5711;19984
231025;201601;7840;24096;7167;22967;939;3175;4627;15069;5566;18244
231030;201601;7522;24501;6430;22321;1133;4196;3357;11715;4490;15911
231040;201601;3144;10028;2790;9325;166;734;1992;6464;2158;7198
231050;201601;11760;33621;10061;30647;788;2688;7223;21882;8011;24570
231060;201601;2309;7573;2148;7276;145;718;1541;5039;1686;5757
231070;201601;8512;27130;7760;25604;1296;4539;4246;14122;5542;18661
231080;201601;4011;12520;3646;11920;185;938;2781;8714;2966;9652
231085;201601;4701;14626;4517;14375;693;2157;3078;10162;3771;12319
231090;201601;4099;11529;3339;10037;176;611;2271;6737;2447;7348
231095;201601;2172;7046;1897;6495;210;808;1212;4154;1422;4962
231100;201601;3179;9838;2679;8894;200;781;1873;6163;2073;6944
231110;201601;3480;11673;3443;11601;341;1327;2355;7885;2696;9212
231120;201601;1970;6737;1866;6524;281;1044;1139;4042;1420;5086
231123;201601;2031;5637;1758;5175;135;394;1330;3904;1465;4298
231126;201601;6152;17596;5223;16056;293;1141;3775;11465;4068;12606
231130;201601;18811;57859;17008;54900;3359;11174;9578;32464;12937;43638
231135;201601;4048;12206;3480;11192;253;892;2409;7719;2662;8611
231140;201601;16766;52819;14814;49185;1240;5452;9646;30965;10886;36417
231150;201601;5692;16382;4864;14865;789;2535;2394;7363;3183;9898
231160;201601;5768;19039;5383;18270;972;3278;3065;10549;4037;13827
231170;201601;4190;13501;3774;12664;286;1191;2593;8468;2879;9659
231180;201601;13839;41267;12441;38533;2089;6937;6931;21098;9020;28035
231190;201601;4517;12763;3812;11691;241;881;2886;8651;3127;9532
231195;201601;4532;15253;3929;14071;410;1816;2623;9249;3033;11065
231200;201601;7714;26400;6762;24426;441;2256;4721;16596;5162;18852
231210;201601;4896;15479;4285;14633;284;1378;3300;11108;3584;12486
231220;201601;11625;33792;10272;31283;514;1996;7534;22472;8048;24468
231230;201601;9058;30387;8260;29151;767;3250;6028;21248;6795;24498
231240;201601;11864;37194;10746;34971;2255;7528;4998;16532;7253;24060
231250;201601;1981;5730;1403;4331;433;1308;293;901;726;2209
231260;201601;3438;10253;3096;9714;532;1646;1832;5907;2364;7553
231270;201601;7132;19719;6315;18436;326;1359;4708;13382;5034;14741
231280;201601;1715;5640;1605;5440;179;639;1081;3692;1260;4331
231290;201601;33216;113010;30170;106267;6394;24997;12019;41247;18413;66244
231300;201601;4442;12919;3643;11377;247;955;2428;7360;2675;8315
231310;201601;7233;20645;6051;18208;876;2687;3338;9919;4214;12606
231320;201601;6942;21286;5911;19283;318;1357;4149;13459;4467;14816
231325;201601;2729;8061;2400;7561;276;898;1558;5004;1834;5902
231330;201601;12067;38289;10503;35275;1631;5509;6059;20665;7690;26174
231335;201601;5264;15153;4591;13916;199;834;3558;10536;3757;11370
231340;201601;17139;56772;15862;54818;1105;3891;12441;43867;13546;47758
231350;201601;13240;41164;12685;40376;976;2981;10730;34677;11706;37658
231355;201601;4403;14077;4062;13505;275;1125;2955;9731;3230;10856
231360;201601;7580;24205;6743;22739;1190;4071;4062;14062;5252;18133
231370;201601;2388;6675;1876;5830;77;246;1383;4307;1460;4553
231375;201601;4201;14299;3947;13833;237;1102;3087;10684;3324;11786
231380;201601;5166;16443;4888;16084;547;1915;3411;11506;3958;13421
231390;201601;3391;10666;3127;10206;271;951;2175;7059;2446;8010
231395;201601;3752;12342;3428;11734;585;2014;1904;6603;2489;8617
231400;201601;8910;27560;8314;26405;537;2097;6113;19143;6650;21240
231410;201601;13961;47539;12903;45988;1292;4796;9616;34705;10908;39501
240010;201601;2403;7233;2020;6471;335;1194;972;3010;1307;4204
240020;201601;10407;32901;9389;31017;2043;7173;4345;14474;6388;21647
240030;201601;2418;6999;2341;6882;119;437;1991;5718;2110;6155
240040;201601;826;2447;698;2188;27;132;485;1443;512;1575
240050;201601;3393;9201;2897;8353;108;375;2298;6525;2406;6900
240060;201601;1377;3970;1232;3698;53;202;971;2808;1024;3010
240070;201601;2513;7435;2350;7122;381;1201;1489;4441;1870;5642
240080;201601;2999;8080;2611;7559;191;555;1981;5726;2172;6281
240090;201601;2248;6088;1856;5382;42;155;1438;4071;1480;4226
240100;201601;8061;23178;7232;21510;627;2080;5132;14869;5759;16949
240110;201601;4705;14843;4232;13899;649;2417;2319;7346;2968;9763
240120;201601;2647;9130;2532;8910;382;1472;1568;5487;1950;6959
240130;201601;2688;7342;2364;6837;118;396;1883;5356;2001;5752
240140;201601;2193;6608;1881;6045;296;1137;1056;3266;1352;4403
240145;201601;5651;17998;5129;17051;1424;4926;2375;8147;3799;13073
240150;201601;949;2935;788;2592;78;320;501;1593;579;1913
240160;201601;1416;4572;1230;4251;156;592;753;2680;909;3272
240165;201601;883;2808;783;2606;118;354;461;1628;579;1982
240170;201601;2283;6956;2011;6462;499;1753;882;2803;1381;4556
240180;201601;2569;8205;2297;7652;450;1586;1257;4271;1707;5857
240185;201601;1402;4680;1312;4531;86;323;1035;3590;1121;3913
240190;201601;959;3023;865;2871;48;226;634;2067;682;2293
240200;201601;13358;35135;11211;32169;2531;7535;4781;14161;7312;21696
240210;201601;2834;7976;2568;7596;176;625;2068;6013;2244;6638
240220;201601;7210;24241;6719;23504;649;2932;4973;17081;5622;20013
240230;201601;5620;14956;4896;13841;155;494;4115;11604;4270;12098
240240;201601;1809;5503;1273;4212;258;936;216;630;474;1566
240250;201601;2608;7661;2454;7452;113;363;2088;6325;2201;6688
240260;201601;12027;40761;11431;39788;1842;7136;7165;24828;9007;31964
240270;201601;2185;7068;2021;6805;188;661;1536;5238;1724;5899
240280;201601;1524;4332;1358;4088;79;278;1082;3236;1161;3514
240290;201601;1229;3952;1101;3701;59;310;709;2242;768;2552
240300;201601;2241;6222;1669;5023;335;1091;610;1782;945;2873
240310;201601;9370;26909;8525;25597;1170;3866;4710;14316;5880;18182
240320;201601;2000;5971;1621;5211;53;235;1145;3556;1198;3791
240325;201601;33696;93542;27168;83302;8329;27432;5712;18468;14041;45900
240330;201601;1461;4462;1240;3996;73;294;780;2426;853;2720
240340;201601;1955;5247;1669;4795;178;538;1194;3396;1372;3934
240350;201601;1861;5545;1752;5415;118;415;1508;4649;1626;5064
240360;201601;6845;20856;6118;19777;1370;4650;3098;10358;4468;15008
240370;201601;1964;5458;1592;4776;230;665;918;2804;1148;3469
240375;201601;831;2285;732;2116;111;364;452;1227;563;1591
240380;201601;2392;7179;1859;6000;242;807;913;2918;1155;3725
240390;201601;914;2533;776;2284;39;149;544;1546;583;1695
240400;201601;1307;3604;1082;3198;86;302;739;2115;825;2417
240410;201601;480;1591;430;1488;80;335;230;760;310;1095
240420;201601;4587;17680;4320;17075;885;3917;2256;8938;3141;12855
240430;201601;3206;9132;2938;8652;144;579;2296;6532;2440;7111
240440;201601;2444;6421;2199;6057;571;1620;1089;2980;1660;4600
240450;201601;3835;11405;3314;10425;300;1249;2051;6088;2351;7337
240460;201601;2872;8852;2714;8644;175;773;2203;6810;2378;7583
240470;201601;3548;11122;2831;9562;796;2566;1266;4387;2062;6953
240480;201601;515;1377;406;1169;34;107;209;584;243;691
240485;201601;1904;6057;1688;5627;274;969;999;3375;1273;4344
240490;201601;1643;4239;1391;3845;37;136;1151;3113;1188;3249
240500;201601;2088;6032;1898;5752;131;457;1469;4417;1600;4874
240510;201601;1726;5190;1618;5027;127;446;1282;3959;1409;4405
240520;201601;1205;3560;1099;3381;117;417;802;2403;919;2820
240530;201601;1935;6307;1783;6074;386;1347;1094;3732;1480;5079
240540;201601;1657;5059;1589;4948;119;395;1289;4001;1408;4396
240550;201601;794;2274;689;2097;39;135;516;1550;555;1685
240560;201601;3121;9155;2923;8852;374;1145;2138;6491;2512;7636
240570;201601;3017;8504;2312;6945;520;1683;766;2047;1286;3730
240580;201601;7441;23575;6925;22665;815;2959;5148;16625;5963;19584
240590;201601;764;2167;670;1994;31;122;501;1452;532;1574
240600;201601;1596;4728;1267;4041;151;554;687;2090;838;2644
240610;201601;4535;13111;3986;12071;477;1570;2468;7295;2945;8865
240615;201601;1022;3020;829;2649;172;587;433;1339;605;1926
240620;201601;1725;5421;1531;5097;199;619;1087;3697;1286;4316
240630;201601;1993;6129;1833;5858;164;454;1273;4191;1437;4645
240640;201601;887;2571;756;2358;54;251;519;1546;573;1797
240650;201601;3750;11331;3381;10794;192;693;2679;8527;2871;9220
240660;201601;2319;7500;2176;7295;185;697;1674;5583;1859;6280
240670;201601;2601;7821;2183;6950;290;977;1186;3725;1476;4702
240680;201601;1478;4358;1203;3870;105;371;749;2371;854;2742
240690;201601;942;2596;813;2377;46;175;648;1839;694;2014
240700;201601;2544;7679;2143;6944;77;343;1626;5165;1703;5508
240710;201601;18694;49116;16291;45573;3069;8539;8992;25785;12061;34324
240720;201601;5148;14807;4686;13956;1518;4635;1884;5436;3402;10071
240725;201601;1048;3175;852;2743;73;244;489;1539;562;1783
240730;201601;2083;6350;1822;5861;119;425;1336;4284;1455;4709
240740;201601;1922;5696;1725;5346;148;584;1210;3618;1358;4202
240750;201601;2087;7910;1954;7655;481;2066;874;3440;1355;5506
240760;201601;1314;3605;1110;3330;108;263;813;2616;921;2879
240770;201601;3052;8842;2733;8401;155;636;2234;6756;2389;7392
240780;201601;5957;16584;4833;14784;800;2484;2599;8081;3399;10565
240790;201601;868;2663;725;2405;35;136;499;1668;534;1804
240800;201601;34627;99776;30923;93621;7429;23300;12315;37906;19744;61206
240810;201601;83104;240934;77160;230975;20380;62245;34794;106390;55174;168635
240820;201601;6258;19116;5482;17896;1309;4603;2192;7498;3501;12101
240830;201601;8478;26548;7940;25767;380;1636;6635;21260;7015;22896
240840;201601;1198;3369;1020;3085;87;275;625;1839;712;2114
240850;201601;1239;3698;933;2995;136;455;452;1433;588;1888
240860;201601;1281;3685;1056;3279;52;195;795;2397;847;2592
240870;201601;1155;3194;944;2804;79;267;580;1642;659;1909
240880;201601;1130;3808;1065;3705;92;412;838;2823;930;3235
240890;201601;4912;14084;4172;12711;901;2856;1691;5052;2592;7908
240895;201601;2558;8958;2370;8625;265;1069;1659;6099;1924;7168
240910;201601;2796;8478;2488;7894;163;614;1866;5860;2029;6474
240920;201601;746;2442;649;2233;126;489;292;977;418;1466
240930;201601;3402;8948;3003;8459;149;415;2453;7007;2602;7422
240933;201601;1358;3909;1208;3667;95;337;902;2665;997;3002
240940;201601;6336;17263;5161;15283;860;2506;2845;8470;3705;10976
240950;201601;946;3140;890;3043;62;303;667;2196;729;2499
240960;201601;776;2436;690;2270;68;239;478;1591;546;1830
240970;201601;1875;5241;1582;4745;111;412;1180;3404;1291;3816
240980;201601;2916;9703;2711;9322;492;1790;1599;5506;2091;7296
240990;201601;2721;8172;2561;7863;438;1430;1510;4579;1948;6009
241000;201601;1042;2924;889;2657;45;168;616;1816;661;1984
241010;201601;2763;9421;2592;9090;320;1366;1791;6054;2111;7420
241020;201601;2019;5681;1658;4960;155;467;1023;2992;1178;3459
241025;201601;1620;4946;1450;4639;77;360;1023;3189;1100;3549
241030;201601;2441;8131;2206;7680;211;915;1557;5350;1768;6265
241040;201601;2172;7488;1993;7168;188;783;1401;5074;1589;5857
241050;201601;1228;3690;1083;3439;62;253;806;2498;868;2751
241060;201601;854;2482;770;2346;52;162;560;1687;612;1849
241070;201601;775;2241;706;2121;64;228;507;1461;571;1689
241080;201601;1126;3368;937;2995;36;160;682;2147;718;2307
241090;201601;2133;6325;1805;5758;126;575;1348;4197;1474;4772
241100;201601;1169;3511;1019;3161;96;315;653;2016;749;2331
241105;201601;1150;3508;1019;3269;236;768;464;1562;700;2330
241110;201601;800;2518;676;2260;51;212;417;1351;468;1563
241120;201601;7178;22168;6571;21180;1501;4815;3531;11906;5032;16721
241140;201601;3363;9268;2918;8396;323;909;1966;5577;2289;6486
241142;201601;714;2131;534;1733;136;505;188;561;324;1066
241150;201601;5329;15882;4779;14950;558;1847;3146;9822;3704;11669
241160;201601;962;2824;868;2662;132;404;536;1649;668;2053
241170;201601;1131;3349;1054;3216;90;281;813;2476;903;2757
241180;201601;932;2616;766;2303;96;309;391;1138;487;1447
241190;201601;1168;3240;935;2767;61;218;585;1654;646;1872
241200;201601;18410;54192;16452;51159;4029;13327;6762;21511;10791;34838
241210;201601;1428;4037;1149;3457;167;581;606;1754;773;2335
241220;201601;7646;25415;7148;24492;1771;6300;3495;12266;5266;18566
241230;201601;2936;8722;2724;8389;157;623;2263;6835;2420;7458
241240;201601;1201;3551;833;2699;91;327;346;1126;437;1453
241250;201601;5929;18379;4976;16550;213;1151;3753;12052;3966;13203
241255;201601;1623;6288;1515;6043;347;1525;707;2813;1054;4338
241260;201601;5034;13679;4068;12172;191;822;2993;8736;3184;9558
241270;201601;1806;5631;1605;5226;120;470;1071;3427;1191;3897
241280;201601;1830;5326;1674;5032;189;584;1182;3523;1371;4107
241290;201601;2957;8376;2518;7620;257;846;1691;5058;1948;5904
241300;201601;1438;4147;1247;3809;55;182;874;2675;929;2857
241310;201601;1579;4771;1451;4555;123;449;1080;3366;1203;3815
241320;201601;907;3117;830;2961;114;461;502;1779;616;2240
241330;201601;1408;4434;1325;4325;94;401;1100;3517;1194;3918
241335;201601;2680;8219;2488;7880;148;536;2030;6388;2178;6924
241340;201601;1812;5633;1563;5087;374;1324;649;2022;1023;3346
241350;201601;1870;5995;1699;5674;137;582;1249;4044;1386;4626
241355;201601;1389;3922;1143;3513;53;199;909;2770;962;2969
241360;201601;2014;5528;1685;4901;68;198;1208;3419;1276;3617
241370;201601;1336;4034;1104;3569;131;486;635;2000;766;2486
241380;201601;641;1842;549;1667;78;253;314;934;392;1187
241390;201601;2698;8962;2521;8656;276;1107;1840;6274;2116;7381
241400;201601;3721;10831;3401;10404;419;1365;2472;7616;2891;8981
241410;201601;2446;7524;2220;7211;528;1803;1187;3844;1715;5647
241415;201601;1633;4938;1481;4701;92;356;1183;3670;1275;4026
241420;201601;2229;7738;1977;7320;610;2470;451;1641;1061;4111
241430;201601;567;1693;446;1419;50;171;245;742;295;913
241440;201601;6114;22209;5774;21662;1108;4362;3761;14300;4869;18662
241445;201601;996;2912;950;2858;82;209;764;2452;846;2661
241450;201601;2980;8188;2620;7690;307;1000;1788;5183;2095;6183
241460;201601;3356;9835;2991;9125;258;915;2101;6244;2359;7159
241470;201601;1322;3758;1109;3482;150;514;727;2268;877;2782
241475;201601;1229;3718;1036;3340;41;192;758;2361;799;2553
241480;201601;2710;9066;2507;8712;1001;3625;539;2071;1540;5696
241490;201601;667;1759;575;1634;37;95;353;980;390;1075
241500;201601;758;2412;648;2238;43;197;482;1634;525;1831
250010;201601;2671;8451;2297;7618;115;514;1698;5499;1813;6013
250020;201601;1625;4689;1268;4044;78;307;817;2513;895;2820
250030;201601;6818;19987;6412;19421;504;1592;5197;15687;5701;17279
250040;201601;4099;13745;3795;13092;593;2107;2310;7983;2903;10090
250050;201601;3348;10667;3159;10399;454;1557;2124;6956;2578;8513
250053;201601;1205;3645;1106;3512;145;483;755;2452;900;2935
250057;201601;618;2647;608;2636;10;17;579;2585;589;2602
250060;201601;5010;15058;4708;14616;400;1452;3725;11409;4125;12861
250070;201601;3930;12242;3649;11769;152;724;2847;8870;2999;9594
250073;201601;748;2301;664;2159;42;164;532;1705;574;1869
250077;201601;2106;6202;1783;5694;173;586;1166;3766;1339;4352
250080;201601;4078;11956;3903;11665;334;1044;2998;8804;3332;9848
250090;201601;2537;7424;2418;7233;101;320;1981;5856;2082;6176
250100;201601;3786;12538;3588;12179;330;1252;2725;9133;3055;10385
250110;201601;4991;15054;4731;14686;444;1628;3722;11358;4166;12986
250115;201601;517;1675;465;1566;32;166;308;970;340;1136
250120;201601;1903;5842;1666;5382;92;337;1270;4080;1362;4417
250130;201601;5198;16380;4826;15765;236;1014;4036;13085;4272;14099
250135;201601;1029;3169;946;3029;48;168;733;2367;781;2535
250140;201601;1966;6666;1889;6546;166;709;1455;5034;1621;5743
250150;201601;4931;16696;4490;15881;311;1387;3278;11436;3589;12823
250153;201601;1392;3855;1229;3625;46;210;1040;2990;1086;3200
250157;201601;1698;5596;1568;5348;166;661;1137;3842;1303;4503
250160;201601;3203;9699;3085;9526;126;481;2802;8615;2928;9096
250170;201601;1466;4481;1350;4309;204;701;918;2954;1122;3655
250180;201601;15389;45641;14551;44370;1390;5025;10652;31592;12042;36617
250190;201601;4123;11976;3778;11443;616;1903;2264;6783;2880;8686
250200;201601;1992;5851;1670;5378;100;396;1362;4338;1462;4734
250205;201601;853;2965;803;2869;50;257;592;2093;642;2350
250210;201601;1404;4787;1319;4661;115;478;984;3408;1099;3886
250215;201601;1335;4391;1267;4288;106;440;829;2780;935;3220
250220;201601;720;2196;639;2089;38;160;526;1706;564;1866
250230;201601;1493;3864;1262;3484;50;183;1027;2714;1077;2897
250240;201601;2271;7665;2154;7449;121;473;1717;5938;1838;6411
250250;201601;4172;12785;3872;12395;186;645;3310;10649;3496;11294
250260;201601;1645;5110;1440;4794;70;275;1122;3729;1192;4004
250270;201601;1225;3881;1123;3759;100;342;848;2929;948;3271
250280;201601;3553;10616;3149;9980;386;1208;2283;7300;2669;8508
250290;201601;1860;5002;1594;4662;37;152;1431;4184;1468;4336
250300;201601;5355;15761;5088;15446;586;2442;4072;11770;4658;14212
250310;201601;1142;3522;1029;3342;77;293;783;2507;860;2800
250320;201601;7880;24121;7482;23463;891;3132;5141;15715;6032;18847
250330;201601;2348;7418;2049;6980;145;612;1559;5242;1704;5854
250340;201601;1076;3234;971;3064;34;130;825;2575;859;2705
250350;201601;4034;11400;3632;10922;144;527;3113;9388;3257;9915
250355;201601;1844;5976;1702;5778;67;344;1456;4842;1523;5186
250360;201601;1819;5424;1715;5274;65;182;1469;4554;1534;4736
250370;201601;11163;33143;10190;32077;852;2763;8670;27458;9522;30221
250375;201601;1056;3267;980;3156;35;137;837;2699;872;2836
250380;201601;1620;4695;1545;4603;97;378;1309;3824;1406;4202
250390;201601;1880;5101;1530;4515;170;480;1009;3015;1179;3495
250400;201601;71135;189574;56908;167309;14194;44032;21495;64408;35689;108440
250403;201601;1489;4908;1378;4757;217;863;839;2821;1056;3684
250407;201601;1152;3316;1007;3082;62;200;733;2186;795;2386
250410;201601;531;1755;500;1701;29;143;391;1293;420;1436
250415;201601;1782;5447;1619;5168;101;343;1210;3825;1311;4168
250420;201601;1217;3657;1113;3503;31;132;977;3046;1008;3178
250430;201601;5908;16446;5542;15912;283;970;4596;12944;4879;13914
250435;201601;1331;4108;1205;3885;132;492;835;2661;967;3153
250440;201601;4260;12519;3962;12107;169;516;3310;10119;3479;10635
250450;201601;1908;5482;1718;5232;66;241;1449;4353;1515;4594
250460;201601;6282;19031;5883;18503;593;1942;4523;14436;5116;16378
250470;201601;1538;4206;1312;3897;140;490;871;2475;1011;2965
250480;201601;3650;11187;3423;10879;105;466;3004;9519;3109;9985
250485;201601;654;1648;549;1493;29;98;440;1156;469;1254
250490;201601;3703;11801;3617;11677;806;2571;2398;7852;3204;10423
250500;201601;1705;5258;1547;5006;304;933;971;3266;1275;4199
250510;201601;4634;13369;4175;12702;176;615;3627;11052;3803;11667
250520;201601;1685;5147;1583;4987;227;769;933;2874;1160;3643
250523;201601;1534;4990;1490;4922;221;812;1055;3444;1276;4256
250527;201601;1353;4135;1288;4059;22;115;1180;3662;1202;3777
250530;201601;590;1847;516;1757;22;71;457;1578;479;1649
250535;201601;1285;4075;1219;3946;47;213;982;3103;1029;3316
250540;201601;2325;6802;2176;6630;48;208;1922;5755;1970;5963
250550;201601;874;2935;796;2817;49;238;618;2144;667;2382
250560;201601;1616;5114;1564;5041;83;359;1370;4337;1453;4696
250570;201601;2580;8274;2274;7683;143;626;1718;5677;1861;6303
250580;201601;1104;2969;951;2736;86;304;734;2046;820;2350
250590;201601;830;2648;788;2598;76;304;642;2066;718;2370
250600;201601;7153;20930;6727;20332;719;2061;5143;15738;5862;17799
250610;201601;3053;8968;2839;8645;257;855;2130;6428;2387;7283
250620;201601;679;2011;605;1863;104;337;349;1058;453;1395
250625;201601;2325;7550;2291;7510;99;232;2144;7165;2243;7397
250630;201601;9226;28909;8506;27495;2025;6570;4160;13634;6185;20204
250640;201601;3331;10351;3184;10170;159;704;2775;8702;2934;9406
250650;201601;776;2281;697;2158;47;186;510;1505;557;1691
250660;201601;1768;4821;1622;4631;22;45;1530;4412;1552;4457
250670;201601;2300;7906;2190;7715;140;653;1795;6203;1935;6856
250680;201601;4653;13477;4436;13215;208;730;3887;11541;4095;12271
250690;201601;5870;15422;5602;15111;459;1185;4871;13163;5330;14348
250700;201601;4650;13856;4278;13311;684;2205;2786;8642;3470;10847
250710;201601;4115;13262;3879;12928;555;1966;2636;8919;3191;10885
250720;201601;2621;7645;2470;7421;90;391;2155;6381;2245;6772
250730;201601;3354;10341;3154;10065;252;874;2382;7473;2634;8347
250740;201601;1837;5457;1621;5127;164;623;1215;3719;1379;4342
250750;201601;96593;275037;89684;265117;12266;39679;60123;175548;72389;215227
250760;201601;2191;6356;1978;6052;125;482;1635;4940;1760;5422
250770;201601;3757;12766;3579;12532;529;2061;2401;8357;2930;10418
250780;201601;1789;5281;1559;4866;171;648;987;2960;1158;3608
250790;201601;2349;7714;2233;7525;497;1673;1287;4485;1784;6158
250800;201601;2593;7319;2307;6865;86;280;1902;5558;1988;5838
250810;201601;1263;3736;1107;3500;76;315;861;2678;937;2993
250820;201601;1800;5705;1725;5612;70;303;1559;5026;1629;5329
250830;201601;5557;18007;5165;17227;582;2192;3485;11391;4067;13583
250840;201601;882;2876;751;2596;56;229;504;1739;560;1968
250850;201601;1923;5997;1757;5728;93;441;1367;4359;1460;4800
250855;201601;1032;3160;949;3045;61;263;716;2219;777;2482
250860;201601;3075;10091;2702;9422;676;2543;881;3109;1557;5652
250870;201601;1041;3056;947;2877;41;161;719;2136;760;2297
250880;201601;1362;3858;1192;3613;156;470;866;2658;1022;3128
250890;201601;9006;27694;8525;27040;1076;4259;6017;18374;7093;22633
250900;201601;2762;9043;2451;8440;244;805;1760;6123;2004;6928
250905;201601;1953;6294;1876;6194;306;997;1357;4548;1663;5545
250910;201601;4837;14187;4600;13835;257;874;3779;11281;4036;12155
250915;201601;1369;4288;1344;4251;105;283;1141;3699;1246;3982
250920;201601;3201;9258;3007;8964;380;1068;2087;6327;2467;7395
250930;201601;1950;6099;1839;5922;197;791;1306;4087;1503;4878
250933;201601;1103;3620;1038;3496;100;381;689;2275;789;2656
250937;201601;644;2009;589;1905;56;220;415;1301;471;1521
250939;201601;1516;4737;1430;4597;138;480;1009;3221;1147;3701
250940;201601;3640;10956;3432;10631;125;488;2905;8992;3030;9480
250950;201601;1225;3774;1085;3595;56;239;861;2838;917;3077
250960;201601;1056;3527;1017;3466;76;292;814;2784;890;3076
250970;201601;8160;22926;7199;21442;778;2414;5047;15025;5825;17439
250980;201601;2504;7456;2301;7103;122;500;1672;4959;1794;5459
250990;201601;1906;6537;1721;6145;255;1030;1029;3552;1284;4582
251000;201601;2044;6227;1875;5979;66;301;1565;4936;1631;5237
251010;201601;2716;7988;2448;7565;75;254;2116;6547;2191;6801
251020;201601;1536;4499;1411;4340;80;257;1254;3867;1334;4124
251030;201601;1065;3036;982;2893;58;194;724;2091;782;2285
251040;201601;1755;5547;1594;5283;89;416;1171;3749;1260;4165
251050;201601;1046;3063;919;2842;95;318;608;1843;703;2161
251060;201601;981;2298;758;2011;42;142;586;1538;628;1680
251065;201601;458;1398;408;1321;30;103;276;846;306;949
251070;201601;608;1721;551;1646;38;154;435;1238;473;1392
251080;201601;19177;54426;17457;51614;4381;13491;7994;24328;12375;37819
251090;201601;2901;9082;2595;8503;190;715;1855;5977;2045;6692
251100;201601;936;2976;845;2822;83;324;551;1777;634;2101
251110;201601;1919;5667;1691;5223;161;466;1120;3479;1281;3945
251120;201601;6020;20459;5759;20009;698;2789;4157;14267;4855;17056
251130;201601;3905;10284;3610;9970;12;33;3555;9841;3567;9874
251140;201601;4101;12657;3880;12314;127;558;3249;10265;3376;10823
251150;201601;2425;8037;2274;7802;191;872;1692;5648;1883;6520
251160;201601;1751;5802;1692;5726;65;260;1533;5194;1598;5454
251170;201601;1386;4239;1319;4158;87;350;1103;3411;1190;3761
251180;201601;2475;7580;2266;7259;393;1249;1363;4380;1756;5629
251190;201601;4243;11862;4090;11692;164;497;3792;10819;3956;11316
251200;201601;3816;12371;3679;12207;101;444;3359;11103;3460;11547
251203;201601;1001;3380;977;3333;51;258;773;2595;824;2853
251207;201601;1062;3365;931;3135;59;277;631;2044;690;2321
251210;201601;7710;22110;6656;20726;729;2225;5029;16136;5758;18361
251220;201601;1120;3007;930;2730;93;273;683;2011;776;2284
251230;201601;4322;13257;4004;12886;210;854;3576;11374;3786;12228
251240;201601;3175;9730;2958;9454;422;1332;2131;6825;2553;8157
251250;201601;10036;29952;9325;28906;907;3300;6925;21051;7832;24351
251260;201601;478;1531;438;1475;20;85;332;1104;352;1189
251270;201601;4142;13398;3867;13073;148;688;3424;11545;3572;12233
251272;201601;1307;3903;1265;3844;78;266;1121;3388;1199;3654
251274;201601;887;2806;805;2670;76;323;562;1820;638;2143
251275;201601;1216;3607;1158;3518;73;327;868;2495;941;2822
251276;201601;1185;3675;1112;3548;81;330;811;2514;892;2844
251278;201601;564;1815;505;1709;59;247;330;1091;389;1338
251280;201601;2249;6902;2124;6695;124;493;1676;5121;1800;5614
251290;201601;5493;15285;5194;14926;576;2073;4037;11228;4613;13301
251300;201601;729;2490;687;2429;37;169;546;1908;583;2077
251310;201601;2929;8776;2704;8462;117;484;2189;6697;2306;7181
251315;201601;1575;5504;1504;5386;172;633;1044;3771;1216;4404
251320;201601;1833;5159;1444;4522;53;192;1041;3255;1094;3447
251330;201601;1718;4726;1490;4431;66;278;1284;3730;1350;4008
251335;201601;1010;3446;933;3308;84;382;650;2260;734;2642
251340;201601;3317;9502;2934;8942;215;856;2182;6430;2397;7286
251350;201601;1264;4080;1182;3930;81;323;902;2913;983;3236
251360;201601;1735;5621;1574;5411;63;281;1364;4697;1427;4978
251365;201601;785;2315;637;2009;20;86;438;1354;458;1440
251370;201601;21473;67921;20906;67179;1794;7193;16547;51579;18341;58772
251380;201601;1299;4100;1117;3794;44;251;924;2997;968;3248
251385;201601;776;2127;670;1963;79;223;433;1233;512;1456
251390;201601;5730;19743;5248;18875;1324;4899;2633;9606;3957;14505
251392;201601;1031;3086;923;2915;72;253;696;2174;768;2427
251394;201601;600;1866;496;1679;46;155;335;1131;381;1286
251396;201601;812;2326;707;2153;100;302;448;1357;548;1659
251398;201601;934;2768;825;2569;49;187;548;1666;597;1853
251400;201601;1131;3210;980;2999;87;315;709;2104;796;2419
251410;201601;1326;3591;1211;3414;63;253;1007;2769;1070;3022
251420;201601;1922;5620;1722;5382;217;690;1226;3818;1443;4508
251430;201601;1606;5703;1477;5493;73;376;1212;4438;1285;4814
251440;201601;1206;3626;999;3226;53;208;738;2352;791;2560
251445;201601;1455;4541;1379;4434;99;408;1053;3263;1152;3671
251450;201601;4364;14189;4136;13882;110;515;3491;11705;3601;12220
251455;201601;1061;3455;958;3267;92;348;649;2224;741;2572
251460;201601;781;2472;732;2395;80;234;571;1920;651;2154
251465;201601;419;1360;372;1255;16;77;272;890;288;967
251470;201601;1131;3342;955;3000;79;279;587;1829;666;2108
251480;201601;920;2606;820;2440;30;138;658;1891;688;2029
251490;201601;1699;5135;1537;4887;154;579;1065;3345;1219;3924
251500;201601;1664;5428;1615;5338;138;545;1246;4025;1384;4570
251510;201601;2538;8359;2309;7906;411;1450;1278;4403;1689;5853
251520;201601;907;2539;810;2381;121;354;491;1436;612;1790
251530;201601;11598;32808;10981;31957;355;1553;9439;26756;9794;28309
251540;201601;2794;9080;2590;8685;179;751;2061;6839;2240;7590
251550;201601;3387;8904;2930;8311;74;313;2449;6834;2523;7147
251560;201601;668;2119;623;2034;81;312;368;1136;449;1448
251570;201601;985;2935;799;2579;44;197;547;1684;591;1881
251580;201601;1878;5312;1739;5123;408;1004;1045;3300;1453;4304
251590;201601;1477;4751;1417;4676;56;218;1171;3854;1227;4072
251593;201601;970;3050;907;2969;131;445;556;1780;687;2225
251597;201601;1846;5723;1783;5647;64;285;1561;4851;1625;5136
251600;201601;6341;18808;5926;18152;353;1204;4784;14546;5137;15750
251610;201601;3161;9657;2927;9282;314;983;2113;6772;2427;7755
251615;201601;1117;3255;912;2897;68;283;638;1974;706;2257
251620;201601;14602;40802;12954;38835;882;2739;10585;32366;11467;35105
251630;201601;4442;11659;3863;10850;277;818;3023;8405;3300;9223
251640;201601;2480;7357;2107;6740;118;490;1573;4968;1691;5458
251650;201601;3829;11214;3547;10854;223;754;3028;9232;3251;9986
251660;201601;3368;11037;3137;10626;116;585;2617;8629;2733;9214
251670;201601;4298;12863;3723;12122;43;149;3444;11354;3487;11503
251675;201601;702;2258;649;2184;148;539;360;1177;508;1716
251680;201601;2631;7646;2175;6938;102;446;1673;5251;1775;5697
251690;201601;3168;9664;2974;9289;143;505;2312;7105;2455;7610
251700;201601;1919;6259;1806;6121;106;491;1530;5099;1636;5590
251710;201601;912;2363;673;1922;81;265;372;1025;453;1290
251720;201601;1375;4239;1212;3952;77;372;920;2884;997;3256
251740;201601;770;2183;616;1921;83;262;356;1123;439;1385
260005;201601;24960;60851;21308;55845;4582;11938;11183;29719;15765;41657
260010;201601;9732;26364;8060;24229;1370;4065;4509;14286;5879;18351
260020;201601;5681;16314;4824;15044;264;951;3758;11860;4022;12811
260030;201601;5964;17287;5376;16394;394;1378;4114;12503;4508;13881
260040;201601;9879;24099;8161;22137;763;1991;6091;17173;6854;19164
260050;201601;11087;34501;10385;33691;566;2042;8927;29285;9493;31327
260060;201601;3765;10743;3374;10048;332;1009;2441;7368;2773;8377
260070;201601;9598;27948;8843;26772;1384;4498;5596;16711;6980;21209
260080;201601;5573;15019;4953;14152;602;1789;3435;9752;4037;11541
260090;201601;4981;14031;4667;13574;945;2652;3037;9007;3982;11659
260100;201601;3209;8952;2788;8358;181;760;2273;6719;2454;7479
260105;201601;4728;13538;4479;13099;318;1137;3580;10241;3898;11378
260110;201601;20293;57996;18809;56242;863;2690;16482;49432;17345;52122
260120;201601;11472;35160;10403;33300;2430;7988;5110;16978;7540;24966
260130;201601;3154;8957;2959;8652;464;1339;2007;5900;2471;7239
260140;201601;13058;32463;11219;30248;820;2430;8815;23979;9635;26409
260150;201601;3072;8731;2753;8304;202;763;2123;6357;2325;7120
260160;201601;5411;17337;4780;16522;291;1346;3876;13324;4167;14670
260170;201601;15819;44965;15101;43941;1117;3550;12282;35454;13399;39004
260180;201601;3199;9819;2921;9426;183;656;2415;7784;2598;8440
260190;201601;15688;36953;14341;35305;440;1197;12425;30236;12865;31433
260200;201601;10348;28624;9632;27691;621;2024;8060;23363;8681;25387
260210;201601;11262;34468;10160;32813;586;2329;8244;26577;8830;28906
260220;201601;9213;27025;8912;26644;422;1665;7842;23061;8264;24726
260230;201601;9339;27087;8624;26091;415;1496;6998;21252;7413;22748
260240;201601;2881;8772;2512;8245;351;1273;1741;5751;2092;7024
260250;201601;2250;6248;2032;5962;102;299;1737;5128;1839;5427
260260;201601;11928;33842;10888;32377;1792;5610;7450;22526;9242;28136
260270;201601;3548;10380;3283;9981;271;1121;2436;7066;2707;8187
260280;201601;12710;41271;11686;39754;706;2551;9714;33394;10420;35945
260290;201601;29821;90048;28235;87308;4970;16354;16976;51744;21946;68098
260300;201601;8438;25902;7510;24532;440;1920;5769;18854;6209;20774
260310;201601;4525;13457;4166;12938;1211;3463;2143;7220;3354;10683
260320;201601;6934;22619;6453;21859;371;1464;5313;18017;5684;19481
260330;201601;2536;8241;2369;7940;118;510;1847;6061;1965;6571
260340;201601;1825;5396;1697;5193;66;223;1479;4511;1545;4734
260345;201601;22396;69880;21028;67332;5560;19526;7737;23583;13297;43109
260350;201601;4661;12729;4349;12291;223;809;3643;10145;3866;10954
260360;201601;2270;6702;2065;6349;176;670;1392;4240;1568;4910
260370;201601;5704;17802;5036;16615;465;1849;3538;11619;4003;13468
260380;201601;4771;15713;4348;15062;307;1266;3234;11162;3541;12428
260390;201601;4237;13613;3747;12659;332;1289;2616;8688;2948;9977
260392;201601;3441;10965;3157;10605;195;873;2701;8932;2896;9805
260400;201601;13419;38292;12726;37166;1711;5593;8576;24449;10287;30042
260410;201601;59873;171497;52547;160023;14962;48229;18927;59196;33889;107425
260415;201601;3786;12024;3281;11033;304;1267;2042;6618;2346;7885
260420;201601;11714;26866;10422;25475;229;757;9409;22717;9638;23474
260430;201601;2776;9124;2473;8592;248;887;1662;5834;1910;6721
260440;201601;3214;9734;2859;9020;415;1439;1698;5221;2113;6660
260450;201601;4803;14370;4594;14075;183;655;4064;12482;4247;13137
260460;201601;5486;17235;5036;16402;935;3269;2756;8816;3691;12085
260470;201601;4391;13439;4081;13061;211;672;3542;11620;3753;12292
260480;201601;4003;11489;3527;10822;568;1924;2239;6933;2807;8857
260490;201601;4910;13142;4276;12066;271;881;3410;9408;3681;10289
260500;201601;5737;16614;5122;15639;770;2358;3292;10067;4062;12425
260510;201601;8481;22971;7903;22239;375;1246;6935;19353;7310;20599
260515;201601;4672;14274;3643;12223;248;955;2272;7622;2520;8577
260520;201601;15497;40994;14861;40150;2142;5811;10715;28990;12857;34801
260530;201601;9477;29152;8455;27606;401;1500;7090;23210;7491;24710
260540;201601;5919;14720;5387;14158;758;1454;4173;11587;4931;13041
260545;201601;71;254;48;187;8;33;11;38;19;71
260550;201601;2683;8806;2290;7969;469;1804;888;3063;1357;4867
260560;201601;6068;16131;5488;15305;155;611;4826;13219;4981;13830
260570;201601;6742;22235;6176;21317;661;2575;4340;14926;5001;17501
260580;201601;3612;10289;3361;9865;177;623;2775;7946;2952;8569
260590;201601;5967;15070;5626;14680;287;803;4858;12649;5145;13452
260600;201601;26931;79634;24306;75309;2106;7794;17399;53318;19505;61112
260610;201601;6497;19529;6160;19007;901;2897;4190;12808;5091;15705
260620;201601;15352;46737;14673;45570;2490;8475;8964;27267;11454;35742
260630;201601;2137;6449;1928;6108;130;557;1529;4680;1659;5237
260640;201601;16725;46363;15691;44976;2570;7557;9854;28389;12424;35946
260650;201601;5234;16764;4667;15791;417;1538;3516;12039;3933;13577
260660;201601;7755;21721;6988;20757;347;1202;5952;17581;6299;18783
260670;201601;2319;6269;1897;5689;161;531;1323;3977;1484;4508
260680;201601;20963;59282;19279;56361;3981;11964;9052;26514;13033;38478
260690;201601;3650;9933;3101;9040;232;672;2373;6945;2605;7617
260700;201601;5620;16736;5486;16598;40;105;5372;16385;5412;16490
260710;201601;1267;3769;1171;3641;89;312;883;2751;972;3063
260720;201601;16403;53521;15556;51961;3589;12345;7949;26860;11538;39205
260730;201601;6527;22106;6139;21463;1049;3770;4088;14363;5137;18133
260740;201601;1249;3781;1103;3529;116;428;764;2444;880;2872
260750;201601;6627;20365;5930;19460;489;1568;4844;16223;5333;17791
260760;201601;4618;12506;4334;12144;247;773;3576;10071;3823;10844
260765;201601;7580;25701;7209;25084;1064;4699;4791;15964;5855;20663
260770;201601;3700;9860;3420;9452;119;401;2835;7719;2954;8120
260775;201601;4965;14429;4687;14023;457;1649;3297;9592;3754;11241
260780;201601;3564;11584;3330;11131;655;2450;1678;5353;2333;7803
260790;201601;107219;271777;99744;260822;20305;54321;56325;146647;76630;200968
260795;201601;2955;8971;2654;8514;251;926;1838;5917;2089;6843
260800;201601;4707;12825;4392;12406;157;621;3886;10656;4043;11277
260805;201601;3785;11092;3329;10393;379;1347;2222;6812;2601;8159
260810;201601;6801;19113;6579;18836;310;945;5780;16527;6090;17472
260820;201601;4068;11608;3672;11027;876;2701;1852;5531;2728;8232
260825;201601;2828;9085;2535;8603;204;772;1908;6527;2112;7299
260830;201601;3613;11743;3247;11036;692;2290;1837;6482;2529;8772
260840;201601;4158;11968;3705;11306;243;915;2967;8941;3210;9856
260845;201601;4080;11948;3853;11547;491;1537;2707;8150;3198;9687
260850;201601;4805;15792;4283;14638;818;3087;1979;6628;2797;9715
260860;201601;3313;10469;2976;9785;161;646;2264;7414;2425;8060
260870;201601;4092;11380;3660;10839;476;1282;2676;8139;3152;9421
260875;201601;6294;17591;5609;16551;852;2530;3655;10894;4507;13424
260880;201601;9299;28611;8543;27381;734;2388;6569;21277;7303;23665
260890;201601;12783;36885;11932;35590;818;2846;8977;26588;9795;29434
260900;201601;5739;17752;4973;16294;489;1963;3086;9917;3575;11880
260910;201601;2941;8962;2686;8578;198;737;2027;6493;2225;7230
260915;201601;4416;14993;4196;14690;77;371;3847;13482;3924;13853
260920;201601;3149;9684;2932;9391;245;956;2297;7378;2542;8334
260930;201601;3868;12654;3464;12003;391;1428;2400;8391;2791;9819
260940;201601;13532;36107;12387;34292;1612;4985;7982;21493;9594;26478
260950;201601;6201;19182;5651;18127;861;3202;2948;9026;3809;12228
260960;201601;53849;150076;49533;143193;9588;29398;25526;73297;35114;102695
260970;201601;4776;14857;4375;14325;254;1064;3442;11228;3696;12292
260980;201601;3750;12299;3533;12028;121;512;3146;10698;3267;11210
260990;201601;16358;51886;14991;50018;1079;4114;11871;39781;12950;43895
261000;201601;15848;43122;12965;38731;2393;7561;6421;19895;8814;27456
261010;201601;2476;7004;2279;6771;143;328;1982;6076;2125;6404
261020;201601;5907;17453;5291;16448;577;1869;3757;11594;4334;13463
261030;201601;3400;10936;3114;10433;217;889;2426;8005;2643;8894
261040;201601;5025;16328;4423;15131;381;1531;3159;10700;3540;12231
261050;201601;7737;22875;7264;22025;1040;3140;4652;14209;5692;17349
261060;201601;11973;35396;11110;33858;1023;3679;8052;23882;9075;27561
261070;201601;49297;121926;43779;114251;6436;17151;27590;72251;34026;89402
261080;201601;5614;16468;5302;16006;364;1032;4483;13774;4847;14806
261090;201601;16055;44523;14843;42871;1364;3884;11534;33676;12898;37560
261100;201601;7871;24992;7093;23629;1307;4689;3879;13132;5186;17821
261110;201601;59004;175455;52946;166486;12268;40746;26184;84316;38452;125062
261120;201601;3634;9743;3200;9233;94;372;2816;8103;2910;8475
261130;201601;6807;17541;6345;17026;176;567;5760;15392;5936;15959
261140;201601;3186;8987;2896;8558;387;1320;1740;5001;2127;6321
261150;201601;5158;15279;4774;14666;407;1491;3792;11566;4199;13057
261153;201601;2091;6069;1712;5492;75;305;1257;4044;1332;4349
261160;201601;192146;504736;178564;485523;42618;120433;84176;231906;126794;352339
261170;201601;5683;15681;5173;14936;554;1649;3829;11171;4383;12820
261180;201601;9351;26213;8757;25392;987;3146;5903;16926;6890;20072
261190;201601;4954;15478;4611;15055;509;2167;3202;10036;3711;12203
261200;201601;3515;8985;3156;8560;415;1080;2419;6745;2834;7825
261210;201601;1864;4954;1753;4816;124;341;1534;4238;1658;4579
261220;201601;12911;40438;10950;36280;1823;6622;5367;17653;7190;24275
261230;201601;4268;13042;3939;12634;155;628;3418;10980;3573;11608
261240;201601;4715;14065;4351;13454;615;1790;2924;9263;3539;11053
261245;201601;3463;10814;3002;9981;159;722;2334;7577;2493;8299
261247;201601;3218;9940;2755;9115;208;849;1944;6477;2152;7326
261250;201601;19005;51112;17920;49701;3509;9369;11878;34059;15387;43428
261255;201601;3898;12242;3521;11568;203;790;2858;9339;3061;10129
261260;201601;11832;33623;10680;32224;589;1871;8870;26981;9459;28852
261270;201601;3556;10613;3209;10055;397;1407;2135;6554;2532;7961
261280;201601;2426;7532;2267;7301;126;489;1833;5848;1959;6337
261290;201601;2875;8278;2626;7952;155;579;2120;6430;2275;7009
261300;201601;10468;34009;9224;31761;1472;5756;5451;18489;6923;24245
261310;201601;7162;22161;6767;21457;1633;5266;3629;11574;5262;16840
261320;201601;5437;17217;5029;16482;214;859;4052;13188;4266;14047
261330;201601;5324;15655;5042;15271;476;1486;3920;11858;4396;13344
261340;201601;3821;12896;3632;12590;389;1706;2405;8184;2794;9890
261350;201601;7821;26119;7368;25355;277;1417;5908;19872;6185;21289
261360;201601;8004;21185;7165;20009;580;1779;5638;15469;6218;17248
261370;201601;19206;56722;17929;54748;3797;12082;9781;29994;13578;42076
261380;201601;4027;13886;3732;13262;594;2328;2315;8222;2909;10550
261390;201601;15742;48157;14341;45868;2116;7332;8514;27230;10630;34562
261400;201601;4575;15883;4130;14963;358;1494;2875;10396;3233;11890
261410;201601;8476;23842;7649;22574;939;2774;5550;16533;6489;19307
261420;201601;7220;24522;6915;24110;1686;6604;3914;13342;5600;19946
261430;201601;3337;10532;2947;9961;270;957;2228;7665;2498;8622
261440;201601;1525;4919;1378;4701;59;311;1061;3527;1120;3838
261450;201601;13822;39225;13345;38661;325;1209;12102;34856;12427;36065
261460;201601;6988;20723;6544;20136;419;1210;5618;17567;6037;18777
261470;201601;3825;10559;3479;10107;123;406;3148;9159;3271;9565
261480;201601;3573;12818;3304;12325;332;1382;2338;8605;2670;9987
261485;201601;4838;14970;4391;14191;710;2611;2535;8030;3245;10641
261500;201601;5558;15531;4956;14738;447;1249;3695;11325;4142;12574
261510;201601;1834;5928;1691;5707;130;489;1247;4221;1377;4710
261520;201601;2611;8542;2443;8231;137;522;1647;5784;1784;6306
261530;201601;11741;37714;10438;35191;2175;8200;4252;14227;6427;22427
261540;201601;7000;22744;6624;22102;1419;4755;3898;13289;5317;18044
261550;201601;3359;9571;3163;9295;244;933;2483;7079;2727;8012
261560;201601;6842;22720;6228;21891;949;3735;4325;15308;5274;19043
261570;201601;3284;10092;2898;9475;402;1390;1826;5981;2228;7371
261580;201601;5765;17901;5225;17042;352;1438;4280;13848;4632;15286
261590;201601;2334;6719;2066;6319;183;564;1518;4680;1701;5244
261600;201601;5119;14064;4451;13137;340;1034;3457;10282;3797;11316
261610;201601;2406;7000;2100;6586;110;473;1647;5072;1757;5545
261618;201601;2431;6861;2215;6592;196;617;1660;4871;1856;5488
261620;201601;4032;12560;3763;12106;634;2091;2447;7995;3081;10086
261630;201601;7556;22219;6381;20053;843;3082;3486;10707;4329;13789
261640;201601;32689;82363;30519;79767;2165;5508;24336;65867;26501;71375
261650;201601;3546;10970;3289;10616;364;1342;2335;7570;2699;8912
270010;201601;4241;16186;3918;15571;428;2011;2640;10522;3068;12533
270020;201601;3720;10675;3464;10308;423;1338;2558;7534;2981;8872
270030;201601;38947;117075;36418;113067;8928;28386;19207;60443;28135;88829
270040;201601;10374;32015;9583;30987;2123;6838;5458;18384;7581;25222
270050;201601;4175;11869;3837;11450;426;1398;2934;8736;3360;10134
270060;201601;1730;5322;1609;5163;280;955;1043;3388;1323;4343
270070;201601;4179;13091;3849;12657;201;982;3265;10459;3466;11441
270080;201601;1220;3907;1077;3624;153;577;660;2160;813;2737
270090;201601;2077;6487;1920;6176;57;310;1602;4969;1659;5279
270100;201601;5572;17467;5262;16930;886;3041;3342;10646;4228;13687
270110;201601;3081;8530;2731;8153;374;1131;1777;5714;2151;6845
270120;201601;3019;8672;2689;8274;89;341;2410;7440;2499;7781
270130;201601;4909;15075;4572;14694;626;2051;3464;11388;4090;13439
270135;201601;1696;4548;1570;4399;179;355;1321;3883;1500;4238
270140;201601;9990;24490;8644;22804;741;2944;6695;16406;7436;19350
270150;201601;2632;8792;2561;8701;69;243;2428;8279;2497;8522
270160;201601;4943;16588;4557;16097;216;916;3889;13676;4105;14592
270170;201601;3707;12068;3414;11677;587;2319;1985;6698;2572;9017
270180;201601;2167;7304;1991;7056;104;547;1622;5639;1726;6186
270190;201601;1741;5762;1660;5659;96;395;1388;4745;1484;5140
270200;201601;2522;8459;2357;8228;203;869;1788;6153;1991;7022
270210;201601;4495;13714;4232;13346;288;1202;3482;10732;3770;11934
270220;201601;1300;4328;1213;4170;229;845;680;2322;909;3167
270230;201601;10662;33725;9397;31771;1239;5135;5648;18467;6887;23602
270235;201601;6265;20346;5859;19701;385;1667;4724;15665;5109;17332
270240;201601;9205;27870;7812;26074;1976;6819;3507;12062;5483;18881
270250;201601;3175;8414;2894;8069;502;1328;2140;5998;2642;7326
270255;201601;4881;14762;3852;12926;258;1076;2713;8921;2971;9997
270260;201601;5618;18505;5441;18260;426;1818;4551;14963;4977;16781
270270;201601;1154;3342;1062;3210;199;633;605;1800;804;2433
270280;201601;3419;9843;3045;9320;343;1049;2130;6532;2473;7581
270290;201601;7940;27868;7441;27014;673;2974;5664;20273;6337;23247
270300;201601;3520;11569;3162;11151;324;1319;2288;8002;2612;9321
270310;201601;7208;22027;6336;20730;266;1381;5256;16776;5522;18157
270320;201601;5659;18122;5407;17724;767;2970;3810;12180;4577;15150
270330;201601;4212;14389;3956;14033;395;1510;3085;11059;3480;12569
270340;201601;1682;5216;1482;4954;124;421;1144;3832;1268;4253
270350;201601;1812;5043;1633;4831;135;479;1191;3507;1326;3986
270360;201601;1925;6042;1846;5951;197;557;1508;5034;1705;5591
270370;201601;1484;4960;1359;4751;122;514;965;3376;1087;3890
270375;201601;2746;7747;2458;7362;202;720;1939;5693;2141;6413
270380;201601;5519;17250;5183;16786;495;1660;3975;13114;4470;14774
270390;201601;1223;3425;1080;3221;77;292;801;2301;878;2593
270400;201601;6142;18523;5525;17650;383;1469;3984;12421;4367;13890
270410;201601;4718;14782;4369;14152;456;1641;3054;9754;3510;11395
270420;201601;5655;18281;5445;17993;254;1179;4466;14430;4720;15609
270430;201601;128470;375796;117835;360004;31533;101849;49325;153539;80858;255388
270440;201601;4527;13760;4189;13308;211;841;3401;10818;3612;11659
270450;201601;6140;19098;5880;18766;310;1354;4872;15283;5182;16637
270460;201601;3311;8970;2980;8564;194;642;2530;7186;2724;7828
270470;201601;10024;32238;9265;31036;1421;4979;5570;19044;6991;24023
270480;201601;2750;8708;2445;8158;243;994;1651;5291;1894;6285
270490;201601;932;3036;877;2957;37;158;704;2347;741;2505
270500;201601;4787;16424;4527;16110;311;1380;3728;13210;4039;14590
270510;201601;5728;17302;5153;16498;658;2709;3741;11436;4399;14145
270520;201601;3489;11177;3218;10728;947;3465;1140;3901;2087;7366
270530;201601;1354;4204;1253;4054;149;492;836;2785;985;3277
270540;201601;1989;6735;1825;6498;118;614;1462;5021;1580;5635
270550;201601;7025;20532;6118;19386;852;2888;4058;13158;4910;16046
270560;201601;2969;9055;2774;8759;299;1159;2004;6168;2303;7327
270570;201601;3924;12711;3598;12160;345;1455;2717;8980;3062;10435
270580;201601;1961;6322;1871;6202;180;610;1434;4851;1614;5461
270590;201601;1336;4486;1282;4397;16;73;1228;4217;1244;4290
270600;201601;2696;9148;2468;8772;157;786;1916;6640;2073;7426
270610;201601;3082;9835;2862;9519;198;744;2325;7675;2523;8419
270620;201601;1332;4594;1257;4472;90;437;990;3387;1080;3824
270630;201601;15954;46741;14663;44654;2257;6732;9671;30381;11928;37113
270640;201601;5530;17304;5039;16570;327;1419;4019;12940;4346;14359
270642;201601;2223;7923;2089;7728;241;1100;1533;5583;1774;6683
270644;201601;2570;7580;2301;7236;262;777;1733;5585;1995;6362
270650;201601;3562;11398;3398;11165;506;2254;2279;7010;2785;9264
270660;201601;2387;6076;1861;5325;84;335;1329;3736;1413;4071
270670;201601;15985;41525;13926;39211;1869;5079;9977;29216;11846;34295
270680;201601;4144;12411;3976;12225;133;373;3661;11369;3794;11742
270690;201601;8448;23583;7598;22629;2403;6853;3847;12194;6250;19047
270700;201601;631;1983;570;1882;76;309;384;1217;460;1526
270710;201601;5694;18488;5429;18147;416;1638;4486;14862;4902;16500
270720;201601;3226;11014;2945;10514;148;791;2381;8327;2529;9118
270730;201601;5983;18080;5702;17776;614;2073;4603;14420;5217;16493
270740;201601;2228;6415;2102;6231;253;860;1568;4547;1821;5407
270750;201601;4920;15493;4590;14981;648;2309;3216;10438;3864;12747
270760;201601;3241;9918;2905;9359;185;721;2249;7180;2434;7901
270770;201601;18610;48786;15392;44916;3296;9651;8218;25310;11514;34961
270780;201601;1715;5701;1630;5564;189;742;1166;3954;1355;4696
270790;201601;1500;4736;1380;4563;336;1193;682;2219;1018;3412
270800;201601;10986;32780;10249;31821;764;2930;8379;25574;9143;28504
270810;201601;3273;9971;2566;8719;272;1122;1534;5241;1806;6363
270820;201601;1733;5775;1572;5508;275;1056;922;3219;1197;4275
270830;201601;5385;14894;4902;14315;386;1233;3899;11623;4285;12856
270840;201601;7644;25004;7133;24357;337;1738;6159;20575;6496;22313
270850;201601;7107;22664;6860;22342;1134;4469;4618;14223;5752;18692
270860;201601;10925;30603;9272;28502;1062;3887;6197;18639;7259;22526
270870;201601;2093;6400;1754;5697;259;878;1066;3437;1325;4315
270880;201601;7915;25577;7386;24798;499;2074;5887;19495;6386;21569
270890;201601;2312;7071;2173;6833;225;873;1582;4824;1807;5697
270895;201601;2761;10377;2665;10242;151;730;2300;8834;2451;9564
270900;201601;1913;5184;1562;4699;94;314;1162;3436;1256;3750
270910;201601;3464;11415;3213;10960;249;1117;2459;8142;2708;9259
270915;201601;9325;31378;8429;29805;1382;5721;4833;16690;6215;22411
270920;201601;5956;18970;5754;18692;212;1131;5152;16276;5364;17407
270930;201601;16898;45207;14009;41795;2675;8089;8097;25127;10772;33216
270940;201601;5521;18489;5238;18185;475;2159;4127;14116;4602;16275
280010;201601;636;1907;555;1769;53;231;344;1033;397;1264
280020;201601;4681;13699;4050;12629;722;2443;2396;7391;3118;9834
280030;201601;72860;191293;63269;177224;17856;52135;23768;68404;41624;120539
280040;201601;3029;9360;2693;8858;241;939;1982;6446;2223;7385
280050;201601;3692;11939;3436;11508;1165;4132;1243;4290;2408;8422
280060;201601;4487;14532;4070;13783;817;2990;2077;7181;2894;10171
280067;201601;7156;20310;6188;18886;891;2675;3874;12071;4765;14746
280070;201601;1862;6199;1774;6074;261;949;1249;4301;1510;5250
280100;201601;3721;11623;3370;11013;647;2301;1935;6353;2582;8654
280110;201601;1387;4220;1279;4062;70;307;1059;3310;1129;3617
280120;201601;7632;24168;7022;23175;1247;3716;4557;15864;5804;19580
280130;201601;7183;20374;6615;19559;1113;3519;4217;12569;5330;16088
280140;201601;5376;14820;4910;14163;429;1297;3843;11157;4272;12454
280150;201601;3274;9912;3071;9577;310;1096;2155;6555;2465;7651
280160;201601;1349;3935;1189;3684;156;531;783;2381;939;2912
280170;201601;4658;13968;4222;13337;460;1489;3090;9926;3550;11415
280190;201601;1068;2951;958;2769;63;226;730;2054;793;2280
280200;201601;1131;3423;1036;3282;126;501;719;2196;845;2697
280210;201601;13108;39447;11842;37703;2262;7659;6778;21914;9040;29573
280220;201601;1512;4694;1417;4542;91;358;1142;3599;1233;3957
280230;201601;3326;10037;2996;9538;363;1253;1921;6161;2284;7414
280240;201601;3394;9970;3083;9484;281;830;2355;7307;2636;8137
280250;201601;803;2123;661;1897;121;416;324;838;445;1254
280260;201601;1973;5323;1839;5156;77;241;1640;4625;1717;4866
280270;201601;2208;6905;1981;6563;121;487;1531;4980;1652;5467
280280;201601;4099;13326;3720;12702;805;2245;2067;7950;2872;10195
280290;201601;17058;52040;15486;49645;2178;7725;9562;30917;11740;38642
280300;201601;9228;28260;8723;27643;873;3013;6732;21829;7605;24842
280310;201601;1325;3747;1182;3521;69;284;823;2401;892;2685
280320;201601;8347;26837;7680;25717;1517;5584;3785;12546;5302;18130
280330;201601;4411;12527;4023;11910;410;1488;3010;8552;3420;10040
280340;201601;3699;10566;3466;10253;357;1171;2693;7959;3050;9130
280350;201601;21431;60526;19222;57217;2945;9198;12113;36415;15058;45613
280360;201601;5552;17458;5216;16924;998;3686;2849;8999;3847;12685
280370;201601;1809;5119;1584;4746;148;465;1097;3263;1245;3728
280380;201601;1023;3151;925;2992;95;358;655;2074;750;2432
280390;201601;3059;9082;2649;8329;390;1302;1642;5171;2032;6473
280400;201601;4095;11693;3750;11200;1272;3748;1597;5064;2869;8812
280410;201601;2160;6857;1853;6273;251;966;1042;3408;1293;4374
280420;201601;3982;11765;3710;11344;229;743;3098;9477;3327;10220
280430;201601;2205;5663;1999;5381;101;347;1567;4115;1668;4462
280440;201601;4573;13640;4298;13317;380;1295;3441;10569;3821;11864
280445;201601;2459;6915;2293;6645;74;291;1823;5191;1897;5482
280450;201601;8720;23654;8153;22949;599;1455;6812;19732;7411;21187
280460;201601;6831;18076;6183;17166;836;2439;4346;12222;5182;14661
280470;201601;1772;5393;1614;5126;188;591;1128;3648;1316;4239
280480;201601;29441;86675;27950;84526;4803;16353;17524;51691;22327;68044
280490;201601;3745;11235;3286;10464;245;954;2398;7468;2643;8422
280500;201601;899;2421;811;2312;46;145;662;1844;708;1989
280510;201601;2588;7535;2263;7113;197;713;1652;5208;1849;5921
280520;201601;1724;4792;1584;4620;145;409;1286;3800;1431;4209
280530;201601;2300;6399;2148;6214;147;418;1751;5132;1898;5550
280540;201601;9099;25082;8463;24209;222;946;7391;20657;7613;21603
280550;201601;6763;17917;5745;16389;613;1770;3954;11357;4567;13127
280560;201601;7415;22024;7034;21466;384;1341;5861;17655;6245;18996
280570;201601;6340;17171;5565;16137;582;1903;3720;10637;4302;12540
280580;201601;5476;16992;4673;15599;818;2755;2655;9155;3473;11910
280590;201601;2296;7006;2133;6794;230;1015;1467;4483;1697;5498
280600;201601;3628;11142;3393;10795;314;1112;2532;7969;2846;9081
280610;201601;2415;6801;2223;6526;196;718;1575;4472;1771;5190
280620;201601;5096;15177;4486;14124;592;1775;2940;9639;3532;11414
280630;201601;3617;11799;3418;11503;323;1029;2711;9396;3034;10425
280640;201601;2181;6542;2082;6430;88;242;1933;6048;2021;6290
280650;201601;1097;3433;993;3265;99;383;691;2253;790;2636
280660;201601;2602;7368;2495;7239;424;1151;1889;5566;2313;6717
280670;201601;15739;41469;14582;39915;2795;8109;8776;23770;11571;31879
280680;201601;2705;7352;2420;6916;199;654;1882;5268;2081;5922
280690;201601;936;2677;836;2535;121;385;560;1701;681;2086
280700;201601;1048;3135;935;2958;68;229;668;2112;736;2341
280710;201601;11563;30609;10571;29492;712;1826;8886;25370;9598;27196
280720;201601;2259;6197;2055;5959;270;810;1380;4101;1650;4911
280730;201601;917;2756;857;2672;88;314;670;2059;758;2373
280740;201601;12800;34933;11165;32469;1520;4375;7085;20964;8605;25339
280750;201601;3447;10515;3163;10042;325;1098;2164;6931;2489;8029
280760;201601;5545;16980;5065;16288;771;2687;3077;10142;3848;12829
290010;201601;2933;6653;2128;5418;51;213;1655;3999;1706;4212
290020;201601;4273;14363;4194;14256;367;1024;3500;12144;3867;13168
290030;201601;3066;9626;2901;9386;531;1683;1974;6465;2505;8148
290035;201601;4615;11761;4000;10955;229;757;3067;8677;3296;9434
290040;201601;3924;10689;3385;10085;198;776;2659;7839;2857;8615
290050;201601;2431;7949;2181;7543;157;652;1608;5545;1765;6197
290060;201601;1252;3302;1061;3080;178;583;761;2150;939;2733
290070;201601;32617;81779;28088;76152;6159;16505;13053;37815;19212;54320
290080;201601;5920;17757;5059;16618;649;2143;3540;11986;4189;14129
290090;201601;2123;4616;1678;4145;167;386;1382;3489;1549;3875
290100;201601;9419;27021;8314;25313;1078;3431;5194;16237;6272;19668
290110;201601;4738;14078;4497;13671;693;2303;2852;8458;3545;10761
290115;201601;4685;14186;4171;13515;224;741;3407;11278;3631;12019
290120;201601;6670;17513;5550;16178;268;940;4568;13189;4836;14129
290130;201601;4559;11974;3787;11027;198;747;3014;8523;3212;9270
290135;201601;4432;11233;3811;10303;258;841;2766;7150;3024;7991
290140;201601;4069;12703;3538;11976;262;1013;2852;9697;3114;10710
290150;201601;2132;6448;2028;6306;228;744;1560;4775;1788;5519
290160;201601;3300;8741;3166;8577;320;646;2601;7165;2921;7811
290170;201601;2695;8948;2446;8589;176;854;2015;6930;2191;7784
290180;201601;2875;8409;2487;7810;183;697;1901;5930;2084;6627
290190;201601;3676;12362;3524;12137;191;864;2735;9272;2926;10136
290195;201601;2129;5829;1801;5339;88;382;1448;4199;1536;4581
290200;201601;3758;11757;3335;11111;286;982;2557;8558;2843;9540
290205;201601;3112;9163;2806;8699;272;1017;2009;6093;2281;7110
290210;201601;14932;41990;13559;40252;2412;6409;8855;28372;11267;34781
290220;201601;2225;6656;2110;6476;133;551;1648;4919;1781;5470
290225;201601;2810;7308;2541;7013;132;391;2279;6288;2411;6679
290230;201601;2253;7298;2142;7171;137;571;1767;5879;1904;6450
290240;201601;3481;9526;3187;9092;295;895;2363;6646;2658;7541
290250;201601;3682;11769;3331;11268;181;614;2738;9575;2919;10189
290260;201601;4918;14061;4143;12914;330;1167;3127;9742;3457;10909
290265;201601;3281;10344;2926;9715;152;672;2260;7426;2412;8098
290270;201601;11822;43124;11269;42261;1492;5901;8048;30614;9540;36515
290280;201601;5190;17024;4822;16427;423;1621;3594;12277;4017;13898
290290;201601;9504;30106;8522;28505;1339;4539;5524;18899;6863;23438
290300;201601;4561;12898;3298;10572;255;814;2129;7061;2384;7875
290310;201601;1434;4309;1258;4036;242;853;667;2146;909;2999
290320;201601;28087;80290;23900;74861;5722;19083;11006;35655;16728;54738
290323;201601;3767;10232;3319;9730;169;525;2734;8027;2903;8552
290327;201601;4314;13129;3716;12057;534;1776;2300;7483;2834;9259
290330;201601;1746;4355;1608;4208;134;373;1381;3625;1515;3998
290340;201601;4823;14981;4515;14598;1302;4296;2417;7933;3719;12229
290350;201601;4249;13306;3742;12561;407;1400;2570;8868;2977;10268
290360;201601;4454;13599;3856;12802;171;660;3192;10720;3363;11380
290370;201601;4623;12899;3988;12090;362;1029;3149;9721;3511;10750
290380;201601;5526;15977;4822;14918;327;1115;3748;11747;4075;12862
290390;201601;14266;43869;12967;41973;2265;7527;7666;25862;9931;33389
290395;201601;2520;8290;2253;7788;136;618;1664;5749;1800;6367
290400;201601;3523;10380;3009;9616;282;909;2102;6697;2384;7606
290405;201601;4571;14490;3886;13235;605;2089;2228;7828;2833;9917
290410;201601;5890;17438;4814;15760;451;1743;3335;10642;3786;12385
290420;201601;3211;9323;2693;8592;209;731;2076;6618;2285;7349
290430;201601;3041;9595;2738;9075;503;1747;1613;5422;2116;7169
290440;201601;2928;7778;2386;7020;165;596;1825;5400;1990;5996
290450;201601;3243;9460;2779;8779;310;1057;1880;5949;2190;7006
290460;201601;12632;36667;11386;34630;3160;9769;4474;13785;7634;23554
290470;201601;4352;11997;3325;10487;775;2663;1364;4484;2139;7147
290475;201601;5123;17013;4627;16094;308;1426;3437;11712;3745;13138
290480;201601;2375;6419;2190;6179;279;814;1499;4437;1778;5251
290485;201601;4713;14980;4107;14080;299;1457;3240;10844;3539;12301
290490;201601;7825;20746;7438;20238;661;1865;5958;16095;6619;17960
290500;201601;4113;12947;3390;11527;511;1899;1755;5949;2266;7848
290510;201601;3249;9352;2844;8813;155;583;2350;7295;2505;7878
290515;201601;3284;9449;2800;8817;254;826;2210;7074;2464;7900
290520;201601;11980;36673;9745;32523;857;3392;5822;19284;6679;22676
290530;201601;4970;14775;4359;13840;324;1003;3378;10824;3702;11827
290540;201601;3841;11073;3643;10831;431;1280;2818;8476;3249;9756
290550;201601;4446;11794;3929;11207;131;388;3572;10248;3703;10636
290560;201601;6177;18024;5458;17001;1280;4024;3017;9678;4297;13702
290570;201601;41606;114030;38034;109150;3949;11713;26740;76828;30689;88541
290580;201601;6820;23341;6424;22708;806;2957;4561;16506;5367;19463
290590;201601;7185;23025;6205;21287;296;1256;4952;16955;5248;18211
290600;201601;17201;52034;15955;50253;2206;6686;11425;37332;13631;44018
290610;201601;2436;8218;2039;7442;145;675;1418;5093;1563;5768
290620;201601;6324;19204;5796;18396;389;1267;4650;14783;5039;16050
290630;201601;7700;20319;6801;19339;607;1794;5548;15945;6155;17739
290640;201601;2621;7668;2117;6866;149;593;1563;4997;1712;5590
290650;201601;10712;30707;10107;29905;2113;6156;6157;18770;8270;24926
290660;201601;3589;10021;3111;9336;132;439;2341;7282;2473;7721
290670;201601;6729;20637;6068;19567;685;2261;4246;13946;4931;16207
290680;201601;10110;30182;9117;28985;448;1772;7491;23696;7939;25468
290682;201601;4392;12636;3919;11967;148;573;3349;10109;3497;10682
290685;201601;3707;8805;2447;7053;290;874;1455;4311;1745;5185
290687;201601;7454;20933;5863;18559;1367;4372;2711;9076;4078;13448
290689;201601;3109;9009;2742;8452;243;792;2030;6502;2273;7294
290690;201601;5351;15289;4752;14498;777;2412;3047;9402;3824;11814
290700;201601;2313;7205;2185;7023;163;608;1683;5400;1846;6008
290710;201601;7595;24080;7132;23407;339;1154;6039;19974;6378;21128
290720;201601;18029;53152;16526;51274;1298;3893;13381;42485;14679;46378
290730;201601;7093;19628;6341;18660;1032;2930;4134;12390;5166;15320
290740;201601;901;2684;737;2398;78;273;496;1623;574;1896
290750;201601;9861;27426;8448;24885;1408;4584;4489;12768;5897;17352
290755;201601;2313;6539;1890;5849;91;338;1377;4225;1468;4563
290760;201601;4169;12605;3418;11254;458;1389;2053;7006;2511;8395
290770;201601;2469;8713;2334;8537;97;454;1885;6912;1982;7366
290780;201601;8813;22361;7647;20686;816;1715;5706;16191;6522;17906
290790;201601;4233;12788;3908;12341;244;789;3273;10382;3517;11171
290800;201601;7127;15219;5674;13669;631;1256;4187;10759;4818;12015
290810;201601;5067;15677;4273;14423;193;735;3224;10974;3417;11709
290820;201601;5569;15489;4947;14696;466;1582;3718;11113;4184;12695
290830;201601;4287;11410;3935;10925;215;722;2957;8011;3172;8733
290840;201601;17394;49117;15395;46160;2488;7267;9686;30361;12174;37628
290850;201601;6035;17466;5823;17211;710;1883;4588;14123;5298;16006
290860;201601;4986;16830;4655;16437;430;1647;3609;13035;4039;14682
290870;201601;4617;13594;3749;12131;263;1056;2648;8509;2911;9565
290880;201601;1410;3825;1125;3380;109;303;734;2251;843;2554
290890;201601;6911;17941;5890;16812;649;1687;4594;13421;5243;15108
290900;201601;2387;6864;1807;5867;269;909;921;3010;1190;3919
290910;201601;4589;12373;3821;11263;102;408;3235;9426;3337;9834
290920;201601;4580;13202;4201;12681;293;850;3424;10421;3717;11271
290930;201601;7710;23761;6772;22212;400;1762;5182;16697;5582;18459
290940;201601;3404;10879;3140;10510;129;453;2633;9012;2762;9465
290950;201601;1529;4252;1340;3971;160;471;884;2663;1044;3134
290960;201601;5654;16057;5152;15433;178;664;4293;12902;4471;13566
290970;201601;3593;11375;3155;10657;299;1019;2117;7309;2416;8328
290980;201601;10442;29726;8909;26914;2386;7401;2663;8092;5049;15493
290990;201601;8914;26791;7750;24902;792;2722;5566;17744;6358;20466
291000;201601;2894;8817;2639;8518;153;587;2307;7451;2460;8038
291005;201601;14111;36725;12438;34547;1716;4827;8334;23616;10050;28443
291010;201601;3244;10036;2565;8610;250;863;1631;5553;1881;6416
291020;201601;1346;3520;1047;3010;106;303;559;1518;665;1821
291030;201601;2240;6112;1659;4974;166;533;963;2856;1129;3389
291040;201601;5448;16362;4859;15523;358;1338;3759;12020;4117;13358
291050;201601;7551;24548;6866;23311;1645;6260;3412;11143;5057;17403
291060;201601;5918;21699;5586;21182;915;3836;3524;13238;4439;17074
291070;201601;15771;45584;13815;42782;1058;3682;10414;32316;11472;35998
291072;201601;22445;66080;18334;58105;4520;15509;6032;19467;10552;34976
291075;201601;5052;14287;4524;13540;242;632;3534;10841;3776;11473
291077;201601;1437;4099;1173;3672;92;301;742;2333;834;2634
291080;201601;76664;237697;69190;223831;23639;77559;14544;47332;38183;124891
291085;201601;5592;14653;4823;13641;417;1251;3859;10952;4276;12203
291090;201601;1527;3716;1385;3550;49;145;1225;3140;1274;3285
291100;201601;2590;6616;2088;6071;97;385;1646;4716;1743;5101
291110;201601;4635;17004;4235;16408;514;2314;2948;11208;3462;13522
291120;201601;7071;19240;6523;18431;848;2399;4494;12859;5342;15258
291125;201601;1858;3739;1409;3256;92;225;1105;2609;1197;2834
291130;201601;2803;8778;2387;8051;125;560;1761;5784;1886;6344
291140;201601;4115;12247;3622;11345;499;1508;2245;7171;2744;8679
291150;201601;1909;5085;1803;4960;113;351;1470;3997;1583;4348
291160;201601;5214;16304;4591;15290;1071;3572;2322;7813;3393;11385
291165;201601;2515;7029;1930;5941;49;200;1394;4188;1443;4388
291170;201601;21424;55752;18330;51625;1560;4769;12074;34153;13634;38922
291180;201601;6098;16054;4960;14355;433;1382;3473;10111;3906;11493
291185;201601;3702;10097;3313;9509;279;809;2636;7523;2915;8332
291190;201601;6900;18983;6095;17879;473;1659;4841;14012;5314;15671
291200;201601;2868;8560;2296;7477;158;540;1526;5073;1684;5613
291210;201601;6741;16242;5681;15041;289;922;4306;11370;4595;12292
291220;201601;4120;12786;3765;12238;480;1791;2516;8073;2996;9864
291230;201601;3954;10086;3611;9709;72;145;3401;9266;3473;9411
291240;201601;4542;12365;3946;11317;132;423;3160;8928;3292;9351
291250;201601;3499;10764;2807;9481;292;1018;1815;6256;2107;7274
291260;201601;1046;3061;967;2957;67;262;799;2368;866;2630
291270;201601;4369;14095;3974;13368;1294;4517;1813;6191;3107;10708
291280;201601;2102;5967;1675;5273;377;1332;786;2354;1163;3686
291290;201601;5446;15147;4735;14230;797;2408;2783;8544;3580;10952
291300;201601;4321;12310;3375;10714;200;738;2464;7706;2664;8444
291310;201601;5237;15032;4580;13834;298;956;3510;10587;3808;11543
291320;201601;5973;18797;4937;16845;1138;4038;2266;7828;3404;11866
291330;201601;1538;4668;1371;4398;127;459;954;3025;1081;3484
291340;201601;3848;10927;3198;10011;129;454;2559;7989;2688;8443
291345;201601;3343;10649;3105;10364;212;725;2604;8883;2816;9608
291350;201601;5658;16614;4967;15449;294;1024;3819;12040;4113;13064
291360;201601;32069;88568;28660;83886;7022;20663;15307;46249;22329;66912
291370;201601;8184;23414;7693;22815;518;1663;5979;17863;6497;19526
291380;201601;3656;11055;3139;10216;211;774;2301;7604;2512;8378
291390;201601;9910;27012;9185;26156;1364;3715;6533;18855;7897;22570
291400;201601;13358;37287;11805;34935;2296;6225;7134;22469;9430;28694
291410;201601;3213;8458;2400;7180;135;578;1724;4972;1859;5550
291420;201601;2058;5640;1787;5321;93;348;1477;4334;1570;4682
291430;201601;3182;9369;2830;8899;137;659;2295;6967;2432;7626
291440;201601;6484;19763;5533;18190;529;1845;4017;13369;4546;15214
291450;201601;8213;23980;7207;22628;343;1083;5722;18747;6065;19830
291460;201601;12935;39066;11672;37102;1689;5858;7175;22946;8864;28804
291465;201601;7827;22272;6896;21225;450;1684;5606;17073;6056;18757
291470;201601;15524;41761;13669;39557;1089;2992;10188;30611;11277;33603
291480;201601;33507;86491;28583;79794;4091;12546;16306;45543;20397;58089
291490;201601;4208;13531;3991;13238;454;1525;2932;9883;3386;11408
291500;201601;4191;12100;3562;11182;210;794;2792;8722;3002;9516
291510;201601;3518;10670;3231;10289;68;247;2878;9301;2946;9548
291520;201601;3738;10255;3227;9573;307;1007;2211;6564;2518;7571
291530;201601;2151;5869;1705;5208;385;1191;821;2715;1206;3906
291535;201601;3698;11257;3343;10715;200;716;2592;8361;2792;9077
291540;201601;2070;4954;1729;4605;116;210;1516;4184;1632;4394
291550;201601;5021;13589;4381;12721;949;2584;2428;7314;3377;9898
291560;201601;17949;42584;12976;36842;1009;2903;9470;28150;10479;31053
291570;201601;2154;5840;1981;5634;154;354;1664;4917;1818;5271
291580;201601;5373;16429;4782;15584;510;2045;3370;10911;3880;12956
291590;201601;1702;5449;1540;5188;161;597;1131;3848;1292;4445
291600;201601;5363;14822;4010;12716;1074;3548;1548;4860;2622;8408
291610;201601;4746;15183;4576;14994;159;567;4144;13677;4303;14244
291620;201601;2891;6883;2291;6257;130;394;1829;5145;1959;5539
291630;201601;3056;7448;2543;6858;261;709;1913;5272;2174;5981
291640;201601;16757;45628;13448;40794;3305;10438;4013;12716;7318;23154
291650;201601;7847;23524;7254;22802;627;1660;5958;19295;6585;20955
291660;201601;2114;5603;1732;5019;142;511;1111;3055;1253;3566
291670;201601;1804;5053;1625;4811;89;263;1295;3905;1384;4168
291680;201601;3949;11539;3445;10711;634;2113;1931;6002;2565;8115
291685;201601;4711;11846;3916;10822;674;1790;2481;7137;3155;8927
291690;201601;3870;10390;3055;9065;219;613;2126;6319;2345;6932
291700;201601;8964;27992;7999;26320;909;2919;5767;19312;6676;22231
291710;201601;5105;13324;4138;12117;338;1061;3007;8836;3345;9897
291720;201601;4383;14385;3751;13081;339;1371;2565;8765;2904;10136
291730;201601;5890;17651;5372;16960;527;1808;4118;13192;4645;15000
291733;201601;2582;7450;2227;6980;216;737;1446;4667;1662;5404
291735;201601;2801;7810;2347;7158;117;424;1876;5692;1993;6116
291740;201601;3507;10370;3034;9703;229;834;2376;7591;2605;8425
291750;201601;22161;56860;17337;49515;3816;11204;8153;23996;11969;35200
291760;201601;10825;34629;9644;32622;3848;14433;2378;8037;6226;22470
291770;201601;7537;21792;6415;19798;787;2627;4063;12325;4850;14952
291780;201601;4396;13303;4107;12824;269;900;3344;10413;3613;11313
291790;201601;2612;8013;2481;7840;89;410;2100;6504;2189;6914
291800;201601;29738;80838;26170;75952;4246;12419;15807;47442;20053;59861
291810;201601;10422;28775;8819;26814;399;1439;7089;21600;7488;23039
291820;201601;3678;10888;3308;10357;211;742;2517;7930;2728;8672
291830;201601;3949;10682;3642;10240;519;1493;2515;7187;3034;8680
291835;201601;6197;19393;5020;17331;1425;5283;2260;7898;3685;13181
291840;201601;46464;130405;41047;124287;6452;19081;27831;87614;34283;106695
291845;201601;2600;7673;2424;7449;139;368;2165;6814;2304;7182
291850;201601;4482;12860;3701;11628;344;997;2666;8666;3010;9663
291855;201601;1793;4497;1547;4193;159;558;1122;2925;1281;3483
291860;201601;2143;6087;1748;5339;85;318;1148;3419;1233;3737
291870;201601;1393;3731;1021;3070;69;265;626;1797;695;2062
291875;201601;2757;8701;2512;8334;115;466;1807;5882;1922;6348
291880;201601;4848;15565;4545;15054;439;1490;3369;11291;3808;12781
291890;201601;1247;3255;1031;2990;261;713;615;1891;876;2604
291900;201601;1240;3331;1007;2963;64;235;744;2155;808;2390
291905;201601;2667;7282;2029;6131;228;808;1339;3850;1567;4658
291910;201601;2709;7229;2276;6719;125;480;1896;5546;2021;6026
291915;201601;6946;21213;5829;19194;320;1159;4495;14888;4815;16047
291920;201601;26030;76384;23862;73388;3882;12470;14296;44347;18178;56817
291930;201601;2572;7606;2280;7149;198;748;1592;4868;1790;5616
291940;201601;3301;9372;2453;7883;304;1082;1378;4307;1682;5389
291950;201601;8558;28579;7767;27091;1213;4257;4509;16230;5722;20487
291955;201601;10481;30243;9708;29287;2294;6991;5226;16625;7520;23616
291960;201601;3102;9083;2544;8246;236;775;1830;6154;2066;6929
291970;201601;3786;11817;3504;11353;391;1437;2335;7624;2726;9061
291980;201601;11833;33582;9079;29651;1047;3502;5966;20041;7013;23543
291990;201601;2125;6536;1937;6290;78;263;1634;5449;1712;5712
291992;201601;2742;8351;2677;8239;372;1170;2003;6140;2375;7310
291995;201601;1951;5700;1711;5360;107;408;1413;4394;1520;4802
292000;201601;2371;6672;2135;6361;229;796;1497;4504;1726;5300
292010;201601;6268;15853;4912;13941;494;1330;3529;10221;4023;11551
292020;201601;3910;13611;3700;13258;648;2429;2561;9171;3209;11600
292030;201601;2019;6209;1805;5914;224;782;1050;3422;1274;4204
292040;201601;4333;11742;3745;11130;286;622;3107;9853;3393;10475
292045;201601;3057;9942;2830;9634;110;453;2568;8634;2678;9087
292050;201601;6220;18958;5363;17249;445;1712;3432;10917;3877;12629
292060;201601;11617;30843;10781;29819;1103;2698;8416;23507;9519;26205
292070;201601;4540;14143;4278;13840;396;1241;3514;11507;3910;12748
292080;201601;3471;9066;2868;8311;176;576;2414;7018;2590;7594
292090;201601;3855;10169;3321;9544;190;696;2790;8021;2980;8717
292100;201601;11081;29764;9475;27606;2389;7244;4255;13004;6644;20248
292105;201601;2953;9220;2642;8725;122;532;2107;6944;2229;7476
292110;201601;6345;17010;4954;14824;1337;4002;2289;7070;3626;11072
292120;201601;7428;20923;6244;18716;1223;3568;3271;10175;4494;13743
292130;201601;2860;7853;2466;7307;476;1276;1433;4495;1909;5771
292140;201601;4895;12835;4076;11689;767;2017;2601;7723;3368;9740
292145;201601;2366;7282;2116;6859;294;923;1370;4651;1664;5574
292150;201601;12664;38780;11684;37224;613;2265;9294;29706;9907;31971
292160;201601;2414;7046;2068;6595;98;410;1798;5669;1896;6079
292170;201601;8603;24574;7133;22072;890;3050;4446;13723;5336;16773
292180;201601;2914;8544;2324;7521;382;1182;1302;4371;1684;5553
292190;201601;3265;9309;2752;8537;552;1791;1472;4651;2024;6442
292200;201601;6581;20325;5642;18709;1636;5832;1903;6367;3539;12199
292205;201601;3773;11436;3400;10903;161;700;2684;8414;2845;9114
292210;201601;6359;17176;5306;15796;310;1144;4333;12827;4643;13971
292220;201601;1855;5098;1663;4816;513;1395;727;2159;1240;3554
292225;201601;3103;9670;2830;9262;159;672;2299;7471;2458;8143
292230;201601;6463;18834;6095;18250;338;1429;4726;13599;5064;15028
292240;201601;4752;14309;4283;13383;481;1586;2909;9046;3390;10632
292250;201601;4938;15255;4594;14659;1123;3690;2027;6567;3150;10257
292260;201601;3088;9179;2885;8911;191;597;2390;7440;2581;8037
292265;201601;3126;9477;2696;8763;123;550;2026;6434;2149;6984
292270;201601;4000;10176;3224;9269;164;548;2678;7734;2842;8282
292273;201601;2720;6301;2086;5522;206;491;1524;4262;1730;4753
292275;201601;1511;4194;1337;3944;164;505;967;2911;1131;3416
292280;201601;2047;5898;1788;5605;166;481;1337;4478;1503;4959
292285;201601;2456;6661;2033;6056;113;410;1565;4624;1678;5034
292290;201601;6930;20811;5776;19271;409;1601;4348;14678;4757;16279
292300;201601;7911;23831;6912;22612;1725;5942;3693;12422;5418;18364
292303;201601;2804;8532;2545;8190;100;415;2164;6844;2264;7259
292305;201601;2867;7755;2703;7524;61;246;2447;6715;2508;6961
292310;201601;5760;17146;5337;16504;173;626;4400;13561;4573;14187
292320;201601;6519;18412;5533;16787;426;1359;4176;12650;4602;14009
292330;201601;2150;5783;1976;5553;159;535;1573;4353;1732;4888
292335;201601;4986;13192;4458;12505;461;1214;3502;10032;3963;11246
292340;201601;6165;17623;5280;16177;510;1558;3659;11314;4169;12872
292350;201601;2247;6619;1956;6206;142;546;1544;4876;1686;5422
292360;201601;5178;13597;4918;13144;207;399;4088;11457;4295;11856
292370;201601;7891;23164;7143;22175;660;1840;5543;17571;6203;19411
292380;201601;7158;21204;6531;20211;556;1586;5065;15913;5621;17499
292390;201601;3358;7700;2848;7149;79;181;2582;6567;2661;6748
292400;201601;20241;61632;19061;59827;2371;7507;13728;43369;16099;50876
292405;201601;4417;11069;3552;9957;193;478;2822;8032;3015;8510
292410;201601;1932;5191;1793;5036;134;366;1495;4203;1629;4569
292420;201601;3734;12068;3538;11791;229;875;2913;9724;3142;10599
292430;201601;5494;16243;4179;14395;320;1257;2830;9797;3150;11054
292440;201601;8267;27525;7668;26639;213;919;6824;23900;7037;24819
292450;201601;3935;11793;3242;10646;344;1136;2225;7416;2569;8552
292460;201601;4940;14878;4278;13773;559;1927;2780;8956;3339;10883
292465;201601;2365;7026;1998;6437;202;729;1259;4129;1461;4858
292467;201601;1820;5883;1739;5760;296;1047;1128;3817;1424;4864
292470;201601;2856;7644;2358;6811;102;353;1839;5256;1941;5609
292480;201601;5966;16071;5138;14988;152;572;4593;13334;4745;13906
292490;201601;2366;6451;1951;5855;141;440;1470;4401;1611;4841
292500;201601;6425;19103;5505;17504;662;2158;3548;11468;4210;13626
292510;201601;12513;35580;10845;33201;768;2787;8274;25507;9042;28294
292520;201601;5434;15503;4749;14518;1132;3480;2380;7451;3512;10931
292525;201601;5162;13560;4409;12676;179;594;3702;10644;3881;11238
292530;201601;26262;74950;22985;70544;6155;19551;9901;31627;16056;51178
292540;201601;2779;7704;2456;7316;268;913;1862;5483;2130;6396
292550;201601;6303;19501;5493;18454;642;2292;4064;14015;4706;16307
292560;201601;3937;11017;3434;10265;181;701;2613;7699;2794;8400
292570;201601;4015;11610;3719;11301;66;152;3509;10928;3575;11080
292575;201601;6100;20322;5907;20028;656;2314;4633;15815;5289;18129
292580;201601;6671;19757;6268;19210;349;1162;5270;16166;5619;17328
292590;201601;7122;21330;6623;20616;480;1499;5410;16772;5890;18271
292593;201601;2953;7671;2452;6899;324;848;1679;4731;2003;5579
292595;201601;5686;15830;5026;14997;388;1240;3857;11580;4245;12820
292600;201601;10478;29644;9422;28296;902;2200;7210;22514;8112;24714
292610;201601;4539;12750;3718;11424;304;948;2241;7230;2545;8178
292620;201601;5996;17662;5263;16816;116;399;4855;15657;4971;16056
292630;201601;9168;23178;7610;20802;847;2256;5131;14329;5978;16585
292640;201601;7680;24964;7130;24120;431;1661;5403;18489;5834;20150
292650;201601;4709;12552;4407;12164;375;876;3658;10234;4033;11110
292660;201601;10574;31753;9710;30516;1050;3379;7186;22937;8236;26316
292665;201601;2421;7472;2309;7324;44;130;2128;6811;2172;6941
292670;201601;3654;10313;2860;8908;186;639;1800;5608;1986;6247
292680;201601;3561;10686;3234;10149;443;1280;2241;7114;2684;8394
292690;201601;2823;7711;2071;6517;171;544;1393;4529;1564;5073
292700;201601;9160;27237;8076;25641;1186;3511;5112;17102;6298;20613
292710;201601;2062;6748;1944;6591;65;264;1718;5824;1783;6088
292720;201601;9058;23185;7816;21809;331;1090;6639;18729;6970;19819
292730;201601;3567;10640;3429;10443;275;873;2675;8172;2950;9045
292740;201601;318650;852941;298870;824082;52851;154354;181699;496534;234550;650888
292750;201601;6398;17142;5509;15947;296;970;4401;12772;4697;13742
292760;201601;3913;12307;3535;11636;405;1417;2354;7799;2759;9216
292770;201601;5809;17021;5124;16065;916;3016;3008;9745;3924;12761
292780;201601;1860;4400;1418;3833;117;411;995;2602;1112;3013
292790;201601;3230;7924;3101;7789;80;145;2949;7499;3029;7644
292800;201601;8908;26370;8209;25218;487;1665;6546;19998;7033;21663
292805;201601;2875;8138;2532;7665;300;980;1830;5527;2130;6507
292810;201601;9253;27708;7742;25601;945;3207;5262;17855;6207;21062
292820;201601;7104;20582;5461;18199;310;1321;4233;14089;4543;15410
292830;201601;1727;5023;1561;4794;73;310;1351;4093;1424;4403
292840;201601;7638;23414;7175;22796;323;1320;6279;19611;6602;20931
292850;201601;3101;8254;2525;7373;330;1012;1534;4378;1864;5390
292860;201601;14669;38203;13456;36640;1130;3225;10327;28014;11457;31239
292870;201601;18857;51521;16506;47917;2054;6587;9530;27248;11584;33835
292880;201601;12307;34874;10943;32996;1055;3565;7665;22709;8720;26274
292890;201601;5201;17578;4723;16722;649;2441;3017;10850;3666;13291
292895;201601;2730;6655;2145;5778;260;646;1455;3993;1715;4639
292900;201601;2713;8400;2583;8204;166;742;1910;5788;2076;6530
292905;201601;3937;11696;3226;10595;235;858;2278;7495;2513;8353
292910;201601;4884;14545;4429;13736;598;1942;2596;8083;3194;10025
292920;201601;8954;26250;8516;25619;532;1946;6976;20412;7508;22358
292925;201601;4997;15288;4512;14591;400;1313;3412;11094;3812;12407
292930;201601;6354;20394;6010;19800;448;1960;4283;13711;4731;15671
292935;201601;1985;5792;1674;5454;86;328;1412;4742;1498;5070
292937;201601;3169;8088;2632;7427;214;651;2046;5775;2260;6426
292940;201601;3232;8827;2577;7962;281;869;1706;5511;1987;6380
292950;201601;7878;23034;7325;22126;521;1913;5334;15702;5855;17615
292960;201601;5143;13260;4426;12302;301;887;3239;8964;3540;9851
292970;201601;4191;12558;3702;11910;145;668;3020;9657;3165;10325
292975;201601;3437;9171;3213;8892;346;883;2693;7569;3039;8452
292980;201601;3241;8697;2537;7708;216;768;1793;5430;2009;6198
292990;201601;11673;33559;10211;31366;411;1486;8278;25353;8689;26839
293000;201601;2746;7146;2519;6879;56;174;2009;5847;2065;6021
293010;201601;17603;48833;14996;44730;2388;7569;8510;25211;10898;32780
293015;201601;7351;25138;6546;23566;744;3050;4215;15099;4959;18149
293020;201601;8854;29731;8343;29015;314;1442;7184;24853;7498;26295
293030;201601;5426;15585;4363;13935;249;837;3061;10174;3310;11011
293040;201601;3640;12026;3478;11724;179;604;3042;10300;3221;10904
293050;201601;19786;54605;17465;51687;3246;9785;9189;28739;12435;38524
293060;201601;3691;9781;3040;8735;244;752;2167;6144;2411;6896
293070;201601;21419;60906;18595;56749;4433;13655;8586;27302;13019;40957
293075;201601;3170;10881;2926;10509;220;941;2255;8129;2475;9070
293076;201601;3693;10183;3324;9695;187;506;2756;8250;2943;8756
293077;201601;4730;14938;4284;14316;970;3391;2352;8137;3322;11528
293080;201601;4507;14259;4131;13661;215;1000;3376;10967;3591;11967
293090;201601;3243;10397;2697;9569;283;1070;1902;6870;2185;7940
293100;201601;5725;16876;4760;15174;455;1533;3368;10850;3823;12383
293105;201601;3928;12901;3437;11949;536;1831;2126;7587;2662;9418
293110;201601;1996;5696;1766;5364;64;218;1444;4406;1508;4624
293120;201601;3649;12117;3486;11865;331;1027;2680;9374;3011;10401
293130;201601;3994;11283;3443;10680;144;527;3007;9498;3151;10025
293135;201601;30837;77745;23512;67542;4757;15411;9002;25864;13759;41275
293140;201601;1941;5524;1849;5396;134;501;1485;4201;1619;4702
293150;201601;5379;17804;4620;16340;753;2724;2743;9992;3496;12716
293160;201601;3703;9488;3390;9129;566;1128;2433;7112;2999;8240
293170;201601;3257;9677;2981;9294;288;1062;2086;6528;2374;7590
293180;201601;5112;14438;4090;12790;156;661;3136;9602;3292;10263
293190;201601;13623;41101;12541;39500;431;2040;10732;33176;11163;35216
293200;201601;7018;19299;6139;18219;183;700;4823;14413;5006;15113
293210;201601;4945;14285;4378;13324;291;961;3275;9955;3566;10916
293220;201601;4906;14476;4220;13283;1137;3623;1480;4830;2617;8453
293230;201601;3674;11301;3323;10760;477;1695;2216;7172;2693;8867
293240;201601;4337;11906;3494;10513;141;464;2554;7706;2695;8170
293245;201601;4135;11880;3779;11368;283;822;2899;8824;3182;9646
293250;201601;5570;15422;5014;14610;505;1541;3525;10244;4030;11785
293260;201601;4410;13256;3775;12328;258;897;2824;9332;3082;10229
293270;201601;5382;14421;4927;13932;411;1002;4179;12073;4590;13075
293280;201601;5158;14568;4385;13550;224;687;3429;10778;3653;11465
293290;201601;14371;47758;13408;45945;3248;11500;5940;20964;9188;32464
293300;201601;6807;16021;5693;14735;339;806;4407;11630;4746;12436
293305;201601;4799;11873;4038;10871;144;443;3373;9051;3517;9494
293310;201601;2483;6503;2025;5730;179;488;1363;3865;1542;4353
293315;201601;4142;10609;3535;9704;389;1010;2532;7070;2921;8080
293317;201601;2422;6993;2192;6581;218;638;1452;4437;1670;5075
293320;201601;7669;25475;7465;25216;802;2868;5819;19763;6621;22631
293325;201601;1775;5063;1456;4584;196;666;943;2972;1139;3638
293330;201601;50117;159736;45238;151360;9908;35306;20875;70760;30783;106066
293340;201601;2615;7435;2051;6475;291;967;1099;3491;1390;4458
293345;201601;3241;9601;2833;9058;245;671;2169;7269;2414;7940
293350;201601;6365;18524;6001;18102;263;602;5371;16730;5634;17332
293360;201601;12627;38913;11452;37435;1069;3970;9446;30761;10515;34731
310010;201601;904;2456;712;2162;107;409;321;908;428;1317
310020;201601;2887;9070;2401;8137;537;1977;310;984;847;2961
310030;201601;2274;7072;1875;6394;411;1564;966;3237;1377;4801
310040;201601;950;2525;795;2317;59;206;614;1756;673;1962
310050;201601;1833;6284;1666;5916;348;1384;672;2313;1020;3697
310060;201601;3148;9948;2732;9411;367;1363;1967;6803;2334;8166
310070;201601;322;906;249;771;21;92;152;433;173;525
310080;201601;697;2110;575;1899;108;449;202;623;310;1072
310090;201601;4473;13380;3869;12325;481;1706;2436;7697;2917;9403
310100;201601;3331;10117;2802;9243;195;797;2098;6869;2293;7666
310110;201601;4628;13101;3993;12078;678;2305;2125;6221;2803;8526
310120;201601;586;1800;461;1544;121;512;175;466;296;978
310130;201601;396;1199;360;1146;89;332;179;519;268;851
310140;201601;199;650;163;595;51;230;41;120;92;350
310150;201601;4592;14063;3997;12954;961;3405;1445;4589;2406;7994
310160;201601;7100;22314;5897;20120;1698;6279;1044;3469;2742;9748
310163;201601;991;3177;836;2870;241;869;212;716;453;1585
310170;201601;8884;25044;7924;23711;1169;3708;5107;15567;6276;19275
310180;201601;1550;4507;1330;4167;292;1004;614;1857;906;2861
310190;201601;2764;9109;2462;8562;680;2585;379;1294;1059;3879
310200;201601;1795;5837;1525;5294;325;1260;513;1770;838;3030
310205;201601;1079;3115;833;2740;147;490;442;1494;589;1984
310210;201601;2642;7715;2377;7326;198;658;1850;5733;2048;6391
310220;201601;1017;3081;906;2901;175;618;528;1652;703;2270
310230;201601;2449;7622;2079;6828;359;1397;1031;3175;1390;4572
310240;201601;885;3227;806;3064;119;500;437;1718;556;2218
310250;201601;798;2644;771;2599;149;615;444;1379;593;1994
310260;201601;3115;9842;2437;8497;568;2238;554;1745;1122;3983
310270;201601;2473;7077;2062;6493;175;670;1577;4925;1752;5595
310280;201601;2255;5974;1855;5374;210;777;1042;2874;1252;3651
310285;201601;2013;7202;1867;6984;222;991;1378;5188;1600;6179
310290;201601;1117;3381;1057;3289;256;894;518;1453;774;2347
310300;201601;1656;5585;1573;5441;431;1696;761;2520;1192;4216
310310;201601;355;972;260;801;34;100;120;381;154;481
310320;201601;380;1196;315;1076;41;194;149;484;190;678
310330;201601;502;1265;339;963;32;106;138;341;170;447
310340;201601;8189;24617;6751;22157;1309;4408;3307;11338;4616;15746
310350;201601;13382;35395;9792;29549;2334;7857;2453;7190;4787;15047
310360;201601;428;1270;399;1230;28;122;284;823;312;945
310370;201601;1379;4584;1253;4365;361;1264;596;2120;957;3384
310375;201601;1189;3201;772;2439;107;395;280;861;387;1256
310380;201601;359;941;243;768;82;284;78;218;160;502
310390;201601;445;1564;386;1451;82;338;68;221;150;559
310400;201601;9857;27341;7519;23447;1723;5878;1743;5522;3466;11400
310410;201601;717;2390;501;2010;105;459;89;359;194;818
310420;201601;5424;15207;3612;11467;616;2163;516;1427;1132;3590
310430;201601;1300;4239;1007;3667;248;997;138;471;386;1468
310440;201601;541;1562;415;1331;72;274;165;508;237;782
310445;201601;1193;3920;1002;3564;133;506;630;2236;763;2742
310450;201601;4420;12570;3613;11413;413;1374;2404;7721;2817;9095
310460;201601;1492;4467;1242;4087;354;1290;259;928;613;2218
310470;201601;3569;8774;3017;8107;273;653;2473;6808;2746;7461
310480;201601;1218;3556;906;2941;187;632;346;1065;533;1697
310490;201601;2793;9126;2433;8437;607;2468;922;3058;1529;5526
310500;201601;1220;4123;1092;3865;248;974;408;1392;656;2366
310510;201601;1997;6260;1577;5352;374;1360;241;815;615;2175
310520;201601;1361;3533;1041;3042;77;220;700;2058;777;2278
310530;201601;983;2935;528;1805;63;242;59;171;122;413
310540;201601;2862;9328;2573;8814;634;2263;1084;3747;1718;6010
310550;201601;1184;3343;955;2987;201;756;459;1328;660;2084
310560;201601;14925;45454;12742;41311;3361;12153;3648;11071;7009;23224
310570;201601;1125;3401;959;3120;154;589;616;1966;770;2555
310590;201601;4160;12097;3387;10671;608;2031;1342;4122;1950;6153
310600;201601;1352;4449;1217;4181;287;1132;447;1420;734;2552
310610;201601;455;1550;398;1424;81;359;104;333;185;692
310620;201601;135506;416376;116988;382184;27048;98704;42611;130123;69659;228827
310630;201601;3935;11911;3633;11425;363;1310;2634;8181;2997;9491
310640;201601;1247;3769;1009;3368;299;1094;246;761;545;1855
310650;201601;2620;8297;2094;7385;336;1254;1157;4099;1493;5353
310660;201601;1301;3952;1151;3756;124;415;824;2676;948;3091
310665;201601;1231;3741;1109;3574;103;362;853;2808;956;3170
310670;201601;38291;117627;34204;109300;8937;30176;11627;36470;20564;66646
310680;201601;642;1872;588;1798;102;342;365;1094;467;1436
310690;201601;1383;4450;1126;4012;245;1030;376;1250;621;2280
310700;201601;520;1283;404;1135;77;258;239;648;316;906
310710;201601;6133;20077;4803;17876;969;4242;646;2184;1615;6426
310720;201601;752;2265;686;2150;98;359;418;1274;516;1633
310730;201601;9139;28359;8181;26793;1531;5415;4536;14826;6067;20241
310740;201601;4786;15172;3830;13340;918;3484;787;2613;1705;6097
310750;201601;1455;3617;1104;3148;210;631;536;1449;746;2080
310760;201601;597;1806;508;1663;94;334;189;621;283;955
310770;201601;862;2704;662;2398;153;628;257;868;410;1496
310780;201601;3618;10076;3075;9122;477;1412;1842;5485;2319;6897
310790;201601;1893;6071;1721;5766;431;1509;750;2634;1181;4143
310800;201601;2742;8662;2113;7456;617;2504;162;522;779;3026
310810;201601;1114;3143;990;2919;175;575;534;1489;709;2064
310820;201601;1271;3654;913;2979;214;752;215;713;429;1465
310825;201601;2468;8339;1944;7420;127;673;1394;5268;1521;5941
310830;201601;1295;4207;1040;3720;294;1123;258;877;552;2000
310840;201601;2073;6333;1614;5545;336;1242;404;1325;740;2567
310850;201601;1487;4438;1261;4143;177;624;864;2853;1041;3477
310855;201601;2829;8939;2431;8327;403;1486;1528;5300;1931;6786
310860;201601;7311;22457;6160;20393;810;2888;3538;11899;4348;14787
310870;201601;998;2767;777;2401;142;474;397;1231;539;1705
310880;201601;1032;3241;862;2935;158;620;418;1404;576;2024
310890;201601;2496;7590;1942;6643;457;1769;389;1204;846;2973
310900;201601;3839;12136;3032;10479;679;2593;883;2852;1562;5445
310910;201601;1882;5306;1269;4129;221;828;150;393;371;1221
310920;201601;1837;5415;1456;4833;335;1264;600;1962;935;3226
310925;201601;883;2918;805;2782;314;1194;272;902;586;2096
310930;201601;5961;16813;4782;15095;837;2830;2614;8527;3451;11357
310940;201601;6045;17055;5051;15543;862;2711;2651;8142;3513;10853
310945;201601;1102;3258;975;3080;125;463;597;1826;722;2289
310950;201601;1958;6235;1465;5172;393;1598;341;1082;734;2680
310960;201601;373;1216;305;1088;89;362;100;352;189;714
310970;201601;1398;4640;1030;3781;244;1008;121;375;365;1383
310980;201601;426;1046;263;773;36;124;120;313;156;437
310990;201601;1117;3649;919;3235;209;831;246;805;455;1636
311000;201601;3440;11682;3136;11104;856;3407;1039;3430;1895;6837
311010;201601;694;2354;642;2260;215;807;279;979;494;1786
311020;201601;869;2577;693;2272;143;536;288;886;431;1422
311030;201601;1560;4244;1103;3439;276;986;337;950;613;1936
311040;201601;457;1531;391;1374;85;301;89;291;174;592
311050;201601;2020;6331;1801;5990;490;1811;756;2503;1246;4314
311060;201601;2268;6695;1715;5557;325;1183;458;1369;783;2552
311070;201601;1347;4650;1191;4348;263;1092;475;1709;738;2801
311080;201601;789;2435;683;2233;141;502;286;876;427;1378
311090;201601;1527;5709;1323;5299;393;1735;270;1057;663;2792
311100;201601;2013;6744;1645;5963;562;2207;225;809;787;3016
311110;201601;3375;8146;2452;6844;379;1141;1220;3413;1599;4554
311115;201601;1182;3461;989;3177;103;433;648;2026;751;2459
311120;201601;7725;21698;6014;18730;1398;4873;1519;4384;2917;9257
311130;201601;1852;5858;1563;5443;315;1339;650;2109;965;3448
311140;201601;1249;3357;1032;3074;92;323;707;2071;799;2394
311150;201601;1706;5891;1568;5670;267;1072;955;3453;1222;4525
311160;201601;3953;13235;3255;11976;1130;4552;723;2651;1853;7203
311170;201601;772;2310;613;2030;62;225;288;990;350;1215
311180;201601;1151;3313;903;2846;266;907;202;598;468;1505
311190;201601;1096;3090;809;2534;159;569;195;537;354;1106
311200;201601;1977;6035;1609;5275;427;1542;272;801;699;2343
311205;201601;979;3256;837;2966;118;477;373;1339;491;1816
311210;201601;917;2966;846;2872;156;521;562;1984;718;2505
311220;201601;855;2682;699;2357;157;572;219;713;376;1285
311230;201601;8101;25456;6440;22130;1255;4606;2209;7885;3464;12491
311240;201601;1004;3031;787;2681;193;721;195;652;388;1373
311250;201601;741;2422;663;2301;196;768;203;615;399;1383
311260;201601;2367;6333;1776;5374;441;1476;550;1655;991;3131
311265;201601;1205;3390;953;2975;179;606;483;1518;662;2124
311270;201601;3239;10355;2830;9788;319;1500;1896;6274;2215;7774
311280;201601;1221;3401;795;2528;157;578;189;568;346;1146
311290;201601;1947;6554;1831;6300;391;1344;1016;3560;1407;4904
311300;201601;4208;14141;3773;13353;453;1904;2563;9000;3016;10904
311310;201601;558;1884;505;1791;93;383;181;587;274;970
311320;201601;3714;12371;3358;11608;638;2493;1161;3782;1799;6275
311330;201601;4496;13516;3891;12494;1028;3666;1585;5104;2613;8770
311340;201601;11552;36456;10126;33763;3012;10740;2631;8690;5643;19430
311350;201601;2239;6354;1750;5447;286;1047;766;2166;1052;3213
311360;201601;1091;3017;845;2708;339;1124;131;452;470;1576
311370;201601;3619;10901;3048;9901;643;2476;1231;3690;1874;6166
311380;201601;394;1304;346;1216;94;360;111;383;205;743
311390;201601;1719;6279;1581;6083;669;2942;445;1595;1114;4537
311400;201601;1381;4379;1154;3951;209;848;464;1442;673;2290
311410;201601;1741;5931;1563;5701;420;1715;748;2776;1168;4491
311420;201601;1838;5930;1270;4547;233;915;154;412;387;1327
311430;201601;3732;11207;2606;8766;468;1711;252;836;720;2547
311440;201601;2347;7469;1747;6391;531;2259;260;939;791;3198
311450;201601;1895;6539;1600;5899;427;1743;305;1042;732;2785
311455;201601;1110;2970;881;2596;214;671;381;1053;595;1724
311460;201601;609;1982;463;1681;97;415;108;363;205;778
311470;201601;481;1589;385;1386;101;433;86;260;187;693
311480;201601;758;2009;707;1941;176;475;418;1143;594;1618
311490;201601;220;809;197;743;58;237;63;221;121;458
311500;201601;411;1196;325;1036;80;297;123;382;203;679
311510;201601;2866;8816;2344;7879;690;2745;487;1547;1177;4292
311520;201601;600;1971;556;1881;175;642;211;681;386;1323
311530;201601;11380;29240;8191;24135;1827;6454;2186;6190;4013;12644
311535;201601;780;2268;514;1747;119;464;69;219;188;683
311540;201601;601;2091;561;2026;212;752;218;788;430;1540
311545;201601;2047;6253;1824;5981;184;691;1290;4178;1474;4869
311547;201601;1457;4114;1220;3744;93;312;809;2480;902;2792
311550;201601;2833;8993;2385;8122;417;1617;823;2744;1240;4361
311560;201601;254;662;216;621;26;76;118;320;144;396
311570;201601;2001;5067;1577;4497;124;391;1149;3356;1273;3747
311580;201601;2287;4657;1728;4011;479;1018;885;2222;1364;3240
311590;201601;438;1334;377;1242;96;370;141;459;237;829
311600;201601;1166;3569;996;3350;181;599;605;2095;786;2694
311610;201601;2880;10169;2593;9695;857;3127;989;3989;1846;7116
311615;201601;3003;9306;2515;8541;255;1009;1725;5854;1980;6863
311620;201601;399;1249;357;1172;67;246;198;647;265;893
311630;201601;1347;3931;1120;3552;247;750;619;1977;866;2727
311640;201601;764;2441;632;2225;126;489;309;1070;435;1559
311650;201601;2208;6368;1874;5842;289;981;973;3045;1262;4026
311660;201601;2271;7527;1771;6383;320;1207;152;459;472;1666
311670;201601;1611;4685;1316;4186;424;1472;381;1206;805;2678
311680;201601;2013;6339;1706;5830;379;1355;881;3033;1260;4388
311690;201601;477;1253;411;1173;35;105;326;948;361;1053
311700;201601;2135;5793;1763;5289;141;470;1319;3900;1460;4370
311710;201601;1612;4881;1195;4105;419;1598;277;911;696;2509
311720;201601;389;1290;349;1211;70;258;150;516;220;774
311730;201601;5651;14145;3282;10099;888;3152;642;1586;1530;4738
311740;201601;767;2315;727;2263;252;761;393;1264;645;2025
311750;201601;3855;12612;3357;11846;625;2507;1727;5989;2352;8496
311760;201601;691;2299;615;2133;137;561;182;539;319;1100
311770;201601;2157;6854;1778;6154;415;1593;511;1708;926;3301
311780;201601;1086;3842;922;3484;263;1156;205;698;468;1854
311783;201601;1905;6290;1611;5720;94;478;1182;4145;1276;4623
311787;201601;569;1953;418;1509;78;307;92;277;170;584
311790;201601;1459;4283;1078;3569;221;828;341;1085;562;1913
311800;201601;4372;14663;3767;13176;753;2841;242;687;995;3528
311810;201601;1047;3401;920;3161;69;323;588;1991;657;2314
311820;201601;578;1817;473;1578;120;441;219;683;339;1124
311830;201601;7966;26545;6602;23307;2026;7781;692;2230;2718;10011
311840;201601;2893;8727;2589;8281;690;2464;1186;3722;1876;6186
311850;201601;262;798;232;753;55;198;102;315;157;513
311860;201601;45920;135807;39410;124467;8110;28040;18321;56200;26431;84240
311870;201601;2059;6042;1535;5055;313;1162;447;1373;760;2535
311880;201601;6655;19118;5906;18195;756;2166;4130;13298;4886;15464
311890;201601;1421;4212;1146;3711;287;1010;445;1416;732;2426
311900;201601;718;2182;631;2056;87;312;368;1223;455;1535
311910;201601;4153;12232;3406;11123;795;2817;1419;4652;2214;7469
311920;201601;1853;6102;1629;5689;210;812;968;3373;1178;4185
311930;201601;3410;9719;2889;8919;1092;3524;748;2299;1840;5823
311940;201601;11959;35813;9738;31402;2402;8430;1928;5830;4330;14260
311950;201601;2151;6346;1800;5840;151;550;1254;4045;1405;4595
311960;201601;362;1146;324;1066;72;274;122;339;194;613
311970;201601;337;1171;284;1058;51;218;70;253;121;471
311980;201601;600;1673;405;1321;62;209;139;474;201;683
311990;201601;403;1181;336;1077;120;423;110;329;230;752
311995;201601;1155;3517;723;2487;46;167;67;177;113;344
312000;201601;584;1770;523;1677;64;223;323;1056;387;1279
312010;201601;867;2822;735;2541;127;480;283;964;410;1444
312015;201601;1330;4295;1194;4047;132;538;768;2573;900;3111
312020;201601;964;3035;847;2849;166;603;402;1361;568;1964
312030;201601;1707;5079;1532;4861;107;408;1274;4008;1381;4416
312040;201601;712;2614;613;2360;154;667;128;470;282;1137
312050;201601;1228;4296;1049;3875;243;1003;144;461;387;1464
312060;201601;738;2237;642;2096;231;804;235;727;466;1531
312070;201601;991;3048;665;2347;147;561;221;784;368;1345
312080;201601;2537;7076;2037;6315;291;1077;1073;3115;1364;4192
312083;201601;866;2496;754;2326;96;326;524;1598;620;1924
312087;201601;2077;6423;1869;6125;228;814;1308;4351;1536;5165
312090;201601;8533;26473;7391;24569;2172;7610;2600;8524;4772;16134
312100;201601;1317;4457;1110;4138;252;1072;470;1727;722;2799
312110;201601;1014;3540;889;3276;271;1146;145;460;416;1606
312120;201601;697;2262;586;2039;128;536;196;591;324;1127
312125;201601;1078;3477;960;3259;220;742;491;1756;711;2498
312130;201601;833;2373;652;2030;92;327;230;681;322;1008
312140;201601;796;2551;698;2325;147;536;194;566;341;1102
312150;201601;495;1441;433;1308;22;81;282;812;304;893
312160;201601;7122;24073;6344;22492;1683;6533;2224;7752;3907;14285
312170;201601;899;2597;763;2366;68;237;475;1453;543;1690
312180;201601;1325;4068;1155;3742;258;902;430;1313;688;2215
312190;201601;566;1829;437;1577;140;562;73;266;213;828
312200;201601;4618;13320;3890;12179;660;2038;2187;6912;2847;8950
312210;201601;1011;2733;776;2393;217;729;302;879;519;1608
312220;201601;1862;6234;1719;6075;187;597;1401;5193;1588;5790
312230;201601;11962;36611;9374;31774;2989;11225;1202;3962;4191;15187
312235;201601;1494;4530;1318;4267;162;630;899;2871;1061;3501
312240;201601;888;2969;715;2606;170;661;183;657;353;1318
312245;201601;2087;6285;1883;6013;106;377;1523;4859;1629;5236
312247;201601;774;2331;602;2033;164;598;245;848;409;1446
312250;201601;1146;3161;877;2711;156;547;337;985;493;1532
312260;201601;873;2763;726;2516;131;526;428;1439;559;1965
312270;201601;636;1915;540;1740;70;297;243;712;313;1009
312280;201601;396;1324;353;1231;117;439;43;143;160;582
312290;201601;732;2403;672;2317;180;724;214;722;394;1446
312300;201601;843;2801;673;2406;156;607;61;168;217;775
312310;201601;833;3117;779;3005;222;946;280;1054;502;2000
312320;201601;1845;5323;1401;4447;296;994;165;417;461;1411
312330;201601;957;2811;804;2595;133;516;560;1783;693;2299
312340;201601;304;815;263;750;36;139;177;455;213;594
312350;201601;280;718;248;682;27;86;200;534;227;620
312352;201601;1565;4971;1406;4738;307;1087;880;3040;1187;4127
312360;201601;2939;9374;2461;8428;510;1937;712;2427;1222;4364
312370;201601;1645;5214;1498;4979;494;1842;483;1511;977;3353
312380;201601;1816;5087;1608;4806;73;216;1341;4119;1414;4335
312385;201601;1270;3762;1094;3481;100;405;758;2343;858;2748
312390;201601;2092;6717;1711;5989;439;1651;283;900;722;2551
312400;201601;3076;9827;2590;8892;950;3363;645;2324;1595;5687
312410;201601;9172;30177;8189;28332;1827;6875;3328;11329;5155;18204
312420;201601;3743;11522;3545;11273;539;1719;2428;7877;2967;9596
312430;201601;7706;22959;6641;21056;1152;3690;3909;12553;5061;16243
312440;201601;697;2192;609;2045;168;625;279;972;447;1597
312450;201601;1064;3512;824;3019;263;1005;228;877;491;1882
312460;201601;342;1026;304;982;83;304;142;455;225;759
312470;201601;643;1755;418;1321;77;273;126;385;203;658
312480;201601;1165;3070;887;2765;205;703;458;1358;663;2061
312490;201601;1928;5085;1513;4476;215;718;843;2403;1058;3121
312500;201601;650;1960;572;1844;100;375;203;626;303;1001
312510;201601;3222;9350;2592;8084;409;1467;1193;3468;1602;4935
312520;201601;246;837;198;753;52;214;55;219;107;433
312530;201601;578;1720;517;1637;70;285;325;993;395;1278
312540;201601;1415;4445;1100;3839;222;832;510;1782;732;2614
312550;201601;658;2027;571;1841;116;386;255;777;371;1163
312560;201601;1979;5270;1637;4834;94;340;1317;3843;1411;4183
312570;201601;2316;6862;1941;6234;554;1915;549;1728;1103;3643
312580;201601;509;1682;430;1513;72;308;150;499;222;807
312590;201601;1625;5433;1415;5005;252;1100;599;1948;851;3048
312595;201601;1878;6314;1685;5868;345;1267;880;3061;1225;4328
312600;201601;759;2479;588;2141;94;436;268;907;362;1343
312610;201601;6807;19045;5016;15846;1094;3864;1068;3199;2162;7063
312620;201601;2126;6176;1648;5526;162;618;1179;4097;1341;4715
312630;201601;330;1081;286;1001;76;301;102;332;178;633
312640;201601;527;1718;430;1517;84;321;125;416;209;737
312650;201601;2078;6146;1563;5118;148;546;894;2935;1042;3481
312660;201601;1317;3553;1091;3219;109;381;730;2106;839;2487
312670;201601;5480;16324;4671;15223;1283;4601;1601;5095;2884;9696
312675;201601;1211;3937;1031;3544;127;507;615;2097;742;2604
312680;201601;1436;4341;1221;4054;196;762;713;2277;909;3039
312690;201601;2074;5568;1693;5032;255;819;1036;2981;1291;3800
312695;201601;788;2826;759;2787;160;569;477;1846;637;2415
312700;201601;1800;5429;1436;4715;192;715;691;2224;883;2939
312705;201601;1223;3514;1040;3191;87;296;734;2216;821;2512
312707;201601;1526;4869;1208;4255;164;680;604;2064;768;2744
312710;201601;6629;16773;4357;13137;1140;3891;746;2162;1886;6053
312720;201601;732;2516;638;2322;146;587;226;788;372;1375
312730;201601;1842;4379;1268;3696;161;510;703;2065;864;2575
312733;201601;1622;4304;1238;3617;62;215;764;2156;826;2371
312735;201601;792;2193;688;2056;159;534;381;1085;540;1619
312737;201601;805;2039;592;1746;188;553;201;621;389;1174
312738;201601;496;1497;367;1243;87;339;111;332;198;671
312740;201601;363;929;225;770;70;273;50;161;120;434
312750;201601;1213;4314;1159;4222;232;1025;548;1913;780;2938
312760;201601;1930;6202;1517;5368;357;1387;325;1137;682;2524
312770;201601;39124;107644;30628;93680;7755;25693;7943;23623;15698;49316
312780;201601;2564;8948;2293;8499;415;1699;1172;4451;1587;6150
312790;201601;309;781;183;566;34;130;47;106;81;236
312800;201601;4819;15666;3947;13945;1184;4532;930;3295;2114;7827
312810;201601;2020;6173;1410;4973;315;1193;227;746;542;1939
312820;201601;1808;5231;1609;4916;92;332;1106;3296;1198;3628
312825;201601;1295;3570;1130;3354;104;347;851;2521;955;2868
312830;201601;2499;7665;1776;6240;425;1632;252;870;677;2502
312840;201601;1183;3838;1004;3495;153;659;389;1269;542;1928
312850;201601;658;2063;528;1817;88;359;162;558;250;917
312860;201601;1070;3139;830;2719;218;783;201;592;419;1375
312870;201601;5462;16875;3894;13600;724;2807;752;2513;1476;5320
312880;201601;1220;3664;1081;3453;139;486;653;2145;792;2631
312890;201601;1543;4669;1023;3508;250;940;314;1089;564;2029
312900;201601;1173;3446;1036;3257;136;448;722;2334;858;2782
312910;201601;1551;3128;951;2354;149;416;455;1038;604;1454
312920;201601;828;2639;689;2390;188;749;250;805;438;1554
312930;201601;2088;6034;1823;5644;402;1294;861;2731;1263;4025
312940;201601;870;2841;759;2660;194;766;205;669;399;1435
312950;201601;3031;8507;2353;7498;775;2674;549;1754;1324;4428
312960;201601;1881;5450;1640;5149;224;658;1224;3982;1448;4640
312965;201601;1746;5563;1491;5109;193;782;888;3036;1081;3818
312970;201601;948;3185;791;2909;219;915;150;532;369;1447
312980;201601;16060;53838;15144;52018;4714;17703;5465;18196;10179;35899
312990;201601;446;1323;326;1119;98;382;93;324;191;706
313000;201601;493;1626;403;1450;98;457;155;479;253;936
313005;201601;2513;8113;2241;7602;519;1709;1118;3921;1637;5630
313010;201601;3415;10905;2878;9987;757;2830;1181;4055;1938;6885
313020;201601;926;3019;733;2546;144;574;137;395;281;969
313030;201601;1455;3881;1066;3339;226;879;435;1267;661;2146
313040;201601;789;2605;684;2361;105;432;262;825;367;1257
313050;201601;1750;5409;1325;4763;294;1191;325;1057;619;2248
313055;201601;1527;4844;1391;4659;92;337;1104;3731;1196;4068
313060;201601;713;2301;570;1968;158;559;67;212;225;771
313065;201601;1888;6133;1623;5714;321;1251;1047;3681;1368;4932
313070;201601;1019;2973;838;2661;183;669;346;1042;529;1711
313080;201601;431;1355;329;1146;71;286;101;319;172;605
313090;201601;5121;14732;4422;13618;1041;3395;2170;6736;3211;10131
313100;201601;1060;3258;954;3085;98;320;715;2356;813;2676
313110;201601;1684;4789;1267;3995;201;707;527;1566;728;2273
313115;201601;2338;7926;2214;7672;506;2005;965;3107;1471;5112
313120;201601;3366;8952;2874;8307;720;2342;1473;4132;2193;6474
313130;201601;24230;73234;21124;67054;4684;16429;7881;23570;12565;39999
313140;201601;567;1464;436;1272;28;99;314;899;342;998
313150;201601;1276;4030;1084;3696;466;1706;206;698;672;2404
313160;201601;909;2776;789;2537;120;451;448;1395;568;1846
313170;201601;7614;25711;6235;22580;1471;5725;1186;4212;2657;9937
313180;201601;2320;6373;1879;5757;475;1621;663;1965;1138;3586
313190;201601;3115;10650;2516;9153;526;2082;570;1945;1096;4027
313200;201601;1120;3671;978;3401;122;471;660;2251;782;2722
313210;201601;4069;12702;3421;11717;795;2922;1429;4756;2224;7678
313220;201601;1397;4193;1037;3421;236;859;215;595;451;1454
313230;201601;2218;7894;2054;7671;307;1234;1401;5241;1708;6475
313240;201601;7480;22888;5976;20196;1198;4633;2100;6773;3298;11406
313250;201601;6752;21219;5915;19819;810;2814;3335;11295;4145;14109
313260;201601;598;1772;432;1428;66;237;94;316;160;553
313270;201601;5226;15646;4382;14239;842;2951;2222;7148;3064;10099
313280;201601;370;1223;273;1012;51;212;55;186;106;398
313290;201601;797;2770;655;2523;227;956;83;298;310;1254
313300;201601;1765;5840;1463;5131;394;1508;185;552;579;2060
313310;201601;1027;3537;919;3310;206;860;162;525;368;1385
313320;201601;2251;6457;1692;5564;325;1191;681;2241;1006;3432
313330;201601;3875;12010;3234;10904;386;1549;1843;6057;2229;7606
313340;201601;1863;4584;1475;4019;282;770;760;2080;1042;2850
313350;201601;2848;8834;2294;7651;455;1682;433;1325;888;3007
313360;201601;1166;3335;892;2900;224;887;434;1314;658;2201
313370;201601;1105;3759;1039;3585;158;650;516;1650;674;2300
313375;201601;2231;5792;1542;4783;280;1081;466;1367;746;2448
313380;201601;4723;14660;3978;13174;989;3593;1200;3739;2189;7332
313390;201601;850;2922;811;2870;95;380;544;1915;639;2295
313400;201601;3582;9812;3157;9324;285;784;2641;8012;2926;8796
313410;201601;1168;3320;985;3046;230;794;520;1559;750;2353
313420;201601;18521;44028;11592;32581;2098;6650;1852;5194;3950;11844
313430;201601;1017;3174;778;2677;148;610;282;889;430;1499
313440;201601;5893;13383;4060;11260;255;736;2600;7320;2855;8056
313450;201601;602;1788;491;1576;97;362;151;444;248;806
313460;201601;2050;7021;1767;6558;458;1942;532;1816;990;3758
313470;201601;3018;8409;2703;7978;401;1239;1768;5145;2169;6384
313480;201601;1042;2967;812;2603;108;407;304;904;412;1311
313490;201601;1436;4214;852;3278;249;1065;99;369;348;1434
313500;201601;372;1198;315;1061;58;221;103;334;161;555
313505;201601;8843;25953;8152;25169;363;840;7399;23366;7762;24206
313507;201601;1323;3691;1155;3445;119;391;760;2281;879;2672
313510;201601;15069;43167;13169;40427;1993;6329;7274;22537;9267;28866
313520;201601;13934;43083;11776;39221;1373;5181;7318;24219;8691;29400
313530;201601;585;1793;484;1614;43;171;159;504;202;675
313535;201601;2372;7149;2146;6735;184;649;1552;4800;1736;5449
313540;201601;1049;3272;779;2587;196;711;164;500;360;1211
313545;201601;1248;4588;1125;4341;155;755;652;2359;807;3114
313550;201601;1771;5693;1563;5286;396;1393;656;2175;1052;3568
313560;201601;2098;4985;1744;4588;317;773;1147;3170;1464;3943
313570;201601;847;2964;728;2733;232;932;207;770;439;1702
313580;201601;5661;16209;4565;14657;768;2609;2562;8393;3330;11002
313590;201601;959;2722;755;2447;374;1334;157;485;531;1819
313600;201601;3712;11180;3220;10419;392;1403;2143;6960;2535;8363
313610;201601;947;2857;812;2601;166;595;392;1218;558;1813
313620;201601;5191;15982;4495;14765;1208;4230;1466;4861;2674;9091
313630;201601;7741;21777;5875;19082;1069;3968;2478;8484;3547;12452
313640;201601;746;2168;563;1888;165;617;166;538;331;1155
313650;201601;1890;6230;1667;5860;273;1094;1062;3655;1335;4749
313652;201601;912;3234;839;3101;141;594;499;1793;640;2387
313655;201601;906;2935;762;2692;110;470;453;1545;563;2015
313657;201601;1285;3861;1069;3534;107;491;777;2399;884;2890
313660;201601;799;2628;707;2465;151;613;317;1047;468;1660
313665;201601;3415;11031;2965;10104;619;2370;1301;4272;1920;6642
313670;201601;43061;126219;32272;105506;7492;26963;9481;30300;16973;57263
313680;201601;1018;3047;906;2865;141;528;522;1597;663;2125
313690;201601;801;2890;701;2656;177;684;237;917;414;1601
313695;201601;1311;4270;1130;3943;101;406;787;2765;888;3171
313700;201601;3350;11605;2975;11140;464;1796;2096;8024;2560;9820
313710;201601;1212;3295;938;2884;182;610;467;1398;649;2008
313720;201601;4978;15892;3985;13768;779;2949;1210;3903;1989;6852
313730;201601;1228;3329;931;2960;161;581;502;1583;663;2164
313740;201601;1996;7181;1707;6505;482;2066;130;435;612;2501
313750;201601;2122;6408;1788;5783;452;1554;539;1627;991;3181
313753;201601;1752;5097;1392;4494;316;1130;564;1807;880;2937
313760;201601;4242;13721;3539;12320;966;3683;903;2939;1869;6622
313770;201601;3131;10140;2779;9610;857;3223;1169;3984;2026;7207
313780;201601;3716;10269;2935;9126;419;1585;1204;3766;1623;5351
313790;201601;477;1657;451;1611;96;340;245;914;341;1254
313800;201601;1201;3253;1036;3008;107;354;686;2018;793;2372
313810;201601;1458;4225;1374;4110;60;163;1194;3676;1254;3839
313820;201601;12387;32967;10301;29836;1752;5962;4577;12675;6329;18637
313830;201601;405;1342;343;1218;90;365;120;428;210;793
313835;201601;862;2910;800;2813;152;624;435;1465;587;2089
313840;201601;7338;21063;5804;18500;1410;4951;1378;4345;2788;9296
313850;201601;1156;3144;1008;2882;197;673;491;1279;688;1952
313860;201601;2624;7954;2019;6666;461;1651;441;1383;902;3034
313862;201601;1180;2966;832;2409;119;337;415;1293;534;1630
313865;201601;2168;6719;1958;6409;218;827;1419;4597;1637;5424
313867;201601;1073;3683;936;3384;275;1075;251;941;526;2016
313868;201601;1572;5363;1354;4923;134;610;893;3181;1027;3791
313870;201601;764;2397;698;2288;202;756;193;554;395;1310
313880;201601;1363;4198;1179;3914;228;865;585;1798;813;2663
313890;201601;1816;4960;1517;4565;345;970;906;2910;1251;3880
313900;201601;3850;13855;3440;12943;1008;4254;903;3321;1911;7575
313910;201601;723;2433;611;2213;216;834;64;218;280;1052
313920;201601;3248;10804;2820;10015;468;1747;1544;5654;2012;7401
313925;201601;1838;4980;1394;4168;77;262;830;2485;907;2747
313930;201601;5182;16776;4273;15145;791;2981;2155;7760;2946;10741
313940;201601;8239;27265;6886;25144;1941;7880;2183;8417;4124;16297
313950;201601;3978;11338;3107;9953;953;3521;937;2706;1890;6227
313960;201601;5305;13640;3861;11646;1051;3447;957;2728;2008;6175
313970;201601;1394;3997;1220;3804;141;492;738;2418;879;2910
313980;201601;1187;3695;924;3247;248;991;385;1354;633;2345
313990;201601;1724;6374;1481;5814;477;2065;273;944;750;3009
314000;201601;7577;24308;6871;22975;1248;4999;3793;12080;5041;17079
314010;201601;1086;3051;902;2815;101;368;556;1680;657;2048
314015;201601;1127;3920;956;3605;240;1008;352;1278;592;2286
314020;201601;500;1510;359;1219;82;314;71;219;153;533
314030;201601;803;2594;648;2258;92;349;229;786;321;1135
314040;201601;667;1889;558;1696;250;809;109;313;359;1122
314050;201601;1641;5100;1309;4447;291;1163;421;1287;712;2450
314053;201601;1511;4770;1336;4544;190;649;863;3095;1053;3744
314055;201601;2095;6292;1835;5906;81;340;1417;4589;1498;4929
314060;201601;1128;3479;892;3079;65;293;557;1880;622;2173
314070;201601;3983;12294;3153;10716;785;2862;675;2192;1460;5054
314080;201601;1907;5868;1347;4608;221;861;270;800;491;1661
314085;201601;1930;6470;1703;6150;432;1737;620;2223;1052;3960
314090;201601;3230;11120;2857;10386;692;2823;939;3504;1631;6327
314100;201601;3170;8169;2803;7687;186;402;2366;6742;2552;7144
314110;201601;3816;12167;3371;11271;604;2360;1368;4167;1972;6527
314120;201601;998;2401;509;1620;106;371;127;395;233;766
314130;201601;717;2059;379;1286;47;175;72;228;119;403
314140;201601;4787;14893;4004;13368;902;3254;1651;5470;2553;8724
314150;201601;1545;4233;1249;3726;192;632;621;1824;813;2456
314160;201601;2499;6434;1963;5727;195;617;1174;3628;1369;4245
314170;201601;1037;3103;862;2742;109;375;444;1365;553;1740
314180;201601;5176;16582;4604;15663;1252;4589;1864;6480;3116;11069
314190;201601;701;2009;548;1775;117;478;210;601;327;1079
314200;201601;2884;8998;2521;8348;290;1140;1686;5456;1976;6596
314210;201601;1903;5580;1694;5231;236;864;1003;2955;1239;3819
314220;201601;1576;4887;1216;4208;363;1376;220;667;583;2043
314225;201601;1286;3777;1186;3648;94;305;970;3033;1064;3338
314230;201601;637;2083;588;1998;121;466;279;930;400;1396
314240;201601;1096;3315;919;3054;139;479;516;1813;655;2292
314250;201601;548;1633;425;1384;95;341;121;350;216;691
314260;201601;995;3542;888;3303;220;896;266;949;486;1845
314270;201601;2817;9165;2373;8386;235;931;1540;5499;1775;6430
314280;201601;3008;8364;2076;6586;461;1704;618;1719;1079;3423
314290;201601;4648;12880;4024;11873;1074;3254;2006;5872;3080;9126
314300;201601;1465;4918;1269;4480;354;1300;365;1261;719;2561
314310;201601;5128;15295;4408;14010;1181;4040;1498;4601;2679;8641
314315;201601;802;3131;735;2998;75;379;500;2006;575;2385
314320;201601;2910;8080;2078;6939;553;2027;970;3330;1523;5357
314330;201601;52561;158332;45486;147185;12443;43286;14933;47838;27376;91124
314340;201601;2839;7680;1673;5472;340;1223;118;258;458;1481
314345;201601;1175;4009;1060;3822;245;921;608;2204;853;3125
314350;201601;1268;3681;990;3241;303;1070;191;606;494;1676
314360;201601;658;2118;447;1621;100;412;82;306;182;718
314370;201601;536;1821;497;1767;129;507;302;1058;431;1565
314380;201601;1252;3744;883;3034;224;839;117;401;341;1240
314390;201601;13437;38868;10201;32968;2409;8421;2304;6929;4713;15350
314400;201601;4316;12791;3706;11932;1315;4440;1145;3849;2460;8289
314410;201601;2526;7880;2085;7040;629;2389;573;1846;1202;4235
314420;201601;735;2097;572;1862;30;159;383;1171;413;1330
314430;201601;6207;18625;5440;17210;1559;5343;1448;4689;3007;10032
314435;201601;1270;4090;1121;3835;116;510;706;2376;822;2886
314437;201601;1059;2763;876;2489;33;100;686;1948;719;2048
314440;201601;625;1817;487;1626;161;604;88;252;249;856
314450;201601;1551;4561;1309;4221;323;1200;553;1660;876;2860
314460;201601;4009;13431;3258;11849;752;3044;559;1968;1311;5012
314465;201601;2197;6932;2056;6686;119;536;1581;5001;1700;5537
314467;201601;967;2767;819;2515;63;189;581;1819;644;2008
314470;201601;2190;6821;1837;6126;343;1410;651;1937;994;3347
314480;201601;5719;18943;4134;14841;578;2256;428;1352;1006;3608
314490;201601;880;2618;689;2239;166;591;292;903;458;1494
314500;201601;1921;5468;1443;4662;348;1185;492;1535;840;2720
314505;201601;1698;5039;1564;4853;240;819;1016;3186;1256;4005
314510;201601;1819;4893;1233;4089;384;1403;274;915;658;2318
314520;201601;2840;10264;2203;8762;452;2042;223;785;675;2827
314530;201601;5789;20647;5521;20186;1037;3677;3283;12491;4320;16168
314535;201601;2687;7513;2276;6944;206;718;1718;5223;1924;5941
314537;201601;1109;3525;889;3131;128;542;509;1753;637;2295
314540;201601;403;1208;335;1071;70;264;94;265;164;529
314545;201601;1343;4131;1156;3863;139;538;812;2730;951;3268
314550;201601;602;1652;449;1437;82;352;166;470;248;822
314560;201601;4286;14719;3647;13229;671;2742;1049;3623;1720;6365
314570;201601;295;868;228;742;61;208;94;296;155;504
314580;201601;503;1681;405;1480;96;420;55;180;151;600
314585;201601;813;2636;591;2160;130;553;131;457;261;1010
314587;201601;1893;5804;1639;5371;360;1123;752;2564;1112;3687
314590;201601;3071;10439;2306;8463;395;1650;237;780;632;2430
314600;201601;1708;5610;1285;4739;304;1231;164;550;468;1781
314610;201601;6666;22613;6003;21119;1296;5122;2449;8113;3745;13235
314620;201601;1535;4630;1384;4412;163;521;992;3187;1155;3708
314625;201601;1418;4889;1317;4706;194;832;922;3162;1116;3994
314630;201601;4722;14119;4149;13233;296;1155;3039;9639;3335;10794
314640;201601;563;1540;443;1338;110;360;116;291;226;651
314650;201601;1045;2879;757;2420;106;405;256;732;362;1137
314655;201601;1556;4633;1167;3877;292;944;414;1404;706;2348
314660;201601;277;753;203;603;23;76;96;271;119;347
314670;201601;1579;4231;1180;3545;188;636;642;1879;830;2515
314675;201601;1746;5342;1506;4907;171;620;1010;3289;1181;3909
314690;201601;2307;7348;1901;6652;530;2105;430;1432;960;3537
314700;201601;8437;28994;6314;24272;1793;7718;783;3012;2576;10730
314710;201601;8933;27017;6330;21436;1134;4261;800;2518;1934;6779
314720;201601;2321;7617;1944;6811;483;1890;571;2001;1054;3891
314730;201601;2119;6396;1759;5865;481;1787;622;1990;1103;3777
314740;201601;2814;8982;2438;8263;431;1684;1105;3585;1536;5269
314750;201601;344;1075;276;918;45;184;122;377;167;561
314760;201601;1711;5674;1297;4687;211;889;252;785;463;1674
314770;201601;1099;3416;651;2208;77;305;94;227;171;532
314780;201601;257;702;193;614;54;204;81;247;135;451
314790;201601;10853;32268;8312;27856;3245;12220;678;1864;3923;14084
314795;201601;1628;4697;1376;4307;112;457;986;2960;1098;3417
314800;201601;10673;30993;7669;25114;2091;7423;870;2748;2961;10171
314810;201601;11444;33291;8933;28995;2461;8803;1676;5481;4137;14284
314820;201601;888;2466;622;2027;154;551;200;638;354;1189
314830;201601;1591;5285;1399;4969;421;1666;547;1930;968;3596
314840;201601;904;3271;749;3045;126;655;447;1745;573;2400
314850;201601;1859;5405;1488;4748;204;799;935;2876;1139;3675
314860;201601;3144;10510;2807;9907;662;2558;1303;4538;1965;7096
314870;201601;5380;16996;4633;16005;509;2200;3292;11277;3801;13477
314875;201601;1679;5543;1604;5443;288;938;1189;4126;1477;5064
314880;201601;843;2287;704;2109;37;100;518;1646;555;1746
314890;201601;593;1773;411;1383;77;317;139;410;216;727
314900;201601;502;1514;410;1379;99;355;195;640;294;995
314910;201601;1646;5355;1329;4828;401;1649;393;1334;794;2983
314915;201601;2449;7786;2155;7299;180;744;1540;5091;1720;5835
314920;201601;547;1503;387;1265;40;157;203;610;243;767
314930;201601;4325;14565;3808;13493;990;3734;868;2972;1858;6706
314940;201601;385;1128;355;1079;65;217;190;543;255;760
314950;201601;337;980;251;854;44;164;69;222;113;386
314960;201601;717;2229;557;1901;134;516;148;454;282;970
314970;201601;545;1865;454;1688;108;451;108;407;216;858
314980;201601;1423;4445;1200;4067;326;1240;86;270;412;1510
314990;201601;2455;7765;1926;6644;507;2029;340;983;847;3012
314995;201601;1553;4748;1360;4453;148;592;856;2724;1004;3316
315000;201601;1016;2946;835;2655;99;352;513;1638;612;1990
315010;201601;432;1327;341;1151;81;339;106;306;187;645
315015;201601;2029;6206;1819;5961;246;839;1306;4507;1552;5346
315020;201601;800;2489;607;2072;95;386;259;830;354;1216
315030;201601;677;2032;547;1811;138;496;115;360;253;856
315040;201601;859;2660;809;2569;157;517;485;1526;642;2043
315050;201601;1328;3836;1082;3460;229;842;444;1401;673;2243
315053;201601;1010;3014;912;2849;153;601;413;1297;566;1898
315057;201601;1643;5683;1439;5359;279;1044;786;3039;1065;4083
315060;201601;822;2679;600;2184;119;471;85;303;204;774
315070;201601;730;2199;623;2030;175;615;282;881;457;1496
315080;201601;2779;9276;2445;8541;637;2385;982;3396;1619;5781
315090;201601;765;2728;679;2534;159;667;170;614;329;1281
315100;201601;1145;3865;839;3152;191;825;200;692;391;1517
315110;201601;1374;4195;1182;3834;276;971;412;1310;688;2281
315120;201601;14029;32799;9680;27284;1481;4384;4758;14339;6239;18723
315130;201601;1352;4485;1231;4267;335;1295;365;1227;700;2522
315140;201601;2596;8297;2163;7403;480;1922;717;2239;1197;4161
315150;201601;4534;12280;3420;10430;672;2301;1206;3630;1878;5931
315160;201601;1176;3414;955;2973;193;641;385;1169;578;1810
315170;201601;1434;4285;1181;3877;256;919;414;1460;670;2379
315180;201601;16402;46206;9757;32298;1658;6240;1524;4658;3182;10898
315190;201601;1983;5161;1667;4681;456;1299;843;2395;1299;3694
315200;201601;3761;12657;3119;11297;948;3723;610;2190;1558;5913
315210;201601;7550;22273;6088;19316;1213;4320;2055;6221;3268;10541
315213;201601;1055;3390;992;3301;54;205;804;2674;858;2879
315217;201601;2351;8158;1992;7525;239;1113;1134;4219;1373;5332
315220;201601;9677;27891;8160;25495;2346;7244;3280;10893;5626;18137
315230;201601;2856;7500;2566;7164;203;296;2140;6496;2343;6792
315240;201601;3008;9207;2555;8500;671;2437;1214;3936;1885;6373
315250;201601;9661;29518;7465;25364;1806;6810;2025;6885;3831;13695
315260;201601;954;2964;668;2362;143;554;100;309;243;863
315270;201601;707;2281;552;1986;104;415;122;397;226;812
315280;201601;2962;8444;1916;6221;404;1417;303;901;707;2318
315290;201601;1312;3677;952;3094;292;1034;151;483;443;1517
315300;201601;519;1347;348;1134;152;516;121;407;273;923
315310;201601;1226;3936;1037;3608;133;559;645;2145;778;2704
315320;201601;769;2326;612;2128;108;436;282;999;390;1435
315330;201601;706;2553;459;1891;111;509;46;192;157;701
315340;201601;3482;10012;2855;9079;621;2163;1098;3395;1719;5558
315350;201601;1810;4996;1361;4344;289;978;710;2333;999;3311
315360;201601;1626;5404;1351;4764;246;950;415;1377;661;2327
315370;201601;478;1445;418;1360;83;285;211;706;294;991
315380;201601;201;685;160;589;39;166;32;95;71;261
315390;201601;1293;4292;973;3544;217;902;164;552;381;1454
315400;201601;4121;12444;3395;11089;684;2476;1480;4739;2164;7215
315410;201601;1998;5315;1687;4881;197;685;1124;3253;1321;3938
315415;201601;954;3148;865;3020;301;1063;396;1477;697;2540
315420;201601;1196;3805;942;3303;221;823;132;436;353;1259
315430;201601;3561;9702;2707;8308;722;2469;563;1649;1285;4118
315440;201601;879;2740;762;2545;147;558;336;1073;483;1631
315445;201601;2051;5758;1626;5105;186;661;1121;3483;1307;4144
315450;201601;2352;7432;2108;7062;464;1442;1183;4165;1647;5607
315460;201601;31724;103338;28229;96284;9167;33366;4748;15631;13915;48997
315470;201601;465;1404;381;1250;47;193;195;613;242;806
315480;201601;1647;5012;1099;3771;186;710;167;582;353;1292
315490;201601;2958;8015;2308;7143;338;1195;896;2656;1234;3851
315500;201601;484;1450;329;1104;45;179;119;342;164;521
315510;201601;1371;3934;1161;3608;99;339;823;2493;922;2832
315520;201601;985;2995;813;2713;104;386;506;1632;610;2018
315530;201601;552;1889;468;1699;170;656;121;412;291;1068
315540;201601;1069;3355;885;3008;172;693;301;1018;473;1711
315550;201601;1658;4667;1297;4154;338;1204;389;1207;727;2411
315560;201601;6353;21262;5757;20440;625;2471;3830;13776;4455;16247
315570;201601;1916;6053;1781;5843;313;1173;937;2979;1250;4152
315580;201601;2422;7101;1910;6195;468;1737;484;1461;952;3198
315590;201601;858;2508;761;2366;138;467;388;1178;526;1645
315600;201601;2410;8564;1955;7698;344;1418;1002;4122;1346;5540
315610;201601;967;2769;784;2404;149;577;279;713;428;1290
315620;201601;311;1093;294;1064;92;314;154;594;246;908
315630;201601;829;2653;699;2392;176;642;164;530;340;1172
315640;201601;471;1357;382;1216;74;286;164;483;238;769
315645;201601;829;2521;685;2222;244;845;149;470;393;1315
315650;201601;1806;5030;1439;4506;86;367;1053;3297;1139;3664
315660;201601;2486;6558;2062;5898;374;1087;1232;3505;1606;4592
315670;201601;10078;33347;9002;31297;2552;9553;3002;10268;5554;19821
315680;201601;2980;9930;2336;8631;809;3147;394;1449;1203;4596
315690;201601;3301;9368;2303;7611;573;2103;384;1346;957;3449
315700;201601;7065;22054;5997;19962;1068;3975;2702;8610;3770;12585
315710;201601;1742;5078;1399;4537;112;460;878;2772;990;3232
315720;201601;3503;11012;3111;10318;503;1960;1607;5065;2110;7025
315725;201601;1407;4506;1263;4284;293;1026;748;2594;1041;3620
315727;201601;570;1783;475;1590;98;364;172;549;270;913
315730;201601;776;2414;712;2288;110;403;395;1235;505;1638
315733;201601;949;2874;850;2701;259;896;245;724;504;1620
315737;201601;1230;3768;965;3297;68;300;610;2132;678;2432
315740;201601;976;3010;816;2696;155;623;398;1216;553;1839
315750;201601;1079;3365;989;3202;68;269;712;2286;780;2555
315760;201601;991;2676;950;2625;25;86;860;2348;885;2434
315765;201601;1392;4353;1244;4157;69;267;1009;3421;1078;3688
315770;201601;1374;4462;1193;4144;314;1199;281;991;595;2190
315780;201601;20855;68221;18881;64013;4734;17177;5332;17971;10066;35148
315790;201601;3487;11647;3065;10807;298;1011;2040;7418;2338;8429
315800;201601;1431;5516;1146;4700;258;1157;175;694;433;1851
315810;201601;1319;3583;1118;3285;132;388;782;2276;914;2664
315820;201601;2417;8201;2123;7694;693;2594;813;3062;1506;5656
315830;201601;1145;3866;983;3523;123;542;277;886;400;1428
315840;201601;824;2177;596;1783;93;311;165;459;258;770
315850;201601;948;3432;924;3386;225;885;475;1699;700;2584
315860;201601;508;1745;385;1489;98;451;64;221;162;672
315870;201601;444;1316;363;1187;100;360;137;419;237;779
315880;201601;1182;3044;940;2742;214;763;305;815;519;1578
315890;201601;1436;4902;1281;4645;465;1803;489;1760;954;3563
315895;201601;5037;15714;4387;14300;973;3504;1503;4627;2476;8131
315900;201601;714;2149;685;2100;74;301;527;1517;601;1818
315910;201601;489;1652;454;1593;148;577;246;828;394;1405
315920;201601;1543;4253;918;2946;196;687;152;416;348;1103
315930;201601;1039;2837;785;2396;198;671;188;553;386;1224
315935;201601;922;3049;828;2850;233;876;200;667;433;1543
315940;201601;610;1937;528;1769;126;489;232;740;358;1229
315950;201601;1143;3529;1031;3324;219;657;611;2039;830;2696
315960;201601;3355;10615;2333;8553;829;3505;97;233;926;3738
315970;201601;721;1960;554;1737;40;108;390;1295;430;1403
315980;201601;3902;9509;2400;7027;600;2011;544;1335;1144;3346
315990;201601;3864;11212;3240;10229;538;2062;1607;4926;2145;6988
316000;201601;542;1625;460;1512;139;558;166;516;305;1074
316010;201601;590;1953;478;1738;70;298;188;620;258;918
316020;201601;1013;3243;883;3038;118;468;567;1907;685;2375
316030;201601;3081;9068;2299;7668;209;804;1351;4605;1560;5409
316040;201601;3437;10834;2616;9158;389;1582;437;1273;826;2855
316045;201601;1996;6256;1837;5998;265;842;1240;4210;1505;5052
316050;201601;344;1091;274;982;52;210;123;411;175;621
316060;201601;715;2148;570;1941;80;356;325;1036;405;1392
316070;201601;5944;18706;5146;16954;1149;4233;1994;6248;3143;10481
316080;201601;714;2609;636;2420;144;628;71;273;215;901
316090;201601;568;1693;384;1300;76;297;85;265;161;562
316095;201601;1404;4471;1210;4129;212;733;719;2468;931;3201
316100;201601;2705;8918;2050;7296;477;1928;377;1223;854;3151
316105;201601;918;2624;694;2251;173;587;255;859;428;1446
316110;201601;11968;40882;10655;38668;1295;5084;6930;25869;8225;30953
316120;201601;1084;3526;882;3035;200;727;212;627;412;1354
316130;201601;1425;3215;888;2480;140;460;386;1029;526;1489
316140;201601;893;2629;711;2349;96;323;395;1339;491;1662
316150;201601;1445;4006;1265;3698;213;716;706;2045;919;2761
316160;201601;1218;3614;945;3108;157;593;412;1346;569;1939
316165;201601;897;2429;756;2230;150;506;395;1163;545;1669
316170;201601;1321;3824;994;3268;156;579;395;1190;551;1769
316180;201601;1323;4162;942;3330;193;775;155;464;348;1239
316190;201601;2737;8506;1459;5160;255;918;203;622;458;1540
316200;201601;3704;11804;2886;10197;636;2566;733;2547;1369;5113
316210;201601;4519;14469;3845;13192;1482;5378;504;1757;1986;7135
316220;201601;787;2421;570;2005;114;459;69;256;183;715
316225;201601;1154;3219;984;2955;133;435;597;1748;730;2183
316230;201601;402;1133;326;1003;52;180;151;501;203;681
316240;201601;6427;19757;5615;18682;654;2184;4008;13521;4662;15705
316245;201601;3151;10902;2920;10522;215;1079;2252;7878;2467;8957
316250;201601;10378;29962;8145;25670;2078;7136;1994;5986;4072;13122
316255;201601;2451;7477;2160;7128;408;1470;1347;4451;1755;5921
316257;201601;1311;3645;987;3065;174;613;355;1042;529;1655
316260;201601;1746;4956;1382;4416;89;331;782;2667;871;2998
316265;201601;1316;3692;969;3023;103;400;549;1647;652;2047
316270;201601;3923;13131;3610;12510;948;3539;1381;4675;2329;8214
316280;201601;3110;10125;2827;9597;454;1723;1528;5098;1982;6821
316290;201601;3218;10088;2743;9203;531;2100;1084;3486;1615;5586
316292;201601;3188;10182;2842;9624;572;2158;1527;4959;2099;7117
316294;201601;829;2648;614;2199;114;484;42;151;156;635
316295;201601;1711;5685;1598;5471;215;920;1010;3327;1225;4247
316300;201601;981;3040;835;2812;69;254;531;1822;600;2076
316310;201601;692;1993;468;1593;89;351;123;394;212;745
316320;201601;600;1902;480;1692;83;351;88;294;171;645
316330;201601;895;2786;700;2339;80;304;427;1396;507;1700
316340;201601;919;2965;753;2621;172;723;314;1017;486;1740
316350;201601;1285;4104;1153;3889;193;672;650;2256;843;2928
316360;201601;715;1893;569;1681;72;218;390;1175;462;1393
316370;201601;4302;13952;3740;12841;1027;3856;536;1845;1563;5701
316380;201601;1568;4180;1250;3739;85;286;868;2622;953;2908
316390;201601;869;2542;735;2333;186;645;288;945;474;1590
316400;201601;1218;3828;957;3352;213;799;350;1187;563;1986
316410;201601;1016;3401;943;3291;201;731;563;1987;764;2718
316420;201601;1857;6044;1652;5773;141;615;1157;3921;1298;4536
316430;201601;909;2782;675;2311;154;575;144;446;298;1021
316440;201601;637;2085;531;1923;187;777;100;360;287;1137
316443;201601;659;1952;546;1751;124;452;202;603;326;1055
316447;201601;1534;4648;1400;4471;92;321;1190;3820;1282;4141
316450;201601;2068;6994;1774;6442;225;905;1154;4225;1379;5130
316460;201601;687;2145;620;2027;163;573;314;1006;477;1579
316470;201601;7071;22753;5645;19787;1401;5655;1443;4906;2844;10561
316480;201601;182;611;161;567;33;121;46;154;79;275
316490;201601;291;921;243;808;49;172;93;288;142;460
316500;201601;1130;4004;791;2993;137;558;35;126;172;684
316510;201601;745;2762;665;2596;220;917;153;582;373;1499
316520;201601;1048;3187;852;2887;155;583;269;811;424;1394
316530;201601;1005;3283;851;2983;185;804;275;792;460;1596
316540;201601;841;2690;748;2543;116;486;237;755;353;1241
316550;201601;1150;3855;1076;3735;214;856;643;2222;857;3078
316553;201601;1777;6238;1410;5335;377;1590;300;1111;677;2701
316555;201601;2735;9564;2442;9202;179;784;1818;6907;1997;7691
316556;201601;595;1559;474;1364;48;165;302;827;350;992
316557;201601;747;2700;711;2644;281;1107;158;525;439;1632
316560;201601;306;1081;261;983;56;263;51;171;107;434
316570;201601;1217;3880;1069;3600;131;476;527;1793;658;2269
316580;201601;287;804;193;619;42;157;43;133;85;290
316590;201601;1422;3882;1021;3216;261;872;404;1191;665;2063
316600;201601;1024;3326;910;3104;269;992;304;1008;573;2000
316610;201601;559;2030;490;1890;97;432;291;1094;388;1526
316620;201601;2078;6341;1777;5840;297;1164;1035;3308;1332;4472
316630;201601;1391;4642;1200;4235;475;1763;290;1055;765;2818
316640;201601;173;548;155;513;31;133;66;183;97;316
316650;201601;869;3204;771;3045;113;450;481;1980;594;2430
316660;201601;187;483;91;281;9;38;19;43;28;81
316670;201601;1824;5233;1497;4671;584;1963;262;775;846;2738
316680;201601;1859;5045;1501;4555;195;632;1018;3103;1213;3735
316690;201601;1121;3812;1004;3547;286;1137;293;1009;579;2146
316695;201601;1062;3362;923;3093;134;467;528;1771;662;2238
316700;201601;344;1055;310;1000;45;190;186;541;231;731
316710;201601;2849;10661;2463;9833;876;3688;597;2552;1473;6240
316720;201601;15113;48365;12471;42804;3378;12310;2381;7994;5759;20304
316730;201601;351;1091;303;997;73;273;126;377;199;650
316740;201601;613;2063;553;1959;112;471;270;950;382;1421
316750;201601;380;1283;323;1158;55;237;104;332;159;569
316760;201601;3277;10961;2826;10364;1544;5806;715;2715;2259;8521
316770;201601;1214;3485;1107;3345;107;416;861;2567;968;2983
316780;201601;559;1849;498;1731;140;567;92;275;232;842
316790;201601;838;2405;626;2048;152;539;174;569;326;1108
316800;201601;5047;16664;4478;15568;837;3280;2195;7195;3032;10475
316805;201601;773;2030;746;1993;66;174;626;1741;692;1915
316810;201601;601;1834;503;1642;142;517;184;552;326;1069
316820;201601;384;998;217;712;36;139;31;98;67;237
316830;201601;557;1913;532;1869;166;630;203;707;369;1337
316840;201601;2760;8485;2433;7878;554;2078;1030;3146;1584;5224
316850;201601;1960;5787;1640;5253;237;860;901;2867;1138;3727
316860;201601;16923;53623;14538;49247;3310;12875;5709;18518;9019;31393
316870;201601;5667;18358;4641;15990;1306;4923;653;2177;1959;7100
316880;201601;826;2533;715;2346;211;811;217;688;428;1499
316890;201601;1193;2954;964;2660;292;940;501;1289;793;2229
316900;201601;2469;7414;1958;6371;438;1603;550;1592;988;3195
316905;201601;444;1483;385;1352;132;490;117;410;249;900
316910;201601;770;2445;560;2026;155;603;94;356;249;959
316920;201601;1514;4198;1120;3659;316;1181;358;1116;674;2297
316930;201601;8194;27727;6519;24087;1373;5557;749;2542;2122;8099
316935;201601;4850;14221;3244;11021;815;3075;493;1618;1308;4693
316940;201601;6786;22113;5601;19651;1242;4600;1107;3783;2349;8383
316950;201601;1464;4145;1247;3835;120;436;866;2629;986;3065
316960;201601;4645;11785;3665;10460;694;2170;1962;5534;2656;7704
316970;201601;3144;10000;2970;9724;666;2550;1133;3400;1799;5950
316980;201601;930;2848;678;2363;215;830;103;355;318;1185
316990;201601;9503;30344;8096;27141;2424;8839;653;2069;3077;10908
317000;201601;2696;9246;2595;9134;326;1064;1894;7506;2220;8570
317005;201601;2485;7700;2211;7278;440;1470;1224;4089;1664;5559
317010;201601;29716;73763;18528;56493;4332;15000;3419;11021;7751;26021
317020;201601;57033;157049;35011;112750;6916;24574;6598;19723;13514;44297
317030;201601;691;2048;581;1877;64;268;342;1075;406;1343
317040;201601;9942;28935;8019;25610;2023;6960;2827;9023;4850;15983
317043;201601;690;1907;596;1788;79;228;378;1159;457;1387
317047;201601;1113;2958;817;2480;112;378;385;1167;497;1545
317050;201601;1456;4982;1148;4272;225;902;404;1421;629;2323
317052;201601;2260;7337;2076;7054;171;688;1507;5063;1678;5751
317057;201601;1631;4596;1244;3916;118;474;716;2176;834;2650
317060;201601;384;1131;264;868;55;206;70;201;125;407
317065;201601;1226;4007;1118;3835;116;523;803;2685;919;3208
317070;201601;9394;29090;6527;22680;1299;5099;815;2763;2114;7862
317075;201601;1011;3086;806;2658;193;686;169;520;362;1206
317080;201601;5899;16270;5009;14784;1473;4512;1445;4207;2918;8719
317090;201601;4703;15746;4379;15243;612;2123;2951;10533;3563;12656
317100;201601;2855;7885;2164;6737;664;2234;674;2020;1338;4254
317103;201601;1961;6745;1675;6208;267;1252;795;2835;1062;4087
317107;201601;1266;3922;1101;3585;179;707;664;2020;843;2727
317110;201601;627;1592;363;1140;74;280;114;371;188;651
317115;201601;1102;3474;955;3171;116;384;649;2196;765;2580
317120;201601;10139;33644;8271;29254;1918;7513;2764;9568;4682;17081
317130;201601;7121;21376;6021;19395;1270;4572;2436;7758;3706;12330
317140;201601;545;1758;504;1698;74;265;321;1097;395;1362
317150;201601;944;2630;817;2483;94;338;584;1721;678;2059
317160;201601;3407;9036;2591;7959;201;663;1785;5467;1986;6130
317170;201601;1832;5033;1481;4451;88;338;784;2208;872;2546
317180;201601;1745;5845;1421;5154;384;1523;365;1285;749;2808
317190;201601;1340;3865;1076;3489;116;413;713;2300;829;2713
317200;201601;4334;13582;3748;12422;981;3620;1108;3523;2089;7143
317210;201601;1011;3037;838;2803;156;648;453;1469;609;2117
317220;201601;276;963;263;944;77;300;107;366;184;666
320010;201601;4789;15058;4178;13807;760;2656;2107;6893;2867;9549
320013;201601;1807;5547;1345;4600;211;751;552;1970;763;2721
320016;201601;2987;8555;2609;7994;353;1041;1782;5529;2135;6570
320020;201601;3726;11636;3179;10509;915;3259;960;3185;1875;6444
320030;201601;1639;5257;1331;4608;398;1457;387;1308;785;2765
320035;201601;1739;5143;1516;4804;499;1744;498;1472;997;3216
320040;201601;3195;10275;2651;9192;587;2212;766;2592;1353;4804
320050;201601;1700;4602;1469;4193;338;1040;617;1660;955;2700
320060;201601;11421;36122;8868;30359;2006;7474;2287;7425;4293;14899
320070;201601;1370;4419;1108;3839;251;971;260;803;511;1774
320080;201601;5359;15257;4110;12786;1039;3401;968;3007;2007;6408
320090;201601;7913;23156;6313;19953;1693;5683;2137;6527;3830;12210
320100;201601;2741;8504;2213;7437;611;2136;711;2388;1322;4524
320110;201601;1229;3684;1077;3383;255;811;321;1013;576;1824
320115;201601;1726;6161;1561;5862;838;3274;338;1344;1176;4618
320120;201601;15488;47083;12157;40652;3000;11007;3237;10919;6237;21926
320130;201601;34591;111599;31488;105419;6489;24170;14200;46040;20689;70210
320140;201601;3567;11301;2570;9043;623;2432;262;930;885;3362
320150;201601;15630;43376;11501;35595;2640;8853;1604;4806;4244;13659
320160;201601;4733;15051;4136;13830;1032;3879;1315;4024;2347;7903
320170;201601;1666;5346;1365;4696;360;1295;477;1651;837;2946
320180;201601;741;2486;660;2344;261;962;153;573;414;1535
320190;201601;3607;12385;2877;10608;807;3118;459;1704;1266;4822
320200;201601;1020;3155;862;2892;218;790;275;974;493;1764
320210;201601;4627;13078;3955;11811;842;2824;1767;4902;2609;7726
320220;201601;2396;7443;1966;6592;510;1849;702;2400;1212;4249
320225;201601;1336;4524;1073;3906;364;1426;152;561;516;1987
320230;201601;4035;13164;3513;12292;1119;4180;1204;4316;2323;8496
320240;201601;11946;35028;9550;30726;2419;8551;2350;7471;4769;16022
320245;201601;3376;11554;3129;10966;1036;3856;752;2551;1788;6407
320250;201601;1743;5343;1262;4241;331;1295;193;535;524;1830
320255;201601;1688;5706;1482;5354;610;2382;470;1810;1080;4192
320260;201601;1032;3183;804;2666;202;726;187;526;389;1252
320265;201601;2286;7233;1992;6818;441;1578;1114;3951;1555;5529
320270;201601;2618;7808;1956;6533;435;1584;741;2501;1176;4085
320280;201601;6398;19621;5655;18128;1344;4753;1931;5755;3275;10508
320290;201601;1395;4583;1041;3728;320;1208;135;496;455;1704
320300;201601;4132;13804;3697;12855;1199;4411;803;2792;2002;7203
320305;201601;4344;14039;3792;12810;897;3288;1519;4927;2416;8215
320310;201601;1903;5698;1625;5151;416;1374;574;1781;990;3155
320313;201601;2149;6230;1502;4761;323;1224;252;688;575;1912
320316;201601;1708;5145;1393;4498;434;1485;405;1261;839;2746
320320;201601;19060;58600;15499;52052;4163;15354;4772;15688;8935;31042
320330;201601;2924;8688;2486;7968;613;1936;1151;3930;1764;5866
320332;201601;4863;16169;4256;15010;1534;5745;1129;4043;2663;9788
320334;201601;1878;5993;1328;4805;366;1491;209;712;575;2203
320335;201601;2322;6849;1501;4972;369;1361;170;470;539;1831
320340;201601;5791;15662;4807;14035;1076;3413;1945;5763;3021;9176
320350;201601;4954;13386;3757;11215;809;2583;1441;4265;2250;6848
320360;201601;1695;4480;1249;3621;216;675;464;1257;680;1932
320370;201601;2950;9623;2401;8401;683;2451;709;2472;1392;4923
320380;201601;2188;6461;1930;6011;375;1281;1059;3211;1434;4492
320390;201601;7230;21823;5908;19058;1694;5911;1459;4496;3153;10407
320400;201601;3480;10749;3115;10108;916;3292;1047;3187;1963;6479
320405;201601;3966;11772;3482;11011;858;2884;1656;5135;2514;8019
320410;201601;5409;14270;3991;12425;1018;3404;1646;5167;2664;8571
320420;201601;2026;6164;1575;5349;456;1749;339;1129;795;2878
320425;201601;1868;5085;1582;4606;207;656;944;2691;1151;3347
320430;201601;2327;6519;2026;5927;424;1313;1020;2885;1444;4198
320435;201601;2763;9067;2302;8130;1054;3873;588;2200;1642;6073
320440;201601;1032;3444;913;3138;201;783;286;921;487;1704
320450;201601;1950;6127;1598;5434;436;1638;611;1997;1047;3635
320455;201601;4004;13182;2965;10683;842;3238;615;2178;1457;5416
320460;201601;2595;8389;2044;7182;525;1995;519;1763;1044;3758
320465;201601;1557;4884;1184;4050;220;821;484;1653;704;2474
320470;201601;4263;12865;2938;9864;771;2867;408;1268;1179;4135
320480;201601;1764;5488;1559;5103;411;1482;513;1627;924;3109
320490;201601;15372;47228;12892;42724;3809;13792;3362;11216;7171;25008
320495;201601;1232;3675;879;2927;270;946;98;354;368;1300
320500;201601;45392;137111;39568;126672;9485;32897;17473;54706;26958;87603
320501;201601;4167;13074;3545;12151;1199;4622;1135;3733;2334;8355
320503;201601;1819;6175;1490;5480;580;2312;340;1127;920;3439
320506;201601;3883;12035;2800;9485;817;3000;178;503;995;3503
320510;201601;7835;24581;6768;22532;1649;5891;2887;9541;4536;15432
320515;201601;1847;5332;1529;4644;395;1229;268;757;663;1986
320517;201601;2114;6834;1733;6094;580;2228;323;1082;903;3310
320520;201601;36284;108763;29819;96992;7671;27513;9813;31559;17484;59072
320530;201601;26151;79453;21842;71213;4459;16741;9844;30091;14303;46832
330010;201601;19739;60039;17801;56353;3770;12879;9115;28399;12885;41278
330015;201601;1604;4482;1398;4101;238;806;581;1651;819;2457
330020;201601;16718;49232;15300;46945;2944;9897;8667;25999;11611;35896
330022;201601;1794;5405;1513;4948;297;1098;729;2309;1026;3407
330023;201601;3089;9550;2718;8958;766;2743;817;2585;1583;5328
330025;201601;4330;11669;3442;10238;792;2584;1699;4994;2491;7578
330030;201601;7688;25553;6804;23811;1387;5370;3190;10695;4577;16065
330040;201601;11643;34436;10288;31967;2306;7623;4876;14712;7182;22335
330045;201601;67887;187434;59554;175787;7789;24656;39337;114479;47126;139135
330050;201601;2359;7394;2094;6861;607;2198;602;1819;1209;4017
330060;201601;5574;16169;4854;15138;1202;4202;2346;7241;3548;11443
330070;201601;21346;64576;19081;60744;4181;14282;8453;26900;12634;41182
330080;201601;7625;21930;7123;21178;869;2576;4859;14593;5728;17169
330090;201601;2587;7035;2342;6647;448;1409;1234;3398;1682;4807
330093;201601;1987;5903;1666;5330;384;1283;565;1872;949;3155
330095;201601;950;3240;829;2968;226;917;200;664;426;1581
330100;201601;55126;175013;50331;167253;8749;32765;26477;87753;35226;120518
330110;201601;2302;7270;2047;6832;515;1863;567;1859;1082;3722
330115;201601;1900;5456;1669;5110;303;1043;858;2534;1161;3577
330120;201601;2462;6909;2181;6493;496;1631;1109;3179;1605;4810
330130;201601;3474;11178;3085;10497;794;2927;1324;4435;2118;7362
330140;201601;2926;9126;2666;8740;620;2232;1302;4234;1922;6466
330150;201601;2267;6689;1793;5743;392;1368;383;1242;775;2610
330160;201601;1131;3647;995;3416;286;1114;432;1401;718;2515
330170;201601;98042;294220;89794;281500;16223;53975;51601;160928;67824;214903
330180;201601;1974;5803;1644;5203;152;601;970;2867;1122;3468
330185;201601;7714;24196;6737;22299;1513;5454;3311;10694;4824;16148
330187;201601;3709;10634;3189;9768;461;1593;2067;6223;2528;7816
330190;201601;24579;70182;22899;67540;4371;13536;14448;42384;18819;55920
330200;201601;13539;42765;12067;40262;3155;10904;5515;18677;8670;29581
330205;201601;2137;5848;1863;5389;343;1096;982;2733;1325;3829
330210;201601;3775;10333;3017;8904;840;2615;696;2021;1536;4636
330220;201601;9885;30202;8683;27679;2294;7938;2117;6208;4411;14146
330225;201601;3749;11645;3387;11008;429;1638;2052;6590;2481;8228
330227;201601;16863;48578;15219;46193;3925;12173;7632;23651;11557;35824
330230;201601;1342;4022;1220;3826;303;1075;497;1470;800;2545
330240;201601;16441;50670;14127;46333;4642;16487;2958;9252;7600;25739
330245;201601;1254;3874;994;3399;243;919;177;574;420;1493
330250;201601;35311;103152;32302;98269;9748;29893;12384;38959;22132;68852
330260;201601;3556;11232;3126;10380;607;2250;1258;3958;1865;6208
330270;201601;17425;41809;12163;34691;2950;9304;4008;11514;6958;20818
330280;201601;2126;6363;1784;5688;304;1071;794;2356;1098;3427
330285;201601;17694;50917;16052;48549;2761;9057;9697;29042;12458;38099
330290;201601;3329;9439;2956;8887;486;1659;1712;4935;2198;6594
330300;201601;3208;10427;2925;9902;421;1661;1718;5641;2139;7302
330310;201601;2277;6515;1965;5994;314;1037;1064;3175;1378;4212
330320;201601;12762;38422;11965;37215;1771;5990;8509;26269;10280;32259
330330;201601;26220;73003;23084;68105;3893;12912;13765;39260;17658;52172
330340;201601;14034;40993;11139;35725;2778;9500;3156;10030;5934;19530
330350;201601;82822;247730;76668;238870;11421;37390;52356;163428;63777;200818
330360;201601;5661;16953;5460;16677;350;1206;4637;14079;4987;15285
330370;201601;3299;11699;3007;11068;1038;3966;955;3562;1993;7528
330380;201601;4783;15505;4091;14162;900;3431;1571;5315;2471;8746
330385;201601;3912;13520;3597;12907;1126;4343;1254;4489;2380;8832
330390;201601;22557;73660;19980;68529;4773;17883;8248;27672;13021;45555
330395;201601;2907;8582;2636;8134;260;962;1729;5177;1989;6139
330400;201601;2437;7752;2203;7369;310;1258;1259;3859;1569;5117
330410;201601;2771;8580;2314;7711;503;1849;993;3207;1496;5056
330411;201601;2277;7100;1989;6500;229;894;1117;3487;1346;4381
330412;201601;1304;4417;1090;3993;230;983;432;1473;662;2456
330414;201601;23690;67142;21011;63422;4253;12742;12074;36905;16327;49647
330415;201601;3470;10617;3030;9852;791;2659;1065;3510;1856;6169
330420;201601;9373;27233;6515;21945;1426;5240;1046;3411;2472;8651
330430;201601;7162;21274;6398;19865;1326;4420;2979;9047;4305;13467
330440;201601;1601;5361;1397;4940;425;1675;264;826;689;2501
330450;201601;1304;4359;1166;4109;266;1127;555;1871;821;2998
330452;201601;13298;38927;10575;33706;2673;9294;3568;10990;6241;20284
330455;201601;464209;1289056;388359;1171176;90300;289197;181844;543799;272144;832996
330460;201601;1159;3786;1034;3568;220;869;456;1531;676;2400
330470;201601;4276;12989;3817;12150;887;3080;1637;5068;2524;8148
330475;201601;7699;23917;6796;22414;2002;7215;2416;7771;4418;14986
330480;201601;5652;16721;5191;16063;1064;3560;2859;8715;3923;12275
330490;201601;102551;273562;93222;259972;9370;27148;68463;191382;77833;218530
330500;201601;5498;16917;5239;16447;671;2308;3534;10948;4205;13256
330510;201601;36515;111903;32940;106349;10228;33569;13833;45768;24061;79337
330513;201601;1462;4410;1329;4170;397;1253;492;1591;889;2844
330515;201601;2983;9228;2633;8564;789;2587;763;2490;1552;5077
330520;201601;11218;33693;10043;31662;2106;6969;4551;14272;6657;21241
330530;201601;1459;4384;1304;4102;343;1156;479;1476;822;2632
330540;201601;2824;8385;2375;7592;570;1962;948;2949;1518;4911
330550;201601;7730;25918;6861;24281;2950;10859;1012;3630;3962;14489
330555;201601;9887;29099;8790;27546;1656;5275;5165;16650;6821;21925
330560;201601;4129;12467;3771;11824;742;2593;1896;5704;2638;8297
330570;201601;3352;9821;2884;9045;753;2492;1336;4195;2089;6687
330575;201601;5021;14500;4497;13568;724;2460;2756;7952;3480;10412
330580;201601;13719;43207;11710;39134;3015;10624;4459;14963;7474;25587
330590;201601;1580;4858;1465;4672;299;1025;867;2732;1166;3757
330600;201601;10507;30195;8562;27009;1172;4214;4545;14090;5717;18304
330610;201601;8616;27113;7877;25795;1391;5169;4429;14197;5820;19366
330615;201601;1638;5755;1485;5434;659;2592;270;1000;929;3592
330620;201601;3390;11773;3069;11165;1071;4234;703;2626;1774;6860
330630;201601;22158;65183;18336;58527;3162;11524;9353;28682;12515;40206
350010;201601;1932;5763;1302;4491;286;1073;153;482;439;1555
350020;201601;446;1207;313;948;48;153;150;428;198;581
350030;201601;4217;13280;3332;11493;1176;4419;661;2160;1837;6579
350040;201601;433;1508;330;1274;72;292;75;268;147;560
350050;201601;874;2676;711;2379;172;661;237;711;409;1372
350055;201601;613;1825;523;1681;113;373;274;870;387;1243
350060;201601;107;310;83;273;23;90;36;111;59;201
350070;201601;3472;10519;2291;8006;446;1719;383;1163;829;2882
350075;201601;422;1421;336;1278;125;488;75;275;200;763
350080;201601;546;1558;383;1235;80;287;129;405;209;692
350090;201601;556;1433;355;1085;82;245;120;373;202;618
350100;201601;1731;5468;1253;4480;269;1061;305;1034;574;2095
350110;201601;439;1310;337;1096;46;176;155;484;201;660
350115;201601;1166;3607;1048;3369;187;712;560;1653;747;2365
350120;201601;567;1497;301;935;62;198;38;118;100;316
350130;201601;3042;9098;2705;8442;397;1432;1417;4170;1814;5602
350140;201601;545;1770;466;1640;82;339;207;711;289;1050
350150;201601;372;1267;330;1180;119;452;80;287;199;739
350160;201601;7432;21704;5141;17187;1186;4457;1794;5490;2980;9947
350170;201601;1616;5575;1405;5058;349;1357;291;981;640;2338
350180;201601;969;2703;634;1957;106;328;266;826;372;1154
350190;201601;2860;8930;2379;7986;493;1964;1094;3258;1587;5222
350200;201601;322;1042;277;960;39;147;140;489;179;636
350210;201601;4658;12442;3468;10510;975;3241;1279;3766;2254;7007
350220;201601;2462;7861;2152;7218;540;2140;737;2227;1277;4367
350230;201601;597;1982;544;1891;130;510;221;739;351;1249
350240;201601;441;1395;374;1226;74;250;199;644;273;894
350250;201601;1930;7072;1815;6840;643;2569;610;2297;1253;4866
350260;201601;930;2508;657;2021;117;391;264;769;381;1160
350270;201601;4893;15042;4136;13449;780;2680;1629;5122;2409;7802
350275;201601;1781;5989;1620;5708;454;1710;578;1949;1032;3659
350280;201601;21136;52036;13270;38853;2729;8550;2598;7676;5327;16226
350290;201601;1648;5335;1302;4618;272;1079;311;1038;583;2117
350300;201601;330;978;278;883;73;230;135;426;208;656
350310;201601;797;2644;703;2443;99;389;303;1019;402;1408
350315;201601;496;1570;395;1351;62;255;96;293;158;548
350320;201601;10591;32938;9371;30653;2560;8917;1332;4545;3892;13462
350330;201601;13365;37610;9026;27734;1775;5416;2742;8086;4517;13502
350335;201601;315;1034;273;944;24;72;182;656;206;728
350340;201601;1059;3180;747;2554;140;551;202;667;342;1218
350350;201601;698;2181;601;2024;114;452;212;686;326;1138
350360;201601;756;2577;651;2356;183;702;225;841;408;1543
350370;201601;586;1762;437;1433;79;287;81;241;160;528
350380;201601;3978;11374;2658;9076;662;2523;592;1818;1254;4341
350390;201601;8367;26088;7500;24494;2259;7693;2681;8590;4940;16283
350395;201601;338;946;168;587;23;90;33;112;56;202
350400;201601;7538;21682;6136;19199;1406;4897;2300;6921;3706;11818
350410;201601;7775;25959;6068;22503;1561;6389;835;2992;2396;9381
350420;201601;514;1561;367;1293;66;281;22;76;88;357
350430;201601;668;2090;547;1870;118;443;232;757;350;1200
350440;201601;1157;3639;1044;3418;262;883;460;1489;722;2372
350450;201601;7218;22026;5737;19022;1311;4693;1260;4036;2571;8729
350460;201601;1260;3592;849;2753;165;592;235;703;400;1295
350470;201601;221;618;180;545;30;114;100;282;130;396
350480;201601;748;2276;529;1798;75;288;87;255;162;543
350490;201601;1744;5244;1511;4891;376;1333;546;1646;922;2979
350500;201601;534;1587;467;1475;99;345;217;672;316;1017
350510;201601;1000;3038;791;2601;130;505;309;939;439;1444
350520;201601;1284;4729;1010;4011;243;1062;154;607;397;1669
350530;201601;2188;6494;1831;5769;531;1717;526;1572;1057;3289
350535;201601;1236;3976;1163;3852;149;606;761;2411;910;3017
350540;201601;1711;4911;1358;4280;385;1252;401;1317;786;2569
350550;201601;10717;28570;7436;23215;1514;5318;2375;7082;3889;12400
350560;201601;3028;10098;2737;9469;386;1425;1418;4983;1804;6408
350570;201601;16984;56564;15303;53102;4432;16534;5358;17810;9790;34344
350580;201601;1563;4870;1141;3927;243;912;129;387;372;1299
350590;201601;3902;12093;3033;10349;779;2944;974;3053;1753;5997
350600;201601;39070;95751;26123;74166;4110;12530;11306;30439;15416;42969
350610;201601;6749;19796;5392;17438;1103;3966;2252;7144;3355;11110
350620;201601;374;1060;277;912;58;225;118;362;176;587
350630;201601;1503;4462;1168;3844;246;959;335;978;581;1937
350635;201601;5893;17595;4580;15279;1045;3792;1672;5527;2717;9319
350640;201601;693;2174;492;1698;85;325;91;295;176;620
350650;201601;7309;22208;4454;15389;992;3835;444;1419;1436;5254
350660;201601;4235;12552;3580;11487;728;2564;1862;5835;2590;8399
350670;201601;1571;4898;1457;4686;286;955;841;2675;1127;3630
350680;201601;997;3030;793;2631;168;625;310;1018;478;1643
350690;201601;792;2627;639;2324;134;523;179;634;313;1157
350700;201601;4035;11930;2690;9440;716;2716;570;1777;1286;4493
350710;201601;2429;7639;2184;7211;321;1193;1321;4294;1642;5487
350715;201601;792;2428;692;2236;219;746;217;642;436;1388
350720;201601;118;350;104;328;30;96;41;131;71;227
350730;201601;361;1369;349;1338;97;416;125;466;222;882
350740;201601;1772;5501;1325;4466;227;852;370;1123;597;1975
350745;201601;376;1186;272;922;44;164;116;352;160;516
350750;201601;9457;28547;7499;24753;1678;6103;1500;4555;3178;10658
350760;201601;12478;36479;10056;32217;2433;8644;3034;8961;5467;17605
350770;201601;677;1944;463;1536;65;245;206;664;271;909
350775;201601;531;1448;447;1321;59;217;253;729;312;946
350780;201601;1750;5382;1374;4637;388;1426;168;589;556;2015
350790;201601;1861;5772;1391;4854;326;1230;263;808;589;2038
350800;201601;2866;9572;2697;9306;421;1700;1670;5610;2091;7310
350810;201601;1927;5458;1600;4998;462;1541;584;1842;1046;3383
350820;201601;525;1420;390;1168;63;237;174;472;237;709
350830;201601;815;2533;554;1942;82;294;121;368;203;662
350840;201601;2280;8090;1889;7187;538;2184;320;1106;858;3290
350850;201601;5650;18818;4792;16949;1474;5489;1000;3447;2474;8936
350860;201601;3043;9482;2927;9320;223;903;2276;7171;2499;8074
350870;201601;2594;8257;2171;7596;533;2123;1203;4218;1736;6341
350880;201601;1165;3882;983;3502;226;858;218;763;444;1621
350890;201601;597;1697;408;1289;54;200;86;201;140;401
350900;201601;3437;11198;2647;9414;657;2568;271;901;928;3469
350910;201601;776;2345;681;2150;226;747;242;739;468;1486
350920;201601;9559;27527;8635;25943;1022;3417;5796;16772;6818;20189
350925;201601;4509;13982;3743;12460;899;3191;1296;3943;2195;7134
350930;201601;1549;4230;1240;3684;140;455;780;2229;920;2684
350940;201601;1713;5642;1564;5421;291;1173;886;3000;1177;4173
350945;201601;871;2744;746;2517;117;477;404;1314;521;1791
350950;201601;64847;196121;52503;170974;11876;42406;20198;62616;32074;105022
350960;201601;4315;14395;3697;13124;656;2620;1984;6751;2640;9371
350970;201601;4105;14132;3499;12709;1076;4257;661;2099;1737;6356
350980;201601;568;1865;514;1779;210;764;167;593;377;1357
350990;201601;1635;5657;1400;5218;415;1669;335;1242;750;2911
350995;201601;716;2485;687;2433;98;455;434;1445;532;1900
351000;201601;2934;8779;2461;7903;335;1196;1131;3439;1466;4635
351010;201601;323;916;204;669;49;178;63;209;112;387
351015;201601;767;2626;644;2395;148;607;273;996;421;1603
351020;201601;7770;24339;6765;22801;1676;5940;2988;10212;4664;16152
351030;201601;1602;5711;1440;5330;314;1358;437;1484;751;2842
351040;201601;3101;9433;2838;9000;438;1568;1802;5507;2240;7075
351050;201601;13428;38371;9584;31608;2324;8430;2308;7534;4632;15964
351060;201601;32489;95806;26718;85402;5839;20400;11373;35426;17212;55826
351070;201601;1454;4100;991;3252;280;1004;107;301;387;1305
351080;201601;2490;7216;1907;6492;475;1779;814;2679;1289;4458
351090;201601;345;1184;281;1048;57;245;47;175;104;420
351100;201601;1997;6102;1607;5302;456;1566;351;1226;807;2792
351110;201601;6963;17281;3838;12208;782;2854;743;2220;1525;5074
351120;201601;598;1729;486;1507;49;185;250;674;299;859
351130;201601;963;2681;521;1770;79;291;91;291;170;582
351140;201601;1608;5405;1329;4832;389;1506;294;1015;683;2521
351150;201601;1460;5135;1103;4215;176;734;167;568;343;1302
351160;201601;1187;4088;1048;3768;267;1086;330;1086;597;2172
351170;201601;1316;4216;1088;3727;199;737;440;1441;639;2178
351190;201601;742;2384;586;1981;103;352;132;450;235;802
351200;201601;1953;5781;1654;5221;307;1091;545;1551;852;2642
351210;201601;1008;3000;765;2519;165;597;240;723;405;1320
351220;201601;3070;10344;2804;9802;547;2106;1316;4517;1863;6623
351230;201601;1600;5026;1355;4575;258;1039;680;2206;938;3245
351240;201601;1057;3325;799;2774;216;808;187;567;403;1375
351250;201601;873;2511;588;1912;106;366;192;588;298;954
351260;201601;888;2618;774;2384;167;532;303;902;470;1434
351270;201601;304;1069;269;997;58;255;102;336;160;591
351280;201601;4606;13516;3518;11274;698;2447;1181;3589;1879;6036
351290;201601;937;2673;699;2213;159;509;270;843;429;1352
351300;201601;11920;38820;8958;32514;2098;8392;2514;8969;4612;17361
351310;201601;2946;8992;2396;8020;457;1762;1071;3330;1528;5092
351320;201601;849;2826;734;2578;147;594;219;680;366;1274
351330;201601;255;701;208;631;83;258;43;121;126;379
351340;201601;5483;18297;4770;16902;1340;5040;1700;6026;3040;11066
351350;201601;7176;23012;6202;21005;1726;6072;1891;6084;3617;12156
351360;201601;3984;12416;3649;11777;872;3091;1163;3442;2035;6533
351370;201601;2084;6407;1661;5548;346;1306;608;1864;954;3170
351380;201601;35668;104671;32330;98603;6385;21005;13690;40801;20075;61806
351385;201601;193;598;177;570;36;127;81;244;117;371
351390;201601;1035;3385;881;3087;235;948;316;993;551;1941
351400;201601;829;2778;790;2691;314;1138;242;806;556;1944
351410;201601;2433;7276;2139;6770;341;1148;1226;3798;1567;4946
351420;201601;306;873;208;685;46;158;50;164;96;322
351430;201601;773;2416;721;2332;96;337;523;1676;619;2013
351440;201601;3189;9520;2473;7981;520;1718;373;1098;893;2816
351450;201601;1524;4296;1267;3910;311;1000;486;1583;797;2583
351460;201601;650;1958;554;1797;285;945;132;428;417;1373
351470;201601;940;2826;837;2631;190;666;336;1004;526;1670
351480;201601;2652;8710;2453;8385;407;1762;1350;4387;1757;6149
351490;201601;1663;5496;1486;5131;181;783;865;2831;1046;3614
351492;201601;201;623;159;529;16;65;91;294;107;359
351495;201601;158;510;126;427;28;115;45;131;73;246
351500;201601;23189;66569;17991;57032;4441;15487;6571;19869;11012;35356
351510;201601;8134;25190;6695;22317;1573;5687;3060;10039;4633;15726
351512;201601;435;1266;334;1050;55;164;178;572;233;736
351515;201601;2138;6726;1536;5390;364;1386;368;1168;732;2554
351518;201601;1989;6205;1372;5068;330;1406;384;1291;714;2697
351519;201601;746;2201;556;1784;102;396;156;380;258;776
351520;201601;745;2002;377;1304;56;230;59;182;115;412
351530;201601;358;1096;263;877;35;116;67;187;102;303
351535;201601;2220;5754;1732;5042;167;565;1085;3049;1252;3614
351540;201601;1680;5087;1354;4465;421;1501;184;605;605;2106
351550;201601;4715;13813;3373;11068;669;2490;1145;3631;1814;6121
351560;201601;341;1097;297;1016;63;256;45;146;108;402
351565;201601;157;527;145;497;23;84;62;211;85;295
351570;201601;11095;33918;9374;30488;2042;7175;4761;15040;6803;22215
351580;201601;317;845;197;594;51;144;49;152;100;296
351590;201601;401;1069;279;847;30;98;110;322;140;420
351600;201601;1642;4573;1397;4161;230;759;685;1921;915;2680
351610;201601;636;1748;495;1508;59;226;223;614;282;840
351620;201601;17361;55390;13458;47528;2759;10876;3107;9769;5866;20645
351630;201601;18226;57587;16426;54712;3714;13182;8847;29204;12561;42386
351640;201601;11441;34227;9344;30499;1677;5999;5007;16035;6684;22034
351650;201601;427;1291;214;734;37;149;28;79;65;228
351660;201601;738;2369;557;1903;116;423;115;346;231;769
351670;201601;3724;11592;3086;10234;561;2089;1358;4218;1919;6307
351680;201601;603;1879;387;1375;69;253;65;232;134;485
351685;201601;356;1101;318;1035;82;258;150;499;232;757
351690;201601;1019;3035;729;2406;134;477;199;585;333;1062
351700;201601;1110;3269;958;2976;236;718;362;1111;598;1829
351710;201601;541;1796;456;1619;80;273;161;569;241;842
351720;201601;1528;4648;1052;3502;201;701;283;886;484;1587
351730;201601;1035;2974;842;2703;251;931;307;948;558;1879
351740;201601;3954;10757;3166;9233;644;2000;1083;3028;1727;5028
351750;201601;1059;3403;723;2636;164;666;163;570;327;1236
351760;201601;3439;10774;2844;9484;754;2683;913;2859;1667;5542
351770;201601;2101;6614;1802;6104;501;1794;745;2423;1246;4217
351780;201601;1474;4119;884;2829;145;499;208;641;353;1140
351790;201601;962;2831;846;2652;242;742;360;1181;602;1923
351800;201601;441;982;287;765;35;93;134;356;169;449
351810;201601;935;2678;835;2544;105;335;598;1831;703;2166
351820;201601;2316;7320;1774;6218;440;1627;160;529;600;2156
351830;201601;3675;11564;2863;9747;499;1912;1288;4209;1787;6121
351840;201601;6562;21798;5716;20134;1451;5537;1923;6597;3374;12134
351850;201601;1769;4909;1282;4052;186;732;583;1643;769;2375
351860;201601;3181;10147;2773;9309;728;2612;1025;3299;1753;5911
351870;201601;27349;81829;23175;74338;6458;21816;9406;29857;15864;51673
351880;201601;104602;329735;89916;300060;25833;91460;22018;70976;47851;162436
351885;201601;520;1843;490;1785;132;491;198;725;330;1216
351890;201601;603;1844;476;1594;111;413;80;231;191;644
351900;201601;1187;3616;998;3314;269;949;298;990;567;1939
351905;201601;423;1332;345;1187;47;194;184;575;231;769
351907;201601;16609;49031;13866;43990;1707;6469;8329;25488;10036;31957
351910;201601;922;2904;790;2617;153;569;342;1084;495;1653
351920;201601;968;2644;845;2466;118;404;502;1426;620;1830
351925;201601;845;2658;716;2405;120;424;319;1029;439;1453
351930;201601;2475;8040;2354;7814;457;1899;1557;4802;2014;6701
351940;201601;925;2789;777;2505;165;588;317;974;482;1562
351950;201601;1408;3877;995;3111;138;467;490;1519;628;1986
351960;201601;3987;11464;2894;9450;636;2298;1111;3603;1747;5901
351970;201601;4744;17031;4198;15993;1198;4902;1383;5151;2581;10053
351980;201601;831;2506;652;2127;123;442;214;622;337;1064
351990;201601;1421;4044;1150;3543;243;879;208;540;451;1419
352000;201601;2170;6978;1964;6565;433;1540;889;2814;1322;4354
352010;201601;1577;5315;1381;4869;327;1252;281;986;608;2238
352020;201601;1325;4147;1141;3815;263;966;409;1299;672;2265
352030;201601;4651;13677;3871;12523;888;3009;1935;6317;2823;9326
352040;201601;1849;6056;1534;5369;307;1176;322;1070;629;2246
352042;201601;3128;8734;2029;6363;404;1380;878;2680;1282;4060
352044;201601;1283;4156;980;3476;184;727;163;512;347;1239
352050;201601;9546;28807;6520;22263;1408;5389;1178;3582;2586;8971
352060;201601;671;2001;552;1784;116;431;215;643;331;1074
352070;201601;771;1992;610;1726;136;410;200;557;336;967
352080;201601;389;1125;277;917;47;161;95;300;142;461
352090;201601;1288;4423;1075;3897;206;847;196;645;402;1492
352100;201601;2446;7441;1845;6332;464;1780;587;1868;1051;3648
352110;201601;453;1581;385;1445;111;432;136;477;247;909
352115;201601;400;1276;348;1179;58;207;159;511;217;718
352120;201601;866;2734;717;2462;122;510;351;1134;473;1644
352130;201601;1733;4968;1180;3870;323;1091;257;780;580;1871
352140;201601;1698;4879;1022;3452;156;558;340;1100;496;1658
352150;201601;710;2180;563;1896;145;504;231;770;376;1274
352160;201601;967;2677;762;2302;150;499;249;660;399;1159
352170;201601;2547;7706;2302;7229;443;1489;1180;3479;1623;4968
352180;201601;3165;9056;2663;8079;620;2007;926;2684;1546;4691
352190;201601;1097;3289;877;2827;150;587;274;689;424;1276
352200;201601;350;1230;283;1091;55;240;115;427;170;667
352210;201601;15430;41823;12625;37789;2332;7414;7205;21833;9537;29247
352215;201601;540;1687;498;1629;63;225;290;931;353;1156
352220;201601;11645;37608;9812;33876;3180;11728;2291;7967;5471;19695
352230;201601;11761;39420;10220;36592;2820;11101;3536;12234;6356;23335
352240;201601;11748;34101;9155;29608;2635;9630;2593;7513;5228;17143
352250;201601;21260;68483;18609;63087;5360;19375;5392;18256;10752;37631
352260;201601;5057;14402;3299;10756;611;2216;1075;3232;1686;5448
352265;201601;830;2683;715;2478;75;340;419;1372;494;1712
352270;201601;1665;5745;1406;5185;366;1426;312;1146;678;2572
352280;201601;2088;6321;1737;5722;427;1603;601;1863;1028;3466
352290;201601;1047;3327;893;3001;208;822;301;894;509;1716
352300;201601;903;2658;713;2309;165;572;289;873;454;1445
352310;201601;37465;111778;30982;100861;7867;26980;15129;49531;22996;76511
352320;201601;5366;16514;4644;15175;1297;4529;1369;4053;2666;8582
352330;201601;1909;6112;1628;5717;520;1947;432;1509;952;3456
352340;201601;5161;16434;3961;14086;998;3880;672;2173;1670;6053
352350;201601;1534;5259;1381;4947;277;1130;486;1652;763;2782
352360;201601;994;3056;866;2809;168;655;527;1608;695;2263
352370;201601;788;2719;714;2554;132;525;330;1147;462;1672
352380;201601;907;2897;778;2661;236;923;169;550;405;1473
352390;201601;17458;46944;11748;36208;2008;7054;5341;15379;7349;22433
352400;201601;3805;10692;2526;8245;689;2364;650;1964;1339;4328
352410;201601;2788;8458;2375;7765;605;2069;833;2643;1438;4712
352420;201601;819;2344;697;2112;172;553;294;866;466;1419
352430;201601;5998;18000;5020;16450;1676;6011;1440;4623;3116;10634
352440;201601;14553;44157;11832;38952;2857;10007;3979;12824;6836;22831
352450;201601;596;1808;414;1452;86;338;99;313;185;651
352460;201601;2224;7251;1873;6583;521;2039;455;1429;976;3468
352470;201601;3983;10963;2533;8206;399;1426;759;2325;1158;3751
352480;201601;4231;11613;3302;9895;637;2160;1176;3203;1813;5363
352490;201601;628;2180;500;1855;89;371;110;369;199;740
352500;201601;7841;22929;6897;21537;3262;10918;1700;4694;4962;15612
352510;201601;2734;8593;2169;7536;638;2445;484;1602;1122;4047
352520;201601;1902;6694;1687;6174;435;1731;681;2436;1116;4167
352530;201601;7731;24611;5916;20656;1495;5597;755;2286;2250;7883
352540;201601;474;1463;354;1196;60;228;93;282;153;510
352550;201601;841;2789;601;2218;138;580;99;339;237;919
352560;201601;612;1827;443;1454;75;233;115;343;190;576
352570;201601;1744;5756;1330;4814;272;1138;242;767;514;1905
352580;201601;782;2328;677;2162;143;499;357;1125;500;1624
352585;201601;208;670;174;609;56;212;31;115;87;327
352590;201601;11945;36622;9632;32137;2579;9298;3751;11774;6330;21072
352600;201601;1478;4539;1314;4249;331;1163;544;1667;875;2830
352610;201601;3131;9625;2606;8764;757;2850;690;2198;1447;5048
352620;201601;4937;15187;4537;14602;944;3283;2512;7905;3456;11188
352630;201601;585;1889;554;1809;122;473;217;650;339;1123
352640;201601;2488;7686;2078;6881;263;1004;1129;3656;1392;4660
352650;201601;762;2293;571;1890;119;414;148;468;267;882
352660;201601;979;3327;782;2887;150;622;176;648;326;1270
352670;201601;10008;30155;6326;22080;1431;5441;536;1770;1967;7211
352680;201601;2785;9356;2145;7889;497;2028;591;1959;1088;3987
352690;201601;28957;79802;20594;63227;3372;11359;9440;27766;12812;39125
352700;201601;573;1716;477;1570;134;493;207;660;341;1153
352710;201601;5204;15081;3979;12692;945;3352;1355;4109;2300;7461
352720;201601;7162;23211;6425;21632;1888;6407;1956;6585;3844;12992
352725;201601;385;1077;238;779;36;142;85;257;121;399
352730;201601;2026;6748;1828;6235;366;1338;622;1879;988;3217
352740;201601;1866;5256;1519;4688;237;878;867;2514;1104;3392
352750;201601;448;1284;230;786;35;131;41;130;76;261
352760;201601;1090;3738;935;3370;284;1069;315;1080;599;2149
352770;201601;717;2250;624;2069;136;499;247;792;383;1291
352780;201601;563;1884;464;1669;96;385;125;420;221;805
352790;201601;601;1737;444;1463;90;301;92;308;182;609
352800;201601;896;3207;660;2582;144;620;169;589;313;1209
352810;201601;1093;2861;723;2150;133;434;217;613;350;1047
352820;201601;579;1602;424;1357;97;359;88;278;185;637
352830;201601;492;1415;306;989;49;183;41;106;90;289
352840;201601;3440;11754;3080;10991;948;3535;981;3438;1929;6973
352850;201601;7987;24767;6688;22591;1768;6359;2214;7396;3982;13755
352860;201601;730;2432;667;2294;157;570;221;728;378;1298
352870;201601;862;2149;618;1691;61;239;358;870;419;1109
352880;201601;2176;6165;1619;5067;297;947;521;1547;818;2494
352885;201601;196;668;185;640;22;85;118;391;140;476
352890;201601;619;1664;451;1328;61;212;203;535;264;747
352900;201601;19130;55893;14212;46152;2871;10235;5024;15588;7895;25823
352910;201601;340;1001;202;673;20;71;25;73;45;144
352920;201601;2193;6639;1681;5588;340;1283;647;1970;987;3253
352930;201601;5391;16700;4245;14214;1041;3740;920;2942;1961;6682
352940;201601;21423;69408;17933;61406;5679;20877;2111;6661;7790;27538
352950;201601;285;834;182;644;40;165;33;101;73;266
352960;201601;561;1714;360;1255;56;220;53;175;109;395
352965;201601;352;1005;225;726;52;166;33;91;85;257
352970;201601;2965;7514;2380;6646;305;877;1505;4240;1810;5117
352980;201601;1160;3522;968;3224;211;692;525;1861;736;2553
352990;201601;3888;12324;3446;11578;920;3484;1333;4219;2253;7703
353000;201601;452;1279;255;825;29;98;36;110;65;208
353010;201601;2910;8124;2154;6663;514;1814;555;1482;1069;3296
353020;201601;4018;10973;2583;7904;350;1233;904;2471;1254;3704
353030;201601;3566;10500;2903;9298;812;2806;560;1709;1372;4515
353040;201601;530;1459;450;1337;114;381;140;387;254;768
353050;201601;4523;15131;3804;13694;1096;4205;1303;4547;2399;8752
353060;201601;33811;102051;30936;97568;3415;12991;22337;67925;25752;80916
353070;201601;9589;29776;6972;24251;1673;6173;1647;5756;3320;11929
353080;201601;4901;15485;3394;12197;693;2770;693;2324;1386;5094
353090;201601;487;1642;440;1549;41;166;249;820;290;986
353100;201601;243;665;123;410;24;78;20;63;44;141
353110;201601;7051;21597;6034;19959;1491;5267;3037;10124;4528;15391
353120;201601;648;1918;412;1371;86;334;98;268;184;602
353130;201601;2347;6784;1895;6090;592;2031;555;1741;1147;3772
353140;201601;2196;5995;1695;5035;404;1297;657;1838;1061;3135
353150;201601;1564;4710;1271;4210;335;1160;333;1119;668;2279
353160;201601;649;1850;421;1370;90;308;56;133;146;441
353170;201601;387;1280;351;1224;96;428;158;499;254;927
353180;201601;7729;22135;6162;19348;1112;3818;3000;9167;4112;12985
353190;201601;3428;10430;2864;9216;520;1886;1405;4227;1925;6113
353200;201601;885;2972;730;2611;221;873;179;597;400;1470
353205;201601;346;1130;305;1052;72;252;116;408;188;660
353210;201601;952;2423;684;1953;35;131;449;1246;484;1377
353215;201601;354;1137;311;1038;51;198;112;322;163;520
353220;201601;616;1932;508;1697;123;440;102;310;225;750
353230;201601;783;2543;715;2427;174;662;178;570;352;1232
353240;201601;1882;6064;1679;5671;369;1400;845;2735;1214;4135
353250;201601;1016;2748;774;2306;104;324;372;1082;476;1406
353260;201601;840;2313;605;1888;95;340;219;658;314;998
353270;201601;600;1777;526;1638;139;451;172;518;311;969
353280;201601;543;1782;447;1563;111;426;93;327;204;753
353282;201601;1562;5044;1471;4882;196;743;927;2964;1123;3707
353284;201601;331;887;192;592;34;103;48;147;82;250
353286;201601;139;418;99;330;16;49;15;54;31;103
353290;201601;540;1704;429;1511;74;323;228;747;302;1070
353300;201601;1301;4049;1087;3595;254;960;359;1058;613;2018
353310;201601;171;535;144;487;46;166;44;141;90;307
353320;201601;499;1439;438;1341;78;270;237;691;315;961
353325;201601;562;1845;475;1684;87;334;79;241;166;575
353330;201601;579;1681;389;1239;68;250;165;492;233;742
353340;201601;2527;7179;1672;5573;444;1564;398;1302;842;2866
353350;201601;3003;9022;2480;8034;736;2545;881;2709;1617;5254
353360;201601;368;1195;327;1107;41;164;207;670;248;834
353370;201601;592;1943;514;1762;63;251;276;910;339;1161
353380;201601;295;987;245;888;46;199;72;241;118;440
353390;201601;5591;15287;4011;12489;755;2540;1285;3802;2040;6342
353400;201601;446;1359;382;1232;97;348;75;201;172;549
353410;201601;554;1624;459;1467;84;288;251;802;335;1090
353420;201601;527;1469;369;1128;108;323;98;284;206;607
353430;201601;2065;7128;1563;5815;355;1409;185;642;540;2051
353440;201601;54318;172453;45596;153183;12197;42809;15193;49510;27390;92319
353450;201601;403;1207;335;1071;70;249;124;376;194;625
353460;201601;3210;9076;2727;8255;412;1390;1282;3950;1694;5340
353470;201601;7902;23848;5809;19641;1257;4689;1214;3829;2471;8518
353475;201601;1518;4279;1066;3308;195;645;290;822;485;1467
353480;201601;1312;3998;1167;3717;200;678;660;2040;860;2718
353490;201601;896;2578;719;2235;149;491;242;711;391;1202
353500;201601;916;2480;747;2201;249;735;305;884;554;1619
353510;201601;926;2958;685;2370;148;542;131;427;279;969
353520;201601;1035;2998;822;2654;150;557;320;995;470;1552
353530;201601;2373;7032;2078;6513;346;1277;1092;3274;1438;4551
353540;201601;1797;5500;1556;5090;407;1398;610;1949;1017;3347
353550;201601;5553;15308;4713;14020;533;1878;2941;8327;3474;10205
353560;201601;1966;6460;1639;5907;415;1693;422;1404;837;3097
353570;201601;411;1268;347;1145;64;214;202;640;266;854
353580;201601;2098;6440;1919;6145;326;1178;1216;3859;1542;5037
353590;201601;687;1987;523;1674;142;480;150;494;292;974
353600;201601;1633;4528;1466;4250;220;708;745;2091;965;2799
353610;201601;516;1738;389;1469;66;297;60;197;126;494
353620;201601;2050;6719;1745;6105;441;1654;487;1575;928;3229
353625;201601;311;866;191;638;43;157;49;165;92;322
353630;201601;1453;5086;1176;4387;216;879;128;410;344;1289
353640;201601;1231;3684;984;3162;125;427;482;1533;607;1960
353650;201601;6965;20540;5241;17000;1006;3393;1623;5177;2629;8570
353657;201601;271;852;239;786;36;135;72;225;108;360
353660;201601;1052;2743;796;2321;298;937;108;214;406;1151
353670;201601;3314;10700;2817;9641;903;3463;796;2433;1699;5896
353680;201601;644;2092;556;1937;192;759;189;611;381;1370
353690;201601;502;1349;286;935;48;169;59;148;107;317
353700;201601;1817;5645;1563;5136;291;1013;631;1993;922;3006
353710;201601;2896;6957;1386;4533;288;961;205;691;493;1652
353715;201601;456;1308;330;1050;28;111;82;234;110;345
353720;201601;1910;6003;1652;5603;320;1270;808;2593;1128;3863
353730;201601;4138;12494;3271;10722;659;2354;950;2845;1609;5199
353740;201601;1752;5239;1364;4482;360;1230;324;1050;684;2280
353750;201601;779;2621;601;2214;118;495;142;528;260;1023
353760;201601;9057;25237;7348;22803;1325;4574;4067;12428;5392;17002
353770;201601;739;2293;465;1627;66;229;21;45;87;274
353780;201601;3835;13265;3345;12267;1078;4173;857;3132;1935;7305
353790;201601;1917;6569;1591;5915;424;1803;295;1097;719;2900
353800;201601;15079;46061;12000;40611;3086;11387;3874;12835;6960;24222
353810;201601;974;3097;749;2614;153;601;218;747;371;1348
353820;201601;1223;4124;1114;3871;229;944;556;1773;785;2717
353830;201601;617;1665;482;1454;92;307;248;732;340;1039
353850;201601;1585;4996;1417;4675;305;1067;570;1843;875;2910
353860;201601;2372;7903;2022;7112;520;1981;508;1716;1028;3697
353870;201601;27160;78405;19064;62939;3827;13892;5284;15861;9111;29753
353880;201601;2430;7695;2055;7055;288;1192;1056;3568;1344;4760
353890;201601;2562;6287;1787;5042;292;883;825;2219;1117;3102
353900;201601;939;2917;688;2412;143;555;179;601;322;1156
353910;201601;964;3520;923;3432;247;921;505;1905;752;2826
353920;201601;2221;6555;1561;5168;324;1168;250;718;574;1886
353930;201601;4297;12936;2982;10536;718;2745;534;1900;1252;4645
353940;201601;1119;3532;897;3048;146;543;286;923;432;1466
353950;201601;3116;9957;2803;9359;443;1653;1622;5211;2065;6864
353960;201601;563;1780;433;1496;90;323;80;234;170;557
353970;201601;495;1435;431;1352;43;147;292;917;335;1064
353980;201601;11881;35877;10281;32868;2264;7713;4811;14914;7075;22627
353990;201601;302;972;276;916;44;180;131;408;175;588
354000;201601;2032;5787;1373;4458;245;851;119;364;364;1215
354010;201601;345;1040;287;948;69;230;154;524;223;754
354020;201601;4075;12803;3585;11725;957;3326;1131;3458;2088;6784
354025;201601;843;2342;610;1914;123;405;180;547;303;952
354030;201601;437;1228;305;995;48;170;124;388;172;558
354040;201601;698;1932;491;1539;53;182;244;707;297;889
354050;201601;874;2839;743;2573;199;753;177;589;376;1342
354060;201601;4708;14571;3344;11552;805;2962;832;2763;1637;5725
354070;201601;2508;8395;2160;7630;518;1966;394;1328;912;3294
354075;201601;1750;6522;1651;6310;393;1681;732;2731;1125;4412
354080;201601;1457;4486;1031;3544;200;705;184;572;384;1277
354085;201601;311;796;276;745;15;55;224;593;239;648
354090;201601;1236;3703;1184;3619;124;415;826;2561;950;2976
354100;201601;13798;46093;11442;41717;2886;11232;4527;16248;7413;27480
354105;201601;782;2397;699;2260;116;416;440;1384;556;1800
354110;201601;681;1882;546;1698;207;712;74;175;281;887
354120;201601;1812;5012;1395;4244;244;814;550;1563;794;2377
354130;201601;5783;16809;4462;14277;1663;5614;437;1207;2100;6821
354140;201601;25475;63848;15899;46936;3164;10048;4589;12501;7753;22549
354150;201601;3665;9964;2830;8453;463;1545;1325;3801;1788;5346
354160;201601;3126;10175;2611;9004;725;2686;911;3038;1636;5724
354165;201601;377;1359;332;1257;93;395;103;374;196;769
354170;201601;1252;3931;1000;3374;198;745;351;1076;549;1821
354180;201601;442;1321;393;1217;52;194;222;615;274;809
354190;201601;1460;4673;1226;4186;324;1217;366;1191;690;2408
354200;201601;956;2714;771;2393;108;386;332;947;440;1333
354210;201601;550;1773;470;1627;68;282;240;777;308;1059
354220;201601;2674;7838;2292;7151;495;1663;1004;3064;1499;4727
354230;201601;586;1933;531;1829;99;387;214;713;313;1100
354240;201601;1123;3667;842;3022;152;602;160;559;312;1161
354250;201601;651;1860;435;1477;141;519;106;380;247;899
354260;201601;7544;22342;6326;20353;1759;6090;1909;6129;3668;12219
354270;201601;1039;3586;895;3265;195;785;284;1012;479;1797
354280;201601;643;1973;592;1885;89;349;403;1215;492;1564
354290;201601;844;2942;765;2785;189;753;316;1159;505;1912
354300;201601;3273;10941;3159;10734;864;3005;1453;4897;2317;7902
354310;201601;817;2507;646;2169;137;487;287;968;424;1455
354320;201601;672;2024;563;1813;145;540;162;468;307;1008
354323;201601;401;1139;309;977;68;236;93;264;161;500
354325;201601;1174;3892;963;3390;187;746;356;1170;543;1916
354330;201601;6120;18527;5011;16361;1004;3654;2231;6836;3235;10490
354340;201601;22090;68259;18087;61174;5415;19760;6123;20147;11538;39907
354350;201601;1016;3027;942;2894;279;961;441;1229;720;2190
354360;201601;439;1404;290;1051;41;152;16;72;57;224
354370;201601;1088;3651;944;3373;111;495;534;1847;645;2342
354380;201601;822;2456;657;2162;191;740;91;241;282;981
354390;201601;12117;35931;8617;29158;1757;6458;1618;5356;3375;11814
354400;201601;1433;5004;1181;4399;246;992;314;1147;560;2139
354410;201601;5026;15578;4238;14124;1027;3600;1710;5692;2737;9292
354420;201601;1089;3309;822;2700;195;696;286;891;481;1587
354425;201601;2216;6425;1892;5829;587;1909;376;1161;963;3070
354430;201601;1245;4026;1142;3824;246;934;466;1516;712;2450
354440;201601;475;1427;354;1176;45;175;148;454;193;629
354450;201601;392;1125;233;792;33;136;36;99;69;235
354460;201601;823;2269;604;1902;167;569;229;712;396;1281
354470;201601;551;1532;432;1293;45;167;213;576;258;743
354480;201601;650;1808;554;1664;90;301;315;919;405;1220
354490;201601;647;2159;500;1811;75;281;154;526;229;807
354500;201601;1999;6565;1759;6155;655;2611;246;777;901;3388
354510;201601;674;1935;610;1833;93;264;385;1195;478;1459
354515;201601;263;878;202;740;37;157;68;229;105;386
354520;201601;6810;22134;3910;13682;745;2945;1400;4565;2145;7510
354530;201601;2765;9543;2481;8928;668;2645;968;3369;1636;6014
354540;201601;1175;3568;964;3189;342;1235;135;405;477;1640
354550;201601;421;1279;358;1145;62;212;172;531;234;743
354560;201601;1510;4290;1010;3199;177;550;380;1153;557;1703
354570;201601;790;2312;504;1640;73;250;66;191;139;441
354580;201601;9657;27469;7261;23089;1337;4622;2822;8537;4159;13159
354600;201601;1437;4792;1282;4467;277;1170;609;1987;886;3157
354610;201601;360;1041;213;690;26;74;39;115;65;189
354620;201601;357;1168;282;1037;72;328;125;434;197;762
354625;201601;257;827;190;682;32;121;52;173;84;294
354630;201601;1959;6616;1760;6188;704;2588;258;859;962;3447
354640;201601;3263;10713;2613;9316;535;2191;506;1642;1041;3833
354650;201601;827;2504;720;2293;95;333;460;1439;555;1772
354660;201601;2091;6075;1590;5196;200;745;893;2904;1093;3649
354670;201601;1311;4208;1021;3503;241;897;206;636;447;1533
354680;201601;4166;13704;3779;12941;1025;3765;1511;5082;2536;8847
354690;201601;731;2371;498;1787;89;326;113;404;202;730
354700;201601;1119;3209;791;2530;151;558;306;852;457;1410
354710;201601;493;1476;396;1268;48;174;170;480;218;654
354720;201601;220;591;136;432;43;133;33;100;76;233
354730;201601;7339;23975;5706;20620;1269;5026;2201;7717;3470;12743
354740;201601;227;702;138;503;18;78;27;94;45;172
354750;201601;2312;7009;1773;6044;489;1855;601;1968;1090;3823
354760;201601;1808;5721;1470;4993;414;1513;180;588;594;2101
354765;201601;265;730;144;470;13;50;14;31;27;81
354770;201601;2162;6028;1655;5177;581;1922;431;1294;1012;3216
354780;201601;46944;132091;40313;118429;6868;22617;21246;58707;28114;81324
354790;201601;723;2404;649;2248;121;466;320;1046;441;1512
354800;201601;1983;5822;1757;5530;443;1549;859;2658;1302;4207
354805;201601;910;2720;671;2209;58;201;141;425;199;626
354810;201601;572;1861;373;1376;62;285;55;150;117;435
354820;201601;914;3157;787;2883;171;744;203;662;374;1406
354830;201601;372;1048;288;899;70;231;121;347;191;578
354840;201601;585;1672;467;1462;97;314;222;689;319;1003
354850;201601;15823;48636;11876;40775;2567;9890;4532;14289;7099;24179
354860;201601;1310;4120;1125;3813;227;882;436;1391;663;2273
354870;201601;40890;121565;36581;112766;8645;28416;14818;45000;23463;73416
354880;201601;4017;11060;2298;7499;347;1333;622;1657;969;2990
354890;201601;15214;44319;12656;39786;3008;10173;4476;13646;7484;23819
354900;201601;405;1244;309;1041;65;226;63;207;128;433
354910;201601;6148;18325;3647;12945;561;2229;156;550;717;2779
354920;201601;393;1160;272;924;49;194;63;213;112;407
354925;201601;296;889;188;652;28;112;21;63;49;175
354930;201601;195;518;140;428;26;83;64;193;90;276
354940;201601;1765;6294;1460;5492;501;2023;164;558;665;2581
354950;201601;1375;4421;1178;4094;124;527;667;2272;791;2799
354960;201601;739;2310;643;2158;133;512;268;866;401;1378
354970;201601;3629;11872;3217;11041;569;2247;1695;5598;2264;7845
354980;201601;32335;80519;19963;60275;3455;11717;6146;17145;9601;28862
354990;201601;47026;138327;37755;120100;6763;23334;17809;54972;24572;78306
354995;201601;1613;4943;1378;4575;326;1110;689;2299;1015;3409
355000;201601;1324;4298;1172;4019;368;1448;205;609;573;2057
355010;201601;3348;10330;2654;8787;700;2430;854;2898;1554;5328
355020;201601;2706;9002;2095;7777;799;3236;412;1487;1211;4723
355030;201601;995498;2756870;852923;2484021;189618;598695;362223;1011787;551841;1610482
355040;201601;2346;7219;2078;6761;511;1769;1072;3437;1583;5206
355050;201601;1093;3350;889;2961;289;981;124;407;413;1388
355060;201601;4153;13873;3399;12316;768;3121;925;3066;1693;6187
355070;201601;5937;18543;5322;17560;1095;4201;2694;8294;3789;12495
355080;201601;931;3237;673;2633;107;496;40;145;147;641
355090;201601;1044;3567;889;3231;160;619;345;1256;505;1875
355100;201601;16268;50990;13743;46843;3742;14020;6045;20147;9787;34167
355110;201601;1132;3696;976;3404;280;1039;215;744;495;1783
355120;201601;584;1861;497;1692;102;421;175;554;277;975
355130;201601;572;1449;287;847;46;134;85;235;131;369
355140;201601;1044;3476;991;3395;222;849;516;1811;738;2660
355150;201601;3015;8757;2543;8017;539;1763;1272;4074;1811;5837
355160;201601;1440;4544;1226;4216;401;1548;347;1129;748;2677
355170;201601;8011;22231;6021;18935;1902;6385;1374;4442;3276;10827
355180;201601;2700;8416;2235;7574;574;2287;675;2067;1249;4354
355190;201601;1192;4037;1016;3679;362;1393;315;1119;677;2512
355200;201601;699;2529;652;2431;268;1086;131;456;399;1542
355210;201601;2412;7723;2134;7162;394;1521;1079;3430;1473;4951
355220;201601;29701;90337;24524;80189;8012;27558;5631;17569;13643;45127
355230;201601;1370;3799;778;2515;142;463;162;488;304;951
355240;201601;24510;69813;17453;55817;3580;12267;5618;17410;9198;29677
355250;201601;23889;77359;20960;71823;5887;21576;7738;25959;13625;47535
355255;201601;793;2186;527;1647;89;296;128;378;217;674
355260;201601;1168;3401;1000;3127;228;815;398;1104;626;1919
355270;201601;1463;4297;1375;4166;112;383;1092;3283;1204;3666
355280;201601;23361;68196;19234;60440;3633;12781;8119;24216;11752;36997
355290;201601;850;2679;702;2343;131;469;246;746;377;1215
355300;201601;1114;3607;927;3217;192;730;320;1038;512;1768
355310;201601;929;2842;783;2564;140;485;382;1256;522;1741
355320;201601;545;1702;470;1539;78;308;175;496;253;804
355330;201601;1735;5352;1236;4362;264;1038;429;1469;693;2507
355340;201601;2345;6189;2102;5786;368;1021;1223;3321;1591;4342
355350;201601;1244;4244;1011;3721;249;1006;266;933;515;1939
355360;201601;1047;3340;948;3142;142;485;626;2143;768;2628
355365;201601;243;718;165;585;36;141;46;160;82;301
355370;201601;7382;18134;5374;15661;1428;4512;2094;6464;3522;10976
355380;201601;3113;9396;2454;7947;535;1905;496;1329;1031;3234
355385;201601;788;2509;727;2416;277;999;180;533;457;1532
355390;201601;811;2310;620;1926;134;463;226;608;360;1071
355395;201601;1833;5517;1381;4500;210;719;559;1694;769;2413
355400;201601;8444;27807;7350;25565;2178;8210;2045;6861;4223;15071
355410;201601;14900;48898;12102;43343;3654;14337;2173;7916;5827;22253
355420;201601;701;2521;653;2422;207;846;157;590;364;1436
355430;201601;3245;9152;2703;8236;518;1698;1342;3943;1860;5641
355440;201601;877;2709;675;2274;116;409;186;572;302;981
355450;201601;3522;10043;2047;6795;357;1213;545;1704;902;2917
355460;201601;569;1559;379;1214;73;283;105;265;178;548
355465;201601;323;1053;279;970;57;222;69;239;126;461
355470;201601;703;2193;582;1956;119;437;255;832;374;1269
355475;201601;143;511;132;482;32;121;65;232;97;353
355480;201601;2660;9316;2444;8910;590;2323;1130;4059;1720;6382
355490;201601;925;2664;607;2009;111;379;127;396;238;775
355495;201601;685;2296;602;2112;116;437;186;639;302;1076
355500;201601;7170;20732;4798;15683;766;2752;793;2451;1559;5203
355510;201601;1945;5203;1110;3531;149;569;322;912;471;1481
355520;201601;422;988;223;606;31;101;90;217;121;318
355530;201601;394;939;170;530;17;62;26;68;43;130
355535;201601;637;1948;511;1712;148;568;108;296;256;864
355540;201601;7712;24398;7266;23681;1870;6486;3634;11500;5504;17986
355550;201601;669;2036;575;1899;125;489;256;831;381;1320
355560;201601;1182;3534;772;2635;145;563;71;174;216;737
355570;201601;178;555;120;434;19;74;10;36;29;110
355580;201601;1225;3424;850;2659;158;569;306;937;464;1506
355590;201601;214;560;173;487;24;76;91;244;115;320
355600;201601;1050;3225;879;2879;274;970;245;759;519;1729
355610;201601;1294;3645;1108;3341;205;694;517;1516;722;2210
355620;201601;3681;11522;2996;10033;508;1945;1321;4119;1829;6064
355630;201601;3163;9071;2027;6779;376;1355;463;1504;839;2859
355635;201601;850;2799;737;2614;89;366;489;1756;578;2122
355640;201601;2812;8949;2083;7477;339;1350;208;709;547;2059
355645;201601;3008;10364;2705;9878;459;1872;1552;5638;2011;7510
355650;201601;6279;19080;5369;17437;856;3233;3078;9365;3934;12598
355660;201601;1150;3665;937;3239;197;817;356;1148;553;1965
355670;201601;2339;7177;1714;5816;314;1255;713;2143;1027;3398
355680;201601;1562;5164;1154;4192;305;1183;180;636;485;1819
355690;201601;401;1253;299;1082;174;673;17;49;191;722
355695;201601;276;860;163;562;10;32;9;18;19;50
355700;201601;4945;16314;4223;14715;1031;3778;1492;5036;2523;8814
355710;201601;9704;24017;5791;16939;1311;4106;1301;3565;2612;7671
355715;201601;278;845;184;635;40;144;34;111;74;255
355720;201601;1486;4931;1239;4381;338;1291;341;1081;679;2372
355730;201601;738;2443;618;2173;193;692;134;473;327;1165
410010;201601;1310;4110;1141;3750;237;850;231;750;468;1600
410020;201601;1099;3633;964;3336;256;938;375;1282;631;2220
410030;201601;1104;3760;929;3323;212;817;145;507;357;1324
410040;201601;8993;29693;7899;27583;1992;7735;2162;7510;4154;15245
410045;201601;977;2768;692;2225;156;542;152;455;308;997
410050;201601;2413;6689;1541;4972;382;1299;123;325;505;1624
410060;201601;2161;6657;1920;6209;454;1552;800;2633;1254;4185
410070;201601;1607;4565;1240;3866;386;1310;243;698;629;2008
410080;201601;1304;3723;1048;3266;168;595;440;1272;608;1867
410090;201601;931;2953;868;2822;223;806;258;842;481;1648
410100;201601;2601;7926;1985;6516;428;1581;201;595;629;2176
410105;201601;355;1111;241;843;38;164;26;78;64;242
410110;201601;2587;7612;2111;6713;345;1220;631;1983;976;3203
410115;201601;492;1329;388;1140;59;182;121;323;180;505
410120;201601;2329;8075;2177;7805;698;2652;755;2748;1453;5400
410130;201601;1057;3362;977;3167;397;1325;210;649;607;1974
410140;201601;16040;42075;10982;33163;2264;7498;2738;8043;5002;15541
410150;201601;16113;40333;8514;25423;1594;5143;1183;3202;2777;8345
410160;201601;2823;8706;2550;8249;679;2438;868;2827;1547;5265
410165;201601;699;2042;553;1717;128;409;211;608;339;1017
410170;201601;2063;5994;1636;5090;443;1540;263;775;706;2315
410180;201601;9450;30088;8182;27402;2005;7262;2862;8941;4867;16203
410185;201601;520;1464;407;1252;93;288;88;245;181;533
410190;201601;1974;5830;1570;4919;310;1067;241;688;551;1755
410200;201601;3585;10079;2682;8334;545;1913;304;895;849;2808
410210;201601;2416;7189;1816;5901;300;1146;355;954;655;2100
410220;201601;617;1734;461;1446;79;293;132;392;211;685
410230;201601;1296;4071;1123;3741;264;1008;409;1329;673;2337
410240;201601;4073;12498;3712;11744;1201;4299;565;1677;1766;5976
410250;201601;2549;7073;1799;5539;436;1456;306;887;742;2343
410260;201601;1452;4349;1210;3926;290;1017;440;1406;730;2423
410270;201601;520;1459;390;1200;58;192;140;403;198;595
410275;201601;795;2429;565;1906;76;285;259;875;335;1160
410280;201601;2157;6271;1630;5229;336;1230;443;1340;779;2570
410290;201601;3255;9766;2764;8837;663;2244;1023;3299;1686;5543
410300;201601;667;1878;565;1668;94;306;239;629;333;935
410302;201601;394;1058;255;811;28;93;124;414;152;507
410304;201601;1163;3755;1057;3529;288;994;376;1315;664;2309
410305;201601;1726;4752;1454;4299;339;1093;743;2184;1082;3277
410310;201601;2110;6846;1917;6505;414;1558;707;2424;1121;3982
410315;201601;624;1818;406;1381;73;258;104;336;177;594
410320;201601;1167;3537;757;2583;93;364;63;191;156;555
410322;201601;517;1517;334;1118;62;214;68;222;130;436
410330;201601;1325;3631;1088;3182;240;744;285;830;525;1574
410335;201601;911;2697;785;2467;151;507;303;917;454;1424
410337;201601;784;2058;584;1689;81;279;201;518;282;797
410340;201601;487;1466;342;1084;44;158;126;354;170;512
410345;201601;1695;4892;1204;3833;266;909;289;892;555;1801
410347;201601;678;1860;479;1475;66;234;140;412;206;646
410350;201601;1000;3003;737;2468;150;556;110;316;260;872
410360;201601;3400;9511;2719;8328;455;1620;1239;3670;1694;5290
410370;201601;11301;33013;8363;26206;1489;5251;2173;5859;3662;11110
410380;201601;1192;3562;1072;3308;133;502;521;1553;654;2055
410390;201601;2376;7148;1953;6244;585;2003;466;1354;1051;3357
410395;201601;830;2771;733;2559;186;734;302;1044;488;1778
410400;201601;4162;12877;3567;11764;759;2825;1280;4071;2039;6896
410405;201601;829;2426;673;2142;156;541;216;697;372;1238
410410;201601;1218;3849;1173;3788;341;1311;467;1397;808;2708
410420;201601;6487;21025;5364;18490;1337;4956;671;2012;2008;6968
410425;201601;2725;8642;1987;7003;329;1232;168;582;497;1814
410430;201601;13624;36878;10017;30301;1968;6534;2701;7879;4669;14413
410440;201601;2687;8640;2409;8106;645;2411;910;2979;1555;5390
410442;201601;2568;8620;2267;7934;684;2464;586;2104;1270;4568
410445;201601;2207;7349;1928;6852;510;2040;563;2080;1073;4120
410450;201601;2020;5746;1573;4876;424;1373;149;365;573;1738
410460;201601;1892;5630;1506;4887;386;1289;325;1016;711;2305
410465;201601;1912;6339;1613;5710;349;1357;584;1947;933;3304
410470;201601;1634;5264;1356;4675;292;1156;303;1031;595;2187
410480;201601;27941;79168;18344;59058;3336;11458;1821;5156;5157;16614
410490;201601;10273;32308;8074;27706;1880;7205;1854;5845;3734;13050
410500;201601;1474;4675;1201;4062;428;1612;252;809;680;2421
410510;201601;2322;6196;1661;4891;294;881;598;1602;892;2483
410520;201601;2955;10306;2794;9984;847;3201;1023;3713;1870;6914
410530;201601;1468;4042;1072;3237;196;643;273;777;469;1420
410540;201601;2916;8679;2060;6870;420;1442;553;1848;973;3290
410550;201601;5724;16560;4020;12894;726;2572;507;1489;1233;4061
410560;201601;1150;3432;884;2893;201;758;238;664;439;1422
410570;201601;2501;8061;2261;7652;644;2376;690;2614;1334;4990
410580;201601;19646;59652;16142;52725;3983;14348;4135;12659;8118;27007
410590;201601;1331;4150;865;2924;120;401;151;462;271;863
410600;201601;1762;5184;1432;4545;352;1123;490;1585;842;2708
410610;201601;743;2098;579;1774;80;274;202;603;282;877
410620;201601;1619;5536;1215;4543;303;1234;117;422;420;1656
410630;201601;2378;7040;1711;5563;398;1408;213;576;611;1984
410640;201601;4273;11844;3196;9797;792;2824;472;1349;1264;4173
410645;201601;1072;3770;1014;3681;484;1853;201;783;685;2636
410650;201601;2000;6209;1624;5431;514;1802;205;647;719;2449
410655;201601;799;2305;618;1956;119;431;194;596;313;1027
410657;201601;707;1967;506;1555;84;295;166;442;250;737
410660;201601;2513;7363;1544;5168;319;1154;157;462;476;1616
410670;201601;863;2370;595;1811;107;347;158;430;265;777
410680;201601;2774;9119;2281;7926;654;2200;635;2400;1289;4600
410685;201601;609;1763;529;1628;43;140;372;1162;415;1302
410690;201601;107795;311386;77057;248119;15386;54611;16213;45895;31599;100506
410700;201601;2139;6544;1966;6217;518;1750;783;2382;1301;4132
410710;201601;860;2565;596;1981;131;445;136;402;267;847
410712;201601;780;2354;668;2137;237;813;170;575;407;1388
410715;201601;877;2801;655;2265;115;438;182;594;297;1032
410720;201601;3236;9496;2381;7724;477;1767;470;1372;947;3139
410725;201601;995;2853;712;2290;107;334;86;249;193;583
410730;201601;495;1392;403;1249;125;422;89;297;214;719
410740;201601;894;2654;648;2160;100;382;263;873;363;1255
410750;201601;1726;5061;1419;4418;295;999;423;1242;718;2241
410752;201601;281;772;151;496;28;105;41;114;69;219
410753;201601;409;1189;255;829;32;123;73;217;105;340
410754;201601;1004;3017;870;2793;61;198;560;1889;621;2087
410755;201601;776;1950;598;1674;93;286;316;852;409;1138
410760;201601;2251;6872;1963;6356;532;1875;536;1707;1068;3582
410765;201601;14805;44088;11218;37115;1812;6803;867;2645;2679;9448
410770;201601;883;2451;640;1971;169;586;104;299;273;885
410773;201601;1251;3612;1084;3361;191;684;616;1848;807;2532
410775;201601;1356;3930;1250;3785;293;988;449;1331;742;2319
410780;201601;517;1431;367;1155;88;277;115;410;203;687
410785;201601;716;2270;603;2013;195;709;110;355;305;1064
410790;201601;398;1289;357;1191;73;264;43;102;116;366
410800;201601;2678;6675;2076;5666;378;1221;714;1758;1092;2979
410810;201601;327;1011;276;905;54;200;103;339;157;539
410820;201601;799;2410;611;1987;139;499;84;255;223;754
410830;201601;29607;84368;23799;74489;6699;23309;7306;21901;14005;45210
410832;201601;909;2656;791;2427;86;322;438;1265;524;1587
410840;201601;6683;19588;4464;14897;897;3245;319;833;1216;4078
410845;201601;1202;3570;1025;3211;206;714;399;1212;605;1926
410850;201601;2640;7799;2374;7384;515;1793;997;3134;1512;4927
410855;201601;558;1557;403;1235;67;221;129;374;196;595
410860;201601;3755;10552;3008;9169;550;1809;1000;2953;1550;4762
410865;201601;1411;4868;1348;4750;354;1351;727;2627;1081;3978
410870;201601;1139;3522;1058;3392;254;869;605;1965;859;2834
410880;201601;3498;11206;2965;10103;582;2200;512;1685;1094;3885
410890;201601;853;2803;686;2456;177;726;62;197;239;923
410895;201601;1046;3622;936;3376;319;1225;204;696;523;1921
410900;201601;841;2308;596;1875;101;356;177;516;278;872
410910;201601;396;1046;300;872;37;119;146;412;183;531
410920;201601;784;2178;626;1910;161;561;200;594;361;1155
410930;201601;1545;4580;1315;4133;318;1174;406;1263;724;2437
410940;201601;19708;63588;16959;58588;5032;18861;4011;14097;9043;32958
410950;201601;1636;5440;1524;5234;221;790;1041;3588;1262;4378
410960;201601;6868;19060;4374;14333;1271;4566;770;2399;2041;6965
410965;201601;996;3050;837;2743;229;768;320;1047;549;1815
410970;201601;4300;12675;3386;10907;926;3432;560;1746;1486;5178
410975;201601;1550;4482;1239;3889;216;789;429;1290;645;2079
410980;201601;5457;15301;3473;11369;669;2454;585;1804;1254;4258
410990;201601;881;2565;554;1865;166;621;53;136;219;757
411000;201601;476;1427;355;1157;66;246;70;186;136;432
411005;201601;467;1403;292;980;66;250;26;69;92;319
411007;201601;2182;6858;1878;6209;545;1889;503;1646;1048;3535
411010;201601;3738;12874;3374;12073;869;3446;445;1527;1314;4973
411020;201601;2433;7550;2134;7049;677;2493;633;2046;1310;4539
411030;201601;634;1724;452;1366;73;245;102;284;175;529
411040;201601;642;1866;301;1020;47;167;56;200;103;367
411050;201601;1919;6647;1722;6226;492;1955;241;783;733;2738
411060;201601;1408;4315;1136;3724;217;815;120;347;337;1162
411065;201601;348;1026;276;886;53;174;91;288;144;462
411070;201601;5493;16449;4302;14047;1144;4130;812;2386;1956;6516
411080;201601;2084;6226;1847;5791;452;1587;407;1192;859;2779
411090;201601;771;1897;545;1554;70;254;111;295;181;549
411095;201601;1390;3978;1073;3333;160;578;264;721;424;1299
411100;201601;1277;3741;938;3038;153;605;137;389;290;994
411110;201601;559;1655;316;1071;35;131;31;87;66;218
411120;201601;1573;4758;1188;3919;295;1103;354;1080;649;2183
411125;201601;3933;12942;3758;12602;1087;3857;1366;4530;2453;8387
411130;201601;669;2013;507;1663;116;409;126;453;242;862
411140;201601;2048;7092;1761;6418;516;1958;570;2166;1086;4124
411150;201601;3960;11176;3034;9354;643;2139;393;1072;1036;3211
411155;201601;875;2403;654;1994;99;341;256;756;355;1097
411160;201601;208;600;167;527;33;107;33;93;66;200
411170;201601;634;2022;541;1806;127;475;174;549;301;1024
411180;201601;5332;15951;4399;14205;989;3562;1382;4463;2371;8025
411190;201601;1327;3845;1110;3433;274;967;224;610;498;1577
411200;201601;4096;12086;3285;10681;793;2910;1049;3246;1842;6156
411210;201601;1867;5377;1494;4702;403;1388;161;447;564;1835
411220;201601;1082;3083;864;2685;213;765;276;746;489;1511
411230;201601;1190;3314;751;2441;170;591;185;566;355;1157
411240;201601;1345;3223;745;2214;132;405;213;582;345;987
411250;201601;2097;6198;1760;5588;482;1682;421;1342;903;3024
411260;201601;290;814;197;650;24;86;74;232;98;318
411270;201601;1666;5222;1478;4871;259;995;633;1981;892;2976
411275;201601;1255;3747;1030;3241;254;838;196;574;450;1412
411280;201601;1410;4149;985;3250;181;653;148;450;329;1103
411290;201601;710;2074;543;1728;133;442;141;435;274;877
411295;201601;923;2618;827;2431;154;481;299;908;453;1389
411300;201601;1276;3254;913;2557;94;296;345;889;439;1185
411310;201601;802;2194;633;1918;72;248;200;607;272;855
411320;201601;5298;15319;3944;12791;984;3359;658;1930;1642;5289
411325;201601;1481;4685;1304;4308;275;978;621;2077;896;3055
411330;201601;2957;9165;2518;8330;799;2943;578;1925;1377;4868
411340;201601;894;2635;572;1875;54;213;186;573;240;786
411342;201601;675;1917;558;1685;158;510;164;445;322;955
411345;201601;854;2697;766;2533;213;769;305;1008;518;1777
411350;201601;2586;7769;1911;6374;489;1807;175;557;664;2364
411360;201601;555;1396;382;1100;46;164;162;402;208;566
411370;201601;42492;119962;33581;103690;5529;19639;13198;37832;18727;57471
411373;201601;1405;4382;1219;4042;263;978;258;856;521;1834
411375;201601;1083;2980;798;2428;159;494;182;522;341;1016
411380;201601;1174;3200;713;2148;115;359;190;520;305;879
411390;201601;1766;5243;1486;4686;292;1030;431;1243;723;2273
411400;201601;1988;5685;1506;4669;262;898;372;1087;634;1985
411410;201601;1920;5801;1496;4832;316;1145;339;937;655;2082
411420;201601;3772;10837;2662;8425;372;1324;370;931;742;2255
411430;201601;2936;8882;2457;8093;638;2318;1064;3442;1702;5760
411435;201601;424;1405;357;1235;83;310;130;439;213;749
411440;201601;2539;8226;2298;7758;734;2596;505;1830;1239;4426
411450;201601;2152;6629;1959;6261;399;1295;970;3221;1369;4516
411460;201601;3119;9112;1736;5965;271;1050;78;251;349;1301
411470;201601;803;2411;551;1820;71;246;76;231;147;477
411480;201601;4239;12737;3199;10756;807;3013;429;1347;1236;4360
411490;201601;1365;4158;1150;3777;238;857;253;753;491;1610
411500;201601;1787;4754;1258;3819;258;854;320;949;578;1803
411510;201601;1939;5865;1607;5177;445;1580;245;712;690;2292
411520;201601;24826;67472;15351;47853;2693;9128;2873;8333;5566;17461
411530;201601;988;2742;707;2256;157;575;112;304;269;879
411535;201601;498;1514;271;969;30;131;24;72;54;203
411540;201601;2845;7760;2135;6324;532;1805;497;1272;1029;3077
411545;201601;920;3082;840;2937;154;577;507;1819;661;2396
411550;201601;770;2086;626;1866;209;682;119;364;328;1046
411560;201601;2255;6725;1659;5383;280;1036;173;477;453;1513
411570;201601;6294;16853;4702;14300;1093;3794;919;2904;2012;6698
411573;201601;819;2454;768;2364;139;443;447;1413;586;1856
411575;201601;1445;4501;1216;4012;229;802;419;1368;648;2170
411580;201601;3779;10738;2551;8290;321;1242;330;948;651;2190
411585;201601;681;2197;380;1338;82;301;56;185;138;486
411590;201601;337;1035;297;971;46;174;123;378;169;552
411600;201601;291;841;201;696;44;172;70;251;114;423
411605;201601;1613;4447;1135;3488;182;631;387;1163;569;1794
411610;201601;2035;5707;1705;5155;342;1146;823;2391;1165;3537
411620;201601;2495;7926;2298;7602;631;2273;1004;3358;1635;5631
411630;201601;467;1212;289;948;52;213;39;113;91;326
411640;201601;432;1313;346;1121;56;186;106;307;162;493
411650;201601;187;615;147;534;27;117;34;119;61;236
411660;201601;823;2267;650;1944;114;367;275;809;389;1176
411670;201601;1068;3000;879;2600;184;589;288;813;472;1402
411680;201601;1339;4127;1200;3873;181;619;742;2479;923;3098
411690;201601;3143;9259;2490;8043;641;2159;482;1644;1123;3803
411695;201601;758;2467;616;2156;138;534;182;637;320;1171
411700;201601;1655;4850;1172;3860;213;766;170;503;383;1269
411705;201601;1833;6360;1611;5915;360;1299;788;3091;1148;4390
411710;201601;1557;4613;1261;3999;314;1060;209;659;523;1719
411720;201601;815;2317;629;1943;89;290;172;487;261;777
411721;201601;684;2058;573;1838;149;522;61;185;210;707
411722;201601;620;1852;430;1439;79;307;99;278;178;585
411725;201601;1349;4335;871;3111;190;711;141;505;331;1216
411727;201601;1756;5196;1337;4289;320;1096;260;808;580;1904
411729;201601;551;1469;398;1187;121;368;68;177;189;545
411730;201601;5379;15480;4503;13806;1660;5154;1039;3205;2699;8359
411740;201601;607;1751;404;1287;67;230;126;380;193;610
411745;201601;852;2464;703;2163;130;431;218;662;348;1093
411750;201601;4520;13492;3461;11101;723;2558;898;2758;1621;5316
411760;201601;7369;21669;6345;19919;2045;6877;1459;4651;3504;11528
411770;201601;3216;10640;2686;9429;772;2933;464;1550;1236;4483
411780;201601;2518;7996;2384;7789;327;1163;1496;5101;1823;6264
411790;201601;3107;8834;2255;7098;600;2119;514;1536;1114;3655
411800;201601;1117;3227;775;2520;116;424;106;304;222;728
411810;201601;1521;4437;1255;3908;266;890;401;1168;667;2058
411820;201601;12878;41690;10909;37641;3758;13426;2308;8183;6066;21609
411830;201601;502;1330;404;1172;117;385;14;61;131;446
411840;201601;9868;28376;7428;23708;1642;5747;1268;4001;2910;9748
411845;201601;488;1489;313;1034;41;142;45;130;86;272
411850;201601;6585;19767;5433;17385;1316;4551;1309;4112;2625;8663
411860;201601;832;2578;672;2237;166;583;202;651;368;1234
411870;201601;814;2663;565;1982;103;428;100;310;203;738
411880;201601;2149;6250;1759;5574;412;1515;363;1051;775;2566
411885;201601;821;2267;684;2023;127;468;198;528;325;996
411890;201601;1020;3124;686;2319;98;382;50;128;148;510
411900;201601;934;2938;679;2334;157;549;94;325;251;874
411910;201601;1139;3751;894;3175;249;959;192;622;441;1581
411915;201601;14919;41071;9771;30876;1762;6041;1855;5405;3617;11446
411920;201601;811;2760;709;2521;181;769;72;196;253;965
411925;201601;586;1656;390;1285;86;289;91;271;177;560
411930;201601;5768;18854;5071;17450;2185;7995;816;2802;3001;10797
411940;201601;3115;10407;2718;9548;664;2435;570;1947;1234;4382
411950;201601;11404;36134;9682;32816;2331;8476;4081;13616;6412;22092
411960;201601;5162;15409;4775;14704;1064;3660;1900;5726;2964;9386
411965;201601;564;1606;407;1342;73;289;119;410;192;699
411970;201601;706;1983;586;1799;187;627;181;595;368;1222
411980;201601;1588;4798;1387;4399;288;970;446;1428;734;2398
411990;201601;27334;88447;23090;79501;5898;22443;6034;20132;11932;42575
411995;201601;2272;7036;1943;6424;598;2219;385;1177;983;3396
412000;201601;2026;5269;1587;4514;246;829;752;1948;998;2777
412010;201601;671;2284;543;1995;79;302;106;375;185;677
412015;201601;627;1865;512;1626;101;338;226;725;327;1063
412020;201601;352;1029;239;779;47;167;66;197;113;364
412030;201601;686;2147;493;1710;68;261;115;378;183;639
412033;201601;730;2154;505;1624;82;292;110;337;192;629
412035;201601;937;2627;631;2070;139;481;199;657;338;1138
412040;201601;557;1752;437;1487;79;285;100;332;179;617
412050;201601;1661;4805;1266;4038;219;780;275;834;494;1614
412060;201601;6565;22503;6001;21361;1882;7237;1621;5694;3503;12931
412065;201601;787;2364;615;2005;125;452;157;463;282;915
412070;201601;1282;3459;952;2783;154;482;309;890;463;1372
412080;201601;1311;4091;802;2908;93;386;17;59;110;445
412085;201601;407;1181;150;526;30;114;19;59;49;173
412090;201601;4210;13301;3956;12854;703;2423;2205;7354;2908;9777
412100;201601;1842;5711;1519;5080;432;1591;348;1153;780;2744
412110;201601;1040;2935;704;2236;154;519;119;388;273;907
412120;201601;1618;5471;1405;5006;365;1447;427;1344;792;2791
412125;201601;608;1994;558;1899;126;472;193;625;319;1097
412130;201601;579;1722;435;1404;102;361;64;187;166;548
412135;201601;448;1272;311;994;69;234;96;296;165;530
412140;201601;1481;4476;1244;3981;277;944;233;704;510;1648
412150;201601;2770;8038;2396;7290;292;1032;1443;4298;1735;5330
412160;201601;1108;3538;710;2509;168;637;80;254;248;891
412170;201601;4346;13419;3560;11900;921;3361;1198;3792;2119;7153
412175;201601;1326;4470;1154;4095;283;1118;452;1582;735;2700
412180;201601;1556;4816;1167;4070;262;1047;318;1042;580;2089
412190;201601;3072;8809;2321;7471;526;1880;630;2139;1156;4019
412200;201601;2040;6533;1475;5064;280;1039;419;1443;699;2482
412210;201601;663;1818;399;1271;54;198;30;73;84;271
412215;201601;3509;10790;3165;10185;705;2262;1740;5813;2445;8075
412217;201601;1033;2938;912;2729;119;433;587;1652;706;2085
412220;201601;5358;17676;5135;17271;1499;5177;2428;8238;3927;13415
412230;201601;2631;8703;2300;8051;473;1883;636;2096;1109;3979
412240;201601;8450;21391;4862;14784;832;2816;789;2181;1621;4997
412250;201601;1799;5304;1542;4806;405;1349;195;522;600;1871
412260;201601;1234;3394;815;2519;113;390;268;747;381;1137
412265;201601;964;2962;847;2762;212;782;347;1129;559;1911
412270;201601;794;2511;527;1836;99;381;133;429;232;810
412280;201601;593;1840;438;1506;186;691;24;75;210;766
412290;201601;968;2795;755;2390;133;451;234;680;367;1131
412300;201601;1828;5524;1539;4969;399;1432;308;941;707;2373
412310;201601;993;2892;877;2711;121;449;437;1382;558;1831
412320;201601;813;2193;589;1799;105;378;193;577;298;955
412330;201601;1455;4188;1124;3494;182;635;511;1573;693;2208
412340;201601;887;2762;602;2040;71;265;84;248;155;513
412350;201601;2060;6438;1675;5608;334;1182;107;305;441;1487
412360;201601;281;842;176;575;21;80;54;149;75;229
412370;201601;858;2537;642;2142;146;540;123;407;269;947
412380;201601;1423;4591;1184;4007;293;1042;247;843;540;1885
412382;201601;653;1840;456;1431;80;259;94;258;174;517
412385;201601;2262;7136;2031;6608;669;2290;373;1192;1042;3482
412390;201601;2001;5770;1799;5439;458;1503;664;2082;1122;3585
412395;201601;774;2243;618;1986;73;265;338;1058;411;1323
412400;201601;857;2723;744;2474;204;725;158;538;362;1263
412402;201601;1763;5256;1432;4587;314;1128;272;791;586;1919
412405;201601;3461;10135;2237;7432;352;1346;141;421;493;1767
412410;201601;4532;13963;3768;12519;1045;4047;619;1936;1664;5983
412420;201601;323;961;233;749;37;126;73;193;110;319
412430;201601;511;1426;378;1173;53;181;133;388;186;569
412440;201601;3134;9575;2525;8480;552;2040;733;2501;1285;4541
412450;201601;310;990;244;830;35;108;18;44;53;152
412460;201601;679;2119;562;1863;152;555;104;323;256;878
412470;201601;1827;6257;1587;5629;522;1968;323;1192;845;3160
412480;201601;1068;3265;806;2642;130;453;87;226;217;679
412490;201601;816;2413;692;2164;126;407;180;547;306;954
412500;201601;1844;5362;1550;4790;297;1026;349;951;646;1977
412510;201601;2154;7028;1803;6183;510;1880;585;1989;1095;3869
412520;201601;1429;4050;1074;3324;240;776;189;546;429;1322
412530;201601;571;1679;442;1378;84;279;91;250;175;529
412535;201601;661;1935;442;1416;90;302;84;247;174;549
412540;201601;1206;3477;958;2997;136;492;269;833;405;1325
412545;201601;740;2122;564;1737;89;317;160;408;249;725
412550;201601;27495;82508;19350;64424;4361;15554;3354;10495;7715;26049
412555;201601;255;773;173;583;31;107;36;107;67;214
412560;201601;4876;14943;3825;12746;755;2999;989;3087;1744;6086
412570;201601;4013;11867;2774;9185;601;2217;440;1484;1041;3701
412575;201601;821;2532;636;2084;136;504;153;449;289;953
412580;201601;1147;3213;828;2619;144;476;251;742;395;1218
412590;201601;393;1153;263;863;52;199;66;212;118;411
412600;201601;1383;4208;1073;3547;218;801;274;836;492;1637
412610;201601;671;2002;437;1413;112;393;103;301;215;694
412620;201601;1170;3729;929;3207;205;817;129;375;334;1192
412625;201601;9339;26731;7116;22442;1426;4849;838;2512;2264;7361
412627;201601;884;2761;631;2169;175;663;52;161;227;824
412630;201601;3151;10020;2572;8765;526;1831;703;2316;1229;4147
412635;201601;465;1382;326;1072;77;259;11;25;88;284
412640;201601;873;2645;597;2004;82;266;40;121;122;387
412650;201601;1651;4939;1387;4427;282;1039;369;1052;651;2091
412660;201601;2633;7643;2076;6514;402;1394;363;1018;765;2412
412665;201601;620;1620;348;1089;89;283;66;201;155;484
412667;201601;1600;4665;1267;4019;301;1034;211;589;512;1623
412670;201601;506;1596;392;1350;96;370;58;176;154;546
412680;201601;1294;3871;819;2805;128;473;158;489;286;962
412690;201601;743;2255;557;1851;157;547;99;325;256;872
412700;201601;1766;5441;1488;5016;510;1949;367;1192;877;3141
412710;201601;6681;21033;5672;19004;1209;4512;1222;3776;2431;8288
412720;201601;1304;4046;930;3129;143;517;151;420;294;937
412730;201601;1954;5900;1211;4193;222;816;98;288;320;1104
412740;201601;1330;4241;1011;3552;228;892;138;534;366;1426
412750;201601;3864;11867;3448;11178;522;2045;2007;6339;2529;8384
412760;201601;2193;7081;2065;6860;425;1640;1120;3572;1545;5212
412770;201601;10506;28798;6170;19725;855;2966;959;2696;1814;5662
412780;201601;1203;3752;1046;3428;231;824;346;1095;577;1919
412785;201601;2227;6397;1668;5240;467;1525;674;2146;1141;3671
412788;201601;1321;4234;1160;3901;271;1035;351;1079;622;2114
412790;201601;1071;3176;798;2602;150;554;156;427;306;981
412795;201601;889;2490;726;2180;148;464;246;734;394;1198
412796;201601;2596;8033;2391;7658;589;2096;864;2583;1453;4679
412800;201601;2851;8294;2273;7047;370;1274;747;2201;1117;3475
412810;201601;10648;29024;6262;19677;799;2799;1213;3163;2012;5962
412820;201601;6931;20354;5173;16926;1141;4018;1080;3596;2221;7614
412830;201601;329;1021;265;872;40;154;73;214;113;368
412840;201601;1703;4928;1375;4247;255;861;244;735;499;1596
412850;201601;2761;8172;2306;7415;460;1726;804;2418;1264;4144
412853;201601;1619;4655;1439;4302;155;564;759;2110;914;2674
412855;201601;1412;4083;1114;3438;236;802;279;754;515;1556
412860;201601;1153;3331;951;2966;247;847;361;1114;608;1961
412862;201601;686;1805;481;1434;68;226;134;371;202;597
412863;201601;1127;3879;1097;3827;178;682;732;2515;910;3197
412865;201601;665;2025;507;1679;113;397;161;557;274;954
412870;201601;833;2379;663;2093;236;820;89;257;325;1077
412880;201601;850;2491;671;2140;154;519;103;298;257;817
420005;201601;524;1564;332;1131;54;189;107;361;161;550
420010;201601;2918;8493;2421;7796;369;1226;1605;5284;1974;6510
420020;201601;731;2375;417;1547;38;171;30;91;68;262
420030;201601;497;1296;253;841;45;179;25;85;70;264
420040;201601;689;2198;445;1678;87;361;28;87;115;448
420050;201601;639;1883;435;1458;133;467;125;420;258;887
420055;201601;208;635;123;429;20;75;19;62;39;137
420060;201601;236;766;160;581;25;114;27;73;52;187
420070;201601;1325;4188;1012;3433;161;623;385;1304;546;1927
420075;201601;168;446;89;272;17;57;15;38;32;95
420080;201601;579;1825;463;1600;148;547;105;367;253;914
420090;201601;468;1552;327;1245;76;309;51;206;127;515
420100;201601;1160;3648;1037;3478;247;863;559;1895;806;2758
420110;201601;316;1069;286;1000;66;244;101;348;167;592
420120;201601;251;880;208;780;69;286;40;137;109;423
420125;201601;230;869;204;810;60;246;79;292;139;538
420127;201601;528;1567;208;768;51;201;19;70;70;271
420130;201601;1704;5753;1398;5174;333;1342;282;963;615;2305
420140;201601;4403;12988;3130;10516;665;2486;408;1218;1073;3704
420150;201601;712;1993;431;1439;78;281;134;416;212;697
420160;201601;267;731;164;531;25;82;46;148;71;230
420165;201601;212;664;127;445;26;100;23;73;49;173
420170;201601;187;573;125;451;41;171;10;28;51;199
420180;201601;397;1210;221;805;39;151;35;128;74;279
420190;201601;443;1261;234;796;31;120;15;42;46;162
420195;201601;1237;3651;1021;3299;235;795;315;1004;550;1799
420200;201601;2398;7530;1410;5237;245;1051;126;439;371;1490
420205;201601;880;2898;756;2696;174;664;377;1365;551;2029
420207;201601;1467;4303;1038;3427;282;1060;202;615;484;1675
420208;201601;550;1539;300;1088;90;348;86;333;176;681
420209;201601;308;951;199;692;33;130;70;239;103;369
420210;201601;1509;4665;1011;3847;258;1158;285;1040;543;2198
420213;201601;776;2777;734;2675;155;600;417;1536;572;2136
420215;201601;322;1056;214;795;50;205;18;77;68;282
420220;201601;154;542;125;478;30;124;27;92;57;216
420230;201601;4118;11961;3039;10042;581;2296;1184;3766;1765;6062
420240;201601;10169;28202;6337;20985;1005;3997;2339;6964;3344;10961
420243;201601;590;1792;468;1548;90;323;162;522;252;845
420245;201601;1073;3255;747;2565;122;462;206;655;328;1117
420250;201601;508;1633;463;1550;127;509;189;598;316;1107
420253;201601;484;1318;374;1169;56;182;207;673;263;855
420257;201601;303;849;195;652;36;123;91;305;127;428
420260;201601;1195;3777;979;3382;201;770;378;1313;579;2083
420270;201601;557;1701;196;701;30;122;41;129;71;251
420280;201601;2227;6016;1356;4451;269;978;433;1349;702;2327
420285;201601;140;423;70;261;8;33;2;9;10;42
420287;201601;504;1507;418;1372;129;422;122;414;251;836
420290;201601;5994;17783;3998;13206;736;2632;1043;3211;1779;5843
420300;201601;6381;19305;4230;14728;863;3272;639;2166;1502;5438
420310;201601;739;2063;665;1947;107;338;464;1332;571;1670
420315;201601;904;2884;710;2515;190;737;234;821;424;1558
420320;201601;4633;14202;3779;12705;988;3616;1352;4553;2340;8169
420325;201601;228;780;207;726;41;163;75;250;116;413
420330;201601;932;3236;688;2616;170;716;146;504;316;1220
420340;201601;1407;4384;1084;3649;211;786;118;347;329;1133
420350;201601;1415;4253;1045;3534;275;979;339;1151;614;2130
420360;201601;2979;9042;1872;6641;376;1511;136;396;512;1907
420370;201601;1772;5074;1372;4361;151;492;970;3083;1121;3575
420380;201601;4887;15116;3325;11535;762;2891;694;2388;1456;5279
420390;201601;1345;3762;695;2394;103;422;101;282;204;704
420395;201601;1353;4155;945;3244;128;502;126;374;254;876
420400;201601;1235;3593;869;2885;216;831;179;524;395;1355
420410;201601;743;1983;517;1610;113;397;289;876;402;1273
420415;201601;446;1394;324;1105;94;338;86;281;180;619
420417;201601;681;2199;569;1926;99;345;286;974;385;1319
420419;201601;364;1100;236;845;80;322;17;70;97;392
420420;201601;10262;30956;8181;26974;2684;9826;1834;5587;4518;15413
420425;201601;1196;3226;823;2526;74;298;349;998;423;1296
420430;201601;3146;9585;2033;6976;414;1553;605;2091;1019;3644
420435;201601;291;856;179;610;41;153;70;225;111;378
420440;201601;852;2649;498;1748;205;759;79;275;284;1034
420445;201601;360;1065;257;823;49;157;98;319;147;476
420450;201601;775;2343;512;1768;105;398;93;302;198;700
420455;201601;1858;5603;1608;5178;287;1137;730;2226;1017;3363
420460;201601;8303;24182;6250;20567;1355;5141;2177;6809;3532;11950
420470;201601;1038;2821;638;2039;140;505;160;466;300;971
420475;201601;121;356;64;224;16;54;7;23;23;77
420480;201601;4541;13374;3349;11130;968;3467;502;1713;1470;5180
420490;201601;660;1715;358;1203;84;313;73;245;157;558
420500;201601;1511;4793;1167;4119;342;1356;366;1272;708;2628
420510;201601;74;287;63;271;16;74;26;107;42;181
420515;201601;108;363;86;319;13;57;16;59;29;116
420517;201601;803;2538;705;2370;117;435;358;1163;475;1598
420519;201601;544;1427;391;1159;60;194;104;296;164;490
420520;201601;642;1594;397;1252;85;284;127;340;212;624
420530;201601;989;3293;732;2697;164;691;142;469;306;1160
420535;201601;257;739;139;490;31;120;4;13;35;133
420540;201601;19338;55158;14006;44116;3304;11410;3303;9069;6607;20479
420543;201601;384;1013;298;877;24;81;178;570;202;651
420545;201601;1460;4599;1171;3965;263;1002;341;1078;604;2080
420550;201601;3932;12539;2917;10409;692;2921;469;1535;1161;4456
420555;201601;358;1102;274;930;68;248;79;258;147;506
420560;201601;500;1456;373;1227;71;257;179;579;250;836
420570;201601;2033;6454;1588;5460;395;1564;502;1589;897;3153
420580;201601;1349;4170;1080;3710;261;1023;425;1428;686;2451
420590;201601;3002;9110;2017;6823;377;1409;271;813;648;2222
420600;201601;822;2698;745;2540;116;423;404;1431;520;1854
420610;201601;485;1485;270;1002;66;279;60;218;126;497
420620;201601;521;1618;469;1520;117;409;132;432;249;841
420630;201601;950;2931;664;2258;144;526;198;629;342;1155
420640;201601;753;2277;375;1372;73;298;21;72;94;370
420650;201601;2458;7150;1560;5310;256;1001;333;1036;589;2037
420660;201601;453;1301;325;1037;63;228;104;320;167;548
420665;201601;671;1892;430;1427;67;238;107;319;174;557
420670;201601;1560;4641;1097;3677;202;795;261;798;463;1593
420675;201601;193;613;139;487;26;94;37;130;63;224
420680;201601;484;1160;281;846;46;157;87;255;133;412
420690;201601;827;2831;626;2290;98;381;126;418;224;799
420700;201601;2954;8693;2268;7332;464;1708;687;2092;1151;3800
420710;201601;541;1811;412;1542;117;496;114;408;231;904
420720;201601;1660;4753;1296;4279;336;1175;664;2213;1000;3388
420730;201601;3091;9276;2517;8270;611;2204;927;2930;1538;5134
420740;201601;815;2497;672;2236;207;765;252;773;459;1538
420750;201601;2218;7120;1595;5651;256;1059;420;1341;676;2400
420757;201601;96;232;43;147;7;31;19;64;26;95
420760;201601;338;1052;198;669;38;141;36;104;74;245
420765;201601;533;1682;273;1029;49;220;38;134;87;354
420768;201601;1114;3912;865;3374;293;1188;273;1089;566;2277
420770;201601;629;1838;344;1266;76;323;63;231;139;554
420775;201601;628;1900;378;1294;84;304;59;184;143;488
420780;201601;1491;4474;901;3053;177;608;113;350;290;958
420785;201601;273;825;193;627;28;98;41;128;69;226
420790;201601;1248;4266;986;3666;281;1145;334;1164;615;2309
420800;201601;808;2300;415;1387;96;352;87;277;183;629
420810;201601;1951;6608;1546;5726;452;1918;304;1025;756;2943
420820;201601;7670;22788;5226;18657;1256;5098;1098;3864;2354;8962
420830;201601;2412;7669;2002;6919;621;2338;658;2266;1279;4604
420840;201601;987;2933;505;1824;106;445;82;264;188;709
420845;201601;1238;3771;911;3197;240;982;181;591;421;1573
420850;201601;1607;5009;974;3659;212;930;69;239;281;1169
420860;201601;439;1243;273;924;70;272;72;247;142;519
420870;201601;1112;3081;870;2709;290;1047;222;596;512;1643
420880;201601;986;3257;764;2692;151;579;129;407;280;986
420890;201601;10292;27063;5177;16987;830;2965;1086;3103;1916;6068
420895;201601;243;661;134;428;39;124;13;34;52;158
420900;201601;1798;5091;1156;3856;229;898;264;805;493;1703
420910;201601;22535;66829;15368;52563;2826;10968;4105;12938;6931;23906
420915;201601;532;2123;392;1709;83;383;167;685;250;1068
420917;201601;443;1382;210;714;40;161;73;207;113;368
420920;201601;181;506;75;258;12;48;13;46;25;94
420930;201601;17141;49472;13453;43320;3043;10888;4585;14333;7628;25221
420940;201601;2742;8323;2116;7052;567;2082;169;478;736;2560
420945;201601;197;628;129;471;22;101;34;117;56;218
420950;201601;597;1678;279;1036;39;193;31;101;70;294
420960;201601;854;2467;699;2192;137;478;289;849;426;1327
420970;201601;2420;7648;2007;6898;587;2262;535;1803;1122;4065
420980;201601;461;1334;339;1132;113;419;109;402;222;821
420985;201601;485;1382;227;821;43;190;46;143;89;333
420990;201601;880;2366;497;1667;82;308;102;291;184;599
421000;201601;552;1846;356;1343;67;264;54;168;121;432
421003;201601;709;1926;276;924;26;90;36;76;62;166
421005;201601;151;463;113;397;19;77;57;206;76;283
421010;201601;5265;14979;3668;12138;922;3437;687;2006;1609;5443
421020;201601;466;1452;361;1270;41;146;190;700;231;846
421030;201601;683;2518;624;2362;180;739;101;383;281;1122
421040;201601;826;2111;521;1631;95;359;240;705;335;1064
421050;201601;1598;4471;953;3136;167;613;184;520;351;1133
421055;201601;199;579;112;367;26;89;24;66;50;155
421060;201601;468;1600;317;1179;69;285;104;376;173;661
421070;201601;684;2204;447;1603;100;412;71;247;171;659
421080;201601;499;1501;418;1377;85;271;256;856;341;1127
421085;201601;525;1399;292;981;58;223;77;272;135;495
421090;201601;385;1086;200;687;29;107;65;200;94;307
421100;201601;848;2361;486;1557;130;429;63;188;193;617
421105;201601;1398;4314;1153;3897;256;919;389;1383;645;2302
421110;201601;975;3566;889;3366;321;1291;182;644;503;1935
421120;201601;1259;4017;844;3009;128;525;197;643;325;1168
421125;201601;395;1092;293;916;81;296;87;246;168;542
421130;201601;2890;9507;2442;8670;781;3089;739;2648;1520;5737
421140;201601;326;952;245;779;47;149;78;230;125;379
421145;201601;540;1714;337;1168;46;169;101;341;147;510
421150;201601;545;1609;394;1359;72;274;148;506;220;780
421160;201601;1193;3310;584;1939;107;398;190;602;297;1000
421165;201601;274;943;219;786;34;123;90;330;124;453
421170;201601;1271;3733;1020;3342;214;766;568;1847;782;2613
421175;201601;1198;3375;875;2853;191;782;289;822;480;1604
421180;201601;548;1558;297;1026;61;239;52;171;113;410
421185;201601;390;1086;277;872;48;141;126;425;174;566
421187;201601;266;798;196;652;34;116;82;261;116;377
421189;201601;406;1250;355;1149;70;235;114;352;184;587
421190;201601;11188;32114;6858;23399;1318;4994;899;2912;2217;7906
421200;201601;869;2903;745;2650;161;629;196;644;357;1273
421205;201601;241;730;180;614;37;149;36;100;73;249
421210;201601;1490;4552;1114;3676;277;953;223;735;500;1688
421220;201601;1907;6483;1663;5945;480;1919;271;861;751;2780
421223;201601;508;1634;389;1382;100;375;104;364;204;739
421225;201601;1044;3328;886;3012;205;785;307;1042;512;1827
421227;201601;786;2585;701;2454;150;562;397;1384;547;1946
421230;201601;421;1396;375;1314;96;385;162;537;258;922
421240;201601;429;1388;259;940;32;148;35;113;67;261
421250;201601;1666;4840;1090;3821;292;1118;211;741;503;1859
421260;201601;344;983;97;353;21;73;18;64;39;137
421265;201601;673;2100;586;1957;127;460;258;841;385;1301
421270;201601;795;2137;412;1369;82;289;73;282;155;571
421280;201601;1482;4672;1202;4202;341;1357;402;1359;743;2716
421290;201601;1209;3377;722;2361;122;433;111;319;233;752
421300;201601;293;888;232;759;66;249;87;265;153;514
421310;201601;231;731;182;616;35;128;53;168;88;296
421315;201601;362;1064;202;729;39;145;16;58;55;203
421320;201601;519;1656;349;1239;50;184;42;102;92;286
421330;201601;527;1719;406;1490;129;542;67;238;196;780
421335;201601;509;1687;422;1514;99;403;82;315;181;718
421340;201601;1714;4909;1375;4373;194;763;790;2474;984;3237
421350;201601;899;3000;743;2657;147;617;310;1033;457;1650
421360;201601;2953;8497;1899;6462;390;1533;488;1519;878;3052
421370;201601;669;2225;513;1878;143;595;142;501;285;1096
421380;201601;950;2710;784;2394;135;469;354;1061;489;1530
421390;201601;136;410;69;249;9;32;34;127;43;159
421400;201601;250;823;166;655;39;162;45;166;84;328
421410;201601;310;897;218;724;26;89;97;314;123;403
421415;201601;346;1130;163;604;37;146;28;92;65;238
421420;201601;847;2566;614;2039;116;411;158;493;274;904
421430;201601;235;730;177;614;30;114;35;128;65;242
421440;201601;797;2336;535;1856;126;493;199;683;325;1176
421450;201601;481;1481;311;1137;65;276;29;112;94;388
421460;201601;622;1686;324;1135;49;210;62;220;111;430
421470;201601;427;1418;336;1215;96;372;100;349;196;721
421480;201601;2897;8168;1787;6153;397;1628;285;818;682;2446
421490;201601;269;809;121;462;26;113;15;50;41;163
421500;201601;2110;7214;1757;6486;553;2292;218;774;771;3066
421505;201601;349;1184;304;1081;66;246;139;496;205;742
421507;201601;525;1585;339;1189;64;228;90;336;154;564
421510;201601;172;548;148;507;25;119;75;214;100;333
421520;201601;861;2282;580;1720;57;207;241;634;298;841
421530;201601;385;1186;234;856;35;167;57;208;92;375
421535;201601;674;1990;373;1375;64;274;146;503;210;777
421540;201601;320;885;257;781;52;174;98;268;150;442
421545;201601;800;2582;587;2171;134;563;125;459;259;1022
421550;201601;1876;6054;1568;5510;462;1814;405;1355;867;3169
421555;201601;321;947;115;412;18;68;14;52;32;120
421560;201601;203;622;89;309;18;68;20;68;38;136
421565;201601;825;2409;722;2260;253;880;280;873;533;1753
421567;201601;645;2380;579;2241;306;1229;115;441;421;1670
421568;201601;495;1536;337;1168;71;243;79;286;150;529
421569;201601;230;688;113;408;18;69;21;72;39;141
421570;201601;1331;4009;736;2586;180;703;108;349;288;1052
421575;201601;435;1445;380;1334;64;245;226;799;290;1044
421580;201601;2976;9411;2246;7791;540;2112;510;1578;1050;3690
421590;201601;216;669;176;596;20;60;92;310;112;370
421600;201601;549;1652;417;1369;99;357;78;230;177;587
421605;201601;576;1769;413;1462;77;322;89;289;166;611
421610;201601;1360;3709;1057;3205;159;548;537;1567;696;2115
421620;201601;4259;12929;2897;10109;798;2972;804;2831;1602;5803
421625;201601;373;1029;153;525;20;70;19;72;39;142
421630;201601;2799;8412;1598;5526;361;1392;175;563;536;1955
421635;201601;244;730;126;427;15;59;39;108;54;167
421640;201601;989;2995;745;2492;152;520;292;971;444;1491
421650;201601;1963;6348;1570;5477;424;1698;214;625;638;2323
421660;201601;7426;24002;6043;21222;1429;5650;1732;5625;3161;11275
421670;201601;1035;3180;720;2477;195;767;182;595;377;1362
421680;201601;1110;3611;924;3215;295;1085;161;536;456;1621
421690;201601;1601;5241;1227;4405;245;962;107;343;352;1305
421700;201601;486;1541;271;989;44;175;52;139;96;314
421710;201601;222;743;111;405;30;113;28;95;58;208
421715;201601;260;694;138;444;36;126;32;88;68;214
421720;201601;1864;5517;1195;4176;315;1235;212;663;527;1898
421725;201601;105;347;95;324;26;94;21;67;47;161
421730;201601;582;1676;288;996;47;172;42;121;89;293
421740;201601;726;2320;501;1793;107;451;75;214;182;665
421750;201601;951;2560;593;1857;115;398;245;702;360;1100
421755;201601;319;926;185;601;39;138;55;172;94;310
421760;201601;694;2207;377;1359;72;291;102;340;174;631
421770;201601;2810;8549;2154;7229;552;1942;646;2256;1198;4198
421775;201601;477;1408;339;1156;65;247;87;279;152;526
421780;201601;1187;4015;915;3377;227;941;277;969;504;1910
421790;201601;778;2114;445;1559;113;455;120;388;233;843
421795;201601;346;1020;221;709;35;131;55;175;90;306
421800;201601;2547;7606;1930;6459;417;1610;709;2196;1126;3806
421810;201601;568;1782;410;1471;103;398;40;146;143;544
421820;201601;1050;3061;666;2275;113;413;116;349;229;762
421825;201601;1387;4476;1289;4266;189;749;757;2375;946;3124
421830;201601;2337;8086;2109;7634;477;1976;899;3118;1376;5094
421835;201601;141;413;99;351;22;101;57;191;79;292
421840;201601;270;875;195;704;49;202;47;156;96;358
421850;201601;394;1228;247;870;51;219;50;166;101;385
421860;201601;323;989;210;754;34;127;42;126;76;253
421870;201601;3760;10594;2629;8381;769;2651;410;1274;1179;3925
421875;201601;421;1248;194;706;35;142;16;54;51;196
421880;201601;850;2606;638;2163;135;519;137;441;272;960
421885;201601;282;909;225;808;73;293;66;230;139;523
421890;201601;821;2809;711;2580;234;976;227;771;461;1747
421895;201601;350;1137;309;1065;80;280;153;541;233;821
421900;201601;881;2459;559;1792;146;502;136;390;282;892
421910;201601;480;1536;337;1214;67;281;62;194;129;475
421915;201601;499;1508;318;1091;60;211;67;213;127;424
421917;201601;548;1596;398;1372;129;508;107;357;236;865
421920;201601;759;2114;483;1741;253;962;98;350;351;1312
421930;201601;3047;8023;1697;5686;376;1383;251;762;627;2145
421935;201601;645;2140;473;1764;104;453;139;482;243;935
421940;201601;263;893;137;517;18;75;15;46;33;121
421950;201601;3522;9654;1710;5807;377;1406;200;683;577;2089
421960;201601;192;569;146;477;32;118;28;74;60;192
421970;201601;2109;5900;1328;4272;424;1444;315;925;739;2369
421985;201601;488;1246;270;820;44;170;70;208;114;378
422000;201601;1065;3186;897;2882;230;815;339;1112;569;1927
430003;201601;789;2301;607;1996;161;592;159;509;320;1101
430005;201601;317;944;232;785;45;162;99;321;144;483
430010;201601;2095;5654;1559;4762;386;1247;616;1923;1002;3170
430020;201601;696;1742;579;1589;70;206;373;999;443;1205
430030;201601;1008;2661;745;2178;246;789;118;317;364;1106
430040;201601;11000;28729;8505;24491;2292;7138;1391;3824;3683;10962
430045;201601;674;1821;516;1497;100;297;219;627;319;924
430047;201601;285;690;157;474;20;56;60;184;80;240
430050;201601;1226;3296;733;2317;131;439;163;484;294;923
430055;201601;296;796;159;492;27;95;63;183;90;278
430057;201601;69;159;31;88;3;6;4;5;7;11
430060;201601;15654;50150;13614;46674;3700;13533;5481;19064;9181;32597
430063;201601;978;2886;797;2518;196;654;381;1237;577;1891
430064;201601;1373;4126;1113;3655;271;909;414;1388;685;2297
430066;201601;165;399;121;334;9;32;64;167;73;199
430070;201601;593;1586;190;622;29;113;25;66;54;179
430080;201601;655;1851;399;1345;82;304;110;335;192;639
430085;201601;844;2209;561;1711;107;360;189;588;296;948
430087;201601;940;2859;874;2743;122;463;543;1600;665;2063
430090;201601;884;2335;360;1181;35;136;46;158;81;294
430100;201601;808;2134;426;1346;104;348;109;294;213;642
430105;201601;945;2793;643;2225;163;634;197;673;360;1307
430107;201601;254;833;186;644;36;135;42;135;78;270
430110;201601;1837;5275;1506;4763;403;1328;622;1916;1025;3244
430120;201601;1721;5080;1284;4185;260;874;581;1872;841;2746
430130;201601;3783;9866;3269;9132;769;2319;1309;3583;2078;5902
430140;201601;1183;3591;794;2712;219;770;219;752;438;1522
430150;201601;731;1957;503;1529;116;379;127;386;243;765
430155;201601;400;1109;227;741;36;136;61;200;97;336
430160;201601;16356;47814;14582;44864;3126;10562;6387;19717;9513;30279
430163;201601;1836;5436;1501;4845;245;865;721;2335;966;3200
430165;201601;454;1118;136;456;17;58;20;58;37;116
430170;201601;935;2632;375;1331;50;183;33;99;83;282
430175;201601;919;2855;756;2476;193;588;287;1030;480;1618
430180;201601;830;2285;677;2040;153;514;332;964;485;1478
430185;201601;574;1482;325;1011;47;159;101;260;148;419
430187;201601;649;1936;510;1659;113;421;167;511;280;932
430190;201601;1662;4954;1446;4538;280;973;782;2440;1062;3413
430192;201601;197;601;94;307;6;19;18;53;24;72
430195;201601;353;1077;102;352;8;28;4;12;12;40
430200;201601;1403;4503;1203;4092;343;1234;271;910;614;2144
430205;201601;544;1570;419;1343;42;165;290;932;332;1097
430210;201601;6015;16057;3530;11038;577;1973;716;2040;1293;4013
430215;201601;355;984;241;743;38;121;94;276;132;397
430220;201601;742;1870;271;921;41;168;46;154;87;322
430222;201601;272;819;213;693;34;134;98;296;132;430
430223;201601;337;954;291;886;63;194;169;540;232;734
430225;201601;35;87;15;44;6;17;5;15;11;32
430230;201601;1621;4846;1559;4782;180;408;1346;4308;1526;4716
430235;201601;273;896;224;777;48;186;64;204;112;390
430237;201601;516;1335;379;1108;43;147;230;651;273;798
430240;201601;947;2480;639;1962;111;404;274;789;385;1193
430245;201601;866;2685;659;2255;170;584;274;995;444;1579
430250;201601;1195;3412;1047;3175;371;1174;165;511;536;1685
430258;201601;164;457;121;382;10;34;52;173;62;207
430260;201601;763;2191;542;1754;62;212;285;966;347;1178
430265;201601;273;837;212;714;42;132;9;34;51;166
430270;201601;2898;8081;2493;7409;353;1219;1405;3995;1758;5214
430280;201601;4597;12469;3726;10962;922;2773;1513;4483;2435;7256
430290;201601;2370;6275;2182;6017;153;444;1867;5172;2020;5616
430300;201601;8927;26420;7450;23644;1818;6241;2988;9698;4806;15939
430310;201601;6070;18332;4752;15863;1134;4142;1623;5097;2757;9239
430320;201601;818;2406;547;1847;103;294;251;921;354;1215
430330;201601;661;1772;514;1498;147;416;194;542;341;958
430340;201601;722;1801;401;1295;66;240;196;635;262;875
430350;201601;6121;18747;5234;16901;1808;6058;1568;4993;3376;11051
430355;201601;367;915;146;447;25;77;15;42;40;119
430360;201601;1020;2702;860;2422;173;562;334;855;507;1417
430367;201601;254;658;158;491;47;172;47;132;94;304
430370;201601;498;1418;374;1185;104;362;81;235;185;597
430380;201601;859;2225;481;1560;139;497;121;392;260;889
430390;201601;3931;11090;2672;8572;526;1822;441;1368;967;3190
430400;201601;1381;3314;981;2685;310;880;322;831;632;1711
430410;201601;619;1669;448;1380;87;295;202;618;289;913
430420;201601;3573;10369;2818;8738;744;2361;1029;3165;1773;5526
430430;201601;741;1975;471;1490;124;429;108;347;232;776
430435;201601;1996;5409;1503;4535;375;1192;536;1640;911;2832
430440;201601;3867;12214;3057;10378;636;2289;1350;4728;1986;7017
430450;201601;7504;20833;6013;18041;1984;6328;1294;3891;3278;10219
430460;201601;27750;82152;21534;71133;5734;20897;6078;19720;11812;40617
430461;201601;510;1365;164;526;23;77;30;89;53;166
430462;201601;299;850;224;728;69;253;50;143;119;396
430463;201601;3999;12708;3447;11695;740;2677;1553;5407;2293;8084
430465;201601;634;1703;530;1535;166;523;245;684;411;1207
430466;201601;3508;9700;3084;9060;592;1895;1692;4838;2284;6733
430467;201601;500;1480;433;1361;86;291;171;508;257;799
430468;201601;1382;3871;1185;3582;330;1070;430;1253;760;2323
430469;201601;405;1089;64;223;9;39;9;23;18;62
430470;201601;7513;20051;5344;16463;1499;5024;807;2418;2306;7442
430471;201601;580;1920;511;1777;155;534;124;471;279;1005
430480;201601;952;2475;475;1504;71;259;103;301;174;560
430485;201601;212;585;98;312;14;50;21;55;35;105
430490;201601;310;891;204;671;45;161;87;286;132;447
430495;201601;373;1111;243;840;50;192;41;118;91;310
430500;201601;1167;3263;947;2895;265;901;383;1152;648;2053
430510;201601;19535;57264;15913;50643;5261;18294;4073;12060;9334;30354
430511;201601;404;1242;177;628;23;88;19;51;42;139
430512;201601;1153;2968;980;2670;246;699;307;881;553;1580
430513;201601;754;1991;463;1389;90;286;169;502;259;788
430515;201601;470;1368;347;1120;55;188;155;519;210;707
430517;201601;1151;3647;963;3264;191;665;509;1760;700;2425
430520;201601;1501;4162;1043;3240;258;874;289;821;547;1695
430530;201601;1105;2974;548;1750;69;265;128;376;197;641
430535;201601;2182;6604;1683;5629;353;1301;567;1847;920;3148
430537;201601;478;1524;412;1391;44;144;288;989;332;1133
430540;201601;731;1620;485;1284;92;252;267;711;359;963
430543;201601;485;1263;424;1200;78;229;299;867;377;1096
430544;201601;644;2071;547;1879;105;379;270;918;375;1297
430545;201601;1270;4047;1086;3822;375;1415;421;1522;796;2937
430550;201601;627;1826;385;1298;79;293;91;306;170;599
430558;201601;81;237;41;142;10;44;7;24;17;68
430560;201601;377;939;218;668;17;61;69;199;86;260
430570;201601;1097;2837;709;2070;174;601;248;597;422;1198
430580;201601;1233;3090;740;2280;176;600;247;782;423;1382
430583;201601;166;459;57;189;3;15;4;13;7;28
430585;201601;327;849;214;614;49;170;83;204;132;374
430587;201601;191;595;164;539;48;166;43;152;91;318
430590;201601;1184;3418;1114;3310;160;519;751;2194;911;2713
430593;201601;25;96;23;89;5;25;10;34;15;59
430595;201601;242;660;79;271;7;30;7;20;14;50
430597;201601;332;967;239;750;25;87;60;164;85;251
430600;201601;2058;5537;1179;3592;215;694;355;1032;570;1726
430605;201601;1315;3954;1030;3374;227;869;402;1318;629;2187
430607;201601;746;1845;554;1557;82;244;330;960;412;1204
430610;201601;8089;21682;6267;18870;1702;5552;1716;5099;3418;10651
430613;201601;275;668;121;366;26;73;19;46;45;119
430620;201601;681;1957;542;1672;150;478;184;552;334;1030
430630;201601;432;1348;220;750;37;123;23;71;60;194
430632;201601;691;1917;370;1161;56;198;130;348;186;546
430635;201601;571;1662;448;1417;101;353;220;676;321;1029
430637;201601;482;1375;424;1259;62;217;251;706;313;923
430640;201601;1598;4289;734;2447;59;202;28;63;87;265
430642;201601;463;1242;289;916;54;186;105;327;159;513
430645;201601;267;629;105;306;15;40;22;65;37;105
430650;201601;1818;5856;1549;5332;316;1111;853;3002;1169;4113
430655;201601;158;399;136;357;22;78;72;156;94;234
430660;201601;5559;15725;4463;13828;1094;3707;1711;5268;2805;8975
430670;201601;488;1420;444;1343;40;124;326;1023;366;1147
430673;201601;714;1702;347;1051;75;228;102;312;177;540
430675;201601;259;762;104;349;13;52;41;133;54;185
430676;201601;3409;10260;2814;9176;759;2657;785;2610;1544;5267
430680;201601;1207;3458;758;2490;133;449;176;516;309;965
430690;201601;4329;12175;3446;10476;1056;3339;835;2575;1891;5914
430692;201601;274;911;204;774;20;89;133;487;153;576
430693;201601;1274;3532;847;2667;159;588;190;556;349;1144
430695;201601;562;1573;385;1221;77;270;142;422;219;692
430697;201601;478;1347;355;1128;99;318;121;404;220;722
430700;201601;10092;25912;5114;16492;833;3083;279;833;1112;3916
430705;201601;271;832;236;766;83;288;58;174;141;462
430710;201601;1752;4491;1318;3767;287;896;477;1400;764;2296
430720;201601;887;2148;578;1702;129;410;184;541;313;951
430730;201601;1596;4189;1087;3374;289;886;360;1210;649;2096
430740;201601;537;1505;314;1063;79;289;44;156;123;445
430745;201601;507;1437;261;839;42;152;31;95;73;247
430750;201601;1539;4227;1206;3675;232;794;601;1775;833;2569
430755;201601;496;1340;331;1002;32;109;128;364;160;473
430760;201601;2993;7284;2030;5899;457;1589;707;2136;1164;3725
430770;201601;6123;17813;4809;15386;917;3195;2433;7703;3350;10898
430780;201601;2457;6512;1466;4668;282;963;390;1194;672;2157
430781;201601;534;1537;360;1194;71;234;96;321;167;555
430783;201601;539;1324;337;983;57;179;144;388;201;567
430786;201601;71;233;47;173;6;25;12;38;18;63
430790;201601;4633;12566;3242;9827;712;2389;1130;3156;1842;5545
430800;201601;885;2523;604;1899;123;427;189;556;312;983
430805;201601;529;1461;352;1120;43;132;168;545;211;677
430807;201601;417;1208;282;902;60;218;65;201;125;419
430810;201601;707;1856;287;945;49;195;62;165;111;360
430820;201601;1238;3772;802;2742;154;560;186;637;340;1197
430825;201601;394;1019;154;471;23;60;26;60;49;120
430830;201601;1749;5388;1617;5197;235;823;1054;3367;1289;4190
430840;201601;963;2918;878;2767;228;731;400;1301;628;2032
430843;201601;97;268;53;170;7;30;14;36;21;66
430845;201601;306;925;253;812;108;369;20;52;128;421
430850;201601;2438;7186;2055;6476;475;1630;786;2429;1261;4059
430860;201601;1001;2693;504;1666;136;520;150;465;286;985
430865;201601;633;1664;563;1553;197;572;257;684;454;1256
430870;201601;700;1944;396;1296;94;312;63;167;157;479
430880;201601;1161;3291;827;2639;227;775;208;709;435;1484
430885;201601;242;590;138;433;16;52;90;286;106;338
430890;201601;1758;4656;1250;3776;174;648;317;862;491;1510
430900;201601;2802;7388;2305;6556;514;1721;992;2608;1506;4329
430905;201601;1030;2914;648;2107;147;520;125;390;272;910
430910;201601;1484;4378;1030;3419;231;863;356;1060;587;1923
430912;201601;461;1312;359;1133;49;174;218;685;267;859
430915;201601;573;1803;392;1447;120;475;88;355;208;830
430920;201601;15363;46645;13651;43503;2771;9801;7571;23465;10342;33266
430925;201601;97;231;49;147;12;41;17;51;29;92
430930;201601;9532;27106;6645;21714;1746;6161;1443;4918;3189;11079
430940;201601;1229;3715;726;2471;141;523;110;343;251;866
430950;201601;986;2723;654;2042;151;527;230;635;381;1162
430955;201601;137;412;65;212;13;48;15;46;28;94
430957;201601;254;833;205;743;46;163;99;386;145;549
430960;201601;1342;3608;1100;3188;260;829;510;1518;770;2347
430965;201601;1484;4239;1267;3879;81;312;977;2931;1058;3243
430970;201601;512;1408;301;967;52;178;77;236;129;414
430975;201601;590;1914;463;1624;80;298;207;748;287;1046
430980;201601;424;1058;254;806;65;217;79;244;144;461
430990;201601;541;1728;387;1331;80;288;79;255;159;543
430995;201601;585;1711;466;1467;155;510;142;414;297;924
431000;201601;1558;3978;804;2485;127;445;68;182;195;627
431010;201601;2645;7404;1627;5431;279;1036;254;765;533;1801
431020;201601;11069;27253;7228;20561;1712;5033;1754;4960;3466;9993
431030;201601;325;947;160;582;41;167;24;90;65;257
431033;201601;2337;6821;2057;6423;551;1842;940;3015;1491;4857
431036;201601;199;508;79;266;13;49;13;33;26;82
431040;201601;905;2586;723;2283;160;577;335;1019;495;1596
431041;201601;513;1407;466;1344;161;464;180;548;341;1012
431043;201601;434;1270;257;910;110;426;53;158;163;584
431046;201601;109;309;77;242;9;34;23;68;32;102
431050;201601;1679;4264;1279;3593;282;847;651;1805;933;2652
431053;201601;591;1923;486;1690;141;537;103;364;244;901
431055;201601;648;1767;605;1695;61;169;446;1261;507;1430
431057;201601;370;1069;226;757;44;155;57;179;101;334
431060;201601;5485;16216;4931;15398;1556;4890;1907;6216;3463;11106
431065;201601;540;1542;406;1280;70;251;161;471;231;722
431070;201601;707;2032;426;1408;89;293;63;187;152;480
431075;201601;288;875;207;702;34;122;56;202;90;324
431080;201601;605;1887;475;1591;90;334;109;351;199;685
431085;201601;842;2296;652;1893;106;327;336;972;442;1299
431087;201601;587;1658;504;1496;63;183;332;1003;395;1186
431090;201601;512;1248;251;752;59;182;51;155;110;337
431100;201601;3621;10071;2917;8879;743;2438;920;2773;1663;5211
431110;201601;1539;4071;1147;3307;261;784;399;1063;660;1847
431112;201601;551;1781;508;1696;130;445;229;748;359;1193
431113;201601;500;1436;392;1232;99;329;110;358;209;687
431115;201601;1368;3958;1198;3676;232;742;663;2056;895;2798
431120;201601;2623;8045;2048;6923;627;2419;619;1897;1246;4316
431123;201601;454;1305;309;1035;58;198;168;579;226;777
431125;201601;1352;4110;1015;3408;305;1010;219;829;524;1839
431127;201601;253;674;60;199;4;9;7;19;11;28
431130;201601;3286;9372;2399;7732;468;1671;763;2444;1231;4115
431140;201601;4636;11437;2622;8071;398;1342;598;1634;996;2976
431142;201601;435;1301;389;1216;38;124;264;849;302;973
431150;201601;1105;3309;845;2788;186;686;281;929;467;1615
431160;201601;891;2616;743;2322;132;392;361;1248;493;1640
431162;201601;527;1367;251;843;36;155;21;44;57;199
431164;201601;174;476;54;193;7;27;4;16;11;43
431170;201601;709;1964;507;1607;136;460;132;410;268;870
431171;201601;770;2279;666;2074;209;682;181;544;390;1226
431173;201601;450;1295;384;1183;110;358;187;576;297;934
431175;201601;1011;2842;863;2608;250;804;254;748;504;1552
431177;201601;800;2628;645;2330;211;855;253;895;464;1750
431179;201601;370;808;97;286;14;46;19;49;33;95
431180;201601;2208;6353;1533;4989;378;1310;297;911;675;2221
431190;201601;612;1696;368;1175;54;194;68;203;122;397
431198;201601;357;1172;320;1098;123;440;78;284;201;724
431200;201601;393;1101;120;410;16;50;3;9;19;59
431205;201601;292;877;139;478;34;106;36;135;70;241
431210;201601;739;1986;618;1786;177;500;297;900;474;1400
431213;201601;229;705;177;603;32;129;77;261;109;390
431215;201601;276;817;150;524;23;76;7;18;30;94
431217;201601;171;525;128;431;38;137;44;150;82;287
431220;201601;902;2433;549;1701;51;174;236;681;287;855
431225;201601;1334;3715;1075;3268;224;719;494;1481;718;2200
431230;201601;857;2461;646;2031;85;278;313;968;398;1246
431235;201601;112;315;33;106;6;21;5;11;11;32
431237;201601;490;1434;385;1280;82;335;207;665;289;1000
431238;201601;43;137;35;119;9;35;8;27;17;62
431240;201601;2918;8649;2574;8146;814;2762;828;2601;1642;5363
431242;201601;362;1145;315;1057;91;314;105;372;196;686
431244;201601;377;870;226;623;28;96;112;278;140;374
431245;201601;1150;2998;830;2436;126;392;417;1194;543;1586
431247;201601;185;538;139;441;40;130;26;74;66;204
431250;201601;1494;4757;1302;4489;352;1317;510;1771;862;3088
431260;201601;343;957;169;591;29;121;51;165;80;286
431261;201601;241;828;212;766;35;165;77;242;112;407
431262;201601;414;1118;192;614;24;97;79;255;103;352
431265;201601;1397;3607;778;2370;141;462;176;439;317;901
431267;201601;175;475;139;419;29;106;79;216;108;322
431270;201601;2712;6819;1786;5338;458;1536;558;1672;1016;3208
431275;201601;218;667;119;445;33;129;11;41;44;170
431280;201601;321;894;133;447;15;58;23;55;38;113
431290;201601;308;941;228;761;50;199;39;112;89;311
431295;201601;93;257;49;152;3;10;17;48;20;58
431300;201601;396;990;70;262;6;23;1;4;7;27
431301;201601;266;821;122;421;23;84;16;49;39;133
431303;201601;744;1967;429;1317;59;216;121;343;180;559
431306;201601;2279;5902;1477;4511;168;612;429;1149;597;1761
431308;201601;40;139;36;125;20;75;10;33;30;108
431310;201601;752;2244;470;1609;82;285;132;478;214;763
431320;201601;782;2141;413;1366;70;244;89;274;159;518
431330;201601;2789;6815;1389;4350;338;1212;81;217;419;1429
431333;201601;420;1131;179;549;21;76;38;98;59;174
431335;201601;54;166;39;133;12;41;6;13;18;54
431337;201601;2339;7144;1781;6039;394;1440;268;873;662;2313
431339;201601;585;1587;399;1214;78;249;177;539;255;788
431340;201601;23487;62780;17376;52259;3946;12831;4061;12172;8007;25003
431342;201601;529;1351;418;1170;136;427;197;511;333;938
431344;201601;351;974;255;804;14;41;186;605;200;646
431346;201601;319;818;139;429;28;89;19;59;47;148
431349;201601;712;2038;481;1491;93;293;146;431;239;724
431350;201601;3995;11670;3284;10395;667;2391;1205;3576;1872;5967
431360;201601;643;1642;422;1272;99;324;129;401;228;725
431365;201601;1219;3605;1040;3316;247;846;502;1647;749;2493
431370;201601;4809;13541;3757;11735;1049;3538;1008;3233;2057;6771
431380;201601;912;2851;846;2715;130;463;496;1559;626;2022
431390;201601;3140;8207;1903;5893;343;1202;472;1299;815;2501
431395;201601;1219;3654;1034;3338;233;820;483;1542;716;2362
431400;201601;338;1063;171;591;35;134;21;63;56;197
431402;201601;1266;2972;738;2055;144;418;335;895;479;1313
431403;201601;251;723;183;609;52;182;30;100;82;282
431405;201601;3905;11003;3221;9998;622;2162;1616;4923;2238;7085
431406;201601;735;2260;552;1884;150;539;232;789;382;1328
431407;201601;536;1532;352;1179;73;245;93;292;166;537
431410;201601;13462;38510;9252;30493;2596;9672;1057;3360;3653;13032
431413;201601;192;467;87;280;5;19;27;83;32;102
431415;201601;670;1917;502;1608;120;438;160;464;280;902
431417;201601;562;1431;465;1298;58;171;281;782;339;953
431420;201601;1340;3694;1178;3450;244;745;513;1596;757;2341
431430;201601;512;1342;313;950;61;208;92;233;153;441
431440;201601;22128;61941;18170;55671;5208;16915;5491;17842;10699;34757
431442;201601;123;358;78;253;12;45;9;20;21;65
431445;201601;519;1469;237;765;32;99;79;240;111;339
431446;201601;420;1247;305;1016;72;251;94;309;166;560
431447;201601;569;1639;442;1383;85;272;196;632;281;904
431449;201601;777;2165;619;1893;62;196;350;1085;412;1281
431450;201601;2169;5386;1895;5000;297;874;1311;3342;1608;4216
431454;201601;64;227;56;206;15;60;21;83;36;143
431455;201601;708;1784;384;1094;97;279;87;223;184;502
431460;201601;3303;9136;2820;8220;744;2184;851;2627;1595;4811
431470;201601;1742;5193;1341;4303;312;1003;417;1381;729;2384
431475;201601;193;564;47;187;6;24;1;3;7;27
431477;201601;718;1866;474;1372;54;179;245;673;299;852
431478;201601;261;679;103;308;17;52;18;42;35;94
431480;201601;2896;8066;2217;6862;569;1941;770;2267;1339;4208
431490;201601;107166;289739;91546;266675;11148;38299;61711;174988;72859;213287
431500;201601;595;1663;466;1406;105;315;226;686;331;1001
431505;201601;495;1191;334;960;21;50;206;611;227;661
431507;201601;352;866;215;601;41;106;113;318;154;424
431510;201601;1882;5276;1481;4475;339;1080;489;1362;828;2442
431513;201601;302;820;147;469;18;61;70;222;88;283
431514;201601;112;298;45;160;4;19;8;29;12;48
431515;201601;622;1843;424;1374;97;340;135;393;232;733
431517;201601;73;236;58;196;9;30;14;41;23;71
431520;201601;463;1250;241;785;38;151;26;79;64;230
431530;201601;4236;10001;3210;8805;1063;3154;890;2569;1953;5723
431531;201601;258;753;175;576;30;103;55;187;85;290
431532;201601;483;1346;407;1186;98;306;151;424;249;730
431535;201601;339;888;148;467;25;87;49;135;74;222
431540;201601;2036;6763;1792;6395;202;723;1131;4276;1333;4999
431545;201601;324;878;55;188;5;18;9;30;14;48
431550;201601;2205;6491;1951;6051;376;1321;861;2573;1237;3894
431555;201601;684;1721;519;1457;77;221;310;895;387;1116
431560;201601;19630;58345;14158;47916;3354;12759;2992;10667;6346;23426
431570;201601;5430;14542;4587;13367;1282;3831;1904;5716;3186;9547
431575;201601;405;1031;294;861;44;147;64;168;108;315
431580;201601;619;1750;390;1268;81;284;109;328;190;612
431590;201601;940;2551;583;1842;94;288;190;619;284;907
431595;201601;437;1256;346;1069;46;141;200;634;246;775
431600;201601;1938;5350;1387;4366;299;1115;326;965;625;2080
431610;201601;1411;4104;1053;3424;191;637;401;1331;592;1968
431620;201601;464;1372;238;763;58;200;89;258;147;458
431630;201601;1412;3797;912;2772;249;801;260;755;509;1556
431640;201601;5987;17006;5360;16087;1188;3881;2901;8723;4089;12604
431642;201601;493;1328;388;1146;59;194;182;524;241;718
431643;201601;268;680;150;419;20;62;51;121;71;183
431645;201601;1643;4748;1413;4358;268;916;782;2373;1050;3289
431647;201601;154;443;104;339;18;65;13;35;31;100
431650;201601;317;972;224;775;32;127;50;146;82;273
431660;201601;1139;3202;718;2367;132;467;135;390;267;857
431670;201601;1256;3318;943;2769;199;668;384;1035;583;1703
431673;201601;228;622;126;403;23;77;15;34;38;111
431675;201601;592;1551;145;487;22;74;22;66;44;140
431680;201601;9513;25780;7211;21654;1912;6170;1653;5032;3565;11202
431690;201601;22964;64018;18163;56138;4878;16116;5762;18452;10640;34568
431695;201601;132;403;91;299;19;61;18;44;37;105
431697;201601;444;1278;393;1181;100;303;181;564;281;867
431700;201601;1520;4324;1306;3926;225;718;683;1999;908;2717
431710;201601;12414;35813;10141;32210;3189;10940;2174;7532;5363;18472
431720;201601;7023;19375;5381;16262;1160;3797;1771;5282;2931;9079
431725;201601;16;45;7;23;2;5;1;3;3;8
431730;201601;3844;11180;3055;9802;796;2832;765;2564;1561;5396
431740;201601;5172;14415;4136;12571;1311;4389;656;1811;1967;6200
431750;201601;8866;25196;7716;23377;1796;5903;3506;10780;5302;16683
431755;201601;330;908;80;281;12;41;11;34;23;75
431760;201601;3755;10799;3026;9481;653;2249;1095;3264;1748;5513
431770;201601;1972;5268;1622;4736;300;894;888;2586;1188;3480
431775;201601;208;561;145;446;40;127;14;34;54;161
431780;201601;2408;6495;1839;5457;462;1459;369;1015;831;2474
431790;201601;1162;3533;952;3129;151;553;522;1728;673;2281
431795;201601;376;1017;223;681;36;116;69;208;105;324
431800;201601;8650;25457;6928;22289;2081;7205;1058;3325;3139;10530
431805;201601;332;801;109;362;16;62;15;49;31;111
431810;201601;3162;8719;2474;7386;457;1486;1039;3019;1496;4505
431820;201601;2479;7752;2153;7128;431;1580;873;2793;1304;4373
431830;201601;10617;25976;8270;22563;2280;6771;2953;8169;5233;14940
431840;201601;2618;7856;2260;7260;578;1990;931;3046;1509;5036
431842;201601;796;2000;343;1055;44;150;73;194;117;344
431843;201601;352;1014;289;900;40;142;144;432;184;574
431844;201601;272;738;94;310;21;74;19;49;40;123
431845;201601;480;1423;379;1207;26;91;233;747;259;838
431846;201601;322;992;277;923;25;96;189;626;214;722
431848;201601;244;654;144;461;16;56;31;90;47;146
431849;201601;455;1103;103;311;17;53;16;36;33;89
431850;201601;4717;13789;4142;12700;992;3244;1476;4524;2468;7768
431860;201601;744;1963;564;1660;106;349;265;739;371;1088
431861;201601;94;275;45;161;3;11;7;20;10;31
431862;201601;467;1517;378;1351;106;439;90;287;196;726
431870;201601;17302;50086;13823;43937;3390;11659;4223;13546;7613;25205
431880;201601;4201;12522;3391;10848;790;2808;1145;3463;1935;6271
431890;201601;4986;13507;3668;11168;1086;3493;841;2663;1927;6156
431900;201601;1045;2950;690;2225;175;650;259;760;434;1410
431910;201601;1002;2386;481;1387;72;208;131;349;203;557
431912;201601;493;1431;404;1271;122;361;140;468;262;829
431915;201601;1287;3491;999;2981;225;701;360;1088;585;1789
431920;201601;1269;3576;1098;3309;123;378;781;2350;904;2728
431930;201601;1228;3344;860;2736;225;694;384;1297;609;1991
431935;201601;52;163;42;140;11;45;14;39;25;84
431936;201601;383;1114;286;902;61;198;113;368;174;566
431937;201601;331;862;188;571;43;143;26;73;69;216
431940;201601;2529;6877;1688;5232;375;1251;406;1237;781;2488
431950;201601;1606;4908;1412;4559;252;913;649;2022;901;2935
431960;201601;2816;8160;2469;7503;629;1965;751;2268;1380;4233
431970;201601;447;1242;215;724;35;135;43;135;78;270
431971;201601;97;283;65;223;8;29;15;48;23;77
431973;201601;462;1605;410;1500;62;221;246;945;308;1166
431975;201601;105;245;20;80;6;30;3;9;9;39
431980;201601;1371;4034;1132;3561;268;894;332;997;600;1891
431990;201601;7046;19715;5364;16911;942;3411;1518;4542;2460;7953
432000;201601;9553;26658;7573;23317;2346;7558;2326;7146;4672;14704
432010;201601;2147;6053;1749;5357;372;1206;786;2411;1158;3617
432020;201601;2258;5485;1706;4726;244;730;1123;3072;1367;3802
432023;201601;511;1462;334;1076;64;220;104;307;168;527
432026;201601;1203;3636;888;2963;140;459;439;1473;579;1932
432030;201601;395;1153;295;931;56;168;139;433;195;601
432032;201601;596;1539;392;1174;70;219;165;460;235;679
432035;201601;802;2428;715;2285;284;975;217;704;501;1679
432040;201601;980;2283;461;1422;88;304;111;330;199;634
432045;201601;237;669;134;462;22;80;42;143;64;223
432050;201601;624;1744;534;1589;84;260;295;906;379;1166
432055;201601;850;2505;672;2179;124;430;352;1119;476;1549
432057;201601;404;979;305;817;51;126;187;494;238;620
432060;201601;502;1312;202;676;37;137;40;121;77;258
432065;201601;209;600;159;510;38;137;58;172;96;309
432067;201601;969;2997;722;2484;144;514;329;1150;473;1664
432070;201601;2338;6471;1568;4924;328;1130;300;873;628;2003
432080;201601;3617;10307;3058;9350;994;3222;889;2741;1883;5963
432085;201601;300;825;192;648;42;149;88;294;130;443
432090;201601;1391;3947;1074;3326;315;1041;377;1112;692;2153
432100;201601;1296;3739;658;2243;92;324;49;127;141;451
432110;201601;2625;7931;1969;6599;468;1797;197;602;665;2399
432120;201601;4686;13793;3951;12557;1436;4858;973;3024;2409;7882
432130;201601;2589;7240;2106;6624;722;2535;688;2133;1410;4668
432132;201601;396;1100;197;672;23;90;58;189;81;279
432135;201601;654;2048;621;1987;78;284;457;1432;535;1716
432140;201601;1882;6028;1483;5251;338;1265;590;2207;928;3472
432143;201601;1366;3990;1136;3605;207;663;523;1746;730;2409
432145;201601;1178;3588;736;2571;112;446;107;340;219;786
432146;201601;171;561;121;443;27;113;22;81;49;194
432147;201601;637;2015;480;1678;127;479;122;449;249;928
432149;201601;359;1007;229;698;47;141;81;255;128;396
432150;201601;3620;10149;2718;8523;582;2050;754;2268;1336;4318
432160;201601;4291;13514;3740;12554;1149;4063;1246;4342;2395;8405
432162;201601;391;931;76;236;12;42;12;27;24;69
432163;201601;357;957;94;301;5;18;4;12;9;30
432166;201601;669;1972;551;1737;73;271;258;778;331;1049
432170;201601;1058;3275;710;2528;138;508;121;423;259;931
432180;201601;2726;7307;1815;5596;414;1322;391;1185;805;2507
432183;201601;413;1281;325;1100;130;469;57;182;187;651
432185;201601;880;2366;556;1774;107;355;227;739;334;1094
432190;201601;3260;8886;2177;6586;495;1563;554;1571;1049;3134
432195;201601;1064;2916;834;2546;110;347;466;1372;576;1719
432200;201601;3016;9005;2418;7997;583;2123;1014;3386;1597;5509
432210;201601;411;1131;299;948;73;265;111;328;184;593
432215;201601;842;2574;714;2371;139;423;406;1452;545;1875
432218;201601;270;686;173;500;28;79;62;159;90;238
432220;201601;4131;10947;3405;9811;383;1305;2080;5815;2463;7120
432225;201601;65;211;57;196;22;78;16;55;38;133
432230;201601;1038;2795;627;1899;131;437;142;350;273;787
432232;201601;511;1451;399;1232;74;235;146;453;220;688
432234;201601;363;1007;240;744;47;147;61;184;108;331
432235;201601;107;302;39;127;9;32;1;1;10;33
432237;201601;460;1253;420;1192;16;68;310;850;326;918
432240;201601;13566;42555;11364;39705;1805;7459;6512;23489;8317;30948
432250;201601;4565;15539;4150;14726;1339;5168;1239;4457;2578;9625
432252;201601;378;1042;266;862;49;169;132;447;181;616
432253;201601;1304;4125;821;2882;209;804;95;337;304;1141
432254;201601;823;2229;249;819;52;182;28;81;80;263
432255;201601;192;521;116;387;24;85;35;108;59;193
432260;201601;7430;18466;5209;14892;1166;3438;1960;5884;3126;9322
432270;201601;2504;7429;2104;6746;589;1955;714;2372;1303;4327
432280;201601;1340;3657;721;2330;108;372;145;420;253;792
432285;201601;188;601;33;117;7;28;4;8;11;36
432290;201601;557;1622;352;1162;83;279;99;320;182;599
432300;201601;22704;67236;19917;62537;3824;13064;10767;33433;14591;46497
432310;201601;788;2319;624;2049;143;511;300;977;443;1488
432320;201601;207;529;104;335;17;55;16;43;33;98
432330;201601;323;842;124;408;13;43;9;23;22;66
432335;201601;147;422;65;228;15;56;10;31;25;87
432340;201601;368;886;180;542;30;99;52;149;82;248
432345;201601;634;1762;579;1674;78;294;344;904;422;1198
432350;201601;390;1051;213;703;32;102;56;177;88;279
432360;201601;182;563;41;149;12;50;10;31;22;81
432370;201601;411;1143;334;1001;43;124;200;608;243;732
432375;201601;758;1900;580;1610;75;206;326;923;401;1129
432377;201601;174;572;38;140;7;21;5;11;12;32
432380;201601;871;2875;760;2661;257;994;280;945;537;1939
500020;201601;2190;6518;1664;5601;363;1447;638;2058;1001;3505
500025;201601;1308;3020;819;2193;88;239;474;1251;562;1490
500060;201601;6710;19912;5357;17656;655;2237;3342;11489;3997;13726
500070;201601;4130;11949;3449;10784;694;2445;1436;4452;2130;6897
500080;201601;1456;4297;1089;3623;288;1069;334;1122;622;2191
500085;201601;2143;5558;1516;4649;169;550;863;2589;1032;3139
500090;201601;2328;6682;1691;5539;347;1175;720;2474;1067;3649
500100;201601;2505;7323;2131;6684;499;1794;854;2556;1353;4350
500110;201601;8125;24023;6566;21629;1079;3843;3144;11072;4223;14915
500124;201601;2015;6446;1745;6003;350;1123;897;3442;1247;4565
500150;201601;1383;3453;962;2775;184;635;354;851;538;1486
500190;201601;4682;12223;3668;10850;688;2178;1923;5853;2611;8031
500200;201601;2392;6064;1832;5061;385;1160;728;1893;1113;3053
500210;201601;4687;13984;3914;12784;883;3061;1755;5844;2638;8905
500215;201601;1530;4718;1208;4082;193;711;433;1439;626;2150
500220;201601;2875;9031;2395;8207;492;1792;925;3283;1417;5075
500230;201601;2738;6883;1931;5630;443;1411;837;2496;1280;3907
500240;201601;4530;14137;3301;11646;524;2000;1003;3833;1527;5833
500260;201601;2666;6829;1952;5741;303;1003;923;2594;1226;3597
500270;201601;119845;306213;76794;233055;17237;56732;15633;47190;32870;103922
500280;201601;1344;3485;1139;3221;95;290;857;2460;952;2750
500290;201601;4304;9821;2501;7215;507;1650;795;2207;1302;3857
500295;201601;2594;7616;1645;5511;272;1000;349;1006;621;2006
500310;201601;734;1929;605;1746;134;457;282;765;416;1222
500315;201601;3010;9435;2495;8610;363;1288;1499;5404;1862;6692
500320;201601;16686;53065;13293;46858;3757;14515;3671;13701;7428;28216
500325;201601;3978;10147;2892;8474;583;1852;1451;4288;2034;6140
500330;201601;6580;17364;4627;13782;864;2853;1960;5740;2824;8593
500345;201601;2141;5586;1672;4878;352;1119;777;2253;1129;3372
500348;201601;2254;6487;1947;6008;134;500;1390;4240;1524;4740
500350;201601;1236;3686;725;2480;98;358;226;813;324;1171
500370;201601;22795;68590;17468;59005;3731;14253;4693;16092;8424;30345
500375;201601;2884;7892;2152;6512;463;1466;558;1643;1021;3109
500380;201601;2989;8347;2393;7311;649;2069;867;2687;1516;4756
500390;201601;572;1278;337;920;52;168;175;437;227;605
500400;201601;1304;3936;978;3183;229;817;221;640;450;1457
500410;201601;2171;6099;1750;5491;462;1595;764;2429;1226;4024
500430;201601;2425;6890;1902;6139;403;1466;746;2530;1149;3996
500440;201601;1462;3864;983;3036;172;593;419;1270;591;1863
500450;201601;1610;4820;1189;4020;231;864;197;593;428;1457
500460;201601;3623;10802;2755;9156;706;2555;537;1771;1243;4326
500470;201601;3024;8784;2128;6898;516;1873;300;881;816;2754
500480;201601;2118;6533;1970;6350;249;684;1395;4969;1644;5653
500490;201601;917;2563;695;2177;201;717;150;494;351;1211
500500;201601;3662;11326;2874;10141;1116;4491;718;2571;1834;7062
500510;201601;828;2133;531;1623;68;225;214;600;282;825
500515;201601;1835;4897;1517;4481;254;793;838;2691;1092;3484
500520;201601;3069;10506;2742;9969;395;1577;1751;6478;2146;8055
500525;201601;1136;3612;907;3179;165;658;391;1410;556;2068
500540;201601;6222;17009;3714;12342;938;3678;438;1295;1376;4973
500560;201601;4513;14840;4104;14214;515;1959;2889;10091;3404;12050
500568;201601;4060;10124;2818;8286;561;1972;937;2564;1498;4536
500570;201601;7465;19847;4952;15193;1255;4152;876;2607;2131;6759
500580;201601;3620;10222;2891;9057;280;901;1988;6354;2268;7255
500600;201601;3797;10033;2499;7636;562;1847;687;2104;1249;3951
500620;201601;7563;21610;5798;18332;1107;3834;2345;7540;3452;11374
500625;201601;775;2258;433;1475;83;308;125;424;208;732
500627;201601;553;1601;430;1387;83;273;112;389;195;662
500630;201601;5934;16096;4258;13342;1049;3625;1236;3798;2285;7423
500635;201601;2691;10019;2206;9266;312;1270;1405;6485;1717;7755
500640;201601;1613;3869;1224;3320;87;278;866;2305;953;2583
500660;201601;18691;53380;14518;46782;4278;15534;4003;12999;8281;28533
500690;201601;2559;7558;2070;6885;945;3267;532;1955;1477;5222
500710;201601;3542;10493;2990;9590;656;2358;1227;3938;1883;6296
500720;201601;5970;15778;3826;12145;974;3421;777;2426;1751;5847
500730;201601;959;2658;678;2110;154;541;195;575;349;1116
500740;201601;4028;11020;3288;9664;399;1465;1478;4436;1877;5901
500750;201601;876;2413;746;2233;131;422;388;1148;519;1570
500755;201601;1158;3400;799;2663;166;602;171;476;337;1078
500769;201601;4971;13239;2975;9180;480;1646;539;1442;1019;3088
500770;201601;1663;4861;1224;4054;304;1057;290;1017;594;2074
500780;201601;1059;3069;853;2691;223;739;217;673;440;1412
500790;201601;9215;25380;7706;22840;1348;4602;4044;11724;5392;16326
500793;201601;2218;6369;1714;5527;444;1527;411;1222;855;2749
500795;201601;2372;7050;2014;6552;266;722;1384;4865;1650;5587
500797;201601;823;2240;576;1809;95;326;203;620;298;946
500800;201601;2756;7403;2141;6543;820;2867;501;1581;1321;4448
500830;201601;18553;49645;13027;39511;2487;8298;4010;11588;6497;19886
500840;201601;1266;3557;872;2778;105;363;342;1043;447;1406
510010;201601;1208;3604;1002;3277;265;874;475;1583;740;2457
510020;201601;3243;9221;2053;6832;447;1611;452;1437;899;3048
510025;201601;7367;21400;5756;18469;1310;4586;1710;5103;3020;9689
510030;201601;1665;4505;1360;4039;269;895;634;1792;903;2687
510035;201601;786;2281;611;2036;125;424;332;1147;457;1571
510040;201601;1654;4527;1283;3973;202;672;673;2116;875;2788
510050;201601;1807;5246;1311;4315;335;1216;347;1118;682;2334
510060;201601;1554;4439;1183;3744;213;709;464;1447;677;2156
510080;201601;1075;3351;853;2929;250;960;145;438;395;1398
510100;201601;666;1758;481;1391;57;191;217;584;274;775
510120;201601;302;647;190;505;15;46;120;324;135;370
510125;201601;3065;8051;2357;6836;406;1413;900;2417;1306;3830
510130;201601;1738;4766;1421;4252;370;1164;442;1334;812;2498
510140;201601;2736;8789;2215;8025;936;3806;412;1296;1348;5102
510160;201601;1296;4357;1169;4146;158;634;698;2415;856;3049
510170;201601;5047;15273;4181;13805;758;2787;1935;6208;2693;8995
510180;201601;11875;30809;8340;25334;2338;7529;2373;8198;4711;15727
510185;201601;1291;3828;1076;3539;132;430;684;2524;816;2954
510190;201601;2237;6496;1573;5506;313;1203;690;2571;1003;3774
510250;201601;13152;40468;11455;37879;3392;12116;4123;14155;7515;26271
510260;201601;2076;8589;1754;7950;457;2096;733;3916;1190;6012
510263;201601;3945;10563;2911;8913;691;2238;720;2123;1411;4361
510267;201601;5415;15505;3881;12343;828;2876;908;2732;1736;5608
510268;201601;785;2328;677;2171;140;468;362;1174;502;1642
510269;201601;984;3030;739;2559;229;821;174;623;403;1444
510270;201601;2593;8437;2202;7661;372;1298;950;3300;1322;4598
510279;201601;1747;5442;1434;4796;377;1335;352;1056;729;2391
510285;201601;1219;3567;947;3108;255;914;295;931;550;1845
510300;201601;3235;9422;2664;8613;203;773;1963;6400;2166;7173
510305;201601;1458;4512;1139;3925;288;1076;323;1111;611;2187
510310;201601;750;2312;638;2098;198;698;195;624;393;1322
510320;201601;3368;9718;2664;8436;637;2357;697;2088;1334;4445
510325;201601;5112;16097;4349;15071;1189;4265;2456;8901;3645;13166
510330;201601;2557;8122;2052;7215;531;2072;671;2368;1202;4440
510335;201601;4716;14136;3819;13026;484;1595;2675;9767;3159;11362
510336;201601;564;1736;420;1468;74;280;207;728;281;1008
510337;201601;2031;6680;1638;5925;633;2411;243;913;876;3324
510340;201601;73476;196388;51875;163233;16390;57551;8796;29150;25186;86701
510343;201601;1078;3114;892;2811;99;336;637;2050;736;2386
510345;201601;1569;4670;1272;4156;329;1157;431;1368;760;2525
510350;201601;3131;8491;2389;7453;575;1901;1021;3365;1596;5266
510360;201601;1714;4224;1090;3473;106;431;745;2321;851;2752
510370;201601;1170;3869;990;3581;203;743;565;2177;768;2920
510380;201601;512;1510;319;1120;117;446;24;80;141;526
510385;201601;910;3441;675;2910;88;410;301;1440;389;1850
510390;201601;1077;3339;984;3223;263;679;599;2222;862;2901
510395;201601;716;1765;519;1488;84;273;198;663;282;936
510410;201601;3615;11825;3221;11062;781;2805;1585;5589;2366;8394
510420;201601;2344;5958;1734;4957;184;666;880;2473;1064;3139
510450;201601;644;1689;450;1393;98;343;137;415;235;758
510452;201601;601;1947;451;1609;84;334;208;749;292;1083
510454;201601;800;2557;688;2340;102;383;421;1456;523;1839
510455;201601;940;2876;715;2422;133;519;218;700;351;1219
510460;201601;2196;5754;1679;5042;218;779;937;2687;1155;3466
510480;201601;4342;11478;3109;9274;653;2062;709;2003;1362;4065
510490;201601;1568;4879;1321;4505;284;1083;701;2333;985;3416
510500;201601;1489;4414;1014;3486;237;939;383;1247;620;2186
510510;201601;2518;8757;2183;8165;688;2779;639;2422;1327;5201
510515;201601;5957;18060;4444;14804;970;3577;967;3015;1937;6592
510517;201601;1617;4848;1332;4332;404;1382;321;1034;725;2416
510520;201601;2010;4680;1453;4006;62;185;989;2917;1051;3102
510523;201601;955;2844;852;2666;129;408;569;1838;698;2246
510525;201601;7813;20124;5328;16329;1045;3316;1823;5628;2868;8944
510530;201601;488;1395;404;1277;49;217;250;750;299;967
510550;201601;2535;8369;2066;7468;569;2221;647;2340;1216;4561
510558;201601;1813;5225;1539;4839;289;1005;777;2537;1066;3542
510560;201601;1612;4879;1056;3949;289;1203;199;757;488;1960
510562;201601;5185;15288;4081;13135;1173;4117;978;3243;2151;7360
510590;201601;2922;7785;2442;7173;498;1471;1328;4097;1826;5568
510600;201601;1533;3974;1036;3157;186;609;401;1175;587;1784
510610;201601;2814;8049;2303;7289;191;686;1541;4865;1732;5551
510615;201601;1992;6061;1689;5581;494;1712;724;2500;1218;4212
510617;201601;589;1766;487;1590;37;112;379;1294;416;1406
510618;201601;1395;4078;1025;3372;177;681;442;1415;619;2096
510619;201601;789;2196;479;1612;53;194;50;128;103;322
510620;201601;1381;3464;793;2568;199;721;107;325;306;1046
510621;201601;874;3052;784;2868;201;815;245;852;446;1667
510622;201601;3632;11002;2562;8785;648;2406;250;755;898;3161
510623;201601;3218;9208;2575;8087;656;2253;917;2732;1573;4985
510624;201601;1364;4100;952;3261;194;756;213;663;407;1419
510625;201601;2040;5753;1570;4960;409;1434;276;882;685;2316
510626;201601;1449;3899;965;3243;299;1137;238;824;537;1961
510627;201601;708;2029;478;1536;110;392;84;262;194;654
510628;201601;1493;3717;1072;3154;99;308;760;2261;859;2569
510629;201601;1694;5463;1379;4798;405;1569;396;1338;801;2907
510630;201601;2436;8266;1814;6979;449;1925;294;1185;743;3110
510631;201601;349;1009;309;946;36;99;232;716;268;815
510637;201601;2590;7612;2241;7061;681;2305;808;2590;1489;4895
510642;201601;4539;15002;3935;14132;1153;4560;1693;6303;2846;10863
510645;201601;955;2160;607;1688;182;498;164;499;346;997
510650;201601;6131;20388;5532;19692;1418;5258;3312;12340;4730;17598
510665;201601;1432;3817;952;2945;208;669;291;898;499;1567
510670;201601;379;858;211;626;20;80;98;275;118;355
510675;201601;6173;19366;4979;17042;1405;5429;1091;3641;2496;9070
510677;201601;1876;5110;1558;4702;168;517;1153;3654;1321;4171
510680;201601;696;2115;544;1810;126;438;122;389;248;827
510682;201601;2062;6546;1614;5707;435;1778;274;903;709;2681
510685;201601;927;2482;764;2269;83;287;503;1469;586;1756
510700;201601;4205;10907;2892;9092;611;2010;1357;4411;1968;6421
510704;201601;9013;23925;7394;21493;1387;4440;3605;10291;4992;14731
510706;201601;1816;5374;1247;4529;274;1019;606;2364;880;3383
510710;201601;3287;9121;2340;7220;539;1720;525;1485;1064;3205
510715;201601;705;1728;468;1322;89;270;149;420;238;690
510718;201601;2231;5544;1463;4664;678;2223;338;1264;1016;3487
510719;201601;398;926;265;753;26;111;137;358;163;469
510720;201601;1079;2626;832;2304;237;732;335;850;572;1582
510724;201601;685;2102;551;1859;119;445;210;663;329;1108
510726;201601;579;1489;437;1261;79;245;187;490;266;735
510729;201601;713;1770;418;1236;91;292;139;413;230;705
510730;201601;2618;7650;2022;6595;563;2010;509;1606;1072;3616
510735;201601;1005;3352;784;3002;168;724;370;1441;538;2165
510740;201601;1049;2591;768;2181;176;474;380;1149;556;1623
510757;201601;670;2259;556;2040;201;744;161;611;362;1355
510760;201601;29475;76046;20265;61217;5577;18453;4289;12760;9866;31213
510770;201601;4183;10754;3572;10023;329;900;2353;7396;2682;8296
510774;201601;363;1025;329;973;68;232;153;480;221;712
510775;201601;680;2003;565;1808;169;604;146;430;315;1034
510776;201601;522;1439;408;1208;85;277;173;510;258;787
510777;201601;1510;4513;1146;4025;156;585;862;3072;1018;3657
510779;201601;620;1856;472;1572;69;234;227;792;296;1026
510780;201601;3469;10503;2890;9611;707;2487;1125;3990;1832;6477
510785;201601;1687;4883;1260;4158;406;1384;235;818;641;2202
510787;201601;2166;6507;1733;5765;655;2340;321;1028;976;3368
510788;201601;529;1367;386;1160;161;509;80;272;241;781
510790;201601;15359;44479;10665;35708;2148;8392;1000;3398;3148;11790
510792;201601;7524;22281;5304;18108;1041;4028;766;2445;1807;6473
510794;201601;1095;3500;892;3095;297;1126;254;837;551;1963
510795;201601;7928;23596;5885;19833;1504;5597;1103;3947;2607;9544
510800;201601;1478;4175;1171;3736;274;962;449;1334;723;2296
510805;201601;1870;5223;1481;4640;250;853;884;2767;1134;3620
510810;201601;627;1575;491;1392;140;406;212;574;352;980
510820;201601;714;1703;481;1351;82;272;175;430;257;702
510830;201601;627;2013;530;1862;137;527;259;982;396;1509
510835;201601;602;1797;464;1533;104;382;167;510;271;892
510840;201601;45775;113967;36598;102343;8806;26058;16473;47563;25279;73621
510850;201601;1381;3931;983;3239;270;983;117;341;387;1324
510860;201601;2588;8185;1931;6899;739;2908;101;311;840;3219
510880;201601;619;2047;529;1893;170;658;196;730;366;1388
510885;201601;629;1758;508;1594;96;343;202;627;298;970
510890;201601;811;2582;667;2366;191;766;261;878;452;1644
510895;201601;1046;3250;885;2943;214;813;327;1034;541;1847
520005;201601;1351;4314;1203;4100;317;1123;575;2033;892;3156
520010;201601;1590;5345;1292;4745;478;2029;216;710;694;2739
520013;201601;3346;9360;2494;7779;563;1838;790;2520;1353;4358
520015;201601;440;1263;362;1152;77;265;126;414;203;679
520017;201601;1017;3052;862;2803;220;789;319;972;539;1761
520020;201601;442;1128;338;986;74;231;142;408;216;639
520025;201601;25077;78266;23817;76801;2722;9434;18856;60816;21578;70250
520030;201601;4379;13714;3709;12614;737;2767;1785;6105;2522;8872
520050;201601;409;1026;283;829;15;37;179;549;194;586
520055;201601;703;2136;619;1962;101;314;325;1072;426;1386
520060;201601;1296;4051;1113;3684;241;913;397;1262;638;2175
520080;201601;1757;5140;1494;4796;302;951;813;2804;1115;3755
520082;201601;1032;2850;929;2688;140;377;611;1846;751;2223
520085;201601;836;2528;725;2334;171;552;230;733;401;1285
520090;201601;960;2193;691;1861;154;381;343;1016;497;1397
520110;201601;40590;117213;31900;104269;11281;42070;4987;15873;16268;57943
520120;201601;186;501;123;393;24;94;29;94;53;188
520130;201601;3303;9303;2991;8859;747;2428;1417;4236;2164;6664
520140;201601;35814;115989;30961;107268;10579;39946;5098;17527;15677;57473
520145;201601;343;932;248;767;59;192;82;248;141;440
520150;201601;447;1184;359;1087;51;177;214;649;265;826
520160;201601;863;2343;705;2116;217;669;179;564;396;1233
520170;201601;4055;9461;3172;8458;255;749;2533;6860;2788;7609
520180;201601;1995;5852;1648;5327;326;1231;712;2267;1038;3498
520215;201601;1848;4785;1543;4308;181;528;964;2721;1145;3249
520235;201601;672;1749;493;1483;102;347;190;546;292;893
520250;201601;1465;4247;1109;3659;280;1063;224;702;504;1765
520260;201601;762;1947;520;1499;75;241;195;528;270;769
520280;201601;545;1572;477;1485;162;529;173;609;335;1138
520310;201601;1180;2810;849;2288;230;665;264;772;494;1437
520320;201601;1799;5590;1494;5028;141;499;928;3199;1069;3698
520330;201601;2627;8050;2009;6996;503;1897;310;1020;813;2917
520340;201601;1772;4449;1378;3947;205;523;893;2758;1098;3281
520350;201601;2977;8176;2341;7069;600;2018;841;2459;1441;4477
520355;201601;1016;3402;911;3239;298;1158;334;1139;632;2297
520357;201601;817;2187;689;1977;51;168;492;1415;543;1583
520360;201601;641;1873;555;1731;131;433;224;716;355;1149
520380;201601;1259;3402;857;2625;127;423;356;1067;483;1490
520390;201601;1050;2461;613;1890;174;615;202;567;376;1182
520393;201601;467;1159;372;1022;54;151;215;586;269;737
520396;201601;684;2222;569;2001;71;289;355;1220;426;1509
520400;201601;1638;4702;1404;4371;224;740;880;2718;1104;3458
520410;201601;1343;3291;1002;2820;191;607;545;1524;736;2131
520420;201601;309;862;229;698;42;137;67;178;109;315
520425;201601;1060;2926;884;2629;236;727;415;1252;651;1979
520430;201601;1812;4833;1187;3666;248;801;298;844;546;1645
520440;201601;3591;9218;2451;7229;705;2285;477;1406;1182;3691
520450;201601;9875;27574;6816;21910;1352;4742;456;1423;1808;6165
520455;201601;625;1874;505;1667;134;473;163;543;297;1016
520460;201601;857;2423;700;2164;121;441;361;1065;482;1506
520465;201601;765;2166;668;2049;107;351;396;1221;503;1572
520470;201601;1678;5439;1507;5168;365;1262;899;3240;1264;4502
520480;201601;927;2696;687;2290;121;438;272;852;393;1290
520485;201601;1209;3839;1049;3591;269;1030;561;1911;830;2941
520490;201601;3773;11906;3021;10736;911;3338;1275;4733;2186;8071
520495;201601;1233;3415;1073;3209;77;252;878;2678;955;2930
520500;201601;1281;3596;1061;3286;280;941;412;1269;692;2210
520505;201601;731;2090;625;1928;148;450;310;975;458;1425
520510;201601;8702;24334;6277;20569;1559;5623;1838;6285;3397;11908
520520;201601;1046;2906;832;2595;261;857;240;778;501;1635
520530;201601;1890;6314;1587;5789;552;2006;453;1823;1005;3829
520540;201601;2763;7805;2086;6595;555;1841;382;1246;937;3087
520545;201601;1041;3144;873;2851;174;602;264;823;438;1425
520547;201601;638;2029;555;1870;199;685;168;539;367;1224
520549;201601;9333;27324;7827;25322;2360;7958;3352;11121;5712;19079
520551;201601;3377;10317;3117;9953;876;3094;1769;5576;2645;8670
520552;201601;744;2234;673;2139;93;317;465;1504;558;1821
520570;201601;537;1527;397;1294;144;506;100;301;244;807
520580;201601;3197;7918;2203;6541;601;2026;869;2535;1470;4561
520590;201601;1330;3758;1038;3281;231;747;196;597;427;1344
520620;201601;7053;21967;6411;21077;1640;5601;3475;11627;5115;17228
520630;201601;797;2099;589;1795;113;363;231;712;344;1075
520640;201601;2720;7535;2242;6749;615;1893;790;2477;1405;4370
520650;201601;833;2226;618;1827;134;435;298;870;432;1305
520660;201601;335;947;267;860;89;316;84;274;173;590
520670;201601;887;2616;802;2498;62;195;661;2079;723;2274
520680;201601;692;1840;551;1641;149;442;228;689;377;1131
520690;201601;314;870;246;762;57;148;110;367;167;515
520710;201601;545;1408;345;1020;5;14;206;601;211;615
520725;201601;1482;3814;1123;3235;197;620;652;1868;849;2488
520735;201601;728;2065;518;1663;129;469;145;454;274;923
520740;201601;1552;4331;1246;3950;227;799;626;1980;853;2779
520750;201601;555;1510;443;1339;87;253;217;704;304;957
520753;201601;1340;3716;1217;3543;150;434;818;2536;968;2970
520760;201601;799;2135;704;2013;84;244;494;1480;578;1724
520780;201601;1874;4590;1504;4090;157;417;991;2700;1148;3117
520790;201601;2722;7079;2163;6288;240;664;1488;4553;1728;5217
520800;201601;15140;43814;13216;41553;2855;8571;7828;26591;10683;35162
520810;201601;1006;2498;803;2257;126;341;558;1685;684;2026
520815;201601;572;1828;438;1550;172;697;16;41;188;738
520830;201601;1459;3966;1226;3716;41;121;1034;3146;1075;3267
520840;201601;1502;4867;1261;4456;441;1711;227;858;668;2569
520850;201601;570;1777;435;1528;103;397;141;491;244;888
520860;201601;6362;18615;4804;16068;1195;4287;1503;5171;2698;9458
520870;201601;97382;260825;69079;215762;19071;65746;14337;43698;33408;109444
520880;201601;6647;19058;5023;16731;1660;6226;600;2007;2260;8233
520890;201601;3685;10400;2984;9276;593;2011;1415;4420;2008;6431
520910;201601;3705;10743;2727;8889;858;3005;453;1446;1311;4451
520915;201601;651;1935;534;1717;120;404;235;751;355;1155
520920;201601;3334;8966;2375;7458;495;1703;814;2650;1309;4353
520929;201601;521;1443;403;1264;75;231;225;734;300;965
520940;201601;1014;2950;827;2675;104;381;571;1834;675;2215
520945;201601;643;1543;514;1334;145;328;224;590;369;918
520960;201601;958;2840;764;2466;84;280;359;1192;443;1472
520970;201601;2733;8314;2380;7716;602;2126;650;2045;1252;4171
520980;201601;710;2072;632;1963;231;768;272;846;503;1614
520990;201601;2838;9278;2687;9067;447;1580;1811;6357;2258;7937
520993;201601;909;2328;737;2087;48;146;536;1542;584;1688
520995;201601;2262;6065;1990;5743;347;932;1327;3978;1674;4910
521000;201601;6521;19801;5432;17867;1535;5599;1463;4559;2998;10158
521010;201601;3868;11288;3046;9815;801;2581;1031;3403;1832;5984
521015;201601;658;1845;567;1699;156;454;258;783;414;1237
521020;201601;3525;9951;2428;7802;632;2196;248;741;880;2937
521030;201601;654;1645;497;1381;93;250;198;584;291;834
521040;201601;5683;15380;4856;14212;1691;5086;1748;5469;3439;10555
521056;201601;824;2534;696;2333;236;827;217;818;453;1645
521060;201601;1057;2747;855;2451;187;510;424;1312;611;1822
521080;201601;1124;2714;673;1983;78;297;239;588;317;885
521090;201601;2810;7568;2212;6817;673;2173;664;2140;1337;4313
521100;201601;1888;4176;1456;3702;273;632;929;2564;1202;3196
521120;201601;4133;11394;3352;10351;872;2895;1261;4019;2133;6914
521130;201601;969;2631;736;2200;109;387;401;1181;510;1568
521140;201601;993;3019;814;2686;217;744;257;863;474;1607
521150;201601;12161;30954;7754;22989;2651;8363;1551;4630;4202;12993
521160;201601;816;1922;509;1408;105;296;204;555;309;851
521170;201601;1105;2710;830;2309;176;510;445;1207;621;1717
521180;201601;6198;20270;5602;19256;1755;6464;1510;5278;3265;11742
521190;201601;9060;25877;6217;20796;1524;5534;1219;4116;2743;9650
521200;201601;718;1950;594;1751;75;239;340;985;415;1224
521205;201601;565;1610;435;1377;42;142;236;748;278;890
521210;201601;915;2545;615;1950;177;659;130;335;307;994
521220;201601;4000;10438;3030;9152;812;2680;1185;3637;1997;6317
521225;201601;357;879;289;805;35;86;199;593;234;679
521230;201601;1124;3579;1036;3413;338;1190;492;1582;830;2772
521250;201601;26562;85016;23608;80567;9884;35905;6061;21207;15945;57112
521260;201601;648;1603;551;1465;85;291;341;844;426;1135
521270;201601;1808;5346;1665;5149;135;330;1296;4218;1431;4548
521280;201601;1816;5531;1486;4895;427;1488;394;1271;821;2759
521290;201601;476;1342;361;1163;92;349;152;462;244;811
521295;201601;1151;2869;978;2644;152;402;679;1944;831;2346
521300;201601;1868;5257;1604;4846;249;713;927;2886;1176;3599
521305;201601;735;2090;601;1880;108;318;327;1066;435;1384
521308;201601;4269;12606;3372;10891;915;2991;1160;3771;2075;6762
521310;201601;7376;21888;5431;18230;1364;5005;989;3169;2353;8174
521340;201601;269;722;250;693;16;44;201;555;217;599
521350;201601;1878;5193;1570;4724;228;657;1040;3264;1268;3921
521370;201601;902;2652;693;2293;225;807;143;462;368;1269
521375;201601;1148;3522;972;3215;215;771;399;1270;614;2041
521377;201601;1047;2666;969;2584;69;126;842;2342;911;2468
521380;201601;5281;14981;3859;12355;630;2173;933;3101;1563;5274
521385;201601;448;1232;403;1176;100;319;205;591;305;910
521390;201601;835;2283;657;2058;173;646;175;511;348;1157
521400;201601;1858;5399;1731;5241;229;773;1302;3972;1531;4745
521405;201601;1336;3761;1046;3240;284;938;419;1327;703;2265
521410;201601;681;2100;637;2031;229;681;272;959;501;1640
521440;201601;1299;3806;1111;3412;153;524;486;1297;639;1821
521450;201601;3792;12259;3085;10900;1026;3853;532;1856;1558;5709
521460;201601;6380;18597;5389;16936;1354;4587;2439;7597;3793;12184
521470;201601;681;1947;509;1616;109;376;75;237;184;613
521480;201601;365;1105;247;846;49;175;80;264;129;439
521483;201601;2799;7324;2152;6226;545;1574;597;1704;1142;3278
521486;201601;1499;3857;1248;3501;114;305;909;2577;1023;2882
521487;201601;576;1483;410;1212;110;334;72;205;182;539
521490;201601;760;2220;623;1996;56;251;393;1202;449;1453
521500;201601;1302;4120;1009;3501;190;743;232;705;422;1448
521520;201601;873;2092;666;1816;171;490;299;876;470;1366
521523;201601;12868;46596;12164;45406;4279;17419;1489;6277;5768;23696
521525;201601;991;2617;864;2437;113;376;550;1505;663;1881
521530;201601;1674;4757;1067;3531;230;815;126;413;356;1228
521540;201601;916;2451;630;1980;139;518;196;585;335;1103
521550;201601;1237;3164;895;2507;209;624;411;1115;620;1739
521560;201601;3507;11745;3023;11062;1178;4693;944;3424;2122;8117
521565;201601;592;1516;495;1401;86;207;313;913;399;1120
521570;201601;4496;12370;2938;9323;629;2208;524;1693;1153;3901
521580;201601;542;1251;359;996;92;264;95;252;187;516
521590;201601;612;1712;509;1551;150;497;118;348;268;845
521600;201601;477;1308;345;1089;87;292;75;229;162;521
521630;201601;1337;3371;959;2836;237;825;166;428;403;1253
521640;201601;1977;5080;1528;4470;435;1305;606;1863;1041;3168
521645;201601;557;1637;426;1366;65;223;149;444;214;667
521680;201601;1329;4256;1121;3847;526;1945;150;493;676;2438
521690;201601;565;1654;501;1545;122;436;222;627;344;1063
521710;201601;2685;8055;2230;7251;478;1623;820;2716;1298;4339
521720;201601;1804;5156;1478;4586;318;982;772;2341;1090;3323
521730;201601;3529;11561;3096;10716;1130;4347;632;1937;1762;6284
521740;201601;3431;9427;2726;8447;712;2407;1138;3780;1850;6187
521760;201601;12439;40842;11068;38528;2819;10685;4481;15821;7300;26506
521770;201601;2543;7402;2058;6522;753;2562;527;1583;1280;4145
521800;201601;6838;20737;5911;19161;1817;6278;2058;6932;3875;13210
521805;201601;887;2016;644;1670;151;356;338;960;489;1316
521810;201601;805;2017;594;1718;125;385;235;724;360;1109
521830;201601;5113;16183;4578;15393;776;2852;2963;9963;3739;12815
521839;201601;686;1883;529;1608;98;314;172;507;270;821
521850;201601;6584;17654;5053;15054;1210;3826;1373;3776;2583;7602
521860;201601;1910;5196;1475;4526;336;1138;410;1232;746;2370
521870;201601;470;1546;385;1362;96;360;104;358;200;718
521878;201601;721;2077;516;1654;81;294;202;612;283;906
521880;201601;22235;57325;15193;46076;3886;12660;4243;13468;8129;26128
521890;201601;3285;9799;2580;8475;737;2593;512;1648;1249;4241
521900;201601;1387;3669;988;3086;234;774;318;911;552;1685
521910;201601;870;2396;782;2293;133;412;456;1420;589;1832
521920;201601;292;909;242;818;90;331;42;133;132;464
521925;201601;659;2006;556;1826;111;400;192;592;303;992
521930;201601;3551;11452;3090;10581;987;3547;543;1898;1530;5445
521935;201601;573;1638;498;1505;146;441;209;627;355;1068
521940;201601;984;2747;802;2470;189;639;373;1125;562;1764
521945;201601;637;2043;562;1930;98;324;344;1286;442;1610
521950;201601;613;1632;497;1463;71;222;301;908;372;1130
521960;201601;652;1982;532;1753;108;402;228;733;336;1135
521970;201601;2507;6699;2091;6191;217;624;1603;4933;1820;5557
521971;201601;1036;2743;742;2219;138;419;165;471;303;890
521973;201601;889;2760;744;2500;164;588;283;937;447;1525
521975;201601;11763;32433;10809;31343;1963;5904;7328;21270;9291;27174
521980;201601;1926;5444;1659;5115;257;678;1266;4093;1523;4771
521990;201601;1085;3069;894;2782;87;298;586;1850;673;2148
522000;201601;2190;6042;1596;5288;201;752;890;3105;1091;3857
522005;201601;391;961;271;774;79;215;87;264;166;479
522010;201601;3299;9453;2774;8604;967;3062;593;1890;1560;4952
522015;201601;867;2579;734;2370;164;522;353;1167;517;1689
522020;201601;4978;12993;3960;11477;939;2782;1934;5567;2873;8349
522026;201601;609;1654;448;1468;105;377;154;548;259;925
522028;201601;505;1460;407;1245;65;193;232;720;297;913
522040;201601;2229;5520;1767;4960;392;1114;1016;2893;1408;4007
522045;201601;14591;47578;12207;42820;3436;13261;2176;7526;5612;20787
522050;201601;1129;3185;818;2609;206;701;225;639;431;1340
522060;201601;2566;7641;2000;6796;566;2120;836;2858;1402;4978
522068;201601;1625;5115;1481;4947;151;434;1154;4076;1305;4510
522070;201601;710;2146;636;2026;77;299;453;1436;530;1735
522100;201601;505;1523;438;1425;168;601;173;537;341;1138
522108;201601;843;2619;712;2429;61;262;530;1775;591;2037
522119;201601;1332;4121;1132;3832;274;975;494;1730;768;2705
522130;201601;341;968;284;904;88;281;165;541;253;822
522140;201601;17190;47657;13928;42240;3986;12961;3653;10668;7639;23629
522145;201601;770;2179;675;2031;271;831;217;714;488;1545
522150;201601;818;2330;718;2166;201;615;261;788;462;1403
522155;201601;770;2188;678;2048;130;345;418;1356;548;1701
522157;201601;648;1789;550;1650;39;140;427;1286;466;1426
522160;201601;5690;16306;4184;13613;1194;4340;364;1145;1558;5485
522170;201601;2269;6674;1838;5895;577;1944;400;1289;977;3233
522180;201601;306;886;231;756;69;249;58;200;127;449
522185;201601;14603;42026;12212;39009;3172;10685;6361;20781;9533;31466
522190;201601;868;2155;663;1871;100;294;328;984;428;1278
522200;201601;1609;5201;1357;4682;344;1289;337;1133;681;2422
522205;201601;1351;3841;1096;3440;239;807;512;1572;751;2379
522220;201601;1301;3492;1061;3200;257;755;526;1760;783;2515
522230;201601;1201;3375;1011;3085;114;409;623;1897;737;2306
530010;201601;214723;673957;191197;633627;51574;188976;63030;204757;114604;393733
